,Unnamed: 0,id,grid,start_hour,end_hour,duration,lon,lat,gps2id
0,0,2F1CD98DD5F5A4A3E6D47AB706E19DF1,38154,4,6,2,109.5266,18.28278,1615
1,1,2F1CD98DD5F5A4A3E6D47AB706E19DF1,30151,6,15,9,109.50986,18.25083,1560
2,2,2F1CD98DD5F5A4A3E6D47AB706E19DF1,60641,15,17,2,109.53854,18.2359,1657
3,3,2F1CD98DD5F5A4A3E6D47AB706E19DF1,31551,18,19,1,109.55868,18.24222,1708
4,4,2F1CD98DD5F5A4A3E6D47AB706E19DF1,31171,20,21,1,109.50938,18.24917,1559
5,5,2F1CD98DD5F5A4A3E6D47AB706E19DF1,38154,21,22,1,109.5266,18.28278,1615
6,11,8CD2F16F090DFFBF34897CAC847CB1B1,38991,0,8,8,109.52681,18.30368,1618
7,12,8CD2F16F090DFFBF34897CAC847CB1B1,30071,12,13,1,109.52819,18.30472,1619
8,13,8CD2F16F090DFFBF34897CAC847CB1B1,31145,14,16,2,109.20431,18.30479,369
9,14,8CD2F16F090DFFBF34897CAC847CB1B1,38991,19,23,4,109.52681,18.30368,1618
10,62,3BB24F8BCA3E0C99C850EC3AEEBC46A9,31411,19,21,2,109.5016,18.23576,1507
11,74,59F29435D748531F416A4F1636997ECF,31071,0,5,5,109.58257,18.28458,1815
12,75,59F29435D748531F416A4F1636997ECF,30221,7,8,1,109.57833,18.20222,1802
13,76,59F29435D748531F416A4F1636997ECF,30854,12,22,10,109.56889,18.27076,1763
18,94,A8ABE4987042D12DD458C81CFD9663F5,30771,0,15,15,109.49938,18.26042,1511
19,95,A8ABE4987042D12DD458C81CFD9663F5,30971,20,21,1,109.48708,18.29319,1467
20,112,29064106BAD1EF15D718EE782B958C59,30854,16,17,1,109.56889,18.27076,1763
21,113,29064106BAD1EF15D718EE782B958C59,39111,19,23,4,109.5191,18.22597,1555
25,197,066CC6CBB5ADF978A93AF5D0C3292806,60501,13,14,1,109.48701,18.29021,1466
26,198,066CC6CBB5ADF978A93AF5D0C3292806,60031,15,17,2,109.49694,18.31632,1521
27,219,8F33595CCA53EF587ED1CFDC11EABCC3,60381,17,18,1,109.5241,18.22458,1605
28,220,8F33595CCA53EF587ED1CFDC11EABCC3,38251,19,20,1,109.49618,18.25493,1510
32,269,656B9E927798C6351C23CE193C829143,30171,9,20,11,109.48458,18.27139,1463
33,272,D359BF2318E0673A42DA16770C88CC4A,31145,13,15,2,109.20431,18.30479,369
34,273,D359BF2318E0673A42DA16770C88CC4A,31471,16,17,1,109.34583,18.29563,917
35,274,D359BF2318E0673A42DA16770C88CC4A,30341,18,20,2,109.3625,18.29167,966
36,288,90D91A493F9482486DCC3B27CF3F61EE,30854,6,8,2,109.56889,18.27076,1763
37,289,90D91A493F9482486DCC3B27CF3F61EE,31071,11,12,1,109.58257,18.28458,1815
38,290,90D91A493F9482486DCC3B27CF3F61EE,30854,12,17,5,109.56889,18.27076,1763
42,323,51A31646817F28C39250F582919BD19D,30111,1,7,6,109.47583,18.30542,1419
43,324,51A31646817F28C39250F582919BD19D,31431,7,9,2,109.44639,18.29042,1316
44,335,299AC9422F298CCC4ED16594B565B2CA,31864,19,20,1,109.49014,18.28333,1465
45,336,299AC9422F298CCC4ED16594B565B2CA,31861,20,22,2,109.49042,18.27549,1464
46,360,6BEBB9BBE9F4AFE976BF8920DDE09F08,31521,0,12,12,109.51458,18.22542,1555
47,361,6BEBB9BBE9F4AFE976BF8920DDE09F08,60054,13,17,4,109.3016,18.31229,770
48,362,6BEBB9BBE9F4AFE976BF8920DDE09F08,31031,18,20,2,109.49979,18.25382,1510
49,363,6BEBB9BBE9F4AFE976BF8920DDE09F08,31521,21,23,2,109.51458,18.22542,1555
50,383,FBD16F71D823E84C51D72176C3087A7E,30051,0,20,20,109.48917,18.21215,1453
51,384,FBD16F71D823E84C51D72176C3087A7E,31031,20,21,1,109.49979,18.25382,1510
52,423,68B7F3DB5AE2950AAD1040D6DBF076CF,30921,11,18,7,109.53903,18.29451,1667
53,424,68B7F3DB5AE2950AAD1040D6DBF076CF,38017,21,22,1,109.49729,18.21424,1504
54,433,104D50A9C0319F25E132948E6191A1E5,30271,9,11,2,109.49132,18.23153,1456
55,434,104D50A9C0319F25E132948E6191A1E5,30211,12,22,10,109.49882,18.23931,1508
56,540,46DF6D1FF2BE866E5B4B2D35C5373299,30854,7,15,8,109.56889,18.27076,1763
57,541,46DF6D1FF2BE866E5B4B2D35C5373299,60221,18,20,2,109.52569,18.29188,1616
61,576,D4EE8E1A4C04A1FF0596E4221D0B8B42,30854,13,16,3,109.56889,18.27076,1763
62,577,D4EE8E1A4C04A1FF0596E4221D0B8B42,39111,21,22,1,109.5191,18.22597,1555
66,598,5A888DC7A3AA300CC584D9862C5384A1,30721,0,7,7,109.51597,18.28257,1565
67,599,5A888DC7A3AA300CC584D9862C5384A1,39183,9,16,7,109.55542,18.28208,1715
68,684,1EB913BACF9C05B44A304AC858725E50,30421,19,21,2,109.50021,18.25861,1511
69,685,1EB913BACF9C05B44A304AC858725E50,30809,21,23,2,109.4891,18.28229,1465
73,885,33D03C41649B47EDC5176C93FF6F1D8D,60411,0,8,8,109.32514,18.30854,869
74,886,33D03C41649B47EDC5176C93FF6F1D8D,31471,9,11,2,109.34583,18.29563,917
75,887,33D03C41649B47EDC5176C93FF6F1D8D,30661,12,14,2,109.37028,18.24361,1008
76,888,33D03C41649B47EDC5176C93FF6F1D8D,31251,19,20,1,109.18528,18.2975,317
77,889,33D03C41649B47EDC5176C93FF6F1D8D,31471,22,23,1,109.34583,18.29563,917
78,903,AECF79630BEEC0EA88FD59B92FCAE378,30854,0,4,4,109.56889,18.27076,1763
79,904,AECF79630BEEC0EA88FD59B92FCAE378,30891,5,6,1,109.59431,18.28389,1865
80,909,34C10AAA4D010054D06315D944876FA4,30451,12,15,3,109.1791,18.36229,278
101,1207,EB316856896788EC8FD871E122E95728,30931,0,7,7,109.55653,18.32722,1722
102,1208,EB316856896788EC8FD871E122E95728,31811,9,11,2,109.54201,18.31806,1671
103,1209,EB316856896788EC8FD871E122E95728,30701,12,13,1,109.59313,18.32007,1871
104,1210,EB316856896788EC8FD871E122E95728,31811,14,17,3,109.54201,18.31806,1671
105,1211,EB316856896788EC8FD871E122E95728,30701,18,23,5,109.59313,18.32007,1871
106,1258,CD3BCBAB8571FB81953C842A434E5DB8,31071,1,5,4,109.58257,18.28458,1815
107,1259,CD3BCBAB8571FB81953C842A434E5DB8,30854,6,8,2,109.56889,18.27076,1763
108,1260,CD3BCBAB8571FB81953C842A434E5DB8,31071,13,15,2,109.58257,18.28458,1815
109,1261,CD3BCBAB8571FB81953C842A434E5DB8,30854,16,17,1,109.56889,18.27076,1763
110,1262,CD3BCBAB8571FB81953C842A434E5DB8,30771,21,23,2,109.49938,18.26042,1511
111,1319,42D399F7EB31A1EB2D2AA44B247ACDAA,38331,14,19,5,109.62465,18.22736,1956
112,1320,42D399F7EB31A1EB2D2AA44B247ACDAA,30421,20,22,2,109.50021,18.25861,1511
113,1326,38F4BE4A665B515DC81C1A78A906BDC2,60371,0,14,14,109.53063,18.30056,1618
114,1327,38F4BE4A665B515DC81C1A78A906BDC2,31931,19,21,2,109.54771,18.29403,1667
119,1398,D8898064D7FB8C9B8CE800B6EE2F87B6,30854,12,13,1,109.56889,18.27076,1763
120,1399,D8898064D7FB8C9B8CE800B6EE2F87B6,31071,14,15,1,109.58257,18.28458,1815
121,1400,D8898064D7FB8C9B8CE800B6EE2F87B6,30951,19,20,1,109.56208,18.25667,1761
126,1419,EBD16061EA20EE33D9344D33735E5205,38891,0,7,7,109.51486,18.24118,1558
127,1420,EBD16061EA20EE33D9344D33735E5205,31441,7,10,3,109.51181,18.24424,1559
128,1421,EBD16061EA20EE33D9344D33735E5205,38153,10,12,2,109.51819,18.25736,1561
129,1422,EBD16061EA20EE33D9344D33735E5205,38291,15,17,2,109.51618,18.24313,1558
130,1423,EBD16061EA20EE33D9344D33735E5205,38891,21,22,1,109.51486,18.24118,1558
141,1506,B4323D9C4164A7FE0A6F3CFD303FFF9A,31821,8,9,1,109.51181,18.24924,1559
142,1507,B4323D9C4164A7FE0A6F3CFD303FFF9A,30854,12,15,3,109.56889,18.27076,1763
143,1508,B4323D9C4164A7FE0A6F3CFD303FFF9A,60281,16,23,7,109.51743,18.25924,1561
144,1512,5EBEA276FCB4A19AC5C987F5C7CC8908,38361,0,6,6,109.43667,18.29201,1267
145,1513,5EBEA276FCB4A19AC5C987F5C7CC8908,60504,8,9,1,109.47917,18.28903,1416
146,1523,A1E318C80BE4457762B208DEDA1DAC8C,30151,0,3,3,109.50986,18.25083,1560
147,1524,A1E318C80BE4457762B208DEDA1DAC8C,60281,7,23,16,109.51743,18.25924,1561
148,1549,45086BC0869D90A8E8F669EDA6561CFA,31071,0,12,12,109.58257,18.28458,1815
149,1550,45086BC0869D90A8E8F669EDA6561CFA,31945,13,14,1,109.58021,18.29403,1817
150,1551,45086BC0869D90A8E8F669EDA6561CFA,39151,19,20,1,109.49875,18.25097,1510
151,1555,DB4DF566D4757FF3BB488F82DE126248,31561,6,21,15,109.56792,18.28479,1765
152,1556,DB4DF566D4757FF3BB488F82DE126248,30851,22,23,1,109.5616,18.27396,1713
153,1588,0312B43ACF9ED1D8304E325E851AEE29,31561,10,11,1,109.56792,18.28479,1765
154,1589,0312B43ACF9ED1D8304E325E851AEE29,30851,12,14,2,109.5616,18.27396,1713
155,1590,0312B43ACF9ED1D8304E325E851AEE29,31561,15,17,2,109.56792,18.28479,1765
156,1591,0312B43ACF9ED1D8304E325E851AEE29,30851,17,18,1,109.5616,18.27396,1713
157,1592,0312B43ACF9ED1D8304E325E851AEE29,31561,19,20,1,109.56792,18.28479,1765
165,1710,1A0300554B3838A02F1EC14AF8F37391,31945,0,7,7,109.58021,18.29403,1817
166,1711,1A0300554B3838A02F1EC14AF8F37391,30581,9,10,1,109.62257,18.24951,1959
167,1712,1A0300554B3838A02F1EC14AF8F37391,31221,11,12,1,109.61333,18.26833,1913
168,1713,1A0300554B3838A02F1EC14AF8F37391,30581,13,15,2,109.62257,18.24951,1959
169,1714,1A0300554B3838A02F1EC14AF8F37391,30854,16,20,4,109.56889,18.27076,1763
173,1801,0C8D15C0488D521680F0DE3A28CFE111,31811,0,11,11,109.54201,18.31806,1671
174,1802,0C8D15C0488D521680F0DE3A28CFE111,30701,11,18,7,109.59313,18.32007,1871
175,1834,64F4CDF664AA04E7B79DE93C57128CF6,39183,8,10,2,109.55542,18.28208,1715
176,1835,64F4CDF664AA04E7B79DE93C57128CF6,39181,11,12,1,109.55153,18.28035,1715
177,1836,64F4CDF664AA04E7B79DE93C57128CF6,39181,14,18,4,109.55153,18.28035,1715
178,1837,64F4CDF664AA04E7B79DE93C57128CF6,31931,19,20,1,109.54771,18.29403,1667
179,1874,DE5024DB59D5BF6AE5857A85EB7680EA,31071,0,7,7,109.58257,18.28458,1815
180,1875,DE5024DB59D5BF6AE5857A85EB7680EA,30854,11,22,11,109.56889,18.27076,1763
181,1882,5ACB2494699EB2F10AA3427B417842C4,60614,10,11,1,109.48799,18.29521,1467
182,1883,5ACB2494699EB2F10AA3427B417842C4,39151,15,16,1,109.49875,18.25097,1510
183,1901,40E7F0D633192F9BEA9F194F24931F67,30854,0,2,2,109.56889,18.27076,1763
184,1902,40E7F0D633192F9BEA9F194F24931F67,31071,2,9,7,109.58257,18.28458,1815
185,1903,40E7F0D633192F9BEA9F194F24931F67,30854,11,12,1,109.56889,18.27076,1763
186,1904,40E7F0D633192F9BEA9F194F24931F67,38111,13,19,6,109.52007,18.22403,1555
187,1905,40E7F0D633192F9BEA9F194F24931F67,38111,19,23,4,109.52007,18.22403,1555
188,1906,5BC4B4AAE031D7EDA11762088F9D6C7A,31271,18,20,2,109.48958,18.26257,1462
189,1907,5BC4B4AAE031D7EDA11762088F9D6C7A,31271,21,23,2,109.48958,18.26257,1462
190,2009,FACE88BC4E42BD847E718B0C0EE3CB9B,30251,0,8,8,109.50611,18.26653,1512
191,2010,FACE88BC4E42BD847E718B0C0EE3CB9B,38185,9,23,14,109.51333,18.27347,1563
192,2058,D59A2A795558AA457F13EDE8D62837D5,31821,0,9,9,109.51181,18.24924,1559
196,2090,F0F944706382F0443615560FA328E069,38754,12,14,2,109.74667,18.37382,2430
197,2091,F0F944706382F0443615560FA328E069,30341,19,21,2,109.3625,18.29167,966
198,2101,249541951E1FA75CAD2B8C3DC95305E9,31181,0,11,11,109.50382,18.24813,1509
199,2102,249541951E1FA75CAD2B8C3DC95305E9,60011,14,16,2,109.48965,18.30222,1468
200,2103,249541951E1FA75CAD2B8C3DC95305E9,31031,18,19,1,109.49979,18.25382,1510
201,2104,249541951E1FA75CAD2B8C3DC95305E9,31181,19,23,4,109.50382,18.24813,1509
202,2147,6587551DA47309E484D1302521C8D417,30854,10,12,2,109.56889,18.27076,1763
203,2148,6587551DA47309E484D1302521C8D417,30361,15,17,2,109.50347,18.24,1508
204,2185,3977578BE56276DA0700B04B81DC1356,30851,0,11,11,109.5616,18.27396,1713
205,2186,3977578BE56276DA0700B04B81DC1356,31561,11,23,12,109.56792,18.28479,1765
206,2211,57B6DD4E285A51425E04EA17431CFA29,30211,0,8,8,109.49882,18.23931,1508
207,2212,57B6DD4E285A51425E04EA17431CFA29,31145,10,13,3,109.20431,18.30479,369
208,2213,57B6DD4E285A51425E04EA17431CFA29,38754,14,19,5,109.74667,18.37382,2430
209,2248,44A75810FF8F9221047E9675BDBF60A2,31561,0,15,15,109.56792,18.28479,1765
210,2249,44A75810FF8F9221047E9675BDBF60A2,30854,15,23,8,109.56889,18.27076,1763
211,2351,C709D01469E0800AF998DFAF42105CDC,31561,6,8,2,109.56792,18.28479,1765
212,2352,C709D01469E0800AF998DFAF42105CDC,30851,8,10,2,109.5616,18.27396,1713
213,2353,C709D01469E0800AF998DFAF42105CDC,31561,13,16,3,109.56792,18.28479,1765
214,2354,C709D01469E0800AF998DFAF42105CDC,30854,19,21,2,109.56889,18.27076,1763
215,2382,451E2BF48CD7B253EB0892324E679BCC,38291,1,3,2,109.51618,18.24313,1558
216,2383,451E2BF48CD7B253EB0892324E679BCC,60281,7,10,3,109.51743,18.25924,1561
217,2384,451E2BF48CD7B253EB0892324E679BCC,38297,11,12,1,109.52576,18.24965,1609
218,2385,451E2BF48CD7B253EB0892324E679BCC,60281,14,17,3,109.51743,18.25924,1561
219,2386,451E2BF48CD7B253EB0892324E679BCC,38291,18,22,4,109.51618,18.24313,1558
224,2394,4DB778A581941E2A7955D8DA3B7ADAFE,38185,0,6,6,109.51333,18.27347,1563
225,2395,4DB778A581941E2A7955D8DA3B7ADAFE,31931,7,9,2,109.54771,18.29403,1667
226,2396,4DB778A581941E2A7955D8DA3B7ADAFE,60121,10,12,2,109.74507,18.37472,2430
227,2397,4DB778A581941E2A7955D8DA3B7ADAFE,60114,13,15,2,109.73028,18.33847,2374
228,2398,4DB778A581941E2A7955D8DA3B7ADAFE,30921,19,20,1,109.53903,18.29451,1667
229,2405,8A0382A2385C362EFE2664E8795F133E,39183,15,17,2,109.55542,18.28208,1715
230,2406,8A0382A2385C362EFE2664E8795F133E,31561,21,23,2,109.56792,18.28479,1765
231,2407,8E6B76C12940F9EC43BDEAF6EF9A8328,31061,0,1,1,109.53333,18.23257,1607
232,2408,8E6B76C12940F9EC43BDEAF6EF9A8328,31421,4,6,2,109.55382,18.22347,1705
233,2409,8E6B76C12940F9EC43BDEAF6EF9A8328,31061,6,9,3,109.53333,18.23257,1607
234,2410,8E6B76C12940F9EC43BDEAF6EF9A8328,31101,13,14,1,109.65389,18.23403,2057
235,2411,8E6B76C12940F9EC43BDEAF6EF9A8328,30361,19,21,2,109.50347,18.24,1508
236,2435,93715618B304E009FF2F157425BB5843,30771,19,21,2,109.49938,18.26042,1511
237,2436,93715618B304E009FF2F157425BB5843,60504,21,23,2,109.47917,18.28903,1416
238,2472,DDE77D3A656666992FC3458B84010D43,39183,0,14,14,109.55542,18.28208,1715
239,2473,DDE77D3A656666992FC3458B84010D43,31561,15,17,2,109.56792,18.28479,1765
240,2479,07FD145FE6C81328C98C6C5C8452E794,30854,0,9,9,109.56889,18.27076,1763
241,2480,07FD145FE6C81328C98C6C5C8452E794,30232,9,17,8,109.6191,18.31701,1971
242,2481,07FD145FE6C81328C98C6C5C8452E794,30854,18,23,5,109.56889,18.27076,1763
247,2621,9743FAD06BC4515BFDF8E186D0A37E74,38951,11,17,6,109.48097,18.28868,1416
248,2622,9743FAD06BC4515BFDF8E186D0A37E74,31351,19,23,4,109.4959,18.28417,1465
249,2710,A96BFAAC9CC1774B195362BA60EA846D,31071,0,8,8,109.58257,18.28458,1815
250,2711,A96BFAAC9CC1774B195362BA60EA846D,30854,10,19,9,109.56889,18.27076,1763
251,2715,40C57F24FE0409ABB752B2031C349577,38951,0,7,7,109.48097,18.28868,1416
252,2716,40C57F24FE0409ABB752B2031C349577,60041,8,16,8,109.39889,18.31944,1121
253,2717,40C57F24FE0409ABB752B2031C349577,38951,17,22,5,109.48097,18.28868,1416
254,2738,B494C063E7230AFA1BB1CFB38DCE979E,60054,1,4,3,109.3016,18.31229,770
255,2739,B494C063E7230AFA1BB1CFB38DCE979E,30661,4,9,5,109.37028,18.24361,1008
256,2740,B494C063E7230AFA1BB1CFB38DCE979E,60411,13,15,2,109.32514,18.30854,869
257,2741,B494C063E7230AFA1BB1CFB38DCE979E,30661,16,18,2,109.37028,18.24361,1008
258,2742,B494C063E7230AFA1BB1CFB38DCE979E,60411,21,23,2,109.32514,18.30854,869
259,2788,1FE2866848043A2C10AD87212485FE15,31071,3,6,3,109.58257,18.28458,1815
260,2789,1FE2866848043A2C10AD87212485FE15,30854,7,21,14,109.56889,18.27076,1763
261,2800,82591CF1D9AFC5ADCA95A1BAF87D07E3,31161,14,16,2,109.70229,18.31361,2270
262,2846,CD576F1C1CDFB89E6A99A20E65927346,31071,0,2,2,109.58257,18.28458,1815
263,2847,CD576F1C1CDFB89E6A99A20E65927346,30854,6,21,15,109.56889,18.27076,1763
264,2867,412879740E648AE1B2C1A60DD3B08C37,30111,5,8,3,109.47583,18.30542,1419
265,2868,412879740E648AE1B2C1A60DD3B08C37,60501,12,14,2,109.48701,18.29021,1466
266,2869,412879740E648AE1B2C1A60DD3B08C37,60221,16,17,1,109.52569,18.29188,1616
267,2870,412879740E648AE1B2C1A60DD3B08C37,30201,20,21,1,109.4909,18.26465,1462
268,2871,412879740E648AE1B2C1A60DD3B08C37,30111,22,23,1,109.47583,18.30542,1419
276,2909,79AB721DDB2EAA1CD0308535004E6A67,31071,0,8,8,109.58257,18.28458,1815
277,2910,79AB721DDB2EAA1CD0308535004E6A67,30854,8,10,2,109.56889,18.27076,1763
278,2911,79AB721DDB2EAA1CD0308535004E6A67,31071,12,13,1,109.58257,18.28458,1815
279,2912,79AB721DDB2EAA1CD0308535004E6A67,30854,14,16,2,109.56889,18.27076,1763
280,2913,79AB721DDB2EAA1CD0308535004E6A67,31071,20,23,3,109.58257,18.28458,1815
281,2945,3397CDF1AF021D9811232E8E7A104352,31521,0,9,9,109.51458,18.22542,1555
282,2946,3397CDF1AF021D9811232E8E7A104352,31781,12,14,2,109.19847,18.2975,367
283,2947,3397CDF1AF021D9811232E8E7A104352,39081,14,15,1,109.19382,18.29111,366
284,2948,3397CDF1AF021D9811232E8E7A104352,30361,17,21,4,109.50347,18.24,1508
285,2949,3397CDF1AF021D9811232E8E7A104352,31521,21,23,2,109.51458,18.22542,1555
286,3009,B26DD5C650BE7CEA4DB62E608BAE05C3,30361,19,20,1,109.50347,18.24,1508
287,3010,B26DD5C650BE7CEA4DB62E608BAE05C3,30931,21,23,2,109.55653,18.32722,1722
288,3011,B9591D667BD29C99F03D89422A405684,60084,0,1,1,109.4984,18.2334,1507
289,3012,B9591D667BD29C99F03D89422A405684,60161,2,8,6,109.49174,18.26181,1461
290,3013,B9591D667BD29C99F03D89422A405684,60401,9,10,1,109.47444,18.27583,1414
291,3014,B9591D667BD29C99F03D89422A405684,38484,18,20,2,109.53028,18.31528,1620
292,3015,B9591D667BD29C99F03D89422A405684,60281,21,23,2,109.51743,18.25924,1561
293,3033,E46795A590C643FCDE6B993B35621D2F,31931,0,14,14,109.54771,18.29403,1667
294,3034,E46795A590C643FCDE6B993B35621D2F,30921,17,18,1,109.53903,18.29451,1667
298,3047,066E3B290AAC556F650E56DD0F693AB2,60401,1,2,1,109.47444,18.27583,1414
299,3048,066E3B290AAC556F650E56DD0F693AB2,38251,5,6,1,109.49618,18.25493,1510
300,3049,066E3B290AAC556F650E56DD0F693AB2,33481,10,15,5,109.67278,18.41278,2187
304,3099,4DD578E2E3AB8705D8DDD716449001B9,30921,10,12,2,109.53903,18.29451,1667
305,3100,4DD578E2E3AB8705D8DDD716449001B9,31931,15,16,1,109.54771,18.29403,1667
306,3101,4DD578E2E3AB8705D8DDD716449001B9,60361,19,22,3,109.51938,18.29681,1567
307,3182,5535A1723CC527F3594ACA1502453D67,31471,13,15,2,109.34583,18.29563,917
308,3183,5535A1723CC527F3594ACA1502453D67,30354,18,23,5,109.42813,18.29076,1216
313,3248,70A62761FE79F922D082380DA7747243,30854,4,16,12,109.56889,18.27076,1763
314,3249,70A62761FE79F922D082380DA7747243,30861,18,22,4,109.52722,18.22743,1606
315,3256,E1108DE9382EA6DD2052A0875C7E83C6,31161,12,13,1,109.70229,18.31361,2270
316,3257,E1108DE9382EA6DD2052A0875C7E83C6,60111,14,19,5,109.72556,18.31924,2371
317,3258,E1108DE9382EA6DD2052A0875C7E83C6,31861,21,23,2,109.49042,18.27549,1464
324,3332,362A5B9B34971851814BD592D30A5666,30854,4,13,9,109.56889,18.27076,1763
325,3333,362A5B9B34971851814BD592D30A5666,38241,15,16,1,109.54111,18.30542,1669
333,3516,5EE8D9F14A8252BCCE8FF36AFB4B75F8,31521,13,14,1,109.51458,18.22542,1555
334,3517,5EE8D9F14A8252BCCE8FF36AFB4B75F8,30731,15,18,3,109.50944,18.22306,1555
335,3518,5EE8D9F14A8252BCCE8FF36AFB4B75F8,31521,18,22,4,109.51458,18.22542,1555
339,3535,6DF7485545B790F22810B0EDD8F1B356,31945,0,14,14,109.58021,18.29403,1817
340,3536,6DF7485545B790F22810B0EDD8F1B356,30854,15,16,1,109.56889,18.27076,1763
341,3567,0641FC44BB6634907F408B361FAAE705,30721,11,19,8,109.51597,18.28257,1565
342,3568,0641FC44BB6634907F408B361FAAE705,60221,21,22,1,109.52569,18.29188,1616
343,3574,6D02659C8AB6FF777A098A468ACF74DA,39091,16,19,3,109.50097,18.25222,1510
344,3575,6D02659C8AB6FF777A098A468ACF74DA,38102,21,23,2,109.40875,18.29111,1166
345,3631,0F558B6653C655C7F0BAEA9D66B33F57,31071,3,8,5,109.58257,18.28458,1815
346,3632,0F558B6653C655C7F0BAEA9D66B33F57,30854,9,10,1,109.56889,18.27076,1763
347,3635,1026894DC5FF9A7FAF3A2EE28B95E239,30891,0,8,8,109.59431,18.28389,1865
348,3636,1026894DC5FF9A7FAF3A2EE28B95E239,30854,12,22,10,109.56889,18.27076,1763
349,3662,7421066246AAD1C230E7E2A7ADF06E9D,60631,0,7,7,109.57778,18.27583,1814
350,3663,7421066246AAD1C230E7E2A7ADF06E9D,30854,7,17,10,109.56889,18.27076,1763
351,3664,7421066246AAD1C230E7E2A7ADF06E9D,31461,19,22,3,109.5091,18.25389,1510
356,3699,C153552CEA2677B0FF473AE565EA979E,30821,0,14,14,109.43681,18.33639,1274
357,3700,C153552CEA2677B0FF473AE565EA979E,30651,18,19,1,109.42611,18.385,1232
362,3842,6ABCA112AF80119A11E9BA7816F26F03,60381,0,8,8,109.5241,18.22458,1605
370,3913,8DD23AA43C0F7967C45F7488D66F9159,31945,0,2,2,109.58021,18.29403,1817
371,3914,8DD23AA43C0F7967C45F7488D66F9159,30854,2,4,2,109.56889,18.27076,1763
372,3915,8DD23AA43C0F7967C45F7488D66F9159,31945,6,7,1,109.58021,18.29403,1817
373,3916,8DD23AA43C0F7967C45F7488D66F9159,60631,10,11,1,109.57778,18.27583,1814
374,3917,8DD23AA43C0F7967C45F7488D66F9159,31945,13,14,1,109.58021,18.29403,1817
382,4004,4B0AADB3989E3C45AA834D87FDC75667,31181,0,11,11,109.50382,18.24813,1509
383,4005,4B0AADB3989E3C45AA834D87FDC75667,60011,14,15,1,109.48965,18.30222,1468
384,4006,4B0AADB3989E3C45AA834D87FDC75667,31031,18,19,1,109.49979,18.25382,1510
385,4007,4B0AADB3989E3C45AA834D87FDC75667,39101,20,23,3,109.50132,18.24931,1509
386,4025,8A01C766ABD659C6DF7A6AE90AA81678,60291,0,8,8,109.50826,18.24639,1509
387,4026,8A01C766ABD659C6DF7A6AE90AA81678,31521,9,23,14,109.51458,18.22542,1555
388,4066,CDA1EB7B89E47C48A7CAC823B0773234,31701,15,16,1,109.44132,18.28833,1266
389,4067,CDA1EB7B89E47C48A7CAC823B0773234,30831,18,19,1,109.69813,18.32076,2271
390,4096,B37777551ADDE84A1FDFE1FF465C24DC,31931,0,15,15,109.54771,18.29403,1667
391,4097,B37777551ADDE84A1FDFE1FF465C24DC,30921,15,20,5,109.53903,18.29451,1667
392,4145,FBDACEF8C95F9F2B8E3E865976CD03F5,31561,2,14,12,109.56792,18.28479,1765
393,4146,FBDACEF8C95F9F2B8E3E865976CD03F5,30854,17,18,1,109.56889,18.27076,1763
398,4227,928DF0385E8541CFD2F5858501C04155,30234,0,7,7,109.60681,18.29979,1918
399,4228,928DF0385E8541CFD2F5858501C04155,30854,7,23,16,109.56889,18.27076,1763
400,4272,75817DB682187A07461734D66E1E6492,31061,0,1,1,109.53333,18.23257,1607
401,4273,75817DB682187A07461734D66E1E6492,30854,2,16,14,109.56889,18.27076,1763
402,4274,75817DB682187A07461734D66E1E6492,60631,18,23,5,109.57778,18.27583,1814
403,4282,E5B7DF0BD5F9C6028960F1174FAA2027,60084,0,11,11,109.4984,18.2334,1507
404,4283,E5B7DF0BD5F9C6028960F1174FAA2027,38754,14,15,1,109.74667,18.37382,2430
405,4284,E5B7DF0BD5F9C6028960F1174FAA2027,30161,18,19,1,109.50042,18.24389,1508
406,4285,E5B7DF0BD5F9C6028960F1174FAA2027,30271,20,21,1,109.49132,18.23153,1456
410,4307,005F3AEFE6DBF371ED1FD57736434098,30854,14,17,3,109.56889,18.27076,1763
411,4308,005F3AEFE6DBF371ED1FD57736434098,31461,19,22,3,109.5091,18.25389,1510
412,4330,94976FAA0C4E2BB13E4130A03A47F4ED,60631,3,9,6,109.57778,18.27583,1814
413,4331,94976FAA0C4E2BB13E4130A03A47F4ED,30854,9,22,13,109.56889,18.27076,1763
414,4337,D4EDFC03E7ED63DAAF98D926C98FC74F,38754,13,14,1,109.74667,18.37382,2430
415,4338,D4EDFC03E7ED63DAAF98D926C98FC74F,30511,16,17,1,109.51069,18.24208,1558
416,4339,EC70F9D6B8EC4124E51EFCFD87BAFA84,38361,2,3,1,109.43667,18.29201,1267
417,4340,EC70F9D6B8EC4124E51EFCFD87BAFA84,31671,4,6,2,109.38965,18.29813,1068
418,4341,EC70F9D6B8EC4124E51EFCFD87BAFA84,38027,7,9,2,109.38833,18.2909,1066
419,4342,EC70F9D6B8EC4124E51EFCFD87BAFA84,38027,14,19,5,109.38833,18.2909,1066
420,4343,EC70F9D6B8EC4124E51EFCFD87BAFA84,38141,19,20,1,109.39479,18.2916,1116
421,4344,EC70F9D6B8EC4124E51EFCFD87BAFA84,38903,21,23,2,109.39229,18.29243,1117
422,4345,8D8AA41210FC9E2D5DD4D81CF4DB18D7,38991,0,7,7,109.52681,18.30368,1618
423,4346,8D8AA41210FC9E2D5DD4D81CF4DB18D7,39151,8,10,2,109.49875,18.25097,1510
424,4347,8D8AA41210FC9E2D5DD4D81CF4DB18D7,30271,11,12,1,109.49132,18.23153,1456
425,4348,8D8AA41210FC9E2D5DD4D81CF4DB18D7,30084,12,15,3,109.50118,18.26972,1513
426,4349,8D8AA41210FC9E2D5DD4D81CF4DB18D7,31521,19,20,1,109.51458,18.22542,1555
427,4350,8D8AA41210FC9E2D5DD4D81CF4DB18D7,38991,22,23,1,109.52681,18.30368,1618
432,4387,5E97A4561E11AAC4FBC53FD068EAA52B,30854,1,6,5,109.56889,18.27076,1763
433,4388,5E97A4561E11AAC4FBC53FD068EAA52B,30531,9,18,9,109.53271,18.21472,1604
434,4389,5E97A4561E11AAC4FBC53FD068EAA52B,30854,21,23,2,109.56889,18.27076,1763
435,4390,85E9F50B5ABCB1024F25DC89F0D41C6E,60201,0,2,2,109.5041,18.2509,1510
436,4391,85E9F50B5ABCB1024F25DC89F0D41C6E,60281,3,7,4,109.51743,18.25924,1561
437,4392,85E9F50B5ABCB1024F25DC89F0D41C6E,31041,7,9,2,109.50278,18.23701,1507
438,4393,85E9F50B5ABCB1024F25DC89F0D41C6E,31261,12,15,3,109.51174,18.2466,1559
439,4394,85E9F50B5ABCB1024F25DC89F0D41C6E,60281,19,23,4,109.51743,18.25924,1561
447,4567,6F25B46DE233F84CBE88187DB2427FA9,30201,0,6,6,109.4909,18.26465,1462
448,4568,6F25B46DE233F84CBE88187DB2427FA9,30201,8,9,1,109.4909,18.26465,1462
449,4569,6F25B46DE233F84CBE88187DB2427FA9,31021,10,12,2,109.49021,18.27,1463
450,4570,6F25B46DE233F84CBE88187DB2427FA9,30201,12,14,2,109.4909,18.26465,1462
451,4571,6F25B46DE233F84CBE88187DB2427FA9,31021,17,19,2,109.49021,18.27,1463
452,4572,6F25B46DE233F84CBE88187DB2427FA9,30201,19,23,4,109.4909,18.26465,1462
453,4573,5EAEAB611440D169B1CE8706AE16111E,31521,2,4,2,109.51458,18.22542,1555
454,4574,5EAEAB611440D169B1CE8706AE16111E,30511,5,11,6,109.51069,18.24208,1558
455,4575,5EAEAB611440D169B1CE8706AE16111E,38251,12,13,1,109.49618,18.25493,1510
456,4576,5EAEAB611440D169B1CE8706AE16111E,30511,15,16,1,109.51069,18.24208,1558
457,4577,5EAEAB611440D169B1CE8706AE16111E,38127,19,22,3,109.50833,18.27222,1513
458,4578,27BCEF3137923B84211F08830816C810,61011,12,13,1,109.60653,18.19076,1900
459,4580,27BCEF3137923B84211F08830816C810,61011,16,18,2,109.60653,18.19076,1900
460,4612,E7A64185897DA568208C43A23DB11EB2,30854,13,15,2,109.56889,18.27076,1763
461,4613,E7A64185897DA568208C43A23DB11EB2,30861,18,22,4,109.52722,18.22743,1606
468,4682,1065A9749A8F2A571941F492CF248982,30341,0,6,6,109.3625,18.29167,966
469,4683,1065A9749A8F2A571941F492CF248982,31781,9,13,4,109.19847,18.2975,367
470,4684,1065A9749A8F2A571941F492CF248982,60054,14,16,2,109.3016,18.31229,770
471,4685,1065A9749A8F2A571941F492CF248982,30711,18,19,1,109.50271,18.25347,1510
472,4686,1065A9749A8F2A571941F492CF248982,30341,20,22,2,109.3625,18.29167,966
473,4691,3D408742D0773F860BA62D41C728BA97,30711,15,16,1,109.50271,18.25347,1510
474,4692,3D408742D0773F860BA62D41C728BA97,39091,17,20,3,109.50097,18.25222,1510
478,4761,45A4BBA7E29D98A1407820384344799B,38951,2,11,9,109.48097,18.28868,1416
479,4762,45A4BBA7E29D98A1407820384344799B,33481,13,15,2,109.67278,18.41278,2187
480,4763,45A4BBA7E29D98A1407820384344799B,60221,20,21,1,109.52569,18.29188,1616
481,4764,45A4BBA7E29D98A1407820384344799B,60614,22,23,1,109.48799,18.29521,1467
482,4783,B340EDEF4A878E8DF5CBEC25E465EACE,30854,0,7,7,109.56889,18.27076,1763
483,4784,B340EDEF4A878E8DF5CBEC25E465EACE,31071,7,9,2,109.58257,18.28458,1815
484,4785,B340EDEF4A878E8DF5CBEC25E465EACE,30854,9,11,2,109.56889,18.27076,1763
485,4786,B340EDEF4A878E8DF5CBEC25E465EACE,31071,13,14,1,109.58257,18.28458,1815
486,4787,B340EDEF4A878E8DF5CBEC25E465EACE,30854,14,16,2,109.56889,18.27076,1763
487,4810,F198CAA1F49ACA5D003FD8F8473B3798,30581,17,20,3,109.62257,18.24951,1959
488,4811,F198CAA1F49ACA5D003FD8F8473B3798,30854,20,21,1,109.56889,18.27076,1763
489,4823,9FD9B533440DEDA093A3D6D9A5E4AA42,60361,0,14,14,109.51938,18.29681,1567
490,4824,9FD9B533440DEDA093A3D6D9A5E4AA42,30854,14,15,1,109.56889,18.27076,1763
491,4837,B73C72A488430C5DAE1758758E9D50EF,30951,0,1,1,109.56208,18.25667,1761
492,4838,B73C72A488430C5DAE1758758E9D50EF,31561,2,3,1,109.56792,18.28479,1765
493,4871,9CA3E2C253A813AF94072459FC979221,38321,0,11,11,109.39854,18.29132,1116
494,4872,9CA3E2C253A813AF94072459FC979221,31781,12,13,1,109.19847,18.2975,367
495,4873,9CA3E2C253A813AF94072459FC979221,31145,14,15,1,109.20431,18.30479,369
496,4874,9CA3E2C253A813AF94072459FC979221,31781,15,17,2,109.19847,18.2975,367
497,4875,9CA3E2C253A813AF94072459FC979221,38105,18,23,5,109.40299,18.29229,1117
498,4885,F6BB537A775832A45DF7D139A32B29FF,30711,2,7,5,109.50271,18.25347,1510
499,4886,F6BB537A775832A45DF7D139A32B29FF,31851,11,14,3,109.71736,18.29007,2316
500,4887,F6BB537A775832A45DF7D139A32B29FF,30711,17,19,2,109.50271,18.25347,1510
501,4888,F6BB537A775832A45DF7D139A32B29FF,60221,19,20,1,109.52569,18.29188,1616
502,4889,F6BB537A775832A45DF7D139A32B29FF,31851,22,23,1,109.71736,18.29007,2316
510,4991,FB69127E95B4D9EC5AF61282F8D7EEB7,30854,9,15,6,109.56889,18.27076,1763
511,4992,FB69127E95B4D9EC5AF61282F8D7EEB7,30861,17,21,4,109.52722,18.22743,1606
512,5000,8CBDC50DA35EAA1BF96B888A29A6656F,30351,18,22,4,109.41701,18.29292,1217
513,5006,2D39AE6120F2674000C6DBB8A6E572A0,31945,0,13,13,109.58021,18.29403,1817
514,5007,2D39AE6120F2674000C6DBB8A6E572A0,30854,14,23,9,109.56889,18.27076,1763
515,5014,E5E20C78783BEE4FE22BF6D264C660C6,31071,1,6,5,109.58257,18.28458,1815
516,5015,E5E20C78783BEE4FE22BF6D264C660C6,30854,9,18,9,109.56889,18.27076,1763
523,5221,AAE004FC512551834D40DDD86F1BD5D3,60161,1,3,2,109.49174,18.26181,1461
524,5222,AAE004FC512551834D40DDD86F1BD5D3,60041,4,11,7,109.39889,18.31944,1121
525,5223,AAE004FC512551834D40DDD86F1BD5D3,60161,15,16,1,109.49174,18.26181,1461
526,5224,AAE004FC512551834D40DDD86F1BD5D3,60231,17,19,2,109.49903,18.21972,1504
527,5225,AAE004FC512551834D40DDD86F1BD5D3,60161,21,22,1,109.49174,18.26181,1461
528,5259,462D8D1C789FC84A63DF1607C3EC93C5,60631,0,7,7,109.57778,18.27583,1814
529,5260,462D8D1C789FC84A63DF1607C3EC93C5,30854,8,11,3,109.56889,18.27076,1763
530,5263,E191BF114A3C2277CB7C3323BAA13F43,39151,18,19,1,109.49875,18.25097,1510
531,5264,E191BF114A3C2277CB7C3323BAA13F43,30854,21,22,1,109.56889,18.27076,1763
543,5402,90B0A60855A43B2DB99A0964CE51D3AF,31071,1,7,6,109.58257,18.28458,1815
544,5403,90B0A60855A43B2DB99A0964CE51D3AF,30854,11,23,12,109.56889,18.27076,1763
545,5425,3D39BFF619D555933510C63A4C03CAF1,60221,20,23,3,109.52569,18.29188,1616
546,5439,EF6EAAF19212F026BFFCE69929597502,31931,12,18,6,109.54771,18.29403,1667
547,5440,EF6EAAF19212F026BFFCE69929597502,31181,20,22,2,109.50382,18.24813,1509
548,5442,7AEDF35A88732925ED623E93535ACF94,31351,22,23,1,109.4959,18.28417,1465
557,5574,33E1BB37556BA5DDC29CF09F78EA92CE,60641,0,7,7,109.53854,18.2359,1657
558,5575,33E1BB37556BA5DDC29CF09F78EA92CE,60381,10,11,1,109.5241,18.22458,1605
559,5576,33E1BB37556BA5DDC29CF09F78EA92CE,30854,13,15,2,109.56889,18.27076,1763
560,5577,33E1BB37556BA5DDC29CF09F78EA92CE,60381,17,21,4,109.5241,18.22458,1605
561,5578,33E1BB37556BA5DDC29CF09F78EA92CE,60641,21,23,2,109.53854,18.2359,1657
562,5601,A9FCE0049DB44FE004EAFBF5B783F4A5,31945,0,6,6,109.58021,18.29403,1817
563,5602,A9FCE0049DB44FE004EAFBF5B783F4A5,30854,9,17,8,109.56889,18.27076,1763
575,5676,C0D9A8D1FC57A96EA766A127A0E8EAAC,30854,0,10,10,109.56889,18.27076,1763
576,5677,C0D9A8D1FC57A96EA766A127A0E8EAAC,60631,10,11,1,109.57778,18.27583,1814
577,5678,C0D9A8D1FC57A96EA766A127A0E8EAAC,30854,13,14,1,109.56889,18.27076,1763
578,5679,C0D9A8D1FC57A96EA766A127A0E8EAAC,60631,15,21,6,109.57778,18.27583,1814
579,5680,C0D9A8D1FC57A96EA766A127A0E8EAAC,30854,21,23,2,109.56889,18.27076,1763
580,5690,015CDEB9169BCE5537ABAE49B6A63F2B,39111,0,5,5,109.5191,18.22597,1555
581,5691,015CDEB9169BCE5537ABAE49B6A63F2B,30854,9,10,1,109.56889,18.27076,1763
582,5692,015CDEB9169BCE5537ABAE49B6A63F2B,31071,11,13,2,109.58257,18.28458,1815
583,5693,015CDEB9169BCE5537ABAE49B6A63F2B,30854,14,16,2,109.56889,18.27076,1763
584,5694,015CDEB9169BCE5537ABAE49B6A63F2B,31071,17,19,2,109.58257,18.28458,1815
585,5711,31812AB81FCECCF927F1F278190E0A39,60631,0,6,6,109.57778,18.27583,1814
586,5712,31812AB81FCECCF927F1F278190E0A39,31931,7,8,1,109.54771,18.29403,1667
587,5713,31812AB81FCECCF927F1F278190E0A39,60631,12,13,1,109.57778,18.27583,1814
588,5714,31812AB81FCECCF927F1F278190E0A39,31931,14,15,1,109.54771,18.29403,1667
589,5715,31812AB81FCECCF927F1F278190E0A39,60631,19,23,4,109.57778,18.27583,1814
593,5759,BE586ACB441383CC10D7CF3923850B73,60371,11,12,1,109.53063,18.30056,1618
594,5760,BE586ACB441383CC10D7CF3923850B73,31931,13,16,3,109.54771,18.29403,1667
595,5761,BE586ACB441383CC10D7CF3923850B73,31271,20,21,1,109.48958,18.26257,1462
596,5762,BE586ACB441383CC10D7CF3923850B73,31931,22,23,1,109.54771,18.29403,1667
600,5839,FCB3111133B2F972ED78C764490210E1,30854,0,6,6,109.56889,18.27076,1763
601,5840,FCB3111133B2F972ED78C764490210E1,31071,8,17,9,109.58257,18.28458,1815
602,5874,3D8D036A35BC58F8F36AEB163DF7D2CC,30181,1,11,10,109.51597,18.23313,1557
603,5875,3D8D036A35BC58F8F36AEB163DF7D2CC,31145,15,16,1,109.20431,18.30479,369
604,5876,3D8D036A35BC58F8F36AEB163DF7D2CC,30361,19,21,2,109.50347,18.24,1508
605,5877,3D8D036A35BC58F8F36AEB163DF7D2CC,30181,21,22,1,109.51597,18.23313,1557
606,5878,934029FB5F97BCE114EDCE88F0393A63,31071,2,19,17,109.58257,18.28458,1815
607,5879,934029FB5F97BCE114EDCE88F0393A63,30854,21,23,2,109.56889,18.27076,1763
611,5909,335A7B1DE8538918FDA774EE3E402A76,30191,0,7,7,109.50361,18.22701,1506
612,5910,335A7B1DE8538918FDA774EE3E402A76,60381,9,10,1,109.5241,18.22458,1605
613,5911,335A7B1DE8538918FDA774EE3E402A76,33481,13,16,3,109.67278,18.41278,2187
614,5912,335A7B1DE8538918FDA774EE3E402A76,30191,18,23,5,109.50361,18.22701,1506
615,5939,AA17C9279A63248D7DCDF49F93EB8817,39183,3,4,1,109.55542,18.28208,1715
616,5940,AA17C9279A63248D7DCDF49F93EB8817,38275,8,18,10,109.62875,18.22938,2006
617,5941,AA17C9279A63248D7DCDF49F93EB8817,30854,19,23,4,109.56889,18.27076,1763
618,5988,F84D949DDCBF25D5530F771BC55E0B9D,61011,0,18,18,109.60653,18.19076,1900
619,5989,F84D949DDCBF25D5530F771BC55E0B9D,31321,20,22,2,109.63799,18.23201,2007
628,6022,7369BED4E2FC40D6F6B26C6889CDEE8A,31205,14,16,2,109.51111,18.23736,1557
629,6023,7369BED4E2FC40D6F6B26C6889CDEE8A,31206,20,23,3,109.50819,18.23549,1507
630,6055,EB99FEF99139730D7C75B28A9DFBB9BC,60631,0,2,2,109.57778,18.27583,1814
631,6056,EB99FEF99139730D7C75B28A9DFBB9BC,31071,3,23,20,109.58257,18.28458,1815
632,6084,9C1407835BC54BEBDB541F52E1DA1820,61011,0,4,4,109.60653,18.19076,1900
633,6086,9C1407835BC54BEBDB541F52E1DA1820,61011,12,13,1,109.60653,18.19076,1900
634,6104,3C25AA28A73DA6B8FA6F4FFBF4B84B84,38754,14,16,2,109.74667,18.37382,2430
635,6105,3C25AA28A73DA6B8FA6F4FFBF4B84B84,30181,16,18,2,109.51597,18.23313,1557
636,6106,3C25AA28A73DA6B8FA6F4FFBF4B84B84,31521,18,21,3,109.51458,18.22542,1555
637,6132,52C15F07544D9CC60D46BD6BA2551891,60631,2,3,1,109.57778,18.27583,1814
638,6133,52C15F07544D9CC60D46BD6BA2551891,30854,6,17,11,109.56889,18.27076,1763
639,6175,5FB9536C7DD9A23FF858DBBDE43D97B4,60361,0,8,8,109.51938,18.29681,1567
640,6176,5FB9536C7DD9A23FF858DBBDE43D97B4,31471,12,14,2,109.34583,18.29563,917
641,6177,5FB9536C7DD9A23FF858DBBDE43D97B4,60411,14,15,1,109.32514,18.30854,869
642,6178,5FB9536C7DD9A23FF858DBBDE43D97B4,60361,19,23,4,109.51938,18.29681,1567
643,6179,87C93C09107C554DB19E0C119A198391,30581,0,6,6,109.62257,18.24951,1959
644,6180,87C93C09107C554DB19E0C119A198391,33481,10,13,3,109.67278,18.41278,2187
645,6181,6A638A7D814A6949897842F2EB3E49DC,31521,0,7,7,109.51458,18.22542,1555
646,6182,6A638A7D814A6949897842F2EB3E49DC,31521,9,23,14,109.51458,18.22542,1555
647,6185,50C94A5D81902FD587CF080801CF1E9B,30661,19,20,1,109.37028,18.24361,1008
648,6186,50C94A5D81902FD587CF080801CF1E9B,60411,21,22,1,109.32514,18.30854,869
649,6210,DBB710D279E76C79F1E4B0766F579F8A,30441,0,6,6,109.64021,18.25424,2010
650,6211,DBB710D279E76C79F1E4B0766F579F8A,30854,7,8,1,109.56889,18.27076,1763
654,6230,8799356B7181F28146A203E5F86C52F0,31351,0,7,7,109.4959,18.28417,1465
655,6231,8799356B7181F28146A203E5F86C52F0,38834,8,18,10,109.47639,18.21146,1403
656,6232,8799356B7181F28146A203E5F86C52F0,31351,19,23,4,109.4959,18.28417,1465
665,6338,17B36FE04A8DB99ADD8F8C217141C7D9,60251,0,7,7,109.51229,18.325,1572
666,6339,17B36FE04A8DB99ADD8F8C217141C7D9,30854,9,10,1,109.56889,18.27076,1763
667,6340,17B36FE04A8DB99ADD8F8C217141C7D9,38484,11,12,1,109.53028,18.31528,1620
668,6341,17B36FE04A8DB99ADD8F8C217141C7D9,60251,12,23,11,109.51229,18.325,1572
669,6347,DF1914B7230B32BA806E8A8749CAD846,60261,18,20,2,109.44326,18.3075,1319
670,6348,DF1914B7230B32BA806E8A8749CAD846,60201,21,23,2,109.5041,18.2509,1510
671,6386,E5E2DA460104E389257158E8D8C9FBDA,60281,0,6,6,109.51743,18.25924,1561
672,6387,E5E2DA460104E389257158E8D8C9FBDA,30251,7,8,1,109.50611,18.26653,1512
673,6388,E5E2DA460104E389257158E8D8C9FBDA,38291,9,11,2,109.51618,18.24313,1558
674,6389,E5E2DA460104E389257158E8D8C9FBDA,60291,13,17,4,109.50826,18.24639,1509
675,6390,E5E2DA460104E389257158E8D8C9FBDA,60281,18,22,4,109.51743,18.25924,1561
679,6489,A79D6124A17B67306E527E63C62B840F,31521,15,18,3,109.51458,18.22542,1555
680,6490,A79D6124A17B67306E527E63C62B840F,30181,21,23,2,109.51597,18.23313,1557
681,6550,A8E9C7BB918ADAD29A3EA7ACDDCD32D7,38951,0,8,8,109.48097,18.28868,1416
682,6551,A8E9C7BB918ADAD29A3EA7ACDDCD32D7,60041,8,14,6,109.39889,18.31944,1121
683,6552,A8E9C7BB918ADAD29A3EA7ACDDCD32D7,38951,17,23,6,109.48097,18.28868,1416
691,6590,1980C8D409DE9551539224B3D393CDAA,30071,12,21,9,109.52819,18.30472,1619
692,6591,1980C8D409DE9551539224B3D393CDAA,31951,21,23,2,109.52174,18.30299,1568
693,6616,7CF61852566EFB50DFB9BA6236C84059,30181,0,7,7,109.51597,18.23313,1557
694,6617,7CF61852566EFB50DFB9BA6236C84059,60552,9,10,1,109.41729,18.30014,1218
695,6618,7CF61852566EFB50DFB9BA6236C84059,30581,13,14,1,109.62257,18.24951,1959
699,6683,FA0EB766C44C307B69FC2247C53C674E,60131,0,7,7,109.49819,18.24778,1509
700,6684,FA0EB766C44C307B69FC2247C53C674E,30711,9,12,3,109.50271,18.25347,1510
701,6685,FA0EB766C44C307B69FC2247C53C674E,30941,13,14,1,109.5559,18.33938,1724
702,6686,FA0EB766C44C307B69FC2247C53C674E,39151,18,23,5,109.49875,18.25097,1510
703,6693,F017FF3142A71039848F82213CC35CB8,38052,5,11,6,109.62618,18.23042,1956
704,6694,F017FF3142A71039848F82213CC35CB8,38331,12,14,2,109.62465,18.22736,1956
705,6695,F017FF3142A71039848F82213CC35CB8,60594,14,15,1,109.62694,18.22799,1956
706,6696,F017FF3142A71039848F82213CC35CB8,38052,16,18,2,109.62618,18.23042,1956
707,6697,F017FF3142A71039848F82213CC35CB8,31031,18,20,2,109.49979,18.25382,1510
708,6698,F017FF3142A71039848F82213CC35CB8,60594,21,23,2,109.62694,18.22799,1956
709,6788,8752BC71725B50257436D50C6598F252,31071,0,7,7,109.58257,18.28458,1815
710,6789,8752BC71725B50257436D50C6598F252,30854,9,22,13,109.56889,18.27076,1763
715,6814,13CB28894FE9758E951221ECF7C4C4A1,30201,0,7,7,109.4909,18.26465,1462
716,6818,13CB28894FE9758E951221ECF7C4C4A1,31291,19,23,4,109.30375,18.40729,786
717,6841,08077B5D5F0A9938A81D328635D03C8B,31071,14,16,2,109.58257,18.28458,1815
718,6842,08077B5D5F0A9938A81D328635D03C8B,30854,17,19,2,109.56889,18.27076,1763
719,6843,08077B5D5F0A9938A81D328635D03C8B,31071,20,21,1,109.58257,18.28458,1815
720,6844,08077B5D5F0A9938A81D328635D03C8B,30854,21,23,2,109.56889,18.27076,1763
724,6863,34879982D44451BF0E6B0E476F030D2C,60084,0,7,7,109.4984,18.2334,1507
725,6864,34879982D44451BF0E6B0E476F030D2C,31781,12,13,1,109.19847,18.2975,367
726,6865,34879982D44451BF0E6B0E476F030D2C,31471,15,16,1,109.34583,18.29563,917
727,6866,34879982D44451BF0E6B0E476F030D2C,60084,21,23,2,109.4984,18.2334,1507
728,6875,C983E73D646629A775690ECA8920EB29,31631,0,8,8,109.59542,18.36826,1879
729,6876,C983E73D646629A775690ECA8920EB29,30101,11,12,1,109.57299,18.33333,1773
730,6877,C983E73D646629A775690ECA8920EB29,38251,14,15,1,109.49618,18.25493,1510
734,6905,D4AA3869830031578B573FD0033C24A8,30921,3,4,1,109.53903,18.29451,1667
735,6906,D4AA3869830031578B573FD0033C24A8,31931,4,23,19,109.54771,18.29403,1667
740,6976,6422CB87ACC55DDEF6EBE8946593C808,30281,0,1,1,109.50597,18.27583,1514
741,6977,6422CB87ACC55DDEF6EBE8946593C808,30201,1,5,4,109.4909,18.26465,1462
742,6979,6422CB87ACC55DDEF6EBE8946593C808,38834,15,20,5,109.47639,18.21146,1403
743,6980,6422CB87ACC55DDEF6EBE8946593C808,31351,22,23,1,109.4959,18.28417,1465
744,7004,68503E543A99EE2DC3294A01A2A414B7,38871,2,4,2,109.44681,18.28625,1316
745,7005,68503E543A99EE2DC3294A01A2A414B7,30111,5,7,2,109.47583,18.30542,1419
746,7006,68503E543A99EE2DC3294A01A2A414B7,38871,11,14,3,109.44681,18.28625,1316
747,7007,68503E543A99EE2DC3294A01A2A414B7,31431,18,20,2,109.44639,18.29042,1316
748,7008,68503E543A99EE2DC3294A01A2A414B7,30201,21,23,2,109.4909,18.26465,1462
752,7036,16BD55F34E997950AC3D027030FD92BC,30921,0,6,6,109.53903,18.29451,1667
753,7037,16BD55F34E997950AC3D027030FD92BC,31931,10,22,12,109.54771,18.29403,1667
754,7042,10C6D0E1E57880F0DC4DD15E8732EE08,30121,9,12,3,109.52861,18.27222,1613
755,7045,9AA959ED87D1ECC3053DED17290EFCBD,30854,10,12,2,109.56889,18.27076,1763
756,7046,9AA959ED87D1ECC3053DED17290EFCBD,39183,13,16,3,109.55542,18.28208,1715
757,7047,9AA959ED87D1ECC3053DED17290EFCBD,31561,17,23,6,109.56792,18.28479,1765
761,7126,C6FE4CF0CD47303AD7F7EC5A71315B10,30854,6,7,1,109.56889,18.27076,1763
762,7127,C6FE4CF0CD47303AD7F7EC5A71315B10,38205,10,22,12,109.62743,18.23139,1956
763,7132,32D0EBFA645FCE8DAD65D018847E5043,30232,0,5,5,109.6191,18.31701,1971
764,7133,32D0EBFA645FCE8DAD65D018847E5043,30854,8,12,4,109.56889,18.27076,1763
765,7134,32D0EBFA645FCE8DAD65D018847E5043,30232,12,14,2,109.6191,18.31701,1971
766,7135,32D0EBFA645FCE8DAD65D018847E5043,30854,14,16,2,109.56889,18.27076,1763
767,7145,A3DA1BE8D565CA010F364D67C383BE19,30161,15,16,1,109.50042,18.24389,1508
768,7190,8693FEE8E02E59F02AA0D7E67DE9383E,31031,0,10,10,109.49979,18.25382,1510
769,7191,8693FEE8E02E59F02AA0D7E67DE9383E,31561,14,15,1,109.56792,18.28479,1765
770,7192,8693FEE8E02E59F02AA0D7E67DE9383E,31031,16,22,6,109.49979,18.25382,1510
774,7266,9E8746086915F9D4A063A74CF0B5B7AB,39183,14,18,4,109.55542,18.28208,1715
775,7267,9E8746086915F9D4A063A74CF0B5B7AB,31561,20,22,2,109.56792,18.28479,1765
776,7289,DCD1B69C002595BDB52E9CC1F8BAAE8A,38831,0,8,8,109.4916,18.20938,1453
777,7290,DCD1B69C002595BDB52E9CC1F8BAAE8A,38251,11,12,1,109.49618,18.25493,1510
778,7292,DCD1B69C002595BDB52E9CC1F8BAAE8A,31941,20,22,2,109.62451,18.31222,1970
782,7318,FD5B9AB034F15F72E8BEF02193669238,60241,0,6,6,109.53319,18.28667,1616
783,7319,FD5B9AB034F15F72E8BEF02193669238,31931,8,10,2,109.54771,18.29403,1667
784,7320,FD5B9AB034F15F72E8BEF02193669238,60241,12,13,1,109.53319,18.28667,1616
785,7321,FD5B9AB034F15F72E8BEF02193669238,31931,14,15,1,109.54771,18.29403,1667
786,7322,FD5B9AB034F15F72E8BEF02193669238,60241,19,21,2,109.53319,18.28667,1616
787,7323,FD5B9AB034F15F72E8BEF02193669238,60371,22,23,1,109.53063,18.30056,1618
792,7358,033CEEC20746801745CF4A53CD517C31,31821,17,18,1,109.51181,18.24924,1559
793,7359,033CEEC20746801745CF4A53CD517C31,31391,18,20,2,109.50382,18.24285,1508
794,7360,033CEEC20746801745CF4A53CD517C31,31181,20,23,3,109.50382,18.24813,1509
795,7361,E9FE314BF6BA7C40D9DECC5BB702593F,31071,12,14,2,109.58257,18.28458,1815
796,7362,E9FE314BF6BA7C40D9DECC5BB702593F,30854,15,22,7,109.56889,18.27076,1763
797,7384,1419F2503130508E06D5FA0D4A5CF329,31031,0,9,9,109.49979,18.25382,1510
798,7385,1419F2503130508E06D5FA0D4A5CF329,31031,11,13,2,109.49979,18.25382,1510
799,7386,1419F2503130508E06D5FA0D4A5CF329,60291,15,16,1,109.50826,18.24639,1509
800,7387,1419F2503130508E06D5FA0D4A5CF329,31261,17,21,4,109.51174,18.2466,1559
801,7388,1419F2503130508E06D5FA0D4A5CF329,31031,21,23,2,109.49979,18.25382,1510
805,7405,D4F66FB71406E4E38A7A105B0CD3164D,30711,0,4,4,109.50271,18.25347,1510
806,7406,D4F66FB71406E4E38A7A105B0CD3164D,30711,4,21,17,109.50271,18.25347,1510
811,7485,60C76AD19DF8888A84F620E94C92FF2B,30571,4,5,1,109.50243,18.21861,1504
812,7486,60C76AD19DF8888A84F620E94C92FF2B,60231,7,8,1,109.49903,18.21972,1504
813,7487,60C76AD19DF8888A84F620E94C92FF2B,60161,12,15,3,109.49174,18.26181,1461
814,7488,60C76AD19DF8888A84F620E94C92FF2B,30341,18,19,1,109.3625,18.29167,966
815,7489,60C76AD19DF8888A84F620E94C92FF2B,38325,20,22,2,109.39792,18.2909,1116
816,7517,2981C8B3C1AD0C63670497656AA260BB,30151,20,22,2,109.50986,18.25083,1560
817,7518,2981C8B3C1AD0C63670497656AA260BB,30721,22,23,1,109.51597,18.28257,1565
822,7596,9D5FE3225DA80BAE67F5E52EB432B0A5,31351,11,12,1,109.4959,18.28417,1465
823,7597,9D5FE3225DA80BAE67F5E52EB432B0A5,60551,14,16,2,109.42722,18.30111,1218
824,7604,5F70E6EFF50C46A1203DB5C4C03B4FD3,31701,2,12,10,109.44132,18.28833,1266
825,7605,5F70E6EFF50C46A1203DB5C4C03B4FD3,38754,16,18,2,109.74667,18.37382,2430
826,7606,5F70E6EFF50C46A1203DB5C4C03B4FD3,31701,21,23,2,109.44132,18.28833,1266
830,7658,DFFF17B7FE30E79B8AABBB5CE171272F,31561,13,14,1,109.56792,18.28479,1765
831,7659,DFFF17B7FE30E79B8AABBB5CE171272F,39183,15,17,2,109.55542,18.28208,1715
832,7660,DFFF17B7FE30E79B8AABBB5CE171272F,31561,21,22,1,109.56792,18.28479,1765
833,7678,B34415F599F0ED7D1A073EE314A60B9B,60041,3,7,4,109.39889,18.31944,1121
834,7679,B34415F599F0ED7D1A073EE314A60B9B,31671,7,23,16,109.38965,18.29813,1068
839,7734,36240C8151C140450D90485BA4232298,30861,0,7,7,109.52722,18.22743,1606
840,7735,36240C8151C140450D90485BA4232298,31145,12,14,2,109.20431,18.30479,369
844,7752,DFEFB1CD7965FB8E2BDF1B532ED92233,30854,16,17,1,109.56889,18.27076,1763
845,7753,DFEFB1CD7965FB8E2BDF1B532ED92233,31931,19,21,2,109.54771,18.29403,1667
846,7788,28C2CCAEBA502B987F7F8A800965B87A,31521,7,11,4,109.51458,18.22542,1555
847,7789,28C2CCAEBA502B987F7F8A800965B87A,31521,13,14,1,109.51458,18.22542,1555
848,7790,28C2CCAEBA502B987F7F8A800965B87A,60221,17,20,3,109.52569,18.29188,1616
849,7791,28C2CCAEBA502B987F7F8A800965B87A,60381,21,22,1,109.5241,18.22458,1605
853,7940,5994FF6B1B98D57BC00DD456224D499E,31521,19,20,1,109.51458,18.22542,1555
854,7941,5994FF6B1B98D57BC00DD456224D499E,30271,22,23,1,109.49132,18.23153,1456
855,7971,967E548F53382C36FB0D7FF12F6A99E7,31531,0,6,6,109.49583,18.25972,1461
856,7972,967E548F53382C36FB0D7FF12F6A99E7,60331,6,8,2,109.505,18.26507,1512
857,7973,967E548F53382C36FB0D7FF12F6A99E7,31531,8,11,3,109.49583,18.25972,1461
858,7974,967E548F53382C36FB0D7FF12F6A99E7,60131,13,15,2,109.49819,18.24778,1509
859,7975,967E548F53382C36FB0D7FF12F6A99E7,60331,17,18,1,109.505,18.26507,1512
860,7976,967E548F53382C36FB0D7FF12F6A99E7,30201,18,19,1,109.4909,18.26465,1462
861,7977,967E548F53382C36FB0D7FF12F6A99E7,31531,21,22,1,109.49583,18.25972,1461
865,8053,4C7F249ED8CAEDF4D8459D40AD053582,60631,18,19,1,109.57778,18.27583,1814
866,8054,4C7F249ED8CAEDF4D8459D40AD053582,30854,20,22,2,109.56889,18.27076,1763
871,8095,1D8B814EC83D52D7C5F3FED99C129EE0,30854,0,7,7,109.56889,18.27076,1763
872,8096,1D8B814EC83D52D7C5F3FED99C129EE0,38283,10,13,3,109.62229,18.22618,1956
873,8097,1D8B814EC83D52D7C5F3FED99C129EE0,38271,17,19,2,109.62632,18.23049,1956
874,8098,1D8B814EC83D52D7C5F3FED99C129EE0,30854,22,23,1,109.56889,18.27076,1763
875,8156,B855550E4CC0B884D3E498DD555D8030,60541,0,8,8,109.4084,18.29208,1167
876,8157,B855550E4CC0B884D3E498DD555D8030,38102,9,10,1,109.40875,18.29111,1166
877,8158,B855550E4CC0B884D3E498DD555D8030,31031,13,15,2,109.49979,18.25382,1510
878,8159,B855550E4CC0B884D3E498DD555D8030,38102,16,19,3,109.40875,18.29111,1166
879,8160,B855550E4CC0B884D3E498DD555D8030,60541,22,23,1,109.4084,18.29208,1167
880,8212,2C71D4EA311A341740E13C6213E06050,30361,17,19,2,109.50347,18.24,1508
881,8213,2C71D4EA311A341740E13C6213E06050,30861,19,22,3,109.52722,18.22743,1606
882,8331,452F0FF6BC36839041DCBEF2292D6E55,30861,0,10,10,109.52722,18.22743,1606
883,8359,C462628FF36F8FF2D0B7493E6DDA38BB,30661,4,12,8,109.37028,18.24361,1008
884,8360,C462628FF36F8FF2D0B7493E6DDA38BB,60411,15,17,2,109.32514,18.30854,869
885,8361,C462628FF36F8FF2D0B7493E6DDA38BB,30661,19,23,4,109.37028,18.24361,1008
889,8387,F8D799D9161B0143E0D71C40472A357E,30071,1,15,14,109.52819,18.30472,1619
890,8388,F8D799D9161B0143E0D71C40472A357E,30071,16,23,7,109.52819,18.30472,1619
891,8395,599AFAF71D30C85AA4E0085C43FF5E03,30051,14,15,1,109.48917,18.21215,1453
892,8396,599AFAF71D30C85AA4E0085C43FF5E03,31041,15,18,3,109.50278,18.23701,1507
893,8397,599AFAF71D30C85AA4E0085C43FF5E03,38891,18,20,2,109.51486,18.24118,1558
894,8407,C0CA4E58B15F58D7F48B8BEF10CEB35A,30854,0,6,6,109.56889,18.27076,1763
895,8408,C0CA4E58B15F58D7F48B8BEF10CEB35A,60631,8,9,1,109.57778,18.27583,1814
896,8414,E7DB0F55EDE33BB4C08C98B80B7173BF,30921,0,6,6,109.53903,18.29451,1667
897,8416,E7DB0F55EDE33BB4C08C98B80B7173BF,60371,13,15,2,109.53063,18.30056,1618
898,8417,E7DB0F55EDE33BB4C08C98B80B7173BF,31181,19,20,1,109.50382,18.24813,1509
899,8418,E7DB0F55EDE33BB4C08C98B80B7173BF,60371,20,22,2,109.53063,18.30056,1618
900,8419,7BF65E5054DA81A230AB5423620158E1,60631,1,7,6,109.57778,18.27583,1814
901,8420,7BF65E5054DA81A230AB5423620158E1,30854,7,22,15,109.56889,18.27076,1763
902,8530,D26DFF9CD872B22A8694735583552102,30201,17,23,6,109.4909,18.26465,1462
903,8577,C6C3BC01E542B810EF853FEEB6C81198,31206,0,2,2,109.50819,18.23549,1507
904,8578,C6C3BC01E542B810EF853FEEB6C81198,60361,4,17,13,109.51938,18.29681,1567
905,8579,C6C3BC01E542B810EF853FEEB6C81198,31561,20,21,1,109.56792,18.28479,1765
906,8602,E298B72756164833AF59D588A2ED08C0,30854,8,10,2,109.56889,18.27076,1763
907,8603,E298B72756164833AF59D588A2ED08C0,31945,10,12,2,109.58021,18.29403,1817
908,8604,E298B72756164833AF59D588A2ED08C0,30854,15,16,1,109.56889,18.27076,1763
909,8605,E298B72756164833AF59D588A2ED08C0,60631,16,17,1,109.57778,18.27583,1814
910,8606,E298B72756164833AF59D588A2ED08C0,30371,19,21,2,109.51,18.24771,1559
914,8625,52626520133C58C019E9712FB19D3224,39091,14,15,1,109.50097,18.25222,1510
915,8626,52626520133C58C019E9712FB19D3224,38171,19,23,4,109.50799,18.28139,1515
916,8629,D372DBE97920212E2B5B6136E2BCFBCE,60161,0,11,11,109.49174,18.26181,1461
917,8630,D372DBE97920212E2B5B6136E2BCFBCE,30341,12,13,1,109.3625,18.29167,966
918,8631,D372DBE97920212E2B5B6136E2BCFBCE,61011,18,19,1,109.60653,18.19076,1900
919,8632,D372DBE97920212E2B5B6136E2BCFBCE,31421,22,23,1,109.55382,18.22347,1705
923,8660,63B5E489F3503F8EC6E40A38F9D2117C,60241,3,7,4,109.53319,18.28667,1616
924,8661,63B5E489F3503F8EC6E40A38F9D2117C,60171,9,14,5,109.51292,18.30694,1569
925,8695,8DEBA8F3DD446F0F0680296AB7E73431,30764,6,11,5,109.45806,18.29486,1367
926,8696,8DEBA8F3DD446F0F0680296AB7E73431,60441,12,23,11,109.46792,18.28604,1366
927,8734,8AABF5FDF2B06EB445749240A3894969,31071,3,13,10,109.58257,18.28458,1815
928,8735,8AABF5FDF2B06EB445749240A3894969,31851,15,17,2,109.71736,18.29007,2316
929,8736,8AABF5FDF2B06EB445749240A3894969,39181,20,22,2,109.55153,18.28035,1715
930,8772,3F197D0DAA06984EE5CE0801FD1B5C1F,30351,7,10,3,109.41701,18.29292,1217
931,8773,3F197D0DAA06984EE5CE0801FD1B5C1F,31201,12,13,1,109.51042,18.23819,1558
932,8774,3F197D0DAA06984EE5CE0801FD1B5C1F,60381,14,17,3,109.5241,18.22458,1605
933,8775,3F197D0DAA06984EE5CE0801FD1B5C1F,30361,17,20,3,109.50347,18.24,1508
934,8792,A0D67E4ED0CFB18CCA0714B3A5A7DEED,30711,15,18,3,109.50271,18.25347,1510
935,8818,CA373FFAFD7EFAD5EEFC32965095EB00,39151,3,6,3,109.49875,18.25097,1510
936,8819,CA373FFAFD7EFAD5EEFC32965095EB00,60201,6,8,2,109.5041,18.2509,1510
937,8820,CA373FFAFD7EFAD5EEFC32965095EB00,30561,9,11,2,109.52778,18.31938,1621
938,8821,CA373FFAFD7EFAD5EEFC32965095EB00,30711,12,15,3,109.50271,18.25347,1510
939,8822,CA373FFAFD7EFAD5EEFC32965095EB00,38241,15,16,1,109.54111,18.30542,1669
940,8823,CA373FFAFD7EFAD5EEFC32965095EB00,31061,19,20,1,109.53333,18.23257,1607
941,8827,E8BAAF476E8FE57075BAB1A8D4FF1780,30891,0,1,1,109.59431,18.28389,1865
942,8828,E8BAAF476E8FE57075BAB1A8D4FF1780,31945,1,4,3,109.58021,18.29403,1817
943,8829,E8BAAF476E8FE57075BAB1A8D4FF1780,31071,5,6,1,109.58257,18.28458,1815
944,8830,E8BAAF476E8FE57075BAB1A8D4FF1780,30854,15,17,2,109.56889,18.27076,1763
945,8831,E8BAAF476E8FE57075BAB1A8D4FF1780,30951,17,18,1,109.56208,18.25667,1761
946,8832,E8BAAF476E8FE57075BAB1A8D4FF1780,30181,19,21,2,109.51597,18.23313,1557
947,8833,BC4D9B63CA4001C365CE5CB9219EAEA2,30711,18,20,2,109.50271,18.25347,1510
948,8834,BC4D9B63CA4001C365CE5CB9219EAEA2,30051,22,23,1,109.48917,18.21215,1453
949,8835,EBB8C4DC19F3856E93F775E3331F31B3,30081,14,17,3,109.50243,18.26632,1512
950,8836,EBB8C4DC19F3856E93F775E3331F31B3,38291,18,19,1,109.51618,18.24313,1558
951,8837,EBB8C4DC19F3856E93F775E3331F31B3,31171,19,21,2,109.50938,18.24917,1559
952,8838,EBB8C4DC19F3856E93F775E3331F31B3,60331,21,22,1,109.505,18.26507,1512
953,8839,B1CA398CBCC08726B10214389CB30840,48574,17,20,3,109.48931,18.28458,1465
954,8840,B1CA398CBCC08726B10214389CB30840,60501,21,22,1,109.48701,18.29021,1466
955,8849,30CE72A519D49881F23B8123486E3A02,30661,2,7,5,109.37028,18.24361,1008
956,8850,30CE72A519D49881F23B8123486E3A02,60411,7,8,1,109.32514,18.30854,869
957,8851,30CE72A519D49881F23B8123486E3A02,31471,11,12,1,109.34583,18.29563,917
958,8852,30CE72A519D49881F23B8123486E3A02,60411,12,13,1,109.32514,18.30854,869
959,8898,DF46068B3DCC89EB9FA3327E53A99A8C,39101,0,1,1,109.50132,18.24931,1509
960,8899,DF46068B3DCC89EB9FA3327E53A99A8C,30161,1,6,5,109.50042,18.24389,1508
961,8900,DF46068B3DCC89EB9FA3327E53A99A8C,31031,6,8,2,109.49979,18.25382,1510
962,8901,DF46068B3DCC89EB9FA3327E53A99A8C,30361,9,10,1,109.50347,18.24,1508
963,8902,DF46068B3DCC89EB9FA3327E53A99A8C,30361,12,13,1,109.50347,18.24,1508
964,8903,DF46068B3DCC89EB9FA3327E53A99A8C,31851,17,23,6,109.71736,18.29007,2316
968,8951,2E6ECF3A2D9F0F99E9DEBA2062D89A0D,31071,14,18,4,109.58257,18.28458,1815
969,8952,2E6ECF3A2D9F0F99E9DEBA2062D89A0D,39183,20,21,1,109.55542,18.28208,1715
970,8999,AEA7DA64082D7A925B68DE7CFFD60270,30854,0,7,7,109.56889,18.27076,1763
971,9000,AEA7DA64082D7A925B68DE7CFFD60270,38085,10,21,11,109.6291,18.23625,2007
972,9017,0E0F371A7D8562A765810CFB477294DF,30951,0,5,5,109.56208,18.25667,1761
973,9018,0E0F371A7D8562A765810CFB477294DF,30851,7,8,1,109.5616,18.27396,1713
974,9019,0E0F371A7D8562A765810CFB477294DF,30951,10,11,1,109.56208,18.25667,1761
975,9020,0E0F371A7D8562A765810CFB477294DF,30851,13,15,2,109.5616,18.27396,1713
976,9021,0E0F371A7D8562A765810CFB477294DF,30861,18,20,2,109.52722,18.22743,1606
977,9022,FC9B7FD2465F862BBF1D529A5948B21C,60161,0,7,7,109.49174,18.26181,1461
978,9023,FC9B7FD2465F862BBF1D529A5948B21C,38291,8,9,1,109.51618,18.24313,1558
979,9033,E4C7AB656E412C7E33554D18277C9478,30711,20,21,1,109.50271,18.25347,1510
980,9034,E4C7AB656E412C7E33554D18277C9478,60291,22,23,1,109.50826,18.24639,1509
984,9104,0ECAA77148BC3CC3B9A4A65F40F94BCA,30711,12,18,6,109.50271,18.25347,1510
985,9137,1B6EBBFF3B9D8A3E18753343B6A29EAE,31071,0,8,8,109.58257,18.28458,1815
986,9138,1B6EBBFF3B9D8A3E18753343B6A29EAE,31561,9,10,1,109.56792,18.28479,1765
987,9139,1B6EBBFF3B9D8A3E18753343B6A29EAE,30851,10,11,1,109.5616,18.27396,1713
988,9140,1B6EBBFF3B9D8A3E18753343B6A29EAE,31071,11,14,3,109.58257,18.28458,1815
989,9141,1B6EBBFF3B9D8A3E18753343B6A29EAE,30851,15,17,2,109.5616,18.27396,1713
990,9142,1B6EBBFF3B9D8A3E18753343B6A29EAE,31071,19,23,4,109.58257,18.28458,1815
991,9171,519F735EBD513C9F3D65CD2441510E18,31421,18,20,2,109.55382,18.22347,1705
992,9172,519F735EBD513C9F3D65CD2441510E18,30181,20,22,2,109.51597,18.23313,1557
993,9194,4D4289AE0DFBF4B5C79A47559DC2EBDD,30854,3,17,14,109.56889,18.27076,1763
994,9195,4D4289AE0DFBF4B5C79A47559DC2EBDD,60381,21,22,1,109.5241,18.22458,1605
995,9209,68DBE0B52FD0AB95F1DD47068FD7847F,39111,0,5,5,109.5191,18.22597,1555
996,9210,68DBE0B52FD0AB95F1DD47068FD7847F,31521,7,9,2,109.51458,18.22542,1555
997,9211,68DBE0B52FD0AB95F1DD47068FD7847F,38291,10,12,2,109.51618,18.24313,1558
998,9212,68DBE0B52FD0AB95F1DD47068FD7847F,31521,13,14,1,109.51458,18.22542,1555
999,9213,68DBE0B52FD0AB95F1DD47068FD7847F,60311,17,23,6,109.52097,18.24319,1558
1004,9248,29064106BAD1EF15D718EE782B958C59,31071,0,6,6,109.58257,18.28458,1815
1005,9249,29064106BAD1EF15D718EE782B958C59,30854,11,20,9,109.56889,18.27076,1763
1006,9331,6AE576B33B9BEDB98E30FC866EE1D31C,30421,18,20,2,109.50021,18.25861,1511
1007,9332,6AE576B33B9BEDB98E30FC866EE1D31C,31861,20,22,2,109.49042,18.27549,1464
1008,9346,066CC6CBB5ADF978A93AF5D0C3292806,30071,0,5,5,109.52819,18.30472,1619
1009,9347,066CC6CBB5ADF978A93AF5D0C3292806,31931,6,7,1,109.54771,18.29403,1667
1010,9348,066CC6CBB5ADF978A93AF5D0C3292806,60211,8,9,1,109.63549,18.26049,2011
1011,9349,066CC6CBB5ADF978A93AF5D0C3292806,31931,12,14,2,109.54771,18.29403,1667
1012,9374,CDB953050813C58D32D89D5658BB96B4,30071,19,20,1,109.52819,18.30472,1619
1013,9375,CDB953050813C58D32D89D5658BB96B4,30071,21,23,2,109.52819,18.30472,1619
1017,9428,B175A0347ABEEA30E818C5CCD25E280F,30821,12,17,5,109.43681,18.33639,1274
1018,9429,B175A0347ABEEA30E818C5CCD25E280F,60011,20,22,2,109.48965,18.30222,1468
1019,9450,46D10B971C10D2856504DC61068F66E7,30071,0,8,8,109.52819,18.30472,1619
1020,9451,46D10B971C10D2856504DC61068F66E7,31091,9,11,2,109.41201,18.31222,1170
1021,9452,46D10B971C10D2856504DC61068F66E7,30071,13,15,2,109.52819,18.30472,1619
1022,9480,90D91A493F9482486DCC3B27CF3F61EE,30854,6,8,2,109.56889,18.27076,1763
1023,9481,90D91A493F9482486DCC3B27CF3F61EE,31071,8,9,1,109.58257,18.28458,1815
1024,9482,90D91A493F9482486DCC3B27CF3F61EE,30854,13,14,1,109.56889,18.27076,1763
1025,9493,EA4EEEA6F324C3F08DBAE63BA2B33BB6,60131,14,16,2,109.49819,18.24778,1509
1026,9494,EA4EEEA6F324C3F08DBAE63BA2B33BB6,30084,18,22,4,109.50118,18.26972,1513
1027,9522,299AC9422F298CCC4ED16594B565B2CA,30711,15,16,1,109.50271,18.25347,1510
1028,9542,BD5D5103B08534F20AF53FB58E9A43CA,38241,2,8,6,109.54111,18.30542,1669
1029,9543,BD5D5103B08534F20AF53FB58E9A43CA,31931,9,10,1,109.54771,18.29403,1667
1030,9544,BD5D5103B08534F20AF53FB58E9A43CA,38171,14,16,2,109.50799,18.28139,1515
1031,9545,BD5D5103B08534F20AF53FB58E9A43CA,30281,16,18,2,109.50597,18.27583,1514
1032,9546,BD5D5103B08534F20AF53FB58E9A43CA,31931,21,23,2,109.54771,18.29403,1667
1033,9630,5A4EB554D34C333CED1A7004ABAA2EDE,60401,18,19,1,109.47444,18.27583,1414
1034,9631,5A4EB554D34C333CED1A7004ABAA2EDE,38903,21,23,2,109.39229,18.29243,1117
1035,9681,4A6E6277F47F7550E2618B9C1ADC3166,30361,14,15,1,109.50347,18.24,1508
1036,9682,4A6E6277F47F7550E2618B9C1ADC3166,30361,19,23,4,109.50347,18.24,1508
1037,9732,D4EE8E1A4C04A1FF0596E4221D0B8B42,31071,1,8,7,109.58257,18.28458,1815
1038,9733,D4EE8E1A4C04A1FF0596E4221D0B8B42,30854,8,18,10,109.56889,18.27076,1763
1039,9734,D4EE8E1A4C04A1FF0596E4221D0B8B42,31421,19,21,2,109.55382,18.22347,1705
1043,9764,5A888DC7A3AA300CC584D9862C5384A1,60361,0,2,2,109.51938,18.29681,1567
1044,9765,5A888DC7A3AA300CC584D9862C5384A1,60221,2,4,2,109.52569,18.29188,1616
1045,9766,5A888DC7A3AA300CC584D9862C5384A1,60361,6,7,1,109.51938,18.29681,1567
1046,9767,5A888DC7A3AA300CC584D9862C5384A1,39181,9,10,1,109.55153,18.28035,1715
1047,9768,5A888DC7A3AA300CC584D9862C5384A1,39183,12,14,2,109.55542,18.28208,1715
1048,9769,5A888DC7A3AA300CC584D9862C5384A1,38127,18,20,2,109.50833,18.27222,1513
1049,9770,5A888DC7A3AA300CC584D9862C5384A1,30421,21,23,2,109.50021,18.25861,1511
1053,9863,1EB913BACF9C05B44A304AC858725E50,31864,0,9,9,109.49014,18.28333,1465
1054,9864,1EB913BACF9C05B44A304AC858725E50,30421,12,13,1,109.50021,18.25861,1511
1055,9865,1EB913BACF9C05B44A304AC858725E50,31206,14,15,1,109.50819,18.23549,1507
1056,9866,1EB913BACF9C05B44A304AC858725E50,30151,17,19,2,109.50986,18.25083,1560
1057,9867,1EB913BACF9C05B44A304AC858725E50,31864,21,23,2,109.49014,18.28333,1465
1058,9903,5334281F127888E8146BE3F4F35A8EA8,30351,0,11,11,109.41701,18.29292,1217
1059,9994,8E244E94833DBF281BCBFE2F4A36E102,60641,0,8,8,109.53854,18.2359,1657
1060,9995,8E244E94833DBF281BCBFE2F4A36E102,31671,9,10,1,109.38965,18.29813,1068
1061,9996,8E244E94833DBF281BCBFE2F4A36E102,60641,11,23,12,109.53854,18.2359,1657
1062,10007,17D13F6A66037B54FAB5668CDC734401,60311,11,16,5,109.52097,18.24319,1558
1063,10038,2C222853895C7F3CD32A59ECC6E42FBB,30251,15,21,6,109.50611,18.26653,1512
1064,10039,2C222853895C7F3CD32A59ECC6E42FBB,31864,21,23,2,109.49014,18.28333,1465
1068,10066,3A145BF69DF902E1EF820C356086EF54,60381,0,7,7,109.5241,18.22458,1605
1069,10067,3A145BF69DF902E1EF820C356086EF54,38071,8,9,1,109.40722,18.30938,1169
1070,10068,3A145BF69DF902E1EF820C356086EF54,60631,10,13,3,109.57778,18.27583,1814
1071,10069,3A145BF69DF902E1EF820C356086EF54,30854,13,15,2,109.56889,18.27076,1763
1072,10070,8F82FA1F1481A587FFA3C3105705BF6F,60631,0,7,7,109.57778,18.27583,1814
1073,10071,8F82FA1F1481A587FFA3C3105705BF6F,30854,9,10,1,109.56889,18.27076,1763
1078,10093,EE20B3A69AE234B0D2D16E1DB1ACB48E,30111,0,9,9,109.47583,18.30542,1419
1079,10094,EE20B3A69AE234B0D2D16E1DB1ACB48E,31471,10,13,3,109.34583,18.29563,917
1080,10095,EE20B3A69AE234B0D2D16E1DB1ACB48E,31781,15,16,1,109.19847,18.2975,367
1081,10096,EE20B3A69AE234B0D2D16E1DB1ACB48E,60641,19,20,1,109.53854,18.2359,1657
1082,10148,9F491EEC0F2450C8C4B42D79DC4B8D6F,60381,14,15,1,109.5241,18.22458,1605
1083,10149,9F491EEC0F2450C8C4B42D79DC4B8D6F,31521,18,22,4,109.51458,18.22542,1555
1084,10188,8621CFDF1B89A83351494618C53D033F,30851,1,6,5,109.5616,18.27396,1713
1085,10189,8621CFDF1B89A83351494618C53D033F,31071,6,7,1,109.58257,18.28458,1815
1086,10190,8621CFDF1B89A83351494618C53D033F,39181,8,15,7,109.55153,18.28035,1715
1087,10191,8621CFDF1B89A83351494618C53D033F,31071,15,16,1,109.58257,18.28458,1815
1088,10192,8621CFDF1B89A83351494618C53D033F,39181,18,21,3,109.55153,18.28035,1715
1089,10194,CCAE44B3710517001962C25A64C7F320,30161,7,8,1,109.50042,18.24389,1508
1090,10284,4D190727D19452A2A511EC780EEEE090,30921,1,8,7,109.53903,18.29451,1667
1091,10285,4D190727D19452A2A511EC780EEEE090,31931,10,22,12,109.54771,18.29403,1667
1092,10295,2CCD2660E589B7FF2F231B9957C903F7,31571,0,10,10,109.61563,18.23326,1957
1093,10313,8B3125BACE32612AE7F9DC5599DC75E6,60081,0,7,7,109.51097,18.22639,1556
1094,10314,8B3125BACE32612AE7F9DC5599DC75E6,60054,9,10,1,109.3016,18.31229,770
1095,10315,8B3125BACE32612AE7F9DC5599DC75E6,30661,15,17,2,109.37028,18.24361,1008
1096,10316,8B3125BACE32612AE7F9DC5599DC75E6,30731,20,23,3,109.50944,18.22306,1555
1100,10400,74A9CCA48CD6C2DA9FC7DFDB8817D50B,31945,0,3,3,109.58021,18.29403,1817
1101,10401,74A9CCA48CD6C2DA9FC7DFDB8817D50B,31071,3,6,3,109.58257,18.28458,1815
1102,10476,CD3BCBAB8571FB81953C842A434E5DB8,30771,0,4,4,109.49938,18.26042,1511
1103,10477,CD3BCBAB8571FB81953C842A434E5DB8,30854,7,12,5,109.56889,18.27076,1763
1107,10550,632A9EB46E40EB8DE8C99AAD5A0CDFB2,31181,0,2,2,109.50382,18.24813,1509
1108,10551,632A9EB46E40EB8DE8C99AAD5A0CDFB2,30711,2,13,11,109.50271,18.25347,1510
1109,10569,1D22B80919ED7BC636AC7BE0DCB27647,31021,0,7,7,109.49021,18.27,1463
1110,10570,1D22B80919ED7BC636AC7BE0DCB27647,60411,11,12,1,109.32514,18.30854,869
1111,10571,1D22B80919ED7BC636AC7BE0DCB27647,31471,17,19,2,109.34583,18.29563,917
1112,10572,1D22B80919ED7BC636AC7BE0DCB27647,30661,20,21,1,109.37028,18.24361,1008
1113,10601,706B8E0F0F5D1C9FC2F8EBB2574EE89F,31461,0,3,3,109.5091,18.25389,1510
1114,10602,706B8E0F0F5D1C9FC2F8EBB2574EE89F,30711,3,5,2,109.50271,18.25347,1510
1115,10603,706B8E0F0F5D1C9FC2F8EBB2574EE89F,31461,5,8,3,109.5091,18.25389,1510
1116,10604,706B8E0F0F5D1C9FC2F8EBB2574EE89F,30711,8,11,3,109.50271,18.25347,1510
1117,10605,706B8E0F0F5D1C9FC2F8EBB2574EE89F,38297,11,13,2,109.52576,18.24965,1609
1118,10606,706B8E0F0F5D1C9FC2F8EBB2574EE89F,30711,14,23,9,109.50271,18.25347,1510
1119,10617,EBD16061EA20EE33D9344D33735E5205,38891,0,7,7,109.51486,18.24118,1558
1120,10618,EBD16061EA20EE33D9344D33735E5205,38291,7,19,12,109.51618,18.24313,1558
1121,10619,EBD16061EA20EE33D9344D33735E5205,60371,19,22,3,109.53063,18.30056,1618
1122,10631,34A1BA5A97F90C4ABB34EDC7004774A9,30851,7,12,5,109.5616,18.27396,1713
1123,10632,34A1BA5A97F90C4ABB34EDC7004774A9,31071,13,15,2,109.58257,18.28458,1815
1124,10633,34A1BA5A97F90C4ABB34EDC7004774A9,30851,20,23,3,109.5616,18.27396,1713
1128,10637,3C6B416FA80A7A03E14FC0317D60CB00,31071,2,7,5,109.58257,18.28458,1815
1129,10638,3C6B416FA80A7A03E14FC0317D60CB00,30854,10,23,13,109.56889,18.27076,1763
1130,10689,5264833F0013AE6B294396000613EF89,60201,0,9,9,109.5041,18.2509,1510
1131,10690,5264833F0013AE6B294396000613EF89,30901,12,13,1,109.27597,18.3134,670
1132,10691,5264833F0013AE6B294396000613EF89,60581,14,16,2,109.59785,18.29931,1868
1133,10702,2122DEFC32157A6D7A592FF94F389FA0,30391,0,7,7,109.4975,18.27118,1513
1134,10703,2122DEFC32157A6D7A592FF94F389FA0,31021,8,9,1,109.49021,18.27,1463
1135,10704,2122DEFC32157A6D7A592FF94F389FA0,30391,13,14,1,109.4975,18.27118,1513
1136,10705,2122DEFC32157A6D7A592FF94F389FA0,31351,18,19,1,109.4959,18.28417,1465
1137,10706,2122DEFC32157A6D7A592FF94F389FA0,30391,20,23,3,109.4975,18.27118,1513
1138,10714,ADAB51A6D99BADC8222FC392D72ADA01,60281,0,19,19,109.51743,18.25924,1561
1139,10715,ADAB51A6D99BADC8222FC392D72ADA01,31261,21,23,2,109.51174,18.2466,1559
1143,10733,0547C7536E43628EF24935F0C2BF5E2C,31931,7,10,3,109.54771,18.29403,1667
1144,10734,0547C7536E43628EF24935F0C2BF5E2C,30921,11,20,9,109.53903,18.29451,1667
1145,10745,ACDEAAF45B65DE48CF80A48DBD3C775E,31071,1,5,4,109.58257,18.28458,1815
1146,10746,ACDEAAF45B65DE48CF80A48DBD3C775E,30854,7,22,15,109.56889,18.27076,1763
1147,10794,DB4DF566D4757FF3BB488F82DE126248,30851,9,10,1,109.5616,18.27396,1713
1148,10795,DB4DF566D4757FF3BB488F82DE126248,31561,13,15,2,109.56792,18.28479,1765
1149,10796,DB4DF566D4757FF3BB488F82DE126248,60351,19,23,4,109.58403,18.28958,1816
1150,10800,A4132C7C24D4F6CFBC6C091695995585,30631,0,7,7,109.34382,18.32778,922
1151,10801,A4132C7C24D4F6CFBC6C091695995585,30341,8,9,1,109.3625,18.29167,966
1152,10802,A4132C7C24D4F6CFBC6C091695995585,30631,11,14,3,109.34382,18.32778,922
1153,10803,A4132C7C24D4F6CFBC6C091695995585,31691,14,17,3,109.36604,18.3075,1019
1154,10804,A4132C7C24D4F6CFBC6C091695995585,30631,19,23,4,109.34382,18.32778,922
1155,10816,61737F015E2BA5FF98146651AD724408,30341,9,11,2,109.3625,18.29167,966
1156,10817,61737F015E2BA5FF98146651AD724408,30661,11,15,4,109.37028,18.24361,1008
1157,10818,61737F015E2BA5FF98146651AD724408,31271,18,20,2,109.48958,18.26257,1462
1158,10828,CB44FE843228066922623C4A2B161A4C,60504,1,9,8,109.47917,18.28903,1416
1159,10829,CB44FE843228066922623C4A2B161A4C,30081,13,15,2,109.50243,18.26632,1512
1160,10837,0312B43ACF9ED1D8304E325E851AEE29,39181,9,11,2,109.55153,18.28035,1715
1161,10838,0312B43ACF9ED1D8304E325E851AEE29,30851,12,14,2,109.5616,18.27396,1713
1162,10839,0312B43ACF9ED1D8304E325E851AEE29,31561,15,16,1,109.56792,18.28479,1765
1163,10840,0312B43ACF9ED1D8304E325E851AEE29,30851,17,23,6,109.5616,18.27396,1713
1164,10862,4BA143AD44480D9BEACA2836C34FF531,60401,4,5,1,109.47444,18.27583,1414
1165,10863,4BA143AD44480D9BEACA2836C34FF531,60231,7,11,4,109.49903,18.21972,1504
1166,10886,33F9415FD6B58B5A945236B41FCD67FA,60381,0,13,13,109.5241,18.22458,1605
1167,10887,33F9415FD6B58B5A945236B41FCD67FA,31521,14,23,9,109.51458,18.22542,1555
1168,10903,1A1509AC6E667B603EE3773D1273B7B0,38541,15,19,4,109.73715,18.34875,2426
1169,10904,1A1509AC6E667B603EE3773D1273B7B0,60121,19,20,1,109.74507,18.37472,2430
1170,10950,C8135D3E403B7CC96352A41CBCD291A7,38241,1,15,14,109.54111,18.30542,1669
1171,10951,C8135D3E403B7CC96352A41CBCD291A7,31861,18,20,2,109.49042,18.27549,1464
1172,10983,9BB6AFF9C9C200381B5723FC341A4F0D,60121,19,21,2,109.74507,18.37472,2430
1173,10996,41D4EB5552A7A416EEB26FAA30F55A4B,39183,0,7,7,109.55542,18.28208,1715
1174,10997,41D4EB5552A7A416EEB26FAA30F55A4B,31931,8,9,1,109.54771,18.29403,1667
1175,10998,41D4EB5552A7A416EEB26FAA30F55A4B,39183,9,14,5,109.55542,18.28208,1715
1176,10999,41D4EB5552A7A416EEB26FAA30F55A4B,39181,16,17,1,109.55153,18.28035,1715
1177,11000,41D4EB5552A7A416EEB26FAA30F55A4B,39183,17,23,6,109.55542,18.28208,1715
1181,11074,A992D60126719EF3134D37993767E1EF,30611,0,2,2,109.74958,18.40188,2485
1188,11119,DE5024DB59D5BF6AE5857A85EB7680EA,30854,16,17,1,109.56889,18.27076,1763
1189,11120,DE5024DB59D5BF6AE5857A85EB7680EA,60381,20,21,1,109.5241,18.22458,1605
1190,11251,E292D83051830D054E89D209EEABA4B9,31561,18,20,2,109.56792,18.28479,1765
1191,11252,E292D83051830D054E89D209EEABA4B9,39183,21,22,1,109.55542,18.28208,1715
1196,11295,8376D19E65EF2C30F16F6D8DCBD4B812,38261,0,7,7,109.50361,18.28153,1515
1197,11296,8376D19E65EF2C30F16F6D8DCBD4B812,30281,8,11,3,109.50597,18.27583,1514
1198,11389,CA9DF84C64B1C31A61B42BDFD659A4B0,31071,17,18,1,109.58257,18.28458,1815
1199,11390,CA9DF84C64B1C31A61B42BDFD659A4B0,30854,20,21,1,109.56889,18.27076,1763
1200,11455,3977578BE56276DA0700B04B81DC1356,31071,12,14,2,109.58257,18.28458,1815
1201,11456,3977578BE56276DA0700B04B81DC1356,31561,18,21,3,109.56792,18.28479,1765
1202,11502,2027AA9558BB48F6DAA6F83AE664254B,31071,1,7,6,109.58257,18.28458,1815
1203,11503,2027AA9558BB48F6DAA6F83AE664254B,30854,7,8,1,109.56889,18.27076,1763
1204,11513,0133DDFFB5CECBB261CEDEF10A82D50B,31561,0,10,10,109.56792,18.28479,1765
1205,11514,0133DDFFB5CECBB261CEDEF10A82D50B,30441,12,13,1,109.64021,18.25424,2010
1206,11515,0133DDFFB5CECBB261CEDEF10A82D50B,31561,16,17,1,109.56792,18.28479,1765
1207,11516,0133DDFFB5CECBB261CEDEF10A82D50B,30854,21,22,1,109.56889,18.27076,1763
1211,11574,0E129C09250C0D46273B4BD7E5225556,30151,0,6,6,109.50986,18.25083,1560
1212,11575,0E129C09250C0D46273B4BD7E5225556,60201,6,9,3,109.5041,18.2509,1510
1213,11576,0E129C09250C0D46273B4BD7E5225556,60441,9,11,2,109.46792,18.28604,1366
1214,11577,0E129C09250C0D46273B4BD7E5225556,31851,12,18,6,109.71736,18.29007,2316
1215,11578,0E129C09250C0D46273B4BD7E5225556,60281,20,21,1,109.51743,18.25924,1561
1216,11579,0E129C09250C0D46273B4BD7E5225556,30151,21,23,2,109.50986,18.25083,1560
1224,11667,173CD7A2B7B334BC53A50A1D248FBCFE,31071,3,7,4,109.58257,18.28458,1815
1225,11668,173CD7A2B7B334BC53A50A1D248FBCFE,30854,7,20,13,109.56889,18.27076,1763
1226,11697,8883DF5E66B5FC284A8EF97DE8EAAAB3,30581,14,15,1,109.62257,18.24951,1959
1227,11698,8883DF5E66B5FC284A8EF97DE8EAAAB3,30854,17,19,2,109.56889,18.27076,1763
1228,11699,8883DF5E66B5FC284A8EF97DE8EAAAB3,60631,19,21,2,109.57778,18.27583,1814
1229,11703,E90F25B3D4E3C87347B14227D807559F,31101,0,8,8,109.65389,18.23403,2057
1230,11704,E90F25B3D4E3C87347B14227D807559F,60631,12,23,11,109.57778,18.27583,1814
1231,11705,93715618B304E009FF2F157425BB5843,30421,17,21,4,109.50021,18.25861,1511
1232,11706,93715618B304E009FF2F157425BB5843,60504,21,23,2,109.47917,18.28903,1416
1233,11720,0E00D7E0174B24239144B08D52B998E8,31931,0,10,10,109.54771,18.29403,1667
1234,11721,0E00D7E0174B24239144B08D52B998E8,31124,14,17,3,109.17069,18.35,276
1235,11733,0E5593A90D661690BE3DAAA17AD936E2,38127,0,7,7,109.50833,18.27222,1513
1236,11734,0E5593A90D661690BE3DAAA17AD936E2,31761,8,9,1,109.60521,18.27965,1914
1237,11735,0E5593A90D661690BE3DAAA17AD936E2,38073,11,14,3,109.40813,18.30958,1169
1238,11736,0E5593A90D661690BE3DAAA17AD936E2,38127,16,18,2,109.50833,18.27222,1513
1239,11737,0E5593A90D661690BE3DAAA17AD936E2,30504,22,23,1,109.705,18.35368,2277
1240,11744,DDE77D3A656666992FC3458B84010D43,30854,2,4,2,109.56889,18.27076,1763
1241,11745,DDE77D3A656666992FC3458B84010D43,39183,4,10,6,109.55542,18.28208,1715
1242,11749,07FD145FE6C81328C98C6C5C8452E794,30232,0,3,3,109.6191,18.31701,1971
1243,11750,07FD145FE6C81328C98C6C5C8452E794,30854,3,6,3,109.56889,18.27076,1763
1244,11751,07FD145FE6C81328C98C6C5C8452E794,30232,6,11,5,109.6191,18.31701,1971
1245,11752,07FD145FE6C81328C98C6C5C8452E794,30854,12,22,10,109.56889,18.27076,1763
1246,11760,9F62B931A9E30D8BD766712CF9C5E867,31021,15,16,1,109.49021,18.27,1463
1247,11789,807F73DE76DFE56E472FA61396F0887C,60371,18,19,1,109.53063,18.30056,1618
1251,11817,CD2724D853B922EC14C4E5BF560D0D4F,39063,1,5,4,109.386,18.2919,1066
1252,11818,CD2724D853B922EC14C4E5BF560D0D4F,31345,5,7,2,109.39,18.29,1066
1253,11819,CD2724D853B922EC14C4E5BF560D0D4F,31031,8,9,1,109.49979,18.25382,1510
1254,11820,CD2724D853B922EC14C4E5BF560D0D4F,31345,9,13,4,109.39,18.29,1066
1255,11821,CD2724D853B922EC14C4E5BF560D0D4F,60561,19,20,1,109.38229,18.29785,1067
1256,11822,CD2724D853B922EC14C4E5BF560D0D4F,31345,21,23,2,109.39,18.29,1066
1257,11833,283001ED673D8EDBEF7EEB00BDB31533,60201,13,16,3,109.5041,18.2509,1510
1258,11834,283001ED673D8EDBEF7EEB00BDB31533,31181,16,18,2,109.50382,18.24813,1509
1259,11858,2D819E49BADBA83BD227E1A0B23BE3D8,30421,0,6,6,109.50021,18.25861,1511
1260,11859,2D819E49BADBA83BD227E1A0B23BE3D8,31461,6,8,2,109.5091,18.25389,1510
1261,11861,2D819E49BADBA83BD227E1A0B23BE3D8,31471,13,14,1,109.34583,18.29563,917
1262,11862,2D819E49BADBA83BD227E1A0B23BE3D8,60641,19,23,4,109.53854,18.2359,1657
1263,11864,02F7708F1CFAC98CD0B107132A271A25,48574,15,21,6,109.48931,18.28458,1465
1264,11869,B5D5F035B558647FF9F44A76F16A1183,31206,0,9,9,109.50819,18.23549,1507
1265,11870,B5D5F035B558647FF9F44A76F16A1183,60344,14,15,1,109.68847,18.31931,2221
1266,11871,B5D5F035B558647FF9F44A76F16A1183,31271,19,21,2,109.48958,18.26257,1462
1267,11971,D39D64452E6BBEF7B3056CA239E1B86E,30854,0,7,7,109.56889,18.27076,1763
1268,11972,D39D64452E6BBEF7B3056CA239E1B86E,31561,8,10,2,109.56792,18.28479,1765
1269,11973,D39D64452E6BBEF7B3056CA239E1B86E,30854,11,14,3,109.56889,18.27076,1763
1270,11974,D39D64452E6BBEF7B3056CA239E1B86E,31561,14,19,5,109.56792,18.28479,1765
1271,11975,D39D64452E6BBEF7B3056CA239E1B86E,30854,19,21,2,109.56889,18.27076,1763
1272,11976,D39D64452E6BBEF7B3056CA239E1B86E,30851,21,23,2,109.5616,18.27396,1713
1273,12034,E92C4377A82D1512C2FDA9EFCDAFE67D,30351,0,6,6,109.41701,18.29292,1217
1274,12035,E92C4377A82D1512C2FDA9EFCDAFE67D,30354,7,8,1,109.42813,18.29076,1216
1275,12036,E92C4377A82D1512C2FDA9EFCDAFE67D,31781,12,14,2,109.19847,18.2975,367
1276,12037,E92C4377A82D1512C2FDA9EFCDAFE67D,30821,19,21,2,109.43681,18.33639,1274
1284,12066,003C6689B311B427695E6FEF3BF3C281,31221,19,21,2,109.61333,18.26833,1913
1285,12067,003C6689B311B427695E6FEF3BF3C281,38331,22,23,1,109.62465,18.22736,1956
1289,12107,CD576F1C1CDFB89E6A99A20E65927346,31561,1,2,1,109.56792,18.28479,1765
1290,12108,CD576F1C1CDFB89E6A99A20E65927346,30854,7,22,15,109.56889,18.27076,1763
1291,12123,EFBA9F65D905E3E75BCCC831CAFA27CF,60084,0,7,7,109.4984,18.2334,1507
1292,12124,EFBA9F65D905E3E75BCCC831CAFA27CF,60552,9,10,1,109.41729,18.30014,1218
1293,12141,412879740E648AE1B2C1A60DD3B08C37,30111,0,7,7,109.47583,18.30542,1419
1294,12143,412879740E648AE1B2C1A60DD3B08C37,30711,18,19,1,109.50271,18.25347,1510
1295,12144,412879740E648AE1B2C1A60DD3B08C37,31391,19,20,1,109.50382,18.24285,1508
1302,12255,E32F04C32D00AF60E04FA89AD4525A3E,39111,0,8,8,109.5191,18.22597,1555
1303,12256,E32F04C32D00AF60E04FA89AD4525A3E,31521,8,10,2,109.51458,18.22542,1555
1304,12257,E32F04C32D00AF60E04FA89AD4525A3E,31781,12,13,1,109.19847,18.2975,367
1305,12270,D1238E1360D3AC93342B86056AD44C9C,39154,2,6,4,109.50201,18.25681,1511
1306,12271,D1238E1360D3AC93342B86056AD44C9C,30711,7,9,2,109.50271,18.25347,1510
1307,12272,D1238E1360D3AC93342B86056AD44C9C,31781,10,14,4,109.19847,18.2975,367
1308,12273,D1238E1360D3AC93342B86056AD44C9C,30201,19,20,1,109.4909,18.26465,1462
1309,12281,33D0BAF81064BA9871C044941C4D0C71,30361,15,18,3,109.50347,18.24,1508
1310,12282,33D0BAF81064BA9871C044941C4D0C71,38251,20,21,1,109.49618,18.25493,1510
1311,12313,B26DD5C650BE7CEA4DB62E608BAE05C3,30931,1,10,9,109.55653,18.32722,1722
1312,12314,B26DD5C650BE7CEA4DB62E608BAE05C3,31031,14,15,1,109.49979,18.25382,1510
1313,12315,B26DD5C650BE7CEA4DB62E608BAE05C3,30931,17,23,6,109.55653,18.32722,1722
1314,12362,F47C4E1E39056C43B0AD32AC994AB7C0,60361,14,16,2,109.51938,18.29681,1567
1315,12363,F47C4E1E39056C43B0AD32AC994AB7C0,31931,17,22,5,109.54771,18.29403,1667
1316,12414,3738BCD5F22BB841A8E524306ADFE0A0,38171,1,8,7,109.50799,18.28139,1515
1317,12415,3738BCD5F22BB841A8E524306ADFE0A0,38751,9,10,1,109.74903,18.37639,2481
1318,12416,3738BCD5F22BB841A8E524306ADFE0A0,60231,12,23,11,109.49903,18.21972,1504
1325,12515,A928E9F6C796FE1A60807BA003DE87BB,39183,14,16,2,109.55542,18.28208,1715
1326,12516,A928E9F6C796FE1A60807BA003DE87BB,30854,17,20,3,109.56889,18.27076,1763
1327,12564,42158B50A96F4BB50162AD5AAF8D7E2D,38911,0,1,1,109.51674,18.24965,1559
1328,12565,42158B50A96F4BB50162AD5AAF8D7E2D,38891,2,5,3,109.51486,18.24118,1558
1329,12566,42158B50A96F4BB50162AD5AAF8D7E2D,31201,5,11,6,109.51042,18.23819,1558
1330,12567,42158B50A96F4BB50162AD5AAF8D7E2D,30211,15,17,2,109.49882,18.23931,1508
1331,12568,42158B50A96F4BB50162AD5AAF8D7E2D,30324,19,20,1,109.50326,18.29257,1517
1332,12569,42158B50A96F4BB50162AD5AAF8D7E2D,31201,21,23,2,109.51042,18.23819,1558
1336,12643,86435198F57620D5DAC23B4A4DA78009,39183,17,20,3,109.55542,18.28208,1715
1337,12673,608A55C14BAB2A5B627ACC1F39B89FB6,31945,0,5,5,109.58021,18.29403,1817
1338,12674,608A55C14BAB2A5B627ACC1F39B89FB6,31071,5,6,1,109.58257,18.28458,1815
1339,12675,608A55C14BAB2A5B627ACC1F39B89FB6,30854,9,10,1,109.56889,18.27076,1763
1340,12676,608A55C14BAB2A5B627ACC1F39B89FB6,31071,11,12,1,109.58257,18.28458,1815
1341,12677,608A55C14BAB2A5B627ACC1F39B89FB6,30854,13,18,5,109.56889,18.27076,1763
1342,12678,608A55C14BAB2A5B627ACC1F39B89FB6,31071,18,20,2,109.58257,18.28458,1815
1343,12731,E887C057B111AD6EF085C23E238E5BF5,31031,0,9,9,109.49979,18.25382,1510
1344,12732,E887C057B111AD6EF085C23E238E5BF5,33051,12,14,2,109.6475,18.46618,2096
1345,12733,E887C057B111AD6EF085C23E238E5BF5,31031,17,23,6,109.49979,18.25382,1510
1346,12840,C40018C062136AA3E05F546791CEC6AA,30854,0,5,5,109.56889,18.27076,1763
1347,12841,C40018C062136AA3E05F546791CEC6AA,31931,7,9,2,109.54771,18.29403,1667
1348,12842,C40018C062136AA3E05F546791CEC6AA,30854,11,13,2,109.56889,18.27076,1763
1349,12843,C40018C062136AA3E05F546791CEC6AA,31931,13,16,3,109.54771,18.29403,1667
1350,12844,C40018C062136AA3E05F546791CEC6AA,30854,16,23,7,109.56889,18.27076,1763
1351,12859,13166628932DF36C0AD7B1DB5811240A,60591,0,6,6,109.61118,18.21715,1904
1352,12860,13166628932DF36C0AD7B1DB5811240A,30854,8,18,10,109.56889,18.27076,1763
1353,12861,13166628932DF36C0AD7B1DB5811240A,60591,19,22,3,109.61118,18.21715,1904
1354,12878,B621E9075674E792CCB217233825F9D1,30851,2,7,5,109.5616,18.27396,1713
1355,12879,B621E9075674E792CCB217233825F9D1,60591,10,13,3,109.61118,18.21715,1904
1356,12880,B621E9075674E792CCB217233825F9D1,30854,15,16,1,109.56889,18.27076,1763
1361,12964,0F558B6653C655C7F0BAEA9D66B33F57,31071,1,7,6,109.58257,18.28458,1815
1362,12965,0F558B6653C655C7F0BAEA9D66B33F57,30854,7,17,10,109.56889,18.27076,1763
1363,12966,0F558B6653C655C7F0BAEA9D66B33F57,60381,20,21,1,109.5241,18.22458,1605
1364,13003,7421066246AAD1C230E7E2A7ADF06E9D,30721,1,4,3,109.51597,18.28257,1565
1365,13004,7421066246AAD1C230E7E2A7ADF06E9D,60631,4,7,3,109.57778,18.27583,1814
1366,13005,7421066246AAD1C230E7E2A7ADF06E9D,30854,8,10,2,109.56889,18.27076,1763
1367,13006,7421066246AAD1C230E7E2A7ADF06E9D,31071,11,12,1,109.58257,18.28458,1815
1368,13007,7421066246AAD1C230E7E2A7ADF06E9D,30854,13,17,4,109.56889,18.27076,1763
1369,13008,7421066246AAD1C230E7E2A7ADF06E9D,31071,21,23,2,109.58257,18.28458,1815
1370,13009,A4823EEC9A8E697E80697432C029B488,30391,10,13,3,109.4975,18.27118,1513
1371,13010,A4823EEC9A8E697E80697432C029B488,30771,15,16,1,109.49938,18.26042,1511
1372,13011,A4823EEC9A8E697E80697432C029B488,30391,17,19,2,109.4975,18.27118,1513
1373,13012,A4823EEC9A8E697E80697432C029B488,31561,20,22,2,109.56792,18.28479,1765
1374,13017,17CC4D48447B18FFE0C5E2D7115F70E9,60131,13,14,1,109.49819,18.24778,1509
1375,13018,17CC4D48447B18FFE0C5E2D7115F70E9,60161,15,17,2,109.49174,18.26181,1461
1376,13019,17CC4D48447B18FFE0C5E2D7115F70E9,60381,20,21,1,109.5241,18.22458,1605
1377,13034,6E580E35F1856BA2850385BDFB597BF5,60472,12,13,1,109.46625,18.29542,1367
1378,13035,6E580E35F1856BA2850385BDFB597BF5,30891,13,15,2,109.59431,18.28389,1865
1379,13036,6E580E35F1856BA2850385BDFB597BF5,30854,15,20,5,109.56889,18.27076,1763
1380,13037,6E580E35F1856BA2850385BDFB597BF5,30891,20,21,1,109.59431,18.28389,1865
1381,13050,417408FFDA93B177641D270D3A5C4B2D,60631,15,18,3,109.57778,18.27583,1814
1382,13051,417408FFDA93B177641D270D3A5C4B2D,30854,19,20,1,109.56889,18.27076,1763
1383,13052,417408FFDA93B177641D270D3A5C4B2D,31071,21,23,2,109.58257,18.28458,1815
1384,13060,B64867C82EE7534D608484389B1D83C4,30771,14,16,2,109.49938,18.26042,1511
1388,13192,D2A5F87218CF25385163A2F3C4229CB8,30851,15,17,2,109.5616,18.27396,1713
1389,13193,D2A5F87218CF25385163A2F3C4229CB8,31561,18,21,3,109.56792,18.28479,1765
1394,13221,8DD23AA43C0F7967C45F7488D66F9159,30854,12,15,3,109.56889,18.27076,1763
1395,13222,8DD23AA43C0F7967C45F7488D66F9159,31945,16,18,2,109.58021,18.29403,1817
1396,13223,8DD23AA43C0F7967C45F7488D66F9159,30854,20,21,1,109.56889,18.27076,1763
1401,13293,1BB9B63ACB6167FB07445AABC3759692,38881,0,10,10,109.51618,18.26431,1562
1402,13308,D517610C2076C41FED0ED80CB6FFB44C,60631,0,6,6,109.57778,18.27583,1814
1403,13309,D517610C2076C41FED0ED80CB6FFB44C,30851,7,23,16,109.5616,18.27396,1713
1404,13328,9BD0746EAD915C7FE62E448DC71186FA,31071,0,7,7,109.58257,18.28458,1815
1405,13329,9BD0746EAD915C7FE62E448DC71186FA,30854,8,9,1,109.56889,18.27076,1763
1406,13330,9BD0746EAD915C7FE62E448DC71186FA,30711,10,14,4,109.50271,18.25347,1510
1407,13331,9BD0746EAD915C7FE62E448DC71186FA,30854,18,21,3,109.56889,18.27076,1763
1408,13380,90B8061AE1F491815A6E5F31CEB31F04,31411,0,4,4,109.5016,18.23576,1507
1409,13381,90B8061AE1F491815A6E5F31CEB31F04,60361,4,19,15,109.51938,18.29681,1567
1410,13382,90B8061AE1F491815A6E5F31CEB31F04,31041,21,22,1,109.50278,18.23701,1507
1415,13431,7CAEC865F307698D027CF1E4BD3354EF,30271,3,4,1,109.49132,18.23153,1456
1416,13432,7CAEC865F307698D027CF1E4BD3354EF,39061,5,6,1,109.38222,18.28958,1066
1417,13433,7CAEC865F307698D027CF1E4BD3354EF,30051,6,9,3,109.48917,18.21215,1453
1418,13474,EBF906C5498076BCFA3E97DF6001B4F3,60631,13,14,1,109.57778,18.27583,1814
1419,13475,EBF906C5498076BCFA3E97DF6001B4F3,30854,15,23,8,109.56889,18.27076,1763
1420,13501,2575DC0A6ACDD25FC20DB5874F9656C2,38127,15,23,8,109.50833,18.27222,1513
1421,13519,7AD77D97FC73EB9AE75B3794F240C672,31041,0,7,7,109.50278,18.23701,1507
1422,13525,4896D3267708A1E47DCC054292145AD0,30051,20,21,1,109.48917,18.21215,1453
1423,13526,4896D3267708A1E47DCC054292145AD0,60084,22,23,1,109.4984,18.2334,1507
1424,13539,E50C3F5EAF024523809A782B7E9AE8AE,60524,0,8,8,109.42951,18.28993,1216
1425,13540,E50C3F5EAF024523809A782B7E9AE8AE,38251,11,13,2,109.49618,18.25493,1510
1426,13541,E50C3F5EAF024523809A782B7E9AE8AE,31031,15,17,2,109.49979,18.25382,1510
1427,13542,E50C3F5EAF024523809A782B7E9AE8AE,60524,18,20,2,109.42951,18.28993,1216
1428,13562,18EE47452FD5BE7C01D5DBC710576D9F,60291,15,16,1,109.50826,18.24639,1509
1429,13563,18EE47452FD5BE7C01D5DBC710576D9F,39136,19,23,4,109.20861,18.30014,418
1430,13566,75817DB682187A07461734D66E1E6492,60631,0,4,4,109.57778,18.27583,1814
1431,13567,75817DB682187A07461734D66E1E6492,30854,5,14,9,109.56889,18.27076,1763
1432,13568,75817DB682187A07461734D66E1E6492,31061,18,20,2,109.53333,18.23257,1607
1433,13569,75817DB682187A07461734D66E1E6492,60631,21,23,2,109.57778,18.27583,1814
1440,13632,F7A05B3FECD253C9C578617425D22E9D,38754,14,15,1,109.74667,18.37382,2430
1444,13657,53875E69050EC42E511A64D3211FA7B3,60631,0,6,6,109.57778,18.27583,1814
1445,13658,53875E69050EC42E511A64D3211FA7B3,30854,9,20,11,109.56889,18.27076,1763
1446,13668,4EA9CCC3AA7079FA0621BD2D5CA90A77,60401,16,19,3,109.47444,18.27583,1414
1447,13669,4EA9CCC3AA7079FA0621BD2D5CA90A77,60291,20,22,2,109.50826,18.24639,1509
1448,13670,1877AE3F054132FD529E292AD524A6EA,30854,0,12,12,109.56889,18.27076,1763
1449,13671,1877AE3F054132FD529E292AD524A6EA,60381,13,14,1,109.5241,18.22458,1605
1450,13672,1877AE3F054132FD529E292AD524A6EA,30854,16,17,1,109.56889,18.27076,1763
1451,13673,1877AE3F054132FD529E292AD524A6EA,38291,19,20,1,109.51618,18.24313,1558
1452,13691,D4EDFC03E7ED63DAAF98D926C98FC74F,31181,8,9,1,109.50382,18.24813,1509
1453,13692,D4EDFC03E7ED63DAAF98D926C98FC74F,33051,13,14,1,109.6475,18.46618,2096
1454,13693,D4EDFC03E7ED63DAAF98D926C98FC74F,30511,18,19,1,109.51069,18.24208,1558
1455,13694,D4EDFC03E7ED63DAAF98D926C98FC74F,31181,19,21,2,109.50382,18.24813,1509
1459,13732,075EA8BE53B43CC5FEFFAE0960577C3C,60671,0,3,3,109.52979,18.31757,1621
1460,13733,075EA8BE53B43CC5FEFFAE0960577C3C,38241,3,5,2,109.54111,18.30542,1669
1461,13734,075EA8BE53B43CC5FEFFAE0960577C3C,30561,6,7,1,109.52778,18.31938,1621
1462,13735,075EA8BE53B43CC5FEFFAE0960577C3C,30561,12,14,2,109.52778,18.31938,1621
1463,13736,075EA8BE53B43CC5FEFFAE0960577C3C,38157,16,17,1,109.51483,18.26958,1563
1464,13737,075EA8BE53B43CC5FEFFAE0960577C3C,60671,18,21,3,109.52979,18.31757,1621
1465,13738,ABCD0851CC1C78BCD7AF6DBDF2F5DE49,60041,0,2,2,109.39889,18.31944,1121
1466,13739,ABCD0851CC1C78BCD7AF6DBDF2F5DE49,60552,3,8,5,109.41729,18.30014,1218
1467,13740,ABCD0851CC1C78BCD7AF6DBDF2F5DE49,60401,8,10,2,109.47444,18.27583,1414
1468,13741,ABCD0851CC1C78BCD7AF6DBDF2F5DE49,60552,11,22,11,109.41729,18.30014,1218
1469,13788,E6541B4F346982101D887BAAF0315541,31931,1,7,6,109.54771,18.29403,1667
1470,13789,E6541B4F346982101D887BAAF0315541,30854,11,14,3,109.56889,18.27076,1763
1471,13800,9EB99F27F9127F01C16DB7BA7D10B6E0,30854,18,20,2,109.56889,18.27076,1763
1472,13801,9EB99F27F9127F01C16DB7BA7D10B6E0,31071,20,21,1,109.58257,18.28458,1815
1473,13831,5130F8AFB1F97479AEA6CBCEC229D9D4,39111,0,6,6,109.5191,18.22597,1555
1474,13832,5130F8AFB1F97479AEA6CBCEC229D9D4,31521,8,9,1,109.51458,18.22542,1555
1475,13833,5130F8AFB1F97479AEA6CBCEC229D9D4,30661,11,12,1,109.37028,18.24361,1008
1476,13834,5130F8AFB1F97479AEA6CBCEC229D9D4,31521,14,17,3,109.51458,18.22542,1555
1477,13835,5130F8AFB1F97479AEA6CBCEC229D9D4,31521,17,23,6,109.51458,18.22542,1555
1478,13836,B643AC77F8D8498A9694D45BA8B0F75F,60631,0,6,6,109.57778,18.27583,1814
1479,13837,B643AC77F8D8498A9694D45BA8B0F75F,31561,7,8,1,109.56792,18.28479,1765
1480,13838,B643AC77F8D8498A9694D45BA8B0F75F,60631,9,17,8,109.57778,18.27583,1814
1481,13839,B643AC77F8D8498A9694D45BA8B0F75F,31561,18,19,1,109.56792,18.28479,1765
1482,13840,B643AC77F8D8498A9694D45BA8B0F75F,30854,20,21,1,109.56889,18.27076,1763
1490,13942,5EAEAB611440D169B1CE8706AE16111E,31521,0,1,1,109.51458,18.22542,1555
1491,13943,5EAEAB611440D169B1CE8706AE16111E,30511,1,6,5,109.51069,18.24208,1558
1492,13945,27BCEF3137923B84211F08830816C810,30851,2,4,2,109.5616,18.27396,1713
1493,13946,27BCEF3137923B84211F08830816C810,31561,7,9,2,109.56792,18.28479,1765
1494,13947,27BCEF3137923B84211F08830816C810,30851,9,10,1,109.5616,18.27396,1713
1495,13948,27BCEF3137923B84211F08830816C810,30821,11,14,3,109.43681,18.33639,1274
1496,13949,27BCEF3137923B84211F08830816C810,30851,15,16,1,109.5616,18.27396,1713
1497,13950,27BCEF3137923B84211F08830816C810,31561,18,20,2,109.56792,18.28479,1765
1498,13957,5426296000364EE32711CD0E73D782C8,31561,12,17,5,109.56792,18.28479,1765
1499,13958,5426296000364EE32711CD0E73D782C8,30854,20,21,1,109.56889,18.27076,1763
1500,13968,439C404954398764464D854D76F475D8,38281,0,11,11,109.6525,18.23403,2057
1501,13970,439C404954398764464D854D76F475D8,38754,19,21,2,109.74667,18.37382,2430
1502,13998,91EC74D2B208A10BECBB101C6735C578,38484,0,1,1,109.53028,18.31528,1620
1503,13999,91EC74D2B208A10BECBB101C6735C578,31864,1,8,7,109.49014,18.28333,1465
1504,14000,91EC74D2B208A10BECBB101C6735C578,60171,10,11,1,109.51292,18.30694,1569
1505,14001,91EC74D2B208A10BECBB101C6735C578,60131,18,20,2,109.49819,18.24778,1509
1506,14002,91EC74D2B208A10BECBB101C6735C578,60281,21,22,1,109.51743,18.25924,1561
1507,14014,4995463B780282C9C030A19D9F49AEAC,31206,1,2,1,109.50819,18.23549,1507
1508,14015,4995463B780282C9C030A19D9F49AEAC,31071,3,7,4,109.58257,18.28458,1815
1509,14016,4995463B780282C9C030A19D9F49AEAC,30854,9,20,11,109.56889,18.27076,1763
1513,14064,1065A9749A8F2A571941F492CF248982,38145,3,6,3,109.378,18.2912,1066
1514,14065,1065A9749A8F2A571941F492CF248982,30341,6,8,2,109.3625,18.29167,966
1515,14066,1065A9749A8F2A571941F492CF248982,30731,10,11,1,109.50944,18.22306,1555
1516,14067,1065A9749A8F2A571941F492CF248982,38145,15,16,1,109.378,18.2912,1066
1517,14068,1065A9749A8F2A571941F492CF248982,30341,17,18,1,109.3625,18.29167,966
1518,14069,1065A9749A8F2A571941F492CF248982,60221,20,21,1,109.52569,18.29188,1616
1519,14124,B4398296165C17394538440AD55C60F2,60631,0,2,2,109.57778,18.27583,1814
1520,14125,B4398296165C17394538440AD55C60F2,31071,2,5,3,109.58257,18.28458,1815
1521,14126,B4398296165C17394538440AD55C60F2,60631,5,6,1,109.57778,18.27583,1814
1522,14127,B4398296165C17394538440AD55C60F2,60552,9,10,1,109.41729,18.30014,1218
1523,14132,996C0D9500BF90CC0E7F5A04C49A464B,30921,0,5,5,109.53903,18.29451,1667
1524,14133,996C0D9500BF90CC0E7F5A04C49A464B,31931,5,22,17,109.54771,18.29403,1667
1525,14140,B340EDEF4A878E8DF5CBEC25E465EACE,30854,6,10,4,109.56889,18.27076,1763
1526,14141,B340EDEF4A878E8DF5CBEC25E465EACE,31071,13,14,1,109.58257,18.28458,1815
1527,14142,B340EDEF4A878E8DF5CBEC25E465EACE,30854,15,17,2,109.56889,18.27076,1763
1528,14143,B340EDEF4A878E8DF5CBEC25E465EACE,31071,18,21,3,109.58257,18.28458,1815
1533,14180,DDFC31B0586E2DBCED7345CFA87818AD,30771,2,8,6,109.49938,18.26042,1511
1534,14182,DDFC31B0586E2DBCED7345CFA87818AD,30771,18,23,5,109.49938,18.26042,1511
1535,14187,B73C72A488430C5DAE1758758E9D50EF,30951,0,3,3,109.56208,18.25667,1761
1536,14188,B73C72A488430C5DAE1758758E9D50EF,30851,3,6,3,109.5616,18.27396,1713
1537,14189,B73C72A488430C5DAE1758758E9D50EF,30221,8,10,2,109.57833,18.20222,1802
1538,14192,C860767955774E3494068CF38C009FB6,30191,15,17,2,109.50361,18.22701,1506
1539,14193,C860767955774E3494068CF38C009FB6,31031,19,20,1,109.49979,18.25382,1510
1540,14194,C860767955774E3494068CF38C009FB6,60391,21,23,2,109.47667,18.28757,1416
1541,14238,5585250DBD68ABC768E4FEDB3CFC1D84,31471,13,14,1,109.34583,18.29563,917
1542,14239,5585250DBD68ABC768E4FEDB3CFC1D84,30354,17,19,2,109.42813,18.29076,1216
1546,14246,35C6EDC8AAC6B5ABA770190223528BA2,30861,18,19,1,109.52722,18.22743,1606
1547,14247,35C6EDC8AAC6B5ABA770190223528BA2,31061,21,23,2,109.53333,18.23257,1607
1548,14248,8C5A16299A6D294198C90C34C25C5949,30854,3,4,1,109.56889,18.27076,1763
1549,14249,8C5A16299A6D294198C90C34C25C5949,31561,7,9,2,109.56792,18.28479,1765
1550,14250,8C5A16299A6D294198C90C34C25C5949,31071,11,12,1,109.58257,18.28458,1815
1551,14251,8C5A16299A6D294198C90C34C25C5949,39183,14,17,3,109.55542,18.28208,1715
1552,14252,8C5A16299A6D294198C90C34C25C5949,30854,20,21,1,109.56889,18.27076,1763
1553,14253,8C5A16299A6D294198C90C34C25C5949,39183,22,23,1,109.55542,18.28208,1715
1554,14285,686506971A60578CA4060BE72A9FBFEA,31701,19,22,3,109.44132,18.28833,1266
1555,14297,B43DB539B5964E15F0064080164C40C1,60631,1,7,6,109.57778,18.27583,1814
1556,14298,B43DB539B5964E15F0064080164C40C1,38052,10,17,7,109.62618,18.23042,1956
1557,14299,B43DB539B5964E15F0064080164C40C1,60631,21,22,1,109.57778,18.27583,1814
1558,14346,77E0479537D8350123531CE1FA2E6649,31561,18,20,2,109.56792,18.28479,1765
1559,14347,77E0479537D8350123531CE1FA2E6649,30854,20,21,1,109.56889,18.27076,1763
1563,14380,E5E20C78783BEE4FE22BF6D264C660C6,31071,0,9,9,109.58257,18.28458,1815
1564,14381,E5E20C78783BEE4FE22BF6D264C660C6,30854,11,13,2,109.56889,18.27076,1763
1568,14410,C1F9914EF577AE2A8300B1A3945A50FF,31561,2,7,5,109.56792,18.28479,1765
1569,14411,C1F9914EF577AE2A8300B1A3945A50FF,31071,8,9,1,109.58257,18.28458,1815
1570,14480,1F1673F70557E9225354F49F96F77617,30271,19,21,2,109.49132,18.23153,1456
1577,14631,3D6D7E38DA6A03DDB2ACEC009234F360,31041,11,13,2,109.50278,18.23701,1507
1578,14640,BCEE5AD02B2E24116CD9422ACE964174,60381,11,12,1,109.5241,18.22458,1605
1579,14641,BCEE5AD02B2E24116CD9422ACE964174,30361,12,14,2,109.50347,18.24,1508
1580,14642,BCEE5AD02B2E24116CD9422ACE964174,60381,15,23,8,109.5241,18.22458,1605
1581,14662,47AFFCF7456D0B900AE2B4ED9BB222C6,31221,0,4,4,109.61333,18.26833,1913
1582,14663,47AFFCF7456D0B900AE2B4ED9BB222C6,60594,4,9,5,109.62694,18.22799,1956
1583,14664,47AFFCF7456D0B900AE2B4ED9BB222C6,31471,13,14,1,109.34583,18.29563,917
1584,14665,47AFFCF7456D0B900AE2B4ED9BB222C6,30361,16,18,2,109.50347,18.24,1508
1585,14666,47AFFCF7456D0B900AE2B4ED9BB222C6,31571,20,23,3,109.61563,18.23326,1957
1586,14667,8AD9F37216B2D3FCE05CA77434307672,30741,0,14,14,109.49833,18.28681,1516
1587,14668,8AD9F37216B2D3FCE05CA77434307672,30361,15,19,4,109.50347,18.24,1508
1588,14669,E191BF114A3C2277CB7C3323BAA13F43,30854,0,1,1,109.56889,18.27076,1763
1589,14670,E191BF114A3C2277CB7C3323BAA13F43,31561,5,6,1,109.56792,18.28479,1765
1590,14671,E191BF114A3C2277CB7C3323BAA13F43,30854,6,7,1,109.56889,18.27076,1763
1591,14672,E191BF114A3C2277CB7C3323BAA13F43,30211,12,13,1,109.49882,18.23931,1508
1595,14680,30407A7D3E455A7731D8523C4C83EC11,60552,1,7,6,109.41729,18.30014,1218
1596,14681,30407A7D3E455A7731D8523C4C83EC11,38073,8,9,1,109.40813,18.30958,1169
1597,14682,30407A7D3E455A7731D8523C4C83EC11,31471,12,13,1,109.34583,18.29563,917
1598,14683,30407A7D3E455A7731D8523C4C83EC11,30661,15,17,2,109.37028,18.24361,1008
1599,14684,30407A7D3E455A7731D8523C4C83EC11,60411,19,21,2,109.32514,18.30854,869
1600,14714,8004316015532C0761573F4B267C6FE4,30441,0,11,11,109.64021,18.25424,2010
1601,14715,8004316015532C0761573F4B267C6FE4,39151,13,14,1,109.49875,18.25097,1510
1602,14716,8004316015532C0761573F4B267C6FE4,30211,16,18,2,109.49882,18.23931,1508
1603,14717,8004316015532C0761573F4B267C6FE4,60291,19,21,2,109.50826,18.24639,1509
1604,14778,2E31826F518B91677E3401BE3F9A1AF2,60221,0,7,7,109.52569,18.29188,1616
1605,14779,2E31826F518B91677E3401BE3F9A1AF2,60361,11,16,5,109.51938,18.29681,1567
1606,14806,34211070C0856836040CA55D5A0FB3C4,38251,16,18,2,109.49618,18.25493,1510
1607,14807,34211070C0856836040CA55D5A0FB3C4,60084,19,20,1,109.4984,18.2334,1507
1608,14817,E504C7D2F929BB396CEA3A3E20B74D1F,31521,0,9,9,109.51458,18.22542,1555
1609,14818,E504C7D2F929BB396CEA3A3E20B74D1F,33481,10,13,3,109.67278,18.41278,2187
1610,14819,E504C7D2F929BB396CEA3A3E20B74D1F,31521,14,22,8,109.51458,18.22542,1555
1611,14823,90B0A60855A43B2DB99A0964CE51D3AF,31071,0,6,6,109.58257,18.28458,1815
1612,14824,90B0A60855A43B2DB99A0964CE51D3AF,30854,8,10,2,109.56889,18.27076,1763
1613,14829,59D035BE3D59A55EC6EA89871E8778D5,39151,11,14,3,109.49875,18.25097,1510
1614,14830,59D035BE3D59A55EC6EA89871E8778D5,31121,18,23,5,109.16292,18.37063,230
1615,14831,41BFDF202AA15C7D0EC7487840A4D094,30851,4,5,1,109.5616,18.27396,1713
1616,14832,41BFDF202AA15C7D0EC7487840A4D094,30854,6,23,17,109.56889,18.27076,1763
1617,14837,DBCB3A87F89C2AC16ED8152735BE6F75,38251,0,1,1,109.49618,18.25493,1510
1618,14838,DBCB3A87F89C2AC16ED8152735BE6F75,60401,1,4,3,109.47444,18.27583,1414
1619,14839,DBCB3A87F89C2AC16ED8152735BE6F75,31031,5,10,5,109.49979,18.25382,1510
1620,14840,DBCB3A87F89C2AC16ED8152735BE6F75,60411,14,15,1,109.32514,18.30854,869
1621,14841,DBCB3A87F89C2AC16ED8152735BE6F75,31031,16,23,7,109.49979,18.25382,1510
1622,14842,05F9648883BF713D4E846B58647DFC7D,60401,0,8,8,109.47444,18.27583,1414
1623,14843,05F9648883BF713D4E846B58647DFC7D,60524,8,9,1,109.42951,18.28993,1216
1624,14871,4B7C998F79696CE662F2E58BD2418D12,30711,0,14,14,109.50271,18.25347,1510
1625,14872,4B7C998F79696CE662F2E58BD2418D12,60281,14,16,2,109.51743,18.25924,1561
1626,14873,4B7C998F79696CE662F2E58BD2418D12,31171,16,17,1,109.50938,18.24917,1559
1627,14874,4B7C998F79696CE662F2E58BD2418D12,31101,21,23,2,109.65389,18.23403,2057
1628,14885,122D07F80E4FAC68FAE7EDBB2DF1AFA3,31071,0,9,9,109.58257,18.28458,1815
1629,14886,122D07F80E4FAC68FAE7EDBB2DF1AFA3,30854,10,11,1,109.56889,18.27076,1763
1630,14887,122D07F80E4FAC68FAE7EDBB2DF1AFA3,31071,14,16,2,109.58257,18.28458,1815
1631,14888,122D07F80E4FAC68FAE7EDBB2DF1AFA3,30854,17,18,1,109.56889,18.27076,1763
1632,14889,122D07F80E4FAC68FAE7EDBB2DF1AFA3,31071,21,22,1,109.58257,18.28458,1815
1633,14890,AC0473CD58A736C6A311A0DEEA929506,38023,1,10,9,109.37132,18.28993,1016
1634,14891,AC0473CD58A736C6A311A0DEEA929506,60054,14,15,1,109.3016,18.31229,770
1635,14892,AC0473CD58A736C6A311A0DEEA929506,31221,20,21,1,109.61333,18.26833,1913
1636,14893,AC0473CD58A736C6A311A0DEEA929506,31571,22,23,1,109.61563,18.23326,1957
1637,14923,B3EF0679F09F3DEC127B54C54EEBFAA7,31071,2,7,5,109.58257,18.28458,1815
1638,14924,B3EF0679F09F3DEC127B54C54EEBFAA7,30854,11,14,3,109.56889,18.27076,1763
1639,14925,0D3DA8126B134D203BB35373EAFFB116,30854,15,16,1,109.56889,18.27076,1763
1640,14926,0D3DA8126B134D203BB35373EAFFB116,31071,19,23,4,109.58257,18.28458,1815
1641,14927,A31156C6519BD5D8AB23829D811E9C63,38157,1,16,15,109.51483,18.26958,1563
1642,14928,A31156C6519BD5D8AB23829D811E9C63,30361,17,18,1,109.50347,18.24,1508
1643,14929,A31156C6519BD5D8AB23829D811E9C63,38903,20,22,2,109.39229,18.29243,1117
1644,14941,40B64400C6DDE5B4C041DD8F12A72251,38251,0,9,9,109.49618,18.25493,1510
1645,14942,40B64400C6DDE5B4C041DD8F12A72251,60054,13,14,1,109.3016,18.31229,770
1646,14943,40B64400C6DDE5B4C041DD8F12A72251,30421,17,19,2,109.50021,18.25861,1511
1647,14944,40B64400C6DDE5B4C041DD8F12A72251,38251,20,23,3,109.49618,18.25493,1510
1651,15102,68CD8D5D4C42D0506F4B33008FB98D15,31521,0,7,7,109.51458,18.22542,1555
1652,15103,68CD8D5D4C42D0506F4B33008FB98D15,30661,11,14,3,109.37028,18.24361,1008
1653,15104,68CD8D5D4C42D0506F4B33008FB98D15,31521,16,23,7,109.51458,18.22542,1555
1665,15219,40D62DAB923B148A7A4FFB3BCA6C7343,31271,14,15,1,109.48958,18.26257,1462
1666,15220,40D62DAB923B148A7A4FFB3BCA6C7343,38951,17,18,1,109.48097,18.28868,1416
1667,15221,E42A094C724E592924F39C0439AFCA4D,39151,19,21,2,109.49875,18.25097,1510
1668,15222,E42A094C724E592924F39C0439AFCA4D,60201,22,23,1,109.5041,18.2509,1510
1673,15251,E479C02F0DB5BD6494F47697E43E2BA3,30441,1,2,1,109.64021,18.25424,2010
1674,15252,E479C02F0DB5BD6494F47697E43E2BA3,38054,4,5,1,109.63479,18.23097,2006
1675,15253,E479C02F0DB5BD6494F47697E43E2BA3,30441,6,8,2,109.64021,18.25424,2010
1676,15254,E479C02F0DB5BD6494F47697E43E2BA3,39321,13,16,3,109.529,18.2167,1604
1677,15255,E479C02F0DB5BD6494F47697E43E2BA3,30361,16,18,2,109.50347,18.24,1508
1678,15256,E479C02F0DB5BD6494F47697E43E2BA3,39321,20,22,2,109.529,18.2167,1604
1679,15257,567BF1868FBA42FA9B3B29F2CA13F65D,31931,4,15,11,109.54771,18.29403,1667
1680,15258,567BF1868FBA42FA9B3B29F2CA13F65D,30221,19,21,2,109.57833,18.20222,1802
1681,15270,F00821368F615DCDAF214035D8EC4A44,31071,2,14,12,109.58257,18.28458,1815
1682,15271,F00821368F615DCDAF214035D8EC4A44,30854,14,17,3,109.56889,18.27076,1763
1683,15275,0B2CDE43D7DE290E07FF365A2D22E5DE,30854,16,18,2,109.56889,18.27076,1763
1684,15287,AFFFF065007C995513D9884CB60C17FD,60381,0,1,1,109.5241,18.22458,1605
1685,15288,AFFFF065007C995513D9884CB60C17FD,31031,2,5,3,109.49979,18.25382,1510
1686,15289,AFFFF065007C995513D9884CB60C17FD,60381,5,9,4,109.5241,18.22458,1605
1687,15290,AFFFF065007C995513D9884CB60C17FD,31071,17,18,1,109.58257,18.28458,1815
1688,15291,AFFFF065007C995513D9884CB60C17FD,31031,20,21,1,109.49979,18.25382,1510
1689,15292,AFFFF065007C995513D9884CB60C17FD,60381,22,23,1,109.5241,18.22458,1605
1690,15297,EB0479048CEC4253CB4301400973BCD9,31071,13,14,1,109.58257,18.28458,1815
1691,15298,EB0479048CEC4253CB4301400973BCD9,60381,14,15,1,109.5241,18.22458,1605
1696,15316,2F6B5C7AA084DDA6FD780C1010658B83,31391,0,4,4,109.50382,18.24285,1508
1697,15317,2F6B5C7AA084DDA6FD780C1010658B83,31521,4,9,5,109.51458,18.22542,1555
1698,15318,2F6B5C7AA084DDA6FD780C1010658B83,60381,9,10,1,109.5241,18.22458,1605
1699,15319,2F6B5C7AA084DDA6FD780C1010658B83,31521,11,14,3,109.51458,18.22542,1555
1700,15320,2F6B5C7AA084DDA6FD780C1010658B83,31521,17,19,2,109.51458,18.22542,1555
1704,15350,4290A01FCBC2456E9D2F061E9D5E5D68,60371,0,21,21,109.53063,18.30056,1618
1705,15351,4290A01FCBC2456E9D2F061E9D5E5D68,30854,21,23,2,109.56889,18.27076,1763
1706,15387,E43A8F31A67CD411544F9CC89C636B06,60381,1,8,7,109.5241,18.22458,1605
1707,15388,E43A8F31A67CD411544F9CC89C636B06,31061,12,16,4,109.53333,18.23257,1607
1708,15389,E43A8F31A67CD411544F9CC89C636B06,31071,19,20,1,109.58257,18.28458,1815
1709,15402,316EB27B7555943C1D6557CD7E5A08F6,38341,15,19,4,109.49965,18.21299,1503
1710,15433,AD39A6F857F8E578E6A2D9E072C4613F,39061,2,6,4,109.38222,18.28958,1066
1711,15434,AD39A6F857F8E578E6A2D9E072C4613F,30681,6,8,2,109.48493,18.26917,1463
1712,15435,AD39A6F857F8E578E6A2D9E072C4613F,30361,12,13,1,109.50347,18.24,1508
1713,15436,AD39A6F857F8E578E6A2D9E072C4613F,60221,15,20,5,109.52569,18.29188,1616
1714,15437,9FB9A7A4E811D65655B56CAECAAFDC8A,60381,0,10,10,109.5241,18.22458,1605
1715,15438,9FB9A7A4E811D65655B56CAECAAFDC8A,31521,10,22,12,109.51458,18.22542,1555
1716,15446,53490AD77ACCA93C3ED0F3DE79CA488B,31071,0,5,5,109.58257,18.28458,1815
1717,15447,53490AD77ACCA93C3ED0F3DE79CA488B,30854,9,21,12,109.56889,18.27076,1763
1721,15521,B1CCD68E3CC8A7232EF2DE7E986C4789,38017,0,10,10,109.49729,18.21424,1504
1722,15522,B1CCD68E3CC8A7232EF2DE7E986C4789,60084,11,13,2,109.4984,18.2334,1507
1723,15523,B1CCD68E3CC8A7232EF2DE7E986C4789,38017,14,18,4,109.49729,18.21424,1504
1724,15524,B1CCD68E3CC8A7232EF2DE7E986C4789,60121,19,20,1,109.74507,18.37472,2430
1725,15525,B1CCD68E3CC8A7232EF2DE7E986C4789,38017,21,23,2,109.49729,18.21424,1504
1726,15533,9C1407835BC54BEBDB541F52E1DA1820,61011,0,6,6,109.60653,18.19076,1900
1727,15576,5E28EAB5F2E807365535BF3233D32C9B,38017,16,18,2,109.49729,18.21424,1504
1728,15577,5E28EAB5F2E807365535BF3233D32C9B,31521,19,23,4,109.51458,18.22542,1555
1729,15588,C1C0BE3268A989F4F57CDD79CA1A84CD,30271,19,21,2,109.49132,18.23153,1456
1730,15589,C1C0BE3268A989F4F57CDD79CA1A84CD,31271,21,23,2,109.48958,18.26257,1462
1731,15606,2875EEABF8ED00FBC275508759985153,31521,0,4,4,109.51458,18.22542,1555
1732,15607,2875EEABF8ED00FBC275508759985153,31391,5,6,1,109.50382,18.24285,1508
1733,15608,2875EEABF8ED00FBC275508759985153,31521,6,9,3,109.51458,18.22542,1555
1734,15609,2875EEABF8ED00FBC275508759985153,31521,10,13,3,109.51458,18.22542,1555
1735,15610,2875EEABF8ED00FBC275508759985153,31521,17,19,2,109.51458,18.22542,1555
1736,15611,2875EEABF8ED00FBC275508759985153,38071,20,22,2,109.40722,18.30938,1169
1737,15678,B80D4B4CDBD08237A9C4254F8883AEF4,30771,0,7,7,109.49938,18.26042,1511
1738,15679,B80D4B4CDBD08237A9C4254F8883AEF4,60201,8,11,3,109.5041,18.2509,1510
1739,15680,B80D4B4CDBD08237A9C4254F8883AEF4,39151,12,14,2,109.49875,18.25097,1510
1740,15681,B80D4B4CDBD08237A9C4254F8883AEF4,31171,15,18,3,109.50938,18.24917,1559
1741,15682,B80D4B4CDBD08237A9C4254F8883AEF4,30421,18,20,2,109.50021,18.25861,1511
1742,15683,B80D4B4CDBD08237A9C4254F8883AEF4,31041,20,23,3,109.50278,18.23701,1507
1743,15693,CCCD2290FB632A48009771412BE68ADD,31561,0,8,8,109.56792,18.28479,1765
1744,15694,CCCD2290FB632A48009771412BE68ADD,39183,8,10,2,109.55542,18.28208,1715
1745,15695,CCCD2290FB632A48009771412BE68ADD,31561,11,15,4,109.56792,18.28479,1765
1746,15696,CCCD2290FB632A48009771412BE68ADD,39183,16,18,2,109.55542,18.28208,1715
1747,15697,CCCD2290FB632A48009771412BE68ADD,31561,22,23,1,109.56792,18.28479,1765
1748,15701,8799356B7181F28146A203E5F86C52F0,31351,0,7,7,109.4959,18.28417,1465
1749,15702,8799356B7181F28146A203E5F86C52F0,38834,8,14,6,109.47639,18.21146,1403
1750,15703,8799356B7181F28146A203E5F86C52F0,31351,19,22,3,109.4959,18.28417,1465
1754,15721,73EAC1341C5005A58B26B1A52457F38B,39101,2,18,16,109.50132,18.24931,1509
1755,15722,73EAC1341C5005A58B26B1A52457F38B,60121,18,21,3,109.74507,18.37472,2430
1762,15801,37D38EF0062E64D55C94EB554B76F9EE,30854,14,16,2,109.56889,18.27076,1763
1763,15802,37D38EF0062E64D55C94EB554B76F9EE,31071,17,18,1,109.58257,18.28458,1815
1764,15803,37D38EF0062E64D55C94EB554B76F9EE,30854,20,21,1,109.56889,18.27076,1763
1771,15867,B5F757525A1D4CCFC85B8B869B252C51,60411,2,6,4,109.32514,18.30854,869
1772,15868,B5F757525A1D4CCFC85B8B869B252C51,30661,7,8,1,109.37028,18.24361,1008
1773,15875,E5E2DA460104E389257158E8D8C9FBDA,60281,0,5,5,109.51743,18.25924,1561
1774,15876,E5E2DA460104E389257158E8D8C9FBDA,30511,6,8,2,109.51069,18.24208,1558
1775,15877,E5E2DA460104E389257158E8D8C9FBDA,60281,11,12,1,109.51743,18.25924,1561
1776,15878,E5E2DA460104E389257158E8D8C9FBDA,31261,13,17,4,109.51174,18.2466,1559
1777,15879,E5E2DA460104E389257158E8D8C9FBDA,60281,18,23,5,109.51743,18.25924,1561
1778,15925,70E36A4B82878626B569C66E46C7827C,60241,19,20,1,109.53319,18.28667,1616
1779,15926,70E36A4B82878626B569C66E46C7827C,39091,21,23,2,109.50097,18.25222,1510
1780,15980,FFF78F4198B8925E2094E7DEEAA9FD4B,60231,0,7,7,109.49903,18.21972,1504
1781,15981,FFF78F4198B8925E2094E7DEEAA9FD4B,38105,7,9,2,109.40299,18.29229,1117
1782,16013,012ABD06F231728C214A4BA917E75B1C,31561,0,8,8,109.56792,18.28479,1765
1783,16014,012ABD06F231728C214A4BA917E75B1C,30851,8,10,2,109.5616,18.27396,1713
1784,16015,012ABD06F231728C214A4BA917E75B1C,31561,10,11,1,109.56792,18.28479,1765
1785,16016,012ABD06F231728C214A4BA917E75B1C,30851,12,18,6,109.5616,18.27396,1713
1786,16017,012ABD06F231728C214A4BA917E75B1C,31561,18,21,3,109.56792,18.28479,1765
1794,16079,8DDAC29F1E8D0CBA7C68BCF69300ACB7,38157,19,21,2,109.51483,18.26958,1563
1795,16080,8DDAC29F1E8D0CBA7C68BCF69300ACB7,60084,22,23,1,109.4984,18.2334,1507
1804,16143,FA0EB766C44C307B69FC2247C53C674E,60131,0,7,7,109.49819,18.24778,1509
1805,16144,FA0EB766C44C307B69FC2247C53C674E,60321,11,12,1,109.63611,18.24306,2008
1806,16145,FA0EB766C44C307B69FC2247C53C674E,31031,13,16,3,109.49979,18.25382,1510
1807,16146,FA0EB766C44C307B69FC2247C53C674E,39154,20,21,1,109.50201,18.25681,1511
1808,16166,9B36D53A2DB7FECD4570227EC8F2E0E7,31781,14,15,1,109.19847,18.2975,367
1809,16167,9B36D53A2DB7FECD4570227EC8F2E0E7,60551,19,20,1,109.42722,18.30111,1218
1810,16168,9B36D53A2DB7FECD4570227EC8F2E0E7,31031,21,22,1,109.49979,18.25382,1510
1811,16172,733574DC984D9A31BC05EAD957FD2697,31101,17,19,2,109.65389,18.23403,2057
1812,16183,43E035AE85036EBD9891453E9567CB81,30151,0,15,15,109.50986,18.25083,1560
1813,16184,43E035AE85036EBD9891453E9567CB81,30151,19,23,4,109.50986,18.25083,1560
1814,16206,BD2C08FAEF5FEEC783652D604747CF6D,33481,13,16,3,109.67278,18.41278,2187
1815,16207,BD2C08FAEF5FEEC783652D604747CF6D,31521,20,21,1,109.51458,18.22542,1555
1816,16208,BD2C08FAEF5FEEC783652D604747CF6D,31521,22,23,1,109.51458,18.22542,1555
1817,16228,2371AF49C13083A9B56BAFD9F258B46A,30861,0,10,10,109.52722,18.22743,1606
1818,16229,2371AF49C13083A9B56BAFD9F258B46A,30171,12,14,2,109.48458,18.27139,1463
1819,16230,2371AF49C13083A9B56BAFD9F258B46A,30341,16,18,2,109.3625,18.29167,966
1820,16231,2371AF49C13083A9B56BAFD9F258B46A,30721,19,23,4,109.51597,18.28257,1565
1821,16232,C304B7CAC34AD51294A1441D84A8C903,30351,0,8,8,109.41701,18.29292,1217
1822,16233,C304B7CAC34AD51294A1441D84A8C903,38111,11,12,1,109.52007,18.22403,1555
1823,16234,C304B7CAC34AD51294A1441D84A8C903,30351,17,19,2,109.41701,18.29292,1217
1824,16235,C304B7CAC34AD51294A1441D84A8C903,31271,20,21,1,109.48958,18.26257,1462
1825,16248,8752BC71725B50257436D50C6598F252,31071,2,4,2,109.58257,18.28458,1815
1826,16249,8752BC71725B50257436D50C6598F252,30854,7,20,13,109.56889,18.27076,1763
1827,16254,92E14A6094471B9C1A50CE8585136EC6,60087,3,13,10,109.50688,18.22299,1505
1828,16255,92E14A6094471B9C1A50CE8585136EC6,38754,17,18,1,109.74667,18.37382,2430
1829,16256,92E14A6094471B9C1A50CE8585136EC6,30731,19,21,2,109.50944,18.22306,1555
1830,16277,B65A42EE158A1686688454429BA4F642,31521,0,15,15,109.51458,18.22542,1555
1831,16278,B65A42EE158A1686688454429BA4F642,60221,18,21,3,109.52569,18.29188,1616
1832,16309,DC9973204E62AA99FA79F0696CF6C0F6,30851,0,6,6,109.5616,18.27396,1713
1833,16310,DC9973204E62AA99FA79F0696CF6C0F6,30854,9,23,14,109.56889,18.27076,1763
1834,16324,7BBB2DDEDB0AE43F8CE7FBD1FCB52741,31071,0,6,6,109.58257,18.28458,1815
1835,16325,7BBB2DDEDB0AE43F8CE7FBD1FCB52741,30854,10,23,13,109.56889,18.27076,1763
1836,16341,EF9F15FAFA5926C5B853D240732ABDEA,60524,16,19,3,109.42951,18.28993,1216
1837,16342,EF9F15FAFA5926C5B853D240732ABDEA,30161,20,22,2,109.50042,18.24389,1508
1838,16366,3EAE2CCEF780CC2E20C47963EA2CF3C6,30851,19,20,1,109.5616,18.27396,1713
1839,16367,3EAE2CCEF780CC2E20C47963EA2CF3C6,31561,21,23,2,109.56792,18.28479,1765
1840,16411,6422CB87ACC55DDEF6EBE8946593C808,31351,0,7,7,109.4959,18.28417,1465
1841,16412,6422CB87ACC55DDEF6EBE8946593C808,30571,11,15,4,109.50243,18.21861,1504
1842,16413,6422CB87ACC55DDEF6EBE8946593C808,38834,16,21,5,109.47639,18.21146,1403
1847,16488,7890099D98AA300C5BF12527E7372DB0,60631,0,7,7,109.57778,18.27583,1814
1848,16489,7890099D98AA300C5BF12527E7372DB0,30854,8,11,3,109.56889,18.27076,1763
1849,16490,7890099D98AA300C5BF12527E7372DB0,60631,12,14,2,109.57778,18.27583,1814
1850,16491,7890099D98AA300C5BF12527E7372DB0,30854,15,17,2,109.56889,18.27076,1763
1851,16492,7890099D98AA300C5BF12527E7372DB0,60631,18,23,5,109.57778,18.27583,1814
1852,16507,B874EAC8926625C0D1165CC1283F451E,31061,0,7,7,109.53333,18.23257,1607
1853,16508,B874EAC8926625C0D1165CC1283F451E,30661,9,10,1,109.37028,18.24361,1008
1854,16509,B874EAC8926625C0D1165CC1283F451E,31781,12,13,1,109.19847,18.2975,367
1855,16510,B874EAC8926625C0D1165CC1283F451E,30191,18,19,1,109.50361,18.22701,1506
1856,16511,B874EAC8926625C0D1165CC1283F451E,31061,22,23,1,109.53333,18.23257,1607
1860,16562,C6FE4CF0CD47303AD7F7EC5A71315B10,31561,18,19,1,109.56792,18.28479,1765
1861,16563,C6FE4CF0CD47303AD7F7EC5A71315B10,60631,21,22,1,109.57778,18.27583,1814
1862,16571,32D0EBFA645FCE8DAD65D018847E5043,30232,0,7,7,109.6191,18.31701,1971
1863,16572,32D0EBFA645FCE8DAD65D018847E5043,30854,8,23,15,109.56889,18.27076,1763
1864,16584,7084657DF30063A945AAA5EF4742695F,39183,14,19,5,109.55542,18.28208,1715
1865,16585,7084657DF30063A945AAA5EF4742695F,31071,20,23,3,109.58257,18.28458,1815
1866,16614,0036A867CCF4154EF4E16AF8E847E92C,38251,16,17,1,109.49618,18.25493,1510
1867,16615,0036A867CCF4154EF4E16AF8E847E92C,60084,19,20,1,109.4984,18.2334,1507
1868,16622,C1A86408F22C4A96CA9DED3C9439B426,31145,15,16,1,109.20431,18.30479,369
1869,16623,C1A86408F22C4A96CA9DED3C9439B426,30861,18,23,5,109.52722,18.22743,1606
1870,16656,566423B784470FF1F6B17BF1D21CA750,38171,0,2,2,109.50799,18.28139,1515
1871,16657,566423B784470FF1F6B17BF1D21CA750,38171,4,12,8,109.50799,18.28139,1515
1872,16658,566423B784470FF1F6B17BF1D21CA750,38094,16,17,1,109.45403,18.28778,1316
1873,16659,566423B784470FF1F6B17BF1D21CA750,38903,18,20,2,109.39229,18.29243,1117
1874,16660,566423B784470FF1F6B17BF1D21CA750,38171,20,23,3,109.50799,18.28139,1515
1875,16696,C8922FAF66F21ECAECB6B717FCD5A53B,60391,9,17,8,109.47667,18.28757,1416
1876,16697,C8922FAF66F21ECAECB6B717FCD5A53B,60614,19,23,4,109.48799,18.29521,1467
1877,16713,9E8746086915F9D4A063A74CF0B5B7AB,31561,0,6,6,109.56792,18.28479,1765
1878,16714,9E8746086915F9D4A063A74CF0B5B7AB,39183,7,8,1,109.55542,18.28208,1715
1879,16726,D200070A291DD799906C2E0FB6841C80,38271,0,8,8,109.62632,18.23049,1956
1880,16727,D200070A291DD799906C2E0FB6841C80,31801,11,12,1,109.20417,18.32118,371
1881,16728,D200070A291DD799906C2E0FB6841C80,31471,12,14,2,109.34583,18.29563,917
1882,16729,D200070A291DD799906C2E0FB6841C80,31205,15,16,1,109.51111,18.23736,1557
1883,16730,D200070A291DD799906C2E0FB6841C80,38271,19,23,4,109.62632,18.23049,1956
1884,16745,A503639E15A0B5D04B0130D882921438,31031,0,16,16,109.49979,18.25382,1510
1885,16746,A503639E15A0B5D04B0130D882921438,30711,16,21,5,109.50271,18.25347,1510
1886,16802,8B67CA01C44A0A9FF0492771727FF584,30281,18,20,2,109.50597,18.27583,1514
1887,16803,8B67CA01C44A0A9FF0492771727FF584,38241,20,22,2,109.54111,18.30542,1669
1891,16853,64C897065E9EDCA8A69F38A94EFB9055,31181,13,16,3,109.50382,18.24813,1509
1895,16878,A4120452FF09D9783BEC38585F9D2055,31321,15,16,1,109.63799,18.23201,2007
1896,16879,A4120452FF09D9783BEC38585F9D2055,31321,18,19,1,109.63799,18.23201,2007
1897,16880,A4120452FF09D9783BEC38585F9D2055,38134,21,23,2,109.63931,18.23451,2007
1898,16901,AD0A1E1F1E587F1E96859B31EF886F77,60084,19,20,1,109.4984,18.2334,1507
1899,16902,AD0A1E1F1E587F1E96859B31EF886F77,38361,21,23,2,109.43667,18.29201,1267
1904,16940,56DFEAF03DB999C001DE943D9823E4CB,60161,13,14,1,109.49174,18.26181,1461
1905,16941,56DFEAF03DB999C001DE943D9823E4CB,31531,16,19,3,109.49583,18.25972,1461
1906,16942,56DFEAF03DB999C001DE943D9823E4CB,60401,21,23,2,109.47444,18.27583,1414
1907,16976,D832D0A98B7486BD43D374BC2EF00900,30441,12,14,2,109.64021,18.25424,2010
1908,16977,D832D0A98B7486BD43D374BC2EF00900,31031,16,17,1,109.49979,18.25382,1510
1909,16978,D832D0A98B7486BD43D374BC2EF00900,38251,18,20,2,109.49618,18.25493,1510
1910,16979,D832D0A98B7486BD43D374BC2EF00900,30161,20,23,3,109.50042,18.24389,1508
1911,16980,8DA877D3A30401F86E81FB7BC1CA2A00,30854,2,6,4,109.56889,18.27076,1763
1912,16981,8DA877D3A30401F86E81FB7BC1CA2A00,31071,8,9,1,109.58257,18.28458,1815
1913,16984,2AE38FAF341950B0B91404FFCE5A0F3E,39181,19,21,2,109.55153,18.28035,1715
1914,16985,2AE38FAF341950B0B91404FFCE5A0F3E,39183,21,23,2,109.55542,18.28208,1715
1919,17029,5F70E6EFF50C46A1203DB5C4C03B4FD3,31701,1,11,10,109.44132,18.28833,1266
1920,17030,5F70E6EFF50C46A1203DB5C4C03B4FD3,30361,12,14,2,109.50347,18.24,1508
1921,17031,5F70E6EFF50C46A1203DB5C4C03B4FD3,31701,16,17,1,109.44132,18.28833,1266
1925,17076,DFFF17B7FE30E79B8AABBB5CE171272F,31561,0,3,3,109.56792,18.28479,1765
1926,17077,DFFF17B7FE30E79B8AABBB5CE171272F,39183,4,6,2,109.55542,18.28208,1715
1927,17078,DFFF17B7FE30E79B8AABBB5CE171272F,31561,6,7,1,109.56792,18.28479,1765
1928,17079,DFFF17B7FE30E79B8AABBB5CE171272F,39183,20,22,2,109.55542,18.28208,1715
1929,17080,DFFF17B7FE30E79B8AABBB5CE171272F,31561,22,23,1,109.56792,18.28479,1765
1930,17096,B34415F599F0ED7D1A073EE314A60B9B,60041,2,5,3,109.39889,18.31944,1121
1931,17097,B34415F599F0ED7D1A073EE314A60B9B,31671,7,19,12,109.38965,18.29813,1068
1932,17118,0792180C7D67367A30DA0E9989B71457,60291,0,1,1,109.50826,18.24639,1509
1933,17119,0792180C7D67367A30DA0E9989B71457,60381,2,17,15,109.5241,18.22458,1605
1934,17120,0792180C7D67367A30DA0E9989B71457,60641,18,19,1,109.53854,18.2359,1657
1935,17121,0792180C7D67367A30DA0E9989B71457,30861,19,21,2,109.52722,18.22743,1606
1936,17122,0792180C7D67367A30DA0E9989B71457,31091,22,23,1,109.41201,18.31222,1170
1937,17153,EC4B90EDBF35256FDB4D4F8B87DB8A04,31071,1,11,10,109.58257,18.28458,1815
1938,17154,EC4B90EDBF35256FDB4D4F8B87DB8A04,30854,14,20,6,109.56889,18.27076,1763
1943,17172,248CE0B148D688C343222BB27AEE2380,60631,0,7,7,109.57778,18.27583,1814
1944,17173,248CE0B148D688C343222BB27AEE2380,30854,7,8,1,109.56889,18.27076,1763
1945,17174,248CE0B148D688C343222BB27AEE2380,31071,8,10,2,109.58257,18.28458,1815
1946,17175,248CE0B148D688C343222BB27AEE2380,60631,12,13,1,109.57778,18.27583,1814
1947,17176,248CE0B148D688C343222BB27AEE2380,30854,14,19,5,109.56889,18.27076,1763
1948,17177,248CE0B148D688C343222BB27AEE2380,60631,19,22,3,109.57778,18.27583,1814
1949,17198,ED90ACC7338DC6DF91BAC96D9385175E,31531,13,14,1,109.49583,18.25972,1461
1950,17199,ED90ACC7338DC6DF91BAC96D9385175E,60621,18,20,2,109.48354,18.27451,1464
1951,17200,ED90ACC7338DC6DF91BAC96D9385175E,31531,21,23,2,109.49583,18.25972,1461
1955,17298,18B397C6C5E352538250AEDC640C72E3,30581,16,19,3,109.62257,18.24951,1959
1956,17299,18B397C6C5E352538250AEDC640C72E3,30232,20,21,1,109.6191,18.31701,1971
1957,17300,18B397C6C5E352538250AEDC640C72E3,31941,22,23,1,109.62451,18.31222,1970
1961,17346,B46B1495EF30AEB09B62A86592EC76F4,38251,12,15,3,109.49618,18.25493,1510
1962,17347,B46B1495EF30AEB09B62A86592EC76F4,30361,16,18,2,109.50347,18.24,1508
1963,17348,B46B1495EF30AEB09B62A86592EC76F4,38251,19,21,2,109.49618,18.25493,1510
1964,17349,B46B1495EF30AEB09B62A86592EC76F4,60131,21,23,2,109.49819,18.24778,1509
1969,17400,27229B6D41BD7CDDDAA38911093865DB,30854,1,3,2,109.56889,18.27076,1763
1970,17401,27229B6D41BD7CDDDAA38911093865DB,38085,5,13,8,109.6291,18.23625,2007
1971,17402,27229B6D41BD7CDDDAA38911093865DB,30854,18,19,1,109.56889,18.27076,1763
1972,17403,27229B6D41BD7CDDDAA38911093865DB,31071,20,23,3,109.58257,18.28458,1815
1976,17456,68E0EBFAA45AF77E4FC7ED3FB8F5EC2D,38331,17,18,1,109.62465,18.22736,1956
1977,17457,68E0EBFAA45AF77E4FC7ED3FB8F5EC2D,30581,19,20,1,109.62257,18.24951,1959
1978,17458,68E0EBFAA45AF77E4FC7ED3FB8F5EC2D,38331,21,23,2,109.62465,18.22736,1956
1979,17487,1D8B814EC83D52D7C5F3FED99C129EE0,60631,0,1,1,109.57778,18.27583,1814
1980,17488,1D8B814EC83D52D7C5F3FED99C129EE0,30854,2,9,7,109.56889,18.27076,1763
1981,17489,1D8B814EC83D52D7C5F3FED99C129EE0,38271,12,18,6,109.62632,18.23049,1956
1982,17490,1D8B814EC83D52D7C5F3FED99C129EE0,60631,19,21,2,109.57778,18.27583,1814
1986,17663,94C6B6D07606799F9DD78C376ADCB85C,38911,8,9,1,109.51674,18.24965,1559
1987,17664,94C6B6D07606799F9DD78C376ADCB85C,38291,9,14,5,109.51618,18.24313,1558
1988,17665,94C6B6D07606799F9DD78C376ADCB85C,31461,16,17,1,109.5091,18.25389,1510
1989,17666,94C6B6D07606799F9DD78C376ADCB85C,38911,20,22,2,109.51674,18.24965,1559
1990,17680,26320D482FA7887F152191DD18B790C6,30854,0,2,2,109.56889,18.27076,1763
1991,17681,26320D482FA7887F152191DD18B790C6,31071,5,15,10,109.58257,18.28458,1815
1992,17747,C462628FF36F8FF2D0B7493E6DDA38BB,60411,1,2,1,109.32514,18.30854,869
1993,17748,C462628FF36F8FF2D0B7493E6DDA38BB,30661,2,9,7,109.37028,18.24361,1008
1994,17749,C462628FF36F8FF2D0B7493E6DDA38BB,60411,9,11,2,109.32514,18.30854,869
1995,17750,C462628FF36F8FF2D0B7493E6DDA38BB,30661,11,12,1,109.37028,18.24361,1008
1996,17751,C462628FF36F8FF2D0B7493E6DDA38BB,60411,13,23,10,109.32514,18.30854,869
1997,17789,44950E3F507F69B4213B7A47ACD45534,39111,11,14,3,109.5191,18.22597,1555
1998,17790,44950E3F507F69B4213B7A47ACD45534,31061,15,16,1,109.53333,18.23257,1607
1999,17791,72839B8F6256E6FF641405D4832BF569,31071,1,2,1,109.58257,18.28458,1815
2000,17792,72839B8F6256E6FF641405D4832BF569,30854,4,15,11,109.56889,18.27076,1763
2001,17800,599AFAF71D30C85AA4E0085C43FF5E03,39091,15,16,1,109.50097,18.25222,1510
2002,17801,599AFAF71D30C85AA4E0085C43FF5E03,30161,18,19,1,109.50042,18.24389,1508
2011,17892,E6651E3C6D8FEA2077D9EFC6D097D06C,38251,0,21,21,109.49618,18.25493,1510
2012,17893,E6651E3C6D8FEA2077D9EFC6D097D06C,30581,22,23,1,109.62257,18.24951,1959
2013,17961,52DF9393BC04EE7B5E83988CA7733BE9,31071,4,13,9,109.58257,18.28458,1815
2014,17962,52DF9393BC04EE7B5E83988CA7733BE9,30854,13,14,1,109.56889,18.27076,1763
2015,17995,A46BA306DAEA889FAC7ACE9E5FD6A1FF,60331,0,7,7,109.505,18.26507,1512
2016,17996,A46BA306DAEA889FAC7ACE9E5FD6A1FF,31461,8,9,1,109.5091,18.25389,1510
2017,17997,A46BA306DAEA889FAC7ACE9E5FD6A1FF,30911,13,16,3,109.50493,18.26181,1511
2018,17998,A46BA306DAEA889FAC7ACE9E5FD6A1FF,31171,18,19,1,109.50938,18.24917,1559
2019,17999,A46BA306DAEA889FAC7ACE9E5FD6A1FF,30511,19,22,3,109.51069,18.24208,1558
2020,18000,E649CF84A26278291AA1A5B5C5D01FCA,31561,0,6,6,109.56792,18.28479,1765
2021,18001,E649CF84A26278291AA1A5B5C5D01FCA,30854,6,23,17,109.56889,18.27076,1763
2026,18019,68254E0B24F7E3AA28CA608A59CAC78B,31221,0,6,6,109.61333,18.26833,1913
2027,18020,68254E0B24F7E3AA28CA608A59CAC78B,60594,6,17,11,109.62694,18.22799,1956
2032,18054,6C0260646767B781577B5B8CE2471E51,38484,9,20,11,109.53028,18.31528,1620
2033,18055,6C0260646767B781577B5B8CE2471E51,30071,21,23,2,109.52819,18.30472,1619
2034,18076,060A07AE17806CC79BB6F45DB4C73F3F,30821,0,20,20,109.43681,18.33639,1274
2035,18077,060A07AE17806CC79BB6F45DB4C73F3F,39151,21,23,2,109.49875,18.25097,1510
2039,18139,8DEBA8F3DD446F0F0680296AB7E73431,60472,9,11,2,109.46625,18.29542,1367
2040,18140,8DEBA8F3DD446F0F0680296AB7E73431,60011,15,19,4,109.48965,18.30222,1468
2041,18160,9D95A3171C1BE00DB2BC8E0B4B7E1AC6,60621,0,7,7,109.48354,18.27451,1464
2042,18161,9D95A3171C1BE00DB2BC8E0B4B7E1AC6,30061,9,11,2,109.29257,18.47521,747
2043,18162,9D95A3171C1BE00DB2BC8E0B4B7E1AC6,30171,15,16,1,109.48458,18.27139,1463
2044,18163,9D95A3171C1BE00DB2BC8E0B4B7E1AC6,30251,18,20,2,109.50611,18.26653,1512
2045,18164,9D95A3171C1BE00DB2BC8E0B4B7E1AC6,30171,21,23,2,109.48458,18.27139,1463
2050,18194,8AABF5FDF2B06EB445749240A3894969,31071,0,8,8,109.58257,18.28458,1815
2051,18195,8AABF5FDF2B06EB445749240A3894969,30854,10,11,1,109.56889,18.27076,1763
2052,18196,8AABF5FDF2B06EB445749240A3894969,31071,11,13,2,109.58257,18.28458,1815
2053,18197,8AABF5FDF2B06EB445749240A3894969,31851,14,18,4,109.71736,18.29007,2316
2054,18198,8AABF5FDF2B06EB445749240A3894969,30101,20,22,2,109.57299,18.33333,1773
2058,18285,FC8552628F8A5A5219C1C30314657039,60661,0,20,20,109.548,18.2377,1657
2059,18286,FC8552628F8A5A5219C1C30314657039,31021,22,23,1,109.49021,18.27,1463
2060,18296,CA373FFAFD7EFAD5EEFC32965095EB00,60201,0,6,6,109.5041,18.2509,1510
2061,18297,CA373FFAFD7EFAD5EEFC32965095EB00,38251,6,11,5,109.49618,18.25493,1510
2062,18298,CA373FFAFD7EFAD5EEFC32965095EB00,60201,12,14,2,109.5041,18.2509,1510
2063,18299,CA373FFAFD7EFAD5EEFC32965095EB00,38484,20,21,1,109.53028,18.31528,1620
2064,18300,CA373FFAFD7EFAD5EEFC32965095EB00,31031,22,23,1,109.49979,18.25382,1510
2065,18306,E8BAAF476E8FE57075BAB1A8D4FF1780,30232,0,12,12,109.6191,18.31701,1971
2066,18307,E8BAAF476E8FE57075BAB1A8D4FF1780,30854,15,16,1,109.56889,18.27076,1763
2067,18308,E8BAAF476E8FE57075BAB1A8D4FF1780,30232,21,22,1,109.6191,18.31701,1971
2068,18311,EBB8C4DC19F3856E93F775E3331F31B3,31201,6,8,2,109.51042,18.23819,1558
2069,18312,EBB8C4DC19F3856E93F775E3331F31B3,30081,11,17,6,109.50243,18.26632,1512
2070,18313,EBB8C4DC19F3856E93F775E3331F31B3,31521,18,20,2,109.51458,18.22542,1555
2071,18314,EBB8C4DC19F3856E93F775E3331F31B3,31521,20,23,3,109.51458,18.22542,1555
2076,18364,9A1D1AA5EE2CD156CC396C667ED8C5B9,31071,0,8,8,109.58257,18.28458,1815
2077,18365,9A1D1AA5EE2CD156CC396C667ED8C5B9,30854,10,20,10,109.56889,18.27076,1763
2078,18395,408C4FED868686E7B96333835F4C4205,60631,0,8,8,109.57778,18.27583,1814
2079,18396,408C4FED868686E7B96333835F4C4205,30581,8,11,3,109.62257,18.24951,1959
2080,18397,408C4FED868686E7B96333835F4C4205,30854,12,14,2,109.56889,18.27076,1763
2081,18398,408C4FED868686E7B96333835F4C4205,60381,19,21,2,109.5241,18.22458,1605
2082,18399,408C4FED868686E7B96333835F4C4205,31071,22,23,1,109.58257,18.28458,1815
2083,18411,7C16827D646BDC874DE2BD7EE32189C5,30854,7,18,11,109.56889,18.27076,1763
2084,18412,7C16827D646BDC874DE2BD7EE32189C5,60631,18,21,3,109.57778,18.27583,1814
2085,18413,7C16827D646BDC874DE2BD7EE32189C5,30854,22,23,1,109.56889,18.27076,1763
2086,18436,134447BAF73045598D228AAEE014B4B8,30854,1,5,4,109.56889,18.27076,1763
2087,18491,8FB6E68E5A6CC62C91B8CA5F70C97052,60381,17,19,2,109.5241,18.22458,1605
2088,18492,8FB6E68E5A6CC62C91B8CA5F70C97052,60661,20,23,3,109.548,18.2377,1657
2089,18516,79C0E9CB0924537F3660125B77C46B0B,30321,0,11,11,109.49563,18.29611,1467
2090,18517,79C0E9CB0924537F3660125B77C46B0B,60171,14,18,4,109.51292,18.30694,1569
2091,18525,8FF2A1D1DB84D4F2908F8F04D1C87C16,30291,0,6,6,109.50403,18.27028,1513
2092,18526,8FF2A1D1DB84D4F2908F8F04D1C87C16,31561,7,11,4,109.56792,18.28479,1765
2093,18527,8FF2A1D1DB84D4F2908F8F04D1C87C16,30291,11,13,2,109.50403,18.27028,1513
2094,18528,8FF2A1D1DB84D4F2908F8F04D1C87C16,31561,15,16,1,109.56792,18.28479,1765
2095,18529,8FF2A1D1DB84D4F2908F8F04D1C87C16,30291,18,23,5,109.50403,18.27028,1513
2096,18549,FEF1B208BFBEDDE7B3E7A77BB07513A4,38271,15,23,8,109.62632,18.23049,1956
2097,18605,BF3873D6BE87123B5F43F4E3ACCB9795,30181,16,18,2,109.51597,18.23313,1557
2098,18606,BF3873D6BE87123B5F43F4E3ACCB9795,30854,21,22,1,109.56889,18.27076,1763
2099,18607,029C4A94CFCDA183C21AA100BC002A17,60054,1,2,1,109.3016,18.31229,770
2100,18608,029C4A94CFCDA183C21AA100BC002A17,60411,4,6,2,109.32514,18.30854,869
2101,18609,029C4A94CFCDA183C21AA100BC002A17,30661,8,23,15,109.37028,18.24361,1008
2102,18642,7F632B4875B2736225CD6D350CD25670,30854,7,11,4,109.56889,18.27076,1763
2103,18643,7F632B4875B2736225CD6D350CD25670,31071,11,12,1,109.58257,18.28458,1815
2104,18644,7F632B4875B2736225CD6D350CD25670,30854,14,20,6,109.56889,18.27076,1763
2105,18663,8CD2F16F090DFFBF34897CAC847CB1B1,39151,0,8,8,109.49875,18.25097,1510
2106,18664,8CD2F16F090DFFBF34897CAC847CB1B1,60131,10,14,4,109.49819,18.24778,1509
2107,18665,8CD2F16F090DFFBF34897CAC847CB1B1,60054,16,17,1,109.3016,18.31229,770
2108,18666,8CD2F16F090DFFBF34897CAC847CB1B1,39151,18,23,5,109.49875,18.25097,1510
2109,18716,D879D98E97B1702A34A3B26E676AE92F,30201,0,1,1,109.4909,18.26465,1462
2110,18717,D879D98E97B1702A34A3B26E676AE92F,31271,2,5,3,109.48958,18.26257,1462
2111,18718,D879D98E97B1702A34A3B26E676AE92F,30201,8,9,1,109.4909,18.26465,1462
2112,18719,D879D98E97B1702A34A3B26E676AE92F,30171,12,13,1,109.48458,18.27139,1463
2113,18720,D879D98E97B1702A34A3B26E676AE92F,60401,15,17,2,109.47444,18.27583,1414
2114,18721,D879D98E97B1702A34A3B26E676AE92F,60441,17,18,1,109.46792,18.28604,1366
2115,18722,D879D98E97B1702A34A3B26E676AE92F,31021,19,20,1,109.49021,18.27,1463
2116,18737,1C4E4A12A4530E1BF0A8E58C02423D58,30421,0,8,8,109.50021,18.25861,1511
2117,18738,1C4E4A12A4530E1BF0A8E58C02423D58,31301,11,12,1,109.14493,18.31222,170
2118,18739,1C4E4A12A4530E1BF0A8E58C02423D58,31471,16,18,2,109.34583,18.29563,917
2119,18740,1C4E4A12A4530E1BF0A8E58C02423D58,30201,19,20,1,109.4909,18.26465,1462
2120,18741,1C4E4A12A4530E1BF0A8E58C02423D58,30771,20,23,3,109.49938,18.26042,1511
2121,18771,172CB232BBE684655CFBDFD055BB1CB5,60491,2,15,13,109.43354,18.30847,1269
2122,18772,172CB232BBE684655CFBDFD055BB1CB5,38251,19,21,2,109.49618,18.25493,1510
2123,18773,172CB232BBE684655CFBDFD055BB1CB5,60491,22,23,1,109.43354,18.30847,1269
2124,18784,066CC6CBB5ADF978A93AF5D0C3292806,30071,0,6,6,109.52819,18.30472,1619
2125,18785,066CC6CBB5ADF978A93AF5D0C3292806,31931,7,8,1,109.54771,18.29403,1667
2126,18786,066CC6CBB5ADF978A93AF5D0C3292806,30221,8,10,2,109.57833,18.20222,1802
2130,18811,222E0B6922623CE9FBB280F81068D40E,60201,0,1,1,109.5041,18.2509,1510
2131,18812,222E0B6922623CE9FBB280F81068D40E,30571,3,8,5,109.50243,18.21861,1504
2132,18813,222E0B6922623CE9FBB280F81068D40E,30854,10,11,1,109.56889,18.27076,1763
2133,18814,222E0B6922623CE9FBB280F81068D40E,39321,11,16,5,109.529,18.2167,1604
2134,18815,222E0B6922623CE9FBB280F81068D40E,30361,17,18,1,109.50347,18.24,1508
2135,18816,222E0B6922623CE9FBB280F81068D40E,31071,18,20,2,109.58257,18.28458,1815
2136,18817,222E0B6922623CE9FBB280F81068D40E,30861,20,21,1,109.52722,18.22743,1606
2137,18846,FA3AD6E291717591632932F7645364C4,60381,16,17,1,109.5241,18.22458,1605
2138,18847,FA3AD6E291717591632932F7645364C4,31201,19,22,3,109.51042,18.23819,1558
2139,18857,90D91A493F9482486DCC3B27CF3F61EE,30854,0,11,11,109.56889,18.27076,1763
2140,18858,90D91A493F9482486DCC3B27CF3F61EE,31071,11,13,2,109.58257,18.28458,1815
2141,18859,90D91A493F9482486DCC3B27CF3F61EE,60011,14,16,2,109.48965,18.30222,1468
2142,18870,C5420A088102AB6EF96693A81B24F272,30161,0,14,14,109.50042,18.24389,1508
2143,18893,16E7FE2323920519CAE8DE58935CE9E2,31021,0,1,1,109.49021,18.27,1463
2144,18894,16E7FE2323920519CAE8DE58935CE9E2,30171,2,3,1,109.48458,18.27139,1463
2145,18895,16E7FE2323920519CAE8DE58935CE9E2,31021,5,12,7,109.49021,18.27,1463
2146,18896,16E7FE2323920519CAE8DE58935CE9E2,31521,13,15,2,109.51458,18.22542,1555
2147,18902,7F6E66BC10419161F6457A6D79258EDB,31431,8,12,4,109.44639,18.29042,1316
2148,18903,7F6E66BC10419161F6457A6D79258EDB,38094,12,13,1,109.45403,18.28778,1316
2149,18904,7F6E66BC10419161F6457A6D79258EDB,38251,13,15,2,109.49618,18.25493,1510
2150,18905,7F6E66BC10419161F6457A6D79258EDB,38094,15,16,1,109.45403,18.28778,1316
2151,18906,7F6E66BC10419161F6457A6D79258EDB,30341,17,19,2,109.3625,18.29167,966
2152,18907,7F6E66BC10419161F6457A6D79258EDB,31431,19,21,2,109.44639,18.29042,1316
2153,18908,7F6E66BC10419161F6457A6D79258EDB,60621,22,23,1,109.48354,18.27451,1464
2154,18912,ADF0A7CED2B8DFD757D8FCA8B507C37E,31561,8,12,4,109.56792,18.28479,1765
2155,18913,ADF0A7CED2B8DFD757D8FCA8B507C37E,30854,16,17,1,109.56889,18.27076,1763
2160,18971,6815588633DF1E7C6974D1816808CD27,30711,14,15,1,109.50271,18.25347,1510
2161,18972,6815588633DF1E7C6974D1816808CD27,60214,17,23,6,109.63104,18.24493,2009
2168,19017,72DB83A0C264C593519E48D6DF804A0A,38145,1,7,6,109.378,18.2912,1066
2169,19018,72DB83A0C264C593519E48D6DF804A0A,38023,8,9,1,109.37132,18.28993,1016
2170,19019,72DB83A0C264C593519E48D6DF804A0A,38754,11,14,3,109.74667,18.37382,2430
2174,19029,D4EE8E1A4C04A1FF0596E4221D0B8B42,31071,0,8,8,109.58257,18.28458,1815
2175,19030,D4EE8E1A4C04A1FF0596E4221D0B8B42,30854,8,19,11,109.56889,18.27076,1763
2176,19038,7803AECF4FFC2BF233E3B7ACD0D2E9F8,39181,0,6,6,109.55153,18.28035,1715
2177,19039,7803AECF4FFC2BF233E3B7ACD0D2E9F8,31931,9,10,1,109.54771,18.29403,1667
2178,19040,7803AECF4FFC2BF233E3B7ACD0D2E9F8,39181,12,13,1,109.55153,18.28035,1715
2179,19041,7803AECF4FFC2BF233E3B7ACD0D2E9F8,31931,14,19,5,109.54771,18.29403,1667
2180,19042,7803AECF4FFC2BF233E3B7ACD0D2E9F8,39181,19,23,4,109.55153,18.28035,1715
2181,19043,21C41A61C814FFC904BE2F7898C083F4,39181,14,17,3,109.55153,18.28035,1715
2182,19044,21C41A61C814FFC904BE2F7898C083F4,30854,19,23,4,109.56889,18.27076,1763
2183,19048,32F65A20D32806FF353EB969C069139F,60131,0,7,7,109.49819,18.24778,1509
2184,19049,32F65A20D32806FF353EB969C069139F,38251,7,9,2,109.49618,18.25493,1510
2185,19050,32F65A20D32806FF353EB969C069139F,31781,11,15,4,109.19847,18.2975,367
2186,19051,32F65A20D32806FF353EB969C069139F,31031,19,23,4,109.49979,18.25382,1510
2187,19103,803884DAE228D36B780CDE250AFE5FD1,31145,10,13,3,109.20431,18.30479,369
2188,19114,8F7D135BB250B868AED050A8A87B3A62,60381,14,20,6,109.5241,18.22458,1605
2189,19115,8F7D135BB250B868AED050A8A87B3A62,31031,21,23,2,109.49979,18.25382,1510
2190,19132,5D13B9AAC9BCDFE76312470DC16FC54B,30821,16,17,1,109.43681,18.33639,1274
2191,19133,5D13B9AAC9BCDFE76312470DC16FC54B,38951,18,23,5,109.48097,18.28868,1416
2192,19140,9B389AE8E9B004176803CCEAFF69104A,30361,15,16,1,109.50347,18.24,1508
2193,19141,9B389AE8E9B004176803CCEAFF69104A,30854,17,18,1,109.56889,18.27076,1763
2194,19157,5334281F127888E8146BE3F4F35A8EA8,38105,10,14,4,109.40299,18.29229,1117
2195,19158,5334281F127888E8146BE3F4F35A8EA8,38105,17,23,6,109.40299,18.29229,1117
2196,19181,607C0807B1A95FC610C778BBD11B692C,60401,2,6,4,109.47444,18.27583,1414
2197,19182,607C0807B1A95FC610C778BBD11B692C,31471,10,12,2,109.34583,18.29563,917
2198,19183,607C0807B1A95FC610C778BBD11B692C,31471,13,15,2,109.34583,18.29563,917
2199,19184,607C0807B1A95FC610C778BBD11B692C,30361,16,17,1,109.50347,18.24,1508
2200,19234,7112BF910BB8852FB892FD72D6683B89,31231,0,2,2,109.42597,18.29292,1217
2205,19320,C53DCD50B35716D9CDF363C094C744D7,60381,16,17,1,109.5241,18.22458,1605
2206,19351,6BB4E2A5DCDB0456DBD1871F654F3F5B,31551,0,9,9,109.55868,18.24222,1708
2207,19352,6BB4E2A5DCDB0456DBD1871F654F3F5B,31554,10,11,1,109.55521,18.2459,1709
2208,19353,6BB4E2A5DCDB0456DBD1871F654F3F5B,31781,14,15,1,109.19847,18.2975,367
2209,19354,6BB4E2A5DCDB0456DBD1871F654F3F5B,31471,17,18,1,109.34583,18.29563,917
2210,19355,6BB4E2A5DCDB0456DBD1871F654F3F5B,30421,19,21,2,109.50021,18.25861,1511
2214,19510,3B665E166952840930754F2FE1E3A505,30211,0,8,8,109.49882,18.23931,1508
2215,19511,3B665E166952840930754F2FE1E3A505,30961,8,15,7,109.74042,18.37903,2431
2216,19512,3B665E166952840930754F2FE1E3A505,31511,20,23,3,109.26326,18.40521,635
2217,19528,38F4BE4A665B515DC81C1A78A906BDC2,60371,0,6,6,109.53063,18.30056,1618
2218,19537,632A9EB46E40EB8DE8C99AAD5A0CDFB2,60231,12,13,1,109.49903,18.21972,1504
2219,19538,632A9EB46E40EB8DE8C99AAD5A0CDFB2,30341,14,15,1,109.3625,18.29167,966
2220,19539,632A9EB46E40EB8DE8C99AAD5A0CDFB2,30661,15,19,4,109.37028,18.24361,1008
2231,19577,EBD16061EA20EE33D9344D33735E5205,31261,13,15,2,109.51174,18.2466,1559
2232,19578,EBD16061EA20EE33D9344D33735E5205,31201,18,21,3,109.51042,18.23819,1558
2233,19579,EBD16061EA20EE33D9344D33735E5205,31391,22,23,1,109.50382,18.24285,1508
2234,19580,DAD41A08139183F422619BE0E02762D2,31781,12,14,2,109.19847,18.2975,367
2235,19581,DAD41A08139183F422619BE0E02762D2,31471,15,17,2,109.34583,18.29563,917
2236,19582,DAD41A08139183F422619BE0E02762D2,60631,21,23,2,109.57778,18.27583,1814
2237,19583,3C6B416FA80A7A03E14FC0317D60CB00,60631,16,18,2,109.57778,18.27583,1814
2238,19584,3C6B416FA80A7A03E14FC0317D60CB00,30854,22,23,1,109.56889,18.27076,1763
2239,19647,B12433B5B11FA73A44C6D6FB9BE61089,60401,0,3,3,109.47444,18.27583,1414
2240,19648,B12433B5B11FA73A44C6D6FB9BE61089,31531,5,7,2,109.49583,18.25972,1461
2241,19649,B12433B5B11FA73A44C6D6FB9BE61089,60401,8,10,2,109.47444,18.27583,1414
2242,19650,B12433B5B11FA73A44C6D6FB9BE61089,60161,11,12,1,109.49174,18.26181,1461
2243,19651,B12433B5B11FA73A44C6D6FB9BE61089,38251,13,16,3,109.49618,18.25493,1510
2244,19652,B12433B5B11FA73A44C6D6FB9BE61089,30161,17,18,1,109.50042,18.24389,1508
2245,19667,ACDEAAF45B65DE48CF80A48DBD3C775E,31071,1,6,5,109.58257,18.28458,1815
2246,19668,ACDEAAF45B65DE48CF80A48DBD3C775E,30854,8,9,1,109.56889,18.27076,1763
2247,19669,ACDEAAF45B65DE48CF80A48DBD3C775E,31071,9,18,9,109.58257,18.28458,1815
2248,19670,ACDEAAF45B65DE48CF80A48DBD3C775E,31061,18,20,2,109.53333,18.23257,1607
2253,19722,6B6A1D2EB88367239FCB3C8A121F0BB1,39091,20,21,1,109.50097,18.25222,1510
2254,19726,77C40EC0900CEBC61DCB060F03E5C749,30661,0,8,8,109.37028,18.24361,1008
2255,19727,77C40EC0900CEBC61DCB060F03E5C749,30711,10,11,1,109.50271,18.25347,1510
2256,19728,77C40EC0900CEBC61DCB060F03E5C749,30281,11,13,2,109.50597,18.27583,1514
2257,19729,77C40EC0900CEBC61DCB060F03E5C749,30661,14,23,9,109.37028,18.24361,1008
2258,19745,FBC323A047041F71D8997C22FDE88F17,30181,0,10,10,109.51597,18.23313,1557
2262,19773,CE17A391725DA64890DF44713AF877C7,31864,0,9,9,109.49014,18.28333,1465
2263,19774,CE17A391725DA64890DF44713AF877C7,31145,10,12,2,109.20431,18.30479,369
2264,19779,33F9415FD6B58B5A945236B41FCD67FA,60381,8,9,1,109.5241,18.22458,1605
2265,19780,33F9415FD6B58B5A945236B41FCD67FA,31521,10,11,1,109.51458,18.22542,1555
2266,19781,33F9415FD6B58B5A945236B41FCD67FA,33481,12,15,3,109.67278,18.41278,2187
2267,19782,33F9415FD6B58B5A945236B41FCD67FA,60381,17,20,3,109.5241,18.22458,1605
2268,19790,1A1509AC6E667B603EE3773D1273B7B0,38541,0,11,11,109.73715,18.34875,2426
2269,19791,1A1509AC6E667B603EE3773D1273B7B0,38145,15,18,3,109.378,18.2912,1066
2270,19792,1A1509AC6E667B603EE3773D1273B7B0,30191,21,22,1,109.50361,18.22701,1506
2274,19877,D2BE734582180DAAF2896780F67C646E,38251,12,13,1,109.49618,18.25493,1510
2275,19878,D2BE734582180DAAF2896780F67C646E,31345,14,17,3,109.39,18.29,1066
2276,19879,D2BE734582180DAAF2896780F67C646E,60241,18,21,3,109.53319,18.28667,1616
2277,19880,D2BE734582180DAAF2896780F67C646E,31345,22,23,1,109.39,18.29,1066
2278,19961,6B806948BC9187A91D033B4096721B00,31561,3,4,1,109.56792,18.28479,1765
2279,19962,6B806948BC9187A91D033B4096721B00,31071,6,14,8,109.58257,18.28458,1815
2280,19963,6B806948BC9187A91D033B4096721B00,30961,15,17,2,109.74042,18.37903,2431
2285,19990,01282A80CFB4D1A01E953241ACFECD26,30232,0,7,7,109.6191,18.31701,1971
2286,19991,01282A80CFB4D1A01E953241ACFECD26,30854,10,23,13,109.56889,18.27076,1763
2287,20001,596B04889B7189F5A19701A1FADC1CE1,60441,0,3,3,109.46792,18.28604,1366
2288,20002,596B04889B7189F5A19701A1FADC1CE1,60501,3,6,3,109.48701,18.29021,1466
2289,20003,596B04889B7189F5A19701A1FADC1CE1,31471,10,12,2,109.34583,18.29563,917
2290,20004,596B04889B7189F5A19701A1FADC1CE1,31471,13,15,2,109.34583,18.29563,917
2291,20005,596B04889B7189F5A19701A1FADC1CE1,30361,16,18,2,109.50347,18.24,1508
2292,20033,149F44702DEC8C73589BE6524F0A1FFD,30854,1,12,11,109.56889,18.27076,1763
2293,20034,149F44702DEC8C73589BE6524F0A1FFD,38085,15,23,8,109.6291,18.23625,2007
2294,20069,11150C7195A88F4196F1FFE1C448FD6F,39191,17,18,1,109.51493,18.23472,1557
2295,20070,11150C7195A88F4196F1FFE1C448FD6F,31521,19,23,4,109.51458,18.22542,1555
2299,20104,CA9DF84C64B1C31A61B42BDFD659A4B0,39111,8,10,2,109.5191,18.22597,1555
2300,20105,CA9DF84C64B1C31A61B42BDFD659A4B0,38111,11,12,1,109.52007,18.22403,1555
2301,20106,CA9DF84C64B1C31A61B42BDFD659A4B0,30581,15,17,2,109.62257,18.24951,1959
2302,20107,CA9DF84C64B1C31A61B42BDFD659A4B0,31061,19,20,1,109.53333,18.23257,1607
2303,20108,CA9DF84C64B1C31A61B42BDFD659A4B0,30854,21,23,2,109.56889,18.27076,1763
2304,20128,4E8D704BCF620F593D2EDF35593B050F,60221,0,2,2,109.52569,18.29188,1616
2305,20129,4E8D704BCF620F593D2EDF35593B050F,30121,3,13,10,109.52861,18.27222,1613
2306,20141,3977578BE56276DA0700B04B81DC1356,30851,0,5,5,109.5616,18.27396,1713
2307,20142,3977578BE56276DA0700B04B81DC1356,31561,8,21,13,109.56792,18.28479,1765
2315,20203,C46791F8A63EAA182DA8476F552E0783,30571,0,6,6,109.50243,18.21861,1504
2316,20204,C46791F8A63EAA182DA8476F552E0783,30051,6,8,2,109.48917,18.21215,1453
2317,20205,C46791F8A63EAA182DA8476F552E0783,30571,9,11,2,109.50243,18.21861,1504
2318,20206,C46791F8A63EAA182DA8476F552E0783,30051,12,18,6,109.48917,18.21215,1453
2319,20207,C46791F8A63EAA182DA8476F552E0783,30571,18,21,3,109.50243,18.21861,1504
2320,20242,65DB2325B6E1E7A0D88A5D2D920F9EA1,30671,17,19,2,109.43611,18.30139,1268
2321,20243,65DB2325B6E1E7A0D88A5D2D920F9EA1,30711,20,21,1,109.50271,18.25347,1510
2322,20251,6214A0F588192A4454E59CAEC65A5FD3,31091,9,11,2,109.41201,18.31222,1170
2323,20252,6214A0F588192A4454E59CAEC65A5FD3,30761,12,14,2,109.45201,18.3,1318
2328,20280,4DB778A581941E2A7955D8DA3B7ADAFE,31931,1,6,5,109.54771,18.29403,1667
2329,20281,4DB778A581941E2A7955D8DA3B7ADAFE,60114,8,16,8,109.73028,18.33847,2374
2330,20282,4DB778A581941E2A7955D8DA3B7ADAFE,31931,20,22,2,109.54771,18.29403,1667
2331,20283,8A0382A2385C362EFE2664E8795F133E,31561,0,5,5,109.56792,18.28479,1765
2332,20284,8A0382A2385C362EFE2664E8795F133E,39183,7,23,16,109.55542,18.28208,1715
2333,20291,E190DB99CF7C69343ED6E8D0E6D1804C,30181,17,19,2,109.51597,18.23313,1557
2334,20292,E190DB99CF7C69343ED6E8D0E6D1804C,60081,20,21,1,109.51097,18.22639,1556
2335,20293,E190DB99CF7C69343ED6E8D0E6D1804C,30191,22,23,1,109.50361,18.22701,1506
2336,20296,FF82E60C3B0E4D2A80EC02E3FA5D30BF,31421,0,1,1,109.55382,18.22347,1705
2337,20297,FF82E60C3B0E4D2A80EC02E3FA5D30BF,30854,4,11,7,109.56889,18.27076,1763
2338,20298,FF82E60C3B0E4D2A80EC02E3FA5D30BF,31071,15,23,8,109.58257,18.28458,1815
2339,20314,DDE77D3A656666992FC3458B84010D43,31561,6,9,3,109.56792,18.28479,1765
2340,20315,DDE77D3A656666992FC3458B84010D43,39183,11,13,2,109.55542,18.28208,1715
2341,20316,DDE77D3A656666992FC3458B84010D43,31561,16,17,1,109.56792,18.28479,1765
2342,20325,07FD145FE6C81328C98C6C5C8452E794,30232,1,3,2,109.6191,18.31701,1971
2343,20326,07FD145FE6C81328C98C6C5C8452E794,30854,5,15,10,109.56889,18.27076,1763
2344,20327,07FD145FE6C81328C98C6C5C8452E794,30232,16,18,2,109.6191,18.31701,1971
2345,20328,07FD145FE6C81328C98C6C5C8452E794,30854,18,23,5,109.56889,18.27076,1763
2346,20352,8FAAC7EA21AE7BB6F52A4D0F285944CD,38721,0,8,8,109.50368,18.27542,1514
2347,20353,8FAAC7EA21AE7BB6F52A4D0F285944CD,60201,9,12,3,109.5041,18.2509,1510
2348,20355,18794851E86EA8BA29FCF821CF1F07C3,60631,0,7,7,109.57778,18.27583,1814
2349,20356,18794851E86EA8BA29FCF821CF1F07C3,31071,7,8,1,109.58257,18.28458,1815
2350,20357,18794851E86EA8BA29FCF821CF1F07C3,30854,9,16,7,109.56889,18.27076,1763
2351,20358,18794851E86EA8BA29FCF821CF1F07C3,39111,21,23,2,109.5191,18.22597,1555
2352,20373,286D46B25329E5094759120B95EE260C,31471,14,18,4,109.34583,18.29563,917
2353,20374,286D46B25329E5094759120B95EE260C,60401,19,23,4,109.47444,18.27583,1414
2354,20391,860D8FD1FD466E2189F245D42B766A0C,30271,0,8,8,109.49132,18.23153,1456
2355,20392,860D8FD1FD466E2189F245D42B766A0C,31145,12,14,2,109.20431,18.30479,369
2356,20393,860D8FD1FD466E2189F245D42B766A0C,31471,15,16,1,109.34583,18.29563,917
2361,20402,7FB788587E50C54855D5FD7A453A7032,31491,11,12,1,109.73042,18.38771,2382
2362,20403,7FB788587E50C54855D5FD7A453A7032,60381,14,16,2,109.5241,18.22458,1605
2363,20404,7FB788587E50C54855D5FD7A453A7032,31521,19,22,3,109.51458,18.22542,1555
2364,20416,B0D3EC92066D758E0973317388F707DC,38251,0,7,7,109.49618,18.25493,1510
2365,20418,B0D3EC92066D758E0973317388F707DC,30711,14,23,9,109.50271,18.25347,1510
2369,20500,ADDDEBD546B43FF699A163EB1EA5FE50,30721,0,10,10,109.51597,18.28257,1565
2370,20501,ADDDEBD546B43FF699A163EB1EA5FE50,60501,13,14,1,109.48701,18.29021,1466
2371,20502,ADDDEBD546B43FF699A163EB1EA5FE50,31145,15,17,2,109.20431,18.30479,369
2379,20579,5EB757C8918F704B5295B0BDE01D6841,60371,1,7,6,109.53063,18.30056,1618
2380,20580,5EB757C8918F704B5295B0BDE01D6841,60524,8,16,8,109.42951,18.28993,1216
2381,20581,5EB757C8918F704B5295B0BDE01D6841,38165,17,20,3,109.44847,18.28896,1316
2382,20582,5EB757C8918F704B5295B0BDE01D6841,31701,22,23,1,109.44132,18.28833,1266
2383,20599,CD576F1C1CDFB89E6A99A20E65927346,31561,0,7,7,109.56792,18.28479,1765
2384,20600,CD576F1C1CDFB89E6A99A20E65927346,30854,8,23,15,109.56889,18.27076,1763
2385,20629,3B9061AE88ADC0D0A5DE900FE25015E0,30421,17,20,3,109.50021,18.25861,1511
2386,20630,3B9061AE88ADC0D0A5DE900FE25015E0,30201,20,23,3,109.4909,18.26465,1462
2387,20642,0695D4E7B3E726CA09D841B87798B560,31561,0,6,6,109.56792,18.28479,1765
2388,20643,0695D4E7B3E726CA09D841B87798B560,30854,9,11,2,109.56889,18.27076,1763
2389,20675,9D46ADF861D5CE19E2EA4CF9567B5E97,31021,0,10,10,109.49021,18.27,1463
2390,20676,9D46ADF861D5CE19E2EA4CF9567B5E97,60411,14,22,8,109.32514,18.30854,869
2391,20677,63FBAC0202144B00077561285E6A7F87,30821,0,21,21,109.43681,18.33639,1274
2392,20678,63FBAC0202144B00077561285E6A7F87,30651,22,23,1,109.42611,18.385,1232
2397,20724,AEA3E45BA06B234C15322E381D44AC89,60361,0,1,1,109.51938,18.29681,1567
2398,20725,AEA3E45BA06B234C15322E381D44AC89,30031,1,8,7,109.53681,18.33313,1673
2399,20726,AEA3E45BA06B234C15322E381D44AC89,38484,8,10,2,109.53028,18.31528,1620
2400,20727,AEA3E45BA06B234C15322E381D44AC89,31731,12,17,5,109.15583,18.41208,237
2401,20733,6CC17B7330C92688489D8257513BBA0C,38951,18,20,2,109.48097,18.28868,1416
2402,20734,6CC17B7330C92688489D8257513BBA0C,38951,20,22,2,109.48097,18.28868,1416
2403,20742,33D0BAF81064BA9871C044941C4D0C71,31531,0,1,1,109.49583,18.25972,1461
2404,20743,33D0BAF81064BA9871C044941C4D0C71,30051,2,8,6,109.48917,18.21215,1453
2405,20744,33D0BAF81064BA9871C044941C4D0C71,30211,9,10,1,109.49882,18.23931,1508
2406,20745,33D0BAF81064BA9871C044941C4D0C71,60161,11,13,2,109.49174,18.26181,1461
2407,20746,33D0BAF81064BA9871C044941C4D0C71,38251,13,14,1,109.49618,18.25493,1510
2408,20747,33D0BAF81064BA9871C044941C4D0C71,30161,17,18,1,109.50042,18.24389,1508
2409,20748,33D0BAF81064BA9871C044941C4D0C71,31031,18,19,1,109.49979,18.25382,1510
2410,20749,33D0BAF81064BA9871C044941C4D0C71,30161,20,21,1,109.50042,18.24389,1508
2411,20835,D75685FDDCAB468D56B1A74F09B1658B,30421,19,20,1,109.50021,18.25861,1511
2412,20836,D75685FDDCAB468D56B1A74F09B1658B,30171,21,22,1,109.48458,18.27139,1463
2413,20872,98E9CA76753F47429976B759A0E81031,30854,16,17,1,109.56889,18.27076,1763
2414,20873,98E9CA76753F47429976B759A0E81031,30361,17,19,2,109.50347,18.24,1508
2422,20910,C0854C822B195FB48BF4D1F38FA62F37,60501,17,18,1,109.48701,18.29021,1466
2430,20955,CC4662D0AB761935A19DD4261E4FE213,30854,17,18,1,109.56889,18.27076,1763
2431,20956,CC4662D0AB761935A19DD4261E4FE213,31561,19,23,4,109.56792,18.28479,1765
2435,20965,380545BA5319E58C5CB79C70AD75585C,30241,10,11,1,109.26174,18.3275,622
2436,20966,380545BA5319E58C5CB79C70AD75585C,38251,15,19,4,109.49618,18.25493,1510
2437,20967,380545BA5319E58C5CB79C70AD75585C,31031,20,23,3,109.49979,18.25382,1510
2438,20981,560794A44CA17A43FA34D0FA6C339747,31071,0,1,1,109.58257,18.28458,1815
2439,20982,560794A44CA17A43FA34D0FA6C339747,30854,3,23,20,109.56889,18.27076,1763
2440,21002,48DFD1831E15E711158295290AA7084B,60121,18,23,5,109.74507,18.37472,2430
2441,21037,85586D73EA48B4F4D520D899B0BE0554,30291,0,5,5,109.50403,18.27028,1513
2442,21038,85586D73EA48B4F4D520D899B0BE0554,30854,7,8,1,109.56889,18.27076,1763
2443,21039,85586D73EA48B4F4D520D899B0BE0554,31071,8,10,2,109.58257,18.28458,1815
2444,21040,85586D73EA48B4F4D520D899B0BE0554,30851,13,15,2,109.5616,18.27396,1713
2445,21041,85586D73EA48B4F4D520D899B0BE0554,30291,20,23,3,109.50403,18.27028,1513
2449,21098,3C162B8B833533A8C79FA08500420144,30711,16,17,1,109.50271,18.25347,1510
2450,21099,3C162B8B833533A8C79FA08500420144,60571,18,19,1,109.50722,18.25056,1510
2451,21100,3C162B8B833533A8C79FA08500420144,30711,20,23,3,109.50271,18.25347,1510
2452,21103,BE84D9BAD945F657EF3BFD7A07C2842B,39154,0,7,7,109.50201,18.25681,1511
2453,21104,BE84D9BAD945F657EF3BFD7A07C2842B,60211,8,17,9,109.63549,18.26049,2011
2458,21116,CAE196EC03060C8EDEBE686324EFE5C1,30271,15,16,1,109.49132,18.23153,1456
2459,21117,CAE196EC03060C8EDEBE686324EFE5C1,60084,16,18,2,109.4984,18.2334,1507
2460,21118,CAE196EC03060C8EDEBE686324EFE5C1,60231,20,21,1,109.49903,18.21972,1504
2461,21130,13166628932DF36C0AD7B1DB5811240A,60591,0,6,6,109.61118,18.21715,1904
2462,21131,13166628932DF36C0AD7B1DB5811240A,30854,6,8,2,109.56889,18.27076,1763
2463,21132,13166628932DF36C0AD7B1DB5811240A,60631,12,13,1,109.57778,18.27583,1814
2464,21133,13166628932DF36C0AD7B1DB5811240A,30854,14,17,3,109.56889,18.27076,1763
2465,21134,13166628932DF36C0AD7B1DB5811240A,60591,19,23,4,109.61118,18.21715,1904
2466,21140,B61666307486DD531F980787F0F8A7B7,60631,1,15,14,109.57778,18.27583,1814
2467,21141,B61666307486DD531F980787F0F8A7B7,30854,20,23,3,109.56889,18.27076,1763
2468,21155,99EC19A65A2EA4B9365521157FB29A4F,60381,0,8,8,109.5241,18.22458,1605
2469,21157,99EC19A65A2EA4B9365521157FB29A4F,31521,17,22,5,109.51458,18.22542,1555
2470,21169,2C5F898948A2B7909519666936FBF333,31145,15,17,2,109.20431,18.30479,369
2471,21170,2C5F898948A2B7909519666936FBF333,38707,18,23,5,109.73778,18.35368,2427
2482,21235,7421066246AAD1C230E7E2A7ADF06E9D,31071,0,5,5,109.58257,18.28458,1815
2483,21236,7421066246AAD1C230E7E2A7ADF06E9D,60631,6,14,8,109.57778,18.27583,1814
2484,21237,7421066246AAD1C230E7E2A7ADF06E9D,31031,17,19,2,109.49979,18.25382,1510
2485,21238,7421066246AAD1C230E7E2A7ADF06E9D,60631,21,22,1,109.57778,18.27583,1814
2490,21270,A01E2FD84FFE4D782E40311D1ABC1ECB,31221,0,11,11,109.61333,18.26833,1913
2491,21271,A01E2FD84FFE4D782E40311D1ABC1ECB,31031,13,14,1,109.49979,18.25382,1510
2492,21272,A01E2FD84FFE4D782E40311D1ABC1ECB,38754,15,17,2,109.74667,18.37382,2430
2493,21273,A01E2FD84FFE4D782E40311D1ABC1ECB,30441,22,23,1,109.64021,18.25424,2010
2494,21274,B1BCC89C2F3E15CBE4070B0B890371C7,60631,3,4,1,109.57778,18.27583,1814
2495,21275,B1BCC89C2F3E15CBE4070B0B890371C7,31101,8,10,2,109.65389,18.23403,2057
2496,21276,B1BCC89C2F3E15CBE4070B0B890371C7,30581,10,11,1,109.62257,18.24951,1959
2497,21284,6862E1409834047709EBD3185EEA79B3,38141,8,19,11,109.39479,18.2916,1116
2498,21285,6862E1409834047709EBD3185EEA79B3,38141,19,23,4,109.39479,18.2916,1116
2499,21334,8B7C10EDB3885C1AA91B5F5776CD55A0,30031,0,12,12,109.53681,18.33313,1673
2500,21337,8B7C10EDB3885C1AA91B5F5776CD55A0,30031,21,23,2,109.53681,18.33313,1673
2501,21364,213DAB3EDFD90975944C0716CF1617C5,38541,17,19,2,109.73715,18.34875,2426
2502,21365,213DAB3EDFD90975944C0716CF1617C5,60381,21,22,1,109.5241,18.22458,1605
2503,21366,C1602FB5A20BD98313F7CC13F431D061,30361,0,4,4,109.50347,18.24,1508
2504,21367,C1602FB5A20BD98313F7CC13F431D061,60084,4,9,5,109.4984,18.2334,1507
2505,21368,C1602FB5A20BD98313F7CC13F431D061,60504,9,11,2,109.47917,18.28903,1416
2506,21369,C1602FB5A20BD98313F7CC13F431D061,30361,11,21,10,109.50347,18.24,1508
2507,21402,1D10133A3A6B6A1226F963E2F33A13EC,38707,0,13,13,109.73778,18.35368,2427
2508,21419,489A7E41DEF66D4D4586FE690272FF2B,31781,13,15,2,109.19847,18.2975,367
2509,21420,489A7E41DEF66D4D4586FE690272FF2B,60054,16,17,1,109.3016,18.31229,770
2510,21421,489A7E41DEF66D4D4586FE690272FF2B,60084,19,22,3,109.4984,18.2334,1507
2511,21436,5AB036BD4852DC840A52FF542200B93C,31461,0,9,9,109.5091,18.25389,1510
2512,21437,5AB036BD4852DC840A52FF542200B93C,60221,9,11,2,109.52569,18.29188,1616
2513,21438,5AB036BD4852DC840A52FF542200B93C,31851,14,18,4,109.71736,18.29007,2316
2514,21439,5AB036BD4852DC840A52FF542200B93C,31461,20,23,3,109.5091,18.25389,1510
2515,21440,8A01C766ABD659C6DF7A6AE90AA81678,31521,0,7,7,109.51458,18.22542,1555
2516,21441,8A01C766ABD659C6DF7A6AE90AA81678,31521,8,15,7,109.51458,18.22542,1555
2517,21463,B37777551ADDE84A1FDFE1FF465C24DC,30921,3,6,3,109.53903,18.29451,1667
2518,21464,B37777551ADDE84A1FDFE1FF465C24DC,31931,7,22,15,109.54771,18.29403,1667
2519,21497,E6006DC9696B1830A4C76DE6D9370D13,31531,15,19,4,109.49583,18.25972,1461
2520,21498,E6006DC9696B1830A4C76DE6D9370D13,38251,19,21,2,109.49618,18.25493,1510
2521,21499,E6006DC9696B1830A4C76DE6D9370D13,31531,21,23,2,109.49583,18.25972,1461
2522,21544,D1827685A895D0D5AAA2F3359D099E94,31521,0,8,8,109.51458,18.22542,1555
2523,21545,D1827685A895D0D5AAA2F3359D099E94,60541,11,13,2,109.4084,18.29208,1167
2524,21546,D1827685A895D0D5AAA2F3359D099E94,31521,16,17,1,109.51458,18.22542,1555
2525,21547,D1827685A895D0D5AAA2F3359D099E94,60381,18,20,2,109.5241,18.22458,1605
2526,21548,D1827685A895D0D5AAA2F3359D099E94,31521,21,23,2,109.51458,18.22542,1555
2527,21615,F46FDDC29A8850C2C04367141B6440B6,30854,1,8,7,109.56889,18.27076,1763
2528,21616,F46FDDC29A8850C2C04367141B6440B6,31071,11,12,1,109.58257,18.28458,1815
2529,21617,F46FDDC29A8850C2C04367141B6440B6,30854,13,14,1,109.56889,18.27076,1763
2530,21618,F46FDDC29A8850C2C04367141B6440B6,31101,16,18,2,109.65389,18.23403,2057
2531,21619,F46FDDC29A8850C2C04367141B6440B6,30421,19,20,1,109.50021,18.25861,1511
2532,21626,1952B2BB316D2BB82BFA729C9CE4CADA,39183,17,19,2,109.55542,18.28208,1715
2533,21627,1952B2BB316D2BB82BFA729C9CE4CADA,30111,21,22,1,109.47583,18.30542,1419
2541,21674,1877AE3F054132FD529E292AD524A6EA,30854,16,17,1,109.56889,18.27076,1763
2542,21675,1877AE3F054132FD529E292AD524A6EA,30731,19,20,1,109.50944,18.22306,1555
2543,21676,1877AE3F054132FD529E292AD524A6EA,30854,20,22,2,109.56889,18.27076,1763
2544,21768,6CD060321C42DD7917A0544141DE86DE,30111,0,8,8,109.47583,18.30542,1419
2545,21769,6CD060321C42DD7917A0544141DE86DE,31471,9,10,1,109.34583,18.29563,917
2546,21770,6CD060321C42DD7917A0544141DE86DE,30731,15,17,2,109.50944,18.22306,1555
2550,21829,75103A7721D2350907ADF04820429536,38706,0,10,10,109.74625,18.37097,2430
2551,21830,75103A7721D2350907ADF04820429536,31471,13,15,2,109.34583,18.29563,917
2552,21831,75103A7721D2350907ADF04820429536,60121,17,23,6,109.74507,18.37472,2430
2553,21833,A0592EF33D66B7A76C86B07EBD78C8A3,60614,12,13,1,109.48799,18.29521,1467
2554,21834,A0592EF33D66B7A76C86B07EBD78C8A3,38707,14,22,8,109.73778,18.35368,2427
2555,21836,5ED5DC921249A25E4C2998A56E67A3A8,31534,11,12,1,109.49368,18.25806,1461
2556,21837,5ED5DC921249A25E4C2998A56E67A3A8,31471,14,16,2,109.34583,18.29563,917
2557,21838,5ED5DC921249A25E4C2998A56E67A3A8,31531,18,19,1,109.49583,18.25972,1461
2558,21839,5ED5DC921249A25E4C2998A56E67A3A8,30681,20,21,1,109.48493,18.26917,1463
2559,21848,E01AE51461B7CBCB8D8E0EDABDD6770A,38154,16,17,1,109.5266,18.28278,1615
2560,21849,E01AE51461B7CBCB8D8E0EDABDD6770A,30071,17,20,3,109.52819,18.30472,1619
2561,21850,E01AE51461B7CBCB8D8E0EDABDD6770A,60371,20,22,2,109.53063,18.30056,1618
2562,21859,6F25B46DE233F84CBE88187DB2427FA9,30201,0,6,6,109.4909,18.26465,1462
2563,21860,6F25B46DE233F84CBE88187DB2427FA9,31021,8,10,2,109.49021,18.27,1463
2564,21861,6F25B46DE233F84CBE88187DB2427FA9,31861,10,12,2,109.49042,18.27549,1464
2565,21862,6F25B46DE233F84CBE88187DB2427FA9,31021,12,16,4,109.49021,18.27,1463
2566,21863,6F25B46DE233F84CBE88187DB2427FA9,30201,17,23,6,109.4909,18.26465,1462
2570,21867,27BCEF3137923B84211F08830816C810,30851,0,7,7,109.5616,18.27396,1713
2571,21868,27BCEF3137923B84211F08830816C810,61011,9,14,5,109.60653,18.19076,1900
2572,21870,27BCEF3137923B84211F08830816C810,30851,21,23,2,109.5616,18.27396,1713
2573,21886,5426296000364EE32711CD0E73D782C8,31851,16,17,1,109.71736,18.29007,2316
2574,21887,5426296000364EE32711CD0E73D782C8,31031,20,21,1,109.49979,18.25382,1510
2575,21929,357A311CCD3254D76B63BF85FD2D2D37,60371,0,12,12,109.53063,18.30056,1618
2576,21930,357A311CCD3254D76B63BF85FD2D2D37,60591,12,18,6,109.61118,18.21715,1904
2577,21997,3D408742D0773F860BA62D41C728BA97,31071,0,7,7,109.58257,18.28458,1815
2578,21998,3D408742D0773F860BA62D41C728BA97,30854,10,12,2,109.56889,18.27076,1763
2579,21999,3D408742D0773F860BA62D41C728BA97,38821,13,16,3,109.50354,18.25243,1510
2586,22050,B4C8402AE2B2A41C5967767B834E807A,31251,0,7,7,109.18528,18.2975,317
2587,22051,B4C8402AE2B2A41C5967767B834E807A,30661,9,12,3,109.37028,18.24361,1008
2588,22052,B4C8402AE2B2A41C5967767B834E807A,31471,12,14,2,109.34583,18.29563,917
2589,22053,B4C8402AE2B2A41C5967767B834E807A,30741,15,23,8,109.49833,18.28681,1516
2593,22065,8A2602EE97ED1F19C3F8048B259C52D2,60381,8,10,2,109.5241,18.22458,1605
2594,22066,8A2602EE97ED1F19C3F8048B259C52D2,31521,11,16,5,109.51458,18.22542,1555
2595,22067,8A2602EE97ED1F19C3F8048B259C52D2,60381,19,20,1,109.5241,18.22458,1605
2596,22086,F6BB537A775832A45DF7D139A32B29FF,31851,0,12,12,109.71736,18.29007,2316
2597,22087,F6BB537A775832A45DF7D139A32B29FF,38754,13,18,5,109.74667,18.37382,2430
2598,22152,6F991F6415332A5D020632F1E0FDD144,60301,16,23,7,109.60715,18.30993,1919
2603,22174,2D39AE6120F2674000C6DBB8A6E572A0,30854,18,20,2,109.56889,18.27076,1763
2604,22175,2D39AE6120F2674000C6DBB8A6E572A0,31945,21,23,2,109.58021,18.29403,1817
2609,22192,07E52E5D3C425C98B9D60E80ED39E24E,30721,0,11,11,109.51597,18.28257,1565
2610,22193,07E52E5D3C425C98B9D60E80ED39E24E,39191,12,13,1,109.51493,18.23472,1557
2611,22194,07E52E5D3C425C98B9D60E80ED39E24E,30721,14,17,3,109.51597,18.28257,1565
2612,22195,07E52E5D3C425C98B9D60E80ED39E24E,39111,17,19,2,109.5191,18.22597,1555
2613,22196,07E52E5D3C425C98B9D60E80ED39E24E,30201,21,23,2,109.4909,18.26465,1462
2620,22243,533C598FBE9A80A69F24B4E517B0CF08,30741,0,8,8,109.49833,18.28681,1516
2621,22245,533C598FBE9A80A69F24B4E517B0CF08,31351,21,22,1,109.4959,18.28417,1465
2622,22277,F605546ADA1ADB3E2AF3E74D19682812,31931,2,7,5,109.54771,18.29403,1667
2623,22278,F605546ADA1ADB3E2AF3E74D19682812,60221,9,19,10,109.52569,18.29188,1616
2624,22297,EE9DF0DA6560AA8A0EC24726BBEB6A9A,31741,16,18,2,109.10229,18.37271,30
2625,22339,94C4D5691F7DFC1AB38806AFFAC1389E,31931,14,15,1,109.54771,18.29403,1667
2626,22340,94C4D5691F7DFC1AB38806AFFAC1389E,30921,18,23,5,109.53903,18.29451,1667
2627,22358,B9D2B06CFEEA354176E1B3D8B1E20D67,31205,1,2,1,109.51111,18.23736,1557
2628,22359,B9D2B06CFEEA354176E1B3D8B1E20D67,30271,3,9,6,109.49132,18.23153,1456
2629,22360,B9D2B06CFEEA354176E1B3D8B1E20D67,60041,13,15,2,109.39889,18.31944,1121
2630,22361,B9D2B06CFEEA354176E1B3D8B1E20D67,30201,18,19,1,109.4909,18.26465,1462
2631,22362,B9D2B06CFEEA354176E1B3D8B1E20D67,31221,22,23,1,109.61333,18.26833,1913
2632,22374,9FC721E86703223349C05C95FE4BBB6F,60087,0,2,2,109.50688,18.22299,1505
2633,22375,9FC721E86703223349C05C95FE4BBB6F,60081,3,11,8,109.51097,18.22639,1556
2634,22376,9FC721E86703223349C05C95FE4BBB6F,60381,11,14,3,109.5241,18.22458,1605
2635,22377,9FC721E86703223349C05C95FE4BBB6F,31521,14,20,6,109.51458,18.22542,1555
2636,22378,9FC721E86703223349C05C95FE4BBB6F,60087,21,23,2,109.50688,18.22299,1505
2637,22385,B616D64706FE00CB4CDA3E3D124853B8,31671,1,7,6,109.38965,18.29813,1068
2638,22386,B616D64706FE00CB4CDA3E3D124853B8,33481,9,12,3,109.67278,18.41278,2187
2639,22387,B616D64706FE00CB4CDA3E3D124853B8,31671,15,22,7,109.38965,18.29813,1068
2643,22415,B4C8A8F357A5CDF8BB918E4017446951,39181,1,14,13,109.55153,18.28035,1715
2644,22416,B4C8A8F357A5CDF8BB918E4017446951,31931,14,16,2,109.54771,18.29403,1667
2645,22462,E504C7D2F929BB396CEA3A3E20B74D1F,38111,19,21,2,109.52007,18.22403,1555
2646,22463,E504C7D2F929BB396CEA3A3E20B74D1F,31521,21,23,2,109.51458,18.22542,1555
2647,22480,DBCB3A87F89C2AC16ED8152735BE6F75,30271,8,12,4,109.49132,18.23153,1456
2648,22481,DBCB3A87F89C2AC16ED8152735BE6F75,30161,13,15,2,109.50042,18.24389,1508
2649,22482,DBCB3A87F89C2AC16ED8152735BE6F75,38251,17,19,2,109.49618,18.25493,1510
2650,22483,DBCB3A87F89C2AC16ED8152735BE6F75,30271,22,23,1,109.49132,18.23153,1456
2651,22502,E741472B5FE1391FC41630B6DBF2DFDE,31351,0,10,10,109.4959,18.28417,1465
2652,22503,E741472B5FE1391FC41630B6DBF2DFDE,31471,13,14,1,109.34583,18.29563,917
2653,22504,E741472B5FE1391FC41630B6DBF2DFDE,31471,15,18,3,109.34583,18.29563,917
2654,22505,E741472B5FE1391FC41630B6DBF2DFDE,60541,21,23,2,109.4084,18.29208,1167
2655,22509,AE1C9860915542FE7A0A03D0A133503E,30854,0,14,14,109.56889,18.27076,1763
2656,22510,AE1C9860915542FE7A0A03D0A133503E,30232,15,16,1,109.6191,18.31701,1971
2657,22511,AE1C9860915542FE7A0A03D0A133503E,31071,19,20,1,109.58257,18.28458,1815
2658,22512,AE1C9860915542FE7A0A03D0A133503E,30854,20,22,2,109.56889,18.27076,1763
2659,22533,122D07F80E4FAC68FAE7EDBB2DF1AFA3,30854,1,7,6,109.56889,18.27076,1763
2660,22534,122D07F80E4FAC68FAE7EDBB2DF1AFA3,31071,8,15,7,109.58257,18.28458,1815
2661,22537,AC0473CD58A736C6A311A0DEEA929506,60161,20,22,2,109.49174,18.26181,1461
2662,22538,AC0473CD58A736C6A311A0DEEA929506,38251,22,23,1,109.49618,18.25493,1510
2663,22553,85113926FD58DF2481DE297BC312E23D,38094,18,22,4,109.45403,18.28778,1316
2664,22554,8DED3AF2A13BD7FD99C437CF1C11E83B,31021,0,14,14,109.49021,18.27,1463
2665,22589,5274FB91D917823AD6AE120EE7F21099,31931,0,7,7,109.54771,18.29403,1667
2666,22590,5274FB91D917823AD6AE120EE7F21099,60591,7,18,11,109.61118,18.21715,1904
2667,22591,5274FB91D917823AD6AE120EE7F21099,31931,18,23,5,109.54771,18.29403,1667
2668,22633,A9FCE0049DB44FE004EAFBF5B783F4A5,31945,15,18,3,109.58021,18.29403,1817
2669,22634,A9FCE0049DB44FE004EAFBF5B783F4A5,30854,19,20,1,109.56889,18.27076,1763
2670,22635,A9FCE0049DB44FE004EAFBF5B783F4A5,30921,21,23,2,109.53903,18.29451,1667
2674,22701,83F8DEFB45E9970F803B6E01CF53475C,38961,2,15,13,109.50847,18.23514,1507
2675,22702,83F8DEFB45E9970F803B6E01CF53475C,31021,18,20,2,109.49021,18.27,1463
2676,22717,BE586ACB441383CC10D7CF3923850B73,31931,0,21,21,109.54771,18.29403,1667
2677,22718,BE586ACB441383CC10D7CF3923850B73,60371,22,23,1,109.53063,18.30056,1618
2684,22764,E18D9C831A7994692184CCEFAFB97A2D,31521,0,12,12,109.51458,18.22542,1555
2685,22765,E18D9C831A7994692184CCEFAFB97A2D,31101,14,16,2,109.65389,18.23403,2057
2686,22766,E18D9C831A7994692184CCEFAFB97A2D,60381,18,20,2,109.5241,18.22458,1605
2687,22767,E18D9C831A7994692184CCEFAFB97A2D,31521,20,23,3,109.51458,18.22542,1555
2688,22791,29C07CFFD8A4887F4FBEBB6647F0059A,30291,0,9,9,109.50403,18.27028,1513
2689,22805,96F98526707B06BE1263CCD4F72E07A1,31071,1,8,7,109.58257,18.28458,1815
2690,22806,96F98526707B06BE1263CCD4F72E07A1,30854,12,16,4,109.56889,18.27076,1763
2691,22834,E24A5B42239D002A0BE02B9D8DF63D1B,30731,2,6,4,109.50944,18.22306,1555
2692,22835,E24A5B42239D002A0BE02B9D8DF63D1B,30341,7,8,1,109.3625,18.29167,966
2693,22836,E24A5B42239D002A0BE02B9D8DF63D1B,30661,9,12,3,109.37028,18.24361,1008
2694,22837,E24A5B42239D002A0BE02B9D8DF63D1B,31471,14,15,1,109.34583,18.29563,917
2695,22838,2655BE064A1397AB1A41DE42D8C35874,60054,15,16,1,109.3016,18.31229,770
2696,22839,2655BE064A1397AB1A41DE42D8C35874,30201,20,21,1,109.4909,18.26465,1462
2697,22856,71048DA762610C5657DD6D8242833DC9,30234,0,7,7,109.60681,18.29979,1918
2698,22857,71048DA762610C5657DD6D8242833DC9,30854,8,10,2,109.56889,18.27076,1763
2703,22893,409F5E8F01172D32BBE91132149C037E,31205,0,12,12,109.51111,18.23736,1557
2704,22894,409F5E8F01172D32BBE91132149C037E,38371,14,15,1,109.50972,18.23924,1558
2705,22895,409F5E8F01172D32BBE91132149C037E,30421,16,18,2,109.50021,18.25861,1511
2706,22896,409F5E8F01172D32BBE91132149C037E,30361,18,20,2,109.50347,18.24,1508
2707,22897,409F5E8F01172D32BBE91132149C037E,38127,20,22,2,109.50833,18.27222,1513
2708,22918,5D9D6200DB70228B7F96ACE5A37B7578,31931,2,8,6,109.54771,18.29403,1667
2709,22919,5D9D6200DB70228B7F96ACE5A37B7578,60361,11,22,11,109.51938,18.29681,1567
2710,22942,3963776B8D4E0FE3D76B833D367A499E,31231,0,10,10,109.42597,18.29292,1217
2711,22943,3963776B8D4E0FE3D76B833D367A499E,30581,13,15,2,109.62257,18.24951,1959
2712,22944,3963776B8D4E0FE3D76B833D367A499E,30441,17,18,1,109.64021,18.25424,2010
2713,22945,3963776B8D4E0FE3D76B833D367A499E,31231,19,23,4,109.42597,18.29292,1217
2714,22957,028D8E55D4EA2BBCD89011B5A8443A67,31471,15,16,1,109.34583,18.29563,917
2715,22958,028D8E55D4EA2BBCD89011B5A8443A67,60411,17,21,4,109.32514,18.30854,869
2716,23007,ECB0D6F4F8CE3A022BB643A50974CBE5,30121,0,13,13,109.52861,18.27222,1613
2717,23040,DBB710D279E76C79F1E4B0766F579F8A,31071,0,5,5,109.58257,18.28458,1815
2718,23041,DBB710D279E76C79F1E4B0766F579F8A,30854,7,17,10,109.56889,18.27076,1763
2719,23062,AF7BD38BAFE82C31043D932015C23584,38251,0,8,8,109.49618,18.25493,1510
2720,23063,AF7BD38BAFE82C31043D932015C23584,31781,12,13,1,109.19847,18.2975,367
2721,23071,73EAC1341C5005A58B26B1A52457F38B,31181,0,15,15,109.50382,18.24813,1509
2722,23072,73EAC1341C5005A58B26B1A52457F38B,31471,17,18,1,109.34583,18.29563,917
2726,23120,0D9082BEF5A52C17C659BB5099A114E7,60411,0,13,13,109.32514,18.30854,869
2727,23121,0D9082BEF5A52C17C659BB5099A114E7,31471,15,16,1,109.34583,18.29563,917
2728,23122,0D9082BEF5A52C17C659BB5099A114E7,30661,16,18,2,109.37028,18.24361,1008
2729,23123,0D9082BEF5A52C17C659BB5099A114E7,60411,18,23,5,109.32514,18.30854,869
2730,23143,E34FF61340C5B86CF9FD0AD454D26266,60331,0,6,6,109.505,18.26507,1512
2731,23144,E34FF61340C5B86CF9FD0AD454D26266,60221,7,10,3,109.52569,18.29188,1616
2732,23145,E34FF61340C5B86CF9FD0AD454D26266,30911,12,13,1,109.50493,18.26181,1511
2733,23146,E34FF61340C5B86CF9FD0AD454D26266,60221,14,16,2,109.52569,18.29188,1616
2734,23147,E34FF61340C5B86CF9FD0AD454D26266,30911,18,20,2,109.50493,18.26181,1511
2735,23148,E34FF61340C5B86CF9FD0AD454D26266,60331,21,23,2,109.505,18.26507,1512
2736,23202,70E36A4B82878626B569C66E46C7827C,39091,0,8,8,109.50097,18.25222,1510
2737,23203,70E36A4B82878626B569C66E46C7827C,38754,13,16,3,109.74667,18.37382,2430
2738,23239,76F6A54588C8DF7DDADFC50CAA11D44C,39101,16,17,1,109.50132,18.24931,1509
2739,23240,76F6A54588C8DF7DDADFC50CAA11D44C,30361,19,20,1,109.50347,18.24,1508
2740,23268,680051EC44844DA68AE2B74B206794D6,38751,0,7,7,109.74903,18.37639,2481
2741,23269,680051EC44844DA68AE2B74B206794D6,31781,9,11,2,109.19847,18.2975,367
2742,23270,680051EC44844DA68AE2B74B206794D6,31471,12,13,1,109.34583,18.29563,917
2743,23271,680051EC44844DA68AE2B74B206794D6,31521,14,16,2,109.51458,18.22542,1555
2744,23272,680051EC44844DA68AE2B74B206794D6,30961,21,22,1,109.74042,18.37903,2431
2745,23273,017B0507B62FB4DD164A656551AFBA4F,38094,16,19,3,109.45403,18.28778,1316
2746,23274,017B0507B62FB4DD164A656551AFBA4F,60401,21,22,1,109.47444,18.27583,1414
2747,23284,51061B3DE820AF1C1C713EF684728003,30854,1,3,2,109.56889,18.27076,1763
2748,23285,51061B3DE820AF1C1C713EF684728003,31071,4,6,2,109.58257,18.28458,1815
2749,23286,51061B3DE820AF1C1C713EF684728003,30854,8,9,1,109.56889,18.27076,1763
2750,23287,51061B3DE820AF1C1C713EF684728003,60631,10,12,2,109.57778,18.27583,1814
2751,23288,51061B3DE820AF1C1C713EF684728003,31071,12,14,2,109.58257,18.28458,1815
2752,23289,51061B3DE820AF1C1C713EF684728003,30854,14,16,2,109.56889,18.27076,1763
2753,23290,51061B3DE820AF1C1C713EF684728003,31071,18,21,3,109.58257,18.28458,1815
2754,23293,7235447B1B76CF7498ADD1835D8DDC17,38111,0,3,3,109.52007,18.22403,1555
2755,23294,7235447B1B76CF7498ADD1835D8DDC17,39321,3,4,1,109.529,18.2167,1604
2756,23295,7235447B1B76CF7498ADD1835D8DDC17,38111,6,9,3,109.52007,18.22403,1555
2757,23296,7235447B1B76CF7498ADD1835D8DDC17,30661,14,17,3,109.37028,18.24361,1008
2758,23297,7235447B1B76CF7498ADD1835D8DDC17,31031,18,19,1,109.49979,18.25382,1510
2759,23298,7235447B1B76CF7498ADD1835D8DDC17,38111,21,22,1,109.52007,18.22403,1555
2760,23364,5D56123A0C68AD72DA20EA4585A51B48,60381,0,8,8,109.5241,18.22458,1605
2761,23365,5D56123A0C68AD72DA20EA4585A51B48,30861,9,14,5,109.52722,18.22743,1606
2762,23366,5D56123A0C68AD72DA20EA4585A51B48,31473,15,17,2,109.34792,18.29465,917
2763,23367,5D56123A0C68AD72DA20EA4585A51B48,31521,19,20,1,109.51458,18.22542,1555
2764,23368,5D56123A0C68AD72DA20EA4585A51B48,30861,20,22,2,109.52722,18.22743,1606
2765,23381,ACC390C77025BECAF4CD259D41E8F314,30232,1,9,8,109.6191,18.31701,1971
2766,23382,ACC390C77025BECAF4CD259D41E8F314,30854,9,13,4,109.56889,18.27076,1763
2767,23383,ACC390C77025BECAF4CD259D41E8F314,30232,14,16,2,109.6191,18.31701,1971
2768,23384,ACC390C77025BECAF4CD259D41E8F314,30854,16,20,4,109.56889,18.27076,1763
2769,23385,ACC390C77025BECAF4CD259D41E8F314,30232,21,23,2,109.6191,18.31701,1971
2770,23414,8EE2B55B9C0133D9EB3C4198C24C9CD9,30201,18,20,2,109.4909,18.26465,1462
2771,23415,8EE2B55B9C0133D9EB3C4198C24C9CD9,30361,21,22,1,109.50347,18.24,1508
2776,23501,300A1885BA30CEEF17B7B730D91F8A14,60571,17,23,6,109.50722,18.25056,1510
2777,23502,DC9973204E62AA99FA79F0696CF6C0F6,30854,11,13,2,109.56889,18.27076,1763
2778,23503,DC9973204E62AA99FA79F0696CF6C0F6,39151,16,18,2,109.49875,18.25097,1510
2779,23504,DC9973204E62AA99FA79F0696CF6C0F6,30854,19,22,3,109.56889,18.27076,1763
2787,23547,8FE97C1052D63DE830211C405D8F5442,30854,8,9,1,109.56889,18.27076,1763
2788,23548,8FE97C1052D63DE830211C405D8F5442,39183,14,17,3,109.55542,18.28208,1715
2789,23549,8FE97C1052D63DE830211C405D8F5442,60631,17,19,2,109.57778,18.27583,1814
2790,23550,8FE97C1052D63DE830211C405D8F5442,30854,20,21,1,109.56889,18.27076,1763
2791,23551,683051AEA9BDC540FAFA471A20E3F6EF,31531,0,6,6,109.49583,18.25972,1461
2792,23557,377A324496E54511961704972731A3D5,38121,13,14,1,109.51361,18.27813,1564
2793,23558,377A324496E54511961704972731A3D5,31521,17,19,2,109.51458,18.22542,1555
2794,23643,117CDF2D41FFFF099F62724091D8605A,60631,7,14,7,109.57778,18.27583,1814
2795,23644,117CDF2D41FFFF099F62724091D8605A,30861,16,17,1,109.52722,18.22743,1606
2796,23645,117CDF2D41FFFF099F62724091D8605A,60631,19,20,1,109.57778,18.27583,1814
2797,23653,0E4E3873A84F880D37A184F5409B3BB0,31531,19,20,1,109.49583,18.25972,1461
2798,23654,0E4E3873A84F880D37A184F5409B3BB0,38826,21,23,2,109.50326,18.25514,1510
2803,23748,0036A867CCF4154EF4E16AF8E847E92C,38251,18,19,1,109.49618,18.25493,1510
2804,23749,0036A867CCF4154EF4E16AF8E847E92C,60551,22,23,1,109.42722,18.30111,1218
2805,23752,B67683EC50B392E6E6AD95EC7DF23326,38094,1,12,11,109.45403,18.28778,1316
2806,23753,B67683EC50B392E6E6AD95EC7DF23326,60201,13,16,3,109.5041,18.2509,1510
2807,23754,B67683EC50B392E6E6AD95EC7DF23326,31861,16,17,1,109.49042,18.27549,1464
2808,23755,B67683EC50B392E6E6AD95EC7DF23326,30171,18,22,4,109.48458,18.27139,1463
2809,23767,C1A86408F22C4A96CA9DED3C9439B426,30861,0,11,11,109.52722,18.22743,1606
2810,23768,C1A86408F22C4A96CA9DED3C9439B426,31061,12,13,1,109.53333,18.23257,1607
2811,23774,C2964FCBFAEAE420B9E51BE5763EEB7D,38251,0,9,9,109.49618,18.25493,1510
2812,23775,C2964FCBFAEAE420B9E51BE5763EEB7D,31781,13,15,2,109.19847,18.2975,367
2813,23776,C2964FCBFAEAE420B9E51BE5763EEB7D,38251,19,23,4,109.49618,18.25493,1510
2814,23831,09154FF8CE563729A318D07DF701B4BA,31071,2,7,5,109.58257,18.28458,1815
2815,23832,09154FF8CE563729A318D07DF701B4BA,30854,10,22,12,109.56889,18.27076,1763
2819,23860,CFF4943452741BA085C68AD1AAC66347,60571,18,20,2,109.50722,18.25056,1510
2820,23898,99E1CC6671A3F5CA76BAB1455D5F851F,30771,22,23,1,109.49938,18.26042,1511
2821,23904,2B60907F04C29DE058B3E64B1D3B4100,30854,9,18,9,109.56889,18.27076,1763
2822,23905,2B60907F04C29DE058B3E64B1D3B4100,31561,21,23,2,109.56792,18.28479,1765
2823,23931,8A19D38C67DEBBE2072401E23B2467C5,31801,15,16,1,109.20417,18.32118,371
2824,23932,8A19D38C67DEBBE2072401E23B2467C5,31161,20,23,3,109.70229,18.31361,2270
2825,23958,1419F2503130508E06D5FA0D4A5CF329,31031,0,7,7,109.49979,18.25382,1510
2826,23959,1419F2503130508E06D5FA0D4A5CF329,31261,8,14,6,109.51174,18.2466,1559
2827,23960,1419F2503130508E06D5FA0D4A5CF329,31031,15,16,1,109.49979,18.25382,1510
2828,23961,1419F2503130508E06D5FA0D4A5CF329,31164,18,19,1,109.69993,18.27215,2263
2829,23966,AC0E940CA4876D60068799AC7DD06B30,31391,0,7,7,109.50382,18.24285,1508
2830,23967,AC0E940CA4876D60068799AC7DD06B30,33481,8,13,5,109.67278,18.41278,2187
2831,23968,AC0E940CA4876D60068799AC7DD06B30,33051,14,16,2,109.6475,18.46618,2096
2832,23969,AC0E940CA4876D60068799AC7DD06B30,33521,17,18,1,109.66313,18.45174,2143
2833,23970,AC0E940CA4876D60068799AC7DD06B30,31391,19,23,4,109.50382,18.24285,1508
2834,24023,6DF0E96353EFA5D45613487A662BB748,60221,0,9,9,109.52569,18.29188,1616
2835,24024,6DF0E96353EFA5D45613487A662BB748,31031,11,15,4,109.49979,18.25382,1510
2839,24088,F6CCF646674665C449464A30D23BCEEF,60231,0,1,1,109.49903,18.21972,1504
2840,24089,F6CCF646674665C449464A30D23BCEEF,60054,2,5,3,109.3016,18.31229,770
2844,24099,39F25FE146A03325C93C111F2A943B6C,31945,2,9,7,109.58021,18.29403,1817
2845,24100,39F25FE146A03325C93C111F2A943B6C,30854,9,12,3,109.56889,18.27076,1763
2846,24101,39F25FE146A03325C93C111F2A943B6C,31945,13,17,4,109.58021,18.29403,1817
2847,24102,39F25FE146A03325C93C111F2A943B6C,31041,19,20,1,109.50278,18.23701,1507
2848,24103,39F25FE146A03325C93C111F2A943B6C,31945,21,23,2,109.58021,18.29403,1817
2853,24145,14AE6C820CE45F96077630992CABD33D,31551,0,21,21,109.55868,18.24222,1708
2854,24146,14AE6C820CE45F96077630992CABD33D,30951,22,23,1,109.56208,18.25667,1761
2855,24159,90794B929F1EAD21564A5BB205588FE7,60054,16,17,1,109.3016,18.31229,770
2856,24160,90794B929F1EAD21564A5BB205588FE7,30354,18,19,1,109.42813,18.29076,1216
2857,24161,90794B929F1EAD21564A5BB205588FE7,31431,21,23,2,109.44639,18.29042,1316
2858,24171,B34415F599F0ED7D1A073EE314A60B9B,31671,0,18,18,109.38965,18.29813,1068
2859,24172,B34415F599F0ED7D1A073EE314A60B9B,60041,20,22,2,109.39889,18.31944,1121
2863,24222,DFEFB1CD7965FB8E2BDF1B532ED92233,31931,0,9,9,109.54771,18.29403,1667
2864,24223,DFEFB1CD7965FB8E2BDF1B532ED92233,30921,11,13,2,109.53903,18.29451,1667
2865,24224,DFEFB1CD7965FB8E2BDF1B532ED92233,31931,13,14,1,109.54771,18.29403,1667
2866,24225,DFEFB1CD7965FB8E2BDF1B532ED92233,60631,18,20,2,109.57778,18.27583,1814
2867,24226,DFEFB1CD7965FB8E2BDF1B532ED92233,31931,21,23,2,109.54771,18.29403,1667
2868,24283,79552C9BA7D6D0482C348613B3829C6B,31181,6,15,9,109.50382,18.24813,1509
2869,24284,79552C9BA7D6D0482C348613B3829C6B,60131,15,17,2,109.49819,18.24778,1509
2870,24285,79552C9BA7D6D0482C348613B3829C6B,31181,18,22,4,109.50382,18.24813,1509
2871,24299,7094512B15E4EF60EF67A3E6DEAF677A,60594,0,6,6,109.62694,18.22799,1956
2872,24300,7094512B15E4EF60EF67A3E6DEAF677A,38052,6,9,3,109.62618,18.23042,1956
2873,24301,7094512B15E4EF60EF67A3E6DEAF677A,38754,11,15,4,109.74667,18.37382,2430
2874,24302,7094512B15E4EF60EF67A3E6DEAF677A,60594,16,17,1,109.62694,18.22799,1956
2875,24303,7094512B15E4EF60EF67A3E6DEAF677A,30441,18,19,1,109.64021,18.25424,2010
2876,24304,7094512B15E4EF60EF67A3E6DEAF677A,30581,19,20,1,109.62257,18.24951,1959
2877,24305,7094512B15E4EF60EF67A3E6DEAF677A,38052,21,22,1,109.62618,18.23042,1956
2878,24306,5B84036FDCD203AB893EE6C99EA52401,30741,13,14,1,109.49833,18.28681,1516
2879,24307,5B84036FDCD203AB893EE6C99EA52401,30821,17,19,2,109.43681,18.33639,1274
2880,24308,5B84036FDCD203AB893EE6C99EA52401,30741,20,23,3,109.49833,18.28681,1516
2881,24343,3AFE4807E5358850C8027BF9B4CCCFB5,30291,0,8,8,109.50403,18.27028,1513
2882,24344,3AFE4807E5358850C8027BF9B4CCCFB5,30391,8,11,3,109.4975,18.27118,1513
2883,24345,3AFE4807E5358850C8027BF9B4CCCFB5,31931,11,14,3,109.54771,18.29403,1667
2884,24346,3AFE4807E5358850C8027BF9B4CCCFB5,31701,16,18,2,109.44132,18.28833,1266
2885,24347,3AFE4807E5358850C8027BF9B4CCCFB5,30291,19,23,4,109.50403,18.27028,1513
2886,24381,F258281576DAF0135C7F7FAA24A5C069,38073,12,13,1,109.40813,18.30958,1169
2887,24403,14F1CC63CDA098F9694EAC8584B9C7A5,31071,2,5,3,109.58257,18.28458,1815
2888,24404,14F1CC63CDA098F9694EAC8584B9C7A5,31561,5,10,5,109.56792,18.28479,1765
2889,24405,14F1CC63CDA098F9694EAC8584B9C7A5,30854,12,13,1,109.56889,18.27076,1763
2890,24406,14F1CC63CDA098F9694EAC8584B9C7A5,31071,19,21,2,109.58257,18.28458,1815
2891,24407,14F1CC63CDA098F9694EAC8584B9C7A5,31561,21,23,2,109.56792,18.28479,1765
2892,24408,72DCCAC1A2B013E19459B9B611396AC3,30461,15,17,2,109.5116,18.26313,1562
2893,24409,72DCCAC1A2B013E19459B9B611396AC3,30171,21,23,2,109.48458,18.27139,1463
2897,24535,24482AD2B7C9FD3282939A5A40C27817,31471,15,18,3,109.34583,18.29563,917
2898,24536,24482AD2B7C9FD3282939A5A40C27817,31143,19,23,4,109.19986,18.29875,368
2899,24605,2D115D52FDAB55086A12D742071FDFC9,30232,1,4,3,109.6191,18.31701,1971
2900,24606,2D115D52FDAB55086A12D742071FDFC9,30854,7,15,8,109.56889,18.27076,1763
2901,24607,2D115D52FDAB55086A12D742071FDFC9,30232,15,16,1,109.6191,18.31701,1971
2902,24608,2D115D52FDAB55086A12D742071FDFC9,30854,19,22,3,109.56889,18.27076,1763
2903,24609,94C6B6D07606799F9DD78C376ADCB85C,38911,0,8,8,109.51674,18.24965,1559
2904,24610,94C6B6D07606799F9DD78C376ADCB85C,38291,8,12,4,109.51618,18.24313,1558
2905,24611,94C6B6D07606799F9DD78C376ADCB85C,31821,12,14,2,109.51181,18.24924,1559
2906,24612,94C6B6D07606799F9DD78C376ADCB85C,60221,17,18,1,109.52569,18.29188,1616
2907,24613,94C6B6D07606799F9DD78C376ADCB85C,38331,20,21,1,109.62465,18.22736,1956
2908,24614,94C6B6D07606799F9DD78C376ADCB85C,60281,22,23,1,109.51743,18.25924,1561
2909,24620,B63C7A38380DE4C1CBF93159ABD5ACDF,30354,0,7,7,109.42813,18.29076,1216
2910,24621,B63C7A38380DE4C1CBF93159ABD5ACDF,60054,8,9,1,109.3016,18.31229,770
2911,24622,B63C7A38380DE4C1CBF93159ABD5ACDF,31781,13,15,2,109.19847,18.2975,367
2912,24623,D90E492BAFD3B5C326CF35A94ED803F0,31781,15,17,2,109.19847,18.2975,367
2913,24624,D90E492BAFD3B5C326CF35A94ED803F0,38754,20,21,1,109.74667,18.37382,2430
2914,24661,AB43182259122294244C13D6FC66D4A1,31071,0,4,4,109.58257,18.28458,1815
2915,24662,AB43182259122294244C13D6FC66D4A1,60631,5,6,1,109.57778,18.27583,1814
2916,24663,AB43182259122294244C13D6FC66D4A1,31071,7,8,1,109.58257,18.28458,1815
2917,24664,AB43182259122294244C13D6FC66D4A1,31561,14,16,2,109.56792,18.28479,1765
2918,24665,AB43182259122294244C13D6FC66D4A1,60631,20,22,2,109.57778,18.27583,1814
2919,24668,C462628FF36F8FF2D0B7493E6DDA38BB,60411,0,8,8,109.32514,18.30854,869
2920,24669,C462628FF36F8FF2D0B7493E6DDA38BB,30661,9,14,5,109.37028,18.24361,1008
2921,24670,C462628FF36F8FF2D0B7493E6DDA38BB,60411,14,15,1,109.32514,18.30854,869
2922,24683,B29F33564DDA3CFA905BF42633BA4302,39101,16,17,1,109.50132,18.24931,1509
2923,24684,B29F33564DDA3CFA905BF42633BA4302,38291,21,22,1,109.51618,18.24313,1558
2924,24689,F8D799D9161B0143E0D71C40472A357E,30071,0,8,8,109.52819,18.30472,1619
2925,24690,F8D799D9161B0143E0D71C40472A357E,38991,10,12,2,109.52681,18.30368,1618
2926,24691,F8D799D9161B0143E0D71C40472A357E,30071,14,15,1,109.52819,18.30472,1619
2927,24692,F8D799D9161B0143E0D71C40472A357E,30711,17,21,4,109.50271,18.25347,1510
2931,24748,C0A7F668E276299BE027E18D29E450FF,30854,15,16,1,109.56889,18.27076,1763
2932,24755,728159D623DE360E7CBC8AEEC345E2FF,60661,0,13,13,109.548,18.2377,1657
2933,24756,728159D623DE360E7CBC8AEEC345E2FF,31091,14,18,4,109.41201,18.31222,1170
2934,24757,728159D623DE360E7CBC8AEEC345E2FF,60661,20,23,3,109.548,18.2377,1657
2935,24768,E62DBF6E801A10F11FF8E6C479369844,30711,13,15,2,109.50271,18.25347,1510
2936,24769,E62DBF6E801A10F11FF8E6C479369844,38754,17,18,1,109.74667,18.37382,2430
2937,24774,D0397702CD04E389C6CD3782DE9B02F8,38157,1,8,7,109.51483,18.26958,1563
2938,24775,D0397702CD04E389C6CD3782DE9B02F8,31521,8,10,2,109.51458,18.22542,1555
2939,24776,D0397702CD04E389C6CD3782DE9B02F8,60381,10,11,1,109.5241,18.22458,1605
2940,24777,D0397702CD04E389C6CD3782DE9B02F8,31521,12,19,7,109.51458,18.22542,1555
2941,24778,D0397702CD04E389C6CD3782DE9B02F8,60201,19,22,3,109.5041,18.2509,1510
2945,24831,C6C3BC01E542B810EF853FEEB6C81198,60361,3,19,16,109.51938,18.29681,1567
2946,24832,C6C3BC01E542B810EF853FEEB6C81198,30854,19,21,2,109.56889,18.27076,1763
2950,24891,39D4F14340B4650E084697607335F122,30161,0,9,9,109.50042,18.24389,1508
2951,24892,39D4F14340B4650E084697607335F122,39101,14,20,6,109.50132,18.24931,1509
2952,24939,C4619CDCDA2CE4B57ED8A6EA3F70D9D0,31351,0,2,2,109.4959,18.28417,1465
2953,24940,C4619CDCDA2CE4B57ED8A6EA3F70D9D0,38157,2,8,6,109.51483,18.26958,1563
2954,24987,8AABF5FDF2B06EB445749240A3894969,30854,17,18,1,109.56889,18.27076,1763
2955,24988,8AABF5FDF2B06EB445749240A3894969,31071,18,20,2,109.58257,18.28458,1815
2956,24994,9372C6333F63FA61AD9230AC50796D39,38951,0,7,7,109.48097,18.28868,1416
2957,24995,9372C6333F63FA61AD9230AC50796D39,30581,12,13,1,109.62257,18.24951,1959
2958,25015,F2E4A1707C14AD7AF444AE9628A7C8BD,30081,9,14,5,109.50243,18.26632,1512
2959,25016,F2E4A1707C14AD7AF444AE9628A7C8BD,60381,17,19,2,109.5241,18.22458,1605
2960,25054,FD9120CA3F85D3F015CEFB66B9BF2F3D,30721,0,13,13,109.51597,18.28257,1565
2961,25055,FD9120CA3F85D3F015CEFB66B9BF2F3D,60301,15,16,1,109.60715,18.30993,1919
2962,25056,FD9120CA3F85D3F015CEFB66B9BF2F3D,30711,18,19,1,109.50271,18.25347,1510
2963,25057,FD9120CA3F85D3F015CEFB66B9BF2F3D,38891,20,21,1,109.51486,18.24118,1558
2964,25058,FD9120CA3F85D3F015CEFB66B9BF2F3D,30721,21,23,2,109.51597,18.28257,1565
2965,25085,E8BAAF476E8FE57075BAB1A8D4FF1780,60631,0,6,6,109.57778,18.27583,1814
2966,25086,E8BAAF476E8FE57075BAB1A8D4FF1780,30854,8,11,3,109.56889,18.27076,1763
2967,25087,E8BAAF476E8FE57075BAB1A8D4FF1780,60381,12,14,2,109.5241,18.22458,1605
2968,25088,E8BAAF476E8FE57075BAB1A8D4FF1780,60281,18,19,1,109.51743,18.25924,1561
2969,25097,30CE72A519D49881F23B8123486E3A02,60054,0,1,1,109.3016,18.31229,770
2970,25098,30CE72A519D49881F23B8123486E3A02,60411,2,3,1,109.32514,18.30854,869
2971,25099,30CE72A519D49881F23B8123486E3A02,60054,3,7,4,109.3016,18.31229,770
2972,25100,30CE72A519D49881F23B8123486E3A02,60411,8,11,3,109.32514,18.30854,869
2973,25101,30CE72A519D49881F23B8123486E3A02,31471,13,16,3,109.34583,18.29563,917
2978,25162,A8FD541EBDB8E347ADD4F948A70B6831,31561,0,10,10,109.56792,18.28479,1765
2979,25163,A8FD541EBDB8E347ADD4F948A70B6831,30111,12,15,3,109.47583,18.30542,1419
2980,25212,5204DBE7E9916DC793C5F718C71EB270,30671,5,7,2,109.43611,18.30139,1268
2981,25213,5204DBE7E9916DC793C5F718C71EB270,31781,9,10,1,109.19847,18.2975,367
2982,25220,CC7872BC5B2873CE85E7AB82CF2C3275,30221,0,8,8,109.57833,18.20222,1802
2983,25221,CC7872BC5B2873CE85E7AB82CF2C3275,31071,12,13,1,109.58257,18.28458,1815
2984,25222,CC7872BC5B2873CE85E7AB82CF2C3275,30221,15,22,7,109.57833,18.20222,1802
2985,25260,9D84057972B69A5E23018ED19BFE5178,38171,0,7,7,109.50799,18.28139,1515
2986,25261,9D84057972B69A5E23018ED19BFE5178,31231,7,14,7,109.42597,18.29292,1217
2987,25262,9D84057972B69A5E23018ED19BFE5178,60117,16,20,4,109.73604,18.35681,2427
2988,25263,9D84057972B69A5E23018ED19BFE5178,38171,22,23,1,109.50799,18.28139,1515
2993,25310,4678B343B4005F2EC771E77847482CF4,60381,14,15,1,109.5241,18.22458,1605
2994,25311,4678B343B4005F2EC771E77847482CF4,31521,18,19,1,109.51458,18.22542,1555
2995,25312,4678B343B4005F2EC771E77847482CF4,38111,20,21,1,109.52007,18.22403,1555
2996,25329,AD5B50011AF724A93ED322CEECA0B566,31101,0,9,9,109.65389,18.23403,2057
2997,25330,AD5B50011AF724A93ED322CEECA0B566,38105,14,18,4,109.40299,18.29229,1117
2998,25331,AD5B50011AF724A93ED322CEECA0B566,31041,20,22,2,109.50278,18.23701,1507
3003,25359,BAC047B6079E6BEA7B1F8943C9D7A733,30854,0,8,8,109.56889,18.27076,1763
3004,25360,BAC047B6079E6BEA7B1F8943C9D7A733,31071,8,9,1,109.58257,18.28458,1815
3005,25361,BAC047B6079E6BEA7B1F8943C9D7A733,30854,13,15,2,109.56889,18.27076,1763
3006,25362,BAC047B6079E6BEA7B1F8943C9D7A733,30361,19,21,2,109.50347,18.24,1508
3010,25391,FA750B530766C5EAE284F9BC6C3A94BD,60221,18,20,2,109.52569,18.29188,1616
3011,25392,FA750B530766C5EAE284F9BC6C3A94BD,38171,21,23,2,109.50799,18.28139,1515
3012,25406,AC13994AA2AD3BE953B786F57E282F5B,30854,14,18,4,109.56889,18.27076,1763
3013,25407,AC13994AA2AD3BE953B786F57E282F5B,31071,22,23,1,109.58257,18.28458,1815
3014,25459,019CCF25DBCE9B21B5D2698F82FCE788,30234,0,7,7,109.60681,18.29979,1918
3015,25460,019CCF25DBCE9B21B5D2698F82FCE788,30854,11,16,5,109.56889,18.27076,1763
3016,25504,B175A0347ABEEA30E818C5CCD25E280F,30821,13,15,2,109.43681,18.33639,1274
3017,25505,B175A0347ABEEA30E818C5CCD25E280F,60361,16,17,1,109.51938,18.29681,1567
3018,25506,B175A0347ABEEA30E818C5CCD25E280F,30821,19,20,1,109.43681,18.33639,1274
3019,25507,7CE2B4E9E3FFA67A4ED2B81C8BF2496C,31521,0,20,20,109.51458,18.22542,1555
3020,25508,7CE2B4E9E3FFA67A4ED2B81C8BF2496C,39111,21,22,1,109.5191,18.22597,1555
3021,25530,40E328762DBD80BABC8A5581C57ED5C7,30111,1,6,5,109.47583,18.30542,1419
3022,25531,40E328762DBD80BABC8A5581C57ED5C7,60054,10,12,2,109.3016,18.31229,770
3023,25532,40E328762DBD80BABC8A5581C57ED5C7,30731,15,16,1,109.50944,18.22306,1555
3024,25533,40E328762DBD80BABC8A5581C57ED5C7,60541,21,22,1,109.4084,18.29208,1167
3025,25584,DD8DCE806AFFEAC5D779812E5F8F2B3D,31561,7,14,7,109.56792,18.28479,1765
3026,25585,DD8DCE806AFFEAC5D779812E5F8F2B3D,31071,14,16,2,109.58257,18.28458,1815
3027,25628,B2F3687F06BC9BF7431C8843AA2E4113,38754,15,16,1,109.74667,18.37382,2430
3028,25629,B2F3687F06BC9BF7431C8843AA2E4113,30361,19,21,2,109.50347,18.24,1508
3029,25630,B2F3687F06BC9BF7431C8843AA2E4113,38017,21,23,2,109.49729,18.21424,1504
3030,25660,48909A32A67BC05C61E91CFDEA889BCD,38271,11,12,1,109.62632,18.23049,1956
3031,25661,48909A32A67BC05C61E91CFDEA889BCD,30581,13,15,2,109.62257,18.24951,1959
3032,25665,7787090BDC7F8BDD60446754BDF84D74,30711,14,22,8,109.50271,18.25347,1510
3033,25696,50B65AC8D2C37EA95C5135CC7670F4EA,38331,19,21,2,109.62465,18.22736,1956
3034,25697,50B65AC8D2C37EA95C5135CC7670F4EA,39181,21,23,2,109.55153,18.28035,1715
3035,25719,ECABE2F9F259F45EBF68156196EE19D5,30854,0,6,6,109.56889,18.27076,1763
3036,25720,ECABE2F9F259F45EBF68156196EE19D5,31471,9,11,2,109.34583,18.29563,917
3040,25760,28FD729A56A38491CC99ABB23711BC1C,39181,11,13,2,109.55153,18.28035,1715
3041,25761,28FD729A56A38491CC99ABB23711BC1C,31931,15,16,1,109.54771,18.29403,1667
3042,25762,28FD729A56A38491CC99ABB23711BC1C,39181,18,23,5,109.55153,18.28035,1715
3043,25780,1B378B100EB2E1F18A0E8906C6FD4DA1,61011,12,13,1,109.60653,18.19076,1900
3044,25782,1B378B100EB2E1F18A0E8906C6FD4DA1,61011,18,21,3,109.60653,18.19076,1900
3045,25846,41E327357BD523862BD5781EC1B279C7,38251,18,19,1,109.49618,18.25493,1510
3046,25847,41E327357BD523862BD5781EC1B279C7,31531,20,23,3,109.49583,18.25972,1461
3047,25880,3D8ADE80304FD3207128013D43F1118A,60421,0,11,11,109.46333,18.31743,1371
3048,25881,3D8ADE80304FD3207128013D43F1118A,60361,13,16,3,109.51938,18.29681,1567
3049,25882,3D8ADE80304FD3207128013D43F1118A,30711,16,18,2,109.50271,18.25347,1510
3050,25883,3D8ADE80304FD3207128013D43F1118A,38291,19,20,1,109.51618,18.24313,1558
3051,25887,AD37BCE39484633C97CEA12395E22DCE,38127,17,18,1,109.50833,18.27222,1513
3052,25888,AD37BCE39484633C97CEA12395E22DCE,38291,18,20,2,109.51618,18.24313,1558
3053,25896,17D13F6A66037B54FAB5668CDC734401,60311,0,9,9,109.52097,18.24319,1558
3054,25897,17D13F6A66037B54FAB5668CDC734401,31931,9,23,14,109.54771,18.29403,1667
3055,25957,1AFB73CFA15D49BFA2ECE037EF4A3987,31031,17,18,1,109.49979,18.25382,1510
3056,25958,1AFB73CFA15D49BFA2ECE037EF4A3987,30854,19,20,1,109.56889,18.27076,1763
3057,25992,D2006452460D74E19DE71BCDEF4A0E0E,31473,9,10,1,109.34792,18.29465,917
3058,25993,D2006452460D74E19DE71BCDEF4A0E0E,31471,11,12,1,109.34583,18.29563,917
3059,25994,D2006452460D74E19DE71BCDEF4A0E0E,31021,15,21,6,109.49021,18.27,1463
3060,25995,D2006452460D74E19DE71BCDEF4A0E0E,30171,22,23,1,109.48458,18.27139,1463
3065,26047,64BA6A8DED043A8A643982CE0E68A1E7,31101,0,12,12,109.65389,18.23403,2057
3066,26048,64BA6A8DED043A8A643982CE0E68A1E7,60401,14,17,3,109.47444,18.27583,1414
3067,26049,64BA6A8DED043A8A643982CE0E68A1E7,38071,19,20,1,109.40722,18.30938,1169
3079,26116,E5BFC902C69425C6766465DD76F010C9,30201,0,8,8,109.4909,18.26465,1462
3080,26117,E5BFC902C69425C6766465DD76F010C9,60421,10,12,2,109.46333,18.31743,1371
3081,26118,E5BFC902C69425C6766465DD76F010C9,39321,15,16,1,109.529,18.2167,1604
3082,26119,E5BFC902C69425C6766465DD76F010C9,38111,18,21,3,109.52007,18.22403,1555
3083,26125,BBD4284E8E1F188C2BAB74412D589E87,31311,11,13,2,109.72299,18.27438,2364
3084,26126,BBD4284E8E1F188C2BAB74412D589E87,31471,16,18,2,109.34583,18.29563,917
3085,26127,BBD4284E8E1F188C2BAB74412D589E87,60381,19,21,2,109.5241,18.22458,1605
3086,26145,47361F17195D15CB84288794245FD3CE,38903,0,8,8,109.39229,18.29243,1117
3087,26146,47361F17195D15CB84288794245FD3CE,30661,11,14,3,109.37028,18.24361,1008
3088,26182,EB316856896788EC8FD871E122E95728,30701,12,14,2,109.59313,18.32007,1871
3089,26183,EB316856896788EC8FD871E122E95728,31811,14,18,4,109.54201,18.31806,1671
3090,26184,EB316856896788EC8FD871E122E95728,30701,20,22,2,109.59313,18.32007,1871
3091,26185,74A9CCA48CD6C2DA9FC7DFDB8817D50B,31071,16,17,1,109.58257,18.28458,1815
3092,26186,74A9CCA48CD6C2DA9FC7DFDB8817D50B,30854,20,21,1,109.56889,18.27076,1763
3093,26260,7C1FA61B704108BBA1EA794ABADA6D1C,38241,0,9,9,109.54111,18.30542,1669
3094,26261,7C1FA61B704108BBA1EA794ABADA6D1C,31471,10,11,1,109.34583,18.29563,917
3095,26262,7C1FA61B704108BBA1EA794ABADA6D1C,31471,12,13,1,109.34583,18.29563,917
3096,26263,7C1FA61B704108BBA1EA794ABADA6D1C,38241,17,18,1,109.54111,18.30542,1669
3097,26264,7C1FA61B704108BBA1EA794ABADA6D1C,31031,19,20,1,109.49979,18.25382,1510
3098,26265,7C1FA61B704108BBA1EA794ABADA6D1C,38241,21,22,1,109.54111,18.30542,1669
3099,26286,D5ED0B56415F07DD214B0DC3E9293672,31071,0,8,8,109.58257,18.28458,1815
3100,26287,D5ED0B56415F07DD214B0DC3E9293672,38157,9,11,2,109.51483,18.26958,1563
3101,26288,D5ED0B56415F07DD214B0DC3E9293672,30232,13,14,1,109.6191,18.31701,1971
3102,26289,D5ED0B56415F07DD214B0DC3E9293672,30151,18,19,1,109.50986,18.25083,1560
3103,26290,D5ED0B56415F07DD214B0DC3E9293672,30854,21,23,2,109.56889,18.27076,1763
3104,26359,4E6B305321F88D7C96BB8FE6495D1FE3,30121,14,18,4,109.52861,18.27222,1613
3105,26360,4E6B305321F88D7C96BB8FE6495D1FE3,30854,19,20,1,109.56889,18.27076,1763
3106,26382,6F2A2E5942A760BD44A11BEC746849C8,31941,0,6,6,109.62451,18.31222,1970
3107,26400,0547C7536E43628EF24935F0C2BF5E2C,60241,0,6,6,109.53319,18.28667,1616
3108,26401,0547C7536E43628EF24935F0C2BF5E2C,31931,6,11,5,109.54771,18.29403,1667
3109,26430,00479D226C4FEC7FFC8500505DCBA62B,31471,16,17,1,109.34583,18.29563,917
3110,26431,00479D226C4FEC7FFC8500505DCBA62B,30341,18,19,1,109.3625,18.29167,966
3111,26432,00479D226C4FEC7FFC8500505DCBA62B,60381,21,23,2,109.5241,18.22458,1605
3122,26473,EEAA904909853FCE4C1006E1C626BEA2,60231,0,11,11,109.49903,18.21972,1504
3123,26474,EEAA904909853FCE4C1006E1C626BEA2,31864,12,13,1,109.49014,18.28333,1465
3124,26475,EEAA904909853FCE4C1006E1C626BEA2,30571,15,16,1,109.50243,18.21861,1504
3125,26476,EEAA904909853FCE4C1006E1C626BEA2,60621,17,20,3,109.48354,18.27451,1464
3126,26477,EEAA904909853FCE4C1006E1C626BEA2,30571,21,23,2,109.50243,18.21861,1504
3131,26498,BAEC5DBAF6DB81E2367A0A6FEDA43BD9,31701,15,16,1,109.44132,18.28833,1266
3132,26499,BAEC5DBAF6DB81E2367A0A6FEDA43BD9,30721,17,19,2,109.51597,18.28257,1565
3133,26500,BAEC5DBAF6DB81E2367A0A6FEDA43BD9,30161,20,21,1,109.50042,18.24389,1508
3134,26501,BAEC5DBAF6DB81E2367A0A6FEDA43BD9,39101,22,23,1,109.50132,18.24931,1509
3135,26502,4BA143AD44480D9BEACA2836C34FF531,60161,9,10,1,109.49174,18.26181,1461
3136,26503,4BA143AD44480D9BEACA2836C34FF531,60084,11,21,10,109.4984,18.2334,1507
3137,26529,C8135D3E403B7CC96352A41CBCD291A7,30921,1,7,6,109.53903,18.29451,1667
3138,26530,C8135D3E403B7CC96352A41CBCD291A7,31571,11,12,1,109.61563,18.23326,1957
3139,26531,C8135D3E403B7CC96352A41CBCD291A7,38241,13,19,6,109.54111,18.30542,1669
3140,26605,64F4CDF664AA04E7B79DE93C57128CF6,31931,2,13,11,109.54771,18.29403,1667
3141,26606,64F4CDF664AA04E7B79DE93C57128CF6,60361,15,18,3,109.51938,18.29681,1567
3142,26627,56ACD6E124DDA410369E9C6960DD08BD,31231,14,18,4,109.42597,18.29292,1217
3143,26628,56ACD6E124DDA410369E9C6960DD08BD,31031,18,20,2,109.49979,18.25382,1510
3144,26640,933C30058B1CA246EC59609197D7CAAB,31071,0,12,12,109.58257,18.28458,1815
3145,26641,933C30058B1CA246EC59609197D7CAAB,60472,14,18,4,109.46625,18.29542,1367
3146,26642,933C30058B1CA246EC59609197D7CAAB,39091,19,20,1,109.50097,18.25222,1510
3147,26643,933C30058B1CA246EC59609197D7CAAB,31071,20,23,3,109.58257,18.28458,1815
3148,26673,2AE5E6210CA3737C538797D0A34CA04C,38336,0,4,4,109.61111,18.21806,1904
3149,26674,2AE5E6210CA3737C538797D0A34CA04C,31345,6,7,1,109.39,18.29,1066
3150,26675,2AE5E6210CA3737C538797D0A34CA04C,38251,8,10,2,109.49618,18.25493,1510
3151,26676,2AE5E6210CA3737C538797D0A34CA04C,31345,10,21,11,109.39,18.29,1066
3152,26703,D0258183D3EC0F3CFFD9389BCF92CEA0,39111,3,5,2,109.5191,18.22597,1555
3153,26704,D0258183D3EC0F3CFFD9389BCF92CEA0,31521,6,10,4,109.51458,18.22542,1555
3154,26705,D0258183D3EC0F3CFFD9389BCF92CEA0,31781,13,15,2,109.19847,18.2975,367
3155,26706,D0258183D3EC0F3CFFD9389BCF92CEA0,31821,17,20,3,109.51181,18.24924,1559
3156,26707,D0258183D3EC0F3CFFD9389BCF92CEA0,60281,20,22,2,109.51743,18.25924,1561
3157,26708,D0258183D3EC0F3CFFD9389BCF92CEA0,31821,22,23,1,109.51181,18.24924,1559
3158,26759,4DC9641A33591180E796A7F08C635775,31951,14,17,3,109.52174,18.30299,1568
3159,26762,16EF8003C4CB7FA32A71712A2EB072A5,60054,14,15,1,109.3016,18.31229,770
3160,26763,16EF8003C4CB7FA32A71712A2EB072A5,60621,16,23,7,109.48354,18.27451,1464
3161,26795,6587551DA47309E484D1302521C8D417,60631,1,3,2,109.57778,18.27583,1814
3162,26796,6587551DA47309E484D1302521C8D417,38275,7,12,5,109.62875,18.22938,2006
3163,26797,6587551DA47309E484D1302521C8D417,60631,15,16,1,109.57778,18.27583,1814
3164,26798,6587551DA47309E484D1302521C8D417,38275,17,22,5,109.62875,18.22938,2006
3165,26854,AB39E4D55C64D507788EA390DFD1227B,38283,0,8,8,109.62229,18.22618,1956
3166,26855,AB39E4D55C64D507788EA390DFD1227B,60054,13,14,1,109.3016,18.31229,770
3167,26856,AB39E4D55C64D507788EA390DFD1227B,38283,17,22,5,109.62229,18.22618,1956
3168,26868,35BCF778DA6962D8791BBC3D2E760483,39041,16,19,3,109.40021,18.29278,1117
3169,26869,35BCF778DA6962D8791BBC3D2E760483,39091,20,21,1,109.50097,18.25222,1510
3170,26915,0E129C09250C0D46273B4BD7E5225556,30151,0,7,7,109.50986,18.25083,1560
3171,26916,0E129C09250C0D46273B4BD7E5225556,60504,10,12,2,109.47917,18.28903,1416
3172,26917,0E129C09250C0D46273B4BD7E5225556,31251,14,15,1,109.18528,18.2975,317
3173,26918,0E129C09250C0D46273B4BD7E5225556,30151,20,22,2,109.50986,18.25083,1560
3174,26919,0E129C09250C0D46273B4BD7E5225556,30421,22,23,1,109.50021,18.25861,1511
3175,26942,08DC3612B41F2768444E0E17E11D8899,31521,0,12,12,109.51458,18.22542,1555
3176,26943,08DC3612B41F2768444E0E17E11D8899,60381,12,14,2,109.5241,18.22458,1605
3177,26944,08DC3612B41F2768444E0E17E11D8899,31521,14,16,2,109.51458,18.22542,1555
3178,26945,08DC3612B41F2768444E0E17E11D8899,30201,18,19,1,109.4909,18.26465,1462
3179,26946,08DC3612B41F2768444E0E17E11D8899,38111,20,21,1,109.52007,18.22403,1555
3180,26947,08DC3612B41F2768444E0E17E11D8899,31521,22,23,1,109.51458,18.22542,1555
3184,26959,C9FB371FC8ECA365AFEE785254927F8D,30854,16,17,1,109.56889,18.27076,1763
3185,26976,F8B87E5729F408BD0003FC75DE302186,38951,0,4,4,109.48097,18.28868,1416
3186,26977,F8B87E5729F408BD0003FC75DE302186,38951,5,7,2,109.48097,18.28868,1416
3187,26978,F8B87E5729F408BD0003FC75DE302186,31471,9,10,1,109.34583,18.29563,917
3188,26979,F8B87E5729F408BD0003FC75DE302186,30821,16,17,1,109.43681,18.33639,1274
3189,26980,F8B87E5729F408BD0003FC75DE302186,38951,18,21,3,109.48097,18.28868,1416
3193,26991,173CD7A2B7B334BC53A50A1D248FBCFE,31071,0,9,9,109.58257,18.28458,1815
3194,26992,173CD7A2B7B334BC53A50A1D248FBCFE,30854,9,12,3,109.56889,18.27076,1763
3195,26993,173CD7A2B7B334BC53A50A1D248FBCFE,60381,16,21,5,109.5241,18.22458,1605
3196,27011,3BD6874462BCE49FA953391885E8CA15,31021,1,6,5,109.49021,18.27,1463
3197,27012,3BD6874462BCE49FA953391885E8CA15,31271,6,8,2,109.48958,18.26257,1462
3198,27013,3BD6874462BCE49FA953391885E8CA15,31021,9,10,1,109.49021,18.27,1463
3199,27014,3BD6874462BCE49FA953391885E8CA15,30201,14,16,2,109.4909,18.26465,1462
3200,27015,3BD6874462BCE49FA953391885E8CA15,30421,17,22,5,109.50021,18.25861,1511
3201,27033,0E00D7E0174B24239144B08D52B998E8,31931,0,16,16,109.54771,18.29403,1667
3202,27034,0E00D7E0174B24239144B08D52B998E8,31351,17,21,4,109.4959,18.28417,1465
3206,27049,F9B50F8C0BC548F341BD45D3142A9731,31461,15,17,2,109.5091,18.25389,1510
3207,27050,F9B50F8C0BC548F341BD45D3142A9731,60281,19,20,1,109.51743,18.25924,1561
3208,27051,F9B50F8C0BC548F341BD45D3142A9731,30711,20,23,3,109.50271,18.25347,1510
3209,27075,6EA58F7924D334CE2A56B731883B1B80,39091,13,15,2,109.50097,18.25222,1510
3214,27109,78161B2FCA02FEE18F8EB6C8D5CE9387,31031,17,20,3,109.49979,18.25382,1510
3215,27110,78161B2FCA02FEE18F8EB6C8D5CE9387,38251,22,23,1,109.49618,18.25493,1510
3216,27112,807F73DE76DFE56E472FA61396F0887C,31851,6,8,2,109.71736,18.29007,2316
3217,27121,007CE09D95F7D7AB1CB08DCE3F879C89,38052,0,9,9,109.62618,18.23042,1956
3218,27122,007CE09D95F7D7AB1CB08DCE3F879C89,31561,10,12,2,109.56792,18.28479,1765
3219,27123,007CE09D95F7D7AB1CB08DCE3F879C89,38052,12,18,6,109.62618,18.23042,1956
3223,27175,1C9C2039AD83BAADE716F80BF1B3E54D,30851,0,4,4,109.5616,18.27396,1713
3224,27181,CB1C8502149DACE0B32B2F7416279EF2,31071,1,9,8,109.58257,18.28458,1815
3225,27182,CB1C8502149DACE0B32B2F7416279EF2,30854,9,11,2,109.56889,18.27076,1763
3226,27183,CB1C8502149DACE0B32B2F7416279EF2,31071,15,17,2,109.58257,18.28458,1815
3227,27184,CB1C8502149DACE0B32B2F7416279EF2,30854,17,18,1,109.56889,18.27076,1763
3228,27185,CB1C8502149DACE0B32B2F7416279EF2,31071,21,23,2,109.58257,18.28458,1815
3229,27222,D39D64452E6BBEF7B3056CA239E1B86E,30851,0,6,6,109.5616,18.27396,1713
3230,27223,D39D64452E6BBEF7B3056CA239E1B86E,31561,6,7,1,109.56792,18.28479,1765
3231,27224,D39D64452E6BBEF7B3056CA239E1B86E,30854,7,14,7,109.56889,18.27076,1763
3232,27225,D39D64452E6BBEF7B3056CA239E1B86E,31561,14,15,1,109.56792,18.28479,1765
3233,27226,D39D64452E6BBEF7B3056CA239E1B86E,30854,15,23,8,109.56889,18.27076,1763
3237,27245,6F45817D7C192D004E915F474595B546,30201,0,9,9,109.4909,18.26465,1462
3238,27246,6F45817D7C192D004E915F474595B546,31471,13,14,1,109.34583,18.29563,917
3239,27247,6F45817D7C192D004E915F474595B546,30661,15,16,1,109.37028,18.24361,1008
3240,27248,6F45817D7C192D004E915F474595B546,30201,18,21,3,109.4909,18.26465,1462
3241,27264,E92C4377A82D1512C2FDA9EFCDAFE67D,60381,17,18,1,109.5241,18.22458,1605
3242,27265,E92C4377A82D1512C2FDA9EFCDAFE67D,30354,21,22,1,109.42813,18.29076,1216
3243,27279,F6EF600D772A11A06069101B0AB9C4EC,31101,17,23,6,109.65389,18.23403,2057
3244,27280,1FE2866848043A2C10AD87212485FE15,31071,2,4,2,109.58257,18.28458,1815
3245,27281,1FE2866848043A2C10AD87212485FE15,30854,9,14,5,109.56889,18.27076,1763
3246,27282,1FE2866848043A2C10AD87212485FE15,31071,14,15,1,109.58257,18.28458,1815
3247,27283,1FE2866848043A2C10AD87212485FE15,30854,17,19,2,109.56889,18.27076,1763
3248,27284,1FE2866848043A2C10AD87212485FE15,31861,21,23,2,109.49042,18.27549,1464
3249,27295,003C6689B311B427695E6FEF3BF3C281,38331,0,7,7,109.62465,18.22736,1956
3250,27341,E9DC5E3F06A9FBF162477C6043E75224,30851,1,5,4,109.5616,18.27396,1713
3251,27342,E9DC5E3F06A9FBF162477C6043E75224,30201,9,10,1,109.4909,18.26465,1462
3252,27358,070984703178D21DC5287E457C03691A,39181,13,15,2,109.55153,18.28035,1715
3253,27359,070984703178D21DC5287E457C03691A,39181,18,23,5,109.55153,18.28035,1715
3254,27366,00064C0E4651B29FBEAE6571FC000567,30571,11,14,3,109.50243,18.21861,1504
3255,27367,00064C0E4651B29FBEAE6571FC000567,60291,18,19,1,109.50826,18.24639,1509
3259,27399,1E0EA1E4B61DDC44157F7F6809A12188,60381,16,17,1,109.5241,18.22458,1605
3260,27400,1E0EA1E4B61DDC44157F7F6809A12188,31554,17,19,2,109.55521,18.2459,1709
3261,27401,1E0EA1E4B61DDC44157F7F6809A12188,31521,19,22,3,109.51458,18.22542,1555
3266,27456,ED36F1C6D51C5483990D27F2F51080D2,38134,0,7,7,109.63931,18.23451,2007
3267,27457,ED36F1C6D51C5483990D27F2F51080D2,38271,8,13,5,109.62632,18.23049,1956
3268,27458,ED36F1C6D51C5483990D27F2F51080D2,31271,17,18,1,109.48958,18.26257,1462
3269,27461,FF389E4ACCCAE9E25F55121145744220,31421,0,15,15,109.55382,18.22347,1705
3270,27462,FF389E4ACCCAE9E25F55121145744220,30421,18,19,1,109.50021,18.25861,1511
3271,27463,FF389E4ACCCAE9E25F55121145744220,31421,22,23,1,109.55382,18.22347,1705
3272,27504,64EA917EAAD3EB55DA2ABB227203C131,60631,7,8,1,109.57778,18.27583,1814
3273,27505,64EA917EAAD3EB55DA2ABB227203C131,30854,9,10,1,109.56889,18.27076,1763
3277,27546,60FF9F8DF12E8BA35F74BE17AE5D7388,60524,13,14,1,109.42951,18.28993,1216
3282,27629,5B93149195498C1BB1324829076057CC,31271,11,13,2,109.48958,18.26257,1462
3283,27630,5B93149195498C1BB1324829076057CC,31471,15,16,1,109.34583,18.29563,917
3284,27631,5B93149195498C1BB1324829076057CC,31271,20,23,3,109.48958,18.26257,1462
3285,27652,E4B522EF4348156010E5C578EC13D60F,30854,0,17,17,109.56889,18.27076,1763
3286,27653,E4B522EF4348156010E5C578EC13D60F,38171,17,20,3,109.50799,18.28139,1515
3287,27658,C5B2C146A715B405C4C002F4F3423FFB,31931,0,11,11,109.54771,18.29403,1667
3288,27659,C5B2C146A715B405C4C002F4F3423FFB,30861,12,15,3,109.52722,18.22743,1606
3289,27660,C5B2C146A715B405C4C002F4F3423FFB,31931,17,18,1,109.54771,18.29403,1667
3290,27661,C5B2C146A715B405C4C002F4F3423FFB,60371,19,20,1,109.53063,18.30056,1618
3291,27662,9AB2A4C72D46DE0CAA5DEDB31E046940,31061,0,8,8,109.53333,18.23257,1607
3292,27663,9AB2A4C72D46DE0CAA5DEDB31E046940,30731,9,10,1,109.50944,18.22306,1555
3293,27664,9AB2A4C72D46DE0CAA5DEDB31E046940,31781,13,15,2,109.19847,18.2975,367
3294,27665,9AB2A4C72D46DE0CAA5DEDB31E046940,60381,19,20,1,109.5241,18.22458,1605
3295,27672,D984F4ED609CD4BB7417303EF42B896E,38751,0,8,8,109.74903,18.37639,2481
3296,27673,D984F4ED609CD4BB7417303EF42B896E,31145,9,11,2,109.20431,18.30479,369
3297,27674,D984F4ED609CD4BB7417303EF42B896E,31471,11,13,2,109.34583,18.29563,917
3298,27675,D984F4ED609CD4BB7417303EF42B896E,31521,15,16,1,109.51458,18.22542,1555
3299,27676,D984F4ED609CD4BB7417303EF42B896E,38751,18,23,5,109.74903,18.37639,2481
3300,27684,90F8D99B000FA30044B427533078E04F,30809,0,10,10,109.4891,18.28229,1465
3301,27685,90F8D99B000FA30044B427533078E04F,31471,14,16,2,109.34583,18.29563,917
3302,27686,90F8D99B000FA30044B427533078E04F,30741,18,20,2,109.49833,18.28681,1516
3303,27687,90F8D99B000FA30044B427533078E04F,30809,21,23,2,109.4891,18.28229,1465
3304,27693,DA5F3652A4E23CF3043432DC065F58A9,38361,0,8,8,109.43667,18.29201,1267
3305,27694,DA5F3652A4E23CF3043432DC065F58A9,30661,10,12,2,109.37028,18.24361,1008
3306,27695,DA5F3652A4E23CF3043432DC065F58A9,38361,13,17,4,109.43667,18.29201,1267
3310,27715,DCB860DE1ABF6C6DC7663667BFE0A93E,38707,0,10,10,109.73778,18.35368,2427
3311,27716,DCB860DE1ABF6C6DC7663667BFE0A93E,38754,11,12,1,109.74667,18.37382,2430
3312,27717,DCB860DE1ABF6C6DC7663667BFE0A93E,30421,14,15,1,109.50021,18.25861,1511
3313,27718,DCB860DE1ABF6C6DC7663667BFE0A93E,30741,18,21,3,109.49833,18.28681,1516
3314,27721,5E6BED6B24013599647F8A86A362B027,30181,18,20,2,109.51597,18.23313,1557
3315,27722,5E6BED6B24013599647F8A86A362B027,30671,22,23,1,109.43611,18.30139,1268
3316,27751,E887C057B111AD6EF085C23E238E5BF5,31031,0,6,6,109.49979,18.25382,1510
3317,27752,E887C057B111AD6EF085C23E238E5BF5,31031,7,9,2,109.49979,18.25382,1510
3318,27753,E887C057B111AD6EF085C23E238E5BF5,30711,10,14,4,109.50271,18.25347,1510
3319,27754,E887C057B111AD6EF085C23E238E5BF5,30111,15,16,1,109.47583,18.30542,1419
3320,27755,E887C057B111AD6EF085C23E238E5BF5,31031,19,22,3,109.49979,18.25382,1510
3325,27788,09B8D144BA6DE5FAC678EA5795D3C895,30351,17,18,1,109.41701,18.29292,1217
3326,27789,09B8D144BA6DE5FAC678EA5795D3C895,31431,21,23,2,109.44639,18.29042,1316
3327,27790,B84894621C2CCD16DD835408A69C7E48,60524,0,15,15,109.42951,18.28993,1216
3328,27791,B84894621C2CCD16DD835408A69C7E48,31421,18,19,1,109.55382,18.22347,1705
3329,27792,B84894621C2CCD16DD835408A69C7E48,31231,21,22,1,109.42597,18.29292,1217
3330,27867,7260738E9AF8A6F148DEA7642BD04088,30711,12,13,1,109.50271,18.25347,1510
3331,27868,7260738E9AF8A6F148DEA7642BD04088,31521,13,15,2,109.51458,18.22542,1555
3332,27869,7260738E9AF8A6F148DEA7642BD04088,60441,17,18,1,109.46792,18.28604,1366
3333,27870,7260738E9AF8A6F148DEA7642BD04088,31164,19,20,1,109.69993,18.27215,2263
3334,27871,7260738E9AF8A6F148DEA7642BD04088,31521,21,23,2,109.51458,18.22542,1555
3335,27877,B621E9075674E792CCB217233825F9D1,30232,1,6,5,109.6191,18.31701,1971
3336,27878,B621E9075674E792CCB217233825F9D1,60591,11,19,8,109.61118,18.21715,1904
3337,27879,B621E9075674E792CCB217233825F9D1,60631,20,22,2,109.57778,18.27583,1814
3338,27880,E605B26D53F08A0D3360A4541E09F4E2,38283,0,19,19,109.62229,18.22618,1956
3339,27881,E605B26D53F08A0D3360A4541E09F4E2,30721,21,23,2,109.51597,18.28257,1565
3340,27907,7E826D5B1F16716D0276910DC964328A,60594,0,9,9,109.62694,18.22799,1956
3341,27908,7E826D5B1F16716D0276910DC964328A,38052,11,12,1,109.62618,18.23042,1956
3342,27909,7E826D5B1F16716D0276910DC964328A,38754,14,15,1,109.74667,18.37382,2430
3343,27910,7E826D5B1F16716D0276910DC964328A,31221,20,21,1,109.61333,18.26833,1913
3344,27911,7E826D5B1F16716D0276910DC964328A,60594,22,23,1,109.62694,18.22799,1956
3345,27915,6D02659C8AB6FF777A098A468ACF74DA,39154,18,19,1,109.50201,18.25681,1511
3346,27916,6D02659C8AB6FF777A098A468ACF74DA,60541,21,23,2,109.4084,18.29208,1167
3347,27936,0773FF31104402E113D05BA6BA68ACF8,38251,0,6,6,109.49618,18.25493,1510
3348,27937,0773FF31104402E113D05BA6BA68ACF8,31781,8,12,4,109.19847,18.2975,367
3349,27938,0773FF31104402E113D05BA6BA68ACF8,31471,15,16,1,109.34583,18.29563,917
3350,27939,0773FF31104402E113D05BA6BA68ACF8,38251,20,22,2,109.49618,18.25493,1510
3351,27950,39FE922EC788ADA47774DA1BA6D14BA8,30911,0,9,9,109.50493,18.26181,1511
3352,27952,39FE922EC788ADA47774DA1BA6D14BA8,30911,16,23,7,109.50493,18.26181,1511
3353,27957,EB57B1FA26A4B27E3FDFDA03A983298F,31471,14,15,1,109.34583,18.29563,917
3354,27958,EB57B1FA26A4B27E3FDFDA03A983298F,31351,18,20,2,109.4959,18.28417,1465
3355,27959,EB57B1FA26A4B27E3FDFDA03A983298F,31864,20,22,2,109.49014,18.28333,1465
3356,27963,76718E7453F1870CDE0710FB6FA84DEF,30861,0,9,9,109.52722,18.22743,1606
3357,27982,17CC4D48447B18FFE0C5E2D7115F70E9,60161,1,6,5,109.49174,18.26181,1461
3358,27983,17CC4D48447B18FFE0C5E2D7115F70E9,38251,6,8,2,109.49618,18.25493,1510
3359,27984,17CC4D48447B18FFE0C5E2D7115F70E9,60161,10,12,2,109.49174,18.26181,1461
3360,27985,17CC4D48447B18FFE0C5E2D7115F70E9,39151,15,16,1,109.49875,18.25097,1510
3361,27986,17CC4D48447B18FFE0C5E2D7115F70E9,60161,18,21,3,109.49174,18.26181,1461
3362,27990,99356E8E9107D8CC5F639D94C8455F88,38052,1,8,7,109.62618,18.23042,1956
3363,27991,99356E8E9107D8CC5F639D94C8455F88,60594,9,10,1,109.62694,18.22799,1956
3364,27992,99356E8E9107D8CC5F639D94C8455F88,30441,11,13,2,109.64021,18.25424,2010
3365,27993,99356E8E9107D8CC5F639D94C8455F88,31321,13,14,1,109.63799,18.23201,2007
3366,27994,99356E8E9107D8CC5F639D94C8455F88,60594,14,17,3,109.62694,18.22799,1956
3367,27995,99356E8E9107D8CC5F639D94C8455F88,38052,21,23,2,109.62618,18.23042,1956
3368,28026,C5CABECFD4367CE586A1356E70EEB174,38291,12,13,1,109.51618,18.24313,1558
3369,28027,C5CABECFD4367CE586A1356E70EEB174,30571,14,17,3,109.50243,18.21861,1504
3370,28028,C5CABECFD4367CE586A1356E70EEB174,30271,21,23,2,109.49132,18.23153,1456
3371,28038,8D0A4EF6BB9DEDE12E59D3FEDBD17479,30111,14,17,3,109.47583,18.30542,1419
3372,28039,8D0A4EF6BB9DEDE12E59D3FEDBD17479,31345,19,23,4,109.39,18.29,1066
3373,28116,D517610C2076C41FED0ED80CB6FFB44C,31561,0,5,5,109.56792,18.28479,1765
3374,28117,D517610C2076C41FED0ED80CB6FFB44C,30851,6,21,15,109.5616,18.27396,1713
3392,28241,0520DF82F6737D601C0552DC0C1A8F1E,31431,5,7,2,109.44639,18.29042,1316
3393,28242,0520DF82F6737D601C0552DC0C1A8F1E,31781,12,13,1,109.19847,18.2975,367
3398,28298,B0B0164974C62F379D91F845F4C0BE0F,31471,0,11,11,109.34583,18.29563,917
3399,28299,B0B0164974C62F379D91F845F4C0BE0F,38271,14,16,2,109.62632,18.23049,1956
3400,28300,B0B0164974C62F379D91F845F4C0BE0F,60321,17,23,6,109.63611,18.24306,2008
3401,28305,D78D90B541213AC9F2AA85F657BE1C24,31391,0,10,10,109.50382,18.24285,1508
3402,28306,D78D90B541213AC9F2AA85F657BE1C24,31031,10,13,3,109.49979,18.25382,1510
3403,28307,D78D90B541213AC9F2AA85F657BE1C24,30361,13,15,2,109.50347,18.24,1508
3404,28308,D78D90B541213AC9F2AA85F657BE1C24,38271,19,23,4,109.62632,18.23049,1956
3408,28353,06FCF67485A2B44C8ABC96FDB92547C5,61011,1,2,1,109.60653,18.19076,1900
3409,28355,06FCF67485A2B44C8ABC96FDB92547C5,61011,8,15,7,109.60653,18.19076,1900
3410,28362,53875E69050EC42E511A64D3211FA7B3,30854,9,10,1,109.56889,18.27076,1763
3411,28363,53875E69050EC42E511A64D3211FA7B3,31071,13,14,1,109.58257,18.28458,1815
3412,28364,53875E69050EC42E511A64D3211FA7B3,30854,16,17,1,109.56889,18.27076,1763
3413,28365,53875E69050EC42E511A64D3211FA7B3,60631,21,23,2,109.57778,18.27583,1814
3414,28371,41C7AB3466DC83ECF2F7D17909D01D78,38754,16,17,1,109.74667,18.37382,2430
3415,28391,ABCD0851CC1C78BCD7AF6DBDF2F5DE49,60552,4,7,3,109.41729,18.30014,1218
3416,28392,ABCD0851CC1C78BCD7AF6DBDF2F5DE49,30211,7,14,7,109.49882,18.23931,1508
3417,28393,ABCD0851CC1C78BCD7AF6DBDF2F5DE49,60552,15,17,2,109.41729,18.30014,1218
3418,28394,ABCD0851CC1C78BCD7AF6DBDF2F5DE49,30211,18,20,2,109.49882,18.23931,1508
3419,28396,9B8B54E350D3B9115A38576A3DFFEADD,31801,10,14,4,109.20417,18.32118,371
3420,28401,5E97A4561E11AAC4FBC53FD068EAA52B,30854,0,14,14,109.56889,18.27076,1763
3421,28402,5E97A4561E11AAC4FBC53FD068EAA52B,30861,18,20,2,109.52722,18.22743,1606
3422,28403,5E97A4561E11AAC4FBC53FD068EAA52B,30854,22,23,1,109.56889,18.27076,1763
3423,28426,DE13C3C5F535C73FEAA4828FD0224890,60161,3,6,3,109.49174,18.26181,1461
3424,28427,DE13C3C5F535C73FEAA4828FD0224890,60131,6,8,2,109.49819,18.24778,1509
3425,28428,DE13C3C5F535C73FEAA4828FD0224890,31471,12,13,1,109.34583,18.29563,917
3426,28429,DE13C3C5F535C73FEAA4828FD0224890,38754,14,17,3,109.74667,18.37382,2430
3427,28430,DE13C3C5F535C73FEAA4828FD0224890,30201,18,19,1,109.4909,18.26465,1462
3428,28431,DE13C3C5F535C73FEAA4828FD0224890,60131,20,21,1,109.49819,18.24778,1509
3429,28432,DE13C3C5F535C73FEAA4828FD0224890,30771,22,23,1,109.49938,18.26042,1511
3430,28503,E83EEC0EDEADBA548B114EA601516E47,38291,19,20,1,109.51618,18.24313,1558
3431,28504,E83EEC0EDEADBA548B114EA601516E47,60291,22,23,1,109.50826,18.24639,1509
3432,28509,B643AC77F8D8498A9694D45BA8B0F75F,60631,0,5,5,109.57778,18.27583,1814
3433,28510,B643AC77F8D8498A9694D45BA8B0F75F,30854,7,9,2,109.56889,18.27076,1763
3434,28511,B643AC77F8D8498A9694D45BA8B0F75F,33481,10,12,2,109.67278,18.41278,2187
3435,28512,B643AC77F8D8498A9694D45BA8B0F75F,30854,13,23,10,109.56889,18.27076,1763
3436,28520,0398D207FA452E02863057A6622936B4,31091,0,7,7,109.41201,18.31222,1170
3437,28521,0398D207FA452E02863057A6622936B4,60541,9,10,1,109.4084,18.29208,1167
3438,28522,0398D207FA452E02863057A6622936B4,30561,13,14,1,109.52778,18.31938,1621
3439,28523,0398D207FA452E02863057A6622936B4,31101,15,18,3,109.65389,18.23403,2057
3440,28524,0398D207FA452E02863057A6622936B4,30201,19,20,1,109.4909,18.26465,1462
3441,28525,0398D207FA452E02863057A6622936B4,60171,22,23,1,109.51292,18.30694,1569
3442,28540,E5D9C2E63CCE9D1234DB3809C4F11F20,38291,0,9,9,109.51618,18.24313,1558
3443,28541,E5D9C2E63CCE9D1234DB3809C4F11F20,31671,10,11,1,109.38965,18.29813,1068
3444,28542,E5D9C2E63CCE9D1234DB3809C4F11F20,30051,14,15,1,109.48917,18.21215,1453
3445,28543,E5D9C2E63CCE9D1234DB3809C4F11F20,30721,18,22,4,109.51597,18.28257,1565
3449,28615,486A78088314F236B361634EA8E4A8C3,60054,14,16,2,109.3016,18.31229,770
3450,28616,486A78088314F236B361634EA8E4A8C3,30821,18,19,1,109.43681,18.33639,1274
3454,28692,1B440859AEF8AC43F8A5EC98A36E6227,31571,0,7,7,109.61563,18.23326,1957
3455,28693,1B440859AEF8AC43F8A5EC98A36E6227,31421,7,23,16,109.55382,18.22347,1705
3456,28699,0C16D819785C0566D50CC6C5E7058EF2,30571,0,20,20,109.50243,18.21861,1504
3457,28700,0C16D819785C0566D50CC6C5E7058EF2,30571,21,23,2,109.50243,18.21861,1504
3458,28728,F198CAA1F49ACA5D003FD8F8473B3798,31071,14,17,3,109.58257,18.28458,1815
3459,28729,F198CAA1F49ACA5D003FD8F8473B3798,30854,17,20,3,109.56889,18.27076,1763
3470,28794,BE44C2D8594D42B84C16E0E81B3F6120,30971,0,6,6,109.48708,18.29319,1467
3471,28795,BE44C2D8594D42B84C16E0E81B3F6120,31101,11,13,2,109.65389,18.23403,2057
3472,28796,BE44C2D8594D42B84C16E0E81B3F6120,31031,14,16,2,109.49979,18.25382,1510
3473,28797,BE44C2D8594D42B84C16E0E81B3F6120,30971,18,20,2,109.48708,18.29319,1467
3474,28798,BE44C2D8594D42B84C16E0E81B3F6120,31351,21,23,2,109.4959,18.28417,1465
3475,28825,B43DB539B5964E15F0064080164C40C1,60631,0,7,7,109.57778,18.27583,1814
3476,28826,B43DB539B5964E15F0064080164C40C1,38085,8,9,1,109.6291,18.23625,2007
3477,28827,B43DB539B5964E15F0064080164C40C1,38052,10,16,6,109.62618,18.23042,1956
3478,28840,4B683433D97E5741B264EA56EEB5A278,39151,14,16,2,109.49875,18.25097,1510
3479,28841,4B683433D97E5741B264EA56EEB5A278,31031,20,21,1,109.49979,18.25382,1510
3480,28842,4B683433D97E5741B264EA56EEB5A278,60131,22,23,1,109.49819,18.24778,1509
3481,28863,E0C692116FEED9FE20A5CF7D2F4944B1,60241,14,16,2,109.53319,18.28667,1616
3482,28864,E0C692116FEED9FE20A5CF7D2F4944B1,60401,19,20,1,109.47444,18.27583,1414
3483,28865,3A5827A88DC93A9B58B304F6E1017BB8,60161,10,12,2,109.49174,18.26181,1461
3484,28866,3A5827A88DC93A9B58B304F6E1017BB8,38251,13,14,1,109.49618,18.25493,1510
3485,28867,3A5827A88DC93A9B58B304F6E1017BB8,30361,18,20,2,109.50347,18.24,1508
3486,28868,3A5827A88DC93A9B58B304F6E1017BB8,60401,21,22,1,109.47444,18.27583,1414
3487,28978,34EBFD58B61AA75C4B7A19FD8B59EBD4,31864,12,13,1,109.49014,18.28333,1465
3488,28979,34EBFD58B61AA75C4B7A19FD8B59EBD4,30171,15,17,2,109.48458,18.27139,1463
3489,28980,34EBFD58B61AA75C4B7A19FD8B59EBD4,30771,19,21,2,109.49938,18.26042,1511
3490,28981,34EBFD58B61AA75C4B7A19FD8B59EBD4,31864,21,23,2,109.49014,18.28333,1465
3491,28982,9FEA4B85EAE4FAEE1CAF0EABFF2FAEA1,39183,17,18,1,109.55542,18.28208,1715
3492,28983,9FEA4B85EAE4FAEE1CAF0EABFF2FAEA1,30854,19,21,2,109.56889,18.27076,1763
3493,28984,9FEA4B85EAE4FAEE1CAF0EABFF2FAEA1,31561,22,23,1,109.56792,18.28479,1765
3497,29002,B2F5783D04A876F88E32A31C35DBACDE,30764,1,8,7,109.45806,18.29486,1367
3498,29003,B2F5783D04A876F88E32A31C35DBACDE,31471,11,12,1,109.34583,18.29563,917
3499,29020,EF428BA2D8FF285B80F14CDB1F80FC95,31841,3,13,10,109.73201,18.33382,2373
3500,29022,EF428BA2D8FF285B80F14CDB1F80FC95,60381,20,21,1,109.5241,18.22458,1605
3501,29089,6AEAAC41A7CA163913D92BB931215E92,31781,14,15,1,109.19847,18.2975,367
3502,29090,6AEAAC41A7CA163913D92BB931215E92,31471,16,18,2,109.34583,18.29563,917
3503,29091,6AEAAC41A7CA163913D92BB931215E92,38251,21,23,2,109.49618,18.25493,1510
3504,29136,37064F9BC763FD0F497B111F9661D621,30711,0,14,14,109.50271,18.25347,1510
3505,29137,37064F9BC763FD0F497B111F9661D621,31121,16,17,1,109.16292,18.37063,230
3506,29138,37064F9BC763FD0F497B111F9661D621,39091,19,23,4,109.50097,18.25222,1510
3507,29160,5C958E9FBADCA0FB00CA547ED9076A9C,30421,18,20,2,109.50021,18.25861,1511
3508,29181,34211070C0856836040CA55D5A0FB3C4,60491,1,6,5,109.43354,18.30847,1269
3509,29182,34211070C0856836040CA55D5A0FB3C4,30341,7,8,1,109.3625,18.29167,966
3510,29183,34211070C0856836040CA55D5A0FB3C4,30661,9,12,3,109.37028,18.24361,1008
3515,29201,76F8F71E1A0B4A83674B128BDF4E5B21,31471,17,18,1,109.34583,18.29563,917
3516,29202,76F8F71E1A0B4A83674B128BDF4E5B21,30791,21,23,2,109.72333,18.40889,2386
3517,29213,F5B7F5C404245BA9BE51737FA0FA3FAB,38707,12,13,1,109.73778,18.35368,2427
3518,29214,F5B7F5C404245BA9BE51737FA0FA3FAB,38754,14,16,2,109.74667,18.37382,2430
3519,29232,344269AF3A98B26B4D929AD801D6CB3E,31031,12,13,1,109.49979,18.25382,1510
3523,29268,85D2E0E28FB58C7F8A0D7BC94160D3DD,30861,16,17,1,109.52722,18.22743,1606
3524,29269,85D2E0E28FB58C7F8A0D7BC94160D3DD,30851,22,23,1,109.5616,18.27396,1713
3525,29302,36CB9BFBE6722CF45733B1AB5C92EBF8,30854,0,17,17,109.56889,18.27076,1763
3526,29303,36CB9BFBE6722CF45733B1AB5C92EBF8,60631,21,23,2,109.57778,18.27583,1814
3527,29304,2181C8620FF53874795AD3D65A9D5C0A,30854,0,2,2,109.56889,18.27076,1763
3528,29305,2181C8620FF53874795AD3D65A9D5C0A,60504,6,7,1,109.47917,18.28903,1416
3529,29306,2181C8620FF53874795AD3D65A9D5C0A,30854,12,13,1,109.56889,18.27076,1763
3530,29308,2181C8620FF53874795AD3D65A9D5C0A,30854,18,22,4,109.56889,18.27076,1763
3531,29318,74AD1AF2EA5153BD40BCF9A3F3F2C4E3,30854,9,16,7,109.56889,18.27076,1763
3532,29319,74AD1AF2EA5153BD40BCF9A3F3F2C4E3,30191,21,23,2,109.50361,18.22701,1506
3533,29363,A69D60E4C46A973519D52B01D44B91F0,31701,10,11,1,109.44132,18.28833,1266
3534,29364,A69D60E4C46A973519D52B01D44B91F0,31671,11,12,1,109.38965,18.29813,1068
3535,29374,8FD14163A768E4253DDACA49F82AA67E,31041,15,17,2,109.50278,18.23701,1507
3536,29375,8FD14163A768E4253DDACA49F82AA67E,30361,18,21,3,109.50347,18.24,1508
3537,29377,4DEA461E038CB97C304B1C8C76D68215,31521,13,18,5,109.51458,18.22542,1555
3538,29378,4DEA461E038CB97C304B1C8C76D68215,39321,21,23,2,109.529,18.2167,1604
3542,29410,0B9CDE8BB5F2B882023703530E5D7EF8,30731,14,15,1,109.50944,18.22306,1555
3543,29411,0B9CDE8BB5F2B882023703530E5D7EF8,30361,17,18,1,109.50347,18.24,1508
3547,29448,A94F66C88B84FF0658441320CD9F667C,31071,1,6,5,109.58257,18.28458,1815
3548,29449,A94F66C88B84FF0658441320CD9F667C,30854,9,23,14,109.56889,18.27076,1763
3549,29453,E5A3ABAC97D4B4693E578C38076A1DC3,30731,0,6,6,109.50944,18.22306,1555
3550,29454,E5A3ABAC97D4B4693E578C38076A1DC3,31521,7,9,2,109.51458,18.22542,1555
3551,29455,E5A3ABAC97D4B4693E578C38076A1DC3,30791,12,16,4,109.72333,18.40889,2386
3552,29456,E5A3ABAC97D4B4693E578C38076A1DC3,38111,17,18,1,109.52007,18.22403,1555
3553,29457,E5A3ABAC97D4B4693E578C38076A1DC3,31521,18,22,4,109.51458,18.22542,1555
3554,29492,8CE55AC8BC984D52D16D6CE4872EB6FC,31391,0,19,19,109.50382,18.24285,1508
3558,29565,6363BCFC385B99D6DCC7B37759A60837,30434,14,15,1,109.17083,18.35861,278
3559,29566,6363BCFC385B99D6DCC7B37759A60837,30451,16,17,1,109.1791,18.36229,278
3560,29567,6363BCFC385B99D6DCC7B37759A60837,31121,18,19,1,109.16292,18.37063,230
3561,29568,6363BCFC385B99D6DCC7B37759A60837,30434,20,22,2,109.17083,18.35861,278
3562,29576,8B167331F8E78254A4CBA6A89A1236BC,60401,15,17,2,109.47444,18.27583,1414
3563,29577,8B167331F8E78254A4CBA6A89A1236BC,60524,20,23,3,109.42951,18.28993,1216
3564,29582,567BF1868FBA42FA9B3B29F2CA13F65D,30221,0,1,1,109.57833,18.20222,1802
3565,29583,567BF1868FBA42FA9B3B29F2CA13F65D,31931,4,17,13,109.54771,18.29403,1667
3570,29613,8D7B9451E0189947198D6AC9CE51CFEE,31091,0,7,7,109.41201,18.31222,1170
3571,29614,8D7B9451E0189947198D6AC9CE51CFEE,30661,9,11,2,109.37028,18.24361,1008
3572,29615,8D7B9451E0189947198D6AC9CE51CFEE,31091,13,19,6,109.41201,18.31222,1170
3573,29616,8D7B9451E0189947198D6AC9CE51CFEE,30111,20,22,2,109.47583,18.30542,1419
3574,29634,1E6314831320135D70F9B2103732B381,39151,11,12,1,109.49875,18.25097,1510
3575,29635,1E6314831320135D70F9B2103732B381,31031,12,15,3,109.49979,18.25382,1510
3576,29641,D947D8D9432E18EA6A214259B6E2987E,60411,0,7,7,109.32514,18.30854,869
3577,29642,D947D8D9432E18EA6A214259B6E2987E,30661,8,13,5,109.37028,18.24361,1008
3578,29643,D947D8D9432E18EA6A214259B6E2987E,60411,14,23,9,109.32514,18.30854,869
3582,29651,BF8433CB102DC5403FA3CD5A55490BD8,31521,0,9,9,109.51458,18.22542,1555
3583,29652,BF8433CB102DC5403FA3CD5A55490BD8,30861,9,11,2,109.52722,18.22743,1606
3584,29653,BF8433CB102DC5403FA3CD5A55490BD8,60054,14,15,1,109.3016,18.31229,770
3585,29654,BF8433CB102DC5403FA3CD5A55490BD8,31521,17,19,2,109.51458,18.22542,1555
3586,29655,BF8433CB102DC5403FA3CD5A55490BD8,60381,22,23,1,109.5241,18.22458,1605
3591,29695,19313A561FA1DB3650F358264FB3F752,38951,18,19,1,109.48097,18.28868,1416
3592,29696,19313A561FA1DB3650F358264FB3F752,38951,20,23,3,109.48097,18.28868,1416
3593,29719,F84D949DDCBF25D5530F771BC55E0B9D,61011,2,5,3,109.60653,18.19076,1900
3594,29721,F84D949DDCBF25D5530F771BC55E0B9D,61011,20,23,3,109.60653,18.19076,1900
3595,29744,B8989CFFC223BB64D623BE9489BA8A6F,38706,0,9,9,109.74625,18.37097,2430
3596,29745,B8989CFFC223BB64D623BE9489BA8A6F,31145,11,15,4,109.20431,18.30479,369
3597,29746,B8989CFFC223BB64D623BE9489BA8A6F,39101,17,18,1,109.50132,18.24931,1509
3598,29747,B8989CFFC223BB64D623BE9489BA8A6F,60121,21,23,2,109.74507,18.37472,2430
3609,29801,EBCB949B72E5CE9FCA5E9C7D3826BEF9,30361,15,16,1,109.50347,18.24,1508
3610,29802,EBCB949B72E5CE9FCA5E9C7D3826BEF9,60201,17,20,3,109.5041,18.2509,1510
3611,29803,EBCB949B72E5CE9FCA5E9C7D3826BEF9,31206,20,22,2,109.50819,18.23549,1507
3612,29814,5E28EAB5F2E807365535BF3233D32C9B,31521,0,13,13,109.51458,18.22542,1555
3613,29815,5E28EAB5F2E807365535BF3233D32C9B,38017,13,14,1,109.49729,18.21424,1504
3614,29835,C162E20472DBB598395501A28AA53C86,31671,0,7,7,109.38965,18.29813,1068
3615,29836,C162E20472DBB598395501A28AA53C86,31861,7,9,2,109.49042,18.27549,1464
3616,29837,C162E20472DBB598395501A28AA53C86,30161,13,14,1,109.50042,18.24389,1508
3617,29838,C162E20472DBB598395501A28AA53C86,38185,15,18,3,109.51333,18.27347,1563
3618,29839,C162E20472DBB598395501A28AA53C86,60261,20,23,3,109.44326,18.3075,1319
3629,29965,E00EF22F493557E868E52C93194870CF,31071,0,6,6,109.58257,18.28458,1815
3630,29966,E00EF22F493557E868E52C93194870CF,30854,10,11,1,109.56889,18.27076,1763
3631,29980,DDF6BFAF733FBE3256FA7987742F55BA,39321,0,3,3,109.529,18.2167,1604
3632,29981,DDF6BFAF733FBE3256FA7987742F55BA,31421,3,7,4,109.55382,18.22347,1705
3633,29982,DDF6BFAF733FBE3256FA7987742F55BA,31301,9,11,2,109.14493,18.31222,170
3634,29983,DDF6BFAF733FBE3256FA7987742F55BA,31471,13,14,1,109.34583,18.29563,917
3635,29984,DDF6BFAF733FBE3256FA7987742F55BA,30351,16,17,1,109.41701,18.29292,1217
3636,29985,DDF6BFAF733FBE3256FA7987742F55BA,31061,18,19,1,109.53333,18.23257,1607
3637,29986,DDF6BFAF733FBE3256FA7987742F55BA,31421,20,23,3,109.55382,18.22347,1705
3638,30000,E5E2DA460104E389257158E8D8C9FBDA,60281,0,6,6,109.51743,18.25924,1561
3639,30001,E5E2DA460104E389257158E8D8C9FBDA,30251,6,11,5,109.50611,18.26653,1512
3640,30002,E5E2DA460104E389257158E8D8C9FBDA,31261,12,13,1,109.51174,18.2466,1559
3641,30003,E5E2DA460104E389257158E8D8C9FBDA,30251,14,17,3,109.50611,18.26653,1512
3642,30004,E5E2DA460104E389257158E8D8C9FBDA,60281,18,23,5,109.51743,18.25924,1561
3643,30016,415231A057DA1965AE18633C79DF4000,60614,3,5,2,109.48799,18.29521,1467
3644,30017,415231A057DA1965AE18633C79DF4000,60501,9,10,1,109.48701,18.29021,1466
3645,30039,1AE87A1A31A67C66BE8B0545FB82EAD0,30854,3,7,4,109.56889,18.27076,1763
3646,30040,1AE87A1A31A67C66BE8B0545FB82EAD0,31101,10,14,4,109.65389,18.23403,2057
3647,30041,1AE87A1A31A67C66BE8B0545FB82EAD0,31321,17,19,2,109.63799,18.23201,2007
3651,30099,768772075CF0012C3AC9B6461FB816C4,31231,0,8,8,109.42597,18.29292,1217
3652,30100,768772075CF0012C3AC9B6461FB816C4,60231,10,12,2,109.49903,18.21972,1504
3653,30101,768772075CF0012C3AC9B6461FB816C4,31471,14,16,2,109.34583,18.29563,917
3654,30102,768772075CF0012C3AC9B6461FB816C4,31231,18,20,2,109.42597,18.29292,1217
3655,30130,012ABD06F231728C214A4BA917E75B1C,30851,9,15,6,109.5616,18.27396,1713
3656,30131,012ABD06F231728C214A4BA917E75B1C,31561,16,23,7,109.56792,18.28479,1765
3657,30132,6541238A8C58DB37BA1296ADDD670E65,31471,13,16,3,109.34583,18.29563,917
3658,30133,6541238A8C58DB37BA1296ADDD670E65,31351,18,20,2,109.4959,18.28417,1465
3659,30134,A938D17B78A9CC3BBA601ADC3528D1E9,31521,0,1,1,109.51458,18.22542,1555
3660,30135,A938D17B78A9CC3BBA601ADC3528D1E9,39111,2,4,2,109.5191,18.22597,1555
3661,30136,A938D17B78A9CC3BBA601ADC3528D1E9,39321,5,15,10,109.529,18.2167,1604
3662,30137,A938D17B78A9CC3BBA601ADC3528D1E9,60381,16,19,3,109.5241,18.22458,1605
3663,30138,A938D17B78A9CC3BBA601ADC3528D1E9,39321,20,22,2,109.529,18.2167,1604
3667,30185,1980C8D409DE9551539224B3D393CDAA,38991,1,2,1,109.52681,18.30368,1618
3668,30186,1980C8D409DE9551539224B3D393CDAA,30071,2,3,1,109.52819,18.30472,1619
3669,30187,1980C8D409DE9551539224B3D393CDAA,30071,7,14,7,109.52819,18.30472,1619
3670,30188,1980C8D409DE9551539224B3D393CDAA,30071,16,20,4,109.52819,18.30472,1619
3671,30189,1980C8D409DE9551539224B3D393CDAA,31951,22,23,1,109.52174,18.30299,1568
3679,30247,D2C6FC87582B8AF9FC2A25EE621715E3,30111,0,10,10,109.47583,18.30542,1419
3680,30248,D2C6FC87582B8AF9FC2A25EE621715E3,30681,11,12,1,109.48493,18.26917,1463
3681,30249,D2C6FC87582B8AF9FC2A25EE621715E3,38094,17,18,1,109.45403,18.28778,1316
3682,30250,D2C6FC87582B8AF9FC2A25EE621715E3,30201,19,20,1,109.4909,18.26465,1462
3683,30251,D2C6FC87582B8AF9FC2A25EE621715E3,30111,21,23,2,109.47583,18.30542,1419
3684,30255,983D4F389BF2B6DDDB09B0049946D36C,60614,0,9,9,109.48799,18.29521,1467
3685,30256,983D4F389BF2B6DDDB09B0049946D36C,38951,9,11,2,109.48097,18.28868,1416
3686,30257,983D4F389BF2B6DDDB09B0049946D36C,30971,11,12,1,109.48708,18.29319,1467
3687,30258,983D4F389BF2B6DDDB09B0049946D36C,38951,14,19,5,109.48097,18.28868,1416
3688,30259,983D4F389BF2B6DDDB09B0049946D36C,38951,22,23,1,109.48097,18.28868,1416
3693,30283,3DAF31DB1DFDD7FA7EE0727CC0FC2507,31571,5,8,3,109.61563,18.23326,1957
3694,30300,37385E5852F0E8B9BD379DD12A67AD23,31351,17,18,1,109.4959,18.28417,1465
3695,30301,37385E5852F0E8B9BD379DD12A67AD23,30151,18,21,3,109.50986,18.25083,1560
3696,30302,37385E5852F0E8B9BD379DD12A67AD23,31864,21,23,2,109.49014,18.28333,1465
3697,30347,8752BC71725B50257436D50C6598F252,31071,0,11,11,109.58257,18.28458,1815
3698,30348,8752BC71725B50257436D50C6598F252,30854,12,14,2,109.56889,18.27076,1763
3699,30353,653802FBFFAEB319D5E2987830A7AC5C,60281,0,9,9,109.51743,18.25924,1561
3700,30354,653802FBFFAEB319D5E2987830A7AC5C,30741,11,13,2,109.49833,18.28681,1516
3701,30355,653802FBFFAEB319D5E2987830A7AC5C,60491,13,14,1,109.43354,18.30847,1269
3706,30401,5332105DB723D1E9073D15BB8FF1303A,60041,0,11,11,109.39889,18.31944,1121
3707,30402,5332105DB723D1E9073D15BB8FF1303A,30581,16,20,4,109.62257,18.24951,1959
3708,30403,5332105DB723D1E9073D15BB8FF1303A,38275,20,22,2,109.62875,18.22938,2006
3709,30486,4E71431CA64A26F33A810235C31BD9CB,31781,14,16,2,109.19847,18.2975,367
3710,30487,4E71431CA64A26F33A810235C31BD9CB,31231,21,22,1,109.42597,18.29292,1217
3711,30488,104EFBF239A23046252D07031DBBF3A9,30361,18,19,1,109.50347,18.24,1508
3712,30489,104EFBF239A23046252D07031DBBF3A9,60231,20,22,2,109.49903,18.21972,1504
3717,30537,D96E01B8E0F0DE9C160C9FEAFDCFDB6D,31071,2,7,5,109.58257,18.28458,1815
3718,30538,D96E01B8E0F0DE9C160C9FEAFDCFDB6D,30854,8,18,10,109.56889,18.27076,1763
3719,30564,32D0EBFA645FCE8DAD65D018847E5043,30232,0,6,6,109.6191,18.31701,1971
3720,30565,32D0EBFA645FCE8DAD65D018847E5043,30854,7,9,2,109.56889,18.27076,1763
3721,30566,32D0EBFA645FCE8DAD65D018847E5043,30232,10,12,2,109.6191,18.31701,1971
3722,30567,32D0EBFA645FCE8DAD65D018847E5043,30854,15,23,8,109.56889,18.27076,1763
3726,30619,70101050DBAAA058104471D2D2A0BE56,31521,0,7,7,109.51458,18.22542,1555
3727,30621,70101050DBAAA058104471D2D2A0BE56,31781,12,14,2,109.19847,18.2975,367
3728,30622,70101050DBAAA058104471D2D2A0BE56,60551,18,20,2,109.42722,18.30111,1218
3729,30624,E4F1C82E597EBE1C472A3BECEA4ABECB,38094,11,13,2,109.45403,18.28778,1316
3730,30625,E4F1C82E597EBE1C472A3BECEA4ABECB,30361,17,19,2,109.50347,18.24,1508
3731,30626,E4F1C82E597EBE1C472A3BECEA4ABECB,38094,20,23,3,109.45403,18.28778,1316
3732,30641,7D1ED6067ECBD941EFC43CE0A6ADAE71,31945,0,5,5,109.58021,18.29403,1817
3733,30642,7D1ED6067ECBD941EFC43CE0A6ADAE71,30854,6,14,8,109.56889,18.27076,1763
3734,30661,04791679D14F3A9B55A1CA70D7059A86,30241,9,11,2,109.26174,18.3275,622
3735,30662,04791679D14F3A9B55A1CA70D7059A86,31471,15,16,1,109.34583,18.29563,917
3736,30663,04791679D14F3A9B55A1CA70D7059A86,60551,19,20,1,109.42722,18.30111,1218
3737,30664,04791679D14F3A9B55A1CA70D7059A86,31671,21,23,2,109.38965,18.29813,1068
3738,30679,FD5B9AB034F15F72E8BEF02193669238,31931,8,10,2,109.54771,18.29403,1667
3739,30680,FD5B9AB034F15F72E8BEF02193669238,60241,12,13,1,109.53319,18.28667,1616
3740,30681,FD5B9AB034F15F72E8BEF02193669238,31931,14,15,1,109.54771,18.29403,1667
3741,30725,4028903DDD08DD112881FE1C80374A0D,31071,0,2,2,109.58257,18.28458,1815
3742,30726,4028903DDD08DD112881FE1C80374A0D,30854,5,14,9,109.56889,18.27076,1763
3746,30743,08A066736557478B1013C0CF834491DF,30921,0,6,6,109.53903,18.29451,1667
3747,30744,08A066736557478B1013C0CF834491DF,31931,8,22,14,109.54771,18.29403,1667
3748,30748,A4120452FF09D9783BEC38585F9D2055,38134,0,5,5,109.63931,18.23451,2007
3749,30749,A4120452FF09D9783BEC38585F9D2055,60321,8,10,2,109.63611,18.24306,2008
3750,30750,A4120452FF09D9783BEC38585F9D2055,30581,11,13,2,109.62257,18.24951,1959
3751,30751,A4120452FF09D9783BEC38585F9D2055,31781,14,16,2,109.19847,18.2975,367
3752,30760,AB51E4EDC409816E27BE55C280A4BEBE,60552,0,10,10,109.41729,18.30014,1218
3753,30761,AB51E4EDC409816E27BE55C280A4BEBE,31231,10,11,1,109.42597,18.29292,1217
3754,30762,AB51E4EDC409816E27BE55C280A4BEBE,60552,12,13,1,109.41729,18.30014,1218
3755,30763,AB51E4EDC409816E27BE55C280A4BEBE,31231,14,17,3,109.42597,18.29292,1217
3756,30764,AB51E4EDC409816E27BE55C280A4BEBE,60552,20,23,3,109.41729,18.30014,1218
3757,30771,AD0A1E1F1E587F1E96859B31EF886F77,30341,7,8,1,109.3625,18.29167,966
3758,30772,AD0A1E1F1E587F1E96859B31EF886F77,30661,8,11,3,109.37028,18.24361,1008
3759,30773,AD0A1E1F1E587F1E96859B31EF886F77,31471,14,15,1,109.34583,18.29563,917
3760,30774,4C01ADD3007A66495A13EABB73C61928,31561,10,12,2,109.56792,18.28479,1765
3761,30779,00FC332040A284DA251A8D0705989FE9,31071,0,7,7,109.58257,18.28458,1815
3762,30780,00FC332040A284DA251A8D0705989FE9,30854,8,16,8,109.56889,18.27076,1763
3763,30781,00FC332040A284DA251A8D0705989FE9,30151,18,20,2,109.50986,18.25083,1560
3764,30799,56DFEAF03DB999C001DE943D9823E4CB,31231,12,16,4,109.42597,18.29292,1217
3765,30800,56DFEAF03DB999C001DE943D9823E4CB,30211,17,19,2,109.49882,18.23931,1508
3766,30801,56DFEAF03DB999C001DE943D9823E4CB,30211,19,21,2,109.49882,18.23931,1508
3767,30802,60C76AD19DF8888A84F620E94C92FF2B,30571,11,13,2,109.50243,18.21861,1504
3768,30803,60C76AD19DF8888A84F620E94C92FF2B,60231,13,22,9,109.49903,18.21972,1504
3769,30804,7787049F99708250268B39FE13E299CD,38361,0,9,9,109.43667,18.29201,1267
3770,30805,7787049F99708250268B39FE13E299CD,31781,11,14,3,109.19847,18.2975,367
3771,30806,7787049F99708250268B39FE13E299CD,31471,16,17,1,109.34583,18.29563,917
3772,30807,7787049F99708250268B39FE13E299CD,30671,18,21,3,109.43611,18.30139,1268
3776,30861,A0DF8CD46D095FD0BDC705548C0AFCD7,30581,12,14,2,109.62257,18.24951,1959
3777,30862,A0DF8CD46D095FD0BDC705548C0AFCD7,31145,16,17,1,109.20431,18.30479,369
3778,30901,5F70E6EFF50C46A1203DB5C4C03B4FD3,31701,0,7,7,109.44132,18.28833,1266
3779,30902,5F70E6EFF50C46A1203DB5C4C03B4FD3,31431,8,11,3,109.44639,18.29042,1316
3780,30903,5F70E6EFF50C46A1203DB5C4C03B4FD3,31311,15,17,2,109.72299,18.27438,2364
3781,30928,51144F334134DECCE0E931E2D7A07D76,30921,7,8,1,109.53903,18.29451,1667
3782,30929,51144F334134DECCE0E931E2D7A07D76,30711,13,14,1,109.50271,18.25347,1510
3783,30930,51144F334134DECCE0E931E2D7A07D76,39091,19,23,4,109.50097,18.25222,1510
3784,30943,DFFF17B7FE30E79B8AABBB5CE171272F,30854,11,12,1,109.56889,18.27076,1763
3785,30944,DFFF17B7FE30E79B8AABBB5CE171272F,31561,12,14,2,109.56792,18.28479,1765
3786,30945,DFFF17B7FE30E79B8AABBB5CE171272F,31931,15,16,1,109.54771,18.29403,1667
3787,30946,DFFF17B7FE30E79B8AABBB5CE171272F,39183,18,19,1,109.55542,18.28208,1715
3788,30947,DFFF17B7FE30E79B8AABBB5CE171272F,31561,20,23,3,109.56792,18.28479,1765
3793,30998,8CD15CF6B5FB4821940FF9AFE6D6CB84,31931,0,6,6,109.54771,18.29403,1667
3794,30999,8CD15CF6B5FB4821940FF9AFE6D6CB84,30071,6,10,4,109.52819,18.30472,1619
3795,31000,8CD15CF6B5FB4821940FF9AFE6D6CB84,31931,15,17,2,109.54771,18.29403,1667
3796,31001,8CD15CF6B5FB4821940FF9AFE6D6CB84,30071,19,20,1,109.52819,18.30472,1619
3797,31002,8CD15CF6B5FB4821940FF9AFE6D6CB84,31931,22,23,1,109.54771,18.29403,1667
3798,31008,248CE0B148D688C343222BB27AEE2380,31071,0,1,1,109.58257,18.28458,1815
3799,31009,248CE0B148D688C343222BB27AEE2380,60631,1,3,2,109.57778,18.27583,1814
3800,31010,248CE0B148D688C343222BB27AEE2380,31071,4,5,1,109.58257,18.28458,1815
3801,31011,248CE0B148D688C343222BB27AEE2380,60631,5,7,2,109.57778,18.27583,1814
3802,31012,248CE0B148D688C343222BB27AEE2380,30854,8,10,2,109.56889,18.27076,1763
3803,31013,248CE0B148D688C343222BB27AEE2380,60631,13,15,2,109.57778,18.27583,1814
3804,31014,248CE0B148D688C343222BB27AEE2380,31071,16,17,1,109.58257,18.28458,1815
3805,31015,248CE0B148D688C343222BB27AEE2380,31041,19,20,1,109.50278,18.23701,1507
3806,31016,248CE0B148D688C343222BB27AEE2380,31071,21,22,1,109.58257,18.28458,1815
3807,31023,F113DDC78FC5471ED8A23532B5EF78E0,30181,0,17,17,109.51597,18.23313,1557
3808,31024,F113DDC78FC5471ED8A23532B5EF78E0,30711,20,23,3,109.50271,18.25347,1510
3809,31043,44BEBA2727205520AE9AF3AB76A75967,38251,17,20,3,109.49618,18.25493,1510
3810,31044,44BEBA2727205520AE9AF3AB76A75967,31231,20,21,1,109.42597,18.29292,1217
3811,31045,44BEBA2727205520AE9AF3AB76A75967,31231,22,23,1,109.42597,18.29292,1217
3812,31101,2B37ECAF93E1D338CBB5FDF40ACD1C13,30854,0,15,15,109.56889,18.27076,1763
3813,31102,2B37ECAF93E1D338CBB5FDF40ACD1C13,30891,18,19,1,109.59431,18.28389,1865
3817,31138,EA446444DFE25212830F95291C13D19D,31931,0,10,10,109.54771,18.29403,1667
3818,31139,EA446444DFE25212830F95291C13D19D,39183,10,11,1,109.55542,18.28208,1715
3819,31140,EA446444DFE25212830F95291C13D19D,39181,11,14,3,109.55153,18.28035,1715
3820,31141,EA446444DFE25212830F95291C13D19D,31931,14,16,2,109.54771,18.29403,1667
3821,31142,EA446444DFE25212830F95291C13D19D,39181,17,18,1,109.55153,18.28035,1715
3822,31143,EA446444DFE25212830F95291C13D19D,31931,18,21,3,109.54771,18.29403,1667
3823,31181,27229B6D41BD7CDDDAA38911093865DB,31071,0,4,4,109.58257,18.28458,1815
3824,31182,27229B6D41BD7CDDDAA38911093865DB,38085,5,16,11,109.6291,18.23625,2007
3825,31183,27229B6D41BD7CDDDAA38911093865DB,30854,17,19,2,109.56889,18.27076,1763
3826,31184,27229B6D41BD7CDDDAA38911093865DB,31071,21,23,2,109.58257,18.28458,1815
3827,31219,12E8A5F9EEE6066A08670ACFE5B51517,30441,6,7,1,109.64021,18.25424,2010
3828,31220,12E8A5F9EEE6066A08670ACFE5B51517,30854,9,19,10,109.56889,18.27076,1763
3829,31250,95B5A6EC0B066FA043A37532D8BE9FCC,31471,14,16,2,109.34583,18.29563,917
3830,31251,95B5A6EC0B066FA043A37532D8BE9FCC,31471,16,18,2,109.34583,18.29563,917
3831,31252,95B5A6EC0B066FA043A37532D8BE9FCC,31031,20,21,1,109.49979,18.25382,1510
3832,31366,745EF9B4BED0129E763F1AECF7B45AF5,38331,0,1,1,109.62465,18.22736,1956
3833,31367,745EF9B4BED0129E763F1AECF7B45AF5,31571,2,9,7,109.61563,18.23326,1957
3834,31368,745EF9B4BED0129E763F1AECF7B45AF5,60071,12,13,1,109.75674,18.31583,2470
3835,31370,745EF9B4BED0129E763F1AECF7B45AF5,60161,18,23,5,109.49174,18.26181,1461
3836,31384,4378D285803CD07A5CF2CE0DBD8B3B3A,60081,0,1,1,109.51097,18.22639,1556
3837,31385,4378D285803CD07A5CF2CE0DBD8B3B3A,60084,3,9,6,109.4984,18.2334,1507
3838,31386,4378D285803CD07A5CF2CE0DBD8B3B3A,31145,11,15,4,109.20431,18.30479,369
3839,31387,4378D285803CD07A5CF2CE0DBD8B3B3A,30421,16,18,2,109.50021,18.25861,1511
3840,31388,4378D285803CD07A5CF2CE0DBD8B3B3A,31321,18,23,5,109.63799,18.23201,2007
3844,31392,3887FF64832E3EF638532F1D2F2E4297,30271,2,3,1,109.49132,18.23153,1456
3845,31393,3887FF64832E3EF638532F1D2F2E4297,60231,4,6,2,109.49903,18.21972,1504
3846,31394,3887FF64832E3EF638532F1D2F2E4297,30271,6,7,1,109.49132,18.23153,1456
3847,31395,3887FF64832E3EF638532F1D2F2E4297,60231,7,21,14,109.49903,18.21972,1504
3848,31396,3887FF64832E3EF638532F1D2F2E4297,30271,22,23,1,109.49132,18.23153,1456
3849,31400,539BEEF0B0699C76362F0AD205B9C94E,38315,12,13,1,109.48979,18.29764,1467
3850,31401,539BEEF0B0699C76362F0AD205B9C94E,38707,15,23,8,109.73778,18.35368,2427
3851,31419,452F0FF6BC36839041DCBEF2292D6E55,30111,15,17,2,109.47583,18.30542,1419
3852,31420,452F0FF6BC36839041DCBEF2292D6E55,60381,19,20,1,109.5241,18.22458,1605
3853,31421,452F0FF6BC36839041DCBEF2292D6E55,30281,21,23,2,109.50597,18.27583,1514
3854,31446,60BBA5D95C900EDF11961F708AA4ED70,30831,18,19,1,109.69813,18.32076,2271
3855,31447,60BBA5D95C900EDF11961F708AA4ED70,31841,20,23,3,109.73201,18.33382,2373
3856,31476,7BF65E5054DA81A230AB5423620158E1,30854,10,11,1,109.56889,18.27076,1763
3857,31477,7BF65E5054DA81A230AB5423620158E1,60631,13,14,1,109.57778,18.27583,1814
3858,31478,7BF65E5054DA81A230AB5423620158E1,38157,18,20,2,109.51483,18.26958,1563
3859,31491,77FFBAF92CA650C238A1DDB50567A1CF,60524,0,4,4,109.42951,18.28993,1216
3860,31492,77FFBAF92CA650C238A1DDB50567A1CF,30351,6,10,4,109.41701,18.29292,1217
3861,31504,E9CDFE5A4E319AABCB1BB5066094528A,31471,17,18,1,109.34583,18.29563,917
3862,31505,E9CDFE5A4E319AABCB1BB5066094528A,30361,19,21,2,109.50347,18.24,1508
3863,31506,E9CDFE5A4E319AABCB1BB5066094528A,60084,22,23,1,109.4984,18.2334,1507
3864,31512,6747589BFB0A700EA355F21AA59F102D,31521,0,8,8,109.51458,18.22542,1555
3865,31513,6747589BFB0A700EA355F21AA59F102D,31471,10,13,3,109.34583,18.29563,917
3866,31514,6747589BFB0A700EA355F21AA59F102D,30421,14,16,2,109.50021,18.25861,1511
3867,31515,6747589BFB0A700EA355F21AA59F102D,31521,19,23,4,109.51458,18.22542,1555
3868,31542,24E94C322C21864A44D8B04F37BB2EEC,30201,18,20,2,109.4909,18.26465,1462
3869,31543,24E94C322C21864A44D8B04F37BB2EEC,30361,21,22,1,109.50347,18.24,1508
3870,31567,83924EE67EAF45029C324F02270BCB05,30854,13,14,1,109.56889,18.27076,1763
3871,31568,83924EE67EAF45029C324F02270BCB05,31071,17,18,1,109.58257,18.28458,1815
3872,31569,83924EE67EAF45029C324F02270BCB05,39111,19,20,1,109.5191,18.22597,1555
3873,31578,2115670ECBCEFE4CA16C55F5204DF607,31761,2,4,2,109.60521,18.27965,1914
3874,31579,2115670ECBCEFE4CA16C55F5204DF607,31071,4,6,2,109.58257,18.28458,1815
3875,31580,2115670ECBCEFE4CA16C55F5204DF607,30854,10,18,8,109.56889,18.27076,1763
3876,31581,2115670ECBCEFE4CA16C55F5204DF607,30181,18,20,2,109.51597,18.23313,1557
3877,31608,5C6DA42AA960EA24C721C08C5847A20C,30761,0,6,6,109.45201,18.3,1318
3878,31609,5C6DA42AA960EA24C721C08C5847A20C,31781,7,8,1,109.19847,18.2975,367
3879,31610,5C6DA42AA960EA24C721C08C5847A20C,30671,12,13,1,109.43611,18.30139,1268
3884,31665,20C15B76A1E0DF79D86EDEAC7BC3D7B7,31071,0,15,15,109.58257,18.28458,1815
3885,31666,20C15B76A1E0DF79D86EDEAC7BC3D7B7,30854,16,17,1,109.56889,18.27076,1763
3886,31667,20C15B76A1E0DF79D86EDEAC7BC3D7B7,31461,18,20,2,109.5091,18.25389,1510
3887,31668,20C15B76A1E0DF79D86EDEAC7BC3D7B7,31945,22,23,1,109.58021,18.29403,1817
3888,31698,63B5E489F3503F8EC6E40A38F9D2117C,60241,6,7,1,109.53319,18.28667,1616
3889,31699,63B5E489F3503F8EC6E40A38F9D2117C,60171,9,10,1,109.51292,18.30694,1569
3890,31700,63B5E489F3503F8EC6E40A38F9D2117C,31951,13,16,3,109.52174,18.30299,1568
3891,31701,63B5E489F3503F8EC6E40A38F9D2117C,31206,20,22,2,109.50819,18.23549,1507
3892,31709,E5B8920F3E3691BAA92FB7B056CFD690,31231,18,21,3,109.42597,18.29292,1217
3893,31710,E5B8920F3E3691BAA92FB7B056CFD690,31345,21,23,2,109.39,18.29,1066
3894,31719,6CBD210FE212796CEDBD8FF4BC0A58A4,39183,0,13,13,109.55542,18.28208,1715
3895,31720,6CBD210FE212796CEDBD8FF4BC0A58A4,31931,14,15,1,109.54771,18.29403,1667
3896,31724,CFFDD1BF3134B9FDD71614F40E1DE0FD,31561,3,5,2,109.56792,18.28479,1765
3897,31725,CFFDD1BF3134B9FDD71614F40E1DE0FD,31071,6,14,8,109.58257,18.28458,1815
3898,31726,CFFDD1BF3134B9FDD71614F40E1DE0FD,60463,17,18,1,109.52507,18.22438,1605
3899,31727,CFFDD1BF3134B9FDD71614F40E1DE0FD,31071,19,23,4,109.58257,18.28458,1815
3900,31795,1EC959553638CEC3C2D1606E92235CDE,30854,13,20,7,109.56889,18.27076,1763
3901,31796,1EC959553638CEC3C2D1606E92235CDE,39111,21,23,2,109.5191,18.22597,1555
3909,31880,5F14E1A15EFA1C13F8B10CBC543F107C,31701,22,23,1,109.44132,18.28833,1266
3910,31897,9A1D1AA5EE2CD156CC396C667ED8C5B9,31071,2,10,8,109.58257,18.28458,1815
3911,31898,9A1D1AA5EE2CD156CC396C667ED8C5B9,30854,11,23,12,109.56889,18.27076,1763
3912,31903,324B1E458381D97CBAB467F6710BB6F8,30421,18,20,2,109.50021,18.25861,1511
3913,31904,324B1E458381D97CBAB467F6710BB6F8,39151,22,23,1,109.49875,18.25097,1510
3914,31996,E7A46627189B4AA0843E68EB21C731B1,31561,11,13,2,109.56792,18.28479,1765
3915,31997,E7A46627189B4AA0843E68EB21C731B1,30324,16,20,4,109.50326,18.29257,1517
3916,31998,E7A46627189B4AA0843E68EB21C731B1,38171,20,22,2,109.50799,18.28139,1515
3917,32021,CEB7EA5D037E7DFD2A157DEECC6ACC53,31121,0,16,16,109.16292,18.37063,230
3918,32022,CEB7EA5D037E7DFD2A157DEECC6ACC53,60463,18,19,1,109.52507,18.22438,1605
3919,32023,CEB7EA5D037E7DFD2A157DEECC6ACC53,31381,22,23,1,109.1375,18.36833,129
3920,32046,3CD8C574CE7F02C34BEF4EF870B371AB,31471,14,15,1,109.34583,18.29563,917
3921,32047,3CD8C574CE7F02C34BEF4EF870B371AB,30361,18,20,2,109.50347,18.24,1508
3922,32048,3CD8C574CE7F02C34BEF4EF870B371AB,30581,21,23,2,109.62257,18.24951,1959
3923,32053,91F59FD84A5A011AF1877621EDB85B69,31071,0,12,12,109.58257,18.28458,1815
3924,32054,91F59FD84A5A011AF1877621EDB85B69,60121,15,18,3,109.74507,18.37472,2430
3925,32055,91F59FD84A5A011AF1877621EDB85B69,60381,19,20,1,109.5241,18.22458,1605
3926,32056,91F59FD84A5A011AF1877621EDB85B69,38706,22,23,1,109.74625,18.37097,2430
3927,32059,92AA74C025DCC8E1B6F69E40B85D2713,31841,15,17,2,109.73201,18.33382,2373
3928,32060,92AA74C025DCC8E1B6F69E40B85D2713,60111,20,23,3,109.72556,18.31924,2371
3929,32082,00A58A36A98278EF81924778C39790CF,60171,0,8,8,109.51292,18.30694,1569
3930,32083,00A58A36A98278EF81924778C39790CF,60661,9,12,3,109.548,18.2377,1657
3931,32107,281B6372FFA07802CACB0B657A6F5DF6,30741,14,15,1,109.49833,18.28681,1516
3932,32122,530ABDCB6E5C0FF39924B84145065468,31101,12,14,2,109.65389,18.23403,2057
3933,32123,530ABDCB6E5C0FF39924B84145065468,30361,16,18,2,109.50347,18.24,1508
3934,32147,7F632B4875B2736225CD6D350CD25670,30854,8,13,5,109.56889,18.27076,1763
3935,32148,7F632B4875B2736225CD6D350CD25670,31561,14,15,1,109.56792,18.28479,1765
3936,32149,7F632B4875B2736225CD6D350CD25670,38251,16,18,2,109.49618,18.25493,1510
3937,32150,7F632B4875B2736225CD6D350CD25670,31461,18,20,2,109.5091,18.25389,1510
3938,32151,7F632B4875B2736225CD6D350CD25670,60381,20,22,2,109.5241,18.22458,1605
3939,32189,4294195F192797A89367A7AA50405953,31091,0,6,6,109.41201,18.31222,1170
3940,32190,4294195F192797A89367A7AA50405953,30201,8,9,1,109.4909,18.26465,1462
3941,32191,4294195F192797A89367A7AA50405953,31181,9,11,2,109.50382,18.24813,1509
3942,32192,4294195F192797A89367A7AA50405953,30201,11,13,2,109.4909,18.26465,1462
3943,32193,4294195F192797A89367A7AA50405953,30201,17,19,2,109.4909,18.26465,1462
3944,32194,4294195F192797A89367A7AA50405953,60551,22,23,1,109.42722,18.30111,1218
3945,32195,1B6EBBFF3B9D8A3E18753343B6A29EAE,31071,0,6,6,109.58257,18.28458,1815
3946,32196,1B6EBBFF3B9D8A3E18753343B6A29EAE,31561,7,9,2,109.56792,18.28479,1765
3947,32197,1B6EBBFF3B9D8A3E18753343B6A29EAE,30851,9,11,2,109.5616,18.27396,1713
3948,32198,1B6EBBFF3B9D8A3E18753343B6A29EAE,31071,12,13,1,109.58257,18.28458,1815
3949,32199,1B6EBBFF3B9D8A3E18753343B6A29EAE,31561,16,18,2,109.56792,18.28479,1765
3950,32200,1B6EBBFF3B9D8A3E18753343B6A29EAE,31071,19,21,2,109.58257,18.28458,1815
3951,32209,004C4A1986E184D2F11887515F258CC6,31931,6,9,3,109.54771,18.29403,1667
3952,32210,004C4A1986E184D2F11887515F258CC6,30921,11,12,1,109.53903,18.29451,1667
3953,32211,004C4A1986E184D2F11887515F258CC6,30671,16,17,1,109.43611,18.30139,1268
3957,32277,68DBE0B52FD0AB95F1DD47068FD7847F,60311,0,8,8,109.52097,18.24319,1558
3958,32278,68DBE0B52FD0AB95F1DD47068FD7847F,30381,8,10,2,109.52521,18.24507,1609
3959,32279,68DBE0B52FD0AB95F1DD47068FD7847F,30161,10,12,2,109.50042,18.24389,1508
3960,32280,68DBE0B52FD0AB95F1DD47068FD7847F,30181,13,15,2,109.51597,18.23313,1557
3961,32281,68DBE0B52FD0AB95F1DD47068FD7847F,30161,15,16,1,109.50042,18.24389,1508
3962,32282,68DBE0B52FD0AB95F1DD47068FD7847F,38291,16,18,2,109.51618,18.24313,1558
3963,32285,59562AEEA1EC6BCB6F4C7AC842D59FB8,38154,19,20,1,109.5266,18.28278,1615
3964,32286,59562AEEA1EC6BCB6F4C7AC842D59FB8,31864,20,23,3,109.49014,18.28333,1465
3965,32305,E29E6421617D17896F31CB4BE6821CC0,31361,17,18,1,109.47417,18.28292,1415
3966,32306,E29E6421617D17896F31CB4BE6821CC0,30171,19,23,4,109.48458,18.27139,1463
3967,32312,AD5B50011AF724A93ED322CEECA0B566,60541,0,11,11,109.4084,18.29208,1167
3968,32313,AD5B50011AF724A93ED322CEECA0B566,30341,12,16,4,109.3625,18.29167,966
3972,32344,C370675BE5878FE166F9AA4715A021CA,60381,0,12,12,109.5241,18.22458,1605
3973,32345,C370675BE5878FE166F9AA4715A021CA,60054,15,17,2,109.3016,18.31229,770
3974,32346,C370675BE5878FE166F9AA4715A021CA,30361,19,23,4,109.50347,18.24,1508
3975,32382,FBD855000564CE6EC034501219E56C85,60281,0,2,2,109.51743,18.25924,1561
3976,32383,FBD855000564CE6EC034501219E56C85,30741,3,7,4,109.49833,18.28681,1516
3977,32384,FBD855000564CE6EC034501219E56C85,31781,9,15,6,109.19847,18.2975,367
3978,32451,6121384AF418DBB207AE4840DB5A99D0,30511,1,3,2,109.51069,18.24208,1558
3979,32452,6121384AF418DBB207AE4840DB5A99D0,60081,3,6,3,109.51097,18.22639,1556
3980,32453,6121384AF418DBB207AE4840DB5A99D0,30191,6,7,1,109.50361,18.22701,1506
3981,32455,6121384AF418DBB207AE4840DB5A99D0,31471,16,17,1,109.34583,18.29563,917
3982,32456,6121384AF418DBB207AE4840DB5A99D0,60081,20,21,1,109.51097,18.22639,1556
3983,32462,2A683F66041B1386AB7A83A8383E4C68,30361,12,15,3,109.50347,18.24,1508
3984,32463,2A683F66041B1386AB7A83A8383E4C68,31101,17,18,1,109.65389,18.23403,2057
3985,32464,2A683F66041B1386AB7A83A8383E4C68,38334,19,23,4,109.65035,18.23785,2057
3986,32470,512C24BB1457413A6C40E61834013B76,31841,0,11,11,109.73201,18.33382,2373
3987,32471,512C24BB1457413A6C40E61834013B76,38315,13,14,1,109.48979,18.29764,1467
3988,32480,9F725703122C1475EAB02BE07EC8AAEA,31021,18,20,2,109.49021,18.27,1463
3989,32481,9F725703122C1475EAB02BE07EC8AAEA,30391,21,22,1,109.4975,18.27118,1513
3998,32571,222E0B6922623CE9FBB280F81068D40E,60661,18,20,2,109.548,18.2377,1657
3999,32572,222E0B6922623CE9FBB280F81068D40E,31061,20,23,3,109.53333,18.23257,1607
4000,32585,FA3AD6E291717591632932F7645364C4,39191,0,3,3,109.51493,18.23472,1557
4001,32586,FA3AD6E291717591632932F7645364C4,31521,4,7,3,109.51458,18.22542,1555
4002,32587,FA3AD6E291717591632932F7645364C4,31201,7,9,2,109.51042,18.23819,1558
4003,32588,FA3AD6E291717591632932F7645364C4,31101,10,12,2,109.65389,18.23403,2057
4004,32589,FA3AD6E291717591632932F7645364C4,31201,14,15,1,109.51042,18.23819,1558
4005,32590,FA3AD6E291717591632932F7645364C4,31206,19,20,1,109.50819,18.23549,1507
4006,32591,FA3AD6E291717591632932F7645364C4,31201,21,23,2,109.51042,18.23819,1558
4007,32610,46D10B971C10D2856504DC61068F66E7,31091,14,17,3,109.41201,18.31222,1170
4008,32611,46D10B971C10D2856504DC61068F66E7,60361,20,23,3,109.51938,18.29681,1567
4009,32649,7C68E1F4B8B2F3CBBD5427BF66BF9C2E,31571,10,11,1,109.61563,18.23326,1957
4010,32650,7C68E1F4B8B2F3CBBD5427BF66BF9C2E,60591,13,16,3,109.61118,18.21715,1904
4011,32665,3E502E0A3912A138848033C0D98673D5,31231,10,12,2,109.42597,18.29292,1217
4012,32666,3E502E0A3912A138848033C0D98673D5,30571,14,16,2,109.50243,18.21861,1504
4013,32667,3E502E0A3912A138848033C0D98673D5,38251,17,18,1,109.49618,18.25493,1510
4014,32672,FCD31F22AA8554809D4B91E6FFCB54BE,30851,12,19,7,109.5616,18.27396,1713
4015,32728,B7C5BB0BB1A7BB13983C520370B8471E,38251,0,10,10,109.49618,18.25493,1510
4016,32729,B7C5BB0BB1A7BB13983C520370B8471E,31471,14,15,1,109.34583,18.29563,917
4017,32730,B7C5BB0BB1A7BB13983C520370B8471E,38251,20,22,2,109.49618,18.25493,1510
4018,32731,061A86146605D753C12EC5BC04F2EF03,30381,0,6,6,109.52521,18.24507,1609
4019,32732,061A86146605D753C12EC5BC04F2EF03,31741,9,15,6,109.10229,18.37271,30
4020,32733,061A86146605D753C12EC5BC04F2EF03,30381,17,23,6,109.52521,18.24507,1609
4021,32755,ADF0A7CED2B8DFD757D8FCA8B507C37E,30854,14,16,2,109.56889,18.27076,1763
4022,32756,ADF0A7CED2B8DFD757D8FCA8B507C37E,31561,16,17,1,109.56792,18.28479,1765
4023,32757,ADF0A7CED2B8DFD757D8FCA8B507C37E,30854,19,21,2,109.56889,18.27076,1763
4028,32874,F568EAB7DFDD5D41E19A6F375B979656,60361,0,12,12,109.51938,18.29681,1567
4029,32875,F568EAB7DFDD5D41E19A6F375B979656,30201,16,17,1,109.4909,18.26465,1462
4030,32880,B2F3687F06BC9BF7431C8843AA2E4113,60234,13,14,1,109.49577,18.2096,1453
4031,32881,B2F3687F06BC9BF7431C8843AA2E4113,38017,15,20,5,109.49729,18.21424,1504
4032,32882,B2F3687F06BC9BF7431C8843AA2E4113,38017,22,23,1,109.49729,18.21424,1504
4033,32892,B023927CBEC0A8053CBDF64A5B76E367,30571,0,6,6,109.50243,18.21861,1504
4034,32893,B023927CBEC0A8053CBDF64A5B76E367,31931,7,9,2,109.54771,18.29403,1667
4035,32894,B023927CBEC0A8053CBDF64A5B76E367,30921,14,15,1,109.53903,18.29451,1667
4036,32935,C5F520449EBC5BB529DC1F3F22008D6A,31431,0,7,7,109.44639,18.29042,1316
4037,32938,C5F520449EBC5BB529DC1F3F22008D6A,30361,19,21,2,109.50347,18.24,1508
4038,32939,C5F520449EBC5BB529DC1F3F22008D6A,31431,21,23,2,109.44639,18.29042,1316
4039,32943,097736CC65CDCC4ACF05842432CBC496,60291,0,10,10,109.50826,18.24639,1509
4040,32944,097736CC65CDCC4ACF05842432CBC496,38275,15,16,1,109.62875,18.22938,2006
4041,32955,AB87DA8A24EEE7231EA58FCCDC7600DC,60641,0,6,6,109.53854,18.2359,1657
4046,33000,4DE71CE1D98B4BE73B9507B19A1BFD20,39081,16,23,7,109.19382,18.29111,366
4047,33001,13104A6A71A054F852B52BB76993ADB2,30854,0,8,8,109.56889,18.27076,1763
4048,33002,13104A6A71A054F852B52BB76993ADB2,30851,10,17,7,109.5616,18.27396,1713
4049,33057,1E4EB590D9A7F8271855EC61FF090359,30711,15,17,2,109.50271,18.25347,1510
4050,33058,1E4EB590D9A7F8271855EC61FF090359,30711,19,23,4,109.50271,18.25347,1510
4051,33068,58A6EA13AE1B5EC7733B5B9E4D600F6F,39131,0,3,3,109.2066,18.29639,417
4052,33069,58A6EA13AE1B5EC7733B5B9E4D600F6F,39131,5,8,3,109.2066,18.29639,417
4053,33071,58A6EA13AE1B5EC7733B5B9E4D600F6F,60054,14,15,1,109.3016,18.31229,770
4063,33170,45FC4D7B7AEB1BB8222449DDC064C06B,31945,0,18,18,109.58021,18.29403,1817
4064,33171,45FC4D7B7AEB1BB8222449DDC064C06B,30854,19,20,1,109.56889,18.27076,1763
4078,33263,9B389AE8E9B004176803CCEAFF69104A,31071,2,6,4,109.58257,18.28458,1815
4079,33264,9B389AE8E9B004176803CCEAFF69104A,60631,7,22,15,109.57778,18.27583,1814
4080,33314,92D84094136F2FB8B7D41AECD69A79AD,30511,17,23,6,109.51069,18.24208,1558
4081,33369,DE9D7565F2919D8BB9F03ACFED85BB11,39131,0,7,7,109.2066,18.29639,417
4085,33380,60BD0B451F2F456B931E74539A61B576,30581,0,7,7,109.62257,18.24951,1959
4086,33381,60BD0B451F2F456B931E74539A61B576,31571,7,9,2,109.61563,18.23326,1957
4087,33382,60BD0B451F2F456B931E74539A61B576,60054,13,14,1,109.3016,18.31229,770
4088,33383,60BD0B451F2F456B931E74539A61B576,38315,17,19,2,109.48979,18.29764,1467
4089,33396,3D8ADE80304FD3207128013D43F1118A,60472,0,2,2,109.46625,18.29542,1367
4090,33397,3D8ADE80304FD3207128013D43F1118A,60421,3,14,11,109.46333,18.31743,1371
4091,33398,3D8ADE80304FD3207128013D43F1118A,31551,16,17,1,109.55868,18.24222,1708
4092,33399,3D8ADE80304FD3207128013D43F1118A,31031,20,21,1,109.49979,18.25382,1510
4093,33420,17D13F6A66037B54FAB5668CDC734401,60671,2,5,3,109.52979,18.31757,1621
4094,33421,17D13F6A66037B54FAB5668CDC734401,31931,9,17,8,109.54771,18.29403,1667
4095,33422,17D13F6A66037B54FAB5668CDC734401,30201,20,21,1,109.4909,18.26465,1462
4096,33464,918CA9A7084F993FB16E3BC0238F013F,38141,0,9,9,109.39479,18.2916,1116
4097,33465,918CA9A7084F993FB16E3BC0238F013F,38027,9,11,2,109.38833,18.2909,1066
4098,33466,918CA9A7084F993FB16E3BC0238F013F,30661,11,16,5,109.37028,18.24361,1008
4099,33467,918CA9A7084F993FB16E3BC0238F013F,38141,17,23,6,109.39479,18.2916,1116
4107,33527,AECF79630BEEC0EA88FD59B92FCAE378,30891,2,13,11,109.59431,18.28389,1865
4108,33528,AECF79630BEEC0EA88FD59B92FCAE378,30854,14,22,8,109.56889,18.27076,1763
4109,33529,3A145BF69DF902E1EF820C356086EF54,60401,1,2,1,109.47444,18.27583,1414
4110,33530,3A145BF69DF902E1EF820C356086EF54,31391,4,6,2,109.50382,18.24285,1508
4111,33531,3A145BF69DF902E1EF820C356086EF54,31561,10,11,1,109.56792,18.28479,1765
4112,33532,3A145BF69DF902E1EF820C356086EF54,30854,12,14,2,109.56889,18.27076,1763
4113,33533,3A145BF69DF902E1EF820C356086EF54,30731,15,17,2,109.50944,18.22306,1555
4114,33534,3A145BF69DF902E1EF820C356086EF54,60054,18,19,1,109.3016,18.31229,770
4115,33535,3A145BF69DF902E1EF820C356086EF54,60234,20,22,2,109.49577,18.2096,1453
4116,33547,1AFB73CFA15D49BFA2ECE037EF4A3987,33051,10,12,2,109.6475,18.46618,2096
4117,33548,1AFB73CFA15D49BFA2ECE037EF4A3987,30854,14,20,6,109.56889,18.27076,1763
4118,33549,1AFB73CFA15D49BFA2ECE037EF4A3987,31071,20,21,1,109.58257,18.28458,1815
4119,33564,C358285726113434A30FBBA8DED710E7,30711,20,21,1,109.50271,18.25347,1510
4120,33565,C358285726113434A30FBBA8DED710E7,60371,22,23,1,109.53063,18.30056,1618
4121,33567,275770A477CB8A98DE699BAE7694B84A,31471,11,13,2,109.34583,18.29563,917
4122,33568,275770A477CB8A98DE699BAE7694B84A,31531,18,23,5,109.49583,18.25972,1461
4123,33569,96740EA54DE1F338A180C12CF430841E,38052,9,11,2,109.62618,18.23042,1956
4124,33570,96740EA54DE1F338A180C12CF430841E,31321,13,14,1,109.63799,18.23201,2007
4125,33571,96740EA54DE1F338A180C12CF430841E,38275,19,20,1,109.62875,18.22938,2006
4129,33611,D2006452460D74E19DE71BCDEF4A0E0E,30171,0,8,8,109.48458,18.27139,1463
4130,33612,D2006452460D74E19DE71BCDEF4A0E0E,31781,10,13,3,109.19847,18.2975,367
4131,33613,D2006452460D74E19DE71BCDEF4A0E0E,30171,15,18,3,109.48458,18.27139,1463
4132,33614,D2006452460D74E19DE71BCDEF4A0E0E,31021,21,23,2,109.49021,18.27,1463
4133,33649,91BBA859510138E2A3B6234A0D61C803,30191,19,21,2,109.50361,18.22701,1506
4134,33650,91BBA859510138E2A3B6234A0D61C803,60381,21,23,2,109.5241,18.22458,1605
4135,33663,8621CFDF1B89A83351494618C53D033F,31071,1,5,4,109.58257,18.28458,1815
4136,33664,8621CFDF1B89A83351494618C53D033F,39181,7,8,1,109.55153,18.28035,1715
4137,33665,8621CFDF1B89A83351494618C53D033F,39181,10,12,2,109.55153,18.28035,1715
4138,33666,8621CFDF1B89A83351494618C53D033F,31071,14,15,1,109.58257,18.28458,1815
4139,33667,8621CFDF1B89A83351494618C53D033F,39181,18,23,5,109.55153,18.28035,1715
4140,33688,B133114A8ECB59B8316DD4DF63AEB9F8,30861,0,11,11,109.52722,18.22743,1606
4141,33689,B133114A8ECB59B8316DD4DF63AEB9F8,31471,14,17,3,109.34583,18.29563,917
4142,33690,B133114A8ECB59B8316DD4DF63AEB9F8,30361,19,21,2,109.50347,18.24,1508
4143,33724,22B987DE38F8C4435934FE5E6190C4A2,30854,0,4,4,109.56889,18.27076,1763
4144,33725,22B987DE38F8C4435934FE5E6190C4A2,60631,4,8,4,109.57778,18.27583,1814
4145,33726,22B987DE38F8C4435934FE5E6190C4A2,30581,11,12,1,109.62257,18.24951,1959
4146,33727,22B987DE38F8C4435934FE5E6190C4A2,30854,15,16,1,109.56889,18.27076,1763
4147,33728,22B987DE38F8C4435934FE5E6190C4A2,60631,20,22,2,109.57778,18.27583,1814
4151,33750,E8BE10EF1C0A6A216F7B6C008ED029A8,60371,0,8,8,109.53063,18.30056,1618
4152,33751,E8BE10EF1C0A6A216F7B6C008ED029A8,31571,8,10,2,109.61563,18.23326,1957
4153,33752,E8BE10EF1C0A6A216F7B6C008ED029A8,60226,12,15,3,109.5175,18.28778,1566
4154,33762,B76381FBDC68F2B2041DDEC63195F0A7,31391,10,16,6,109.50382,18.24285,1508
4155,33763,B76381FBDC68F2B2041DDEC63195F0A7,39181,20,21,1,109.55153,18.28035,1715
4156,33795,DF8F1564B6874B5D4156BD7EDF97726C,33354,0,13,13,109.67465,18.44583,2192
4157,33796,DF8F1564B6874B5D4156BD7EDF97726C,30421,16,19,3,109.50021,18.25861,1511
4158,33797,DF8F1564B6874B5D4156BD7EDF97726C,33354,21,23,2,109.67465,18.44583,2192
4159,33809,34015BC7674A7CCEE2F07FE91B0DCE26,31221,0,9,9,109.61333,18.26833,1913
4160,33810,34015BC7674A7CCEE2F07FE91B0DCE26,30234,10,11,1,109.60681,18.29979,1918
4161,33831,2191B2AD5C915B8862D4C345F0A13CFB,60351,21,22,1,109.58403,18.28958,1816
4162,33832,2191B2AD5C915B8862D4C345F0A13CFB,30851,22,23,1,109.5616,18.27396,1713
4163,33849,E9F64FD67E39C3E2C15C20715338A941,31931,18,19,1,109.54771,18.29403,1667
4164,33850,E9F64FD67E39C3E2C15C20715338A941,30921,21,23,2,109.53903,18.29451,1667
4165,33912,13C882817D5EF3329D8612AEE7E0F34D,31864,1,7,6,109.49014,18.28333,1465
4166,33917,EB316856896788EC8FD871E122E95728,30931,0,6,6,109.55653,18.32722,1722
4167,33918,EB316856896788EC8FD871E122E95728,31811,7,12,5,109.54201,18.31806,1671
4168,33919,EB316856896788EC8FD871E122E95728,30701,12,14,2,109.59313,18.32007,1871
4169,33920,EB316856896788EC8FD871E122E95728,31811,14,16,2,109.54201,18.31806,1671
4170,33921,EB316856896788EC8FD871E122E95728,30701,16,18,2,109.59313,18.32007,1871
4171,33922,EB316856896788EC8FD871E122E95728,60361,19,20,1,109.51938,18.29681,1567
4172,33923,EB316856896788EC8FD871E122E95728,30701,21,22,1,109.59313,18.32007,1871
4173,33929,74A9CCA48CD6C2DA9FC7DFDB8817D50B,31071,9,11,2,109.58257,18.28458,1815
4174,33941,9E33CDC1D50278864BA2D5B1B9BF7797,38834,0,8,8,109.47639,18.21146,1403
4175,33942,9E33CDC1D50278864BA2D5B1B9BF7797,31781,12,13,1,109.19847,18.2975,367
4176,33943,9E33CDC1D50278864BA2D5B1B9BF7797,38291,18,19,1,109.51618,18.24313,1558
4177,33944,9E33CDC1D50278864BA2D5B1B9BF7797,38834,21,22,1,109.47639,18.21146,1403
4178,33948,58979C567AA82D4656FBA764FCCBAA6B,30911,19,20,1,109.50493,18.26181,1511
4179,33949,58979C567AA82D4656FBA764FCCBAA6B,38094,20,23,3,109.45403,18.28778,1316
4180,33975,971FAC974FC919EB70A5D4943C3307C0,60594,14,15,1,109.62694,18.22799,1956
4181,33976,971FAC974FC919EB70A5D4943C3307C0,38052,18,21,3,109.62618,18.23042,1956
4182,34005,8FC35EA2DA8D121B314742A5B151E4A5,31071,0,12,12,109.58257,18.28458,1815
4183,34034,584F5E043DB077A77C792CD4DDE826F7,38811,0,8,8,109.50875,18.2175,1504
4184,34035,584F5E043DB077A77C792CD4DDE826F7,31521,8,10,2,109.51458,18.22542,1555
4185,34036,584F5E043DB077A77C792CD4DDE826F7,38017,10,17,7,109.49729,18.21424,1504
4186,34037,584F5E043DB077A77C792CD4DDE826F7,30361,18,21,3,109.50347,18.24,1508
4187,34038,584F5E043DB077A77C792CD4DDE826F7,38811,22,23,1,109.50875,18.2175,1504
4188,34066,FB16AA24AD94D8CC7E1110E44BD68910,31945,0,7,7,109.58021,18.29403,1817
4189,34067,FB16AA24AD94D8CC7E1110E44BD68910,30854,8,10,2,109.56889,18.27076,1763
4190,34068,FB16AA24AD94D8CC7E1110E44BD68910,31945,12,14,2,109.58021,18.29403,1817
4191,34069,FB16AA24AD94D8CC7E1110E44BD68910,30854,18,19,1,109.56889,18.27076,1763
4192,34070,FB16AA24AD94D8CC7E1110E44BD68910,31945,20,22,2,109.58021,18.29403,1817
4196,34114,D5ED0B56415F07DD214B0DC3E9293672,30232,0,2,2,109.6191,18.31701,1971
4197,34115,D5ED0B56415F07DD214B0DC3E9293672,60631,4,8,4,109.57778,18.27583,1814
4198,34154,EBD16061EA20EE33D9344D33735E5205,38891,1,4,3,109.51486,18.24118,1558
4199,34155,EBD16061EA20EE33D9344D33735E5205,38291,7,8,1,109.51618,18.24313,1558
4200,34156,EBD16061EA20EE33D9344D33735E5205,60291,8,10,2,109.50826,18.24639,1509
4201,34157,EBD16061EA20EE33D9344D33735E5205,31441,14,16,2,109.51181,18.24424,1559
4202,34158,EBD16061EA20EE33D9344D33735E5205,30071,19,23,4,109.52819,18.30472,1619
4203,34176,34A1BA5A97F90C4ABB34EDC7004774A9,31071,4,5,1,109.58257,18.28458,1815
4204,34177,34A1BA5A97F90C4ABB34EDC7004774A9,30851,8,22,14,109.5616,18.27396,1713
4205,34178,D00EAD9144E7A4027F84D32EB5112DB4,30921,1,2,1,109.53903,18.29451,1667
4206,34179,D00EAD9144E7A4027F84D32EB5112DB4,31931,2,20,18,109.54771,18.29403,1667
4210,34242,5264833F0013AE6B294396000613EF89,60201,0,10,10,109.5041,18.2509,1510
4211,34243,5264833F0013AE6B294396000613EF89,60581,13,15,2,109.59785,18.29931,1868
4212,34244,5264833F0013AE6B294396000613EF89,31031,16,18,2,109.49979,18.25382,1510
4213,34245,5264833F0013AE6B294396000613EF89,31041,19,21,2,109.50278,18.23701,1507
4214,34246,5264833F0013AE6B294396000613EF89,30281,22,23,1,109.50597,18.27583,1514
4215,34253,8F86A56802DD74BA7D5D01773E49D5A4,31471,16,18,2,109.34583,18.29563,917
4216,34254,8F86A56802DD74BA7D5D01773E49D5A4,30201,19,23,4,109.4909,18.26465,1462
4224,34287,2F440A235E684ECEDD042B3100A4AE95,31071,0,7,7,109.58257,18.28458,1815
4225,34288,2F440A235E684ECEDD042B3100A4AE95,30854,7,8,1,109.56889,18.27076,1763
4226,34289,2F440A235E684ECEDD042B3100A4AE95,30101,9,12,3,109.57299,18.33333,1773
4227,34290,2F440A235E684ECEDD042B3100A4AE95,30854,17,18,1,109.56889,18.27076,1763
4228,34291,2F440A235E684ECEDD042B3100A4AE95,60331,20,22,2,109.505,18.26507,1512
4229,34297,0547C7536E43628EF24935F0C2BF5E2C,60241,1,2,1,109.53319,18.28667,1616
4230,34298,0547C7536E43628EF24935F0C2BF5E2C,30921,3,5,2,109.53903,18.29451,1667
4231,34299,0547C7536E43628EF24935F0C2BF5E2C,31931,7,10,3,109.54771,18.29403,1667
4232,34300,0547C7536E43628EF24935F0C2BF5E2C,30921,11,12,1,109.53903,18.29451,1667
4233,34301,0547C7536E43628EF24935F0C2BF5E2C,60241,12,13,1,109.53319,18.28667,1616
4234,34302,0547C7536E43628EF24935F0C2BF5E2C,31931,16,18,2,109.54771,18.29403,1667
4235,34308,B64B26F4850FADD461899F7BC9C7F6FF,31181,0,11,11,109.50382,18.24813,1509
4236,34309,B64B26F4850FADD461899F7BC9C7F6FF,38094,15,16,1,109.45403,18.28778,1316
4237,34310,B64B26F4850FADD461899F7BC9C7F6FF,60441,17,19,2,109.46792,18.28604,1366
4238,34311,B64B26F4850FADD461899F7BC9C7F6FF,30711,20,22,2,109.50271,18.25347,1510
4239,34319,ACDEAAF45B65DE48CF80A48DBD3C775E,30854,0,20,20,109.56889,18.27076,1763
4240,34320,ACDEAAF45B65DE48CF80A48DBD3C775E,31071,20,22,2,109.58257,18.28458,1815
4241,34329,F7BA6D8C151E59668884F79A30525DF6,60411,12,13,1,109.32514,18.30854,869
4242,34330,F7BA6D8C151E59668884F79A30525DF6,31471,13,16,3,109.34583,18.29563,917
4243,34351,5EBEA276FCB4A19AC5C987F5C7CC8908,60504,0,5,5,109.47917,18.28903,1416
4244,34352,5EBEA276FCB4A19AC5C987F5C7CC8908,38361,7,10,3,109.43667,18.29201,1267
4245,34353,5EBEA276FCB4A19AC5C987F5C7CC8908,60401,11,12,1,109.47444,18.27583,1414
4246,34354,5EBEA276FCB4A19AC5C987F5C7CC8908,60552,14,17,3,109.41729,18.30014,1218
4247,34355,5EBEA276FCB4A19AC5C987F5C7CC8908,38361,17,18,1,109.43667,18.29201,1267
4248,34396,DB4DF566D4757FF3BB488F82DE126248,31561,0,12,12,109.56792,18.28479,1765
4249,34397,DB4DF566D4757FF3BB488F82DE126248,30851,16,19,3,109.5616,18.27396,1713
4253,34445,9A1BAE903EE169A024CCCFBC47CFC6CC,31701,18,19,1,109.44132,18.28833,1266
4254,34446,9A1BAE903EE169A024CCCFBC47CFC6CC,60161,22,23,1,109.49174,18.26181,1461
4255,34453,4BA143AD44480D9BEACA2836C34FF531,60231,4,5,1,109.49903,18.21972,1504
4256,34454,4BA143AD44480D9BEACA2836C34FF531,39151,5,11,6,109.49875,18.25097,1510
4257,34455,4BA143AD44480D9BEACA2836C34FF531,30211,12,17,5,109.49882,18.23931,1508
4258,34456,4BA143AD44480D9BEACA2836C34FF531,30161,17,19,2,109.50042,18.24389,1508
4259,34457,4BA143AD44480D9BEACA2836C34FF531,31411,21,22,1,109.5016,18.23576,1507
4260,34470,C425D181738CCF9419F024C82994FF27,39181,7,10,3,109.55153,18.28035,1715
4261,34471,C425D181738CCF9419F024C82994FF27,30854,10,12,2,109.56889,18.27076,1763
4262,34478,1C86CB6916B0CD729122DB8E9BB7D66C,31781,15,16,1,109.19847,18.2975,367
4263,34479,1C86CB6916B0CD729122DB8E9BB7D66C,30571,19,20,1,109.50243,18.21861,1504
4264,34489,1A1509AC6E667B603EE3773D1273B7B0,38145,0,10,10,109.378,18.2912,1066
4265,34490,1A1509AC6E667B603EE3773D1273B7B0,31811,12,13,1,109.54201,18.31806,1671
4266,34497,01F0083CC81D0009F9AAB8F7CAA0C106,30771,1,10,9,109.49938,18.26042,1511
4267,34498,01F0083CC81D0009F9AAB8F7CAA0C106,31071,12,18,6,109.58257,18.28458,1815
4268,34499,01F0083CC81D0009F9AAB8F7CAA0C106,30854,18,19,1,109.56889,18.27076,1763
4269,34504,257D40176640D23F8414BA4F22C51BD7,60211,13,15,2,109.63549,18.26049,2011
4270,34531,06E9C92049CDEC98363A970C654C7779,31471,14,16,2,109.34583,18.29563,917
4271,34532,06E9C92049CDEC98363A970C654C7779,60381,18,19,1,109.5241,18.22458,1605
4272,34542,E0223036572082E83876AFB7D72B2DD2,30921,2,14,12,109.53903,18.29451,1667
4273,34543,E0223036572082E83876AFB7D72B2DD2,31931,15,18,3,109.54771,18.29403,1667
4274,34645,B7A2800FDF738E1064EAD2A5E58F7A3C,61011,1,13,12,109.60653,18.19076,1900
4275,34675,4F877A4B395C9E22C3B85958392F2EAB,31181,0,1,1,109.50382,18.24813,1509
4276,34676,4F877A4B395C9E22C3B85958392F2EAB,39151,4,5,1,109.49875,18.25097,1510
4277,34677,4F877A4B395C9E22C3B85958392F2EAB,31181,6,9,3,109.50382,18.24813,1509
4278,34678,4F877A4B395C9E22C3B85958392F2EAB,38297,11,15,4,109.52576,18.24965,1609
4279,34679,4F877A4B395C9E22C3B85958392F2EAB,31261,17,19,2,109.51174,18.2466,1559
4280,34680,4F877A4B395C9E22C3B85958392F2EAB,31181,20,23,3,109.50382,18.24813,1509
4285,34702,CA3896FB33E9BC68E91955EDFF5D709B,31071,0,3,3,109.58257,18.28458,1815
4286,34703,CA3896FB33E9BC68E91955EDFF5D709B,30854,3,5,2,109.56889,18.27076,1763
4287,34704,CA3896FB33E9BC68E91955EDFF5D709B,31071,6,8,2,109.58257,18.28458,1815
4288,34705,CA3896FB33E9BC68E91955EDFF5D709B,60631,11,13,2,109.57778,18.27583,1814
4289,34706,CA3896FB33E9BC68E91955EDFF5D709B,31945,14,17,3,109.58021,18.29403,1817
4290,34707,CA3896FB33E9BC68E91955EDFF5D709B,30854,18,21,3,109.56889,18.27076,1763
4291,34710,EFD740F6F5021C6811A10021B4C14BD7,30361,2,3,1,109.50347,18.24,1508
4292,34711,EFD740F6F5021C6811A10021B4C14BD7,38376,4,9,5,109.50924,18.24,1558
4293,34712,EFD740F6F5021C6811A10021B4C14BD7,30511,11,13,2,109.51069,18.24208,1558
4294,34713,EFD740F6F5021C6811A10021B4C14BD7,30361,14,16,2,109.50347,18.24,1508
4295,34714,EFD740F6F5021C6811A10021B4C14BD7,30421,16,19,3,109.50021,18.25861,1511
4296,34715,EFD740F6F5021C6811A10021B4C14BD7,30361,19,21,2,109.50347,18.24,1508
4305,34736,D4FD7DF925A6D0B68D7C0C172D666450,38903,0,7,7,109.39229,18.29243,1117
4306,34737,D4FD7DF925A6D0B68D7C0C172D666450,38141,8,9,1,109.39479,18.2916,1116
4307,34738,D4FD7DF925A6D0B68D7C0C172D666450,31145,10,11,1,109.20431,18.30479,369
4308,34739,D4FD7DF925A6D0B68D7C0C172D666450,31781,11,14,3,109.19847,18.2975,367
4309,34740,D4FD7DF925A6D0B68D7C0C172D666450,38903,18,23,5,109.39229,18.29243,1117
4310,34745,50B5C4E29EC349E4A9B5B91DC4E97A4E,60221,15,18,3,109.52569,18.29188,1616
4311,34746,50B5C4E29EC349E4A9B5B91DC4E97A4E,60371,18,20,2,109.53063,18.30056,1618
4312,34773,1C22636E4C8CF1C3C148EF1B7DDEF937,31521,0,10,10,109.51458,18.22542,1555
4313,34774,1C22636E4C8CF1C3C148EF1B7DDEF937,31471,12,14,2,109.34583,18.29563,917
4314,34775,1C22636E4C8CF1C3C148EF1B7DDEF937,30201,16,18,2,109.4909,18.26465,1462
4315,34776,1C22636E4C8CF1C3C148EF1B7DDEF937,31521,20,23,3,109.51458,18.22542,1555
4316,34786,56ACD6E124DDA410369E9C6960DD08BD,30211,13,17,4,109.49882,18.23931,1508
4317,34787,56ACD6E124DDA410369E9C6960DD08BD,30421,18,19,1,109.50021,18.25861,1511
4318,34788,56ACD6E124DDA410369E9C6960DD08BD,30361,19,23,4,109.50347,18.24,1508
4319,34791,DE5024DB59D5BF6AE5857A85EB7680EA,31071,0,6,6,109.58257,18.28458,1815
4320,34792,DE5024DB59D5BF6AE5857A85EB7680EA,30854,11,12,1,109.56889,18.27076,1763
4321,34796,5ACB2494699EB2F10AA3427B417842C4,39151,12,14,2,109.49875,18.25097,1510
4322,34800,CFF644097BADAEEAF540049CB3A91F42,39111,1,7,6,109.5191,18.22597,1555
4323,34801,CFF644097BADAEEAF540049CB3A91F42,31031,8,10,2,109.49979,18.25382,1510
4324,34802,CFF644097BADAEEAF540049CB3A91F42,38251,10,11,1,109.49618,18.25493,1510
4325,34803,CFF644097BADAEEAF540049CB3A91F42,31031,11,14,3,109.49979,18.25382,1510
4326,34804,CFF644097BADAEEAF540049CB3A91F42,60381,16,17,1,109.5241,18.22458,1605
4327,34838,5A7A3D5F722F0EB2695C45BF16BBC483,38157,0,9,9,109.51483,18.26958,1563
4328,34839,5A7A3D5F722F0EB2695C45BF16BBC483,31931,12,13,1,109.54771,18.29403,1667
4329,34840,5A7A3D5F722F0EB2695C45BF16BBC483,38271,16,18,2,109.62632,18.23049,1956
4330,34841,5A7A3D5F722F0EB2695C45BF16BBC483,38157,19,23,4,109.51483,18.26958,1563
4331,34847,FE349C1918E7CEFC84B48BBCA0458F0F,31781,13,14,1,109.19847,18.2975,367
4332,34848,FE349C1918E7CEFC84B48BBCA0458F0F,60551,18,20,2,109.42722,18.30111,1218
4333,34858,233DD781A9D8F1A3DD2D1D775A2A623D,30921,16,17,1,109.53903,18.29451,1667
4334,34859,233DD781A9D8F1A3DD2D1D775A2A623D,31931,20,22,2,109.54771,18.29403,1667
4335,34897,F7D930F16EBD509B106614B00A4B3D8D,38706,0,17,17,109.74625,18.37097,2430
4336,34898,F7D930F16EBD509B106614B00A4B3D8D,31206,20,22,2,109.50819,18.23549,1507
4337,34966,B3A1AC27CB357708CE63D3E4F68BF2E7,30854,6,11,5,109.56889,18.27076,1763
4338,34967,B3A1AC27CB357708CE63D3E4F68BF2E7,31071,11,13,2,109.58257,18.28458,1815
4339,34968,B3A1AC27CB357708CE63D3E4F68BF2E7,30854,13,18,5,109.56889,18.27076,1763
4340,34969,B3A1AC27CB357708CE63D3E4F68BF2E7,31071,21,23,2,109.58257,18.28458,1815
4341,34991,149F44702DEC8C73589BE6524F0A1FFD,30854,1,13,12,109.56889,18.27076,1763
4342,34992,149F44702DEC8C73589BE6524F0A1FFD,38085,17,23,6,109.6291,18.23625,2007
4343,34996,6C9D7BB79A70B1E66DD550950EE935C8,30361,18,20,2,109.50347,18.24,1508
4344,34997,6C9D7BB79A70B1E66DD550950EE935C8,31521,20,23,3,109.51458,18.22542,1555
4345,35007,97354F7C2AB6F7E1E04DACCC44310118,38251,20,23,3,109.49618,18.25493,1510
4346,35052,76B21384CC3EFE3F43353B93FDFE32EE,30821,0,7,7,109.43681,18.33639,1274
4347,35053,76B21384CC3EFE3F43353B93FDFE32EE,39091,11,15,4,109.50097,18.25222,1510
4348,35054,76B21384CC3EFE3F43353B93FDFE32EE,30821,18,23,5,109.43681,18.33639,1274
4349,35099,4BCC49C68A0C1DD62F91467170BABC88,30854,17,19,2,109.56889,18.27076,1763
4350,35100,4BCC49C68A0C1DD62F91467170BABC88,30731,19,22,3,109.50944,18.22306,1555
4351,35121,7264945C05DFDC18D47872D9F94F6B4F,30441,14,18,4,109.64021,18.25424,2010
4352,35122,7264945C05DFDC18D47872D9F94F6B4F,60321,19,23,4,109.63611,18.24306,2008
4353,35181,5BB45F08F5C8E403A5AC561137D5477C,38094,0,12,12,109.45403,18.28778,1316
4354,35182,5BB45F08F5C8E403A5AC561137D5477C,31701,12,14,2,109.44132,18.28833,1266
4355,35183,5BB45F08F5C8E403A5AC561137D5477C,60231,16,17,1,109.49903,18.21972,1504
4356,35184,5BB45F08F5C8E403A5AC561137D5477C,30361,18,20,2,109.50347,18.24,1508
4357,35185,5BB45F08F5C8E403A5AC561137D5477C,38094,21,23,2,109.45403,18.28778,1316
4361,35250,89E172ACE2708883A506C917200C7533,31231,0,8,8,109.42597,18.29292,1217
4362,35252,89E172ACE2708883A506C917200C7533,31301,12,13,1,109.14493,18.31222,170
4363,35253,89E172ACE2708883A506C917200C7533,31471,15,17,2,109.34583,18.29563,917
4364,35254,89E172ACE2708883A506C917200C7533,60381,18,20,2,109.5241,18.22458,1605
4365,35255,89E172ACE2708883A506C917200C7533,60552,21,22,1,109.41729,18.30014,1218
4369,35279,3977578BE56276DA0700B04B81DC1356,39181,8,9,1,109.55153,18.28035,1715
4370,35280,3977578BE56276DA0700B04B81DC1356,30851,12,13,1,109.5616,18.27396,1713
4371,35281,3977578BE56276DA0700B04B81DC1356,31561,15,17,2,109.56792,18.28479,1765
4375,35309,46E98DB18E03749C45352338127F9B4B,60411,15,16,1,109.32514,18.30854,869
4376,35310,46E98DB18E03749C45352338127F9B4B,31471,18,20,2,109.34583,18.29563,917
4377,35311,46E98DB18E03749C45352338127F9B4B,60411,21,23,2,109.32514,18.30854,869
4378,35312,4A68C1945FCC1868E3DBF0CF909E5429,38541,0,10,10,109.73715,18.34875,2426
4379,35338,919B6D6CA33899F0F2E7C2D48DA4283C,39321,18,23,5,109.529,18.2167,1604
4383,35387,5186E09F1AC986E196088F011D3C54E4,60121,11,12,1,109.74507,18.37472,2430
4384,35388,5186E09F1AC986E196088F011D3C54E4,30511,13,15,2,109.51069,18.24208,1558
4385,35389,5186E09F1AC986E196088F011D3C54E4,60261,16,23,7,109.44326,18.3075,1319
4386,35414,AD608A919061B1C684914F8654FB2493,60161,12,13,1,109.49174,18.26181,1461
4387,35415,AD608A919061B1C684914F8654FB2493,60084,13,15,2,109.4984,18.2334,1507
4388,35416,AD608A919061B1C684914F8654FB2493,60161,18,19,1,109.49174,18.26181,1461
4389,35418,4EF13302A4A6283D4450282828263850,60117,12,14,2,109.73604,18.35681,2427
4390,35426,53D8AA1BA087F345732BEDDB7238341C,60361,0,8,8,109.51938,18.29681,1567
4391,35427,53D8AA1BA087F345732BEDDB7238341C,60381,9,11,2,109.5241,18.22458,1605
4392,35428,53D8AA1BA087F345732BEDDB7238341C,60361,13,15,2,109.51938,18.29681,1567
4393,35429,53D8AA1BA087F345732BEDDB7238341C,30721,17,18,1,109.51597,18.28257,1565
4394,35430,503D57F7BC7A1E0C94A1BA4749FB68C5,60221,1,8,7,109.52569,18.29188,1616
4395,35431,503D57F7BC7A1E0C94A1BA4749FB68C5,31471,9,11,2,109.34583,18.29563,917
4396,35432,503D57F7BC7A1E0C94A1BA4749FB68C5,38315,14,15,1,109.48979,18.29764,1467
4400,35445,4094E4255C1DC92E37A62D94F33F035E,31781,13,14,1,109.19847,18.2975,367
4401,35446,4094E4255C1DC92E37A62D94F33F035E,60054,15,16,1,109.3016,18.31229,770
4402,35447,4094E4255C1DC92E37A62D94F33F035E,31531,20,23,3,109.49583,18.25972,1461
4403,35451,24892DF473AC6ED4692FBD552CF21D37,60381,0,20,20,109.5241,18.22458,1605
4404,35452,24892DF473AC6ED4692FBD552CF21D37,30711,21,23,2,109.50271,18.25347,1510
4405,35453,44A75810FF8F9221047E9675BDBF60A2,31071,0,16,16,109.58257,18.28458,1815
4406,35454,44A75810FF8F9221047E9675BDBF60A2,31561,18,23,5,109.56792,18.28479,1765
4407,35470,B5111A17FE99EC54DAC2FDD550B4E7BA,30441,12,14,2,109.64021,18.25424,2010
4408,35471,B5111A17FE99EC54DAC2FDD550B4E7BA,30171,17,19,2,109.48458,18.27139,1463
4409,35472,B5111A17FE99EC54DAC2FDD550B4E7BA,60621,22,23,1,109.48354,18.27451,1464
4410,35499,9FE9D15036A68E9BB0005F7A79F0480E,30721,13,15,2,109.51597,18.28257,1565
4411,35500,9FE9D15036A68E9BB0005F7A79F0480E,60221,15,18,3,109.52569,18.29188,1616
4412,35501,9FE9D15036A68E9BB0005F7A79F0480E,30721,18,19,1,109.51597,18.28257,1565
4413,35547,65DB2325B6E1E7A0D88A5D2D920F9EA1,31431,0,7,7,109.44639,18.29042,1316
4414,35548,65DB2325B6E1E7A0D88A5D2D920F9EA1,31304,9,12,3,109.15903,18.32854,223
4415,35549,65DB2325B6E1E7A0D88A5D2D920F9EA1,31081,14,16,2,109.44639,18.30181,1318
4416,35550,65DB2325B6E1E7A0D88A5D2D920F9EA1,30711,20,21,1,109.50271,18.25347,1510
4417,35557,56C8C781972E8BFAF8A768A19AD7F590,38261,0,7,7,109.50361,18.28153,1515
4418,35559,56C8C781972E8BFAF8A768A19AD7F590,30201,19,21,2,109.4909,18.26465,1462
4419,35567,FBAECD693E6B86DD24561BB293296A49,60371,1,6,5,109.53063,18.30056,1618
4420,35568,FBAECD693E6B86DD24561BB293296A49,38241,7,11,4,109.54111,18.30542,1669
4428,35615,4DB778A581941E2A7955D8DA3B7ADAFE,31931,0,8,8,109.54771,18.29403,1667
4429,35618,4DB778A581941E2A7955D8DA3B7ADAFE,31931,19,21,2,109.54771,18.29403,1667
4430,35637,CAD1FFF41FBB07303E4F900E7ED6962A,30611,13,14,1,109.74958,18.40188,2485
4431,35651,D64799F525F391CA7FC0CDD8417C04E0,39321,0,5,5,109.529,18.2167,1604
4432,35652,D64799F525F391CA7FC0CDD8417C04E0,30731,9,11,2,109.50944,18.22306,1555
4433,35653,D64799F525F391CA7FC0CDD8417C04E0,31781,13,14,1,109.19847,18.2975,367
4434,35654,D64799F525F391CA7FC0CDD8417C04E0,60221,19,20,1,109.52569,18.29188,1616
4438,35670,E9927B4E67F3A8CBF17FB017C70DF235,30721,0,19,19,109.51597,18.28257,1565
4439,35671,E9927B4E67F3A8CBF17FB017C70DF235,60281,20,23,3,109.51743,18.25924,1561
4444,35681,0AAC0DF5DA334AB291DB1D2333656F0A,38754,13,17,4,109.74667,18.37382,2430
4445,35682,0AAC0DF5DA334AB291DB1D2333656F0A,30361,18,20,2,109.50347,18.24,1508
4449,35699,1BFA72EACB1A635128314056DAC7D19E,31723,0,6,6,109.68563,18.23701,2207
4450,35700,1BFA72EACB1A635128314056DAC7D19E,30371,9,14,5,109.51,18.24771,1559
4451,35701,1BFA72EACB1A635128314056DAC7D19E,31261,14,16,2,109.51174,18.2466,1559
4452,35702,1BFA72EACB1A635128314056DAC7D19E,31723,18,23,5,109.68563,18.23701,2207
4453,35714,E1079EEA1562514A818A5D1EA4D6596C,38754,15,16,1,109.74667,18.37382,2430
4454,35715,0E5593A90D661690BE3DAAA17AD936E2,30281,1,9,8,109.50597,18.27583,1514
4455,35716,0E5593A90D661690BE3DAAA17AD936E2,31091,10,11,1,109.41201,18.31222,1170
4456,35717,0E5593A90D661690BE3DAAA17AD936E2,38127,12,21,9,109.50833,18.27222,1513
4457,35732,07FD145FE6C81328C98C6C5C8452E794,30854,2,4,2,109.56889,18.27076,1763
4458,35733,07FD145FE6C81328C98C6C5C8452E794,30232,4,17,13,109.6191,18.31701,1971
4459,35734,07FD145FE6C81328C98C6C5C8452E794,30854,21,23,2,109.56889,18.27076,1763
4460,35747,47844E829FCB05D6E87386BF9A1380C3,31701,12,14,2,109.44132,18.28833,1266
4461,35748,47844E829FCB05D6E87386BF9A1380C3,31701,18,20,2,109.44132,18.28833,1266
4462,35749,47844E829FCB05D6E87386BF9A1380C3,30271,20,21,1,109.49132,18.23153,1456
4463,35760,2071FF1D9C1E71B294973F5BC85A9FC1,31101,12,14,2,109.65389,18.23403,2057
4464,35761,2071FF1D9C1E71B294973F5BC85A9FC1,30361,19,23,4,109.50347,18.24,1508
4465,35781,2C3BD53A8702A47FB82F05FB4993B683,31561,0,6,6,109.56792,18.28479,1765
4466,35782,2C3BD53A8702A47FB82F05FB4993B683,39183,6,9,3,109.55542,18.28208,1715
4467,35783,2C3BD53A8702A47FB82F05FB4993B683,31561,10,12,2,109.56792,18.28479,1765
4468,35784,2C3BD53A8702A47FB82F05FB4993B683,31031,16,18,2,109.49979,18.25382,1510
4469,35785,2C3BD53A8702A47FB82F05FB4993B683,31561,20,23,3,109.56792,18.28479,1765
4470,35807,18794851E86EA8BA29FCF821CF1F07C3,39111,0,1,1,109.5191,18.22597,1555
4471,35808,18794851E86EA8BA29FCF821CF1F07C3,31071,3,7,4,109.58257,18.28458,1815
4472,35809,18794851E86EA8BA29FCF821CF1F07C3,30854,7,17,10,109.56889,18.27076,1763
4473,35810,18794851E86EA8BA29FCF821CF1F07C3,31421,18,20,2,109.55382,18.22347,1705
4474,35811,18794851E86EA8BA29FCF821CF1F07C3,31071,22,23,1,109.58257,18.28458,1815
4475,35823,F5FA9E3AD48A61D07594249E558C93A1,60331,0,7,7,109.505,18.26507,1512
4476,35824,F5FA9E3AD48A61D07594249E558C93A1,31031,9,10,1,109.49979,18.25382,1510
4477,35825,F5FA9E3AD48A61D07594249E558C93A1,31101,12,18,6,109.65389,18.23403,2057
4478,35826,F5FA9E3AD48A61D07594249E558C93A1,31231,22,23,1,109.42597,18.29292,1217
4479,35837,28116E081E8AAFD89F4929BB4937EC6F,38127,15,17,2,109.50833,18.27222,1513
4480,35838,28116E081E8AAFD89F4929BB4937EC6F,31041,18,20,2,109.50278,18.23701,1507
4481,35839,28116E081E8AAFD89F4929BB4937EC6F,38127,21,23,2,109.50833,18.27222,1513
4482,35869,860D8FD1FD466E2189F245D42B766A0C,30271,0,8,8,109.49132,18.23153,1456
4483,35870,860D8FD1FD466E2189F245D42B766A0C,60211,11,16,5,109.63549,18.26049,2011
4484,35871,860D8FD1FD466E2189F245D42B766A0C,31761,17,18,1,109.60521,18.27965,1914
4485,35872,860D8FD1FD466E2189F245D42B766A0C,31031,18,20,2,109.49979,18.25382,1510
4486,35882,6449449F1B7E787D614284B9622B1531,38951,0,2,2,109.48097,18.28868,1416
4487,35883,6449449F1B7E787D614284B9622B1531,38951,3,6,3,109.48097,18.28868,1416
4488,35884,6449449F1B7E787D614284B9622B1531,38951,7,8,1,109.48097,18.28868,1416
4489,35885,6449449F1B7E787D614284B9622B1531,30661,13,14,1,109.37028,18.24361,1008
4490,35886,6449449F1B7E787D614284B9622B1531,38951,17,20,3,109.48097,18.28868,1416
4491,35887,6449449F1B7E787D614284B9622B1531,39151,21,22,1,109.49875,18.25097,1510
4492,35888,6449449F1B7E787D614284B9622B1531,38951,22,23,1,109.48097,18.28868,1416
4493,35893,63106A356FA62C4782D11D6E10075301,30421,11,12,1,109.50021,18.25861,1511
4497,35916,42923D86FCA39B981325B127230BF145,60117,16,17,1,109.73604,18.35681,2427
4498,35917,42923D86FCA39B981325B127230BF145,30101,19,22,3,109.57299,18.33333,1773
4499,35946,D778D7F80641F53D92BA8D70258C8DBD,30771,11,12,1,109.49938,18.26042,1511
4500,35947,D778D7F80641F53D92BA8D70258C8DBD,30941,14,18,4,109.5559,18.33938,1724
4504,35958,0F192EC3C2BBBBE0C5456A1D0C57D78A,39321,0,12,12,109.529,18.2167,1604
4505,35959,0F192EC3C2BBBBE0C5456A1D0C57D78A,31561,16,17,1,109.56792,18.28479,1765
4506,35960,0F192EC3C2BBBBE0C5456A1D0C57D78A,60661,18,19,1,109.548,18.2377,1657
4507,35961,0F192EC3C2BBBBE0C5456A1D0C57D78A,39321,21,23,2,109.529,18.2167,1604
4512,36010,6B24823797A23CF47C34C631323C3D8C,31031,0,6,6,109.49979,18.25382,1510
4513,36011,6B24823797A23CF47C34C631323C3D8C,30571,10,12,2,109.50243,18.21861,1504
4514,36057,F5C34768E0DD06615D7F1F7BD0ADA2BD,31471,14,17,3,109.34583,18.29563,917
4515,36058,F5C34768E0DD06615D7F1F7BD0ADA2BD,39111,19,20,1,109.5191,18.22597,1555
4520,36073,50C497E938D256053EDA53A1DE0E2147,31931,0,10,10,109.54771,18.29403,1667
4521,36074,50C497E938D256053EDA53A1DE0E2147,31304,13,15,2,109.15903,18.32854,223
4522,36075,50C497E938D256053EDA53A1DE0E2147,31931,16,23,7,109.54771,18.29403,1667
4523,36095,1FE2866848043A2C10AD87212485FE15,31205,1,2,1,109.51111,18.23736,1557
4524,36096,1FE2866848043A2C10AD87212485FE15,31071,4,11,7,109.58257,18.28458,1815
4525,36097,1FE2866848043A2C10AD87212485FE15,30854,11,15,4,109.56889,18.27076,1763
4526,36098,1FE2866848043A2C10AD87212485FE15,31945,16,17,1,109.58021,18.29403,1817
4527,36099,1FE2866848043A2C10AD87212485FE15,30854,17,20,3,109.56889,18.27076,1763
4528,36100,1FE2866848043A2C10AD87212485FE15,31071,22,23,1,109.58257,18.28458,1815
4529,36104,34AB502A442AA8EA4A7FB30471B204DB,60621,3,7,4,109.48354,18.27451,1464
4530,36105,34AB502A442AA8EA4A7FB30471B204DB,31431,8,9,1,109.44639,18.29042,1316
4531,36106,34AB502A442AA8EA4A7FB30471B204DB,38325,11,13,2,109.39792,18.2909,1116
4532,36107,34AB502A442AA8EA4A7FB30471B204DB,30341,14,15,1,109.3625,18.29167,966
4533,36108,34AB502A442AA8EA4A7FB30471B204DB,38251,15,17,2,109.49618,18.25493,1510
4534,36163,1106C42D626632E595B23A5D1A538F7F,30171,0,6,6,109.48458,18.27139,1463
4535,36164,1106C42D626632E595B23A5D1A538F7F,31145,10,12,2,109.20431,18.30479,369
4536,36165,1106C42D626632E595B23A5D1A538F7F,30171,15,19,4,109.48458,18.27139,1463
4537,36166,1106C42D626632E595B23A5D1A538F7F,30171,19,23,4,109.48458,18.27139,1463
4538,36188,18BDE11B8B881AB9918111A51A22299D,60054,0,8,8,109.3016,18.31229,770
4539,36189,18BDE11B8B881AB9918111A51A22299D,30661,8,11,3,109.37028,18.24361,1008
4540,36190,18BDE11B8B881AB9918111A51A22299D,60054,11,15,4,109.3016,18.31229,770
4541,36191,18BDE11B8B881AB9918111A51A22299D,30661,15,17,2,109.37028,18.24361,1008
4542,36192,18BDE11B8B881AB9918111A51A22299D,60054,17,23,6,109.3016,18.31229,770
4546,36228,A1BC0987A3E1C2D1FC67C0DAF118596D,31521,16,17,1,109.51458,18.22542,1555
4547,36229,A1BC0987A3E1C2D1FC67C0DAF118596D,60381,17,19,2,109.5241,18.22458,1605
4548,36230,A1BC0987A3E1C2D1FC67C0DAF118596D,31521,20,23,3,109.51458,18.22542,1555
4549,36254,E9DC5E3F06A9FBF162477C6043E75224,39181,8,11,3,109.55153,18.28035,1715
4550,36255,E9DC5E3F06A9FBF162477C6043E75224,39181,12,13,1,109.55153,18.28035,1715
4554,36264,791234E587E0C86D41967E57B8EBA1DD,30791,21,23,2,109.72333,18.40889,2386
4555,36279,DC2D9D389C76C3C3F81B17488EA05107,60114,19,20,1,109.73028,18.33847,2374
4556,36280,DC2D9D389C76C3C3F81B17488EA05107,60071,22,23,1,109.75674,18.31583,2470
4557,36294,2B3D1202B9CAAA0F3B6C3510362F28D1,38251,18,20,2,109.49618,18.25493,1510
4558,36295,2B3D1202B9CAAA0F3B6C3510362F28D1,31021,22,23,1,109.49021,18.27,1463
4559,36296,63FBAC0202144B00077561285E6A7F87,30651,2,4,2,109.42611,18.385,1232
4560,36297,63FBAC0202144B00077561285E6A7F87,30821,4,23,19,109.43681,18.33639,1274
4561,36298,CA886EB7268A5A35237559872C8687FC,30861,0,11,11,109.52722,18.22743,1606
4562,36299,CA886EB7268A5A35237559872C8687FC,38325,11,13,2,109.39792,18.2909,1116
4563,36300,CA886EB7268A5A35237559872C8687FC,30661,14,15,1,109.37028,18.24361,1008
4567,36376,900E2AA536A0FD530A3DA5C409DA4E53,30351,0,1,1,109.41701,18.29292,1217
4568,36377,900E2AA536A0FD530A3DA5C409DA4E53,30821,2,6,4,109.43681,18.33639,1274
4569,36378,900E2AA536A0FD530A3DA5C409DA4E53,30351,7,9,2,109.41701,18.29292,1217
4570,36379,900E2AA536A0FD530A3DA5C409DA4E53,31031,13,14,1,109.49979,18.25382,1510
4571,36385,904A4DAC7D8AB1F23EC8AAB1DFE3672F,39111,0,9,9,109.5191,18.22597,1555
4572,36386,904A4DAC7D8AB1F23EC8AAB1DFE3672F,31521,10,23,13,109.51458,18.22542,1555
4573,36415,5533066D8871087CCD481B88DD73EF7D,31361,0,6,6,109.47417,18.28292,1415
4574,36416,5533066D8871087CCD481B88DD73EF7D,60441,8,9,1,109.46792,18.28604,1366
4575,36417,5533066D8871087CCD481B88DD73EF7D,60401,9,11,2,109.47444,18.27583,1414
4576,36418,5533066D8871087CCD481B88DD73EF7D,31361,13,17,4,109.47417,18.28292,1415
4577,36419,5533066D8871087CCD481B88DD73EF7D,60401,18,19,1,109.47444,18.27583,1414
4578,36420,5533066D8871087CCD481B88DD73EF7D,31361,19,23,4,109.47417,18.28292,1415
4579,36456,33D0BAF81064BA9871C044941C4D0C71,60401,2,3,1,109.47444,18.27583,1414
4580,36457,33D0BAF81064BA9871C044941C4D0C71,31231,5,7,2,109.42597,18.29292,1217
4581,36458,33D0BAF81064BA9871C044941C4D0C71,31531,10,15,5,109.49583,18.25972,1461
4582,36459,33D0BAF81064BA9871C044941C4D0C71,31031,15,17,2,109.49979,18.25382,1510
4583,36460,33D0BAF81064BA9871C044941C4D0C71,30421,17,19,2,109.50021,18.25861,1511
4584,36461,33D0BAF81064BA9871C044941C4D0C71,60291,20,21,1,109.50826,18.24639,1509
4585,36483,1593E13193A160EF9BE2323C5CE79FFF,30084,18,19,1,109.50118,18.26972,1513
4586,36484,1593E13193A160EF9BE2323C5CE79FFF,31031,21,22,1,109.49979,18.25382,1510
4587,36512,CB25D65CBFC783CF101DCA33ED449F1A,31071,0,14,14,109.58257,18.28458,1815
4588,36513,CB25D65CBFC783CF101DCA33ED449F1A,30201,19,21,2,109.4909,18.26465,1462
4592,36537,AA2A5396AD753E9245AC53C94BAEDECD,61011,0,2,2,109.60653,18.19076,1900
4596,36557,276E28EA74B0ACD204AF25ED59E826DF,38251,19,21,2,109.49618,18.25493,1510
4597,36620,AE748D8ECC22123141A5E3C651126BDA,60291,0,8,8,109.50826,18.24639,1509
4598,36621,AE748D8ECC22123141A5E3C651126BDA,31471,12,13,1,109.34583,18.29563,917
4599,36625,999DEB7BFC175BF03EAE5DB1D4B2EFB6,60361,0,7,7,109.51938,18.29681,1567
4600,36627,999DEB7BFC175BF03EAE5DB1D4B2EFB6,60121,20,21,1,109.74507,18.37472,2430
4601,36649,18073AD9E71B8DFC1E520C5E3653B1BD,38881,0,8,8,109.51618,18.26431,1562
4602,36650,18073AD9E71B8DFC1E520C5E3653B1BD,31951,12,16,4,109.52174,18.30299,1568
4603,36651,18073AD9E71B8DFC1E520C5E3653B1BD,30781,19,20,1,109.3275,18.37847,881
4604,36652,18073AD9E71B8DFC1E520C5E3653B1BD,31291,21,23,2,109.30375,18.40729,786
4605,36662,14F4ACAD1B4C4B8CE52F7EFB2E582792,60441,17,18,1,109.46792,18.28604,1366
4606,36663,14F4ACAD1B4C4B8CE52F7EFB2E582792,31031,22,23,1,109.49979,18.25382,1510
4607,36665,5500319C4CC4B6D41BA9A9B3B3348D32,31031,12,14,2,109.49979,18.25382,1510
4608,36666,5500319C4CC4B6D41BA9A9B3B3348D32,30771,14,16,2,109.49938,18.26042,1511
4612,36700,876477FD9DD46FF97674E612DA6296D8,60161,0,2,2,109.49174,18.26181,1461
4613,36701,876477FD9DD46FF97674E612DA6296D8,31231,4,7,3,109.42597,18.29292,1217
4614,36702,876477FD9DD46FF97674E612DA6296D8,31531,10,16,6,109.49583,18.25972,1461
4615,36703,876477FD9DD46FF97674E612DA6296D8,30211,17,19,2,109.49882,18.23931,1508
4616,36704,876477FD9DD46FF97674E612DA6296D8,31531,20,23,3,109.49583,18.25972,1461
4617,36721,4335E93DC4F6D2DE747AE4BA0FAD49A5,30861,0,6,6,109.52722,18.22743,1606
4618,36722,4335E93DC4F6D2DE747AE4BA0FAD49A5,60552,9,10,1,109.41729,18.30014,1218
4619,36723,4335E93DC4F6D2DE747AE4BA0FAD49A5,31781,12,13,1,109.19847,18.2975,367
4620,36724,4335E93DC4F6D2DE747AE4BA0FAD49A5,31471,15,16,1,109.34583,18.29563,917
4621,36725,4335E93DC4F6D2DE747AE4BA0FAD49A5,30861,20,23,3,109.52722,18.22743,1606
4622,36737,6A0E249716CDD801F644B3A9F150D4A1,38261,12,14,2,109.50361,18.28153,1515
4623,36795,520E021BAEA9C2E9A1EEC02BE29D26C4,38754,14,16,2,109.74667,18.37382,2430
4624,36797,807332CEC38772FA8DF98C48FBD8DD1E,39183,16,17,1,109.55542,18.28208,1715
4625,36798,807332CEC38772FA8DF98C48FBD8DD1E,31561,20,22,2,109.56792,18.28479,1765
4626,36805,05465E4C43A13393BD3ACA2D09C543FF,38111,17,20,3,109.52007,18.22403,1555
4627,36806,05465E4C43A13393BD3ACA2D09C543FF,31521,21,22,1,109.51458,18.22542,1555
4628,36861,E4B522EF4348156010E5C578EC13D60F,31071,4,6,2,109.58257,18.28458,1815
4629,36862,E4B522EF4348156010E5C578EC13D60F,30854,9,17,8,109.56889,18.27076,1763
4630,36863,E4B522EF4348156010E5C578EC13D60F,60211,18,20,2,109.63549,18.26049,2011
4631,36864,E4B522EF4348156010E5C578EC13D60F,30191,21,23,2,109.50361,18.22701,1506
4632,36865,0EB02C47C78555CF4AFEAD0B55845762,31431,2,9,7,109.44639,18.29042,1316
4633,36866,0EB02C47C78555CF4AFEAD0B55845762,38391,10,11,1,109.44111,18.29083,1266
4634,36872,7168F7EAD82B76A2A520C85DAB769D72,31561,1,5,4,109.56792,18.28479,1765
4635,36873,7168F7EAD82B76A2A520C85DAB769D72,39183,9,19,10,109.55542,18.28208,1715
4636,36874,C5B2C146A715B405C4C002F4F3423FFB,39091,8,10,2,109.50097,18.25222,1510
4637,36875,C5B2C146A715B405C4C002F4F3423FFB,31391,10,14,4,109.50382,18.24285,1508
4638,36876,C5B2C146A715B405C4C002F4F3423FFB,39091,15,16,1,109.50097,18.25222,1510
4642,36883,A02174AC24A0C1CA04FD26E43D25EE05,60071,0,5,5,109.75674,18.31583,2470
4643,36884,A02174AC24A0C1CA04FD26E43D25EE05,30851,7,9,2,109.5616,18.27396,1713
4644,36885,A02174AC24A0C1CA04FD26E43D25EE05,30854,9,12,3,109.56889,18.27076,1763
4648,36985,608A55C14BAB2A5B627ACC1F39B89FB6,31945,0,7,7,109.58021,18.29403,1817
4649,36986,608A55C14BAB2A5B627ACC1F39B89FB6,30854,7,9,2,109.56889,18.27076,1763
4650,36987,608A55C14BAB2A5B627ACC1F39B89FB6,31071,10,12,2,109.58257,18.28458,1815
4651,36988,608A55C14BAB2A5B627ACC1F39B89FB6,31945,12,13,1,109.58021,18.29403,1817
4652,36989,608A55C14BAB2A5B627ACC1F39B89FB6,30854,16,18,2,109.56889,18.27076,1763
4653,36990,608A55C14BAB2A5B627ACC1F39B89FB6,31945,21,23,2,109.58021,18.29403,1817
4654,37019,85586D73EA48B4F4D520D899B0BE0554,30291,0,5,5,109.50403,18.27028,1513
4655,37020,85586D73EA48B4F4D520D899B0BE0554,31071,6,14,8,109.58257,18.28458,1815
4656,37021,85586D73EA48B4F4D520D899B0BE0554,30854,16,17,1,109.56889,18.27076,1763
4657,37022,85586D73EA48B4F4D520D899B0BE0554,31071,18,19,1,109.58257,18.28458,1815
4658,37023,85586D73EA48B4F4D520D899B0BE0554,30291,19,23,4,109.50403,18.27028,1513
4659,37033,10EBF762D28520B09848288F7052CFDE,30854,2,5,3,109.56889,18.27076,1763
4660,37034,10EBF762D28520B09848288F7052CFDE,31181,7,12,5,109.50382,18.24813,1509
4661,37035,10EBF762D28520B09848288F7052CFDE,39101,14,18,4,109.50132,18.24931,1509
4662,37036,10EBF762D28520B09848288F7052CFDE,31561,20,21,1,109.56792,18.28479,1765
4663,37037,10EBF762D28520B09848288F7052CFDE,30854,21,23,2,109.56889,18.27076,1763
4664,37065,EF189AF224755104A3EF0837AE0BC2BB,60281,0,9,9,109.51743,18.25924,1561
4665,37067,EF189AF224755104A3EF0837AE0BC2BB,60281,20,23,3,109.51743,18.25924,1561
4666,37103,506F62361FE26A5D1F7362001D98620C,38111,0,7,7,109.52007,18.22403,1555
4667,37104,506F62361FE26A5D1F7362001D98620C,39321,7,8,1,109.529,18.2167,1604
4668,37105,506F62361FE26A5D1F7362001D98620C,38111,9,10,1,109.52007,18.22403,1555
4669,37106,506F62361FE26A5D1F7362001D98620C,38754,11,14,3,109.74667,18.37382,2430
4670,37107,506F62361FE26A5D1F7362001D98620C,31521,17,19,2,109.51458,18.22542,1555
4671,37108,506F62361FE26A5D1F7362001D98620C,38111,19,23,4,109.52007,18.22403,1555
4672,37116,3C162B8B833533A8C79FA08500420144,30711,15,18,3,109.50271,18.25347,1510
4673,37117,3C162B8B833533A8C79FA08500420144,31271,18,19,1,109.48958,18.26257,1462
4674,37118,3C162B8B833533A8C79FA08500420144,60571,20,21,1,109.50722,18.25056,1510
4675,37119,3C162B8B833533A8C79FA08500420144,38826,22,23,1,109.50326,18.25514,1510
4676,37134,AAB3DCB18BAF89954DC0C8A658A6D766,31031,1,2,1,109.49979,18.25382,1510
4677,37135,AAB3DCB18BAF89954DC0C8A658A6D766,38251,2,5,3,109.49618,18.25493,1510
4678,37136,AAB3DCB18BAF89954DC0C8A658A6D766,60231,5,6,1,109.49903,18.21972,1504
4679,37137,AAB3DCB18BAF89954DC0C8A658A6D766,30051,7,9,2,109.48917,18.21215,1453
4680,37138,AAB3DCB18BAF89954DC0C8A658A6D766,60231,9,18,9,109.49903,18.21972,1504
4681,37139,AAB3DCB18BAF89954DC0C8A658A6D766,31031,19,22,3,109.49979,18.25382,1510
4682,37188,065F1687C35F3C827A2EA4A378A0E2C6,30851,8,10,2,109.5616,18.27396,1713
4683,37189,065F1687C35F3C827A2EA4A378A0E2C6,60091,13,14,1,109.59729,18.30431,1869
4684,37190,065F1687C35F3C827A2EA4A378A0E2C6,30851,17,21,4,109.5616,18.27396,1713
4685,37205,3066D3BA0EF6F55E10FAD924A6ADDDEF,30711,0,2,2,109.50271,18.25347,1510
4686,37206,3066D3BA0EF6F55E10FAD924A6ADDDEF,30381,2,23,21,109.52521,18.24507,1609
4687,37226,13166628932DF36C0AD7B1DB5811240A,60591,0,6,6,109.61118,18.21715,1904
4688,37227,13166628932DF36C0AD7B1DB5811240A,30854,6,15,9,109.56889,18.27076,1763
4689,37228,13166628932DF36C0AD7B1DB5811240A,60591,19,23,4,109.61118,18.21715,1904
4690,37232,1E8430723C686C1702DF9BA656941DD0,38951,0,6,6,109.48097,18.28868,1416
4691,37233,1E8430723C686C1702DF9BA656941DD0,31345,7,9,2,109.39,18.29,1066
4692,37234,1E8430723C686C1702DF9BA656941DD0,31231,9,11,2,109.42597,18.29292,1217
4693,37235,1E8430723C686C1702DF9BA656941DD0,38105,12,13,1,109.40299,18.29229,1117
4694,37236,1E8430723C686C1702DF9BA656941DD0,38094,14,16,2,109.45403,18.28778,1316
4695,37237,1E8430723C686C1702DF9BA656941DD0,38951,18,22,4,109.48097,18.28868,1416
4696,37277,E605B26D53F08A0D3360A4541E09F4E2,30721,0,7,7,109.51597,18.28257,1565
4697,37278,E605B26D53F08A0D3360A4541E09F4E2,31145,11,13,2,109.20431,18.30479,369
4698,37279,E605B26D53F08A0D3360A4541E09F4E2,38283,14,23,9,109.62229,18.22618,1956
4703,37316,F3743A0150B752AC5079D26C89C3915F,60614,0,2,2,109.48799,18.29521,1467
4704,37317,F3743A0150B752AC5079D26C89C3915F,38951,2,5,3,109.48097,18.28868,1416
4705,37318,F3743A0150B752AC5079D26C89C3915F,60614,6,7,1,109.48799,18.29521,1467
4706,37319,F3743A0150B752AC5079D26C89C3915F,38951,10,11,1,109.48097,18.28868,1416
4707,37320,F3743A0150B752AC5079D26C89C3915F,30741,13,14,1,109.49833,18.28681,1516
4708,37321,F3743A0150B752AC5079D26C89C3915F,30971,14,17,3,109.48708,18.29319,1467
4709,37322,F3743A0150B752AC5079D26C89C3915F,38951,19,20,1,109.48097,18.28868,1416
4710,37323,F3743A0150B752AC5079D26C89C3915F,60614,20,21,1,109.48799,18.29521,1467
4711,37338,7E826D5B1F16716D0276910DC964328A,60594,1,10,9,109.62694,18.22799,1956
4712,37339,7E826D5B1F16716D0276910DC964328A,38052,11,12,1,109.62618,18.23042,1956
4713,37340,7E826D5B1F16716D0276910DC964328A,33481,13,14,1,109.67278,18.41278,2187
4714,37341,7E826D5B1F16716D0276910DC964328A,33101,15,16,1,109.68438,18.44368,2242
4715,37342,7E826D5B1F16716D0276910DC964328A,38052,19,22,3,109.62618,18.23042,1956
4716,37412,C48911F2501F3C5309DA39E0641B7D38,31071,15,16,1,109.58257,18.28458,1815
4717,37413,C48911F2501F3C5309DA39E0641B7D38,30854,18,22,4,109.56889,18.27076,1763
4718,37431,96994AD87756271E307B81F41E5136D2,60501,12,13,1,109.48701,18.29021,1466
4719,37432,96994AD87756271E307B81F41E5136D2,60441,14,15,1,109.46792,18.28604,1366
4720,37433,96994AD87756271E307B81F41E5136D2,30854,16,19,3,109.56889,18.27076,1763
4724,37457,08EDC1BDFD8ECE46CA15A186317FA7B7,31521,0,11,11,109.51458,18.22542,1555
4725,37458,08EDC1BDFD8ECE46CA15A186317FA7B7,60054,15,16,1,109.3016,18.31229,770
4726,37459,08EDC1BDFD8ECE46CA15A186317FA7B7,30361,17,20,3,109.50347,18.24,1508
4727,37460,08EDC1BDFD8ECE46CA15A186317FA7B7,31521,21,23,2,109.51458,18.22542,1555
4728,37483,7421066246AAD1C230E7E2A7ADF06E9D,60631,0,5,5,109.57778,18.27583,1814
4729,37484,7421066246AAD1C230E7E2A7ADF06E9D,30854,7,8,1,109.56889,18.27076,1763
4730,37485,7421066246AAD1C230E7E2A7ADF06E9D,31071,8,11,3,109.58257,18.28458,1815
4731,37486,7421066246AAD1C230E7E2A7ADF06E9D,60631,12,13,1,109.57778,18.27583,1814
4732,37487,7421066246AAD1C230E7E2A7ADF06E9D,30854,13,19,6,109.56889,18.27076,1763
4733,37488,7421066246AAD1C230E7E2A7ADF06E9D,60631,22,23,1,109.57778,18.27583,1814
4734,37490,6BCFCC220636F506D1865F02E5E7FDE8,60084,20,21,1,109.4984,18.2334,1507
4735,37491,6BCFCC220636F506D1865F02E5E7FDE8,31761,22,23,1,109.60521,18.27965,1914
4736,37492,A4823EEC9A8E697E80697432C029B488,30391,11,13,2,109.4975,18.27118,1513
4737,37493,A4823EEC9A8E697E80697432C029B488,30771,13,15,2,109.49938,18.26042,1511
4738,37494,A4823EEC9A8E697E80697432C029B488,30391,19,20,1,109.4975,18.27118,1513
4739,37495,A4823EEC9A8E697E80697432C029B488,31561,21,22,1,109.56792,18.28479,1765
4740,37503,17CC4D48447B18FFE0C5E2D7115F70E9,60161,15,16,1,109.49174,18.26181,1461
4741,37504,17CC4D48447B18FFE0C5E2D7115F70E9,38251,16,18,2,109.49618,18.25493,1510
4742,37518,A273393D96A2B92B5EC32D0B9DC69E7D,31021,0,6,6,109.49021,18.27,1463
4743,37519,A273393D96A2B92B5EC32D0B9DC69E7D,30771,7,9,2,109.49938,18.26042,1511
4744,37520,A273393D96A2B92B5EC32D0B9DC69E7D,30201,9,11,2,109.4909,18.26465,1462
4745,37521,A273393D96A2B92B5EC32D0B9DC69E7D,30711,12,14,2,109.50271,18.25347,1510
4746,37522,A273393D96A2B92B5EC32D0B9DC69E7D,31021,18,23,5,109.49021,18.27,1463
4747,37550,D13BDDDA768B4492C03FFA127AE05681,38871,0,6,6,109.44681,18.28625,1316
4748,37551,D13BDDDA768B4492C03FFA127AE05681,30111,7,13,6,109.47583,18.30542,1419
4749,37552,D13BDDDA768B4492C03FFA127AE05681,38283,14,23,9,109.62229,18.22618,1956
4750,37559,417408FFDA93B177641D270D3A5C4B2D,31071,0,6,6,109.58257,18.28458,1815
4751,37560,417408FFDA93B177641D270D3A5C4B2D,60631,7,10,3,109.57778,18.27583,1814
4752,37561,417408FFDA93B177641D270D3A5C4B2D,30854,11,13,2,109.56889,18.27076,1763
4753,37562,417408FFDA93B177641D270D3A5C4B2D,31071,13,14,1,109.58257,18.28458,1815
4754,37563,417408FFDA93B177641D270D3A5C4B2D,60631,15,18,3,109.57778,18.27583,1814
4755,37564,417408FFDA93B177641D270D3A5C4B2D,30891,22,23,1,109.59431,18.28389,1865
4756,37615,6862E1409834047709EBD3185EEA79B3,38141,0,11,11,109.39479,18.2916,1116
4757,37616,6862E1409834047709EBD3185EEA79B3,38141,14,23,9,109.39479,18.2916,1116
4761,37638,0CED616A832F8659D1540B6D8ADE8C66,31781,12,13,1,109.19847,18.2975,367
4762,37639,0CED616A832F8659D1540B6D8ADE8C66,31471,14,15,1,109.34583,18.29563,917
4763,37640,0CED616A832F8659D1540B6D8ADE8C66,38903,19,22,3,109.39229,18.29243,1117
4764,37651,28F7DFD4A036DBA4E68AFC71762D44D7,31561,0,5,5,109.56792,18.28479,1765
4765,37652,28F7DFD4A036DBA4E68AFC71762D44D7,30851,7,19,12,109.5616,18.27396,1713
4766,37660,1D9ABE27C2D558C89E365FD305F32137,30271,0,7,7,109.49132,18.23153,1456
4767,37661,1D9ABE27C2D558C89E365FD305F32137,31521,8,9,1,109.51458,18.22542,1555
4768,37662,1D9ABE27C2D558C89E365FD305F32137,31781,11,15,4,109.19847,18.2975,367
4769,37663,1D9ABE27C2D558C89E365FD305F32137,31521,16,18,2,109.51458,18.22542,1555
4770,37664,1D9ABE27C2D558C89E365FD305F32137,60381,19,20,1,109.5241,18.22458,1605
4771,37665,1D9ABE27C2D558C89E365FD305F32137,30271,20,22,2,109.49132,18.23153,1456
4772,37700,AA42C8D5F23E17A418E66C8770B385FE,60571,0,12,12,109.50722,18.25056,1510
4773,37701,AA42C8D5F23E17A418E66C8770B385FE,30151,15,23,8,109.50986,18.25083,1560
4774,37748,1ACCBC562528CC75566F6D945C1677CB,38251,0,9,9,109.49618,18.25493,1510
4775,37775,707670CE62A106DAC866A70B1F89E816,31431,0,8,8,109.44639,18.29042,1316
4776,37776,707670CE62A106DAC866A70B1F89E816,60071,11,12,1,109.75674,18.31583,2470
4777,37788,6EA83A9329F5D86E7E7F9B8351352891,30421,12,14,2,109.50021,18.25861,1511
4778,37789,6EA83A9329F5D86E7E7F9B8351352891,30921,15,17,2,109.53903,18.29451,1667
4779,37798,8DD23AA43C0F7967C45F7488D66F9159,31945,0,7,7,109.58021,18.29403,1817
4780,37799,8DD23AA43C0F7967C45F7488D66F9159,30854,8,12,4,109.56889,18.27076,1763
4781,37800,8DD23AA43C0F7967C45F7488D66F9159,31945,12,13,1,109.58021,18.29403,1817
4782,37801,8DD23AA43C0F7967C45F7488D66F9159,30854,14,19,5,109.56889,18.27076,1763
4783,37802,8DD23AA43C0F7967C45F7488D66F9159,60311,21,23,2,109.52097,18.24319,1558
4784,37803,D63E20D130E2F81CA5A6AF5385AEF68B,30511,2,6,4,109.51069,18.24208,1558
4785,37804,D63E20D130E2F81CA5A6AF5385AEF68B,31521,7,10,3,109.51458,18.22542,1555
4786,37805,D63E20D130E2F81CA5A6AF5385AEF68B,30361,10,12,2,109.50347,18.24,1508
4787,37806,D63E20D130E2F81CA5A6AF5385AEF68B,38111,13,16,3,109.52007,18.22403,1555
4788,37807,D63E20D130E2F81CA5A6AF5385AEF68B,30731,16,17,1,109.50944,18.22306,1555
4789,37808,D63E20D130E2F81CA5A6AF5385AEF68B,31521,18,20,2,109.51458,18.22542,1555
4790,37809,D63E20D130E2F81CA5A6AF5385AEF68B,60381,20,22,2,109.5241,18.22458,1605
4791,37810,3B66C6D354CAB83AFF8CCC11FF0B09AC,38991,6,9,3,109.52681,18.30368,1618
4792,37811,3B66C6D354CAB83AFF8CCC11FF0B09AC,60171,9,11,2,109.51292,18.30694,1569
4793,37812,3B66C6D354CAB83AFF8CCC11FF0B09AC,31951,11,13,2,109.52174,18.30299,1568
4794,37813,3B66C6D354CAB83AFF8CCC11FF0B09AC,31781,14,16,2,109.19847,18.2975,367
4795,37814,3B66C6D354CAB83AFF8CCC11FF0B09AC,38251,19,23,4,109.49618,18.25493,1510
4796,37833,CC99FA2A6C21E3A9E3287361BB3FB0AC,30851,0,6,6,109.5616,18.27396,1713
4797,37834,CC99FA2A6C21E3A9E3287361BB3FB0AC,31561,7,9,2,109.56792,18.28479,1765
4798,37835,CC99FA2A6C21E3A9E3287361BB3FB0AC,30851,10,11,1,109.5616,18.27396,1713
4799,37836,CC99FA2A6C21E3A9E3287361BB3FB0AC,31561,11,13,2,109.56792,18.28479,1765
4800,37837,CC99FA2A6C21E3A9E3287361BB3FB0AC,30851,14,15,1,109.5616,18.27396,1713
4801,37838,CC99FA2A6C21E3A9E3287361BB3FB0AC,31561,17,18,1,109.56792,18.28479,1765
4802,37839,CC99FA2A6C21E3A9E3287361BB3FB0AC,30851,21,23,2,109.5616,18.27396,1713
4803,37848,1EF385EC60D556EE5F45CC248F3036E3,31301,12,13,1,109.14493,18.31222,170
4804,37849,1EF385EC60D556EE5F45CC248F3036E3,31421,18,19,1,109.55382,18.22347,1705
4805,37894,F7ABE1A2051D725D70F50CD6183F5B8A,30201,0,9,9,109.4909,18.26465,1462
4806,37895,F7ABE1A2051D725D70F50CD6183F5B8A,31781,11,14,3,109.19847,18.2975,367
4807,37896,F7ABE1A2051D725D70F50CD6183F5B8A,31471,16,17,1,109.34583,18.29563,917
4808,37897,F7ABE1A2051D725D70F50CD6183F5B8A,30201,19,23,4,109.4909,18.26465,1462
4809,37912,72A5AEE2B8265DA80B198D741B53A3DA,60371,19,20,1,109.53063,18.30056,1618
4810,37913,72A5AEE2B8265DA80B198D741B53A3DA,30071,21,22,1,109.52819,18.30472,1619
4811,37917,094C7084A845593EA3BA8B1180C420B0,60121,15,16,1,109.74507,18.37472,2430
4812,37918,094C7084A845593EA3BA8B1180C420B0,31091,19,20,1,109.41201,18.31222,1170
4813,37919,094C7084A845593EA3BA8B1180C420B0,30121,21,23,2,109.52861,18.27222,1613
4814,37926,5AB036BD4852DC840A52FF542200B93C,31461,0,8,8,109.5091,18.25389,1510
4815,37927,5AB036BD4852DC840A52FF542200B93C,31161,11,15,4,109.70229,18.31361,2270
4816,37928,5AB036BD4852DC840A52FF542200B93C,30711,16,18,2,109.50271,18.25347,1510
4817,37929,5AB036BD4852DC840A52FF542200B93C,31461,21,23,2,109.5091,18.25389,1510
4818,38039,2CB2771F7B23DF9836E81244B3977177,31471,16,17,1,109.34583,18.29563,917
4819,38040,2CB2771F7B23DF9836E81244B3977177,30201,21,23,2,109.4909,18.26465,1462
4823,38057,324899445F811D5785FB336DE18DAC0E,31931,0,6,6,109.54771,18.29403,1667
4827,38081,25D6F59FBC67CDA90FF7920DEC546472,38706,0,10,10,109.74625,18.37097,2430
4828,38082,25D6F59FBC67CDA90FF7920DEC546472,31781,14,15,1,109.19847,18.2975,367
4829,38083,25D6F59FBC67CDA90FF7920DEC546472,31031,18,19,1,109.49979,18.25382,1510
4830,38084,25D6F59FBC67CDA90FF7920DEC546472,38706,20,23,3,109.74625,18.37097,2430
4831,38119,EBF906C5498076BCFA3E97DF6001B4F3,60631,1,8,7,109.57778,18.27583,1814
4832,38120,EBF906C5498076BCFA3E97DF6001B4F3,30854,10,11,1,109.56889,18.27076,1763
4833,38155,2A6BA0678DDF16AF08BAC9E3FA3C9391,31561,0,6,6,109.56792,18.28479,1765
4834,38156,2A6BA0678DDF16AF08BAC9E3FA3C9391,30854,9,20,11,109.56889,18.27076,1763
4835,38170,928DF0385E8541CFD2F5858501C04155,30234,6,7,1,109.60681,18.29979,1918
4836,38171,928DF0385E8541CFD2F5858501C04155,30854,7,12,5,109.56889,18.27076,1763
4837,38214,4AC58984B2F202FD588F865249555769,31311,1,16,15,109.72299,18.27438,2364
4838,38215,4AC58984B2F202FD588F865249555769,38271,20,22,2,109.62632,18.23049,1956
4839,38216,B334BB19B11E6B0F5578EDD58288683C,30111,12,15,3,109.47583,18.30542,1419
4840,38217,B334BB19B11E6B0F5578EDD58288683C,31081,19,23,4,109.44639,18.30181,1318
4841,38218,8BB15E7C959475309A269AAF24FD7109,30911,0,1,1,109.50493,18.26181,1511
4842,38219,8BB15E7C959475309A269AAF24FD7109,39111,3,9,6,109.5191,18.22597,1555
4843,38220,8BB15E7C959475309A269AAF24FD7109,31391,11,12,1,109.50382,18.24285,1508
4844,38221,8BB15E7C959475309A269AAF24FD7109,31521,13,20,7,109.51458,18.22542,1555
4845,38222,8BB15E7C959475309A269AAF24FD7109,60381,20,22,2,109.5241,18.22458,1605
4846,38223,75817DB682187A07461734D66E1E6492,60631,0,4,4,109.57778,18.27583,1814
4847,38224,75817DB682187A07461734D66E1E6492,30854,4,12,8,109.56889,18.27076,1763
4848,38225,75817DB682187A07461734D66E1E6492,30851,17,18,1,109.5616,18.27396,1713
4849,38226,75817DB682187A07461734D66E1E6492,31061,19,21,2,109.53333,18.23257,1607
4850,38227,75817DB682187A07461734D66E1E6492,60631,22,23,1,109.57778,18.27583,1814
4851,38255,E16204D131FCD957D5ADB9592C1DD0ED,30854,16,19,3,109.56889,18.27076,1763
4852,38256,E16204D131FCD957D5ADB9592C1DD0ED,30361,19,21,2,109.50347,18.24,1508
4853,38257,E16204D131FCD957D5ADB9592C1DD0ED,31561,21,23,2,109.56792,18.28479,1765
4854,38264,F46FDDC29A8850C2C04367141B6440B6,30854,7,8,1,109.56889,18.27076,1763
4855,38265,F46FDDC29A8850C2C04367141B6440B6,31801,9,12,3,109.20417,18.32118,371
4856,38289,7DABC59FEA0DB7B637BC8EAB3272FDB2,31061,0,7,7,109.53333,18.23257,1607
4857,38290,7DABC59FEA0DB7B637BC8EAB3272FDB2,31145,10,12,2,109.20431,18.30479,369
4858,38291,7DABC59FEA0DB7B637BC8EAB3272FDB2,30661,13,15,2,109.37028,18.24361,1008
4859,38292,7DABC59FEA0DB7B637BC8EAB3272FDB2,38251,19,21,2,109.49618,18.25493,1510
4860,38293,7DABC59FEA0DB7B637BC8EAB3272FDB2,31061,22,23,1,109.53333,18.23257,1607
4861,38304,7FB0F8EA4F93FB3B277450D57CE0C694,31321,12,14,2,109.63799,18.23201,2007
4862,38305,7FB0F8EA4F93FB3B277450D57CE0C694,31531,16,23,7,109.49583,18.25972,1461
4863,38319,BB722B9C2BE433A2166F92FAB5C577D9,31521,0,6,6,109.51458,18.22542,1555
4864,38320,BB722B9C2BE433A2166F92FAB5C577D9,31781,9,12,3,109.19847,18.2975,367
4865,38321,BB722B9C2BE433A2166F92FAB5C577D9,31471,14,18,4,109.34583,18.29563,917
4869,38336,ED3B9FA0C7EBC373FA8CE8DAF74F568C,60234,0,5,5,109.49577,18.2096,1453
4870,38337,ED3B9FA0C7EBC373FA8CE8DAF74F568C,30571,6,8,2,109.50243,18.21861,1504
4871,38338,ED3B9FA0C7EBC373FA8CE8DAF74F568C,38347,8,9,1,109.4934,18.21444,1454
4872,38339,ED3B9FA0C7EBC373FA8CE8DAF74F568C,31031,9,11,2,109.49979,18.25382,1510
4873,38340,ED3B9FA0C7EBC373FA8CE8DAF74F568C,30571,14,18,4,109.50243,18.21861,1504
4874,38341,ED3B9FA0C7EBC373FA8CE8DAF74F568C,30361,19,20,1,109.50347,18.24,1508
4875,38342,ED3B9FA0C7EBC373FA8CE8DAF74F568C,30571,21,23,2,109.50243,18.21861,1504
4876,38387,50180B11A4CA88EAD2B9BCC82FC09C4C,30281,0,7,7,109.50597,18.27583,1514
4877,38388,50180B11A4CA88EAD2B9BCC82FC09C4C,31841,9,20,11,109.73201,18.33382,2373
4878,38389,50180B11A4CA88EAD2B9BCC82FC09C4C,30854,21,23,2,109.56889,18.27076,1763
4879,38402,D4EDFC03E7ED63DAAF98D926C98FC74F,31181,0,7,7,109.50382,18.24813,1509
4880,38403,D4EDFC03E7ED63DAAF98D926C98FC74F,30441,10,12,2,109.64021,18.25424,2010
4881,38404,D4EDFC03E7ED63DAAF98D926C98FC74F,31181,17,19,2,109.50382,18.24813,1509
4882,38405,D4EDFC03E7ED63DAAF98D926C98FC74F,31181,19,23,4,109.50382,18.24813,1509
4883,38438,ABCD0851CC1C78BCD7AF6DBDF2F5DE49,30211,6,11,5,109.49882,18.23931,1508
4884,38439,ABCD0851CC1C78BCD7AF6DBDF2F5DE49,60552,11,13,2,109.41729,18.30014,1218
4885,38486,E6541B4F346982101D887BAAF0315541,31561,17,18,1,109.56792,18.28479,1765
4886,38487,E6541B4F346982101D887BAAF0315541,30854,19,23,4,109.56889,18.27076,1763
4887,38501,9EB99F27F9127F01C16DB7BA7D10B6E0,31561,0,8,8,109.56792,18.28479,1765
4888,38502,9EB99F27F9127F01C16DB7BA7D10B6E0,31071,9,10,1,109.58257,18.28458,1815
4889,38503,9EB99F27F9127F01C16DB7BA7D10B6E0,30854,10,12,2,109.56889,18.27076,1763
4890,38504,9EB99F27F9127F01C16DB7BA7D10B6E0,31071,14,16,2,109.58257,18.28458,1815
4891,38505,9EB99F27F9127F01C16DB7BA7D10B6E0,30854,19,21,2,109.56889,18.27076,1763
4900,38553,37907F3D7030B6146A33BAFE73719B21,31781,11,13,2,109.19847,18.2975,367
4901,38554,37907F3D7030B6146A33BAFE73719B21,31231,17,19,2,109.42597,18.29292,1217
4902,38555,37907F3D7030B6146A33BAFE73719B21,31231,20,23,3,109.42597,18.29292,1217
4903,38572,E81160546B66436F002CB563AAB7719F,31571,2,3,1,109.61563,18.23326,1957
4904,38573,E81160546B66436F002CB563AAB7719F,30581,3,7,4,109.62257,18.24951,1959
4905,38574,E81160546B66436F002CB563AAB7719F,31571,7,8,1,109.61563,18.23326,1957
4906,38575,E81160546B66436F002CB563AAB7719F,60054,12,14,2,109.3016,18.31229,770
4907,38576,E81160546B66436F002CB563AAB7719F,38315,17,18,1,109.48979,18.29764,1467
4908,38639,EF727BDF3D7B6D877CF0038228740019,30211,13,14,1,109.49882,18.23931,1508
4909,38640,EF727BDF3D7B6D877CF0038228740019,39151,15,20,5,109.49875,18.25097,1510
4910,38641,EEE6C5854E7673512BDD1CCF526E946C,31471,16,17,1,109.34583,18.29563,917
4911,38642,EEE6C5854E7673512BDD1CCF526E946C,38951,19,20,1,109.48097,18.28868,1416
4912,38643,EEE6C5854E7673512BDD1CCF526E946C,38951,21,23,2,109.48097,18.28868,1416
4913,38644,1B107E88505197CF8BA7F2178A168846,30661,11,13,2,109.37028,18.24361,1008
4914,38645,1B107E88505197CF8BA7F2178A168846,38145,18,23,5,109.378,18.2912,1066
4915,38683,2260047EB2D30172BB0014D53FF32A4B,39111,0,7,7,109.5191,18.22597,1555
4916,38684,2260047EB2D30172BB0014D53FF32A4B,31781,11,12,1,109.19847,18.2975,367
4917,38685,2260047EB2D30172BB0014D53FF32A4B,31471,13,14,1,109.34583,18.29563,917
4918,38686,2260047EB2D30172BB0014D53FF32A4B,30361,17,18,1,109.50347,18.24,1508
4919,38687,2260047EB2D30172BB0014D53FF32A4B,39111,20,23,3,109.5191,18.22597,1555
4924,38705,27BCEF3137923B84211F08830816C810,30851,2,8,6,109.5616,18.27396,1713
4925,38707,27BCEF3137923B84211F08830816C810,61011,14,15,1,109.60653,18.19076,1900
4926,38717,5EAEAB611440D169B1CE8706AE16111E,31521,0,4,4,109.51458,18.22542,1555
4927,38718,5EAEAB611440D169B1CE8706AE16111E,30511,7,9,2,109.51069,18.24208,1558
4928,38719,5EAEAB611440D169B1CE8706AE16111E,31521,12,16,4,109.51458,18.22542,1555
4929,38720,5EAEAB611440D169B1CE8706AE16111E,30511,18,19,1,109.51069,18.24208,1558
4930,38721,5EAEAB611440D169B1CE8706AE16111E,60131,20,21,1,109.49819,18.24778,1509
4931,38724,9BE19A4707368CF2308CCC927EC29D43,31851,15,16,1,109.71736,18.29007,2316
4932,38726,5426296000364EE32711CD0E73D782C8,30854,0,1,1,109.56889,18.27076,1763
4933,38727,5426296000364EE32711CD0E73D782C8,31071,2,23,21,109.58257,18.28458,1815
4934,38729,896E70230E917230ACB2F2222A93F438,30421,17,23,6,109.50021,18.25861,1511
4935,38739,439C404954398764464D854D76F475D8,39071,0,10,10,109.19917,18.29472,367
4936,38740,439C404954398764464D854D76F475D8,30761,13,15,2,109.45201,18.3,1318
4937,38741,439C404954398764464D854D76F475D8,31091,15,17,2,109.41201,18.31222,1170
4938,38760,82727639E71DFEFC2A16FBFC1D14AF54,31101,14,15,1,109.65389,18.23403,2057
4939,38761,82727639E71DFEFC2A16FBFC1D14AF54,60211,19,20,1,109.63549,18.26049,2011
4940,38762,82727639E71DFEFC2A16FBFC1D14AF54,38131,21,22,1,109.65167,18.23535,2057
4941,38786,4995463B780282C9C030A19D9F49AEAC,30854,8,15,7,109.56889,18.27076,1763
4942,38787,4995463B780282C9C030A19D9F49AEAC,31071,16,17,1,109.58257,18.28458,1815
4943,38788,4995463B780282C9C030A19D9F49AEAC,30854,20,21,1,109.56889,18.27076,1763
4944,38789,4995463B780282C9C030A19D9F49AEAC,31071,22,23,1,109.58257,18.28458,1815
4945,38824,C6F078264A4011D72ABD6DE75DA6F035,30391,0,8,8,109.4975,18.27118,1513
4946,38827,C6F078264A4011D72ABD6DE75DA6F035,39101,20,22,2,109.50132,18.24931,1509
4947,38905,00FD2268DE6E83934D2916174E81532F,60472,6,8,2,109.46625,18.29542,1367
4948,38906,00FD2268DE6E83934D2916174E81532F,30111,12,13,1,109.47583,18.30542,1419
4949,38907,00FD2268DE6E83934D2916174E81532F,30761,14,15,1,109.45201,18.3,1318
4950,38908,00FD2268DE6E83934D2916174E81532F,30111,16,21,5,109.47583,18.30542,1419
4951,38964,0C16D819785C0566D50CC6C5E7058EF2,30571,0,11,11,109.50243,18.21861,1504
4952,38965,0C16D819785C0566D50CC6C5E7058EF2,38754,12,17,5,109.74667,18.37382,2430
4953,38966,0C16D819785C0566D50CC6C5E7058EF2,30571,19,20,1,109.50243,18.21861,1504
4954,38978,B340EDEF4A878E8DF5CBEC25E465EACE,30854,2,8,6,109.56889,18.27076,1763
4955,38979,B340EDEF4A878E8DF5CBEC25E465EACE,60631,9,10,1,109.57778,18.27583,1814
4956,38980,B340EDEF4A878E8DF5CBEC25E465EACE,30854,10,12,2,109.56889,18.27076,1763
4957,38981,B340EDEF4A878E8DF5CBEC25E465EACE,31071,12,19,7,109.58257,18.28458,1815
4958,38982,B340EDEF4A878E8DF5CBEC25E465EACE,30854,20,22,2,109.56889,18.27076,1763
4959,38985,3E36844870867DBEBD25143A17160259,30071,5,12,7,109.52819,18.30472,1619
4960,38997,F198CAA1F49ACA5D003FD8F8473B3798,31071,1,20,19,109.58257,18.28458,1815
4961,38998,F198CAA1F49ACA5D003FD8F8473B3798,30854,21,23,2,109.56889,18.27076,1763
4962,39041,C860767955774E3494068CF38C009FB6,39151,16,17,1,109.49875,18.25097,1510
4963,39042,C860767955774E3494068CF38C009FB6,60391,19,23,4,109.47667,18.28757,1416
4964,39046,8A2602EE97ED1F19C3F8048B259C52D2,31521,18,20,2,109.51458,18.22542,1555
4965,39047,8A2602EE97ED1F19C3F8048B259C52D2,60381,20,21,1,109.5241,18.22458,1605
4966,39081,3B9CF45D57A7D2A120FFDEE58BB4974D,31431,0,9,9,109.44639,18.29042,1316
4967,39082,3B9CF45D57A7D2A120FFDEE58BB4974D,31781,11,14,3,109.19847,18.2975,367
4968,39083,3B9CF45D57A7D2A120FFDEE58BB4974D,31431,17,18,1,109.44639,18.29042,1316
4969,39084,3B9CF45D57A7D2A120FFDEE58BB4974D,31701,18,20,2,109.44132,18.28833,1266
4970,39110,8C5A16299A6D294198C90C34C25C5949,31561,14,15,1,109.56792,18.28479,1765
4971,39111,8C5A16299A6D294198C90C34C25C5949,30854,19,20,1,109.56889,18.27076,1763
4972,39112,8C5A16299A6D294198C90C34C25C5949,39183,20,21,1,109.55542,18.28208,1715
4976,39233,ED27A36B4EC5F7DF8073D01D839A8DDC,38356,16,18,2,109.50201,18.21486,1504
4977,39234,ED27A36B4EC5F7DF8073D01D839A8DDC,60381,19,20,1,109.5241,18.22458,1605
4978,39235,ED27A36B4EC5F7DF8073D01D839A8DDC,38356,21,23,2,109.50201,18.21486,1504
4979,39244,3175EB28BB7B27CAE2120D6151C4EC00,38315,0,13,13,109.48979,18.29764,1467
4980,39254,3A5827A88DC93A9B58B304F6E1017BB8,60401,0,1,1,109.47444,18.27583,1414
4981,39255,3A5827A88DC93A9B58B304F6E1017BB8,38251,3,5,2,109.49618,18.25493,1510
4982,39256,3A5827A88DC93A9B58B304F6E1017BB8,31231,6,9,3,109.42597,18.29292,1217
4983,39257,3A5827A88DC93A9B58B304F6E1017BB8,38331,13,23,10,109.62465,18.22736,1956
4984,39283,4699AE6CF383C4C75244005144E585A1,31061,14,21,7,109.53333,18.23257,1607
4985,39284,4699AE6CF383C4C75244005144E585A1,60211,22,23,1,109.63549,18.26049,2011
4986,39285,7C4555390A772AFC617B693DE91FE9EE,60371,3,5,2,109.53063,18.30056,1618
4987,39286,7C4555390A772AFC617B693DE91FE9EE,31931,6,8,2,109.54771,18.29403,1667
4988,39287,7C4555390A772AFC617B693DE91FE9EE,39181,9,11,2,109.55153,18.28035,1715
4989,39288,7C4555390A772AFC617B693DE91FE9EE,31931,13,14,1,109.54771,18.29403,1667
4990,39289,7C4555390A772AFC617B693DE91FE9EE,38241,15,16,1,109.54111,18.30542,1669
4991,39290,7C4555390A772AFC617B693DE91FE9EE,31261,20,23,3,109.51174,18.2466,1559
4992,39291,DB0545D9EAEB3C579F968F7F5B217B6C,38127,0,15,15,109.50833,18.27222,1513
4993,39385,EC3D175E97D1257AC20AF39754562033,39131,0,6,6,109.2066,18.29639,417
4994,39386,EC3D175E97D1257AC20AF39754562033,31781,7,9,2,109.19847,18.2975,367
4995,39440,533C598FBE9A80A69F24B4E517B0CF08,30741,16,20,4,109.49833,18.28681,1516
4996,39441,533C598FBE9A80A69F24B4E517B0CF08,30421,21,22,1,109.50021,18.25861,1511
4997,39447,DC0EB400EA24BEE9EB39D315B0E6AEF0,60041,11,15,4,109.39889,18.31944,1121
4998,39448,DC0EB400EA24BEE9EB39D315B0E6AEF0,38871,17,23,6,109.44681,18.28625,1316
5002,39477,AA303E27C0F1A202B07C13B2600A28E3,31471,15,17,2,109.34583,18.29563,917
5003,39478,AA303E27C0F1A202B07C13B2600A28E3,30361,19,21,2,109.50347,18.24,1508
5007,39548,3566D93A1983F1B060C3ACA68586876F,38951,19,20,1,109.48097,18.28868,1416
5008,39549,3566D93A1983F1B060C3ACA68586876F,38951,22,23,1,109.48097,18.28868,1416
5009,39603,73D60F2EA359EEE2578482BDCFC4E018,39321,14,16,2,109.529,18.2167,1604
5010,39604,73D60F2EA359EEE2578482BDCFC4E018,38541,17,21,4,109.73715,18.34875,2426
5011,39636,9FC721E86703223349C05C95FE4BBB6F,60087,0,2,2,109.50688,18.22299,1505
5012,39637,9FC721E86703223349C05C95FE4BBB6F,60081,2,10,8,109.51097,18.22639,1556
5013,39638,9FC721E86703223349C05C95FE4BBB6F,60381,11,19,8,109.5241,18.22458,1605
5014,39639,9FC721E86703223349C05C95FE4BBB6F,31521,19,20,1,109.51458,18.22542,1555
5015,39640,9FC721E86703223349C05C95FE4BBB6F,60087,21,23,2,109.50688,18.22299,1505
5016,39650,B616D64706FE00CB4CDA3E3D124853B8,30511,15,16,1,109.51069,18.24208,1558
5017,39651,B616D64706FE00CB4CDA3E3D124853B8,31671,17,23,6,109.38965,18.29813,1068
5018,39682,37165DF42A8775B3C0474BD893FEF592,39321,16,18,2,109.529,18.2167,1604
5019,39683,37165DF42A8775B3C0474BD893FEF592,30361,19,21,2,109.50347,18.24,1508
5020,39691,36DE5DE7D024FC0D4AA8374BBC02FD61,60401,0,8,8,109.47444,18.27583,1414
5021,39692,36DE5DE7D024FC0D4AA8374BBC02FD61,33051,11,16,5,109.6475,18.46618,2096
5022,39753,A8CC84F6441C04DAF82A74609E587ED2,30561,0,2,2,109.52778,18.31938,1621
5023,39754,A8CC84F6441C04DAF82A74609E587ED2,30561,4,6,2,109.52778,18.31938,1621
5024,39755,A8CC84F6441C04DAF82A74609E587ED2,31931,7,11,4,109.54771,18.29403,1667
5025,39756,A8CC84F6441C04DAF82A74609E587ED2,30561,12,13,1,109.52778,18.31938,1621
5026,39757,A8CC84F6441C04DAF82A74609E587ED2,31931,14,16,2,109.54771,18.29403,1667
5027,39758,A8CC84F6441C04DAF82A74609E587ED2,30561,18,21,3,109.52778,18.31938,1621
5028,39791,F195AFF17955B04C2BD69FE8CB907348,39061,0,3,3,109.38222,18.28958,1066
5029,39792,F195AFF17955B04C2BD69FE8CB907348,38027,3,8,5,109.38833,18.2909,1066
5030,39793,F195AFF17955B04C2BD69FE8CB907348,31781,8,10,2,109.19847,18.2975,367
5031,39794,F195AFF17955B04C2BD69FE8CB907348,39081,11,12,1,109.19382,18.29111,366
5032,39795,F195AFF17955B04C2BD69FE8CB907348,31471,14,15,1,109.34583,18.29563,917
5033,39823,2576A40187A845D7B849E820F16B3DB1,30854,1,3,2,109.56889,18.27076,1763
5034,39824,2576A40187A845D7B849E820F16B3DB1,31071,3,8,5,109.58257,18.28458,1815
5035,39825,2576A40187A845D7B849E820F16B3DB1,30854,10,11,1,109.56889,18.27076,1763
5036,39826,2576A40187A845D7B849E820F16B3DB1,31071,13,15,2,109.58257,18.28458,1815
5037,39827,2576A40187A845D7B849E820F16B3DB1,30854,16,19,3,109.56889,18.27076,1763
5041,39863,51B9FE31A6261A2E6FE900B23D8E8A33,60391,0,15,15,109.47667,18.28757,1416
5042,39864,51B9FE31A6261A2E6FE900B23D8E8A33,60381,18,19,1,109.5241,18.22458,1605
5043,39865,51B9FE31A6261A2E6FE900B23D8E8A33,30421,20,21,1,109.50021,18.25861,1511
5044,39866,51B9FE31A6261A2E6FE900B23D8E8A33,60391,21,23,2,109.47667,18.28757,1416
5045,39887,4323F1BAF644B54BAE5AE7C688725B1E,31071,0,14,14,109.58257,18.28458,1815
5046,39888,4323F1BAF644B54BAE5AE7C688725B1E,39151,16,18,2,109.49875,18.25097,1510
5051,39930,B20C192805DC56EE880FB74EB0759F15,38754,14,15,1,109.74667,18.37382,2430
5052,39932,DF726AC992EA795A98DE4DF26D62B584,31521,13,20,7,109.51458,18.22542,1555
5053,39933,DF726AC992EA795A98DE4DF26D62B584,30361,20,21,1,109.50347,18.24,1508
5054,39936,9D173245E760E51856EB0F1A3A5A796E,31145,9,11,2,109.20431,18.30479,369
5055,39967,85113926FD58DF2481DE297BC312E23D,38094,0,9,9,109.45403,18.28778,1316
5056,39968,85113926FD58DF2481DE297BC312E23D,31311,11,18,7,109.72299,18.27438,2364
5057,39969,85113926FD58DF2481DE297BC312E23D,60121,18,20,2,109.74507,18.37472,2430
5061,39995,9DC6ECD11DB9342376E99047D8C3456C,30854,1,14,13,109.56889,18.27076,1763
5062,39996,9DC6ECD11DB9342376E99047D8C3456C,38261,18,22,4,109.50361,18.28153,1515
5066,40108,74AD1AF2EA5153BD40BCF9A3F3F2C4E3,30854,7,9,2,109.56889,18.27076,1763
5067,40109,74AD1AF2EA5153BD40BCF9A3F3F2C4E3,31071,9,11,2,109.58257,18.28458,1815
5068,40110,74AD1AF2EA5153BD40BCF9A3F3F2C4E3,30854,11,13,2,109.56889,18.27076,1763
5069,40111,74AD1AF2EA5153BD40BCF9A3F3F2C4E3,31071,14,21,7,109.58257,18.28458,1815
5074,40161,2636D092653DB639DF114DD1E5470CF3,31021,0,11,11,109.49021,18.27,1463
5075,40162,2636D092653DB639DF114DD1E5470CF3,31071,15,21,6,109.58257,18.28458,1815
5076,40193,4DEA461E038CB97C304B1C8C76D68215,31145,12,15,3,109.20431,18.30479,369
5077,40194,4DEA461E038CB97C304B1C8C76D68215,31521,19,20,1,109.51458,18.22542,1555
5078,40195,4DEA461E038CB97C304B1C8C76D68215,39321,20,23,3,109.529,18.2167,1604
5079,40203,92E108319E8175B7B6E72625E24D17C9,30361,18,20,2,109.50347,18.24,1508
5080,40204,92E108319E8175B7B6E72625E24D17C9,38811,22,23,1,109.50875,18.2175,1504
5084,40217,BFBF13B5E10088239CEDE316C8663521,30581,0,7,7,109.62257,18.24951,1959
5085,40218,BFBF13B5E10088239CEDE316C8663521,31571,7,8,1,109.61563,18.23326,1957
5086,40219,BFBF13B5E10088239CEDE316C8663521,60054,12,14,2,109.3016,18.31229,770
5087,40220,BFBF13B5E10088239CEDE316C8663521,60614,17,18,1,109.48799,18.29521,1467
5088,40223,84DF4A7C208235D171EF56473BCCF210,60631,0,18,18,109.57778,18.27583,1814
5089,40224,84DF4A7C208235D171EF56473BCCF210,30851,22,23,1,109.5616,18.27396,1713
5090,40259,C3071072DB6684DC75BE160268E6323C,30854,6,18,12,109.56889,18.27076,1763
5091,40260,C3071072DB6684DC75BE160268E6323C,30084,20,22,2,109.50118,18.26972,1513
5105,40328,C316CE65034FB3C77BE459147CBF943A,60291,0,9,9,109.50826,18.24639,1509
5106,40329,C316CE65034FB3C77BE459147CBF943A,30161,10,12,2,109.50042,18.24389,1508
5107,40330,C316CE65034FB3C77BE459147CBF943A,31181,13,14,1,109.50382,18.24813,1509
5108,40331,C316CE65034FB3C77BE459147CBF943A,30161,15,17,2,109.50042,18.24389,1508
5109,40332,C316CE65034FB3C77BE459147CBF943A,30161,17,19,2,109.50042,18.24389,1508
5110,40333,C316CE65034FB3C77BE459147CBF943A,30371,20,23,3,109.51,18.24771,1559
5111,40336,0563BC067E662950114EF8FD62D34D59,39091,0,9,9,109.50097,18.25222,1510
5112,40337,0563BC067E662950114EF8FD62D34D59,31145,11,12,1,109.20431,18.30479,369
5113,40338,0563BC067E662950114EF8FD62D34D59,39131,13,14,1,109.2066,18.29639,417
5114,40346,79DF40D2B98887E142CED30D6ACACB42,31521,0,8,8,109.51458,18.22542,1555
5115,40347,79DF40D2B98887E142CED30D6ACACB42,31781,10,12,2,109.19847,18.2975,367
5116,40348,79DF40D2B98887E142CED30D6ACACB42,31471,14,15,1,109.34583,18.29563,917
5117,40349,79DF40D2B98887E142CED30D6ACACB42,60161,19,20,1,109.49174,18.26181,1461
5118,40366,57174D33B48D199AA8B09D59209E3E63,31781,13,14,1,109.19847,18.2975,367
5119,40367,57174D33B48D199AA8B09D59209E3E63,31471,15,17,2,109.34583,18.29563,917
5120,40368,57174D33B48D199AA8B09D59209E3E63,30391,21,22,1,109.4975,18.27118,1513
5125,40381,D6A345956751BA2ACC5430EDF68A104F,39181,0,6,6,109.55153,18.28035,1715
5126,40382,D6A345956751BA2ACC5430EDF68A104F,39181,7,10,3,109.55153,18.28035,1715
5127,40383,D6A345956751BA2ACC5430EDF68A104F,31931,10,16,6,109.54771,18.29403,1667
5128,40384,D6A345956751BA2ACC5430EDF68A104F,39181,18,19,1,109.55153,18.28035,1715
5129,40385,D6A345956751BA2ACC5430EDF68A104F,31071,20,22,2,109.58257,18.28458,1815
5130,40386,2DE9EDA76548D997396F5AD85CC3B910,38991,4,5,1,109.52681,18.30368,1618
5131,40387,2DE9EDA76548D997396F5AD85CC3B910,60371,6,8,2,109.53063,18.30056,1618
5132,40388,2DE9EDA76548D997396F5AD85CC3B910,31781,11,14,3,109.19847,18.2975,367
5133,40389,2DE9EDA76548D997396F5AD85CC3B910,60221,17,21,4,109.52569,18.29188,1616
5134,40422,62AE585F0AAA8DA5ED8FA7DC785DB597,30361,12,15,3,109.50347,18.24,1508
5135,40441,C50EC98EBB3AD6F34D76F87C749DAC01,39181,0,9,9,109.55153,18.28035,1715
5136,40442,C50EC98EBB3AD6F34D76F87C749DAC01,31931,10,13,3,109.54771,18.29403,1667
5137,40443,C50EC98EBB3AD6F34D76F87C749DAC01,39181,13,15,2,109.55153,18.28035,1715
5138,40444,C50EC98EBB3AD6F34D76F87C749DAC01,31931,15,19,4,109.54771,18.29403,1667
5139,40445,C50EC98EBB3AD6F34D76F87C749DAC01,39181,19,23,4,109.55153,18.28035,1715
5140,40455,667EA80049388AD19BD964958F75B929,31145,13,15,2,109.20431,18.30479,369
5141,40456,667EA80049388AD19BD964958F75B929,60054,16,18,2,109.3016,18.31229,770
5142,40457,667EA80049388AD19BD964958F75B929,30421,19,20,1,109.50021,18.25861,1511
5143,40461,DB27065941C483C1992B62B188635BF8,31471,14,15,1,109.34583,18.29563,917
5144,40462,DB27065941C483C1992B62B188635BF8,60221,19,20,1,109.52569,18.29188,1616
5145,40463,DB27065941C483C1992B62B188635BF8,31864,21,23,2,109.49014,18.28333,1465
5146,40469,E33D19A2E6AE9CBD99027C143E4122D1,30361,0,3,3,109.50347,18.24,1508
5147,40470,E33D19A2E6AE9CBD99027C143E4122D1,38376,4,10,6,109.50924,18.24,1558
5148,40471,E33D19A2E6AE9CBD99027C143E4122D1,30361,14,16,2,109.50347,18.24,1508
5149,40472,E33D19A2E6AE9CBD99027C143E4122D1,30421,16,19,3,109.50021,18.25861,1511
5150,40473,E33D19A2E6AE9CBD99027C143E4122D1,31391,19,21,2,109.50382,18.24285,1508
5151,40494,CF23CF6CFE18BB23E9BD394A1039CA8D,31145,14,15,1,109.20431,18.30479,369
5152,40495,CF23CF6CFE18BB23E9BD394A1039CA8D,60054,16,18,2,109.3016,18.31229,770
5153,40496,F00821368F615DCDAF214035D8EC4A44,31071,12,13,1,109.58257,18.28458,1815
5154,40497,F00821368F615DCDAF214035D8EC4A44,30854,15,17,2,109.56889,18.27076,1763
5155,40498,F00821368F615DCDAF214035D8EC4A44,38291,18,21,3,109.51618,18.24313,1558
5156,40524,934029FB5F97BCE114EDCE88F0393A63,30854,2,12,10,109.56889,18.27076,1763
5157,40527,8D7B9451E0189947198D6AC9CE51CFEE,30111,0,1,1,109.47583,18.30542,1419
5158,40528,8D7B9451E0189947198D6AC9CE51CFEE,30764,1,3,2,109.45806,18.29486,1367
5159,40529,8D7B9451E0189947198D6AC9CE51CFEE,31091,4,14,10,109.41201,18.31222,1170
5160,40530,8D7B9451E0189947198D6AC9CE51CFEE,31081,19,21,2,109.44639,18.30181,1318
5161,40531,8D7B9451E0189947198D6AC9CE51CFEE,31091,21,23,2,109.41201,18.31222,1170
5162,40549,770049901BD1590EBE86EED8F56910D2,31471,10,12,2,109.34583,18.29563,917
5163,40550,770049901BD1590EBE86EED8F56910D2,31145,14,16,2,109.20431,18.30479,369
5164,40551,770049901BD1590EBE86EED8F56910D2,30361,19,20,1,109.50347,18.24,1508
5165,40552,770049901BD1590EBE86EED8F56910D2,60041,22,23,1,109.39889,18.31944,1121
5169,40606,FE635F2B32C65ADB512C504153E6C643,30361,15,18,3,109.50347,18.24,1508
5170,40607,FE635F2B32C65ADB512C504153E6C643,38052,19,23,4,109.62618,18.23042,1956
5171,40625,B81967918F04CCC09086D5144AD4448F,30201,0,8,8,109.4909,18.26465,1462
5172,40626,B81967918F04CCC09086D5144AD4448F,31471,10,12,2,109.34583,18.29563,917
5173,40627,B81967918F04CCC09086D5144AD4448F,31145,13,14,1,109.20431,18.30479,369
5174,40628,B81967918F04CCC09086D5144AD4448F,31271,18,23,5,109.48958,18.26257,1462
5178,40694,AD39A6F857F8E578E6A2D9E072C4613F,30681,0,8,8,109.48493,18.26917,1463
5179,40695,AD39A6F857F8E578E6A2D9E072C4613F,38111,12,13,1,109.52007,18.22403,1555
5180,40696,AD39A6F857F8E578E6A2D9E072C4613F,30791,15,18,3,109.72333,18.40889,2386
5181,40697,AD39A6F857F8E578E6A2D9E072C4613F,30421,20,21,1,109.50021,18.25861,1511
5185,40725,9147E6833419D1AC88CC9A3C7C57D8F9,30511,2,4,2,109.51069,18.24208,1558
5186,40726,9147E6833419D1AC88CC9A3C7C57D8F9,38376,6,7,1,109.50924,18.24,1558
5187,40727,9147E6833419D1AC88CC9A3C7C57D8F9,30361,8,10,2,109.50347,18.24,1508
5188,40728,9147E6833419D1AC88CC9A3C7C57D8F9,38371,11,13,2,109.50972,18.23924,1558
5189,40729,9147E6833419D1AC88CC9A3C7C57D8F9,30361,14,16,2,109.50347,18.24,1508
5190,40730,9147E6833419D1AC88CC9A3C7C57D8F9,30421,16,19,3,109.50021,18.25861,1511
5191,40731,9147E6833419D1AC88CC9A3C7C57D8F9,30361,19,21,2,109.50347,18.24,1508
5192,40740,55CBF233BA3606523955A1093C92D734,31031,11,13,2,109.49979,18.25382,1510
5193,40741,55CBF233BA3606523955A1093C92D734,30421,13,16,3,109.50021,18.25861,1511
5194,40768,F4066052A05F84E460A213A00F90E37F,60201,0,4,4,109.5041,18.2509,1510
5195,40769,F4066052A05F84E460A213A00F90E37F,38251,5,10,5,109.49618,18.25493,1510
5196,40770,F4066052A05F84E460A213A00F90E37F,38071,14,15,1,109.40722,18.30938,1169
5197,40824,9C1407835BC54BEBDB541F52E1DA1820,61011,8,16,8,109.60653,18.19076,1900
5198,40847,EBCB949B72E5CE9FCA5E9C7D3826BEF9,60201,1,4,3,109.5041,18.2509,1510
5199,40848,EBCB949B72E5CE9FCA5E9C7D3826BEF9,60291,5,9,4,109.50826,18.24639,1509
5200,40849,EBCB949B72E5CE9FCA5E9C7D3826BEF9,60201,9,10,1,109.5041,18.2509,1510
5201,40850,EBCB949B72E5CE9FCA5E9C7D3826BEF9,60161,13,15,2,109.49174,18.26181,1461
5202,40851,EBCB949B72E5CE9FCA5E9C7D3826BEF9,60201,19,23,4,109.5041,18.2509,1510
5203,40893,C162E20472DBB598395501A28AA53C86,31671,0,8,8,109.38965,18.29813,1068
5204,40894,C162E20472DBB598395501A28AA53C86,38185,10,12,2,109.51333,18.27347,1563
5205,40895,C162E20472DBB598395501A28AA53C86,60291,14,15,1,109.50826,18.24639,1509
5206,40896,C162E20472DBB598395501A28AA53C86,31021,16,18,2,109.49021,18.27,1463
5207,40897,C162E20472DBB598395501A28AA53C86,60261,20,22,2,109.44326,18.3075,1319
5211,40951,911CEC4AC21FB385F27D5F98FF05CA40,30201,11,23,12,109.4909,18.26465,1462
5215,40986,951158CC6AD050845D913E5934112D91,60084,0,7,7,109.4984,18.2334,1507
5216,40987,951158CC6AD050845D913E5934112D91,30051,7,8,1,109.48917,18.21215,1453
5217,41041,84CE8301EE7DE9359AE27DC0300F36A9,30761,1,5,4,109.45201,18.3,1318
5218,41042,84CE8301EE7DE9359AE27DC0300F36A9,30854,8,14,6,109.56889,18.27076,1763
5219,41072,000584B3023702F3E9DDF521B1C35B1A,31351,0,2,2,109.4959,18.28417,1465
5220,41073,000584B3023702F3E9DDF521B1C35B1A,31071,4,7,3,109.58257,18.28458,1815
5221,41074,000584B3023702F3E9DDF521B1C35B1A,30854,9,11,2,109.56889,18.27076,1763
5222,41075,000584B3023702F3E9DDF521B1C35B1A,31945,13,14,1,109.58021,18.29403,1817
5223,41076,000584B3023702F3E9DDF521B1C35B1A,30221,16,17,1,109.57833,18.20222,1802
5224,41077,000584B3023702F3E9DDF521B1C35B1A,31071,20,22,2,109.58257,18.28458,1815
5225,41088,84B290D0AF9CB48AF24DF60053E525A2,31271,16,18,2,109.48958,18.26257,1462
5226,41089,84B290D0AF9CB48AF24DF60053E525A2,30681,18,20,2,109.48493,18.26917,1463
5227,41090,84B290D0AF9CB48AF24DF60053E525A2,31271,21,23,2,109.48958,18.26257,1462
5232,41139,E00EF22F493557E868E52C93194870CF,60381,19,21,2,109.5241,18.22458,1605
5233,41140,E00EF22F493557E868E52C93194870CF,30854,21,23,2,109.56889,18.27076,1763
5234,41147,7EC0E6AB7B4A98205882F5FFBEA13441,60234,2,5,3,109.49577,18.2096,1453
5235,41148,7EC0E6AB7B4A98205882F5FFBEA13441,38017,5,13,8,109.49729,18.21424,1504
5236,41149,7EC0E6AB7B4A98205882F5FFBEA13441,38111,13,14,1,109.52007,18.22403,1555
5237,41150,7EC0E6AB7B4A98205882F5FFBEA13441,38754,15,17,2,109.74667,18.37382,2430
5238,41151,7EC0E6AB7B4A98205882F5FFBEA13441,38017,21,23,2,109.49729,18.21424,1504
5239,41155,15FA33D999B0EB11F94D5A6342781D57,31071,0,7,7,109.58257,18.28458,1815
5240,41156,15FA33D999B0EB11F94D5A6342781D57,39081,11,12,1,109.19382,18.29111,366
5241,41157,15FA33D999B0EB11F94D5A6342781D57,31471,14,16,2,109.34583,18.29563,917
5245,41271,7FD31F65A9E7574FDAD4A110ACBA289D,60171,8,17,9,109.51292,18.30694,1569
5246,41272,7FD31F65A9E7574FDAD4A110ACBA289D,31931,18,19,1,109.54771,18.29403,1667
5247,41288,D21A77842B7456864CF5D4493E9BC8AC,31031,19,20,1,109.49979,18.25382,1510
5248,41289,D21A77842B7456864CF5D4493E9BC8AC,30771,21,23,2,109.49938,18.26042,1511
5252,41386,012ABD06F231728C214A4BA917E75B1C,31561,2,12,10,109.56792,18.28479,1765
5253,41387,012ABD06F231728C214A4BA917E75B1C,30851,12,23,11,109.5616,18.27396,1713
5254,41392,AB25B62B696E140EFF56840EA509FBEC,31021,0,12,12,109.49021,18.27,1463
5255,41393,AB25B62B696E140EFF56840EA509FBEC,31071,16,21,5,109.58257,18.28458,1815
5256,41411,2428138ABBB212CA047CB5D8922FEA6C,31271,16,18,2,109.48958,18.26257,1462
5257,41412,2428138ABBB212CA047CB5D8922FEA6C,31271,20,23,3,109.48958,18.26257,1462
5258,41444,B059BBC33E2156C18B654245B6B48400,31841,0,10,10,109.73201,18.33382,2373
5259,41445,B059BBC33E2156C18B654245B6B48400,31471,14,15,1,109.34583,18.29563,917
5260,41446,B059BBC33E2156C18B654245B6B48400,31471,16,17,1,109.34583,18.29563,917
5267,41503,84E955A0550DCD4ABBE7AEDF9211B01F,31781,14,15,1,109.19847,18.2975,367
5268,41504,84E955A0550DCD4ABBE7AEDF9211B01F,30361,16,18,2,109.50347,18.24,1508
5269,41505,84E955A0550DCD4ABBE7AEDF9211B01F,38111,18,22,4,109.52007,18.22403,1555
5278,41560,983D4F389BF2B6DDDB09B0049946D36C,38951,0,1,1,109.48097,18.28868,1416
5279,41561,983D4F389BF2B6DDDB09B0049946D36C,60614,3,7,4,109.48799,18.29521,1467
5280,41562,983D4F389BF2B6DDDB09B0049946D36C,31031,11,13,2,109.49979,18.25382,1510
5281,41563,983D4F389BF2B6DDDB09B0049946D36C,30771,14,15,1,109.49938,18.26042,1511
5282,41564,983D4F389BF2B6DDDB09B0049946D36C,38951,16,20,4,109.48097,18.28868,1416
5283,41566,FDDBAB9FCE399B704F31A21C4D97D4EB,38361,12,19,7,109.43667,18.29201,1267
5284,41567,FDDBAB9FCE399B704F31A21C4D97D4EB,30671,19,21,2,109.43611,18.30139,1268
5285,41568,FDDBAB9FCE399B704F31A21C4D97D4EB,38361,22,23,1,109.43667,18.29201,1267
5286,41577,EACE20B4A2182292F610DC040D74163A,33521,10,14,4,109.66313,18.45174,2143
5287,41607,8EE2B55B9C0133D9EB3C4198C24C9CD9,31271,0,11,11,109.48958,18.26257,1462
5288,41608,8EE2B55B9C0133D9EB3C4198C24C9CD9,31471,13,14,1,109.34583,18.29563,917
5289,41609,8EE2B55B9C0133D9EB3C4198C24C9CD9,31471,16,17,1,109.34583,18.29563,917
5290,41610,8EE2B55B9C0133D9EB3C4198C24C9CD9,30891,18,23,5,109.59431,18.28389,1865
5291,41618,68CEAA977F13F8E6482609B7352C0B52,30711,15,20,5,109.50271,18.25347,1510
5292,41619,68CEAA977F13F8E6482609B7352C0B52,38127,22,23,1,109.50833,18.27222,1513
5293,41636,37385E5852F0E8B9BD379DD12A67AD23,48574,0,12,12,109.48931,18.28458,1465
5294,41637,37385E5852F0E8B9BD379DD12A67AD23,31145,14,16,2,109.20431,18.30479,369
5295,41713,FD18155FE4FC718630CE71D3DC676309,38251,16,23,7,109.49618,18.25493,1510
5296,41722,8752BC71725B50257436D50C6598F252,31071,0,6,6,109.58257,18.28458,1815
5297,41723,8752BC71725B50257436D50C6598F252,30854,8,21,13,109.56889,18.27076,1763
5298,41727,653802FBFFAEB319D5E2987830A7AC5C,60281,0,19,19,109.51743,18.25924,1561
5299,41728,653802FBFFAEB319D5E2987830A7AC5C,30461,20,23,3,109.5116,18.26313,1562
5300,41761,B65A42EE158A1686688454429BA4F642,39321,1,9,8,109.529,18.2167,1604
5301,41762,B65A42EE158A1686688454429BA4F642,31521,11,14,3,109.51458,18.22542,1555
5302,41763,B65A42EE158A1686688454429BA4F642,39321,18,19,1,109.529,18.2167,1604
5303,41764,B65A42EE158A1686688454429BA4F642,39111,20,22,2,109.5191,18.22597,1555
5304,41765,B65A42EE158A1686688454429BA4F642,60381,22,23,1,109.5241,18.22458,1605
5314,41819,C983E73D646629A775690ECA8920EB29,31631,0,1,1,109.59542,18.36826,1879
5315,41820,C983E73D646629A775690ECA8920EB29,30101,3,20,17,109.57299,18.33333,1773
5316,41828,DB6D9FFA46279E97CED98B6CF908C718,60411,4,10,6,109.32514,18.30854,869
5317,41829,DB6D9FFA46279E97CED98B6CF908C718,38754,12,14,2,109.74667,18.37382,2430
5318,41830,DB6D9FFA46279E97CED98B6CF908C718,38871,15,16,1,109.44681,18.28625,1316
5319,41831,DB6D9FFA46279E97CED98B6CF908C718,31471,17,19,2,109.34583,18.29563,917
5320,41844,5B1793F390E8BE5126CF433016029F77,31161,0,9,9,109.70229,18.31361,2270
5321,41845,5B1793F390E8BE5126CF433016029F77,38751,14,17,3,109.74903,18.37639,2481
5322,41846,5B1793F390E8BE5126CF433016029F77,31201,20,21,1,109.51042,18.23819,1558
5323,41847,5B1793F390E8BE5126CF433016029F77,31161,22,23,1,109.70229,18.31361,2270
5324,41935,377A324496E54511961704972731A3D5,38121,13,14,1,109.51361,18.27813,1564
5325,41936,377A324496E54511961704972731A3D5,31521,17,18,1,109.51458,18.22542,1555
5326,41937,377A324496E54511961704972731A3D5,31821,21,23,2,109.51181,18.24924,1559
5327,41981,3011558B901D7A197828D36F3A7146BE,30361,0,9,9,109.50347,18.24,1508
5328,41982,3011558B901D7A197828D36F3A7146BE,60054,11,12,1,109.3016,18.31229,770
5329,41983,3011558B901D7A197828D36F3A7146BE,31471,13,15,2,109.34583,18.29563,917
5330,42026,3AA78C75CDB56F7940531D4F95789DAF,31781,16,17,1,109.19847,18.2975,367
5331,42027,3AA78C75CDB56F7940531D4F95789DAF,38251,19,20,1,109.49618,18.25493,1510
5332,42028,3AA78C75CDB56F7940531D4F95789DAF,31271,21,23,2,109.48958,18.26257,1462
5333,42029,104EFBF239A23046252D07031DBBF3A9,60231,1,3,2,109.49903,18.21972,1504
5334,42030,104EFBF239A23046252D07031DBBF3A9,30571,4,8,4,109.50243,18.21861,1504
5335,42031,104EFBF239A23046252D07031DBBF3A9,39301,9,13,4,109.48361,18.21153,1453
5336,42032,104EFBF239A23046252D07031DBBF3A9,60401,14,15,1,109.47444,18.27583,1414
5337,42033,104EFBF239A23046252D07031DBBF3A9,30571,17,20,3,109.50243,18.21861,1504
5338,42034,104EFBF239A23046252D07031DBBF3A9,60231,21,23,2,109.49903,18.21972,1504
5339,42059,117CDF2D41FFFF099F62724091D8605A,60631,7,9,2,109.57778,18.27583,1814
5340,42060,117CDF2D41FFFF099F62724091D8605A,38911,11,13,2,109.51674,18.24965,1559
5341,42061,117CDF2D41FFFF099F62724091D8605A,30854,14,15,1,109.56889,18.27076,1763
5342,42074,9AA959ED87D1ECC3053DED17290EFCBD,31561,10,11,1,109.56792,18.28479,1765
5343,42075,9AA959ED87D1ECC3053DED17290EFCBD,39183,13,14,1,109.55542,18.28208,1715
5344,42076,9AA959ED87D1ECC3053DED17290EFCBD,31561,18,19,1,109.56792,18.28479,1765
5345,42077,9AA959ED87D1ECC3053DED17290EFCBD,30854,22,23,1,109.56889,18.27076,1763
5346,42081,0E4E3873A84F880D37A184F5409B3BB0,38826,0,7,7,109.50326,18.25514,1510
5347,42082,0E4E3873A84F880D37A184F5409B3BB0,31311,11,15,4,109.72299,18.27438,2364
5348,42083,0E4E3873A84F880D37A184F5409B3BB0,38826,17,21,4,109.50326,18.25514,1510
5349,42084,0E4E3873A84F880D37A184F5409B3BB0,60381,21,23,2,109.5241,18.22458,1605
5350,42109,7890099D98AA300C5BF12527E7372DB0,60631,0,7,7,109.57778,18.27583,1814
5351,42110,7890099D98AA300C5BF12527E7372DB0,31071,9,10,1,109.58257,18.28458,1815
5352,42111,7890099D98AA300C5BF12527E7372DB0,60631,12,14,2,109.57778,18.27583,1814
5353,42112,7890099D98AA300C5BF12527E7372DB0,30854,16,18,2,109.56889,18.27076,1763
5354,42113,7890099D98AA300C5BF12527E7372DB0,60631,18,23,5,109.57778,18.27583,1814
5355,42120,B1CDB845FD43C065DBB8ADFB7BB832CF,60381,0,9,9,109.5241,18.22458,1605
5356,42121,B1CDB845FD43C065DBB8ADFB7BB832CF,60054,12,14,2,109.3016,18.31229,770
5357,42122,B1CDB845FD43C065DBB8ADFB7BB832CF,31521,17,18,1,109.51458,18.22542,1555
5358,42145,C6812E7C0E8E7B7313DC722FACB50779,30854,0,13,13,109.56889,18.27076,1763
5359,42146,C6812E7C0E8E7B7313DC722FACB50779,31071,13,14,1,109.58257,18.28458,1815
5360,42147,C6812E7C0E8E7B7313DC722FACB50779,30854,14,17,3,109.56889,18.27076,1763
5361,42148,C6812E7C0E8E7B7313DC722FACB50779,60631,17,18,1,109.57778,18.27583,1814
5362,42149,C6812E7C0E8E7B7313DC722FACB50779,30854,21,23,2,109.56889,18.27076,1763
5363,42176,F9495F66439606D360743D0ECE9C8939,31471,16,18,2,109.34583,18.29563,917
5364,42177,F9495F66439606D360743D0ECE9C8939,30201,21,23,2,109.4909,18.26465,1462
5365,42196,667C95EE70813FD5688175AD35041F35,31521,0,14,14,109.51458,18.22542,1555
5366,42197,667C95EE70813FD5688175AD35041F35,31471,15,17,2,109.34583,18.29563,917
5367,42198,667C95EE70813FD5688175AD35041F35,60411,18,19,1,109.32514,18.30854,869
5368,42199,667C95EE70813FD5688175AD35041F35,38071,20,21,1,109.40722,18.30938,1169
5369,42212,32D0EBFA645FCE8DAD65D018847E5043,30232,1,7,6,109.6191,18.31701,1971
5370,42213,32D0EBFA645FCE8DAD65D018847E5043,30854,7,17,10,109.56889,18.27076,1763
5371,42214,32D0EBFA645FCE8DAD65D018847E5043,30232,22,23,1,109.6191,18.31701,1971
5372,42228,2261FA59C58CA1DB4ED476451BEA0AD4,48574,0,9,9,109.48931,18.28458,1465
5373,42229,2261FA59C58CA1DB4ED476451BEA0AD4,30341,11,14,3,109.3625,18.29167,966
5374,42230,2261FA59C58CA1DB4ED476451BEA0AD4,60221,15,17,2,109.52569,18.29188,1616
5375,42231,2261FA59C58CA1DB4ED476451BEA0AD4,31864,19,21,2,109.49014,18.28333,1465
5376,42248,4CC3058F56A42FB99DF66B1D4EA3395F,30081,0,8,8,109.50243,18.26632,1512
5377,42249,4CC3058F56A42FB99DF66B1D4EA3395F,33521,13,14,1,109.66313,18.45174,2143
5378,42250,4CC3058F56A42FB99DF66B1D4EA3395F,30771,15,18,3,109.49938,18.26042,1511
5379,42251,4CC3058F56A42FB99DF66B1D4EA3395F,60291,20,21,1,109.50826,18.24639,1509
5380,42252,4CC3058F56A42FB99DF66B1D4EA3395F,30421,21,23,2,109.50021,18.25861,1511
5381,42265,494A811FCF2737ED3FFA69BD83875999,38017,10,15,5,109.49729,18.21424,1504
5382,42266,494A811FCF2737ED3FFA69BD83875999,31261,16,17,1,109.51174,18.2466,1559
5383,42267,494A811FCF2737ED3FFA69BD83875999,38017,20,22,2,109.49729,18.21424,1504
5388,42298,40285EE8CCE25C38988EC087545664EC,31071,0,7,7,109.58257,18.28458,1815
5389,42299,40285EE8CCE25C38988EC087545664EC,30854,9,22,13,109.56889,18.27076,1763
5390,42322,41559587820EDAC647856A7555135196,30351,1,9,8,109.41701,18.29292,1217
5391,42323,41559587820EDAC647856A7555135196,60054,12,14,2,109.3016,18.31229,770
5392,42324,41559587820EDAC647856A7555135196,30351,14,23,9,109.41701,18.29292,1217
5393,42378,15C75AF46ECCD283F35270238206A211,31521,0,9,9,109.51458,18.22542,1555
5394,42379,15C75AF46ECCD283F35270238206A211,30341,9,11,2,109.3625,18.29167,966
5395,42380,15C75AF46ECCD283F35270238206A211,30661,12,14,2,109.37028,18.24361,1008
5396,42408,688D348A33B22EDABB9FBB91115A631A,31321,0,9,9,109.63799,18.23201,2007
5397,42409,688D348A33B22EDABB9FBB91115A631A,60054,13,14,1,109.3016,18.31229,770
5398,42410,688D348A33B22EDABB9FBB91115A631A,31321,16,23,7,109.63799,18.23201,2007
5399,42440,2B60907F04C29DE058B3E64B1D3B4100,31561,0,9,9,109.56792,18.28479,1765
5400,42441,2B60907F04C29DE058B3E64B1D3B4100,30854,10,13,3,109.56889,18.27076,1763
5401,42442,2B60907F04C29DE058B3E64B1D3B4100,31561,13,15,2,109.56792,18.28479,1765
5402,42443,2B60907F04C29DE058B3E64B1D3B4100,30854,16,22,6,109.56889,18.27076,1763
5403,42444,2B60907F04C29DE058B3E64B1D3B4100,31561,22,23,1,109.56792,18.28479,1765
5404,42455,8A19D38C67DEBBE2072401E23B2467C5,30191,18,19,1,109.50361,18.22701,1506
5405,42456,8A19D38C67DEBBE2072401E23B2467C5,31161,21,23,2,109.70229,18.31361,2270
5406,42461,FD5B9AB034F15F72E8BEF02193669238,60241,8,10,2,109.53319,18.28667,1616
5407,42462,FD5B9AB034F15F72E8BEF02193669238,31931,10,11,1,109.54771,18.29403,1667
5408,42463,FD5B9AB034F15F72E8BEF02193669238,60241,12,14,2,109.53319,18.28667,1616
5409,42464,FD5B9AB034F15F72E8BEF02193669238,31931,14,16,2,109.54771,18.29403,1667
5410,42465,FD5B9AB034F15F72E8BEF02193669238,60241,18,19,1,109.53319,18.28667,1616
5411,42483,E393AE4487D1B35F053473F2BB0639D8,60614,11,12,1,109.48799,18.29521,1467
5412,42484,E393AE4487D1B35F053473F2BB0639D8,31145,15,16,1,109.20431,18.30479,369
5413,42485,E393AE4487D1B35F053473F2BB0639D8,31861,19,20,1,109.49042,18.27549,1464
5414,42486,E393AE4487D1B35F053473F2BB0639D8,30391,21,22,1,109.4975,18.27118,1513
5415,42497,770024D3A15B5B9DACFBC750336F966D,30861,16,23,7,109.52722,18.22743,1606
5416,42504,04ABA8BFD5D63DDF1B83BA0577C9019C,31421,2,4,2,109.55382,18.22347,1705
5417,42505,04ABA8BFD5D63DDF1B83BA0577C9019C,39183,6,7,1,109.55542,18.28208,1715
5418,42541,AC0E940CA4876D60068799AC7DD06B30,31391,0,11,11,109.50382,18.24285,1508
5419,42542,AC0E940CA4876D60068799AC7DD06B30,30211,13,14,1,109.49882,18.23931,1508
5420,42543,AC0E940CA4876D60068799AC7DD06B30,38754,16,20,4,109.74667,18.37382,2430
5421,42544,AC0E940CA4876D60068799AC7DD06B30,31391,21,22,1,109.50382,18.24285,1508
5422,42551,5CFFF8D919E96524101209E188C669B3,31951,0,7,7,109.52174,18.30299,1568
5423,42552,5CFFF8D919E96524101209E188C669B3,31761,8,9,1,109.60521,18.27965,1914
5428,42569,B4D280332D4864EE44777CDB8551463D,31461,0,8,8,109.5091,18.25389,1510
5429,42570,B4D280332D4864EE44777CDB8551463D,31781,10,11,1,109.19847,18.2975,367
5430,42572,B4D280332D4864EE44777CDB8551463D,31461,20,23,3,109.5091,18.25389,1510
5431,42581,9D7F04124F972FD96F04746E3F4BE9E0,31781,12,13,1,109.19847,18.2975,367
5432,42582,9D7F04124F972FD96F04746E3F4BE9E0,31471,14,15,1,109.34583,18.29563,917
5433,42583,9D7F04124F972FD96F04746E3F4BE9E0,31671,18,19,1,109.38965,18.29813,1068
5434,42584,08A066736557478B1013C0CF834491DF,30921,0,7,7,109.53903,18.29451,1667
5435,42585,08A066736557478B1013C0CF834491DF,31931,10,23,13,109.54771,18.29403,1667
5436,42618,06540DDC6C869D24F26FD34ED45D168E,38325,1,10,9,109.39792,18.2909,1116
5437,42619,06540DDC6C869D24F26FD34ED45D168E,31145,12,14,2,109.20431,18.30479,369
5438,42620,06540DDC6C869D24F26FD34ED45D168E,30711,17,19,2,109.50271,18.25347,1510
5439,42624,95130D5AB1FAFE982946B601FB0CB133,60161,16,19,3,109.49174,18.26181,1461
5440,42625,95130D5AB1FAFE982946B601FB0CB133,60401,20,23,3,109.47444,18.27583,1414
5441,42631,E75CF54BA14775FEDD26504F9F6B7365,31561,15,17,2,109.56792,18.28479,1765
5442,42632,E75CF54BA14775FEDD26504F9F6B7365,30851,17,18,1,109.5616,18.27396,1713
5443,42633,E75CF54BA14775FEDD26504F9F6B7365,31945,20,21,1,109.58021,18.29403,1817
5444,42634,00FC332040A284DA251A8D0705989FE9,31071,1,13,12,109.58257,18.28458,1815
5445,42635,00FC332040A284DA251A8D0705989FE9,30854,14,15,1,109.56889,18.27076,1763
5446,42646,40EFEC8E77CE7DC1304A309568559076,38212,0,11,11,109.48889,18.26306,1462
5447,42647,40EFEC8E77CE7DC1304A309568559076,31471,12,15,3,109.34583,18.29563,917
5448,42648,40EFEC8E77CE7DC1304A309568559076,31471,17,18,1,109.34583,18.29563,917
5449,42649,40EFEC8E77CE7DC1304A309568559076,38271,20,21,1,109.62632,18.23049,1956
5450,42650,40EFEC8E77CE7DC1304A309568559076,31321,22,23,1,109.63799,18.23201,2007
5455,42674,60C76AD19DF8888A84F620E94C92FF2B,30571,8,12,4,109.50243,18.21861,1504
5456,42675,60C76AD19DF8888A84F620E94C92FF2B,60231,13,14,1,109.49903,18.21972,1504
5457,42676,60C76AD19DF8888A84F620E94C92FF2B,30571,15,23,8,109.50243,18.21861,1504
5458,42677,A9687DB826AE3C93D5CD961A912865D6,38094,0,7,7,109.45403,18.28778,1316
5459,42678,A9687DB826AE3C93D5CD961A912865D6,30661,10,11,1,109.37028,18.24361,1008
5460,42679,A9687DB826AE3C93D5CD961A912865D6,31471,15,16,1,109.34583,18.29563,917
5461,42680,A9687DB826AE3C93D5CD961A912865D6,31531,18,20,2,109.49583,18.25972,1461
5462,42681,A9687DB826AE3C93D5CD961A912865D6,38094,21,23,2,109.45403,18.28778,1316
5463,42704,4B14D70D67BD817E96B015ABCEF5D17B,38911,0,2,2,109.51674,18.24965,1559
5464,42705,4B14D70D67BD817E96B015ABCEF5D17B,31301,5,12,7,109.14493,18.31222,170
5465,42706,4B14D70D67BD817E96B015ABCEF5D17B,30381,13,16,3,109.52521,18.24507,1609
5466,42707,4B14D70D67BD817E96B015ABCEF5D17B,60281,18,23,5,109.51743,18.25924,1561
5467,42710,5169AE4C4AE9067320D7FAAA8A39A4BE,31511,0,8,8,109.26326,18.40521,635
5468,42712,5169AE4C4AE9067320D7FAAA8A39A4BE,31511,17,23,6,109.26326,18.40521,635
5469,42735,7C53E1516813111F7584C70DC82C3E1E,31031,0,9,9,109.49979,18.25382,1510
5470,42736,7C53E1516813111F7584C70DC82C3E1E,39021,10,13,3,109.40368,18.41035,1186
5471,42737,7C53E1516813111F7584C70DC82C3E1E,31031,15,17,2,109.49979,18.25382,1510
5472,42738,7C53E1516813111F7584C70DC82C3E1E,31201,18,19,1,109.51042,18.23819,1558
5473,42739,7C53E1516813111F7584C70DC82C3E1E,30711,21,23,2,109.50271,18.25347,1510
5474,42745,F6CCF646674665C449464A30D23BCEEF,30271,0,16,16,109.49132,18.23153,1456
5475,42746,F6CCF646674665C449464A30D23BCEEF,38251,17,18,1,109.49618,18.25493,1510
5482,42835,63DE0122FF7AF14798CDE9006100D774,38754,15,17,2,109.74667,18.37382,2430
5483,42836,63DE0122FF7AF14798CDE9006100D774,38484,18,19,1,109.53028,18.31528,1620
5484,42837,63DE0122FF7AF14798CDE9006100D774,38821,20,23,3,109.50354,18.25243,1510
5488,42905,B34415F599F0ED7D1A073EE314A60B9B,31671,0,10,10,109.38965,18.29813,1068
5489,42906,B34415F599F0ED7D1A073EE314A60B9B,60041,10,12,2,109.39889,18.31944,1121
5490,42907,B34415F599F0ED7D1A073EE314A60B9B,60541,12,13,1,109.4084,18.29208,1167
5491,42908,B34415F599F0ED7D1A073EE314A60B9B,31671,16,18,2,109.38965,18.29813,1068
5492,42909,B34415F599F0ED7D1A073EE314A60B9B,60041,19,22,3,109.39889,18.31944,1121
5497,42937,545A608945D9F6A83833DD1074D20FCD,31471,14,16,2,109.34583,18.29563,917
5498,42938,545A608945D9F6A83833DD1074D20FCD,30854,19,20,1,109.56889,18.27076,1763
5506,42982,248CE0B148D688C343222BB27AEE2380,31071,1,5,4,109.58257,18.28458,1815
5507,42983,248CE0B148D688C343222BB27AEE2380,30854,9,19,10,109.56889,18.27076,1763
5508,43004,F113DDC78FC5471ED8A23532B5EF78E0,30181,0,10,10,109.51597,18.23313,1557
5509,43005,F113DDC78FC5471ED8A23532B5EF78E0,31031,10,11,1,109.49979,18.25382,1510
5510,43006,F113DDC78FC5471ED8A23532B5EF78E0,30181,12,19,7,109.51597,18.23313,1557
5511,43007,F113DDC78FC5471ED8A23532B5EF78E0,31521,19,20,1,109.51458,18.22542,1555
5512,43008,F113DDC78FC5471ED8A23532B5EF78E0,30181,22,23,1,109.51597,18.23313,1557
5513,43039,D7F545CDB740917BC3BFA2B57C1003E1,60011,14,18,4,109.48965,18.30222,1468
5514,43040,D7F545CDB740917BC3BFA2B57C1003E1,60031,19,20,1,109.49694,18.31632,1521
5515,43047,44BEBA2727205520AE9AF3AB76A75967,38871,1,2,1,109.44681,18.28625,1316
5516,43048,44BEBA2727205520AE9AF3AB76A75967,31231,2,9,7,109.42597,18.29292,1217
5517,43049,44BEBA2727205520AE9AF3AB76A75967,30361,12,23,11,109.50347,18.24,1508
5518,43053,A71E0E95457402DD3D59C9873DD44764,31471,17,19,2,109.34583,18.29563,917
5519,43054,A71E0E95457402DD3D59C9873DD44764,31691,19,22,3,109.36604,18.3075,1019
5520,43064,9C7BAF149C969E12C7E00E6FCA4D0F9D,31321,0,3,3,109.63799,18.23201,2007
5521,43065,9C7BAF149C969E12C7E00E6FCA4D0F9D,30581,6,8,2,109.62257,18.24951,1959
5522,43066,9C7BAF149C969E12C7E00E6FCA4D0F9D,31321,9,12,3,109.63799,18.23201,2007
5523,43067,9C7BAF149C969E12C7E00E6FCA4D0F9D,30671,14,21,7,109.43611,18.30139,1268
5524,43084,79552C9BA7D6D0482C348613B3829C6B,39151,1,2,1,109.49875,18.25097,1510
5525,43085,79552C9BA7D6D0482C348613B3829C6B,31181,5,23,18,109.50382,18.24813,1509
5526,43151,F40E3F81DC1CBEED8C7FE1B2171B6EA7,31031,11,12,1,109.49979,18.25382,1510
5527,43210,D622AAD01DD5982861A246970AE90D47,39111,20,22,2,109.5191,18.22597,1555
5528,43211,7094512B15E4EF60EF67A3E6DEAF677A,60594,0,6,6,109.62694,18.22799,1956
5529,43212,7094512B15E4EF60EF67A3E6DEAF677A,38052,8,9,1,109.62618,18.23042,1956
5530,43213,7094512B15E4EF60EF67A3E6DEAF677A,33051,12,14,2,109.6475,18.46618,2096
5531,43214,7094512B15E4EF60EF67A3E6DEAF677A,38052,15,20,5,109.62618,18.23042,1956
5532,43215,7094512B15E4EF60EF67A3E6DEAF677A,60594,20,23,3,109.62694,18.22799,1956
5536,43261,38CF8AD578A393476F29705A4599B8B1,38891,0,10,10,109.51486,18.24118,1558
5537,43262,38CF8AD578A393476F29705A4599B8B1,31321,11,12,1,109.63799,18.23201,2007
5538,43263,38CF8AD578A393476F29705A4599B8B1,31571,12,14,2,109.61563,18.23326,1957
5539,43264,38CF8AD578A393476F29705A4599B8B1,60211,14,16,2,109.63549,18.26049,2011
5540,43312,0AE94CE0906371E5C953A3B589C7696A,60524,0,9,9,109.42951,18.28993,1216
5541,43313,0AE94CE0906371E5C953A3B589C7696A,31471,11,13,2,109.34583,18.29563,917
5542,43314,0AE94CE0906371E5C953A3B589C7696A,60054,14,15,1,109.3016,18.31229,770
5543,43315,0AE94CE0906371E5C953A3B589C7696A,38683,19,23,4,109.4266,18.29097,1216
5544,43378,14F1CC63CDA098F9694EAC8584B9C7A5,31561,0,13,13,109.56792,18.28479,1765
5545,43379,14F1CC63CDA098F9694EAC8584B9C7A5,30854,14,15,1,109.56889,18.27076,1763
5546,43405,1BC010F6BA936B1BC6461BB11F6A6D07,31181,13,15,2,109.50382,18.24813,1509
5547,43406,1BC010F6BA936B1BC6461BB11F6A6D07,60291,15,17,2,109.50826,18.24639,1509
5548,43407,1BC010F6BA936B1BC6461BB11F6A6D07,31321,18,19,1,109.63799,18.23201,2007
5549,43408,1BC010F6BA936B1BC6461BB11F6A6D07,60211,20,22,2,109.63549,18.26049,2011
5550,43472,1D8B814EC83D52D7C5F3FED99C129EE0,60631,2,3,1,109.57778,18.27583,1814
5551,43473,1D8B814EC83D52D7C5F3FED99C129EE0,30854,4,9,5,109.56889,18.27076,1763
5552,43474,1D8B814EC83D52D7C5F3FED99C129EE0,38271,10,20,10,109.62632,18.23049,1956
5553,43519,2EE87E32F61D076A80AF4573D60352AD,38951,13,17,4,109.48097,18.28868,1416
5554,43520,2EE87E32F61D076A80AF4573D60352AD,38951,20,21,1,109.48097,18.28868,1416
5555,43521,2EE87E32F61D076A80AF4573D60352AD,38951,21,23,2,109.48097,18.28868,1416
5562,43682,18AAFF817ACB01445A8E56AB6C7AC8DB,38951,18,22,4,109.48097,18.28868,1416
5563,43688,94C6B6D07606799F9DD78C376ADCB85C,60281,0,5,5,109.51743,18.25924,1561
5564,43689,94C6B6D07606799F9DD78C376ADCB85C,30151,7,8,1,109.50986,18.25083,1560
5565,43690,94C6B6D07606799F9DD78C376ADCB85C,60201,8,10,2,109.5041,18.2509,1510
5566,43691,94C6B6D07606799F9DD78C376ADCB85C,38911,11,13,2,109.51674,18.24965,1559
5567,43692,94C6B6D07606799F9DD78C376ADCB85C,60281,14,18,4,109.51743,18.25924,1561
5568,43693,94C6B6D07606799F9DD78C376ADCB85C,38061,19,20,1,109.50597,18.23118,1506
5569,43694,94C6B6D07606799F9DD78C376ADCB85C,30361,20,21,1,109.50347,18.24,1508
5570,43702,2D115D52FDAB55086A12D742071FDFC9,30232,0,10,10,109.6191,18.31701,1971
5571,43703,2D115D52FDAB55086A12D742071FDFC9,30854,12,16,4,109.56889,18.27076,1763
5572,43704,2D115D52FDAB55086A12D742071FDFC9,30232,17,19,2,109.6191,18.31701,1971
5573,43705,2D115D52FDAB55086A12D742071FDFC9,30854,20,22,2,109.56889,18.27076,1763
5574,43711,FD99026B657D830B20F9D76D7C087CF9,38094,0,8,8,109.45403,18.28778,1316
5575,43712,FD99026B657D830B20F9D76D7C087CF9,60381,11,13,2,109.5241,18.22458,1605
5576,43713,FD99026B657D830B20F9D76D7C087CF9,38094,14,17,3,109.45403,18.28778,1316
5577,43714,FD99026B657D830B20F9D76D7C087CF9,31031,18,21,3,109.49979,18.25382,1510
5578,43715,FD99026B657D830B20F9D76D7C087CF9,38094,21,23,2,109.45403,18.28778,1316
5579,43730,CD576E44D9D4928B8C41CE5BA0D78E9B,31931,12,16,4,109.54771,18.29403,1667
5580,43731,CD576E44D9D4928B8C41CE5BA0D78E9B,39181,18,23,5,109.55153,18.28035,1715
5581,43750,850F414E89CB3AC3E862CBFA17778006,30571,0,10,10,109.50243,18.21861,1504
5582,43751,850F414E89CB3AC3E862CBFA17778006,31521,11,12,1,109.51458,18.22542,1555
5583,43752,850F414E89CB3AC3E862CBFA17778006,60041,16,23,7,109.39889,18.31944,1121
5584,43771,452F0FF6BC36839041DCBEF2292D6E55,38127,0,10,10,109.50833,18.27222,1513
5585,43772,452F0FF6BC36839041DCBEF2292D6E55,38157,11,15,4,109.51483,18.26958,1563
5586,43773,452F0FF6BC36839041DCBEF2292D6E55,30361,16,18,2,109.50347,18.24,1508
5587,43774,452F0FF6BC36839041DCBEF2292D6E55,38251,18,19,1,109.49618,18.25493,1510
5588,43775,452F0FF6BC36839041DCBEF2292D6E55,38127,22,23,1,109.50833,18.27222,1513
5589,43788,5D8CEDE1DBBC134D191D1BBEC2BD5BCD,60524,0,7,7,109.42951,18.28993,1216
5590,43798,23019CE071DC0B0CEC6E78ADA422CE57,38973,0,13,13,109.51097,18.25389,1560
5591,43799,23019CE071DC0B0CEC6E78ADA422CE57,38754,14,16,2,109.74667,18.37382,2430
5592,43800,23019CE071DC0B0CEC6E78ADA422CE57,31391,19,20,1,109.50382,18.24285,1508
5593,43801,23019CE071DC0B0CEC6E78ADA422CE57,30151,21,23,2,109.50986,18.25083,1560
5594,43802,C462628FF36F8FF2D0B7493E6DDA38BB,30661,2,8,6,109.37028,18.24361,1008
5595,43803,C462628FF36F8FF2D0B7493E6DDA38BB,60411,8,9,1,109.32514,18.30854,869
5596,43804,C462628FF36F8FF2D0B7493E6DDA38BB,30661,10,19,9,109.37028,18.24361,1008
5597,43805,C462628FF36F8FF2D0B7493E6DDA38BB,60411,21,23,2,109.32514,18.30854,869
5598,43809,B7ADBAC4A77BC50F432A788B21FD4A34,31431,10,15,5,109.44639,18.29042,1316
5599,43810,B7ADBAC4A77BC50F432A788B21FD4A34,60381,16,19,3,109.5241,18.22458,1605
5600,43825,B29F33564DDA3CFA905BF42633BA4302,31205,0,1,1,109.51111,18.23736,1557
5601,43826,B29F33564DDA3CFA905BF42633BA4302,60614,3,13,10,109.48799,18.29521,1467
5602,43827,B29F33564DDA3CFA905BF42633BA4302,60291,14,16,2,109.50826,18.24639,1509
5603,43828,B29F33564DDA3CFA905BF42633BA4302,60411,18,23,5,109.32514,18.30854,869
5604,43850,6A96BADFE00274340CC18F957A412DF2,30421,13,16,3,109.50021,18.25861,1511
5605,43853,F8D799D9161B0143E0D71C40472A357E,30071,0,16,16,109.52819,18.30472,1619
5606,43854,F8D799D9161B0143E0D71C40472A357E,30711,18,20,2,109.50271,18.25347,1510
5607,43855,F8D799D9161B0143E0D71C40472A357E,30071,22,23,1,109.52819,18.30472,1619
5611,43861,4BA42026831E7F4B42D17FDF4BDEE62E,31931,1,8,7,109.54771,18.29403,1667
5612,43862,4BA42026831E7F4B42D17FDF4BDEE62E,39181,8,10,2,109.55153,18.28035,1715
5613,43863,4BA42026831E7F4B42D17FDF4BDEE62E,31931,13,15,2,109.54771,18.29403,1667
5614,43864,4BA42026831E7F4B42D17FDF4BDEE62E,39181,16,18,2,109.55153,18.28035,1715
5615,43865,4BA42026831E7F4B42D17FDF4BDEE62E,38315,19,21,2,109.48979,18.29764,1467
5616,43870,8BDE8C6966F9C7122ABA59EA6C195945,31171,18,19,1,109.50938,18.24917,1559
5617,43871,8BDE8C6966F9C7122ABA59EA6C195945,31081,20,23,3,109.44639,18.30181,1318
5618,43901,4DB51FB607DF400B9FA557F761A7BFBF,31311,10,16,6,109.72299,18.27438,2364
5619,43902,4DB51FB607DF400B9FA557F761A7BFBF,38391,20,23,3,109.44111,18.29083,1266
5624,43915,5C9B70CEEA6B4F63E437274BF151DF2C,31471,15,17,2,109.34583,18.29563,917
5625,43916,5C9B70CEEA6B4F63E437274BF151DF2C,39111,19,23,4,109.5191,18.22597,1555
5629,43936,F31EF896F79B80EE579B410C7A108E36,38251,0,8,8,109.49618,18.25493,1510
5630,43937,F31EF896F79B80EE579B410C7A108E36,31031,12,14,2,109.49979,18.25382,1510
5631,43938,F31EF896F79B80EE579B410C7A108E36,30351,14,16,2,109.41701,18.29292,1217
5632,43939,E9CDFE5A4E319AABCB1BB5066094528A,60084,1,3,2,109.4984,18.2334,1507
5633,43940,E9CDFE5A4E319AABCB1BB5066094528A,30271,4,7,3,109.49132,18.23153,1456
5634,43949,ADA7B055F17CD683C10482B3BCB22A75,60491,1,3,2,109.43354,18.30847,1269
5635,43950,ADA7B055F17CD683C10482B3BCB22A75,31081,4,6,2,109.44639,18.30181,1318
5636,43972,E6651E3C6D8FEA2077D9EFC6D097D06C,38251,0,14,14,109.49618,18.25493,1510
5637,43973,E6651E3C6D8FEA2077D9EFC6D097D06C,31031,17,21,4,109.49979,18.25382,1510
5642,43980,6A5315660D9B469BEC66B2E434056CB6,31471,16,17,1,109.34583,18.29563,917
5643,43981,6A5315660D9B469BEC66B2E434056CB6,60381,20,22,2,109.5241,18.22458,1605
5644,43985,24E94C322C21864A44D8B04F37BB2EEC,31271,0,10,10,109.48958,18.26257,1462
5645,43986,24E94C322C21864A44D8B04F37BB2EEC,60054,14,15,1,109.3016,18.31229,770
5646,43987,24E94C322C21864A44D8B04F37BB2EEC,31471,16,17,1,109.34583,18.29563,917
5647,43988,24E94C322C21864A44D8B04F37BB2EEC,30891,21,23,2,109.59431,18.28389,1865
5648,44030,D0397702CD04E389C6CD3782DE9B02F8,38157,0,10,10,109.51483,18.26958,1563
5649,44031,D0397702CD04E389C6CD3782DE9B02F8,31521,12,16,4,109.51458,18.22542,1555
5650,44032,D0397702CD04E389C6CD3782DE9B02F8,60381,16,18,2,109.5241,18.22458,1605
5651,44033,D0397702CD04E389C6CD3782DE9B02F8,31061,19,20,1,109.53333,18.23257,1607
5652,44034,D0397702CD04E389C6CD3782DE9B02F8,38911,22,23,1,109.51674,18.24965,1559
5653,44040,AAC7E9546787DDB508C41969C1E453E7,39154,0,12,12,109.50201,18.25681,1511
5654,44041,AAC7E9546787DDB508C41969C1E453E7,31561,13,15,2,109.56792,18.28479,1765
5655,44042,AAC7E9546787DDB508C41969C1E453E7,60114,16,18,2,109.73028,18.33847,2374
5656,44043,AAC7E9546787DDB508C41969C1E453E7,30421,20,23,3,109.50021,18.25861,1511
5657,44049,3AA728046A24C765839BE31583DC1011,39101,11,12,1,109.50132,18.24931,1509
5658,44050,3AA728046A24C765839BE31583DC1011,31471,14,16,2,109.34583,18.29563,917
5659,44051,3AA728046A24C765839BE31583DC1011,39091,18,22,4,109.50097,18.25222,1510
5660,44067,2115670ECBCEFE4CA16C55F5204DF607,31071,0,7,7,109.58257,18.28458,1815
5661,44068,2115670ECBCEFE4CA16C55F5204DF607,30854,9,20,11,109.56889,18.27076,1763
5662,44078,AF4FF2394625B3300738BCD880272864,30581,10,11,1,109.62257,18.24951,1959
5663,44079,AF4FF2394625B3300738BCD880272864,33354,12,15,3,109.67465,18.44583,2192
5664,44080,AF4FF2394625B3300738BCD880272864,33051,15,16,1,109.6475,18.46618,2096
5665,44086,9BF33DB1F7AC1D27E06AF501C14CCF2C,39181,18,21,3,109.55153,18.28035,1715
5666,44087,9BF33DB1F7AC1D27E06AF501C14CCF2C,31931,22,23,1,109.54771,18.29403,1667
5670,44107,E649CF84A26278291AA1A5B5C5D01FCA,30854,0,3,3,109.56889,18.27076,1763
5671,44108,E649CF84A26278291AA1A5B5C5D01FCA,31561,7,9,2,109.56792,18.28479,1765
5672,44109,E649CF84A26278291AA1A5B5C5D01FCA,30854,9,11,2,109.56889,18.27076,1763
5673,44110,E649CF84A26278291AA1A5B5C5D01FCA,31561,11,12,1,109.56792,18.28479,1765
5674,44111,E649CF84A26278291AA1A5B5C5D01FCA,30161,17,18,1,109.50042,18.24389,1508
5675,44112,E649CF84A26278291AA1A5B5C5D01FCA,30854,19,20,1,109.56889,18.27076,1763
5676,44113,E649CF84A26278291AA1A5B5C5D01FCA,31561,22,23,1,109.56792,18.28479,1765
5677,44114,5AE620030CD6D52CC29C82349F95610D,38111,0,9,9,109.52007,18.22403,1555
5678,44115,5AE620030CD6D52CC29C82349F95610D,31221,13,15,2,109.61333,18.26833,1913
5679,44116,5AE620030CD6D52CC29C82349F95610D,31521,16,19,3,109.51458,18.22542,1555
5680,44117,6C44DD6A334FD8F5ED58CBD00D571465,31521,0,8,8,109.51458,18.22542,1555
5681,44118,6C44DD6A334FD8F5ED58CBD00D571465,31145,12,13,1,109.20431,18.30479,369
5682,44119,6C44DD6A334FD8F5ED58CBD00D571465,31471,16,18,2,109.34583,18.29563,917
5686,44205,6C0260646767B781577B5B8CE2471E51,38484,1,2,1,109.53028,18.31528,1620
5687,44206,6C0260646767B781577B5B8CE2471E51,60614,3,4,1,109.48799,18.29521,1467
5688,44207,6C0260646767B781577B5B8CE2471E51,38484,5,16,11,109.53028,18.31528,1620
5689,44208,6C0260646767B781577B5B8CE2471E51,30321,17,18,1,109.49563,18.29611,1467
5690,44209,6C0260646767B781577B5B8CE2471E51,38484,19,21,2,109.53028,18.31528,1620
5695,44249,52626520133C58C019E9712FB19D3224,31301,15,16,1,109.14493,18.31222,170
5696,44250,52626520133C58C019E9712FB19D3224,30271,19,20,1,109.49132,18.23153,1456
5697,44251,52626520133C58C019E9712FB19D3224,38171,22,23,1,109.50799,18.28139,1515
5705,44316,63B5E489F3503F8EC6E40A38F9D2117C,60171,9,18,9,109.51292,18.30694,1569
5706,44317,63B5E489F3503F8EC6E40A38F9D2117C,60361,21,23,2,109.51938,18.29681,1567
5707,44342,E25E879CAFC04F12992F409DED32F7E4,60011,19,20,1,109.48965,18.30222,1468
5708,44343,E25E879CAFC04F12992F409DED32F7E4,38291,21,22,1,109.51618,18.24313,1558
5709,44345,A59893CF63A9A48BE0D9E2ED611A9BB2,30721,11,12,1,109.51597,18.28257,1565
5716,44381,FF811E88FEA9CBDF12E5CC54DEE7CCA1,30232,0,5,5,109.6191,18.31701,1971
5717,44382,FF811E88FEA9CBDF12E5CC54DEE7CCA1,30854,10,11,1,109.56889,18.27076,1763
5718,44383,781955161DE29ECF49F0988D5A8412EF,31471,16,17,1,109.34583,18.29563,917
5719,44384,781955161DE29ECF49F0988D5A8412EF,38951,19,20,1,109.48097,18.28868,1416
5720,44385,781955161DE29ECF49F0988D5A8412EF,38951,21,23,2,109.48097,18.28868,1416
5721,44410,8AABF5FDF2B06EB445749240A3894969,31071,0,1,1,109.58257,18.28458,1815
5722,44411,8AABF5FDF2B06EB445749240A3894969,30854,2,22,20,109.56889,18.27076,1763
5723,44426,59972224BAF878DB2B5AD7A1D50178FC,31145,14,15,1,109.20431,18.30479,369
5724,44427,59972224BAF878DB2B5AD7A1D50178FC,31471,16,17,1,109.34583,18.29563,917
5725,44428,59972224BAF878DB2B5AD7A1D50178FC,30854,20,22,2,109.56889,18.27076,1763
5726,44460,F315998EC48289C5B7879B7FA5033861,31461,0,14,14,109.5091,18.25389,1510
5727,44461,F315998EC48289C5B7879B7FA5033861,38127,14,16,2,109.50833,18.27222,1513
5728,44474,1EC959553638CEC3C2D1606E92235CDE,39111,0,1,1,109.5191,18.22597,1555
5729,44475,1EC959553638CEC3C2D1606E92235CDE,30854,1,2,1,109.56889,18.27076,1763
5730,44476,1EC959553638CEC3C2D1606E92235CDE,31945,5,6,1,109.58021,18.29403,1817
5731,44477,1EC959553638CEC3C2D1606E92235CDE,30854,10,18,8,109.56889,18.27076,1763
5732,44478,1EC959553638CEC3C2D1606E92235CDE,31421,19,20,1,109.55382,18.22347,1705
5737,44494,0FD89E239CD1BF14C1ED19615717BC0E,31471,14,16,2,109.34583,18.29563,917
5738,44495,0FD89E239CD1BF14C1ED19615717BC0E,31521,18,23,5,109.51458,18.22542,1555
5746,44557,2B8147CA8BF08978004DA378A0F33355,30854,0,4,4,109.56889,18.27076,1763
5747,44558,2B8147CA8BF08978004DA378A0F33355,31031,8,9,1,109.49979,18.25382,1510
5748,44559,2B8147CA8BF08978004DA378A0F33355,31781,13,14,1,109.19847,18.2975,367
5749,44563,CA373FFAFD7EFAD5EEFC32965095EB00,30821,16,18,2,109.43681,18.33639,1274
5750,44564,CA373FFAFD7EFAD5EEFC32965095EB00,60201,21,22,1,109.5041,18.2509,1510
5751,44565,CA373FFAFD7EFAD5EEFC32965095EB00,38251,22,23,1,109.49618,18.25493,1510
5755,44586,DA576E66EB047CDA32DD08419727A116,39183,0,5,5,109.55542,18.28208,1715
5756,44587,DA576E66EB047CDA32DD08419727A116,30851,5,8,3,109.5616,18.27396,1713
5757,44588,DA576E66EB047CDA32DD08419727A116,31421,9,12,3,109.55382,18.22347,1705
5758,44610,5F14E1A15EFA1C13F8B10CBC543F107C,31701,0,14,14,109.44132,18.28833,1266
5759,44611,5F14E1A15EFA1C13F8B10CBC543F107C,60241,18,20,2,109.53319,18.28667,1616
5760,44645,5A612FD41D5C59DA1534F33EB272F1CE,30854,0,13,13,109.56889,18.27076,1763
5761,44646,5A612FD41D5C59DA1534F33EB272F1CE,60591,15,17,2,109.61118,18.21715,1904
5762,44647,5A612FD41D5C59DA1534F33EB272F1CE,30854,19,20,1,109.56889,18.27076,1763
5763,44648,5A612FD41D5C59DA1534F33EB272F1CE,31071,21,23,2,109.58257,18.28458,1815
5764,44671,7C16827D646BDC874DE2BD7EE32189C5,30854,9,11,2,109.56889,18.27076,1763
5765,44672,7C16827D646BDC874DE2BD7EE32189C5,60631,12,13,1,109.57778,18.27583,1814
5766,44673,7C16827D646BDC874DE2BD7EE32189C5,60241,16,18,2,109.53319,18.28667,1616
5767,44678,5D4710E685AEDA29FE14D10D51B03621,33051,14,15,1,109.6475,18.46618,2096
5768,44679,5D4710E685AEDA29FE14D10D51B03621,30051,20,23,3,109.48917,18.21215,1453
5769,44778,CEB7EA5D037E7DFD2A157DEECC6ACC53,31541,21,22,1,109.1809,18.36722,329
5770,44783,1933B3069C81BAD64390BF81190C399E,38127,0,11,11,109.50833,18.27222,1513
5771,44784,1933B3069C81BAD64390BF81190C399E,31471,15,17,2,109.34583,18.29563,917
5772,44785,1933B3069C81BAD64390BF81190C399E,60541,20,21,1,109.4084,18.29208,1167
5773,44789,D12944CE5296653EC6E6CC8C30E0E8A0,60111,18,20,2,109.72556,18.31924,2371
5774,44790,D12944CE5296653EC6E6CC8C30E0E8A0,38961,21,22,1,109.50847,18.23514,1507
5775,44791,D56A67341D1DA856D04BC2181FD404FB,60541,0,1,1,109.4084,18.29208,1167
5776,44792,D56A67341D1DA856D04BC2181FD404FB,31231,3,7,4,109.42597,18.29292,1217
5777,44793,D56A67341D1DA856D04BC2181FD404FB,60541,9,11,2,109.4084,18.29208,1167
5778,44794,D56A67341D1DA856D04BC2181FD404FB,30351,16,17,1,109.41701,18.29292,1217
5779,44795,D56A67341D1DA856D04BC2181FD404FB,60552,17,19,2,109.41729,18.30014,1218
5780,44796,D56A67341D1DA856D04BC2181FD404FB,60541,21,23,2,109.4084,18.29208,1167
5781,44837,E4C7AB656E412C7E33554D18277C9478,60291,14,16,2,109.50826,18.24639,1509
5782,44838,E4C7AB656E412C7E33554D18277C9478,30511,20,22,2,109.51069,18.24208,1558
5783,44862,707F435BF102979FBACE7253981A53B6,30171,1,10,9,109.48458,18.27139,1463
5784,44863,707F435BF102979FBACE7253981A53B6,30421,11,13,2,109.50021,18.25861,1511
5785,44864,707F435BF102979FBACE7253981A53B6,60054,15,16,1,109.3016,18.31229,770
5786,44865,707F435BF102979FBACE7253981A53B6,30171,19,22,3,109.48458,18.27139,1463
5787,44905,66F0C63A2BC847E16C97B2AD6644B4E6,31021,0,11,11,109.49021,18.27,1463
5788,44906,66F0C63A2BC847E16C97B2AD6644B4E6,30341,12,18,6,109.3625,18.29167,966
5789,44941,83B8326C5AE775F9B6383CC3A8412C48,60071,9,10,1,109.75674,18.31583,2470
5790,44942,83B8326C5AE775F9B6383CC3A8412C48,31301,13,15,2,109.14493,18.31222,170
5791,44943,83B8326C5AE775F9B6383CC3A8412C48,31471,16,17,1,109.34583,18.29563,917
5792,44944,83B8326C5AE775F9B6383CC3A8412C48,38951,18,23,5,109.48097,18.28868,1416
5797,44954,B1040167F22A61DD40A5E55E00271607,31351,0,6,6,109.4959,18.28417,1465
5798,44955,B1040167F22A61DD40A5E55E00271607,31301,8,19,11,109.14493,18.31222,170
5799,44956,B1040167F22A61DD40A5E55E00271607,30084,21,23,2,109.50118,18.26972,1513
5803,44994,599A4CAA28C4A41DBB6851A8D7648BC9,30171,0,1,1,109.48458,18.27139,1463
5804,44995,599A4CAA28C4A41DBB6851A8D7648BC9,38871,2,6,4,109.44681,18.28625,1316
5805,44996,599A4CAA28C4A41DBB6851A8D7648BC9,30171,7,10,3,109.48458,18.27139,1463
5806,44997,599A4CAA28C4A41DBB6851A8D7648BC9,30571,12,15,3,109.50243,18.21861,1504
5807,45038,39CA4FE8290F03A5AE8EA1D8371B2A6D,30121,0,7,7,109.52861,18.27222,1613
5808,45040,39CA4FE8290F03A5AE8EA1D8371B2A6D,30121,18,23,5,109.52861,18.27222,1613
5809,45061,3BF3A82A70A93B4B71D52AA73CE29D00,38251,0,9,9,109.49618,18.25493,1510
5810,45062,3BF3A82A70A93B4B71D52AA73CE29D00,31471,12,13,1,109.34583,18.29563,917
5811,45063,3BF3A82A70A93B4B71D52AA73CE29D00,30341,15,17,2,109.3625,18.29167,966
5812,45091,4D4289AE0DFBF4B5C79A47559DC2EBDD,30854,0,10,10,109.56889,18.27076,1763
5813,45092,4D4289AE0DFBF4B5C79A47559DC2EBDD,30861,14,21,7,109.52722,18.22743,1606
5820,45165,0B67294FA9DBD53325D63EA36C1B8784,31231,0,11,11,109.42597,18.29292,1217
5821,45166,0B67294FA9DBD53325D63EA36C1B8784,31145,13,16,3,109.20431,18.30479,369
5822,45235,7E95AEA91A37473FF71C625BDD54FD92,60226,0,1,1,109.5175,18.28778,1566
5823,45236,7E95AEA91A37473FF71C625BDD54FD92,60361,3,9,6,109.51938,18.29681,1567
5824,45237,7E95AEA91A37473FF71C625BDD54FD92,38154,10,11,1,109.5266,18.28278,1615
5825,45238,7E95AEA91A37473FF71C625BDD54FD92,60361,15,16,1,109.51938,18.29681,1567
5826,45239,7E95AEA91A37473FF71C625BDD54FD92,60226,17,18,1,109.5175,18.28778,1566
5827,45240,7E95AEA91A37473FF71C625BDD54FD92,60241,18,20,2,109.53319,18.28667,1616
5828,45241,7E95AEA91A37473FF71C625BDD54FD92,60361,20,23,3,109.51938,18.29681,1567
5829,45254,35E2175E021CD04E6CF0361F38962323,31531,11,12,1,109.49583,18.25972,1461
5830,45255,35E2175E021CD04E6CF0361F38962323,31473,13,15,2,109.34792,18.29465,917
5831,45282,066CC6CBB5ADF978A93AF5D0C3292806,30071,0,6,6,109.52819,18.30472,1619
5832,45283,066CC6CBB5ADF978A93AF5D0C3292806,31931,9,10,1,109.54771,18.29403,1667
5833,45284,066CC6CBB5ADF978A93AF5D0C3292806,60211,13,16,3,109.63549,18.26049,2011
5834,45285,066CC6CBB5ADF978A93AF5D0C3292806,39321,19,21,2,109.529,18.2167,1604
5835,45311,AAFE4E0B4B6AE737025ABC3F9BE70797,31781,15,17,2,109.19847,18.2975,367
5836,45312,AAFE4E0B4B6AE737025ABC3F9BE70797,31701,18,21,3,109.44132,18.28833,1266
5837,45313,AAFE4E0B4B6AE737025ABC3F9BE70797,60524,22,23,1,109.42951,18.28993,1216
5838,45352,967DC30377CC6C2FF7663D7FEE1391C0,31473,16,18,2,109.34792,18.29465,917
5839,45353,967DC30377CC6C2FF7663D7FEE1391C0,30101,20,23,3,109.57299,18.33333,1773
5848,45454,926FBA523DAEDABC03774AE3ED899479,38127,0,14,14,109.50833,18.27222,1513
5849,45455,926FBA523DAEDABC03774AE3ED899479,30281,19,20,1,109.50597,18.27583,1514
5850,45470,551995058BB73CF3CAA268CB90FD9FE2,38251,18,20,2,109.49618,18.25493,1510
5851,45471,551995058BB73CF3CAA268CB90FD9FE2,30421,20,21,1,109.50021,18.25861,1511
5855,45506,E992E0166BE08FEB8B592A9E59B112AB,31471,13,15,2,109.34583,18.29563,917
5856,45507,E992E0166BE08FEB8B592A9E59B112AB,31534,20,23,3,109.49368,18.25806,1461
5860,45530,E154399B1350F1CD6894DBAC16833152,38331,7,9,2,109.62465,18.22736,1956
5861,45531,E154399B1350F1CD6894DBAC16833152,38754,10,11,1,109.74667,18.37382,2430
5862,45532,E154399B1350F1CD6894DBAC16833152,38331,13,16,3,109.62465,18.22736,1956
5863,45533,E154399B1350F1CD6894DBAC16833152,60231,18,20,2,109.49903,18.21972,1504
5868,45600,104D50A9C0319F25E132948E6191A1E5,30211,1,2,1,109.49882,18.23931,1508
5869,45601,104D50A9C0319F25E132948E6191A1E5,60161,6,8,2,109.49174,18.26181,1461
5870,45602,104D50A9C0319F25E132948E6191A1E5,30271,13,14,1,109.49132,18.23153,1456
5871,45603,104D50A9C0319F25E132948E6191A1E5,30211,14,16,2,109.49882,18.23931,1508
5872,45604,104D50A9C0319F25E132948E6191A1E5,30271,17,18,1,109.49132,18.23153,1456
5873,45605,104D50A9C0319F25E132948E6191A1E5,60084,18,20,2,109.4984,18.2334,1507
5877,45614,D54FF92D90E0CD41A304344578DE281C,60541,0,6,6,109.4084,18.29208,1167
5878,45615,D54FF92D90E0CD41A304344578DE281C,31681,7,8,1,109.40396,18.29979,1168
5879,45616,D54FF92D90E0CD41A304344578DE281C,33051,10,12,2,109.6475,18.46618,2096
5880,45617,D54FF92D90E0CD41A304344578DE281C,33481,13,15,2,109.67278,18.41278,2187
5881,45618,D54FF92D90E0CD41A304344578DE281C,60381,16,18,2,109.5241,18.22458,1605
5882,45619,D54FF92D90E0CD41A304344578DE281C,60541,20,23,3,109.4084,18.29208,1167
5883,45660,F15BD9A44406D60DBAB181C797D514C7,31031,0,8,8,109.49979,18.25382,1510
5884,45661,F15BD9A44406D60DBAB181C797D514C7,31781,11,13,2,109.19847,18.2975,367
5885,45662,F15BD9A44406D60DBAB181C797D514C7,31031,15,22,7,109.49979,18.25382,1510
5886,45688,B023927CBEC0A8053CBDF64A5B76E367,30571,0,2,2,109.50243,18.21861,1504
5887,45689,B023927CBEC0A8053CBDF64A5B76E367,30051,3,4,1,109.48917,18.21215,1453
5888,45690,B023927CBEC0A8053CBDF64A5B76E367,60231,5,6,1,109.49903,18.21972,1504
5889,45691,B023927CBEC0A8053CBDF64A5B76E367,31931,10,12,2,109.54771,18.29403,1667
5890,45703,9161F8CF9FE399F91F1ACEDE385ADA60,31781,8,10,2,109.19847,18.2975,367
5891,45704,9161F8CF9FE399F91F1ACEDE385ADA60,31471,12,13,1,109.34583,18.29563,917
5892,45705,9161F8CF9FE399F91F1ACEDE385ADA60,60221,16,17,1,109.52569,18.29188,1616
5893,45720,C5F520449EBC5BB529DC1F3F22008D6A,31431,0,9,9,109.44639,18.29042,1316
5894,45721,C5F520449EBC5BB529DC1F3F22008D6A,31781,13,15,2,109.19847,18.2975,367
5895,45722,C5F520449EBC5BB529DC1F3F22008D6A,31431,19,23,4,109.44639,18.29042,1316
5896,45763,C925EDC1C2C39BAEC75090090BF059D6,30741,0,8,8,109.49833,18.28681,1516
5897,45764,C925EDC1C2C39BAEC75090090BF059D6,38754,11,13,2,109.74667,18.37382,2430
5898,45765,C925EDC1C2C39BAEC75090090BF059D6,31841,15,16,1,109.73201,18.33382,2373
5899,45766,C925EDC1C2C39BAEC75090090BF059D6,31551,18,19,1,109.55868,18.24222,1708
5900,45767,C925EDC1C2C39BAEC75090090BF059D6,30741,21,23,2,109.49833,18.28681,1516
5901,45770,13104A6A71A054F852B52BB76993ADB2,30851,4,17,13,109.5616,18.27396,1713
5902,45771,13104A6A71A054F852B52BB76993ADB2,30854,20,22,2,109.56889,18.27076,1763
5903,45788,027E602081DB43952E091CB45BB3419B,60524,0,7,7,109.42951,18.28993,1216
5904,45845,BBEE860FA709C883F82529C03A4CBE80,60291,0,1,1,109.50826,18.24639,1509
5905,45846,BBEE860FA709C883F82529C03A4CBE80,31521,2,22,20,109.51458,18.22542,1555
5906,45852,D4EE8E1A4C04A1FF0596E4221D0B8B42,31461,12,14,2,109.5091,18.25389,1510
5907,45853,D4EE8E1A4C04A1FF0596E4221D0B8B42,31071,17,21,4,109.58257,18.28458,1815
5908,45858,FF8CB3D02361FAEBFE418108180099D8,60201,12,14,2,109.5041,18.2509,1510
5909,45859,FF8CB3D02361FAEBFE418108180099D8,30711,15,22,7,109.50271,18.25347,1510
5910,45883,32F65A20D32806FF353EB969C069139F,31031,0,7,7,109.49979,18.25382,1510
5911,45884,32F65A20D32806FF353EB969C069139F,33051,10,14,4,109.6475,18.46618,2096
5912,45885,32F65A20D32806FF353EB969C069139F,38251,16,17,1,109.49618,18.25493,1510
5913,45886,32F65A20D32806FF353EB969C069139F,31031,18,23,5,109.49979,18.25382,1510
5918,45933,694A76996BB887B2B7F2884E406FB0D5,30971,1,9,8,109.48708,18.29319,1467
5919,45934,694A76996BB887B2B7F2884E406FB0D5,31781,12,14,2,109.19847,18.2975,367
5920,45935,694A76996BB887B2B7F2884E406FB0D5,60221,16,20,4,109.52569,18.29188,1616
5921,45936,694A76996BB887B2B7F2884E406FB0D5,31521,21,23,2,109.51458,18.22542,1555
5922,45970,304683EC3F3249EB9C6842AA235349DC,30854,1,17,16,109.56889,18.27076,1763
5923,45971,304683EC3F3249EB9C6842AA235349DC,30051,18,19,1,109.48917,18.21215,1453
5924,45972,304683EC3F3249EB9C6842AA235349DC,30571,19,20,1,109.50243,18.21861,1504
5925,45973,6337E3A707231D3808C1315BC45E0374,38141,0,9,9,109.39479,18.2916,1116
5926,45974,6337E3A707231D3808C1315BC45E0374,60381,14,16,2,109.5241,18.22458,1605
5927,45975,6337E3A707231D3808C1315BC45E0374,38141,17,23,6,109.39479,18.2916,1116
5932,46022,28FD729A56A38491CC99ABB23711BC1C,39181,0,2,2,109.55153,18.28035,1715
5933,46023,28FD729A56A38491CC99ABB23711BC1C,31931,7,8,1,109.54771,18.29403,1667
5934,46024,28FD729A56A38491CC99ABB23711BC1C,39181,11,13,2,109.55153,18.28035,1715
5935,46025,28FD729A56A38491CC99ABB23711BC1C,31931,18,20,2,109.54771,18.29403,1667
5936,46026,28FD729A56A38491CC99ABB23711BC1C,39181,20,23,3,109.55153,18.28035,1715
5937,46048,D7D9352263CF977FD0E7820F34F6CA72,60614,0,14,14,109.48799,18.29521,1467
5938,46049,D7D9352263CF977FD0E7820F34F6CA72,31851,17,20,3,109.71736,18.29007,2316
5939,46050,D7D9352263CF977FD0E7820F34F6CA72,30151,21,23,2,109.50986,18.25083,1560
5940,46110,2CA871175E69D08EE1C85C5B81F73318,31071,0,5,5,109.58257,18.28458,1815
5941,46111,2CA871175E69D08EE1C85C5B81F73318,30854,5,7,2,109.56889,18.27076,1763
5942,46112,2CA871175E69D08EE1C85C5B81F73318,31071,8,14,6,109.58257,18.28458,1815
5943,46113,2CA871175E69D08EE1C85C5B81F73318,60661,15,16,1,109.548,18.2377,1657
5944,46114,2CA871175E69D08EE1C85C5B81F73318,31071,18,20,2,109.58257,18.28458,1815
5945,46172,CE47E8C2A5EAD7F93DD37F876A8014ED,30441,0,8,8,109.64021,18.25424,2010
5946,46173,CE47E8C2A5EAD7F93DD37F876A8014ED,31221,9,12,3,109.61333,18.26833,1913
5947,46174,3D8ADE80304FD3207128013D43F1118A,60421,3,12,9,109.46333,18.31743,1371
5948,46175,3D8ADE80304FD3207128013D43F1118A,31591,16,17,1,109.46924,18.34882,1376
5949,46176,3D8ADE80304FD3207128013D43F1118A,30111,19,21,2,109.47583,18.30542,1419
5950,46177,3D8ADE80304FD3207128013D43F1118A,30711,21,23,2,109.50271,18.25347,1510
5955,46217,918CA9A7084F993FB16E3BC0238F013F,38141,0,9,9,109.39479,18.2916,1116
5956,46218,918CA9A7084F993FB16E3BC0238F013F,38315,10,11,1,109.48979,18.29764,1467
5957,46243,54F5D56BC8E73B852AF722D0635DD6D9,30971,15,17,2,109.48708,18.29319,1467
5958,46244,54F5D56BC8E73B852AF722D0635DD6D9,60381,19,23,4,109.5241,18.22458,1605
5959,46247,6256EC46A5EE081F3E479741B6BEAFA5,60501,0,8,8,109.48701,18.29021,1466
5960,46248,6256EC46A5EE081F3E479741B6BEAFA5,31861,11,12,1,109.49042,18.27549,1464
5961,46249,6256EC46A5EE081F3E479741B6BEAFA5,30971,13,15,2,109.48708,18.29319,1467
5962,46250,6256EC46A5EE081F3E479741B6BEAFA5,60501,18,20,2,109.48701,18.29021,1466
5963,46251,6256EC46A5EE081F3E479741B6BEAFA5,30731,21,22,1,109.50944,18.22306,1555
5964,46259,33D03C41649B47EDC5176C93FF6F1D8D,60411,0,11,11,109.32514,18.30854,869
5965,46260,33D03C41649B47EDC5176C93FF6F1D8D,30661,11,19,8,109.37028,18.24361,1008
5966,46261,33D03C41649B47EDC5176C93FF6F1D8D,31251,22,23,1,109.18528,18.2975,317
5971,46319,C358285726113434A30FBBA8DED710E7,60371,0,1,1,109.53063,18.30056,1618
5972,46320,C358285726113434A30FBBA8DED710E7,30921,1,6,5,109.53903,18.29451,1667
5973,46321,C358285726113434A30FBBA8DED710E7,60371,8,9,1,109.53063,18.30056,1618
5974,46322,C358285726113434A30FBBA8DED710E7,30321,9,11,2,109.49563,18.29611,1467
5975,46323,C358285726113434A30FBBA8DED710E7,60171,12,19,7,109.51292,18.30694,1569
5976,46336,ADBF485F417000D97D859A85712FAE70,60411,12,13,1,109.32514,18.30854,869
5977,46337,ADBF485F417000D97D859A85712FAE70,31471,14,18,4,109.34583,18.29563,917
5978,46338,ADBF485F417000D97D859A85712FAE70,60411,20,22,2,109.32514,18.30854,869
5979,46348,6CBFC4099211CFF22099930D5C42EF4F,31761,12,14,2,109.60521,18.27965,1914
5980,46349,6CBFC4099211CFF22099930D5C42EF4F,31071,17,19,2,109.58257,18.28458,1815
5981,46350,6CBFC4099211CFF22099930D5C42EF4F,30854,20,22,2,109.56889,18.27076,1763
5989,46507,6A9C2BB6A710F77DBA3EB36FEB39BE39,38027,0,7,7,109.38833,18.2909,1066
5990,46508,6A9C2BB6A710F77DBA3EB36FEB39BE39,31145,8,13,5,109.20431,18.30479,369
5991,46509,6A9C2BB6A710F77DBA3EB36FEB39BE39,31471,16,17,1,109.34583,18.29563,917
5992,46510,6A9C2BB6A710F77DBA3EB36FEB39BE39,38027,18,23,5,109.38833,18.2909,1066
5997,46532,3C3846E246DA805C8FD831C3E0164BD8,31521,10,11,1,109.51458,18.22542,1555
5998,46533,3C3846E246DA805C8FD831C3E0164BD8,38871,15,16,1,109.44681,18.28625,1316
5999,46534,3C3846E246DA805C8FD831C3E0164BD8,31701,17,19,2,109.44132,18.28833,1266
6000,46535,3C3846E246DA805C8FD831C3E0164BD8,31431,22,23,1,109.44639,18.29042,1316
6001,46546,9EF4EA0E4466E0443B8D1386AD3C2593,31521,0,3,3,109.51458,18.22542,1555
6002,46547,9EF4EA0E4466E0443B8D1386AD3C2593,39321,4,6,2,109.529,18.2167,1604
6003,46548,9EF4EA0E4466E0443B8D1386AD3C2593,31521,6,8,2,109.51458,18.22542,1555
6004,46549,9EF4EA0E4466E0443B8D1386AD3C2593,30361,16,18,2,109.50347,18.24,1508
6005,46550,9EF4EA0E4466E0443B8D1386AD3C2593,31521,21,23,2,109.51458,18.22542,1555
6006,46602,7AB82AF5C83804E1196D4CF764B27017,30321,1,19,18,109.49563,18.29611,1467
6007,46603,7AB82AF5C83804E1196D4CF764B27017,31206,21,22,1,109.50819,18.23549,1507
6018,46740,13C882817D5EF3329D8612AEE7E0F34D,30961,14,15,1,109.74042,18.37903,2431
6019,46741,13C882817D5EF3329D8612AEE7E0F34D,31491,16,17,1,109.73042,18.38771,2382
6020,46742,13C882817D5EF3329D8612AEE7E0F34D,30201,21,23,2,109.4909,18.26465,1462
6021,46756,74A9CCA48CD6C2DA9FC7DFDB8817D50B,31945,20,22,2,109.58021,18.29403,1817
6022,46767,EB316856896788EC8FD871E122E95728,30931,0,6,6,109.55653,18.32722,1722
6023,46768,EB316856896788EC8FD871E122E95728,31811,8,11,3,109.54201,18.31806,1671
6024,46769,EB316856896788EC8FD871E122E95728,30701,11,14,3,109.59313,18.32007,1871
6025,46770,EB316856896788EC8FD871E122E95728,31811,14,18,4,109.54201,18.31806,1671
6026,46771,EB316856896788EC8FD871E122E95728,30701,20,23,3,109.59313,18.32007,1871
6031,46801,560FD465CF3E1590B881631113C42929,30211,10,14,4,109.49882,18.23931,1508
6032,46802,560FD465CF3E1590B881631113C42929,30921,18,22,4,109.53903,18.29451,1667
6042,46975,706B8E0F0F5D1C9FC2F8EBB2574EE89F,30711,0,17,17,109.50271,18.25347,1510
6043,46976,706B8E0F0F5D1C9FC2F8EBB2574EE89F,30711,17,23,6,109.50271,18.25347,1510
6047,47002,EB5A58B29D07DC10D6158FCB5E76E79E,30921,0,15,15,109.53903,18.29451,1667
6048,47003,EB5A58B29D07DC10D6158FCB5E76E79E,30051,17,21,4,109.48917,18.21215,1453
6049,47011,34A1BA5A97F90C4ABB34EDC7004774A9,30851,0,17,17,109.5616,18.27396,1713
6050,47012,34A1BA5A97F90C4ABB34EDC7004774A9,30951,20,23,3,109.56208,18.25667,1761
6055,47032,A492F275D85D5092E783C1723E9E2DAC,30661,13,16,3,109.37028,18.24361,1008
6056,47033,A492F275D85D5092E783C1723E9E2DAC,38315,17,20,3,109.48979,18.29764,1467
6057,47044,B164B8C0AEC0E295C9ED3DBE75B5D547,31461,9,10,1,109.5091,18.25389,1510
6058,47045,B164B8C0AEC0E295C9ED3DBE75B5D547,38145,12,13,1,109.378,18.2912,1066
6059,47046,B164B8C0AEC0E295C9ED3DBE75B5D547,30084,18,20,2,109.50118,18.26972,1513
6060,47058,036D32EAF14CC03AE0D7817408EFE5C6,60631,0,4,4,109.57778,18.27583,1814
6061,47059,036D32EAF14CC03AE0D7817408EFE5C6,30854,7,8,1,109.56889,18.27076,1763
6062,47060,036D32EAF14CC03AE0D7817408EFE5C6,33481,13,15,2,109.67278,18.41278,2187
6063,47061,036D32EAF14CC03AE0D7817408EFE5C6,30854,17,18,1,109.56889,18.27076,1763
6064,47078,BAD2D8FDB06B9C9EA54FA7C4BC5F7D6F,60114,14,16,2,109.73028,18.33847,2374
6065,47080,873371507B11C4BEF9A7B54B7B3E6864,31061,5,7,2,109.53333,18.23257,1607
6066,47081,873371507B11C4BEF9A7B54B7B3E6864,60552,9,10,1,109.41729,18.30014,1218
6067,47086,5264833F0013AE6B294396000613EF89,30381,0,1,1,109.52521,18.24507,1609
6068,47087,5264833F0013AE6B294396000613EF89,30461,2,7,5,109.5116,18.26313,1562
6069,47088,5264833F0013AE6B294396000613EF89,60201,7,8,1,109.5041,18.2509,1510
6070,47089,5264833F0013AE6B294396000613EF89,60581,12,15,3,109.59785,18.29931,1868
6071,47090,5264833F0013AE6B294396000613EF89,39154,16,17,1,109.50201,18.25681,1511
6072,47091,5264833F0013AE6B294396000613EF89,30461,20,23,3,109.5116,18.26313,1562
6076,47106,318C2956C2993982332D961729732BA8,31781,15,16,1,109.19847,18.2975,367
6077,47107,318C2956C2993982332D961729732BA8,30671,20,23,3,109.43611,18.30139,1268
6085,47146,2F440A235E684ECEDD042B3100A4AE95,31071,0,7,7,109.58257,18.28458,1815
6086,47147,2F440A235E684ECEDD042B3100A4AE95,30854,7,8,1,109.56889,18.27076,1763
6087,47148,2F440A235E684ECEDD042B3100A4AE95,30101,9,14,5,109.57299,18.33333,1773
6088,47149,2F440A235E684ECEDD042B3100A4AE95,30854,17,18,1,109.56889,18.27076,1763
6089,47150,2F440A235E684ECEDD042B3100A4AE95,31071,19,23,4,109.58257,18.28458,1815
6094,47204,A4132C7C24D4F6CFBC6C091695995585,30631,0,7,7,109.34382,18.32778,922
6095,47205,A4132C7C24D4F6CFBC6C091695995585,31691,10,11,1,109.36604,18.3075,1019
6096,47206,A4132C7C24D4F6CFBC6C091695995585,30631,12,14,2,109.34382,18.32778,922
6097,47207,A4132C7C24D4F6CFBC6C091695995585,31691,14,17,3,109.36604,18.3075,1019
6098,47208,A4132C7C24D4F6CFBC6C091695995585,30631,19,23,4,109.34382,18.32778,922
6102,47227,FBC323A047041F71D8997C22FDE88F17,60241,19,20,1,109.53319,18.28667,1616
6103,47276,9FA61329C09648F8617BA9BB3AD39F2D,60201,18,19,1,109.5041,18.2509,1510
6104,47277,9FA61329C09648F8617BA9BB3AD39F2D,60161,19,21,2,109.49174,18.26181,1461
6105,47278,9FA61329C09648F8617BA9BB3AD39F2D,60201,22,23,1,109.5041,18.2509,1510
6106,47279,4BA143AD44480D9BEACA2836C34FF531,60161,14,16,2,109.49174,18.26181,1461
6107,47280,4BA143AD44480D9BEACA2836C34FF531,60231,17,18,1,109.49903,18.21972,1504
6108,47287,C834EF1A38F263607CE4942426932ED6,31851,9,11,2,109.71736,18.29007,2316
6109,47288,C834EF1A38F263607CE4942426932ED6,30081,15,18,3,109.50243,18.26632,1512
6110,47289,C834EF1A38F263607CE4942426932ED6,30711,18,19,1,109.50271,18.25347,1510
6111,47290,C834EF1A38F263607CE4942426932ED6,30281,19,20,1,109.50597,18.27583,1514
6112,47291,C834EF1A38F263607CE4942426932ED6,30711,21,22,1,109.50271,18.25347,1510
6113,47292,C425D181738CCF9419F024C82994FF27,30851,12,18,6,109.5616,18.27396,1713
6114,47293,C425D181738CCF9419F024C82994FF27,31561,20,22,2,109.56792,18.28479,1765
6115,47300,2EADBBB6C6C164CAD4547374810838B0,30201,0,7,7,109.4909,18.26465,1462
6116,47301,2EADBBB6C6C164CAD4547374810838B0,60552,8,10,2,109.41729,18.30014,1218
6117,47302,2EADBBB6C6C164CAD4547374810838B0,31301,10,12,2,109.14493,18.31222,170
6118,47303,2EADBBB6C6C164CAD4547374810838B0,31471,14,15,1,109.34583,18.29563,917
6119,47304,2EADBBB6C6C164CAD4547374810838B0,30821,18,19,1,109.43681,18.33639,1274
6120,47305,2EADBBB6C6C164CAD4547374810838B0,30201,20,22,2,109.4909,18.26465,1462
6121,47331,1A1509AC6E667B603EE3773D1273B7B0,30421,18,20,2,109.50021,18.25861,1511
6122,47332,1A1509AC6E667B603EE3773D1273B7B0,31091,21,22,1,109.41201,18.31222,1170
6133,47465,972967B6F1349FDD6DE1B1DC6FF352B3,31521,18,21,3,109.51458,18.22542,1555
6134,47466,972967B6F1349FDD6DE1B1DC6FF352B3,60381,21,23,2,109.5241,18.22458,1605
6135,47477,44B51AB0086A395492A545161BBB3047,39111,0,3,3,109.5191,18.22597,1555
6136,47478,44B51AB0086A395492A545161BBB3047,31521,4,9,5,109.51458,18.22542,1555
6137,47479,44B51AB0086A395492A545161BBB3047,39321,9,12,3,109.529,18.2167,1604
6138,47480,44B51AB0086A395492A545161BBB3047,60381,14,17,3,109.5241,18.22458,1605
6139,47481,44B51AB0086A395492A545161BBB3047,31521,17,19,2,109.51458,18.22542,1555
6140,47482,44B51AB0086A395492A545161BBB3047,31521,19,23,4,109.51458,18.22542,1555
6153,47622,BBD9C34CBFBB91B9631A99054896F05A,31941,5,8,3,109.62451,18.31222,1970
6154,47625,BBD9C34CBFBB91B9631A99054896F05A,39191,20,22,2,109.51493,18.23472,1557
6155,47626,45CCFCD3EBDF941E1C92B70ED06E8B5E,30854,0,17,17,109.56889,18.27076,1763
6156,47627,45CCFCD3EBDF941E1C92B70ED06E8B5E,31561,21,22,1,109.56792,18.28479,1765
6157,47670,41DC1447E442C6A02FED34B3723350A6,30971,16,17,1,109.48708,18.29319,1467
6158,47671,41DC1447E442C6A02FED34B3723350A6,60381,18,23,5,109.5241,18.22458,1605
6159,47685,5ACB2494699EB2F10AA3427B417842C4,39091,13,16,3,109.50097,18.25222,1510
6160,47689,CFF644097BADAEEAF540049CB3A91F42,39111,0,7,7,109.5191,18.22597,1555
6161,47690,CFF644097BADAEEAF540049CB3A91F42,31145,10,12,2,109.20431,18.30479,369
6162,47691,CFF644097BADAEEAF540049CB3A91F42,31521,16,17,1,109.51458,18.22542,1555
6163,47692,CFF644097BADAEEAF540049CB3A91F42,60381,19,21,2,109.5241,18.22458,1605
6164,47739,DB190B6B2094B1275C5FEDCD655A516B,31811,0,6,6,109.54201,18.31806,1671
6165,47740,DB190B6B2094B1275C5FEDCD655A516B,39081,11,12,1,109.19382,18.29111,366
6166,47741,DB190B6B2094B1275C5FEDCD655A516B,60054,15,16,1,109.3016,18.31229,770
6167,47742,DB190B6B2094B1275C5FEDCD655A516B,31811,18,19,1,109.54201,18.31806,1671
6171,47785,617D274C6203C3080475711DB0A2A53F,31521,0,7,7,109.51458,18.22542,1555
6172,47786,617D274C6203C3080475711DB0A2A53F,31521,8,10,2,109.51458,18.22542,1555
6173,47787,617D274C6203C3080475711DB0A2A53F,60381,11,13,2,109.5241,18.22458,1605
6174,47788,617D274C6203C3080475711DB0A2A53F,31521,13,18,5,109.51458,18.22542,1555
6175,47789,617D274C6203C3080475711DB0A2A53F,60381,19,21,2,109.5241,18.22458,1605
6176,47824,E65658506C2BF9C993BA69EE6D38B3C6,31951,1,19,18,109.52174,18.30299,1568
6177,47825,E65658506C2BF9C993BA69EE6D38B3C6,31561,21,22,1,109.56792,18.28479,1765
6178,47853,B3A1AC27CB357708CE63D3E4F68BF2E7,30854,9,19,10,109.56889,18.27076,1763
6179,47854,B3A1AC27CB357708CE63D3E4F68BF2E7,31071,19,21,2,109.58257,18.28458,1815
6180,47855,B3A1AC27CB357708CE63D3E4F68BF2E7,30854,22,23,1,109.56889,18.27076,1763
6181,47873,149F44702DEC8C73589BE6524F0A1FFD,30854,1,11,10,109.56889,18.27076,1763
6182,47874,149F44702DEC8C73589BE6524F0A1FFD,38085,15,23,8,109.6291,18.23625,2007
6186,47961,B871522C394F4429C8D66865C530B2B2,60551,0,1,1,109.42722,18.30111,1218
6187,47962,B871522C394F4429C8D66865C530B2B2,30671,2,3,1,109.43611,18.30139,1268
6188,47963,B871522C394F4429C8D66865C530B2B2,60491,3,4,1,109.43354,18.30847,1269
6189,47964,B871522C394F4429C8D66865C530B2B2,60551,6,7,1,109.42722,18.30111,1218
6190,47965,B871522C394F4429C8D66865C530B2B2,31471,11,14,3,109.34583,18.29563,917
6191,47966,B871522C394F4429C8D66865C530B2B2,31471,15,16,1,109.34583,18.29563,917
6192,47967,B871522C394F4429C8D66865C530B2B2,60491,17,18,1,109.43354,18.30847,1269
6193,48049,891EFF4C7017E69E0ADF4BB9FE2616FD,60524,0,4,4,109.42951,18.28993,1216
6194,48050,891EFF4C7017E69E0ADF4BB9FE2616FD,31271,7,8,1,109.48958,18.26257,1462
6195,48058,367FD9ECC2463438ADE3989905FE5BA2,39321,0,6,6,109.529,18.2167,1604
6196,48059,367FD9ECC2463438ADE3989905FE5BA2,30971,8,9,1,109.48708,18.29319,1467
6197,48060,367FD9ECC2463438ADE3989905FE5BA2,38951,12,23,11,109.48097,18.28868,1416
6198,48065,48C4FC0F4987EC4FBC3EC910EA4A9934,31231,0,9,9,109.42597,18.29292,1217
6199,48066,48C4FC0F4987EC4FBC3EC910EA4A9934,33051,13,14,1,109.6475,18.46618,2096
6200,48067,48C4FC0F4987EC4FBC3EC910EA4A9934,30854,16,17,1,109.56889,18.27076,1763
6201,48088,6587551DA47309E484D1302521C8D417,60631,3,4,1,109.57778,18.27583,1814
6202,48089,6587551DA47309E484D1302521C8D417,38275,7,22,15,109.62875,18.22938,2006
6203,48093,EFDE35289FEC1E13D6F34EFEE66A8AD2,31561,19,20,1,109.56792,18.28479,1765
6204,48094,EFDE35289FEC1E13D6F34EFEE66A8AD2,60631,21,22,1,109.57778,18.27583,1814
6205,48109,BCF7902B3144684D44567B20BDAA780E,30321,19,23,4,109.49563,18.29611,1467
6206,48138,3977578BE56276DA0700B04B81DC1356,30851,0,14,14,109.5616,18.27396,1713
6207,48139,3977578BE56276DA0700B04B81DC1356,31561,15,17,2,109.56792,18.28479,1765
6208,48157,E5DA2FC779B1E8E31A367E849D1BF38A,30951,11,13,2,109.56208,18.25667,1761
6209,48158,E5DA2FC779B1E8E31A367E849D1BF38A,30854,13,16,3,109.56889,18.27076,1763
6210,48159,E5DA2FC779B1E8E31A367E849D1BF38A,38127,20,23,3,109.50833,18.27222,1513
6211,48178,919B6D6CA33899F0F2E7C2D48DA4283C,39321,0,8,8,109.529,18.2167,1604
6212,48179,919B6D6CA33899F0F2E7C2D48DA4283C,31801,10,11,1,109.20417,18.32118,371
6213,48180,919B6D6CA33899F0F2E7C2D48DA4283C,31471,12,13,1,109.34583,18.29563,917
6214,48181,919B6D6CA33899F0F2E7C2D48DA4283C,39321,15,23,8,109.529,18.2167,1604
6215,48211,6527BE1E19E202485FE6583E7CEDE6A0,31521,0,1,1,109.51458,18.22542,1555
6216,48212,6527BE1E19E202485FE6583E7CEDE6A0,30731,3,8,5,109.50944,18.22306,1555
6217,48213,1EC821E40F7D3254B00CC9AB764BF161,38023,0,2,2,109.37132,18.28993,1016
6218,48214,1EC821E40F7D3254B00CC9AB764BF161,38145,3,7,4,109.378,18.2912,1066
6226,48285,44A75810FF8F9221047E9675BDBF60A2,31561,0,7,7,109.56792,18.28479,1765
6227,48286,44A75810FF8F9221047E9675BDBF60A2,30854,12,13,1,109.56889,18.27076,1763
6228,48287,44A75810FF8F9221047E9675BDBF60A2,31071,13,16,3,109.58257,18.28458,1815
6229,48288,44A75810FF8F9221047E9675BDBF60A2,30854,16,18,2,109.56889,18.27076,1763
6230,48289,44A75810FF8F9221047E9675BDBF60A2,31071,19,21,2,109.58257,18.28458,1815
6231,48294,EEA6FAB436EFD40A971681E1E7E827FF,60594,0,8,8,109.62694,18.22799,1956
6232,48295,EEA6FAB436EFD40A971681E1E7E827FF,31781,12,13,1,109.19847,18.2975,367
6233,48296,EEA6FAB436EFD40A971681E1E7E827FF,38754,15,17,2,109.74667,18.37382,2430
6234,48297,EEA6FAB436EFD40A971681E1E7E827FF,30581,19,20,1,109.62257,18.24951,1959
6235,48298,EEA6FAB436EFD40A971681E1E7E827FF,60594,21,23,2,109.62694,18.22799,1956
6239,48350,0BBE0A7C0F4128829E11ADBE9E2E333B,31321,0,8,8,109.63799,18.23201,2007
6240,48351,0BBE0A7C0F4128829E11ADBE9E2E333B,31781,12,13,1,109.19847,18.2975,367
6244,48403,E6312CBC8153A9C6DAB83670095D0D25,38951,16,20,4,109.48097,18.28868,1416
6245,48404,E6312CBC8153A9C6DAB83670095D0D25,38951,21,22,1,109.48097,18.28868,1416
6246,48408,3F80F6C7ECC59E36D89C8EF1746C8724,38121,18,19,1,109.51361,18.27813,1564
6247,48409,3F80F6C7ECC59E36D89C8EF1746C8724,31201,19,22,3,109.51042,18.23819,1558
6248,48428,56C8C781972E8BFAF8A768A19AD7F590,38261,0,7,7,109.50361,18.28153,1515
6249,48431,56C8C781972E8BFAF8A768A19AD7F590,38171,18,23,5,109.50799,18.28139,1515
6257,48485,4DB778A581941E2A7955D8DA3B7ADAFE,31931,1,7,6,109.54771,18.29403,1667
6258,48486,4DB778A581941E2A7955D8DA3B7ADAFE,31841,8,18,10,109.73201,18.33382,2373
6259,48487,4DB778A581941E2A7955D8DA3B7ADAFE,31931,19,20,1,109.54771,18.29403,1667
6260,48488,A5068BA438682A01E08CBBBB05E225FD,30211,0,5,5,109.49882,18.23931,1508
6261,48489,A5068BA438682A01E08CBBBB05E225FD,31251,5,6,1,109.18528,18.2975,317
6262,48490,A5068BA438682A01E08CBBBB05E225FD,60621,6,7,1,109.48354,18.27451,1464
6263,48491,A5068BA438682A01E08CBBBB05E225FD,31781,9,11,2,109.19847,18.2975,367
6264,48492,A5068BA438682A01E08CBBBB05E225FD,31471,13,14,1,109.34583,18.29563,917
6265,48544,0D87DA60FDB2AF9A9FA2C393794B287E,31291,0,9,9,109.30375,18.40729,786
6272,48664,2C3BD53A8702A47FB82F05FB4993B683,31561,0,13,13,109.56792,18.28479,1765
6273,48665,2C3BD53A8702A47FB82F05FB4993B683,30854,14,16,2,109.56889,18.27076,1763
6274,48680,2D747BB9EF94A7A497B1722BD009FBFB,30854,4,13,9,109.56889,18.27076,1763
6275,48681,2D747BB9EF94A7A497B1722BD009FBFB,39183,17,18,1,109.55542,18.28208,1715
6276,48691,122DBE3548D9D99C856018D6EE8E2161,31721,0,6,6,109.67938,18.24014,2158
6277,48692,122DBE3548D9D99C856018D6EE8E2161,30441,7,8,1,109.64021,18.25424,2010
6278,48693,122DBE3548D9D99C856018D6EE8E2161,30121,10,23,13,109.52861,18.27222,1613
6279,48694,F5FA9E3AD48A61D07594249E558C93A1,60401,0,1,1,109.47444,18.27583,1414
6280,48695,F5FA9E3AD48A61D07594249E558C93A1,31231,2,5,3,109.42597,18.29292,1217
6281,48696,F5FA9E3AD48A61D07594249E558C93A1,60084,5,7,2,109.4984,18.2334,1507
6282,48697,F5FA9E3AD48A61D07594249E558C93A1,60401,8,10,2,109.47444,18.27583,1414
6283,48698,F5FA9E3AD48A61D07594249E558C93A1,38315,15,17,2,109.48979,18.29764,1467
6284,48704,866460FA5062A635337B6369BB2AADDA,30854,2,7,5,109.56889,18.27076,1763
6285,48705,866460FA5062A635337B6369BB2AADDA,60381,10,13,3,109.5241,18.22458,1605
6286,48706,866460FA5062A635337B6369BB2AADDA,30854,18,19,1,109.56889,18.27076,1763
6287,48719,C2622C284BAD8F487DCD454B3FAF9432,30721,0,13,13,109.51597,18.28257,1565
6288,48720,C2622C284BAD8F487DCD454B3FAF9432,31121,14,22,8,109.16292,18.37063,230
6292,48742,F0B6727884A767D82C873414BBDB13C7,30581,17,18,1,109.62257,18.24951,1959
6293,48743,F0B6727884A767D82C873414BBDB13C7,60501,20,21,1,109.48701,18.29021,1466
6294,48744,F0B6727884A767D82C873414BBDB13C7,31864,22,23,1,109.49014,18.28333,1465
6295,48761,42923D86FCA39B981325B127230BF145,30101,1,3,2,109.57299,18.33333,1773
6296,48762,42923D86FCA39B981325B127230BF145,39183,5,6,1,109.55542,18.28208,1715
6297,48763,42923D86FCA39B981325B127230BF145,60117,8,9,1,109.73604,18.35681,2427
6298,48764,42923D86FCA39B981325B127230BF145,30232,12,13,1,109.6191,18.31701,1971
6299,48771,EDE78B6CF45A5ED767091F2988348E3D,38315,14,16,2,109.48979,18.29764,1467
6300,48772,EDE78B6CF45A5ED767091F2988348E3D,30861,19,21,2,109.52722,18.22743,1606
6301,48773,EB6BFD55088EBBC13FF4108BB4CD6C9F,60411,0,10,10,109.32514,18.30854,869
6302,48774,EB6BFD55088EBBC13FF4108BB4CD6C9F,30661,11,13,2,109.37028,18.24361,1008
6303,48775,EB6BFD55088EBBC13FF4108BB4CD6C9F,60054,14,15,1,109.3016,18.31229,770
6304,48794,0E1B3CFC64EBB658DA96D0DCA834701E,61011,19,21,2,109.60653,18.19076,1900
6305,48842,6B24823797A23CF47C34C631323C3D8C,31031,0,8,8,109.49979,18.25382,1510
6306,48843,6B24823797A23CF47C34C631323C3D8C,31531,11,13,2,109.49583,18.25972,1461
6307,48844,6B24823797A23CF47C34C631323C3D8C,31031,15,17,2,109.49979,18.25382,1510
6308,48845,6B24823797A23CF47C34C631323C3D8C,38754,18,19,1,109.74667,18.37382,2430
6309,48846,6B24823797A23CF47C34C631323C3D8C,31031,21,23,2,109.49979,18.25382,1510
6310,48868,E144D2237263FD19C57C13D01FC7E08E,60054,10,11,1,109.3016,18.31229,770
6311,48869,E144D2237263FD19C57C13D01FC7E08E,31471,12,14,2,109.34583,18.29563,917
6312,48870,E144D2237263FD19C57C13D01FC7E08E,39091,15,16,1,109.50097,18.25222,1510
6319,48923,FCB0C1D52F8BE5F0C9BD5C8F37313BFD,60241,12,14,2,109.53319,18.28667,1616
6320,48924,FCB0C1D52F8BE5F0C9BD5C8F37313BFD,30721,16,18,2,109.51597,18.28257,1565
6321,48973,34AB502A442AA8EA4A7FB30471B204DB,31471,10,11,1,109.34583,18.29563,917
6322,48974,34AB502A442AA8EA4A7FB30471B204DB,60054,11,13,2,109.3016,18.31229,770
6323,48975,34AB502A442AA8EA4A7FB30471B204DB,38251,15,16,1,109.49618,18.25493,1510
6324,48976,34AB502A442AA8EA4A7FB30471B204DB,30171,20,23,3,109.48458,18.27139,1463
6328,49031,5FF9CBAB281B4ADF0AD2A70608A00E08,30241,10,11,1,109.26174,18.3275,622
6329,49032,5FF9CBAB281B4ADF0AD2A70608A00E08,60614,15,17,2,109.48799,18.29521,1467
6330,49078,E962C3D0A8FC163364DD770DFBF0ADE9,60121,14,15,1,109.74507,18.37472,2430
6335,49141,2B3D1202B9CAAA0F3B6C3510362F28D1,30201,0,7,7,109.4909,18.26465,1462
6336,49142,2B3D1202B9CAAA0F3B6C3510362F28D1,31101,11,12,1,109.65389,18.23403,2057
6337,49143,2B3D1202B9CAAA0F3B6C3510362F28D1,31101,13,15,2,109.65389,18.23403,2057
6347,49214,225EDE82328108AFB3E7EE610CA3F074,31931,0,18,18,109.54771,18.29403,1667
6348,49215,225EDE82328108AFB3E7EE610CA3F074,60371,20,21,1,109.53063,18.30056,1618
6349,49299,1593E13193A160EF9BE2323C5CE79FFF,31931,0,1,1,109.54771,18.29403,1667
6350,49300,1593E13193A160EF9BE2323C5CE79FFF,38241,1,23,22,109.54111,18.30542,1669
6351,49348,4275FD70CE0658198E368801C2857FA2,31521,0,9,9,109.51458,18.22542,1555
6359,49432,48C2384D12D5B16772007E35CE360CBB,30721,0,19,19,109.51597,18.28257,1565
6360,49433,48C2384D12D5B16772007E35CE360CBB,38185,21,22,1,109.51333,18.27347,1563
6364,49471,82EB7611DCDB84F91528CD6B7C229C51,39091,8,9,1,109.50097,18.25222,1510
6365,49472,82EB7611DCDB84F91528CD6B7C229C51,31471,11,12,1,109.34583,18.29563,917
6366,49473,82EB7611DCDB84F91528CD6B7C229C51,31471,14,15,1,109.34583,18.29563,917
6367,49488,14F4ACAD1B4C4B8CE52F7EFB2E582792,31031,0,5,5,109.49979,18.25382,1510
6368,49489,14F4ACAD1B4C4B8CE52F7EFB2E582792,31031,6,11,5,109.49979,18.25382,1510
6369,49490,14F4ACAD1B4C4B8CE52F7EFB2E582792,31534,11,13,2,109.49368,18.25806,1461
6370,49491,14F4ACAD1B4C4B8CE52F7EFB2E582792,31031,13,15,2,109.49979,18.25382,1510
6371,49492,14F4ACAD1B4C4B8CE52F7EFB2E582792,31461,18,20,2,109.5091,18.25389,1510
6372,49493,14F4ACAD1B4C4B8CE52F7EFB2E582792,31031,21,23,2,109.49979,18.25382,1510
6373,49513,FBE9370FE25A2FA07998471D4C524639,31471,1,2,1,109.34583,18.29563,917
6374,49514,FBE9370FE25A2FA07998471D4C524639,30661,2,6,4,109.37028,18.24361,1008
6375,49515,FBE9370FE25A2FA07998471D4C524639,60411,6,7,1,109.32514,18.30854,869
6376,49516,FBE9370FE25A2FA07998471D4C524639,31471,8,10,2,109.34583,18.29563,917
6377,49517,FBE9370FE25A2FA07998471D4C524639,31471,11,15,4,109.34583,18.29563,917
6381,49572,C25D5C616C048636FA7F718C694FFBDC,31521,16,19,3,109.51458,18.22542,1555
6382,49573,C25D5C616C048636FA7F718C694FFBDC,38111,20,21,1,109.52007,18.22403,1555
6383,49574,C25D5C616C048636FA7F718C694FFBDC,31521,21,22,1,109.51458,18.22542,1555
6384,49633,D080330F46FFE140C3D67F6850CA9E9D,31531,0,8,8,109.49583,18.25972,1461
6385,49634,D080330F46FFE140C3D67F6850CA9E9D,31781,11,13,2,109.19847,18.2975,367
6386,49635,D080330F46FFE140C3D67F6850CA9E9D,31531,18,19,1,109.49583,18.25972,1461
6387,49636,D080330F46FFE140C3D67F6850CA9E9D,38251,20,21,1,109.49618,18.25493,1510
6391,49689,000AECFEC5FE1C4D11E1909AB25C278D,60161,0,11,11,109.49174,18.26181,1461
6392,49703,70A62761FE79F922D082380DA7747243,31561,0,6,6,109.56792,18.28479,1765
6393,49704,70A62761FE79F922D082380DA7747243,30854,10,22,12,109.56889,18.27076,1763
6394,49716,E4B522EF4348156010E5C578EC13D60F,30191,0,2,2,109.50361,18.22701,1506
6395,49717,E4B522EF4348156010E5C578EC13D60F,30854,3,4,1,109.56889,18.27076,1763
6396,49718,E4B522EF4348156010E5C578EC13D60F,31945,4,5,1,109.58021,18.29403,1817
6397,49719,E4B522EF4348156010E5C578EC13D60F,30854,11,17,6,109.56889,18.27076,1763
6398,49720,E4B522EF4348156010E5C578EC13D60F,38205,19,20,1,109.62743,18.23139,1956
6402,49729,71E19E1917BF3FC55A3CE758E0010AE6,31391,0,15,15,109.50382,18.24285,1508
6406,49821,2AB873DF25588EC945CFF2CC54F197C3,30581,0,8,8,109.62257,18.24951,1959
6407,49822,2AB873DF25588EC945CFF2CC54F197C3,31471,13,15,2,109.34583,18.29563,917
6408,49823,2AB873DF25588EC945CFF2CC54F197C3,30581,19,23,4,109.62257,18.24951,1959
6409,49845,608A55C14BAB2A5B627ACC1F39B89FB6,31945,0,7,7,109.58021,18.29403,1817
6410,49846,608A55C14BAB2A5B627ACC1F39B89FB6,31071,10,11,1,109.58257,18.28458,1815
6411,49847,608A55C14BAB2A5B627ACC1F39B89FB6,31945,12,13,1,109.58021,18.29403,1817
6412,49848,608A55C14BAB2A5B627ACC1F39B89FB6,30854,13,17,4,109.56889,18.27076,1763
6413,49849,608A55C14BAB2A5B627ACC1F39B89FB6,31071,18,20,2,109.58257,18.28458,1815
6414,49850,608A55C14BAB2A5B627ACC1F39B89FB6,31945,21,23,2,109.58021,18.29403,1817
6415,49879,10EBF762D28520B09848288F7052CFDE,30854,0,5,5,109.56889,18.27076,1763
6416,49880,10EBF762D28520B09848288F7052CFDE,39101,7,11,4,109.50132,18.24931,1509
6417,49881,10EBF762D28520B09848288F7052CFDE,39101,14,15,1,109.50132,18.24931,1509
6418,49882,10EBF762D28520B09848288F7052CFDE,30854,18,20,2,109.56889,18.27076,1763
6419,49883,10EBF762D28520B09848288F7052CFDE,31071,20,23,3,109.58257,18.28458,1815
6420,49904,82ACC50762A431B4A2E6C3A41E29B2C7,30101,0,8,8,109.57299,18.33333,1773
6421,49905,82ACC50762A431B4A2E6C3A41E29B2C7,30071,12,17,5,109.52819,18.30472,1619
6422,49906,82ACC50762A431B4A2E6C3A41E29B2C7,60361,20,21,1,109.51938,18.29681,1567
6423,49907,82ACC50762A431B4A2E6C3A41E29B2C7,30101,22,23,1,109.57299,18.33333,1773
6424,49914,6E6193514D8E876D83956A94AD4F3FB1,31931,0,8,8,109.54771,18.29403,1667
6425,49915,6E6193514D8E876D83956A94AD4F3FB1,30921,10,11,1,109.53903,18.29451,1667
6426,49916,6E6193514D8E876D83956A94AD4F3FB1,31931,12,14,2,109.54771,18.29403,1667
6427,49917,6E6193514D8E876D83956A94AD4F3FB1,30071,18,20,2,109.52819,18.30472,1619
6428,49918,6E6193514D8E876D83956A94AD4F3FB1,31931,21,22,1,109.54771,18.29403,1667
6436,49943,9A369E1280A8BB5227D2B6A5698033ED,60121,17,19,2,109.74507,18.37472,2430
6437,49946,2BF695F70882DCFE1A4499C31C4A9579,60594,0,3,3,109.62694,18.22799,1956
6438,49947,2BF695F70882DCFE1A4499C31C4A9579,38331,3,6,3,109.62465,18.22736,1956
6439,49948,2BF695F70882DCFE1A4499C31C4A9579,38052,7,13,6,109.62618,18.23042,1956
6440,49949,2BF695F70882DCFE1A4499C31C4A9579,31321,13,15,2,109.63799,18.23201,2007
6441,49950,2BF695F70882DCFE1A4499C31C4A9579,38052,15,18,3,109.62618,18.23042,1956
6442,49951,2BF695F70882DCFE1A4499C31C4A9579,38331,19,21,2,109.62465,18.22736,1956
6443,49961,C61360C6C8202A54143E165C2C08120B,30951,0,1,1,109.56208,18.25667,1761
6444,49962,C61360C6C8202A54143E165C2C08120B,30232,1,2,1,109.6191,18.31701,1971
6445,49963,C61360C6C8202A54143E165C2C08120B,30951,3,7,4,109.56208,18.25667,1761
6446,49964,C61360C6C8202A54143E165C2C08120B,30851,11,12,1,109.5616,18.27396,1713
6447,49985,AAB3DCB18BAF89954DC0C8A658A6D766,38251,0,2,2,109.49618,18.25493,1510
6448,49986,AAB3DCB18BAF89954DC0C8A658A6D766,60231,4,5,1,109.49903,18.21972,1504
6449,49987,AAB3DCB18BAF89954DC0C8A658A6D766,31031,5,6,1,109.49979,18.25382,1510
6450,49988,AAB3DCB18BAF89954DC0C8A658A6D766,30051,8,10,2,109.48917,18.21215,1453
6451,49989,AAB3DCB18BAF89954DC0C8A658A6D766,60231,12,13,1,109.49903,18.21972,1504
6452,49998,6EE484A856A2F2B5959CBB035140462D,60641,0,6,6,109.53854,18.2359,1657
6453,49999,6EE484A856A2F2B5959CBB035140462D,31701,10,12,2,109.44132,18.28833,1266
6454,50016,F84CB73131A8F3F2021BE5E4FA198E87,30861,12,16,4,109.52722,18.22743,1606
6455,50017,F84CB73131A8F3F2021BE5E4FA198E87,31031,17,19,2,109.49979,18.25382,1510
6456,50024,F277E39F930DABB1C32B459808E7C21D,31534,0,7,7,109.49368,18.25806,1461
6457,50025,F277E39F930DABB1C32B459808E7C21D,30071,12,13,1,109.52819,18.30472,1619
6458,50081,7260738E9AF8A6F148DEA7642BD04088,31534,0,10,10,109.49368,18.25806,1461
6463,50102,E605B26D53F08A0D3360A4541E09F4E2,30721,1,8,7,109.51597,18.28257,1565
6464,50103,E605B26D53F08A0D3360A4541E09F4E2,38283,9,12,3,109.62229,18.22618,1956
6465,50104,E605B26D53F08A0D3360A4541E09F4E2,38283,14,17,3,109.62229,18.22618,1956
6466,50105,E605B26D53F08A0D3360A4541E09F4E2,30721,20,23,3,109.51597,18.28257,1565
6467,50109,6DF7485545B790F22810B0EDD8F1B356,31945,0,7,7,109.58021,18.29403,1817
6468,50110,6DF7485545B790F22810B0EDD8F1B356,30854,8,9,1,109.56889,18.27076,1763
6469,50111,6DF7485545B790F22810B0EDD8F1B356,31945,12,13,1,109.58021,18.29403,1817
6470,50112,6DF7485545B790F22810B0EDD8F1B356,30854,15,17,2,109.56889,18.27076,1763
6471,50113,6DF7485545B790F22810B0EDD8F1B356,30711,18,21,3,109.50271,18.25347,1510
6472,50143,2C5F898948A2B7909519666936FBF333,38707,0,9,9,109.73778,18.35368,2427
6473,50144,2C5F898948A2B7909519666936FBF333,38707,11,13,2,109.73778,18.35368,2427
6474,50145,2C5F898948A2B7909519666936FBF333,38707,15,17,2,109.73778,18.35368,2427
6475,50146,2C5F898948A2B7909519666936FBF333,31161,19,22,3,109.70229,18.31361,2270
6476,50157,F167FEC88E6854C4E8BE1680AD709113,30861,0,7,7,109.52722,18.22743,1606
6477,50158,F167FEC88E6854C4E8BE1680AD709113,30971,8,9,1,109.48708,18.29319,1467
6478,50159,F167FEC88E6854C4E8BE1680AD709113,30971,10,11,1,109.48708,18.29319,1467
6479,50160,F167FEC88E6854C4E8BE1680AD709113,38951,12,21,9,109.48097,18.28868,1416
6483,50207,80A003466CAB94607199247E4F269A75,39091,12,15,3,109.50097,18.25222,1510
6484,50226,07F3C4748B468EDA7E91DFDA551BC9A2,33354,0,7,7,109.67465,18.44583,2192
6485,50227,07F3C4748B468EDA7E91DFDA551BC9A2,31781,9,11,2,109.19847,18.2975,367
6486,50228,07F3C4748B468EDA7E91DFDA551BC9A2,31471,13,15,2,109.34583,18.29563,917
6487,50229,07F3C4748B468EDA7E91DFDA551BC9A2,38023,16,17,1,109.37132,18.28993,1016
6488,50230,07F3C4748B468EDA7E91DFDA551BC9A2,60221,19,21,2,109.52569,18.29188,1616
6489,50231,07F3C4748B468EDA7E91DFDA551BC9A2,38023,21,23,2,109.37132,18.28993,1016
6497,50274,0F558B6653C655C7F0BAEA9D66B33F57,31071,2,7,5,109.58257,18.28458,1815
6498,50275,0F558B6653C655C7F0BAEA9D66B33F57,30854,8,18,10,109.56889,18.27076,1763
6499,50276,0F558B6653C655C7F0BAEA9D66B33F57,30421,19,21,2,109.50021,18.25861,1511
6506,50352,77CEA39CA686523ACAD4D7ACE43C45F6,31351,13,15,2,109.4959,18.28417,1465
6507,50353,77CEA39CA686523ACAD4D7ACE43C45F6,30351,15,21,6,109.41701,18.29292,1217
6511,50377,131FD19D60F318F2E92456D189868A09,60054,11,13,2,109.3016,18.31229,770
6512,50378,131FD19D60F318F2E92456D189868A09,31781,15,16,1,109.19847,18.2975,367
6521,50438,A119B093D14CCB6B6870AA9A88D1F972,30051,0,7,7,109.48917,18.21215,1453
6522,50439,A119B093D14CCB6B6870AA9A88D1F972,60621,7,9,2,109.48354,18.27451,1464
6523,50440,A119B093D14CCB6B6870AA9A88D1F972,60054,11,13,2,109.3016,18.31229,770
6524,50441,A119B093D14CCB6B6870AA9A88D1F972,31031,15,17,2,109.49979,18.25382,1510
6525,50442,A119B093D14CCB6B6870AA9A88D1F972,60621,19,21,2,109.48354,18.27451,1464
6526,50443,A119B093D14CCB6B6870AA9A88D1F972,30051,21,23,2,109.48917,18.21215,1453
6527,50468,8D0A4EF6BB9DEDE12E59D3FEDBD17479,31311,0,12,12,109.72299,18.27438,2364
6528,50473,0A9117B90774715AACE2ED3045D6F579,60041,13,15,2,109.39889,18.31944,1121
6529,50474,0A9117B90774715AACE2ED3045D6F579,31091,18,20,2,109.41201,18.31222,1170
6530,50475,0A9117B90774715AACE2ED3045D6F579,31861,21,23,2,109.49042,18.27549,1464
6531,50478,EA27C1DACC015E381783BB03940DBA88,31561,13,14,1,109.56792,18.28479,1765
6532,50479,EA27C1DACC015E381783BB03940DBA88,39183,15,16,1,109.55542,18.28208,1715
6533,50512,F866B6E34CEF853A6497211DD74A607E,30711,0,8,8,109.50271,18.25347,1510
6534,50515,F866B6E34CEF853A6497211DD74A607E,30711,19,21,2,109.50271,18.25347,1510
6535,50516,F866B6E34CEF853A6497211DD74A607E,31071,22,23,1,109.58257,18.28458,1815
6536,50519,F3D63C0B2248B39F370D3CF39845220E,60614,16,17,1,109.48799,18.29521,1467
6537,50520,F3D63C0B2248B39F370D3CF39845220E,38951,20,23,3,109.48097,18.28868,1416
6538,50527,EFFEF00C078D502D6D0D1D469ACBA466,30281,19,21,2,109.50597,18.27583,1514
6539,50528,EFFEF00C078D502D6D0D1D469ACBA466,38321,22,23,1,109.39854,18.29132,1116
6543,50575,F1CC7A6DEAC0F0CAF8EACDD2FC371C14,38754,14,16,2,109.74667,18.37382,2430
6544,50576,F1CC7A6DEAC0F0CAF8EACDD2FC371C14,39091,17,18,1,109.50097,18.25222,1510
6545,50577,F1CC7A6DEAC0F0CAF8EACDD2FC371C14,31071,20,21,1,109.58257,18.28458,1815
6546,50588,707670CE62A106DAC866A70B1F89E816,30581,0,8,8,109.62257,18.24951,1959
6547,50589,707670CE62A106DAC866A70B1F89E816,60441,10,11,1,109.46792,18.28604,1366
6548,50590,707670CE62A106DAC866A70B1F89E816,31471,12,15,3,109.34583,18.29563,917
6549,50591,707670CE62A106DAC866A70B1F89E816,30581,19,23,4,109.62257,18.24951,1959
6553,50609,8DD23AA43C0F7967C45F7488D66F9159,31945,1,7,6,109.58021,18.29403,1817
6554,50610,8DD23AA43C0F7967C45F7488D66F9159,30854,11,12,1,109.56889,18.27076,1763
6555,50611,8DD23AA43C0F7967C45F7488D66F9159,31945,12,13,1,109.58021,18.29403,1817
6556,50612,8DD23AA43C0F7967C45F7488D66F9159,30854,18,20,2,109.56889,18.27076,1763
6557,50613,8DD23AA43C0F7967C45F7488D66F9159,31461,21,23,2,109.5091,18.25389,1510
6558,50619,3B66C6D354CAB83AFF8CCC11FF0B09AC,60381,17,18,1,109.5241,18.22458,1605
6559,50620,3B66C6D354CAB83AFF8CCC11FF0B09AC,60361,21,22,1,109.51938,18.29681,1567
6560,50627,D2CF9265B60194574BF1A7726786A2D8,31145,10,15,5,109.20431,18.30479,369
6561,50628,D2CF9265B60194574BF1A7726786A2D8,31304,17,18,1,109.15903,18.32854,223
6562,50629,D2CF9265B60194574BF1A7726786A2D8,31541,19,21,2,109.1809,18.36722,329
6563,50669,598A5BC9BEA86E74379689160E91B24E,30854,1,14,13,109.56889,18.27076,1763
6564,50670,598A5BC9BEA86E74379689160E91B24E,31071,17,18,1,109.58257,18.28458,1815
6565,50699,F4E8369A4C9B6C532D393F00D3A77C26,30854,0,7,7,109.56889,18.27076,1763
6566,50700,F4E8369A4C9B6C532D393F00D3A77C26,39183,10,20,10,109.55542,18.28208,1715
6567,50706,C339249D1ACA3291A5D7DAFA9F0D0DF2,38346,0,6,6,109.49688,18.21306,1503
6568,50707,C339249D1ACA3291A5D7DAFA9F0D0DF2,38341,8,9,1,109.49965,18.21299,1503
6569,50708,C339249D1ACA3291A5D7DAFA9F0D0DF2,31311,10,12,2,109.72299,18.27438,2364
6570,50709,C339249D1ACA3291A5D7DAFA9F0D0DF2,60121,15,17,2,109.74507,18.37472,2430
6571,50710,C339249D1ACA3291A5D7DAFA9F0D0DF2,31321,18,20,2,109.63799,18.23201,2007
6572,50711,C339249D1ACA3291A5D7DAFA9F0D0DF2,60321,22,23,1,109.63611,18.24306,2008
6573,50715,C76D7E78C5C113DAF50BFDE07720534D,30731,0,8,8,109.50944,18.22306,1555
6574,50716,C76D7E78C5C113DAF50BFDE07720534D,31471,11,13,2,109.34583,18.29563,917
6575,50717,C76D7E78C5C113DAF50BFDE07720534D,30361,14,16,2,109.50347,18.24,1508
6576,50718,C76D7E78C5C113DAF50BFDE07720534D,30181,16,20,4,109.51597,18.23313,1557
6577,50719,C76D7E78C5C113DAF50BFDE07720534D,31201,20,22,2,109.51042,18.23819,1558
6581,50743,1D8B56371E487F3812C9965576175C8D,38361,0,9,9,109.43667,18.29201,1267
6582,50744,1D8B56371E487F3812C9965576175C8D,31811,13,14,1,109.54201,18.31806,1671
6583,50750,9BD0746EAD915C7FE62E448DC71186FA,30854,13,15,2,109.56889,18.27076,1763
6584,50751,9BD0746EAD915C7FE62E448DC71186FA,30711,17,18,1,109.50271,18.25347,1510
6585,50752,9BD0746EAD915C7FE62E448DC71186FA,31071,20,21,1,109.58257,18.28458,1815
6586,50769,1A4B51DFD66BF1F13D5FAE3E1A0A202C,30854,13,17,4,109.56889,18.27076,1763
6587,50770,1A4B51DFD66BF1F13D5FAE3E1A0A202C,31071,21,22,1,109.58257,18.28458,1815
6592,50863,EDD211647BCC1D3CABF473CB2801C791,31041,2,10,8,109.50278,18.23701,1507
6593,50864,EDD211647BCC1D3CABF473CB2801C791,30161,11,23,12,109.50042,18.24389,1508
6594,50873,7B2AEE2086698683607EDDDB4B678234,60201,13,15,2,109.5041,18.2509,1510
6595,50874,7B2AEE2086698683607EDDDB4B678234,31461,15,18,3,109.5091,18.25389,1510
6596,50875,7B2AEE2086698683607EDDDB4B678234,60221,19,21,2,109.52569,18.29188,1616
6597,50910,E58F7930139B2ED51DE79005F05C056D,39183,14,15,1,109.55542,18.28208,1715
6598,50911,E58F7930139B2ED51DE79005F05C056D,39181,18,23,5,109.55153,18.28035,1715
6599,50912,856FED43C24F39C7284040D716161D86,31081,0,10,10,109.44639,18.30181,1318
6600,50913,856FED43C24F39C7284040D716161D86,60381,11,13,2,109.5241,18.22458,1605
6601,50914,856FED43C24F39C7284040D716161D86,60114,16,18,2,109.73028,18.33847,2374
6602,50915,856FED43C24F39C7284040D716161D86,31021,19,20,1,109.49021,18.27,1463
6603,50916,856FED43C24F39C7284040D716161D86,31081,21,23,2,109.44639,18.30181,1318
6611,51007,4AC58984B2F202FD588F865249555769,31311,0,8,8,109.72299,18.27438,2364
6612,51008,4AC58984B2F202FD588F865249555769,30761,12,14,2,109.45201,18.3,1318
6613,51009,4AC58984B2F202FD588F865249555769,31311,18,23,5,109.72299,18.27438,2364
6622,51080,005F3AEFE6DBF371ED1FD57736434098,30854,11,20,9,109.56889,18.27076,1763
6623,51081,005F3AEFE6DBF371ED1FD57736434098,31071,21,23,2,109.58257,18.28458,1815
6628,51130,34F3D64B41C252481F72E5CF931AC833,31071,4,6,2,109.58257,18.28458,1815
6629,51131,34F3D64B41C252481F72E5CF931AC833,30851,6,13,7,109.5616,18.27396,1713
6630,51151,D0866918F07FFECFBBDD57492CC6C931,60411,12,13,1,109.32514,18.30854,869
6631,51152,D0866918F07FFECFBBDD57492CC6C931,31471,15,17,2,109.34583,18.29563,917
6632,51153,D0866918F07FFECFBBDD57492CC6C931,60411,18,21,3,109.32514,18.30854,869
6633,51177,73C19B2A002A8D6E0EC77225EBBCD503,31491,2,4,2,109.73042,18.38771,2382
6634,51178,73C19B2A002A8D6E0EC77225EBBCD503,30791,4,7,3,109.72333,18.40889,2386
6635,51190,2FA8C9EB39391D82B65635AB780DCA95,60524,0,8,8,109.42951,18.28993,1216
6636,51191,2FA8C9EB39391D82B65635AB780DCA95,30971,8,10,2,109.48708,18.29319,1467
6637,51192,2FA8C9EB39391D82B65635AB780DCA95,38951,11,15,4,109.48097,18.28868,1416
6638,51193,2FA8C9EB39391D82B65635AB780DCA95,30971,15,18,3,109.48708,18.29319,1467
6639,51194,2FA8C9EB39391D82B65635AB780DCA95,38951,18,23,5,109.48097,18.28868,1416
6640,51202,6B51370D2A6A7CB5ED483F2827F846C2,31471,13,15,2,109.34583,18.29563,917
6641,51203,6B51370D2A6A7CB5ED483F2827F846C2,60291,19,21,2,109.50826,18.24639,1509
6642,51204,6B51370D2A6A7CB5ED483F2827F846C2,39111,22,23,1,109.5191,18.22597,1555
6643,51218,A952750F25C558E5C17B3EB7DD935431,30071,1,3,2,109.52819,18.30472,1619
6644,51219,A952750F25C558E5C17B3EB7DD935431,60371,7,9,2,109.53063,18.30056,1618
6645,51220,A952750F25C558E5C17B3EB7DD935431,31931,11,12,1,109.54771,18.29403,1667
6646,51221,A952750F25C558E5C17B3EB7DD935431,60371,18,21,3,109.53063,18.30056,1618
6647,51222,A952750F25C558E5C17B3EB7DD935431,31931,22,23,1,109.54771,18.29403,1667
6648,51223,BD1C8CAB0CA377D9350002A865081450,38185,0,6,6,109.51333,18.27347,1563
6649,51224,BD1C8CAB0CA377D9350002A865081450,31021,9,11,2,109.49021,18.27,1463
6650,51225,BD1C8CAB0CA377D9350002A865081450,30251,11,13,2,109.50611,18.26653,1512
6651,51226,BD1C8CAB0CA377D9350002A865081450,31021,16,19,3,109.49021,18.27,1463
6652,51227,BD1C8CAB0CA377D9350002A865081450,30251,22,23,1,109.50611,18.26653,1512
6653,51230,ABCD0851CC1C78BCD7AF6DBDF2F5DE49,60524,0,5,5,109.42951,18.28993,1216
6654,51231,ABCD0851CC1C78BCD7AF6DBDF2F5DE49,60552,5,10,5,109.41729,18.30014,1218
6655,51232,ABCD0851CC1C78BCD7AF6DBDF2F5DE49,60524,12,14,2,109.42951,18.28993,1216
6656,51233,ABCD0851CC1C78BCD7AF6DBDF2F5DE49,30671,15,16,1,109.43611,18.30139,1268
6657,51234,ABCD0851CC1C78BCD7AF6DBDF2F5DE49,60552,16,19,3,109.41729,18.30014,1218
6658,51235,F5C95858D90175E8C584149B48249C9D,60524,0,7,7,109.42951,18.28993,1216
6659,51239,5E97A4561E11AAC4FBC53FD068EAA52B,30854,0,14,14,109.56889,18.27076,1763
6660,51240,5E97A4561E11AAC4FBC53FD068EAA52B,30531,17,18,1,109.53271,18.21472,1604
6664,51310,D68CB3826910D94323D89C47E2F5E00C,30854,11,16,5,109.56889,18.27076,1763
6665,51311,D68CB3826910D94323D89C47E2F5E00C,31561,20,21,1,109.56792,18.28479,1765
6666,51351,E83EEC0EDEADBA548B114EA601516E47,60571,0,5,5,109.50722,18.25056,1510
6667,51352,E83EEC0EDEADBA548B114EA601516E47,60291,7,13,6,109.50826,18.24639,1509
6668,51355,B643AC77F8D8498A9694D45BA8B0F75F,60631,0,17,17,109.57778,18.27583,1814
6669,51356,B643AC77F8D8498A9694D45BA8B0F75F,31561,17,20,3,109.56792,18.28479,1765
6670,51405,B509D6A1196DD550C311B4C425D8CCC0,38951,2,8,6,109.48097,18.28868,1416
6671,51406,B509D6A1196DD550C311B4C425D8CCC0,30971,8,12,4,109.48708,18.29319,1467
6672,51407,B509D6A1196DD550C311B4C425D8CCC0,38951,12,16,4,109.48097,18.28868,1416
6673,51408,B509D6A1196DD550C311B4C425D8CCC0,30971,16,18,2,109.48708,18.29319,1467
6674,51409,B509D6A1196DD550C311B4C425D8CCC0,38951,19,23,4,109.48097,18.28868,1416
6675,51455,CE3B82B6F005FAEB254B1A364EFB9408,60411,12,13,1,109.32514,18.30854,869
6676,51456,CE3B82B6F005FAEB254B1A364EFB9408,60614,15,17,2,109.48799,18.29521,1467
6677,51468,4968BDF068C505E078DCD9BE1053BBFB,30201,9,19,10,109.4909,18.26465,1462
6682,51510,FB917EEDD019FE7A46C7EE57314AE768,38162,18,20,2,109.43944,18.28889,1266
6683,51511,FB917EEDD019FE7A46C7EE57314AE768,31391,21,22,1,109.50382,18.24285,1508
6684,51526,5426296000364EE32711CD0E73D782C8,31071,5,7,2,109.58257,18.28458,1815
6685,51527,5426296000364EE32711CD0E73D782C8,30854,8,14,6,109.56889,18.27076,1763
6686,51535,0FCA9DC43F3306C596F52131F1C7B8CA,31471,13,15,2,109.34583,18.29563,917
6687,51536,0FCA9DC43F3306C596F52131F1C7B8CA,30581,18,23,5,109.62257,18.24951,1959
6688,51546,96E79F39E5EC731B78E83C20610BE900,30111,0,5,5,109.47583,18.30542,1419
6689,51547,96E79F39E5EC731B78E83C20610BE900,30321,8,9,1,109.49563,18.29611,1467
6690,51569,5A3AB3066996487C1CB6E18FABA628E7,60381,0,8,8,109.5241,18.22458,1605
6691,51570,5A3AB3066996487C1CB6E18FABA628E7,60054,11,12,1,109.3016,18.31229,770
6692,51571,5A3AB3066996487C1CB6E18FABA628E7,31471,13,14,1,109.34583,18.29563,917
6693,51580,4995463B780282C9C030A19D9F49AEAC,30854,11,16,5,109.56889,18.27076,1763
6694,51581,4995463B780282C9C030A19D9F49AEAC,31071,16,17,1,109.58257,18.28458,1815
6695,51582,4995463B780282C9C030A19D9F49AEAC,30421,19,22,3,109.50021,18.25861,1511
6696,51614,56DB853C0B6BC26DC3ABDBD960F52342,31021,0,6,6,109.49021,18.27,1463
6697,51615,56DB853C0B6BC26DC3ABDBD960F52342,30171,7,8,1,109.48458,18.27139,1463
6698,51620,5513A4EBEB51AF5647B29C75D8B8CC2C,30211,0,9,9,109.49882,18.23931,1508
6699,51621,5513A4EBEB51AF5647B29C75D8B8CC2C,33521,11,15,4,109.66313,18.45174,2143
6700,51622,486A78088314F236B361634EA8E4A8C3,60084,0,6,6,109.4984,18.2334,1507
6701,51623,486A78088314F236B361634EA8E4A8C3,38754,10,12,2,109.74667,18.37382,2430
6702,51737,45A4BBA7E29D98A1407820384344799B,60614,1,3,2,109.48799,18.29521,1467
6703,51738,45A4BBA7E29D98A1407820384344799B,38951,4,5,1,109.48097,18.28868,1416
6704,51739,45A4BBA7E29D98A1407820384344799B,60614,6,8,2,109.48799,18.29521,1467
6705,51740,45A4BBA7E29D98A1407820384344799B,38951,9,14,5,109.48097,18.28868,1416
6706,51741,45A4BBA7E29D98A1407820384344799B,60504,15,17,2,109.47917,18.28903,1416
6707,51742,45A4BBA7E29D98A1407820384344799B,31521,18,20,2,109.51458,18.22542,1555
6708,51743,45A4BBA7E29D98A1407820384344799B,38951,21,23,2,109.48097,18.28868,1416
6709,51744,680C3C6F27D372D5C5B42FAEAC7B1567,38251,2,8,6,109.49618,18.25493,1510
6710,51745,680C3C6F27D372D5C5B42FAEAC7B1567,31471,12,14,2,109.34583,18.29563,917
6711,51746,680C3C6F27D372D5C5B42FAEAC7B1567,30361,17,20,3,109.50347,18.24,1508
6712,51747,680C3C6F27D372D5C5B42FAEAC7B1567,30711,20,22,2,109.50271,18.25347,1510
6713,51754,996C0D9500BF90CC0E7F5A04C49A464B,39183,12,13,1,109.55542,18.28208,1715
6714,51755,996C0D9500BF90CC0E7F5A04C49A464B,31931,14,15,1,109.54771,18.29403,1667
6715,51756,996C0D9500BF90CC0E7F5A04C49A464B,39181,17,18,1,109.55153,18.28035,1715
6716,51757,996C0D9500BF90CC0E7F5A04C49A464B,31931,19,20,1,109.54771,18.29403,1667
6717,51767,DA7695571AF860EADFA185350D767F54,38141,0,17,17,109.39479,18.2916,1116
6718,51768,DA7695571AF860EADFA185350D767F54,31031,18,21,3,109.49979,18.25382,1510
6719,51769,DA7695571AF860EADFA185350D767F54,38141,22,23,1,109.39479,18.2916,1116
6720,51770,B340EDEF4A878E8DF5CBEC25E465EACE,31071,1,3,2,109.58257,18.28458,1815
6721,51771,B340EDEF4A878E8DF5CBEC25E465EACE,30854,3,21,18,109.56889,18.27076,1763
6729,51830,8A2602EE97ED1F19C3F8048B259C52D2,60381,0,7,7,109.5241,18.22458,1605
6730,51831,8A2602EE97ED1F19C3F8048B259C52D2,33051,10,14,4,109.6475,18.46618,2096
6731,51832,8A2602EE97ED1F19C3F8048B259C52D2,31521,17,19,2,109.51458,18.22542,1555
6732,51842,5A7583FE846F06DB3517F6D5D54AC2C3,31781,0,2,2,109.19847,18.2975,367
6733,51843,5A7583FE846F06DB3517F6D5D54AC2C3,31143,3,9,6,109.19986,18.29875,368
6734,51844,5A7583FE846F06DB3517F6D5D54AC2C3,60411,12,13,1,109.32514,18.30854,869
6735,51845,5A7583FE846F06DB3517F6D5D54AC2C3,60054,14,16,2,109.3016,18.31229,770
6736,51846,5A7583FE846F06DB3517F6D5D54AC2C3,31471,16,17,1,109.34583,18.29563,917
6737,51847,5A7583FE846F06DB3517F6D5D54AC2C3,60211,18,22,4,109.63549,18.26049,2011
6741,51883,662D882A6A10D0E6C3566690F0A40636,31071,16,17,1,109.58257,18.28458,1815
6742,51884,662D882A6A10D0E6C3566690F0A40636,30854,21,23,2,109.56889,18.27076,1763
6743,51893,35C6EDC8AAC6B5ABA770190223528BA2,60341,0,4,4,109.70597,18.31778,2271
6744,51894,35C6EDC8AAC6B5ABA770190223528BA2,60552,5,8,3,109.41729,18.30014,1218
6745,51895,35C6EDC8AAC6B5ABA770190223528BA2,31061,11,14,3,109.53333,18.23257,1607
6746,51908,38B4623EE00239B95DF14D8187D4B411,60331,0,6,6,109.505,18.26507,1512
6747,51909,38B4623EE00239B95DF14D8187D4B411,31781,9,11,2,109.19847,18.2975,367
6748,51910,38B4623EE00239B95DF14D8187D4B411,60054,15,16,1,109.3016,18.31229,770
6749,51911,38B4623EE00239B95DF14D8187D4B411,60331,19,23,4,109.505,18.26507,1512
6750,51923,A83D8E7E1A47FE31FB41A8731F87D76F,60381,0,8,8,109.5241,18.22458,1605
6751,51924,A83D8E7E1A47FE31FB41A8731F87D76F,31031,10,12,2,109.49979,18.25382,1510
6752,51925,A83D8E7E1A47FE31FB41A8731F87D76F,31781,13,14,1,109.19847,18.2975,367
6753,51926,A83D8E7E1A47FE31FB41A8731F87D76F,31471,15,17,2,109.34583,18.29563,917
6754,51927,A83D8E7E1A47FE31FB41A8731F87D76F,31031,20,23,3,109.49979,18.25382,1510
6759,51956,B43DB539B5964E15F0064080164C40C1,60631,1,9,8,109.57778,18.27583,1814
6760,51957,B43DB539B5964E15F0064080164C40C1,38052,10,16,6,109.62618,18.23042,1956
6761,51958,B43DB539B5964E15F0064080164C40C1,30861,17,19,2,109.52722,18.22743,1606
6762,51959,297362B848EFD355E0E96CC67D1F021F,30421,0,1,1,109.50021,18.25861,1511
6763,51960,297362B848EFD355E0E96CC67D1F021F,30421,2,6,4,109.50021,18.25861,1511
6764,51961,297362B848EFD355E0E96CC67D1F021F,30911,7,9,2,109.50493,18.26181,1511
6765,51962,297362B848EFD355E0E96CC67D1F021F,30021,10,23,13,109.12014,18.40986,86
6766,51998,C984DAF128575CB0A22AC03D6B0242E9,31031,11,14,3,109.49979,18.25382,1510
6767,51999,C984DAF128575CB0A22AC03D6B0242E9,38251,16,19,3,109.49618,18.25493,1510
6768,52044,FB69127E95B4D9EC5AF61282F8D7EEB7,31561,1,4,3,109.56792,18.28479,1765
6769,52045,FB69127E95B4D9EC5AF61282F8D7EEB7,31071,5,7,2,109.58257,18.28458,1815
6770,52046,FB69127E95B4D9EC5AF61282F8D7EEB7,30854,7,8,1,109.56889,18.27076,1763
6771,52047,FB69127E95B4D9EC5AF61282F8D7EEB7,31561,12,13,1,109.56792,18.28479,1765
6772,52048,FB69127E95B4D9EC5AF61282F8D7EEB7,30854,16,19,3,109.56889,18.27076,1763
6773,52049,E0C692116FEED9FE20A5CF7D2F4944B1,30201,13,15,2,109.4909,18.26465,1462
6774,52086,AB2757F3465D5BF12D6B9326486D6787,30854,7,9,2,109.56889,18.27076,1763
6775,52087,AB2757F3465D5BF12D6B9326486D6787,39183,11,19,8,109.55542,18.28208,1715
6776,52088,AB2757F3465D5BF12D6B9326486D6787,31071,19,20,1,109.58257,18.28458,1815
6777,52110,C1F9914EF577AE2A8300B1A3945A50FF,31561,3,7,4,109.56792,18.28479,1765
6778,52111,C1F9914EF577AE2A8300B1A3945A50FF,30854,9,10,1,109.56889,18.27076,1763
6779,52112,C1F9914EF577AE2A8300B1A3945A50FF,30851,12,13,1,109.5616,18.27396,1713
6780,52113,C1F9914EF577AE2A8300B1A3945A50FF,30084,19,20,1,109.50118,18.26972,1513
6781,52114,C1F9914EF577AE2A8300B1A3945A50FF,30851,21,23,2,109.5616,18.27396,1713
6782,52115,44F505B3929E26B4B29F00CC284F3084,30854,15,16,1,109.56889,18.27076,1763
6783,52116,44F505B3929E26B4B29F00CC284F3084,31071,18,20,2,109.58257,18.28458,1815
6784,52117,44F505B3929E26B4B29F00CC284F3084,30854,20,23,3,109.56889,18.27076,1763
6785,52142,86C0171C8311911DC85F52F1754351D5,31461,0,2,2,109.5091,18.25389,1510
6786,52143,86C0171C8311911DC85F52F1754351D5,39154,4,5,1,109.50201,18.25681,1511
6787,52144,86C0171C8311911DC85F52F1754351D5,30771,7,8,1,109.49938,18.26042,1511
6788,52145,86C0171C8311911DC85F52F1754351D5,30021,11,23,12,109.12014,18.40986,86
6789,52150,1CFC708F68A59EF527E459C034E07554,30531,0,12,12,109.53271,18.21472,1604
6790,52190,4B573FBC218CB9A5C892E803644339BF,30241,10,11,1,109.26174,18.3275,622
6791,52191,4B573FBC218CB9A5C892E803644339BF,31471,13,15,2,109.34583,18.29563,917
6792,52199,E610935782979ECFD62FB0099155ECBC,31031,18,20,2,109.49979,18.25382,1510
6793,52200,E610935782979ECFD62FB0099155ECBC,60524,22,23,1,109.42951,18.28993,1216
6794,52259,F605546ADA1ADB3E2AF3E74D19682812,60371,0,2,2,109.53063,18.30056,1618
6795,52260,F605546ADA1ADB3E2AF3E74D19682812,60221,3,22,19,109.52569,18.29188,1616
6796,52270,4587E26C00C36D3FE7633B1B02F6A233,60661,10,19,9,109.548,18.2377,1657
6801,52303,0D4EC220235B9B6AB88032F5B2A0499A,31701,18,20,2,109.44132,18.28833,1266
6802,52304,0D4EC220235B9B6AB88032F5B2A0499A,31431,20,21,1,109.44639,18.29042,1316
6803,52329,BE8220A49F1231C0A022F4AA2075503E,60381,18,19,1,109.5241,18.22458,1605
6804,52330,BE8220A49F1231C0A022F4AA2075503E,31071,21,22,1,109.58257,18.28458,1815
6805,52410,E191BF114A3C2277CB7C3323BAA13F43,30854,6,11,5,109.56889,18.27076,1763
6806,52411,E191BF114A3C2277CB7C3323BAA13F43,38013,12,13,1,109.49514,18.21951,1454
6807,52427,3379F8CA3C60221B34F1581AF646427C,39111,0,10,10,109.5191,18.22597,1555
6808,52428,3379F8CA3C60221B34F1581AF646427C,30201,12,13,1,109.4909,18.26465,1462
6809,52429,3379F8CA3C60221B34F1581AF646427C,30971,14,17,3,109.48708,18.29319,1467
6810,52430,3379F8CA3C60221B34F1581AF646427C,38951,17,23,6,109.48097,18.28868,1416
6811,52445,187F8A9110396785A2F66708CAB2E68C,60221,2,11,9,109.52569,18.29188,1616
6812,52446,187F8A9110396785A2F66708CAB2E68C,30854,14,15,1,109.56889,18.27076,1763
6813,52447,187F8A9110396785A2F66708CAB2E68C,31521,17,23,6,109.51458,18.22542,1555
6814,52454,A68637AA89BD62624E677D9E66C32FAD,30161,0,10,10,109.50042,18.24389,1508
6815,52455,A68637AA89BD62624E677D9E66C32FAD,60261,12,14,2,109.44326,18.3075,1319
6816,52456,A68637AA89BD62624E677D9E66C32FAD,30361,15,16,1,109.50347,18.24,1508
6817,52457,A68637AA89BD62624E677D9E66C32FAD,30161,16,18,2,109.50042,18.24389,1508
6818,52458,A68637AA89BD62624E677D9E66C32FAD,31031,19,20,1,109.49979,18.25382,1510
6819,52459,A68637AA89BD62624E677D9E66C32FAD,31391,20,22,2,109.50382,18.24285,1508
6823,52506,36DE5DE7D024FC0D4AA8374BBC02FD61,30271,0,8,8,109.49132,18.23153,1456
6824,52507,36DE5DE7D024FC0D4AA8374BBC02FD61,30211,9,10,1,109.49882,18.23931,1508
6829,52628,2576A40187A845D7B849E820F16B3DB1,31071,3,4,1,109.58257,18.28458,1815
6830,52629,2576A40187A845D7B849E820F16B3DB1,30854,4,9,5,109.56889,18.27076,1763
6831,52630,2576A40187A845D7B849E820F16B3DB1,31071,9,15,6,109.58257,18.28458,1815
6832,52631,2576A40187A845D7B849E820F16B3DB1,31561,16,18,2,109.56792,18.28479,1765
6833,52632,2576A40187A845D7B849E820F16B3DB1,30854,18,20,2,109.56889,18.27076,1763
6834,52636,EE972DDDB0EBA2B6E0C8E188BA31FBAC,31231,1,7,6,109.42597,18.29292,1217
6835,52637,EE972DDDB0EBA2B6E0C8E188BA31FBAC,30731,9,11,2,109.50944,18.22306,1555
6836,52638,EE972DDDB0EBA2B6E0C8E188BA31FBAC,33051,14,15,1,109.6475,18.46618,2096
6837,52641,90B0A60855A43B2DB99A0964CE51D3AF,30854,14,15,1,109.56889,18.27076,1763
6838,52642,90B0A60855A43B2DB99A0964CE51D3AF,31071,20,21,1,109.58257,18.28458,1815
6839,52653,2F6227BE52214F56DC5C7B0F02022EE3,39131,0,8,8,109.2066,18.29639,417
6840,52657,5D4C3826131546B88608CD2FD019690E,31061,15,16,1,109.53333,18.23257,1607
6841,52658,5D4C3826131546B88608CD2FD019690E,60381,18,20,2,109.5241,18.22458,1605
6846,52747,DF726AC992EA795A98DE4DF26D62B584,31521,0,7,7,109.51458,18.22542,1555
6847,52748,DF726AC992EA795A98DE4DF26D62B584,31781,8,12,4,109.19847,18.2975,367
6848,52749,DF726AC992EA795A98DE4DF26D62B584,31471,13,14,1,109.34583,18.29563,917
6849,52750,DF726AC992EA795A98DE4DF26D62B584,60381,18,19,1,109.5241,18.22458,1605
6850,52751,DF726AC992EA795A98DE4DF26D62B584,31521,19,22,3,109.51458,18.22542,1555
6851,52783,0D3DA8126B134D203BB35373EAFFB116,31071,0,5,5,109.58257,18.28458,1815
6852,52784,0D3DA8126B134D203BB35373EAFFB116,30854,8,13,5,109.56889,18.27076,1763
6853,52785,0D3DA8126B134D203BB35373EAFFB116,31071,17,19,2,109.58257,18.28458,1815
6854,52786,0D3DA8126B134D203BB35373EAFFB116,30854,20,21,1,109.56889,18.27076,1763
6855,52787,0D3DA8126B134D203BB35373EAFFB116,31071,21,23,2,109.58257,18.28458,1815
6856,52813,97DFCEF20461204135ADC6D971200EB4,60341,20,21,1,109.70597,18.31778,2271
6864,52893,E1E11838338C82F354BD58BE0CE18B02,30661,0,14,14,109.37028,18.24361,1008
6865,52894,E1E11838338C82F354BD58BE0CE18B02,31031,16,19,3,109.49979,18.25382,1510
6866,52895,E1E11838338C82F354BD58BE0CE18B02,31231,20,22,2,109.42597,18.29292,1217
6867,52915,B2945CAC16CB15B397E519AE18D7E012,31951,10,18,8,109.52174,18.30299,1568
6868,52923,A9FCE0049DB44FE004EAFBF5B783F4A5,31945,2,8,6,109.58021,18.29403,1817
6869,52924,A9FCE0049DB44FE004EAFBF5B783F4A5,30854,10,18,8,109.56889,18.27076,1763
6876,53033,E5A756A7B211F9CDD28913639DA08B67,38331,0,1,1,109.62465,18.22736,1956
6877,53035,E5A756A7B211F9CDD28913639DA08B67,38052,7,10,3,109.62618,18.23042,1956
6878,53036,E5A756A7B211F9CDD28913639DA08B67,38331,10,16,6,109.62465,18.22736,1956
6879,53037,E5A756A7B211F9CDD28913639DA08B67,30361,17,19,2,109.50347,18.24,1508
6880,53038,E5A756A7B211F9CDD28913639DA08B67,38052,20,23,3,109.62618,18.23042,1956
6881,53055,DF03FBE0214EA22180A936A96E104200,60381,13,15,2,109.5241,18.22458,1605
6885,53092,62710F810F76361D1B8C4EDC4D8736B2,31471,13,14,1,109.34583,18.29563,917
6886,53093,62710F810F76361D1B8C4EDC4D8736B2,60221,18,21,3,109.52569,18.29188,1616
6887,53094,62710F810F76361D1B8C4EDC4D8736B2,30341,21,22,1,109.3625,18.29167,966
6888,53100,015CDEB9169BCE5537ABAE49B6A63F2B,31071,0,7,7,109.58257,18.28458,1815
6889,53101,015CDEB9169BCE5537ABAE49B6A63F2B,38132,11,13,2,109.64632,18.23417,2057
6890,53102,015CDEB9169BCE5537ABAE49B6A63F2B,38271,14,15,1,109.62632,18.23049,1956
6898,53162,ED11B367500D0FBFDAB3E55D1F336A82,30661,13,14,1,109.37028,18.24361,1008
6899,53163,ED11B367500D0FBFDAB3E55D1F336A82,60321,18,23,5,109.63611,18.24306,2008
6904,53180,BE586ACB441383CC10D7CF3923850B73,31931,1,2,1,109.54771,18.29403,1667
6905,53181,BE586ACB441383CC10D7CF3923850B73,60371,2,5,3,109.53063,18.30056,1618
6906,53182,BE586ACB441383CC10D7CF3923850B73,31931,6,14,8,109.54771,18.29403,1667
6907,53183,BE586ACB441383CC10D7CF3923850B73,60371,14,16,2,109.53063,18.30056,1618
6908,53184,BE586ACB441383CC10D7CF3923850B73,31931,18,22,4,109.54771,18.29403,1667
6909,53200,C874B49FDD8AB3F57E7187DFACBAD030,60054,15,17,2,109.3016,18.31229,770
6910,53201,C874B49FDD8AB3F57E7187DFACBAD030,30211,21,23,2,109.49882,18.23931,1508
6911,53233,67E12DC002DA6B0CA8CA5CAEEC84ACCD,60321,0,9,9,109.63611,18.24306,2008
6912,53234,67E12DC002DA6B0CA8CA5CAEEC84ACCD,60614,13,16,3,109.48799,18.29521,1467
6913,53252,77410BDA5A40A13509119785FF70899D,31321,16,17,1,109.63799,18.23201,2007
6914,53253,77410BDA5A40A13509119785FF70899D,38094,20,23,3,109.45403,18.28778,1316
6921,53272,8B167331F8E78254A4CBA6A89A1236BC,60524,0,13,13,109.42951,18.28993,1216
6922,53273,8B167331F8E78254A4CBA6A89A1236BC,60401,17,18,1,109.47444,18.27583,1414
6926,53292,813E2F35830EA7BC497F7B8897EB64FA,38871,0,8,8,109.44681,18.28625,1316
6927,53293,813E2F35830EA7BC497F7B8897EB64FA,31701,8,12,4,109.44132,18.28833,1266
6928,53294,813E2F35830EA7BC497F7B8897EB64FA,31181,12,13,1,109.50382,18.24813,1509
6929,53295,813E2F35830EA7BC497F7B8897EB64FA,31701,15,18,3,109.44132,18.28833,1266
6937,53354,0B2CDE43D7DE290E07FF365A2D22E5DE,30854,16,22,6,109.56889,18.27076,1763
6938,53355,0B2CDE43D7DE290E07FF365A2D22E5DE,30232,22,23,1,109.6191,18.31701,1971
6939,53359,934029FB5F97BCE114EDCE88F0393A63,30854,12,23,11,109.56889,18.27076,1763
6944,53378,96F98526707B06BE1263CCD4F72E07A1,30854,14,16,2,109.56889,18.27076,1763
6945,53379,96F98526707B06BE1263CCD4F72E07A1,31321,18,19,1,109.63799,18.23201,2007
6946,53380,96F98526707B06BE1263CCD4F72E07A1,31945,21,22,1,109.58021,18.29403,1817
6954,53472,115C807365610875A0C78CE0F5727351,30361,0,10,10,109.50347,18.24,1508
6955,53473,115C807365610875A0C78CE0F5727351,38315,12,15,3,109.48979,18.29764,1467
6965,53531,53490AD77ACCA93C3ED0F3DE79CA488B,31071,8,9,1,109.58257,18.28458,1815
6966,53532,53490AD77ACCA93C3ED0F3DE79CA488B,30854,10,18,8,109.56889,18.27076,1763
6967,53533,53490AD77ACCA93C3ED0F3DE79CA488B,31071,21,23,2,109.58257,18.28458,1815
6976,53587,C75C3F9BB96630EE8B7793004C08C0A4,31181,0,8,8,109.50382,18.24813,1509
6977,53588,C75C3F9BB96630EE8B7793004C08C0A4,39183,10,19,9,109.55542,18.28208,1715
6978,53589,C75C3F9BB96630EE8B7793004C08C0A4,31021,21,23,2,109.49021,18.27,1463
6979,53627,6E2021B014C4D0B652A2E4FE8D2CF038,31071,0,14,14,109.58257,18.28458,1815
6980,53628,6E2021B014C4D0B652A2E4FE8D2CF038,30854,17,20,3,109.56889,18.27076,1763
6981,53629,9C1407835BC54BEBDB541F52E1DA1820,61011,0,5,5,109.60653,18.19076,1900
6982,53631,9C1407835BC54BEBDB541F52E1DA1820,61011,22,23,1,109.60653,18.19076,1900
6983,53737,C162E20472DBB598395501A28AA53C86,31671,0,7,7,109.38965,18.29813,1068
6984,53738,C162E20472DBB598395501A28AA53C86,60621,9,10,1,109.48354,18.27451,1464
6985,53739,C162E20472DBB598395501A28AA53C86,38157,12,15,3,109.51483,18.26958,1563
6986,53740,C162E20472DBB598395501A28AA53C86,38185,17,18,1,109.51333,18.27347,1563
6987,53741,C162E20472DBB598395501A28AA53C86,60261,21,23,2,109.44326,18.3075,1319
6988,53762,ECB0D6F4F8CE3A022BB643A50974CBE5,31721,21,23,2,109.67938,18.24014,2158
6989,53792,725878F92DD1E911C97E4FFA084F4E39,38951,0,8,8,109.48097,18.28868,1416
6990,53793,725878F92DD1E911C97E4FFA084F4E39,30971,8,12,4,109.48708,18.29319,1467
6991,53794,725878F92DD1E911C97E4FFA084F4E39,38951,13,18,5,109.48097,18.28868,1416
6992,53795,725878F92DD1E911C97E4FFA084F4E39,30971,18,21,3,109.48708,18.29319,1467
6993,53796,725878F92DD1E911C97E4FFA084F4E39,38951,21,23,2,109.48097,18.28868,1416
6994,53839,EC2E5F212996789448E1A244BC83F4F2,38127,20,21,1,109.50833,18.27222,1513
6995,53863,8799356B7181F28146A203E5F86C52F0,31351,0,8,8,109.4959,18.28417,1465
6996,53864,8799356B7181F28146A203E5F86C52F0,38834,9,17,8,109.47639,18.21146,1403
6997,53870,680970852212DD0BF6E2D40630BA722B,31431,0,13,13,109.44639,18.29042,1316
6998,53871,680970852212DD0BF6E2D40630BA722B,60241,14,15,1,109.53319,18.28667,1616
6999,53872,680970852212DD0BF6E2D40630BA722B,31571,15,17,2,109.61563,18.23326,1957
7000,53873,680970852212DD0BF6E2D40630BA722B,60041,21,23,2,109.39889,18.31944,1121
7001,53881,45729A78C6274EF974E0AECB4805EEA8,30181,0,8,8,109.51597,18.23313,1557
7002,53882,45729A78C6274EF974E0AECB4805EEA8,31031,9,11,2,109.49979,18.25382,1510
7003,53883,45729A78C6274EF974E0AECB4805EEA8,30181,13,14,1,109.51597,18.23313,1557
7004,53884,45729A78C6274EF974E0AECB4805EEA8,38754,15,17,2,109.74667,18.37382,2430
7005,53885,45729A78C6274EF974E0AECB4805EEA8,30181,20,23,3,109.51597,18.23313,1557
7006,53888,2091DB2ACA69B10ADE950A23CC278A98,31431,0,2,2,109.44639,18.29042,1316
7007,53889,2091DB2ACA69B10ADE950A23CC278A98,30761,2,3,1,109.45201,18.3,1318
7008,53890,2091DB2ACA69B10ADE950A23CC278A98,30451,4,5,1,109.1791,18.36229,278
7009,53891,2091DB2ACA69B10ADE950A23CC278A98,31431,8,19,11,109.44639,18.29042,1316
7010,53892,2091DB2ACA69B10ADE950A23CC278A98,31121,20,22,2,109.16292,18.37063,230
7011,53895,986F83A7E11B8AB62EA723FFB84474AB,30771,0,6,6,109.49938,18.26042,1511
7015,53938,2FE0F3A82C27452F04A6B927F514EFA7,31551,2,10,8,109.55868,18.24222,1708
7016,53939,2FE0F3A82C27452F04A6B927F514EFA7,31554,11,23,12,109.55521,18.2459,1709
7017,53959,000584B3023702F3E9DDF521B1C35B1A,31071,1,7,6,109.58257,18.28458,1815
7018,53960,000584B3023702F3E9DDF521B1C35B1A,30854,10,11,1,109.56889,18.27076,1763
7019,53992,A83913B9ADE36A68ACBE4A33FF9BCCC8,30771,0,8,8,109.49938,18.26042,1511
7020,54006,55FA72F7A9567EE8C2569F2A3640F92B,31931,12,13,1,109.54771,18.29403,1667
7021,54007,55FA72F7A9567EE8C2569F2A3640F92B,39181,14,17,3,109.55153,18.28035,1715
7022,54008,55FA72F7A9567EE8C2569F2A3640F92B,60371,20,23,3,109.53063,18.30056,1618
7023,54009,EAECAD6795CCC08874248CEF19AA1A37,31231,0,7,7,109.42597,18.29292,1217
7024,54010,EAECAD6795CCC08874248CEF19AA1A37,31145,10,11,1,109.20431,18.30479,369
7025,54011,EAECAD6795CCC08874248CEF19AA1A37,60054,16,17,1,109.3016,18.31229,770
7026,54012,EAECAD6795CCC08874248CEF19AA1A37,31231,19,21,2,109.42597,18.29292,1217
7027,54028,C57035AEBF062E3859D2B5CF6DDF4DF1,60391,0,10,10,109.47667,18.28757,1416
7028,54029,C57035AEBF062E3859D2B5CF6DDF4DF1,60391,12,16,4,109.47667,18.28757,1416
7029,54030,C57035AEBF062E3859D2B5CF6DDF4DF1,60381,19,21,2,109.5241,18.22458,1605
7030,54050,15FA33D999B0EB11F94D5A6342781D57,38754,14,15,1,109.74667,18.37382,2430
7031,54051,15FA33D999B0EB11F94D5A6342781D57,39091,17,18,1,109.50097,18.25222,1510
7032,54052,15FA33D999B0EB11F94D5A6342781D57,31071,20,21,1,109.58257,18.28458,1815
7033,54085,E34FF61340C5B86CF9FD0AD454D26266,60241,12,13,1,109.53319,18.28667,1616
7034,54086,E34FF61340C5B86CF9FD0AD454D26266,60331,17,23,6,109.505,18.26507,1512
7035,54094,847C24726A64F90DD9FA53C8F0C0414F,31145,10,11,1,109.20431,18.30479,369
7036,54151,1122041491C04B199A15F6E1E401D68F,30461,0,16,16,109.5116,18.26313,1562
7037,54152,1122041491C04B199A15F6E1E401D68F,60281,16,22,6,109.51743,18.25924,1561
7038,54158,A32249CDCFA0D3FFE2AE1D7FEF6BE36F,30721,0,7,7,109.51597,18.28257,1565
7039,54159,A32249CDCFA0D3FFE2AE1D7FEF6BE36F,38121,8,10,2,109.51361,18.27813,1564
7040,54160,A32249CDCFA0D3FFE2AE1D7FEF6BE36F,30854,12,13,1,109.56889,18.27076,1763
7041,54161,A32249CDCFA0D3FFE2AE1D7FEF6BE36F,38121,15,20,5,109.51361,18.27813,1564
7042,54162,A32249CDCFA0D3FFE2AE1D7FEF6BE36F,30721,21,23,2,109.51597,18.28257,1565
7043,54202,5B655911B80C25070CDB76D312753BF6,30854,9,10,1,109.56889,18.27076,1763
7044,54203,5B655911B80C25070CDB76D312753BF6,31071,12,18,6,109.58257,18.28458,1815
7045,54234,C9B3A6667B962D267CA332A6E590E095,31251,0,8,8,109.18528,18.2975,317
7046,54235,C9B3A6667B962D267CA332A6E590E095,31411,11,13,2,109.5016,18.23576,1507
7047,54236,C9B3A6667B962D267CA332A6E590E095,31206,14,16,2,109.50819,18.23549,1507
7048,54237,C9B3A6667B962D267CA332A6E590E095,30571,17,18,1,109.50243,18.21861,1504
7049,54238,C9B3A6667B962D267CA332A6E590E095,38251,18,20,2,109.49618,18.25493,1510
7050,54239,C9B3A6667B962D267CA332A6E590E095,31041,21,23,2,109.50278,18.23701,1507
7055,54259,51061B3DE820AF1C1C713EF684728003,31071,0,7,7,109.58257,18.28458,1815
7056,54260,51061B3DE820AF1C1C713EF684728003,30854,7,9,2,109.56889,18.27076,1763
7057,54261,51061B3DE820AF1C1C713EF684728003,30221,10,11,1,109.57833,18.20222,1802
7058,54262,51061B3DE820AF1C1C713EF684728003,30854,15,20,5,109.56889,18.27076,1763
7059,54318,4E8D795F40D47DACACC3FDDF22027131,30921,0,13,13,109.53903,18.29451,1667
7060,54319,4E8D795F40D47DACACC3FDDF22027131,31931,16,17,1,109.54771,18.29403,1667
7061,54325,F3652FF504BC297E68234A33C1877043,30234,0,5,5,109.60681,18.29979,1918
7062,54326,F3652FF504BC297E68234A33C1877043,30854,6,19,13,109.56889,18.27076,1763
7066,54373,635914FBAF9BDB855B8CB450E2AE782A,30051,1,13,12,109.48917,18.21215,1453
7067,54374,635914FBAF9BDB855B8CB450E2AE782A,30571,13,19,6,109.50243,18.21861,1504
7068,54382,5D56123A0C68AD72DA20EA4585A51B48,60381,0,8,8,109.5241,18.22458,1605
7069,54383,5D56123A0C68AD72DA20EA4585A51B48,31861,12,14,2,109.49042,18.27549,1464
7070,54384,5D56123A0C68AD72DA20EA4585A51B48,30741,18,23,5,109.49833,18.28681,1516
7071,54404,ACC390C77025BECAF4CD259D41E8F314,30232,0,7,7,109.6191,18.31701,1971
7072,54405,ACC390C77025BECAF4CD259D41E8F314,30854,7,10,3,109.56889,18.27076,1763
7073,54406,ACC390C77025BECAF4CD259D41E8F314,30232,11,14,3,109.6191,18.31701,1971
7074,54407,ACC390C77025BECAF4CD259D41E8F314,30854,15,23,8,109.56889,18.27076,1763
7078,54456,43E035AE85036EBD9891453E9567CB81,60361,15,17,2,109.51938,18.29681,1567
7079,54457,43E035AE85036EBD9891453E9567CB81,30151,19,23,4,109.50986,18.25083,1560
7084,54533,8C2CF39A00D35EA3A7B1A771113C2AE8,31071,0,7,7,109.58257,18.28458,1815
7085,54534,8C2CF39A00D35EA3A7B1A771113C2AE8,30854,7,9,2,109.56889,18.27076,1763
7086,54535,8C2CF39A00D35EA3A7B1A771113C2AE8,38754,10,12,2,109.74667,18.37382,2430
7087,54536,8C2CF39A00D35EA3A7B1A771113C2AE8,31164,13,14,1,109.69993,18.27215,2263
7088,54537,8C2CF39A00D35EA3A7B1A771113C2AE8,60221,16,17,1,109.52569,18.29188,1616
7089,54546,FD18155FE4FC718630CE71D3DC676309,38251,0,8,8,109.49618,18.25493,1510
7090,54547,FD18155FE4FC718630CE71D3DC676309,30341,9,15,6,109.3625,18.29167,966
7091,54551,8752BC71725B50257436D50C6598F252,30854,0,6,6,109.56889,18.27076,1763
7092,54552,8752BC71725B50257436D50C6598F252,31071,7,8,1,109.58257,18.28458,1815
7093,54553,8752BC71725B50257436D50C6598F252,30854,9,12,3,109.56889,18.27076,1763
7094,54554,8752BC71725B50257436D50C6598F252,31071,12,13,1,109.58257,18.28458,1815
7095,54555,8752BC71725B50257436D50C6598F252,30854,15,18,3,109.56889,18.27076,1763
7096,54556,8752BC71725B50257436D50C6598F252,31411,19,21,2,109.5016,18.23576,1507
7097,54582,12D8E06C2EC8C969710FB791DF137B2B,33481,14,15,1,109.67278,18.41278,2187
7098,54583,12D8E06C2EC8C969710FB791DF137B2B,31071,19,23,4,109.58257,18.28458,1815
7102,54631,653802FBFFAEB319D5E2987830A7AC5C,38881,0,12,12,109.51618,18.26431,1562
7103,54632,653802FBFFAEB319D5E2987830A7AC5C,60261,13,18,5,109.44326,18.3075,1319
7104,54645,ED67941542B7BC0CBB81E45CC76BA427,38251,18,21,3,109.49618,18.25493,1510
7105,54646,189633BA4D39EBA8A203BC9E364D4B1F,38291,18,20,2,109.51618,18.24313,1558
7106,54647,189633BA4D39EBA8A203BC9E364D4B1F,30381,22,23,1,109.52521,18.24507,1609
7107,54648,300A1885BA30CEEF17B7B730D91F8A14,30151,0,8,8,109.50986,18.25083,1560
7108,54656,DC9973204E62AA99FA79F0696CF6C0F6,31945,0,2,2,109.58021,18.29403,1817
7109,54657,DC9973204E62AA99FA79F0696CF6C0F6,30232,3,5,2,109.6191,18.31701,1971
7110,54658,DC9973204E62AA99FA79F0696CF6C0F6,30854,7,14,7,109.56889,18.27076,1763
7111,54659,DC9973204E62AA99FA79F0696CF6C0F6,31071,14,15,1,109.58257,18.28458,1815
7112,54660,DC9973204E62AA99FA79F0696CF6C0F6,30854,18,20,2,109.56889,18.27076,1763
7113,54661,DC9973204E62AA99FA79F0696CF6C0F6,31945,21,23,2,109.58021,18.29403,1817
7118,54736,377A324496E54511961704972731A3D5,31821,0,7,7,109.51181,18.24924,1559
7119,54737,377A324496E54511961704972731A3D5,38121,7,8,1,109.51361,18.27813,1564
7120,54738,377A324496E54511961704972731A3D5,39111,12,14,2,109.5191,18.22597,1555
7121,54739,377A324496E54511961704972731A3D5,30711,15,17,2,109.50271,18.25347,1510
7122,54740,377A324496E54511961704972731A3D5,31261,21,23,2,109.51174,18.2466,1559
7126,54871,0E4E3873A84F880D37A184F5409B3BB0,30711,1,12,11,109.50271,18.25347,1510
7127,54872,0E4E3873A84F880D37A184F5409B3BB0,31031,13,15,2,109.49979,18.25382,1510
7128,54883,DBD4841C5E4F303F65EFFFA2DCCC9037,30611,19,20,1,109.74958,18.40188,2485
7129,54894,48C54876E17753CB38ABDB119760EED3,38361,0,7,7,109.43667,18.29201,1267
7130,54895,48C54876E17753CB38ABDB119760EED3,31781,9,11,2,109.19847,18.2975,367
7131,54896,48C54876E17753CB38ABDB119760EED3,30771,16,18,2,109.49938,18.26042,1511
7132,54897,48C54876E17753CB38ABDB119760EED3,31701,19,20,1,109.44132,18.28833,1266
7133,54898,48C54876E17753CB38ABDB119760EED3,38361,21,23,2,109.43667,18.29201,1267
7137,54923,B1CDB845FD43C065DBB8ADFB7BB832CF,60381,1,5,4,109.5241,18.22458,1605
7138,54924,B1CDB845FD43C065DBB8ADFB7BB832CF,31521,5,9,4,109.51458,18.22542,1555
7139,54925,B1CDB845FD43C065DBB8ADFB7BB832CF,31781,13,15,2,109.19847,18.2975,367
7140,54926,B1CDB845FD43C065DBB8ADFB7BB832CF,30361,18,19,1,109.50347,18.24,1508
7141,54927,B1CDB845FD43C065DBB8ADFB7BB832CF,60381,20,23,3,109.5241,18.22458,1605
7142,54938,ED6F7009636BD3F67073E899290E8706,38251,0,8,8,109.49618,18.25493,1510
7143,54939,ED6F7009636BD3F67073E899290E8706,60344,13,14,1,109.68847,18.31931,2221
7144,54940,ED6F7009636BD3F67073E899290E8706,38251,16,23,7,109.49618,18.25493,1510
7149,54966,2018AFC66B55C1596C097BE2B8C40D81,39183,3,4,1,109.55542,18.28208,1715
7150,54967,2018AFC66B55C1596C097BE2B8C40D81,30854,7,8,1,109.56889,18.27076,1763
7151,54968,2018AFC66B55C1596C097BE2B8C40D81,31071,10,14,4,109.58257,18.28458,1815
7152,54969,2018AFC66B55C1596C097BE2B8C40D81,30854,17,21,4,109.56889,18.27076,1763
7153,54970,2018AFC66B55C1596C097BE2B8C40D81,31071,21,23,2,109.58257,18.28458,1815
7154,55030,32D0EBFA645FCE8DAD65D018847E5043,30232,1,6,5,109.6191,18.31701,1971
7155,55031,32D0EBFA645FCE8DAD65D018847E5043,30854,9,11,2,109.56889,18.27076,1763
7156,55032,32D0EBFA645FCE8DAD65D018847E5043,30232,13,14,1,109.6191,18.31701,1971
7157,55033,32D0EBFA645FCE8DAD65D018847E5043,30854,19,21,2,109.56889,18.27076,1763
7158,55041,124582850E875F6ABADF3995E17B9C14,38951,0,8,8,109.48097,18.28868,1416
7159,55042,124582850E875F6ABADF3995E17B9C14,30971,9,11,2,109.48708,18.29319,1467
7160,55043,124582850E875F6ABADF3995E17B9C14,60614,12,13,1,109.48799,18.29521,1467
7161,55044,124582850E875F6ABADF3995E17B9C14,60504,18,19,1,109.47917,18.28903,1416
7162,55045,124582850E875F6ABADF3995E17B9C14,39091,20,22,2,109.50097,18.25222,1510
7163,55052,A3F1A757214C25A449688115E5C4321B,31931,0,15,15,109.54771,18.29403,1667
7164,55053,A3F1A757214C25A449688115E5C4321B,60371,16,18,2,109.53063,18.30056,1618
7165,55059,97310D96003EB3F80B00200829A6C917,30421,0,8,8,109.50021,18.25861,1511
7166,55060,97310D96003EB3F80B00200829A6C917,31781,13,14,1,109.19847,18.2975,367
7167,55061,97310D96003EB3F80B00200829A6C917,30361,16,17,1,109.50347,18.24,1508
7168,55062,97310D96003EB3F80B00200829A6C917,31534,19,21,2,109.49368,18.25806,1461
7169,55080,97D0EDC4C3991BB00D2216D455B37E1E,60491,0,2,2,109.43354,18.30847,1269
7170,55081,97D0EDC4C3991BB00D2216D455B37E1E,60421,3,4,1,109.46333,18.31743,1371
7178,55165,A5CD09962A7112EBCA0B8431614A22D0,33481,13,15,2,109.67278,18.41278,2187
7179,55166,A5CD09962A7112EBCA0B8431614A22D0,30854,17,20,3,109.56889,18.27076,1763
7183,55220,AD90E9B8415F78DBA16ADA8EB692280E,60321,0,7,7,109.63611,18.24306,2008
7184,55221,AD90E9B8415F78DBA16ADA8EB692280E,60541,11,12,1,109.4084,18.29208,1167
7185,55222,AD90E9B8415F78DBA16ADA8EB692280E,60321,16,23,7,109.63611,18.24306,2008
7186,55279,2B60907F04C29DE058B3E64B1D3B4100,31561,0,7,7,109.56792,18.28479,1765
7187,55280,2B60907F04C29DE058B3E64B1D3B4100,30854,7,13,6,109.56889,18.27076,1763
7188,55281,2B60907F04C29DE058B3E64B1D3B4100,31561,13,14,1,109.56792,18.28479,1765
7189,55282,2B60907F04C29DE058B3E64B1D3B4100,38283,16,18,2,109.62229,18.22618,1956
7190,55283,2B60907F04C29DE058B3E64B1D3B4100,31561,22,23,1,109.56792,18.28479,1765
7194,55292,8A19D38C67DEBBE2072401E23B2467C5,31161,0,10,10,109.70229,18.31361,2270
7195,55293,8A19D38C67DEBBE2072401E23B2467C5,33521,13,15,2,109.66313,18.45174,2143
7196,55294,8A19D38C67DEBBE2072401E23B2467C5,30191,20,23,3,109.50361,18.22701,1506
7197,55295,2BCFA9C4E1ED903F9FC4B4668FFF48A3,60421,0,11,11,109.46333,18.31743,1371
7198,55296,2BCFA9C4E1ED903F9FC4B4668FFF48A3,38315,14,17,3,109.48979,18.29764,1467
7199,55305,42E0A9876983C86FFFD22EE12B32D1F7,31521,0,6,6,109.51458,18.22542,1555
7200,55306,42E0A9876983C86FFFD22EE12B32D1F7,31781,8,12,4,109.19847,18.2975,367
7201,55307,42E0A9876983C86FFFD22EE12B32D1F7,31471,14,15,1,109.34583,18.29563,917
7202,55308,42E0A9876983C86FFFD22EE12B32D1F7,31521,19,22,3,109.51458,18.22542,1555
7203,55313,19DF3AF20A6216C60974B8B3423BEBC6,31021,13,15,2,109.49021,18.27,1463
7204,55314,19DF3AF20A6216C60974B8B3423BEBC6,31931,17,19,2,109.54771,18.29403,1667
7205,55315,19DF3AF20A6216C60974B8B3423BEBC6,30921,20,21,1,109.53903,18.29451,1667
7206,55329,8BB72B564DE6262BEA9209907400F565,38094,0,7,7,109.45403,18.28778,1316
7207,55330,8BB72B564DE6262BEA9209907400F565,60054,12,14,2,109.3016,18.31229,770
7208,55347,04ABA8BFD5D63DDF1B83BA0577C9019C,30854,9,17,8,109.56889,18.27076,1763
7209,55348,04ABA8BFD5D63DDF1B83BA0577C9019C,39183,17,19,2,109.55542,18.28208,1715
7210,55407,AC0E940CA4876D60068799AC7DD06B30,30161,0,6,6,109.50042,18.24389,1508
7211,55408,AC0E940CA4876D60068799AC7DD06B30,30281,7,9,2,109.50597,18.27583,1514
7212,55409,AC0E940CA4876D60068799AC7DD06B30,30051,10,11,1,109.48917,18.21215,1453
7213,55410,AC0E940CA4876D60068799AC7DD06B30,60401,15,18,3,109.47444,18.27583,1414
7214,55411,AC0E940CA4876D60068799AC7DD06B30,31391,20,23,3,109.50382,18.24285,1508
7218,55442,D4F66FB71406E4E38A7A105B0CD3164D,31031,0,6,6,109.49979,18.25382,1510
7219,55443,D4F66FB71406E4E38A7A105B0CD3164D,30711,6,22,16,109.50271,18.25347,1510
7220,55452,08A066736557478B1013C0CF834491DF,30921,0,7,7,109.53903,18.29451,1667
7221,55453,08A066736557478B1013C0CF834491DF,31931,9,17,8,109.54771,18.29403,1667
7222,55463,CE0A7F48A0786EED2BD468477FDDA0D5,31031,0,6,6,109.49979,18.25382,1510
7223,55465,CE0A7F48A0786EED2BD468477FDDA0D5,31145,13,14,1,109.20431,18.30479,369
7224,55466,CE0A7F48A0786EED2BD468477FDDA0D5,60221,18,21,3,109.52569,18.29188,1616
7228,55509,00FC332040A284DA251A8D0705989FE9,31071,0,9,9,109.58257,18.28458,1815
7229,55510,00FC332040A284DA251A8D0705989FE9,30854,9,21,12,109.56889,18.27076,1763
7230,55537,60C76AD19DF8888A84F620E94C92FF2B,60161,3,4,1,109.49174,18.26181,1461
7231,55538,60C76AD19DF8888A84F620E94C92FF2B,39151,7,9,2,109.49875,18.25097,1510
7232,55539,60C76AD19DF8888A84F620E94C92FF2B,60084,10,11,1,109.4984,18.2334,1507
7233,55540,60C76AD19DF8888A84F620E94C92FF2B,60161,11,12,1,109.49174,18.26181,1461
7234,55541,60C76AD19DF8888A84F620E94C92FF2B,30571,12,20,8,109.50243,18.21861,1504
7235,55542,60C76AD19DF8888A84F620E94C92FF2B,60231,20,21,1,109.49903,18.21972,1504
7236,55583,2981C8B3C1AD0C63670497656AA260BB,30771,19,22,3,109.49938,18.26042,1511
7237,55584,2981C8B3C1AD0C63670497656AA260BB,30721,22,23,1,109.51597,18.28257,1565
7238,55626,F6CCF646674665C449464A30D23BCEEF,30271,11,14,3,109.49132,18.23153,1456
7239,55627,F6CCF646674665C449464A30D23BCEEF,30571,18,19,1,109.50243,18.21861,1504
7240,55628,39F25FE146A03325C93C111F2A943B6C,30854,15,17,2,109.56889,18.27076,1763
7241,55629,39F25FE146A03325C93C111F2A943B6C,31071,19,21,2,109.58257,18.28458,1815
7242,55634,4E7B7A24B335C2D3B9254A6E7207B078,30651,14,17,3,109.42611,18.385,1232
7243,55635,4E7B7A24B335C2D3B9254A6E7207B078,60551,18,23,5,109.42722,18.30111,1218
7244,55690,8DAAE9387127D24D516B493EB48ABB27,39091,0,10,10,109.50097,18.25222,1510
7245,55730,1E36640BE395A4EE8CCB2697222419A5,60631,2,3,1,109.57778,18.27583,1814
7246,55731,1E36640BE395A4EE8CCB2697222419A5,31071,4,6,2,109.58257,18.28458,1815
7247,55732,1E36640BE395A4EE8CCB2697222419A5,30854,8,18,10,109.56889,18.27076,1763
7248,55733,1E36640BE395A4EE8CCB2697222419A5,38891,19,20,1,109.51486,18.24118,1558
7249,55734,1E36640BE395A4EE8CCB2697222419A5,30191,21,23,2,109.50361,18.22701,1506
7253,55754,DFFF17B7FE30E79B8AABBB5CE171272F,39183,12,14,2,109.55542,18.28208,1715
7254,55755,DFFF17B7FE30E79B8AABBB5CE171272F,31561,14,19,5,109.56792,18.28479,1765
7258,55771,97E500FACC6D356A86120D646AE5646D,38871,1,4,3,109.44681,18.28625,1316
7259,55772,97E500FACC6D356A86120D646AE5646D,30171,7,8,1,109.48458,18.27139,1463
7264,55843,765EFA3B9C0C38522A77B4DC379A88A8,30181,0,12,12,109.51597,18.23313,1557
7265,55844,765EFA3B9C0C38522A77B4DC379A88A8,60221,17,18,1,109.52569,18.29188,1616
7269,55879,5A1FDC762E3A00EF6FB4C515806ADF6A,30151,0,2,2,109.50986,18.25083,1560
7270,55880,5A1FDC762E3A00EF6FB4C515806ADF6A,31261,2,10,8,109.51174,18.2466,1559
7271,55881,5A1FDC762E3A00EF6FB4C515806ADF6A,38291,10,12,2,109.51618,18.24313,1558
7272,55882,5A1FDC762E3A00EF6FB4C515806ADF6A,31261,12,17,5,109.51174,18.2466,1559
7273,55883,5A1FDC762E3A00EF6FB4C515806ADF6A,38291,19,23,4,109.51618,18.24313,1558
7274,55903,0D69669D4DBC1CEB06269A084D86E853,60631,2,11,9,109.57778,18.27583,1814
7275,55904,0D69669D4DBC1CEB06269A084D86E853,31571,15,16,1,109.61563,18.23326,1957
7276,55905,0D69669D4DBC1CEB06269A084D86E853,30581,19,20,1,109.62257,18.24951,1959
7277,55924,03DA52CB04D303C32B3FDE6BAFCAF395,31521,10,14,4,109.51458,18.22542,1555
7278,55925,03DA52CB04D303C32B3FDE6BAFCAF395,60631,15,16,1,109.57778,18.27583,1814
7279,55926,03DA52CB04D303C32B3FDE6BAFCAF395,30854,16,17,1,109.56889,18.27076,1763
7280,55927,03DA52CB04D303C32B3FDE6BAFCAF395,31521,19,23,4,109.51458,18.22542,1555
7281,55930,82DD14B5C026D53A308B7973E7FE94EA,31061,0,7,7,109.53333,18.23257,1607
7282,55931,82DD14B5C026D53A308B7973E7FE94EA,31701,10,12,2,109.44132,18.28833,1266
7283,55935,7AD44260775546C7B79200C2095B5215,31471,15,17,2,109.34583,18.29563,917
7284,55936,7AD44260775546C7B79200C2095B5215,30661,19,22,3,109.37028,18.24361,1008
7285,55995,59CD1D4AEF7EA7DE0994909193B0D818,30681,0,8,8,109.48493,18.26917,1463
7286,55996,59CD1D4AEF7EA7DE0994909193B0D818,31801,10,12,2,109.20417,18.32118,371
7287,55997,59CD1D4AEF7EA7DE0994909193B0D818,31471,15,17,2,109.34583,18.29563,917
7288,55998,59CD1D4AEF7EA7DE0994909193B0D818,31531,18,20,2,109.49583,18.25972,1461
7289,55999,59CD1D4AEF7EA7DE0994909193B0D818,30171,21,23,2,109.48458,18.27139,1463
7293,56019,9390F3530298874939B7DDA5575429FD,30361,20,22,2,109.50347,18.24,1508
7294,56047,2B37ECAF93E1D338CBB5FDF40ACD1C13,30854,6,11,5,109.56889,18.27076,1763
7295,56048,2B37ECAF93E1D338CBB5FDF40ACD1C13,31071,11,12,1,109.58257,18.28458,1815
7296,56049,2B37ECAF93E1D338CBB5FDF40ACD1C13,30854,13,15,2,109.56889,18.27076,1763
7297,56050,2B37ECAF93E1D338CBB5FDF40ACD1C13,31071,17,19,2,109.58257,18.28458,1815
7298,56051,2B37ECAF93E1D338CBB5FDF40ACD1C13,30854,22,23,1,109.56889,18.27076,1763
7299,56056,7094512B15E4EF60EF67A3E6DEAF677A,60594,0,8,8,109.62694,18.22799,1956
7300,56057,7094512B15E4EF60EF67A3E6DEAF677A,38052,8,9,1,109.62618,18.23042,1956
7301,56058,7094512B15E4EF60EF67A3E6DEAF677A,60594,9,11,2,109.62694,18.22799,1956
7302,56059,7094512B15E4EF60EF67A3E6DEAF677A,31571,16,17,1,109.61563,18.23326,1957
7303,56060,7094512B15E4EF60EF67A3E6DEAF677A,31321,19,20,1,109.63799,18.23201,2007
7304,56061,7094512B15E4EF60EF67A3E6DEAF677A,38052,22,23,1,109.62618,18.23042,1956
7305,56092,5C5C16E98C1163D699B17F68D2A1C502,60571,0,8,8,109.50722,18.25056,1510
7306,56106,19AF0D8561DDB234E66714D4BD522678,31521,13,15,2,109.51458,18.22542,1555
7307,56107,19AF0D8561DDB234E66714D4BD522678,31521,15,21,6,109.51458,18.22542,1555
7308,56137,2C75E170FFFB8DA3468A04F9EEF0226E,30854,14,16,2,109.56889,18.27076,1763
7309,56138,2C75E170FFFB8DA3468A04F9EEF0226E,60084,19,20,1,109.4984,18.2334,1507
7313,56197,27229B6D41BD7CDDDAA38911093865DB,38085,5,15,10,109.6291,18.23625,2007
7314,56198,27229B6D41BD7CDDDAA38911093865DB,31071,18,19,1,109.58257,18.28458,1815
7315,56199,27229B6D41BD7CDDDAA38911093865DB,30854,19,22,3,109.56889,18.27076,1763
7316,56215,14F1CC63CDA098F9694EAC8584B9C7A5,31561,0,8,8,109.56792,18.28479,1765
7317,56216,14F1CC63CDA098F9694EAC8584B9C7A5,30854,10,12,2,109.56889,18.27076,1763
7318,56226,E3921F0CF54D3F02F585C6050AAAD093,60084,0,7,7,109.4984,18.2334,1507
7319,56227,E3921F0CF54D3F02F585C6050AAAD093,30854,10,11,1,109.56889,18.27076,1763
7320,56280,DC60807FE78F0A4024F6DE8DC83F5D09,60131,0,2,2,109.49819,18.24778,1509
7321,56281,DC60807FE78F0A4024F6DE8DC83F5D09,39091,3,7,4,109.50097,18.25222,1510
7322,56282,DC60807FE78F0A4024F6DE8DC83F5D09,60381,9,10,1,109.5241,18.22458,1605
7323,56283,DC60807FE78F0A4024F6DE8DC83F5D09,60131,11,12,1,109.49819,18.24778,1509
7324,56284,DC60807FE78F0A4024F6DE8DC83F5D09,39151,13,16,3,109.49875,18.25097,1510
7325,56285,DC60807FE78F0A4024F6DE8DC83F5D09,60131,16,17,1,109.49819,18.24778,1509
7326,56286,DC60807FE78F0A4024F6DE8DC83F5D09,60381,18,21,3,109.5241,18.22458,1605
7327,56287,DC60807FE78F0A4024F6DE8DC83F5D09,31031,21,23,2,109.49979,18.25382,1510
7328,56290,C8501DFE42E6954852B7593EDA5D3099,30211,13,14,1,109.49882,18.23931,1508
7329,56291,C8501DFE42E6954852B7593EDA5D3099,60361,14,16,2,109.51938,18.29681,1567
7330,56292,C8501DFE42E6954852B7593EDA5D3099,39151,18,20,2,109.49875,18.25097,1510
7331,56293,C8501DFE42E6954852B7593EDA5D3099,30731,21,23,2,109.50944,18.22306,1555
7339,56483,7C4B45B599684104AFE3AA992CD3924A,31761,0,7,7,109.60521,18.27965,1914
7340,56484,7C4B45B599684104AFE3AA992CD3924A,30811,8,9,1,109.65188,18.26257,2062
7341,56485,7C4B45B599684104AFE3AA992CD3924A,39021,11,14,3,109.40368,18.41035,1186
7342,56486,7C4B45B599684104AFE3AA992CD3924A,60381,15,17,2,109.5241,18.22458,1605
7343,56487,7C4B45B599684104AFE3AA992CD3924A,38111,21,23,2,109.52007,18.22403,1555
7344,56504,EF19CB13707D6DFCAE162877A347BCE9,31206,0,7,7,109.50819,18.23549,1507
7345,56505,EF19CB13707D6DFCAE162877A347BCE9,30361,8,10,2,109.50347,18.24,1508
7346,56506,EF19CB13707D6DFCAE162877A347BCE9,60401,14,15,1,109.47444,18.27583,1414
7347,56507,EF19CB13707D6DFCAE162877A347BCE9,60441,15,17,2,109.46792,18.28604,1366
7348,56508,EF19CB13707D6DFCAE162877A347BCE9,31206,21,23,2,109.50819,18.23549,1507
7349,56531,C34234ACF873DBD501F7188735591693,31345,0,9,9,109.39,18.29,1066
7350,56532,C34234ACF873DBD501F7188735591693,30171,11,12,1,109.48458,18.27139,1463
7351,56533,C34234ACF873DBD501F7188735591693,31345,12,14,2,109.39,18.29,1066
7352,56534,C34234ACF873DBD501F7188735591693,30361,17,19,2,109.50347,18.24,1508
7353,56535,C34234ACF873DBD501F7188735591693,31345,20,23,3,109.39,18.29,1066
7354,56536,18AAFF817ACB01445A8E56AB6C7AC8DB,30821,15,17,2,109.43681,18.33639,1274
7355,56537,18AAFF817ACB01445A8E56AB6C7AC8DB,38951,18,23,5,109.48097,18.28868,1416
7356,56565,0C3DD1EABA2D708A2506DA8150CEC148,31561,0,6,6,109.56792,18.28479,1765
7357,56566,0C3DD1EABA2D708A2506DA8150CEC148,30854,7,9,2,109.56889,18.27076,1763
7358,56567,0C3DD1EABA2D708A2506DA8150CEC148,31561,10,13,3,109.56792,18.28479,1765
7359,56568,0C3DD1EABA2D708A2506DA8150CEC148,30854,13,17,4,109.56889,18.27076,1763
7360,56569,0C3DD1EABA2D708A2506DA8150CEC148,31561,18,23,5,109.56792,18.28479,1765
7361,56580,CF339E74AE2AB11E21E4B60CD856FF52,60641,9,10,1,109.53854,18.2359,1657
7362,56581,CF339E74AE2AB11E21E4B60CD856FF52,60321,11,15,4,109.63611,18.24306,2008
7363,56593,3887FF64832E3EF638532F1D2F2E4297,60231,4,12,8,109.49903,18.21972,1504
7364,56594,3887FF64832E3EF638532F1D2F2E4297,60201,15,16,1,109.5041,18.2509,1510
7365,56615,20076B8669E5BE36124693E9782985A5,60221,16,18,2,109.52569,18.29188,1616
7366,56616,20076B8669E5BE36124693E9782985A5,31491,19,22,3,109.73042,18.38771,2382
7367,56646,588410E89DFC58F669994FE4D6BC8BEB,31951,10,16,6,109.52174,18.30299,1568
7368,56647,588410E89DFC58F669994FE4D6BC8BEB,38071,19,22,3,109.40722,18.30938,1169
7373,56664,C462628FF36F8FF2D0B7493E6DDA38BB,60411,0,1,1,109.32514,18.30854,869
7374,56665,C462628FF36F8FF2D0B7493E6DDA38BB,30661,1,10,9,109.37028,18.24361,1008
7375,56666,C462628FF36F8FF2D0B7493E6DDA38BB,60411,11,15,4,109.32514,18.30854,869
7376,56667,C462628FF36F8FF2D0B7493E6DDA38BB,30661,18,20,2,109.37028,18.24361,1008
7377,56668,C462628FF36F8FF2D0B7493E6DDA38BB,60411,22,23,1,109.32514,18.30854,869
7378,56669,19A0329D0AB44903B1CD08967E695964,30381,0,9,9,109.52521,18.24507,1609
7379,56670,19A0329D0AB44903B1CD08967E695964,30381,11,14,3,109.52521,18.24507,1609
7380,56702,08DE09BBA0A90299BFCC2039B5540121,38361,17,22,5,109.43667,18.29201,1267
7381,56703,B29F33564DDA3CFA905BF42633BA4302,60614,1,14,13,109.48799,18.29521,1467
7382,56704,B29F33564DDA3CFA905BF42633BA4302,38291,15,19,4,109.51618,18.24313,1558
7383,56705,B29F33564DDA3CFA905BF42633BA4302,31391,20,21,1,109.50382,18.24285,1508
7384,56720,4D1BB128029C55ECC42D47D6B6CF70E9,30581,0,8,8,109.62257,18.24951,1959
7385,56721,4D1BB128029C55ECC42D47D6B6CF70E9,31471,13,14,1,109.34583,18.29563,917
7386,56722,4D1BB128029C55ECC42D47D6B6CF70E9,30581,19,20,1,109.62257,18.24951,1959
7387,56723,4D1BB128029C55ECC42D47D6B6CF70E9,31571,20,23,3,109.61563,18.23326,1957
7388,56724,72839B8F6256E6FF641405D4832BF569,30854,15,17,2,109.56889,18.27076,1763
7389,56725,72839B8F6256E6FF641405D4832BF569,31071,19,22,3,109.58257,18.28458,1815
7390,56736,5EE25A6E7DD554FFDA0C9C1A504114B7,60291,0,6,6,109.50826,18.24639,1509
7391,56737,5EE25A6E7DD554FFDA0C9C1A504114B7,30221,7,16,9,109.57833,18.20222,1802
7392,56738,5EE25A6E7DD554FFDA0C9C1A504114B7,38127,18,20,2,109.50833,18.27222,1513
7393,56739,5EE25A6E7DD554FFDA0C9C1A504114B7,30221,21,23,2,109.57833,18.20222,1802
7394,56740,4BA42026831E7F4B42D17FDF4BDEE62E,31931,0,5,5,109.54771,18.29403,1667
7395,56741,4BA42026831E7F4B42D17FDF4BDEE62E,39181,7,10,3,109.55153,18.28035,1715
7410,56783,E92442C28CB44C67B1AFA3BE5AC81485,31861,0,8,8,109.49042,18.27549,1464
7411,56784,E92442C28CB44C67B1AFA3BE5AC81485,31471,9,11,2,109.34583,18.29563,917
7412,56785,E92442C28CB44C67B1AFA3BE5AC81485,31145,12,14,2,109.20431,18.30479,369
7413,56812,D1A5E6081E70F748BFD3C6895B141C01,30661,2,6,4,109.37028,18.24361,1008
7414,56813,D1A5E6081E70F748BFD3C6895B141C01,60411,6,7,1,109.32514,18.30854,869
7415,56814,D1A5E6081E70F748BFD3C6895B141C01,30661,8,10,2,109.37028,18.24361,1008
7416,56815,D1A5E6081E70F748BFD3C6895B141C01,60411,12,16,4,109.32514,18.30854,869
7417,56816,D1A5E6081E70F748BFD3C6895B141C01,30661,17,19,2,109.37028,18.24361,1008
7418,56817,D1A5E6081E70F748BFD3C6895B141C01,30241,19,20,1,109.26174,18.3275,622
7419,56818,D1A5E6081E70F748BFD3C6895B141C01,30661,21,22,1,109.37028,18.24361,1008
7424,56839,A99D0259FFF60076BAC532F5435B4CD8,31521,0,20,20,109.51458,18.22542,1555
7425,56840,A99D0259FFF60076BAC532F5435B4CD8,60381,20,23,3,109.5241,18.22458,1605
7426,56854,CFA93479DB4AE060A01F399350848C9C,31471,13,14,1,109.34583,18.29563,917
7427,56855,CFA93479DB4AE060A01F399350848C9C,31081,18,19,1,109.44639,18.30181,1318
7428,56856,CFA93479DB4AE060A01F399350848C9C,30671,20,23,3,109.43611,18.30139,1268
7432,56884,29D55E311FBB827A581F4801593055E3,31145,12,14,2,109.20431,18.30479,369
7433,56885,29D55E311FBB827A581F4801593055E3,60381,15,16,1,109.5241,18.22458,1605
7434,56886,29D55E311FBB827A581F4801593055E3,31521,17,19,2,109.51458,18.22542,1555
7435,56887,29D55E311FBB827A581F4801593055E3,60381,21,23,2,109.5241,18.22458,1605
7436,56896,E9CDFE5A4E319AABCB1BB5066094528A,38325,0,4,4,109.39792,18.2909,1116
7437,56897,E9CDFE5A4E319AABCB1BB5066094528A,38251,8,9,1,109.49618,18.25493,1510
7438,56920,4620253064DC63F203FE01AA69A2C318,31071,2,7,5,109.58257,18.28458,1815
7439,56921,4620253064DC63F203FE01AA69A2C318,30854,8,10,2,109.56889,18.27076,1763
7440,56922,4620253064DC63F203FE01AA69A2C318,31071,14,15,1,109.58257,18.28458,1815
7441,56923,4620253064DC63F203FE01AA69A2C318,30854,19,20,1,109.56889,18.27076,1763
7442,56924,4620253064DC63F203FE01AA69A2C318,31071,21,23,2,109.58257,18.28458,1815
7449,56986,D26DFF9CD872B22A8694735583552102,30201,0,6,6,109.4909,18.26465,1462
7450,56987,D26DFF9CD872B22A8694735583552102,30421,6,9,3,109.50021,18.25861,1511
7451,56988,D26DFF9CD872B22A8694735583552102,30191,9,10,1,109.50361,18.22701,1506
7452,56989,D26DFF9CD872B22A8694735583552102,31473,13,16,3,109.34792,18.29465,917
7453,56990,D26DFF9CD872B22A8694735583552102,30201,18,23,5,109.4909,18.26465,1462
7457,57033,13BAA3236560B028172DAA5EDFE7A1EF,38141,0,9,9,109.39479,18.2916,1116
7458,57034,13BAA3236560B028172DAA5EDFE7A1EF,38315,10,11,1,109.48979,18.29764,1467
7459,57043,A46BA306DAEA889FAC7ACE9E5FD6A1FF,30911,0,2,2,109.50493,18.26181,1511
7460,57044,A46BA306DAEA889FAC7ACE9E5FD6A1FF,39154,3,6,3,109.50201,18.25681,1511
7461,57045,A46BA306DAEA889FAC7ACE9E5FD6A1FF,30081,6,12,6,109.50243,18.26632,1512
7462,57046,A46BA306DAEA889FAC7ACE9E5FD6A1FF,31391,16,18,2,109.50382,18.24285,1508
7463,57047,A46BA306DAEA889FAC7ACE9E5FD6A1FF,60331,19,23,4,109.505,18.26507,1512
7464,57059,E649CF84A26278291AA1A5B5C5D01FCA,38013,12,13,1,109.49514,18.21951,1454
7465,57060,E649CF84A26278291AA1A5B5C5D01FCA,30161,16,18,2,109.50042,18.24389,1508
7466,57061,E649CF84A26278291AA1A5B5C5D01FCA,30161,20,21,1,109.50042,18.24389,1508
7467,57066,6C44DD6A334FD8F5ED58CBD00D571465,39111,0,7,7,109.5191,18.22597,1555
7468,57067,6C44DD6A334FD8F5ED58CBD00D571465,31521,8,10,2,109.51458,18.22542,1555
7469,57068,6C44DD6A334FD8F5ED58CBD00D571465,30241,12,14,2,109.26174,18.3275,622
7470,57084,C6C3BC01E542B810EF853FEEB6C81198,60361,0,15,15,109.51938,18.29681,1567
7471,57085,C6C3BC01E542B810EF853FEEB6C81198,31561,20,22,2,109.56792,18.28479,1765
7472,57109,B84B247FA61A8C12DFCCCF3C2D72006D,31071,15,16,1,109.58257,18.28458,1815
7473,57110,B84B247FA61A8C12DFCCCF3C2D72006D,30854,17,19,2,109.56889,18.27076,1763
7474,57111,B84B247FA61A8C12DFCCCF3C2D72006D,31071,19,21,2,109.58257,18.28458,1815
7475,57136,6C0260646767B781577B5B8CE2471E51,38484,0,2,2,109.53028,18.31528,1620
7476,57137,6C0260646767B781577B5B8CE2471E51,38241,3,5,2,109.54111,18.30542,1669
7477,57138,6C0260646767B781577B5B8CE2471E51,38484,7,8,1,109.53028,18.31528,1620
7478,57139,6C0260646767B781577B5B8CE2471E51,30561,10,19,9,109.52778,18.31938,1621
7479,57140,6C0260646767B781577B5B8CE2471E51,60551,19,20,1,109.42722,18.30111,1218
7480,57141,6C0260646767B781577B5B8CE2471E51,38484,21,22,1,109.53028,18.31528,1620
7481,57181,CCDAE1D93142B496C062FB4F9D78FBDF,31931,14,16,2,109.54771,18.29403,1667
7482,57182,CCDAE1D93142B496C062FB4F9D78FBDF,31031,18,19,1,109.49979,18.25382,1510
7483,57183,CCDAE1D93142B496C062FB4F9D78FBDF,31345,19,21,2,109.39,18.29,1066
7484,57184,CCDAE1D93142B496C062FB4F9D78FBDF,30661,22,23,1,109.37028,18.24361,1008
7485,57228,7D7F0272C9EBC060D193BEFCF3336FD2,60551,0,8,8,109.42722,18.30111,1218
7486,57229,7D7F0272C9EBC060D193BEFCF3336FD2,38325,10,13,3,109.39792,18.2909,1116
7487,57235,63B5E489F3503F8EC6E40A38F9D2117C,60171,9,15,6,109.51292,18.30694,1569
7488,57236,63B5E489F3503F8EC6E40A38F9D2117C,31031,19,20,1,109.49979,18.25382,1510
7489,57262,E5B8920F3E3691BAA92FB7B056CFD690,31345,0,11,11,109.39,18.29,1066
7490,57291,E8E23C329BD7B13F35CAF563AB694008,38145,0,6,6,109.378,18.2912,1066
7491,57292,E8E23C329BD7B13F35CAF563AB694008,31781,9,10,1,109.19847,18.2975,367
7492,57293,E8E23C329BD7B13F35CAF563AB694008,60054,12,14,2,109.3016,18.31229,770
7493,57294,E8E23C329BD7B13F35CAF563AB694008,60551,19,20,1,109.42722,18.30111,1218
7494,57300,CFFDD1BF3134B9FDD71614F40E1DE0FD,30854,5,6,1,109.56889,18.27076,1763
7495,57301,CFFDD1BF3134B9FDD71614F40E1DE0FD,31071,7,23,16,109.58257,18.28458,1815
7496,57302,14CF7292716F53E42F641F6D8A9AE1BB,31071,0,7,7,109.58257,18.28458,1815
7497,57303,14CF7292716F53E42F641F6D8A9AE1BB,30854,8,11,3,109.56889,18.27076,1763
7498,57304,14CF7292716F53E42F641F6D8A9AE1BB,31071,12,14,2,109.58257,18.28458,1815
7499,57305,14CF7292716F53E42F641F6D8A9AE1BB,30854,18,19,1,109.56889,18.27076,1763
7500,57306,14CF7292716F53E42F641F6D8A9AE1BB,31071,19,23,4,109.58257,18.28458,1815
7501,57324,8AABF5FDF2B06EB445749240A3894969,31071,1,5,4,109.58257,18.28458,1815
7502,57325,8AABF5FDF2B06EB445749240A3894969,30854,6,12,6,109.56889,18.27076,1763
7503,57331,6CBD210FE212796CEDBD8FF4BC0A58A4,39183,0,5,5,109.55542,18.28208,1715
7504,57332,6CBD210FE212796CEDBD8FF4BC0A58A4,31931,8,11,3,109.54771,18.29403,1667
7505,57333,6CBD210FE212796CEDBD8FF4BC0A58A4,39183,13,14,1,109.55542,18.28208,1715
7506,57334,6CBD210FE212796CEDBD8FF4BC0A58A4,31931,14,18,4,109.54771,18.29403,1667
7507,57335,6CBD210FE212796CEDBD8FF4BC0A58A4,39183,19,23,4,109.55542,18.28208,1715
7508,57379,1EC959553638CEC3C2D1606E92235CDE,30854,5,18,13,109.56889,18.27076,1763
7509,57380,1EC959553638CEC3C2D1606E92235CDE,60551,18,19,1,109.42722,18.30111,1218
7510,57381,1EC959553638CEC3C2D1606E92235CDE,30854,20,21,1,109.56889,18.27076,1763
7511,57382,FE95B3A32EFBC2838F293DF38F55FDD1,39183,0,4,4,109.55542,18.28208,1715
7512,57383,FE95B3A32EFBC2838F293DF38F55FDD1,31931,7,8,1,109.54771,18.29403,1667
7513,57384,FE95B3A32EFBC2838F293DF38F55FDD1,31561,9,10,1,109.56792,18.28479,1765
7514,57385,FE95B3A32EFBC2838F293DF38F55FDD1,39183,10,11,1,109.55542,18.28208,1715
7515,57386,FE95B3A32EFBC2838F293DF38F55FDD1,31931,12,13,1,109.54771,18.29403,1667
7516,57387,FE95B3A32EFBC2838F293DF38F55FDD1,31561,15,16,1,109.56792,18.28479,1765
7517,57388,FE95B3A32EFBC2838F293DF38F55FDD1,39183,20,22,2,109.55542,18.28208,1715
7518,57393,A515C2BA2B0AE21CADC42FF4E7FC0007,39181,0,6,6,109.55153,18.28035,1715
7519,57394,A515C2BA2B0AE21CADC42FF4E7FC0007,31931,7,8,1,109.54771,18.29403,1667
7520,57395,A515C2BA2B0AE21CADC42FF4E7FC0007,39181,11,13,2,109.55153,18.28035,1715
7521,57396,A515C2BA2B0AE21CADC42FF4E7FC0007,31931,13,14,1,109.54771,18.29403,1667
7522,57397,A515C2BA2B0AE21CADC42FF4E7FC0007,39181,18,23,5,109.55153,18.28035,1715
7526,57423,01320058954DC2695E406EF39999A80E,30711,14,18,4,109.50271,18.25347,1510
7527,57424,01320058954DC2695E406EF39999A80E,31031,20,21,1,109.49979,18.25382,1510
7528,57462,CA373FFAFD7EFAD5EEFC32965095EB00,60201,0,10,10,109.5041,18.2509,1510
7529,57463,CA373FFAFD7EFAD5EEFC32965095EB00,39151,11,13,2,109.49875,18.25097,1510
7530,57464,CA373FFAFD7EFAD5EEFC32965095EB00,30531,14,17,3,109.53271,18.21472,1604
7531,57465,CA373FFAFD7EFAD5EEFC32965095EB00,60381,18,19,1,109.5241,18.22458,1605
7532,57466,CA373FFAFD7EFAD5EEFC32965095EB00,30531,20,22,2,109.53271,18.21472,1604
7533,57478,51ED683608E55A4EDEADC423E7C7B6C3,60631,0,15,15,109.57778,18.27583,1814
7534,57479,51ED683608E55A4EDEADC423E7C7B6C3,30854,15,16,1,109.56889,18.27076,1763
7535,57485,EBB8C4DC19F3856E93F775E3331F31B3,31201,9,13,4,109.51042,18.23819,1558
7536,57486,EBB8C4DC19F3856E93F775E3331F31B3,60331,13,17,4,109.505,18.26507,1512
7537,57487,EBB8C4DC19F3856E93F775E3331F31B3,38291,20,21,1,109.51618,18.24313,1558
7538,57488,EBB8C4DC19F3856E93F775E3331F31B3,30181,21,23,2,109.51597,18.23313,1557
7539,57510,30CE72A519D49881F23B8123486E3A02,60411,13,15,2,109.32514,18.30854,869
7540,57511,30CE72A519D49881F23B8123486E3A02,31471,18,19,1,109.34583,18.29563,917
7541,57512,30CE72A519D49881F23B8123486E3A02,60411,20,22,2,109.32514,18.30854,869
7542,57529,2E380E8B6DE6DF345E034CB99A0DCDD4,38951,1,8,7,109.48097,18.28868,1416
7543,57530,2E380E8B6DE6DF345E034CB99A0DCDD4,30971,9,10,1,109.48708,18.29319,1467
7544,57531,2E380E8B6DE6DF345E034CB99A0DCDD4,38951,11,13,2,109.48097,18.28868,1416
7545,57532,2E380E8B6DE6DF345E034CB99A0DCDD4,31031,14,15,1,109.49979,18.25382,1510
7546,57533,2E380E8B6DE6DF345E034CB99A0DCDD4,30971,16,17,1,109.48708,18.29319,1467
7547,57534,2E380E8B6DE6DF345E034CB99A0DCDD4,38951,18,23,5,109.48097,18.28868,1416
7548,57543,5F14E1A15EFA1C13F8B10CBC543F107C,31701,0,10,10,109.44132,18.28833,1266
7549,57577,9A1D1AA5EE2CD156CC396C667ED8C5B9,31071,2,8,6,109.58257,18.28458,1815
7550,57578,9A1D1AA5EE2CD156CC396C667ED8C5B9,31145,12,13,1,109.20431,18.30479,369
7551,57579,9A1D1AA5EE2CD156CC396C667ED8C5B9,30854,16,17,1,109.56889,18.27076,1763
7552,57580,9A1D1AA5EE2CD156CC396C667ED8C5B9,38754,19,20,1,109.74667,18.37382,2430
7553,57581,9A1D1AA5EE2CD156CC396C667ED8C5B9,31071,21,23,2,109.58257,18.28458,1815
7554,57601,CCCCDA317D5974DB71F84A09BF6FE491,30171,1,9,8,109.48458,18.27139,1463
7555,57602,CCCCDA317D5974DB71F84A09BF6FE491,60231,13,14,1,109.49903,18.21972,1504
7556,57603,CCCCDA317D5974DB71F84A09BF6FE491,60311,17,19,2,109.52097,18.24319,1558
7557,57604,CCCCDA317D5974DB71F84A09BF6FE491,30171,22,23,1,109.48458,18.27139,1463
7558,57644,408C4FED868686E7B96333835F4C4205,31071,0,20,20,109.58257,18.28458,1815
7559,57645,408C4FED868686E7B96333835F4C4205,31031,21,22,1,109.49979,18.25382,1510
7560,57677,6FEF3B8DB206443C925B112D4BEDB705,31471,12,13,1,109.34583,18.29563,917
7561,57680,01661942FCE90AF8E243ED68E3EDED24,60221,19,20,1,109.52569,18.29188,1616
7562,57681,01661942FCE90AF8E243ED68E3EDED24,60381,22,23,1,109.5241,18.22458,1605
7563,57686,3F15A4F5D7468DD83DEF8F2C7F2C36E7,31171,0,11,11,109.50938,18.24917,1559
7564,57687,3F15A4F5D7468DD83DEF8F2C7F2C36E7,60054,13,14,1,109.3016,18.31229,770
7565,57688,3F15A4F5D7468DD83DEF8F2C7F2C36E7,30711,17,19,2,109.50271,18.25347,1510
7566,57689,3F15A4F5D7468DD83DEF8F2C7F2C36E7,31821,20,23,3,109.51181,18.24924,1559
7571,57775,D56A67341D1DA856D04BC2181FD404FB,30351,1,7,6,109.41701,18.29292,1217
7572,57776,D56A67341D1DA856D04BC2181FD404FB,60541,8,9,1,109.4084,18.29208,1167
7573,57777,D56A67341D1DA856D04BC2181FD404FB,60552,11,12,1,109.41729,18.30014,1218
7574,57778,D56A67341D1DA856D04BC2181FD404FB,60541,12,15,3,109.4084,18.29208,1167
7575,57779,D56A67341D1DA856D04BC2181FD404FB,60552,17,19,2,109.41729,18.30014,1218
7576,57780,D56A67341D1DA856D04BC2181FD404FB,60541,20,22,2,109.4084,18.29208,1167
7577,57799,8EE232244A6B7B45E2A0712998285336,60291,0,5,5,109.50826,18.24639,1509
7578,57800,8EE232244A6B7B45E2A0712998285336,31521,5,6,1,109.51458,18.22542,1555
7579,57801,8EE232244A6B7B45E2A0712998285336,31781,9,12,3,109.19847,18.2975,367
7580,57802,8EE232244A6B7B45E2A0712998285336,31471,14,15,1,109.34583,18.29563,917
7581,57803,8EE232244A6B7B45E2A0712998285336,31521,19,22,3,109.51458,18.22542,1555
7582,57806,AEA7DA64082D7A925B68DE7CFFD60270,30891,3,6,3,109.59431,18.28389,1865
7583,57807,AEA7DA64082D7A925B68DE7CFFD60270,30854,10,21,11,109.56889,18.27076,1763
7584,57811,85A7453C1FEF050DA02F4B93676DDB91,31061,15,17,2,109.53333,18.23257,1607
7585,57814,92AA74C025DCC8E1B6F69E40B85D2713,60111,0,12,12,109.72556,18.31924,2371
7586,57851,1BCCA6A55B141322D673AB5FC569497E,30201,0,1,1,109.4909,18.26465,1462
7587,57852,1BCCA6A55B141322D673AB5FC569497E,38017,2,3,1,109.49729,18.21424,1504
7588,57853,1BCCA6A55B141322D673AB5FC569497E,30421,4,14,10,109.50021,18.25861,1511
7589,57854,1BCCA6A55B141322D673AB5FC569497E,30911,15,17,2,109.50493,18.26181,1511
7590,57855,1BCCA6A55B141322D673AB5FC569497E,31861,20,23,3,109.49042,18.27549,1464
7591,57858,E4C7AB656E412C7E33554D18277C9478,30151,12,13,1,109.50986,18.25083,1560
7592,57859,E4C7AB656E412C7E33554D18277C9478,60201,17,18,1,109.5041,18.2509,1510
7593,57860,E4C7AB656E412C7E33554D18277C9478,30854,18,21,3,109.56889,18.27076,1763
7594,57918,1C1DA7B8AAE0554EF7DCF4492C7D5937,39321,0,8,8,109.529,18.2167,1604
7595,57919,1C1DA7B8AAE0554EF7DCF4492C7D5937,38111,12,13,1,109.52007,18.22403,1555
7596,57920,1C1DA7B8AAE0554EF7DCF4492C7D5937,39321,16,17,1,109.529,18.2167,1604
7597,57921,1C1DA7B8AAE0554EF7DCF4492C7D5937,60381,19,20,1,109.5241,18.22458,1605
7598,57922,1C1DA7B8AAE0554EF7DCF4492C7D5937,39321,20,22,2,109.529,18.2167,1604
7602,57961,4C809D576F7E163EA2BDA6D9D176F0A1,39151,16,18,2,109.49875,18.25097,1510
7603,57983,7F632B4875B2736225CD6D350CD25670,30854,7,12,5,109.56889,18.27076,1763
7604,57984,7F632B4875B2736225CD6D350CD25670,31071,12,13,1,109.58257,18.28458,1815
7605,57985,7F632B4875B2736225CD6D350CD25670,30854,13,21,8,109.56889,18.27076,1763
7609,58031,3BF3A82A70A93B4B71D52AA73CE29D00,39151,18,20,2,109.49875,18.25097,1510
7610,58032,3BF3A82A70A93B4B71D52AA73CE29D00,60401,21,23,2,109.47444,18.27583,1414
7611,58047,59F29435D748531F416A4F1636997ECF,31071,1,8,7,109.58257,18.28458,1815
7612,58048,59F29435D748531F416A4F1636997ECF,30854,12,23,11,109.56889,18.27076,1763
7613,58049,68DBE0B52FD0AB95F1DD47068FD7847F,60311,0,1,1,109.52097,18.24319,1558
7614,58050,68DBE0B52FD0AB95F1DD47068FD7847F,38911,2,7,5,109.51674,18.24965,1559
7615,58051,68DBE0B52FD0AB95F1DD47068FD7847F,60311,7,8,1,109.52097,18.24319,1558
7616,58052,68DBE0B52FD0AB95F1DD47068FD7847F,30181,8,12,4,109.51597,18.23313,1557
7617,58053,68DBE0B52FD0AB95F1DD47068FD7847F,38291,12,15,3,109.51618,18.24313,1558
7618,58054,68DBE0B52FD0AB95F1DD47068FD7847F,30181,16,17,1,109.51597,18.23313,1557
7619,58055,68DBE0B52FD0AB95F1DD47068FD7847F,30161,18,21,3,109.50042,18.24389,1508
7624,58145,DECB7B3FC95BFA8620EFD8D9DE328252,30854,13,14,1,109.56889,18.27076,1763
7625,58146,DECB7B3FC95BFA8620EFD8D9DE328252,31945,15,16,1,109.58021,18.29403,1817
7626,58147,DECB7B3FC95BFA8620EFD8D9DE328252,30854,19,23,4,109.56889,18.27076,1763
7627,58174,172CB232BBE684655CFBDFD055BB1CB5,30241,16,18,2,109.26174,18.3275,622
7628,58175,172CB232BBE684655CFBDFD055BB1CB5,30771,21,23,2,109.49938,18.26042,1511
7629,58191,CF1922E57BC1E2D5DC4336E820C48B77,60411,3,7,4,109.32514,18.30854,869
7630,58192,CF1922E57BC1E2D5DC4336E820C48B77,30661,8,12,4,109.37028,18.24361,1008
7631,58193,CF1922E57BC1E2D5DC4336E820C48B77,60411,12,23,11,109.32514,18.30854,869
7632,58239,5D5B29A994BBA3635D38463A75BE58F6,30201,0,14,14,109.4909,18.26465,1462
7633,58240,5D5B29A994BBA3635D38463A75BE58F6,30421,18,20,2,109.50021,18.25861,1511
7634,58306,8CA8213586CAC00347DCD29330308F27,31931,12,13,1,109.54771,18.29403,1667
7635,58307,8CA8213586CAC00347DCD29330308F27,30921,15,16,1,109.53903,18.29451,1667
7636,58325,90D91A493F9482486DCC3B27CF3F61EE,30854,6,7,1,109.56889,18.27076,1763
7637,58326,90D91A493F9482486DCC3B27CF3F61EE,31071,8,16,8,109.58257,18.28458,1815
7638,58327,90D91A493F9482486DCC3B27CF3F61EE,30854,18,19,1,109.56889,18.27076,1763
7639,58354,9BD095517798346F169AD6D898CA1A42,60361,0,6,6,109.51938,18.29681,1567
7640,58355,9BD095517798346F169AD6D898CA1A42,60221,9,10,1,109.52569,18.29188,1616
7641,58356,9BD095517798346F169AD6D898CA1A42,60361,12,14,2,109.51938,18.29681,1567
7642,58357,9BD095517798346F169AD6D898CA1A42,30321,15,16,1,109.49563,18.29611,1467
7643,58358,9BD095517798346F169AD6D898CA1A42,60361,19,23,4,109.51938,18.29681,1567
7647,58392,3720DDB8E91BF73FF05637BA50F0661B,31521,0,7,7,109.51458,18.22542,1555
7648,58393,3720DDB8E91BF73FF05637BA50F0661B,60054,11,13,2,109.3016,18.31229,770
7649,58394,3720DDB8E91BF73FF05637BA50F0661B,30361,15,17,2,109.50347,18.24,1508
7650,58395,3720DDB8E91BF73FF05637BA50F0661B,30511,17,18,1,109.51069,18.24208,1558
7651,58396,3720DDB8E91BF73FF05637BA50F0661B,31521,18,20,2,109.51458,18.22542,1555
7652,58397,3720DDB8E91BF73FF05637BA50F0661B,30511,20,23,3,109.51069,18.24208,1558
7656,58414,5482E24643B1F6F0530F56448111EE30,31701,0,8,8,109.44132,18.28833,1266
7657,58415,5482E24643B1F6F0530F56448111EE30,60054,12,14,2,109.3016,18.31229,770
7658,58416,5482E24643B1F6F0530F56448111EE30,31701,18,23,5,109.44132,18.28833,1266
7659,58432,080247CC19405F981D4BEFE1A1E9D339,39181,16,18,2,109.55153,18.28035,1715
7660,58433,080247CC19405F981D4BEFE1A1E9D339,31931,19,23,4,109.54771,18.29403,1667
7661,58489,104D50A9C0319F25E132948E6191A1E5,30271,0,1,1,109.49132,18.23153,1456
7662,58490,104D50A9C0319F25E132948E6191A1E5,30211,1,5,4,109.49882,18.23931,1508
7663,58491,104D50A9C0319F25E132948E6191A1E5,60084,7,10,3,109.4984,18.2334,1507
7664,58492,104D50A9C0319F25E132948E6191A1E5,30271,16,18,2,109.49132,18.23153,1456
7665,58493,104D50A9C0319F25E132948E6191A1E5,60161,19,23,4,109.49174,18.26181,1461
7666,58544,B023927CBEC0A8053CBDF64A5B76E367,30571,0,4,4,109.50243,18.21861,1504
7667,58545,B023927CBEC0A8053CBDF64A5B76E367,38017,4,6,2,109.49729,18.21424,1504
7668,58546,B023927CBEC0A8053CBDF64A5B76E367,31931,8,15,7,109.54771,18.29403,1667
7669,58560,9161F8CF9FE399F91F1ACEDE385ADA60,60381,16,18,2,109.5241,18.22458,1605
7670,58561,9161F8CF9FE399F91F1ACEDE385ADA60,60551,21,22,1,109.42722,18.30111,1218
7671,58587,EAD22166B32AC453F1024BFF97D86E27,39111,17,19,2,109.5191,18.22597,1555
7672,58588,EAD22166B32AC453F1024BFF97D86E27,31521,21,23,2,109.51458,18.22542,1555
7680,58637,4DE71CE1D98B4BE73B9507B19A1BFD20,39081,0,8,8,109.19382,18.29111,366
7685,58672,7803AECF4FFC2BF233E3B7ACD0D2E9F8,39181,0,6,6,109.55153,18.28035,1715
7686,58673,7803AECF4FFC2BF233E3B7ACD0D2E9F8,31931,7,9,2,109.54771,18.29403,1667
7687,58674,7803AECF4FFC2BF233E3B7ACD0D2E9F8,39181,11,12,1,109.55153,18.28035,1715
7688,58675,7803AECF4FFC2BF233E3B7ACD0D2E9F8,31931,14,15,1,109.54771,18.29403,1667
7689,58676,7803AECF4FFC2BF233E3B7ACD0D2E9F8,39181,16,23,7,109.55153,18.28035,1715
7690,58709,5A888DC7A3AA300CC584D9862C5384A1,60221,0,7,7,109.52569,18.29188,1616
7691,58710,5A888DC7A3AA300CC584D9862C5384A1,39181,9,10,1,109.55153,18.28035,1715
7692,58711,5A888DC7A3AA300CC584D9862C5384A1,39183,12,17,5,109.55542,18.28208,1715
7693,58712,5A888DC7A3AA300CC584D9862C5384A1,60371,18,20,2,109.53063,18.30056,1618
7694,58713,5A888DC7A3AA300CC584D9862C5384A1,60221,20,22,2,109.52569,18.29188,1616
7702,58780,8CF08DEE8EF83AC7333B837D79034776,30721,0,8,8,109.51597,18.28257,1565
7703,58782,8CF08DEE8EF83AC7333B837D79034776,38121,17,23,6,109.51361,18.27813,1564
7704,58831,283021500C5E323BF3C7B7DFEEB52477,30191,2,4,2,109.50361,18.22701,1506
7705,58832,283021500C5E323BF3C7B7DFEEB52477,60087,5,7,2,109.50688,18.22299,1505
7706,58833,283021500C5E323BF3C7B7DFEEB52477,30191,8,17,9,109.50361,18.22701,1506
7707,58834,283021500C5E323BF3C7B7DFEEB52477,30711,19,20,1,109.50271,18.25347,1510
7708,58835,283021500C5E323BF3C7B7DFEEB52477,30711,20,23,3,109.50271,18.25347,1510
7709,58840,866D2FF3F0433164D173837FCFC2B596,60381,20,22,2,109.5241,18.22458,1605
7710,58841,866D2FF3F0433164D173837FCFC2B596,31521,22,23,1,109.51458,18.22542,1555
7711,58907,80779C982E47128931C5479B9B9DAF80,30421,12,15,3,109.50021,18.25861,1511
7712,58908,80779C982E47128931C5479B9B9DAF80,30421,19,23,4,109.50021,18.25861,1511
7713,58943,D91289410D46E2838A7CD67AF8E32DCF,30191,9,14,5,109.50361,18.22701,1506
7714,58972,98EB4BE9AFE850A2CD3C4284738A450F,30211,2,8,6,109.49882,18.23931,1508
7715,58973,98EB4BE9AFE850A2CD3C4284738A450F,31781,11,13,2,109.19847,18.2975,367
7716,58974,98EB4BE9AFE850A2CD3C4284738A450F,31471,14,15,1,109.34583,18.29563,917
7717,58975,98EB4BE9AFE850A2CD3C4284738A450F,60221,19,20,1,109.52569,18.29188,1616
7718,59042,C358285726113434A30FBBA8DED710E7,60371,0,10,10,109.53063,18.30056,1618
7719,59043,C358285726113434A30FBBA8DED710E7,31621,10,11,1,109.51035,18.29826,1568
7720,59044,C358285726113434A30FBBA8DED710E7,30181,11,13,2,109.51597,18.23313,1557
7721,59045,C358285726113434A30FBBA8DED710E7,30741,14,15,1,109.49833,18.28681,1516
7722,59095,8621CFDF1B89A83351494618C53D033F,39181,10,12,2,109.55153,18.28035,1715
7723,59096,8621CFDF1B89A83351494618C53D033F,39181,13,14,1,109.55153,18.28035,1715
7724,59097,8621CFDF1B89A83351494618C53D033F,31071,14,16,2,109.58257,18.28458,1815
7725,59098,8621CFDF1B89A83351494618C53D033F,39181,16,18,2,109.55153,18.28035,1715
7726,59099,8621CFDF1B89A83351494618C53D033F,31071,18,20,2,109.58257,18.28458,1815
7727,59100,8621CFDF1B89A83351494618C53D033F,39181,20,21,1,109.55153,18.28035,1715
7728,59101,8621CFDF1B89A83351494618C53D033F,31071,21,23,2,109.58257,18.28458,1815
7729,59160,4E0233AEC2496361DA9DC06776993140,31761,0,6,6,109.60521,18.27965,1914
7739,59200,65DCC597AECA35C4AE4D4EA8A3F39D90,31561,0,13,13,109.56792,18.28479,1765
7740,59201,65DCC597AECA35C4AE4D4EA8A3F39D90,39183,15,16,1,109.55542,18.28208,1715
7741,59244,7BADC73A7F08A10826F163710F0B362C,60401,0,10,10,109.47444,18.27583,1414
7742,59245,7BADC73A7F08A10826F163710F0B362C,31031,11,14,3,109.49979,18.25382,1510
7743,59246,7BADC73A7F08A10826F163710F0B362C,30271,18,19,1,109.49132,18.23153,1456
7744,59247,7BADC73A7F08A10826F163710F0B362C,30161,19,20,1,109.50042,18.24389,1508
7745,59248,7BADC73A7F08A10826F163710F0B362C,60401,21,23,2,109.47444,18.27583,1414
7746,59251,6F89FC58525A7C2DD968C6BC975151FB,30731,0,7,7,109.50944,18.22306,1555
7747,59252,6F89FC58525A7C2DD968C6BC975151FB,38315,8,10,2,109.48979,18.29764,1467
7748,59285,E9F64FD67E39C3E2C15C20715338A941,31931,10,15,5,109.54771,18.29403,1667
7749,59286,E9F64FD67E39C3E2C15C20715338A941,39154,17,23,6,109.50201,18.25681,1511
7750,59320,0F7E5E1521F0A13C4E28C5BB6AF12F0A,31421,3,4,1,109.55382,18.22347,1705
7751,59321,0F7E5E1521F0A13C4E28C5BB6AF12F0A,30951,5,6,1,109.56208,18.25667,1761
7752,59322,0F7E5E1521F0A13C4E28C5BB6AF12F0A,31421,7,11,4,109.55382,18.22347,1705
7753,59323,0F7E5E1521F0A13C4E28C5BB6AF12F0A,30951,14,15,1,109.56208,18.25667,1761
7754,59324,0F7E5E1521F0A13C4E28C5BB6AF12F0A,31421,16,17,1,109.55382,18.22347,1705
7755,59325,0F7E5E1521F0A13C4E28C5BB6AF12F0A,30951,18,20,2,109.56208,18.25667,1761
7756,59326,0F7E5E1521F0A13C4E28C5BB6AF12F0A,31421,21,22,1,109.55382,18.22347,1705
7757,59365,EB316856896788EC8FD871E122E95728,30701,2,3,1,109.59313,18.32007,1871
7758,59366,EB316856896788EC8FD871E122E95728,30931,5,6,1,109.55653,18.32722,1722
7759,59367,EB316856896788EC8FD871E122E95728,31811,7,11,4,109.54201,18.31806,1671
7760,59368,EB316856896788EC8FD871E122E95728,30701,12,14,2,109.59313,18.32007,1871
7761,59369,EB316856896788EC8FD871E122E95728,31811,14,17,3,109.54201,18.31806,1671
7762,59370,EB316856896788EC8FD871E122E95728,30701,21,23,2,109.59313,18.32007,1871
7767,59440,CD3BCBAB8571FB81953C842A434E5DB8,31071,0,5,5,109.58257,18.28458,1815
7768,59441,CD3BCBAB8571FB81953C842A434E5DB8,30854,6,12,6,109.56889,18.27076,1763
7772,59541,D5ED0B56415F07DD214B0DC3E9293672,38171,19,20,1,109.50799,18.28139,1515
7773,59542,D5ED0B56415F07DD214B0DC3E9293672,30854,21,23,2,109.56889,18.27076,1763
7778,59573,706B8E0F0F5D1C9FC2F8EBB2574EE89F,30711,0,17,17,109.50271,18.25347,1510
7779,59574,706B8E0F0F5D1C9FC2F8EBB2574EE89F,30711,19,22,3,109.50271,18.25347,1510
7780,59578,D8898064D7FB8C9B8CE800B6EE2F87B6,30232,0,6,6,109.6191,18.31701,1971
7781,59579,D8898064D7FB8C9B8CE800B6EE2F87B6,30854,8,18,10,109.56889,18.27076,1763
7782,59580,D8898064D7FB8C9B8CE800B6EE2F87B6,30232,21,23,2,109.6191,18.31701,1971
7787,59595,7CEC70539F74ECB5A75A4999FD1AE35E,31864,1,7,6,109.49014,18.28333,1465
7788,59596,7CEC70539F74ECB5A75A4999FD1AE35E,30341,12,13,1,109.3625,18.29167,966
7789,59597,7CEC70539F74ECB5A75A4999FD1AE35E,60054,14,15,1,109.3016,18.31229,770
7790,59598,7CEC70539F74ECB5A75A4999FD1AE35E,60381,18,19,1,109.5241,18.22458,1605
7791,59599,7CEC70539F74ECB5A75A4999FD1AE35E,31864,20,23,3,109.49014,18.28333,1465
7792,59605,34A1BA5A97F90C4ABB34EDC7004774A9,30951,0,8,8,109.56208,18.25667,1761
7793,59606,34A1BA5A97F90C4ABB34EDC7004774A9,30851,9,18,9,109.5616,18.27396,1713
7794,59607,3C6B416FA80A7A03E14FC0317D60CB00,30854,7,9,2,109.56889,18.27076,1763
7795,59608,3C6B416FA80A7A03E14FC0317D60CB00,60631,10,11,1,109.57778,18.27583,1814
7796,59609,3C6B416FA80A7A03E14FC0317D60CB00,30854,11,23,12,109.56889,18.27076,1763
7797,59628,B164B8C0AEC0E295C9ED3DBE75B5D547,30084,0,7,7,109.50118,18.26972,1513
7798,59629,B164B8C0AEC0E295C9ED3DBE75B5D547,31851,9,10,1,109.71736,18.29007,2316
7799,59630,B164B8C0AEC0E295C9ED3DBE75B5D547,38871,13,16,3,109.44681,18.28625,1316
7800,59701,2F440A235E684ECEDD042B3100A4AE95,30031,12,13,1,109.53681,18.33313,1673
7801,59702,2F440A235E684ECEDD042B3100A4AE95,30854,17,18,1,109.56889,18.27076,1763
7802,59703,2F440A235E684ECEDD042B3100A4AE95,31071,18,20,2,109.58257,18.28458,1815
7803,59704,2F440A235E684ECEDD042B3100A4AE95,30251,21,23,2,109.50611,18.26653,1512
7811,59751,5EBEA276FCB4A19AC5C987F5C7CC8908,60504,3,6,3,109.47917,18.28903,1416
7812,59752,5EBEA276FCB4A19AC5C987F5C7CC8908,60472,6,8,2,109.46625,18.29542,1367
7813,59753,5EBEA276FCB4A19AC5C987F5C7CC8908,38361,9,11,2,109.43667,18.29201,1267
7814,59754,5EBEA276FCB4A19AC5C987F5C7CC8908,60504,13,16,3,109.47917,18.28903,1416
7815,59755,5EBEA276FCB4A19AC5C987F5C7CC8908,38361,18,20,2,109.43667,18.29201,1267
7816,59756,5EBEA276FCB4A19AC5C987F5C7CC8908,60552,20,23,3,109.41729,18.30014,1218
7817,59757,54036114D002A873652B2123255670F7,60041,0,1,1,109.39889,18.31944,1121
7818,59758,54036114D002A873652B2123255670F7,31321,3,18,15,109.63799,18.23201,2007
7819,59759,54036114D002A873652B2123255670F7,30511,22,23,1,109.51069,18.24208,1558
7827,59786,DB4DF566D4757FF3BB488F82DE126248,31561,0,13,13,109.56792,18.28479,1765
7828,59787,DB4DF566D4757FF3BB488F82DE126248,39183,16,17,1,109.55542,18.28208,1715
7829,59788,A4132C7C24D4F6CFBC6C091695995585,30631,0,8,8,109.34382,18.32778,922
7830,59789,A4132C7C24D4F6CFBC6C091695995585,31691,9,10,1,109.36604,18.3075,1019
7831,59790,A4132C7C24D4F6CFBC6C091695995585,30631,12,15,3,109.34382,18.32778,922
7832,59791,A4132C7C24D4F6CFBC6C091695995585,31691,16,17,1,109.36604,18.3075,1019
7833,59792,A4132C7C24D4F6CFBC6C091695995585,30631,19,23,4,109.34382,18.32778,922
7837,59852,4BA143AD44480D9BEACA2836C34FF531,60231,6,8,2,109.49903,18.21972,1504
7838,59853,4BA143AD44480D9BEACA2836C34FF531,60161,11,12,1,109.49174,18.26181,1461
7839,59854,4BA143AD44480D9BEACA2836C34FF531,30221,15,17,2,109.57833,18.20222,1802
7840,59855,9FA61329C09648F8617BA9BB3AD39F2D,39151,0,1,1,109.49875,18.25097,1510
7841,59856,9FA61329C09648F8617BA9BB3AD39F2D,60161,2,4,2,109.49174,18.26181,1461
7842,59857,9FA61329C09648F8617BA9BB3AD39F2D,39151,4,6,2,109.49875,18.25097,1510
7843,59858,9FA61329C09648F8617BA9BB3AD39F2D,60161,8,9,1,109.49174,18.26181,1461
7844,59859,9FA61329C09648F8617BA9BB3AD39F2D,31321,13,22,9,109.63799,18.23201,2007
7845,59896,1A1509AC6E667B603EE3773D1273B7B0,60504,14,15,1,109.47917,18.28903,1416
7846,59897,1A1509AC6E667B603EE3773D1273B7B0,30671,15,22,7,109.43611,18.30139,1268
7851,59983,BCF86295AA2D4858A2FA047D814B97DE,31071,0,7,7,109.58257,18.28458,1815
7852,59984,BCF86295AA2D4858A2FA047D814B97DE,30854,9,11,2,109.56889,18.27076,1763
7853,60004,44B51AB0086A395492A545161BBB3047,31521,16,20,4,109.51458,18.22542,1555
7854,60005,44B51AB0086A395492A545161BBB3047,60381,20,22,2,109.5241,18.22458,1605
7855,60026,B7A2800FDF738E1064EAD2A5E58F7A3C,61011,3,12,9,109.60653,18.19076,1900
7856,60028,B7A2800FDF738E1064EAD2A5E58F7A3C,61011,16,23,7,109.60653,18.19076,1900
7857,60066,4F877A4B395C9E22C3B85958392F2EAB,30051,0,9,9,109.48917,18.21215,1453
7858,60067,4F877A4B395C9E22C3B85958392F2EAB,31181,10,14,4,109.50382,18.24813,1509
7859,60068,4F877A4B395C9E22C3B85958392F2EAB,60131,14,16,2,109.49819,18.24778,1509
7860,60069,4F877A4B395C9E22C3B85958392F2EAB,30854,17,23,6,109.56889,18.27076,1763
7864,60098,CA3896FB33E9BC68E91955EDFF5D709B,60631,1,6,5,109.57778,18.27583,1814
7865,60099,CA3896FB33E9BC68E91955EDFF5D709B,30854,7,22,15,109.56889,18.27076,1763
7870,60139,DE5024DB59D5BF6AE5857A85EB7680EA,30854,13,19,6,109.56889,18.27076,1763
7871,60140,DE5024DB59D5BF6AE5857A85EB7680EA,30191,21,23,2,109.50361,18.22701,1506
7872,60145,F621296F333E8058687ACD884B135C6E,31901,1,3,2,109.68236,18.35368,2227
7873,60146,F621296F333E8058687ACD884B135C6E,30504,4,23,19,109.705,18.35368,2277
7874,60151,D97A48FFEC6EDAD02D62F5D217EED3AD,60161,1,2,1,109.49174,18.26181,1461
7875,60152,D97A48FFEC6EDAD02D62F5D217EED3AD,60401,6,10,4,109.47444,18.27583,1414
7876,60153,D97A48FFEC6EDAD02D62F5D217EED3AD,30711,12,15,3,109.50271,18.25347,1510
7877,60154,D97A48FFEC6EDAD02D62F5D217EED3AD,60161,17,19,2,109.49174,18.26181,1461
7878,60155,D97A48FFEC6EDAD02D62F5D217EED3AD,30361,19,21,2,109.50347,18.24,1508
7879,60156,D97A48FFEC6EDAD02D62F5D217EED3AD,30711,21,22,1,109.50271,18.25347,1510
7880,60166,5A7A3D5F722F0EB2695C45BF16BBC483,38157,0,6,6,109.51483,18.26958,1563
7881,60167,5A7A3D5F722F0EB2695C45BF16BBC483,60621,7,8,1,109.48354,18.27451,1464
7882,60168,5A7A3D5F722F0EB2695C45BF16BBC483,30191,10,11,1,109.50361,18.22701,1506
7883,60169,5A7A3D5F722F0EB2695C45BF16BBC483,60661,14,15,1,109.548,18.2377,1657
7884,60170,5A7A3D5F722F0EB2695C45BF16BBC483,60621,16,18,2,109.48354,18.27451,1464
7885,60171,5A7A3D5F722F0EB2695C45BF16BBC483,38157,21,23,2,109.51483,18.26958,1563
7886,60177,01282A80CFB4D1A01E953241ACFECD26,30232,0,9,9,109.6191,18.31701,1971
7887,60178,01282A80CFB4D1A01E953241ACFECD26,30854,12,23,11,109.56889,18.27076,1763
7891,60282,B3A1AC27CB357708CE63D3E4F68BF2E7,31071,2,4,2,109.58257,18.28458,1815
7892,60283,B3A1AC27CB357708CE63D3E4F68BF2E7,30854,7,9,2,109.56889,18.27076,1763
7893,60284,B3A1AC27CB357708CE63D3E4F68BF2E7,30731,9,11,2,109.50944,18.22306,1555
7894,60285,B3A1AC27CB357708CE63D3E4F68BF2E7,30854,14,16,2,109.56889,18.27076,1763
7895,60286,B3A1AC27CB357708CE63D3E4F68BF2E7,31071,17,21,4,109.58257,18.28458,1815
7896,60287,B3A1AC27CB357708CE63D3E4F68BF2E7,30854,22,23,1,109.56889,18.27076,1763
7897,60299,9FC1643F8DE11E5B5C74AA0D49F27E08,30711,11,15,4,109.50271,18.25347,1510
7898,60300,9FC1643F8DE11E5B5C74AA0D49F27E08,30681,15,18,3,109.48493,18.26917,1463
7899,60301,9FC1643F8DE11E5B5C74AA0D49F27E08,30711,18,23,5,109.50271,18.25347,1510
7900,60321,6C9D7BB79A70B1E66DD550950EE935C8,31521,0,6,6,109.51458,18.22542,1555
7901,60322,6C9D7BB79A70B1E66DD550950EE935C8,38145,7,8,1,109.378,18.2912,1066
7902,60323,6C9D7BB79A70B1E66DD550950EE935C8,60054,12,14,2,109.3016,18.31229,770
7903,60324,6C9D7BB79A70B1E66DD550950EE935C8,31521,16,23,7,109.51458,18.22542,1555
7904,60405,21801B44E160B959843F53878D5BED5F,30084,0,5,5,109.50118,18.26972,1513
7905,60406,21801B44E160B959843F53878D5BED5F,30771,5,7,2,109.49938,18.26042,1511
7906,60407,21801B44E160B959843F53878D5BED5F,31781,9,11,2,109.19847,18.2975,367
7907,60433,7264945C05DFDC18D47872D9F94F6B4F,60321,0,9,9,109.63611,18.24306,2008
7908,60445,2B8C748A18FA7D08D4335AD7C9DEF01B,30951,11,14,3,109.56208,18.25667,1761
7909,60446,2B8C748A18FA7D08D4335AD7C9DEF01B,31761,18,19,1,109.60521,18.27965,1914
7910,60471,367FD9ECC2463438ADE3989905FE5BA2,38951,0,7,7,109.48097,18.28868,1416
7911,60472,367FD9ECC2463438ADE3989905FE5BA2,30661,10,13,3,109.37028,18.24361,1008
7912,60473,367FD9ECC2463438ADE3989905FE5BA2,38951,15,23,8,109.48097,18.28868,1416
7913,60474,ED9F022E359658609122089860CD2887,38094,18,20,2,109.45403,18.28778,1316
7914,60475,ED9F022E359658609122089860CD2887,30711,21,22,1,109.50271,18.25347,1510
7915,60496,6587551DA47309E484D1302521C8D417,38275,7,12,5,109.62875,18.22938,2006
7916,60497,6587551DA47309E484D1302521C8D417,60631,13,14,1,109.57778,18.27583,1814
7917,60498,6587551DA47309E484D1302521C8D417,38275,17,22,5,109.62875,18.22938,2006
7918,60538,3977578BE56276DA0700B04B81DC1356,30851,0,6,6,109.5616,18.27396,1713
7919,60539,3977578BE56276DA0700B04B81DC1356,31561,6,20,14,109.56792,18.28479,1765
7920,60551,A77A9A9ECE9C6EA9F5E37047DE8E4E0E,39321,0,6,6,109.529,18.2167,1604
7921,60552,A77A9A9ECE9C6EA9F5E37047DE8E4E0E,38111,7,8,1,109.52007,18.22403,1555
7922,60553,A77A9A9ECE9C6EA9F5E37047DE8E4E0E,31471,10,11,1,109.34583,18.29563,917
7923,60554,A77A9A9ECE9C6EA9F5E37047DE8E4E0E,39321,14,15,1,109.529,18.2167,1604
7924,60555,A77A9A9ECE9C6EA9F5E37047DE8E4E0E,31206,17,19,2,109.50819,18.23549,1507
7925,60556,A77A9A9ECE9C6EA9F5E37047DE8E4E0E,31521,21,23,2,109.51458,18.22542,1555
7929,60620,AD608A919061B1C684914F8654FB2493,60231,16,20,4,109.49903,18.21972,1504
7930,60621,AD608A919061B1C684914F8654FB2493,60084,21,23,2,109.4984,18.2334,1507
7931,60631,0133DDFFB5CECBB261CEDEF10A82D50B,31561,0,18,18,109.56792,18.28479,1765
7932,60632,0133DDFFB5CECBB261CEDEF10A82D50B,30854,20,23,3,109.56889,18.27076,1763
7941,60669,E3AA3CC18802E5190B3AA5A477107D6A,30731,15,16,1,109.50944,18.22306,1555
7942,60670,E3AA3CC18802E5190B3AA5A477107D6A,30571,17,18,1,109.50243,18.21861,1504
7943,60683,0E129C09250C0D46273B4BD7E5225556,30151,0,6,6,109.50986,18.25083,1560
7944,60684,0E129C09250C0D46273B4BD7E5225556,38251,6,11,5,109.49618,18.25493,1510
7945,60685,0E129C09250C0D46273B4BD7E5225556,30661,14,17,3,109.37028,18.24361,1008
7946,60686,0E129C09250C0D46273B4BD7E5225556,38291,20,22,2,109.51618,18.24313,1558
7947,60687,0E129C09250C0D46273B4BD7E5225556,60201,22,23,1,109.5041,18.2509,1510
7948,60707,26A45EFEBFDCEB4A3AD081943B64403C,30631,0,4,4,109.34382,18.32778,922
7949,60708,26A45EFEBFDCEB4A3AD081943B64403C,31121,7,13,6,109.16292,18.37063,230
7950,60709,26A45EFEBFDCEB4A3AD081943B64403C,31691,18,22,4,109.36604,18.3075,1019
7951,60710,26A45EFEBFDCEB4A3AD081943B64403C,30631,22,23,1,109.34382,18.32778,922
7955,60751,3874C4E4871E18E9A94F1B63176AFE6D,31681,0,8,8,109.40396,18.29979,1168
7968,60808,B679F5300CCD6252F372C516FDDBA1B2,31181,16,17,1,109.50382,18.24813,1509
7969,60809,B679F5300CCD6252F372C516FDDBA1B2,31181,18,21,3,109.50382,18.24813,1509
7970,60810,B679F5300CCD6252F372C516FDDBA1B2,31181,21,23,2,109.50382,18.24813,1509
7971,60820,78D44725626E719FF0C0FCBC8763A33E,31561,8,12,4,109.56792,18.28479,1765
7972,60821,78D44725626E719FF0C0FCBC8763A33E,30851,16,18,2,109.5616,18.27396,1713
7973,60822,78D44725626E719FF0C0FCBC8763A33E,60221,18,19,1,109.52569,18.29188,1616
7974,60831,0E5593A90D661690BE3DAAA17AD936E2,38127,0,4,4,109.50833,18.27222,1513
7975,60832,0E5593A90D661690BE3DAAA17AD936E2,38073,8,22,14,109.40813,18.30958,1169
7985,60945,AD596F5EEC3151EE996EA9BC3D4042FE,30421,14,15,1,109.50021,18.25861,1511
7986,60946,AD596F5EEC3151EE996EA9BC3D4042FE,30421,16,18,2,109.50021,18.25861,1511
7987,60947,AD596F5EEC3151EE996EA9BC3D4042FE,38251,19,21,2,109.49618,18.25493,1510
7988,60948,AD596F5EEC3151EE996EA9BC3D4042FE,30421,21,23,2,109.50021,18.25861,1511
7989,60949,521A7ED98375837397B112E54A372514,38017,17,18,1,109.49729,18.21424,1504
7990,60950,521A7ED98375837397B112E54A372514,30191,18,20,2,109.50361,18.22701,1506
7991,60951,521A7ED98375837397B112E54A372514,31431,20,22,2,109.44639,18.29042,1316
7992,60962,EDE78B6CF45A5ED767091F2988348E3D,60381,17,19,2,109.5241,18.22458,1605
7993,60963,EDE78B6CF45A5ED767091F2988348E3D,31351,20,23,3,109.4959,18.28417,1465
7998,61013,0E1B3CFC64EBB658DA96D0DCA834701E,61011,6,20,14,109.60653,18.19076,1900
7999,61021,CB1C8502149DACE0B32B2F7416279EF2,30854,11,15,4,109.56889,18.27076,1763
8000,61022,CB1C8502149DACE0B32B2F7416279EF2,31071,16,17,1,109.58257,18.28458,1815
8001,61023,CB1C8502149DACE0B32B2F7416279EF2,31945,20,22,2,109.58021,18.29403,1817
8002,61065,D39D64452E6BBEF7B3056CA239E1B86E,30854,0,6,6,109.56889,18.27076,1763
8003,61066,D39D64452E6BBEF7B3056CA239E1B86E,31561,6,7,1,109.56792,18.28479,1765
8004,61067,D39D64452E6BBEF7B3056CA239E1B86E,30854,11,13,2,109.56889,18.27076,1763
8005,61068,D39D64452E6BBEF7B3056CA239E1B86E,31561,14,15,1,109.56792,18.28479,1765
8006,61069,D39D64452E6BBEF7B3056CA239E1B86E,30854,16,23,7,109.56889,18.27076,1763
8007,61130,1FE2866848043A2C10AD87212485FE15,31181,1,2,1,109.50382,18.24813,1509
8008,61131,1FE2866848043A2C10AD87212485FE15,31071,3,13,10,109.58257,18.28458,1815
8009,61132,1FE2866848043A2C10AD87212485FE15,30854,13,17,4,109.56889,18.27076,1763
8010,61133,1FE2866848043A2C10AD87212485FE15,31071,21,23,2,109.58257,18.28458,1815
8011,61197,CD576F1C1CDFB89E6A99A20E65927346,31561,14,18,4,109.56792,18.28479,1765
8012,61198,CD576F1C1CDFB89E6A99A20E65927346,30854,20,22,2,109.56889,18.27076,1763
8013,61234,B712327B6033C61F37801CFD6DAC08AD,30071,13,17,4,109.52819,18.30472,1619
8014,61235,B712327B6033C61F37801CFD6DAC08AD,38484,22,23,1,109.53028,18.31528,1620
8015,61267,A7B3BDD8DC79485BA41EC7F220A41345,60631,1,17,16,109.57778,18.27583,1814
8016,61268,A7B3BDD8DC79485BA41EC7F220A41345,30854,20,22,2,109.56889,18.27076,1763
8021,61280,070984703178D21DC5287E457C03691A,39181,16,18,2,109.55153,18.28035,1715
8022,61281,070984703178D21DC5287E457C03691A,39181,19,23,4,109.55153,18.28035,1715
8023,61331,225EDE82328108AFB3E7EE610CA3F074,31931,7,14,7,109.54771,18.29403,1667
8024,61332,225EDE82328108AFB3E7EE610CA3F074,60371,16,18,2,109.53063,18.30056,1618
8025,61333,225EDE82328108AFB3E7EE610CA3F074,31931,19,23,4,109.54771,18.29403,1667
8026,61344,9E2CAA912E7C38B3460AB2C8B985CA0D,30854,0,15,15,109.56889,18.27076,1763
8027,61345,9E2CAA912E7C38B3460AB2C8B985CA0D,30221,18,22,4,109.57833,18.20222,1802
8028,61358,044BFA16D267A2D3E1462E21B9443F95,38085,0,8,8,109.6291,18.23625,2007
8029,61359,044BFA16D267A2D3E1462E21B9443F95,31781,10,12,2,109.19847,18.2975,367
8030,61360,044BFA16D267A2D3E1462E21B9443F95,60441,15,17,2,109.46792,18.28604,1366
8031,61361,044BFA16D267A2D3E1462E21B9443F95,38085,21,23,2,109.6291,18.23625,2007
8032,61369,89362A3CA3AE6F5B75871F2110924F99,30851,0,6,6,109.5616,18.27396,1713
8033,61370,89362A3CA3AE6F5B75871F2110924F99,30951,8,11,3,109.56208,18.25667,1761
8034,61371,89362A3CA3AE6F5B75871F2110924F99,31551,11,13,2,109.55868,18.24222,1708
8035,61372,89362A3CA3AE6F5B75871F2110924F99,30951,13,18,5,109.56208,18.25667,1761
8036,61373,89362A3CA3AE6F5B75871F2110924F99,30851,19,23,4,109.5616,18.27396,1713
8037,61392,4E42F3C8BFACF58FB6187931BEBBDF23,38484,0,2,2,109.53028,18.31528,1620
8038,61393,4E42F3C8BFACF58FB6187931BEBBDF23,30561,2,7,5,109.52778,18.31938,1621
8039,61450,B78E7295CB13532B4E2C30EF158E297F,30854,1,4,3,109.56889,18.27076,1763
8040,61451,B78E7295CB13532B4E2C30EF158E297F,31931,4,6,2,109.54771,18.29403,1667
8041,61452,B78E7295CB13532B4E2C30EF158E297F,30854,6,7,1,109.56889,18.27076,1763
8042,61453,B78E7295CB13532B4E2C30EF158E297F,31561,16,17,1,109.56792,18.28479,1765
8043,61454,B78E7295CB13532B4E2C30EF158E297F,39183,18,19,1,109.55542,18.28208,1715
8044,61455,B78E7295CB13532B4E2C30EF158E297F,30851,22,23,1,109.5616,18.27396,1713
8045,61482,8D20E29FA3AA7FC35B155C473A656344,38111,0,6,6,109.52007,18.22403,1555
8046,61483,8D20E29FA3AA7FC35B155C473A656344,31521,8,10,2,109.51458,18.22542,1555
8047,61484,8D20E29FA3AA7FC35B155C473A656344,30361,11,13,2,109.50347,18.24,1508
8048,61485,8D20E29FA3AA7FC35B155C473A656344,38111,14,16,2,109.52007,18.22403,1555
8049,61486,8D20E29FA3AA7FC35B155C473A656344,38111,17,19,2,109.52007,18.22403,1555
8050,61487,8D20E29FA3AA7FC35B155C473A656344,31521,19,20,1,109.51458,18.22542,1555
8051,61488,8D20E29FA3AA7FC35B155C473A656344,38111,22,23,1,109.52007,18.22403,1555
8055,61560,02789FFFF0828D5AC1FE96B1CA16BB9C,38951,0,9,9,109.48097,18.28868,1416
8056,61561,02789FFFF0828D5AC1FE96B1CA16BB9C,31781,12,15,3,109.19847,18.2975,367
8057,61562,02789FFFF0828D5AC1FE96B1CA16BB9C,31471,16,18,2,109.34583,18.29563,917
8058,61563,02789FFFF0828D5AC1FE96B1CA16BB9C,38951,21,23,2,109.48097,18.28868,1416
8059,61618,A928E9F6C796FE1A60807BA003DE87BB,39183,14,16,2,109.55542,18.28208,1715
8060,61619,A928E9F6C796FE1A60807BA003DE87BB,38127,18,20,2,109.50833,18.27222,1513
8061,61620,A928E9F6C796FE1A60807BA003DE87BB,31071,21,23,2,109.58257,18.28458,1815
8065,61703,70A62761FE79F922D082380DA7747243,31561,1,3,2,109.56792,18.28479,1765
8066,61704,70A62761FE79F922D082380DA7747243,30854,4,23,19,109.56889,18.27076,1763
8067,61749,9AF351B3CC27394DFED45513F0E32162,60351,0,6,6,109.58403,18.28958,1816
8068,61750,9AF351B3CC27394DFED45513F0E32162,31061,9,10,1,109.53333,18.23257,1607
8069,61751,9AF351B3CC27394DFED45513F0E32162,30951,11,14,3,109.56208,18.25667,1761
8070,61752,3D5A468E02E58892BB875A2C29BFAFBA,60281,0,2,2,109.51743,18.25924,1561
8071,61753,3D5A468E02E58892BB875A2C29BFAFBA,38911,3,4,1,109.51674,18.24965,1559
8072,61754,3D5A468E02E58892BB875A2C29BFAFBA,31821,7,10,3,109.51181,18.24924,1559
8073,61755,3D5A468E02E58892BB875A2C29BFAFBA,31781,12,13,1,109.19847,18.2975,367
8074,61756,3D5A468E02E58892BB875A2C29BFAFBA,38291,18,20,2,109.51618,18.24313,1558
8075,61757,3D5A468E02E58892BB875A2C29BFAFBA,60573,21,22,1,109.50757,18.25299,1510
8076,61768,608A55C14BAB2A5B627ACC1F39B89FB6,31945,0,7,7,109.58021,18.29403,1817
8077,61769,608A55C14BAB2A5B627ACC1F39B89FB6,30854,7,16,9,109.56889,18.27076,1763
8078,61770,608A55C14BAB2A5B627ACC1F39B89FB6,31521,19,20,1,109.51458,18.22542,1555
8079,61843,10EBF762D28520B09848288F7052CFDE,31071,0,5,5,109.58257,18.28458,1815
8080,61844,10EBF762D28520B09848288F7052CFDE,30711,7,12,5,109.50271,18.25347,1510
8081,61845,10EBF762D28520B09848288F7052CFDE,30511,12,13,1,109.51069,18.24208,1558
8082,61846,10EBF762D28520B09848288F7052CFDE,39101,14,18,4,109.50132,18.24931,1509
8083,61847,10EBF762D28520B09848288F7052CFDE,30854,19,21,2,109.56889,18.27076,1763
8084,61848,10EBF762D28520B09848288F7052CFDE,31071,22,23,1,109.58257,18.28458,1815
8085,61903,AAB3DCB18BAF89954DC0C8A658A6D766,60231,3,6,3,109.49903,18.21972,1504
8086,61904,AAB3DCB18BAF89954DC0C8A658A6D766,30421,10,21,11,109.50021,18.25861,1511
8087,61905,AAB3DCB18BAF89954DC0C8A658A6D766,31951,21,23,2,109.52174,18.30299,1568
8091,61970,F3743A0150B752AC5079D26C89C3915F,30741,17,18,1,109.49833,18.28681,1516
8092,61971,F3743A0150B752AC5079D26C89C3915F,60614,22,23,1,109.48799,18.29521,1467
8093,61972,13166628932DF36C0AD7B1DB5811240A,60631,11,12,1,109.57778,18.27583,1814
8094,61973,13166628932DF36C0AD7B1DB5811240A,30854,15,19,4,109.56889,18.27076,1763
8095,61974,13166628932DF36C0AD7B1DB5811240A,60591,20,22,2,109.61118,18.21715,1904
8096,61991,B621E9075674E792CCB217233825F9D1,30851,1,10,9,109.5616,18.27396,1713
8097,61992,B621E9075674E792CCB217233825F9D1,60631,13,15,2,109.57778,18.27583,1814
8098,61993,B621E9075674E792CCB217233825F9D1,31571,20,23,3,109.61563,18.23326,1957
8099,62002,6DF7485545B790F22810B0EDD8F1B356,31945,0,7,7,109.58021,18.29403,1817
8100,62003,6DF7485545B790F22810B0EDD8F1B356,30854,7,9,2,109.56889,18.27076,1763
8101,62004,6DF7485545B790F22810B0EDD8F1B356,31945,12,13,1,109.58021,18.29403,1817
8102,62005,6DF7485545B790F22810B0EDD8F1B356,31071,16,17,1,109.58257,18.28458,1815
8103,62006,6DF7485545B790F22810B0EDD8F1B356,31945,19,23,4,109.58021,18.29403,1817
8104,62022,F167FEC88E6854C4E8BE1680AD709113,60054,12,13,1,109.3016,18.31229,770
8105,62023,F167FEC88E6854C4E8BE1680AD709113,38951,15,17,2,109.48097,18.28868,1416
8106,62024,F167FEC88E6854C4E8BE1680AD709113,60614,17,18,1,109.48799,18.29521,1467
8107,62025,F167FEC88E6854C4E8BE1680AD709113,38951,18,22,4,109.48097,18.28868,1416
8108,62061,07F3C4748B468EDA7E91DFDA551BC9A2,38023,0,7,7,109.37132,18.28993,1016
8109,62062,07F3C4748B468EDA7E91DFDA551BC9A2,31081,8,9,1,109.44639,18.30181,1318
8110,62063,07F3C4748B468EDA7E91DFDA551BC9A2,31571,13,14,1,109.61563,18.23326,1957
8111,62064,07F3C4748B468EDA7E91DFDA551BC9A2,31701,16,18,2,109.44132,18.28833,1266
8112,62065,07F3C4748B468EDA7E91DFDA551BC9A2,38023,21,23,2,109.37132,18.28993,1016
8113,62092,0F558B6653C655C7F0BAEA9D66B33F57,30721,0,2,2,109.51597,18.28257,1565
8114,62093,0F558B6653C655C7F0BAEA9D66B33F57,31071,4,7,3,109.58257,18.28458,1815
8115,62094,0F558B6653C655C7F0BAEA9D66B33F57,30854,9,10,1,109.56889,18.27076,1763
8116,62095,0F558B6653C655C7F0BAEA9D66B33F57,31071,10,12,2,109.58257,18.28458,1815
8117,62096,0F558B6653C655C7F0BAEA9D66B33F57,30854,12,16,4,109.56889,18.27076,1763
8118,62097,0F558B6653C655C7F0BAEA9D66B33F57,31521,19,21,2,109.51458,18.22542,1555
8119,62098,0F558B6653C655C7F0BAEA9D66B33F57,30854,22,23,1,109.56889,18.27076,1763
8124,62112,1026894DC5FF9A7FAF3A2EE28B95E239,30891,12,15,3,109.59431,18.28389,1865
8125,62113,1026894DC5FF9A7FAF3A2EE28B95E239,30854,17,23,6,109.56889,18.27076,1763
8126,62120,43F5AB52A0AF3FEB5880C6DCD16BBA02,60011,0,7,7,109.48965,18.30222,1468
8127,62121,43F5AB52A0AF3FEB5880C6DCD16BBA02,31041,9,15,6,109.50278,18.23701,1507
8128,62122,43F5AB52A0AF3FEB5880C6DCD16BBA02,60011,19,23,4,109.48965,18.30222,1468
8129,62150,85AA0B3F846A2C147D928E6A13F763A6,60071,0,8,8,109.75674,18.31583,2470
8130,62152,7421066246AAD1C230E7E2A7ADF06E9D,60631,0,6,6,109.57778,18.27583,1814
8131,62153,7421066246AAD1C230E7E2A7ADF06E9D,30854,7,11,4,109.56889,18.27076,1763
8132,62154,7421066246AAD1C230E7E2A7ADF06E9D,31071,14,15,1,109.58257,18.28458,1815
8133,62155,7421066246AAD1C230E7E2A7ADF06E9D,30854,17,18,1,109.56889,18.27076,1763
8134,62156,7421066246AAD1C230E7E2A7ADF06E9D,60631,21,23,2,109.57778,18.27583,1814
8138,62167,A01B4012B619D942E7CC3AC9B78722B4,39183,0,1,1,109.55542,18.28208,1715
8139,62168,A01B4012B619D942E7CC3AC9B78722B4,31561,3,23,20,109.56792,18.28479,1765
8140,62177,E2A4A2ABBE2AAFDE32C6FA06BCCC268D,30854,11,16,5,109.56889,18.27076,1763
8141,62178,E2A4A2ABBE2AAFDE32C6FA06BCCC268D,31071,20,23,3,109.58257,18.28458,1815
8142,62297,F3D63C0B2248B39F370D3CF39845220E,38951,0,7,7,109.48097,18.28868,1416
8143,62298,F3D63C0B2248B39F370D3CF39845220E,30971,8,9,1,109.48708,18.29319,1467
8144,62299,F3D63C0B2248B39F370D3CF39845220E,30711,10,12,2,109.50271,18.25347,1510
8145,62300,F3D63C0B2248B39F370D3CF39845220E,38951,15,17,2,109.48097,18.28868,1416
8146,62301,F3D63C0B2248B39F370D3CF39845220E,30971,17,19,2,109.48708,18.29319,1467
8147,62302,F3D63C0B2248B39F370D3CF39845220E,38951,19,23,4,109.48097,18.28868,1416
8148,62305,EFFEF00C078D502D6D0D1D469ACBA466,39041,0,8,8,109.40021,18.29278,1117
8149,62306,EFFEF00C078D502D6D0D1D469ACBA466,31471,9,11,2,109.34583,18.29563,917
8150,62307,EFFEF00C078D502D6D0D1D469ACBA466,38321,12,15,3,109.39854,18.29132,1116
8151,62308,EFFEF00C078D502D6D0D1D469ACBA466,30281,19,20,1,109.50597,18.27583,1514
8152,62309,EFFEF00C078D502D6D0D1D469ACBA466,30421,21,23,2,109.50021,18.25861,1511
8153,62350,DF49F834C08C7E8FA6D78272EE1FB651,60361,0,7,7,109.51938,18.29681,1567
8154,62351,DF49F834C08C7E8FA6D78272EE1FB651,30951,12,17,5,109.56208,18.25667,1761
8155,62352,DF49F834C08C7E8FA6D78272EE1FB651,60361,18,23,5,109.51938,18.29681,1567
8163,62381,BD4652414D5C17466BA36FD4BD943A94,39183,15,16,1,109.55542,18.28208,1715
8164,62382,BD4652414D5C17466BA36FD4BD943A94,30421,18,19,1,109.50021,18.25861,1511
8165,62383,BD4652414D5C17466BA36FD4BD943A94,38157,20,21,1,109.51483,18.26958,1563
8166,62398,59F2738320001FD950F433CB128A2616,30361,3,13,10,109.50347,18.24,1508
8167,62399,59F2738320001FD950F433CB128A2616,38157,15,23,8,109.51483,18.26958,1563
8171,62470,F4E8369A4C9B6C532D393F00D3A77C26,31561,2,3,1,109.56792,18.28479,1765
8172,62471,F4E8369A4C9B6C532D393F00D3A77C26,30854,4,6,2,109.56889,18.27076,1763
8173,62472,F4E8369A4C9B6C532D393F00D3A77C26,31561,7,8,1,109.56792,18.28479,1765
8174,62473,F4E8369A4C9B6C532D393F00D3A77C26,39183,8,19,11,109.55542,18.28208,1715
8175,62474,F4E8369A4C9B6C532D393F00D3A77C26,30854,20,22,2,109.56889,18.27076,1763
8176,62495,BFDE1CB7ED71CA9593AFA77408B12977,39183,5,7,2,109.55542,18.28208,1715
8177,62496,BFDE1CB7ED71CA9593AFA77408B12977,30854,8,9,1,109.56889,18.27076,1763
8178,62497,BFDE1CB7ED71CA9593AFA77408B12977,39183,11,13,2,109.55542,18.28208,1715
8179,62498,BFDE1CB7ED71CA9593AFA77408B12977,30731,15,16,1,109.50944,18.22306,1555
8186,62511,1A4B51DFD66BF1F13D5FAE3E1A0A202C,31071,0,7,7,109.58257,18.28458,1815
8187,62512,1A4B51DFD66BF1F13D5FAE3E1A0A202C,30854,7,11,4,109.56889,18.27076,1763
8188,62548,B37777551ADDE84A1FDFE1FF465C24DC,31421,13,17,4,109.55382,18.22347,1705
8189,62549,B37777551ADDE84A1FDFE1FF465C24DC,60381,19,20,1,109.5241,18.22458,1605
8193,62575,D0F0D586BD20DB339C6320E410D3897E,31931,6,11,5,109.54771,18.29403,1667
8194,62628,EBF906C5498076BCFA3E97DF6001B4F3,60631,3,7,4,109.57778,18.27583,1814
8195,62629,EBF906C5498076BCFA3E97DF6001B4F3,30854,12,23,11,109.56889,18.27076,1763
8196,62640,2575DC0A6ACDD25FC20DB5874F9656C2,38127,0,13,13,109.50833,18.27222,1513
8197,62647,2A6BA0678DDF16AF08BAC9E3FA3C9391,31561,0,2,2,109.56792,18.28479,1765
8198,62648,2A6BA0678DDF16AF08BAC9E3FA3C9391,30854,3,6,3,109.56889,18.27076,1763
8199,62649,2A6BA0678DDF16AF08BAC9E3FA3C9391,31561,6,8,2,109.56792,18.28479,1765
8200,62650,2A6BA0678DDF16AF08BAC9E3FA3C9391,30854,9,11,2,109.56889,18.27076,1763
8201,62651,2A6BA0678DDF16AF08BAC9E3FA3C9391,31561,13,15,2,109.56792,18.28479,1765
8202,62652,2A6BA0678DDF16AF08BAC9E3FA3C9391,30854,17,19,2,109.56889,18.27076,1763
8203,62653,2A6BA0678DDF16AF08BAC9E3FA3C9391,31561,21,22,1,109.56792,18.28479,1765
8204,62662,BBA16F6706035825AE1DA4ED4DD948D9,30181,7,12,5,109.51597,18.23313,1557
8205,62663,BBA16F6706035825AE1DA4ED4DD948D9,31521,13,14,1,109.51458,18.22542,1555
8206,62664,BBA16F6706035825AE1DA4ED4DD948D9,30181,14,17,3,109.51597,18.23313,1557
8207,62665,BBA16F6706035825AE1DA4ED4DD948D9,30361,18,20,2,109.50347,18.24,1508
8208,62666,BBA16F6706035825AE1DA4ED4DD948D9,30181,20,23,3,109.51597,18.23313,1557
8212,62676,5330201098C22642D689CB029F620A39,30051,0,6,6,109.48917,18.21215,1453
8213,62677,5330201098C22642D689CB029F620A39,38361,8,9,1,109.43667,18.29201,1267
8214,62678,5330201098C22642D689CB029F620A39,31101,13,16,3,109.65389,18.23403,2057
8222,62742,E16204D131FCD957D5ADB9592C1DD0ED,31071,1,12,11,109.58257,18.28458,1815
8223,62743,E16204D131FCD957D5ADB9592C1DD0ED,60311,14,16,2,109.52097,18.24319,1558
8224,62744,E16204D131FCD957D5ADB9592C1DD0ED,31071,18,20,2,109.58257,18.28458,1815
8225,62756,53FAD38445EA2327DCFAAAADCAABAB84,30361,0,8,8,109.50347,18.24,1508
8226,62757,53FAD38445EA2327DCFAAAADCAABAB84,38315,9,10,1,109.48979,18.29764,1467
8230,62817,EACE0C43F4CFE6E058FB80EE357B16CF,30321,0,18,18,109.49563,18.29611,1467
8231,62818,EACE0C43F4CFE6E058FB80EE357B16CF,31561,18,19,1,109.56792,18.28479,1765
8232,62832,D4EDFC03E7ED63DAAF98D926C98FC74F,31181,6,7,1,109.50382,18.24813,1509
8233,62833,D4EDFC03E7ED63DAAF98D926C98FC74F,30511,10,23,13,109.51069,18.24208,1558
8234,62837,FC12400ACC5D52C4DD5609D1A21E8705,31931,0,6,6,109.54771,18.29403,1667
8235,62838,FC12400ACC5D52C4DD5609D1A21E8705,39181,8,9,1,109.55153,18.28035,1715
8236,62839,FC12400ACC5D52C4DD5609D1A21E8705,31931,9,11,2,109.54771,18.29403,1667
8237,62840,FC12400ACC5D52C4DD5609D1A21E8705,39181,13,18,5,109.55153,18.28035,1715
8238,62841,FC12400ACC5D52C4DD5609D1A21E8705,31931,19,23,4,109.54771,18.29403,1667
8239,62843,8D8AA41210FC9E2D5DD4D81CF4DB18D7,60361,13,16,3,109.51938,18.29681,1567
8240,62844,8D8AA41210FC9E2D5DD4D81CF4DB18D7,30084,19,20,1,109.50118,18.26972,1513
8241,62858,A952750F25C558E5C17B3EB7DD935431,60371,5,9,4,109.53063,18.30056,1618
8242,62859,A952750F25C558E5C17B3EB7DD935431,31931,12,21,9,109.54771,18.29403,1667
8243,62863,ABCD0851CC1C78BCD7AF6DBDF2F5DE49,30671,6,7,1,109.43611,18.30139,1268
8244,62864,ABCD0851CC1C78BCD7AF6DBDF2F5DE49,60552,8,21,13,109.41729,18.30014,1218
8245,62877,FF6409757A02529917194A790554851A,31145,14,15,1,109.20431,18.30479,369
8249,62936,9EB99F27F9127F01C16DB7BA7D10B6E0,30854,17,20,3,109.56889,18.27076,1763
8250,62937,9EB99F27F9127F01C16DB7BA7D10B6E0,31561,21,22,1,109.56792,18.28479,1765
8251,62968,B643AC77F8D8498A9694D45BA8B0F75F,30854,19,20,1,109.56889,18.27076,1763
8252,62969,B643AC77F8D8498A9694D45BA8B0F75F,31561,21,23,2,109.56792,18.28479,1765
8253,63007,DFD04086D24122EB0B303CE9A87DF681,39191,0,6,6,109.51493,18.23472,1557
8254,63008,DFD04086D24122EB0B303CE9A87DF681,31201,7,9,2,109.51042,18.23819,1558
8255,63009,DFD04086D24122EB0B303CE9A87DF681,31471,11,13,2,109.34583,18.29563,917
8256,63010,DFD04086D24122EB0B303CE9A87DF681,31201,15,17,2,109.51042,18.23819,1558
8257,63011,DFD04086D24122EB0B303CE9A87DF681,31201,20,22,2,109.51042,18.23819,1558
8258,63032,CE70D3AAC3EF6B01DB8A5F34BD94E77D,30651,0,3,3,109.42611,18.385,1232
8259,63033,CE70D3AAC3EF6B01DB8A5F34BD94E77D,30821,3,16,13,109.43681,18.33639,1274
8260,63092,4968BDF068C505E078DCD9BE1053BBFB,31473,15,17,2,109.34792,18.29465,917
8261,63093,4968BDF068C505E078DCD9BE1053BBFB,30771,20,21,1,109.49938,18.26042,1511
8262,63094,4968BDF068C505E078DCD9BE1053BBFB,60331,22,23,1,109.505,18.26507,1512
8263,63107,27BCEF3137923B84211F08830816C810,61011,10,13,3,109.60653,18.19076,1900
8264,63109,27BCEF3137923B84211F08830816C810,61011,15,16,1,109.60653,18.19076,1900
8265,63138,439C404954398764464D854D76F475D8,31041,0,8,8,109.50278,18.23701,1507
8266,63139,439C404954398764464D854D76F475D8,39091,11,13,2,109.50097,18.25222,1510
8267,63140,439C404954398764464D854D76F475D8,38251,14,15,1,109.49618,18.25493,1510
8268,63141,439C404954398764464D854D76F475D8,30581,16,23,7,109.62257,18.24951,1959
8272,63197,4995463B780282C9C030A19D9F49AEAC,30721,0,2,2,109.51597,18.28257,1565
8273,63198,4995463B780282C9C030A19D9F49AEAC,31071,4,8,4,109.58257,18.28458,1815
8274,63199,4995463B780282C9C030A19D9F49AEAC,30854,8,15,7,109.56889,18.27076,1763
8275,63200,4995463B780282C9C030A19D9F49AEAC,31071,16,17,1,109.58257,18.28458,1815
8276,63201,4995463B780282C9C030A19D9F49AEAC,31521,19,21,2,109.51458,18.22542,1555
8277,63202,4995463B780282C9C030A19D9F49AEAC,30854,21,22,1,109.56889,18.27076,1763
8281,63211,2361E8D6BAB0231B2E8E3C0F34517282,30291,0,5,5,109.50403,18.27028,1513
8282,63212,2361E8D6BAB0231B2E8E3C0F34517282,30721,9,11,2,109.51597,18.28257,1565
8283,63213,2361E8D6BAB0231B2E8E3C0F34517282,30081,12,14,2,109.50243,18.26632,1512
8284,63214,2361E8D6BAB0231B2E8E3C0F34517282,60331,15,17,2,109.505,18.26507,1512
8285,63215,2361E8D6BAB0231B2E8E3C0F34517282,30081,20,22,2,109.50243,18.26632,1512
8286,63248,937F0B31443CC6355891AA9D2DB0C670,31561,0,16,16,109.56792,18.28479,1765
8287,63249,937F0B31443CC6355891AA9D2DB0C670,31091,19,20,1,109.41201,18.31222,1170
8294,63336,8C8DB7A18864109B823771C405E00B29,30951,9,17,8,109.56208,18.25667,1761
8295,63337,8C8DB7A18864109B823771C405E00B29,31071,19,22,3,109.58257,18.28458,1815
8299,63385,8A2602EE97ED1F19C3F8048B259C52D2,31521,0,7,7,109.51458,18.22542,1555
8300,63386,8A2602EE97ED1F19C3F8048B259C52D2,60381,8,10,2,109.5241,18.22458,1605
8301,63387,8A2602EE97ED1F19C3F8048B259C52D2,38754,13,14,1,109.74667,18.37382,2430
8302,63388,8A2602EE97ED1F19C3F8048B259C52D2,31521,18,21,3,109.51458,18.22542,1555
8303,63393,30732B1BCE6CCF48F1EA3BFF12855D39,31071,0,2,2,109.58257,18.28458,1815
8304,63394,30732B1BCE6CCF48F1EA3BFF12855D39,30854,4,9,5,109.56889,18.27076,1763
8305,63395,30732B1BCE6CCF48F1EA3BFF12855D39,31071,10,11,1,109.58257,18.28458,1815
8306,63396,30732B1BCE6CCF48F1EA3BFF12855D39,30854,12,13,1,109.56889,18.27076,1763
8307,63397,30732B1BCE6CCF48F1EA3BFF12855D39,30221,14,15,1,109.57833,18.20222,1802
8308,63408,874B1DEE34891BC74B0E782C57027407,30461,1,7,6,109.5116,18.26313,1562
8309,63409,874B1DEE34891BC74B0E782C57027407,30911,10,11,1,109.50493,18.26181,1511
8310,63410,874B1DEE34891BC74B0E782C57027407,38881,12,14,2,109.51618,18.26431,1562
8311,63411,874B1DEE34891BC74B0E782C57027407,60361,19,21,2,109.51938,18.29681,1567
8312,63412,874B1DEE34891BC74B0E782C57027407,30461,21,23,2,109.5116,18.26313,1562
8313,63447,662D882A6A10D0E6C3566690F0A40636,30854,1,14,13,109.56889,18.27076,1763
8314,63448,662D882A6A10D0E6C3566690F0A40636,31221,14,16,2,109.61333,18.26833,1913
8315,63480,88E514C9B989D3BAAAAAC4584CA74239,30821,18,19,1,109.43681,18.33639,1274
8316,63481,88E514C9B989D3BAAAAAC4584CA74239,38951,20,23,3,109.48097,18.28868,1416
8321,63496,6C1B85A5DA00EF7C1AE90EE47B67586A,60311,0,7,7,109.52097,18.24319,1558
8322,63497,6C1B85A5DA00EF7C1AE90EE47B67586A,31031,7,8,1,109.49979,18.25382,1510
8323,63498,6C1B85A5DA00EF7C1AE90EE47B67586A,30951,10,12,2,109.56208,18.25667,1761
8324,63499,6C1B85A5DA00EF7C1AE90EE47B67586A,31421,12,14,2,109.55382,18.22347,1705
8325,63500,6C1B85A5DA00EF7C1AE90EE47B67586A,30951,15,16,1,109.56208,18.25667,1761
8326,63501,6C1B85A5DA00EF7C1AE90EE47B67586A,60311,18,22,4,109.52097,18.24319,1558
8327,63502,B43DB539B5964E15F0064080164C40C1,60631,0,7,7,109.57778,18.27583,1814
8328,63503,B43DB539B5964E15F0064080164C40C1,38052,11,14,3,109.62618,18.23042,1956
8329,63504,B43DB539B5964E15F0064080164C40C1,60631,19,20,1,109.57778,18.27583,1814
8336,63594,AB2757F3465D5BF12D6B9326486D6787,31561,0,7,7,109.56792,18.28479,1765
8337,63595,AB2757F3465D5BF12D6B9326486D6787,39183,10,12,2,109.55542,18.28208,1715
8338,63596,AB2757F3465D5BF12D6B9326486D6787,30571,15,17,2,109.50243,18.21861,1504
8339,63597,D9DC36234BE55D2C1082932A9BD7AF66,31471,14,16,2,109.34583,18.29563,917
8340,63598,D9DC36234BE55D2C1082932A9BD7AF66,38951,19,22,3,109.48097,18.28868,1416
8341,63603,44F505B3929E26B4B29F00CC284F3084,31071,3,7,4,109.58257,18.28458,1815
8342,63604,44F505B3929E26B4B29F00CC284F3084,30854,8,23,15,109.56889,18.27076,1763
8346,63624,15CFA914984D65F8478F81F9B1D1EDF1,30581,0,4,4,109.62257,18.24951,1959
8347,63625,15CFA914984D65F8478F81F9B1D1EDF1,60321,5,6,1,109.63611,18.24306,2008
8348,63626,15CFA914984D65F8478F81F9B1D1EDF1,31841,9,11,2,109.73201,18.33382,2373
8349,63627,1B3A598566348B7D6FD7035DB108D269,30181,0,9,9,109.51597,18.23313,1557
8350,63628,1B3A598566348B7D6FD7035DB108D269,30661,12,14,2,109.37028,18.24361,1008
8351,63629,1B3A598566348B7D6FD7035DB108D269,30181,16,23,7,109.51597,18.23313,1557
8355,63648,4E462508978A46CC849EDD9B946711A1,60381,16,17,1,109.5241,18.22458,1605
8356,63649,4E462508978A46CC849EDD9B946711A1,60361,20,21,1,109.51938,18.29681,1567
8360,63825,3E13064FD790A32F797A7600CB4728A2,31561,0,8,8,109.56792,18.28479,1765
8364,63833,E191BF114A3C2277CB7C3323BAA13F43,31561,1,5,4,109.56792,18.28479,1765
8365,63834,E191BF114A3C2277CB7C3323BAA13F43,30854,6,14,8,109.56889,18.27076,1763
8370,63851,5EB30B0DA8B001416D7FFE7A6F67F2E7,31411,0,6,6,109.5016,18.23576,1507
8371,63852,5EB30B0DA8B001416D7FFE7A6F67F2E7,30581,10,11,1,109.62257,18.24951,1959
8372,63854,5EB30B0DA8B001416D7FFE7A6F67F2E7,31041,19,23,4,109.50278,18.23701,1507
8377,63868,4E5C7D4BC6B840901509F09ECE716731,30681,18,20,2,109.48493,18.26917,1463
8378,63869,4E5C7D4BC6B840901509F09ECE716731,60524,22,23,1,109.42951,18.28993,1216
8379,63881,86823533E32EFBE3843EA59936CEBA25,30291,15,16,1,109.50403,18.27028,1513
8380,63882,86823533E32EFBE3843EA59936CEBA25,38251,19,21,2,109.49618,18.25493,1510
8381,63895,2A39E7A469E1A8EB79BEC03B6E43A857,39183,10,13,3,109.55542,18.28208,1715
8382,63896,2A39E7A469E1A8EB79BEC03B6E43A857,31561,16,21,5,109.56792,18.28479,1765
8383,63906,3C7B93BB0A27C1CE56C61B7C28661B4D,31521,0,12,12,109.51458,18.22542,1555
8384,63907,3C7B93BB0A27C1CE56C61B7C28661B4D,30111,14,18,4,109.47583,18.30542,1419
8385,63908,3C7B93BB0A27C1CE56C61B7C28661B4D,30321,20,23,3,109.49563,18.29611,1467
8397,64071,EAC1FFA16DAEE7E9BFF5141167C4613D,31071,0,10,10,109.58257,18.28458,1815
8398,64072,EAC1FFA16DAEE7E9BFF5141167C4613D,30854,13,14,1,109.56889,18.27076,1763
8399,64073,FC6A614D4965712344FE973AE5D670AE,38826,0,3,3,109.50326,18.25514,1510
8400,64074,FC6A614D4965712344FE973AE5D670AE,30421,4,8,4,109.50021,18.25861,1511
8401,64075,FC6A614D4965712344FE973AE5D670AE,31781,9,10,1,109.19847,18.2975,367
8405,64167,E1E11838338C82F354BD58BE0CE18B02,31231,0,10,10,109.42597,18.29292,1217
8406,64168,E1E11838338C82F354BD58BE0CE18B02,38071,13,15,2,109.40722,18.30938,1169
8410,64177,7A43B41ADDC428BDB8DEA80FF49A22D7,30051,14,16,2,109.48917,18.21215,1453
8411,64178,7A43B41ADDC428BDB8DEA80FF49A22D7,30381,17,19,2,109.52521,18.24507,1609
8412,64179,7A43B41ADDC428BDB8DEA80FF49A22D7,31236,20,22,2,109.42965,18.29111,1216
8413,64185,74AD1AF2EA5153BD40BCF9A3F3F2C4E3,30854,12,14,2,109.56889,18.27076,1763
8414,64186,74AD1AF2EA5153BD40BCF9A3F3F2C4E3,31071,16,17,1,109.58257,18.28458,1815
8415,64187,74AD1AF2EA5153BD40BCF9A3F3F2C4E3,30854,20,21,1,109.56889,18.27076,1763
8416,64188,74AD1AF2EA5153BD40BCF9A3F3F2C4E3,31071,21,22,1,109.58257,18.28458,1815
8417,64259,79B6F08E0B8C6978AC15D212F9B7DA57,38951,0,13,13,109.48097,18.28868,1416
8418,64260,79B6F08E0B8C6978AC15D212F9B7DA57,38951,14,16,2,109.48097,18.28868,1416
8419,64290,141EF093A17F7D2104B5D19E539CCBDA,30321,12,23,11,109.49563,18.29611,1467
8420,64291,84DF4A7C208235D171EF56473BCCF210,30851,0,1,1,109.5616,18.27396,1713
8421,64292,84DF4A7C208235D171EF56473BCCF210,31561,3,6,3,109.56792,18.28479,1765
8422,64293,84DF4A7C208235D171EF56473BCCF210,60631,7,8,1,109.57778,18.27583,1814
8423,64294,84DF4A7C208235D171EF56473BCCF210,31864,13,17,4,109.49014,18.28333,1465
8424,64295,84DF4A7C208235D171EF56473BCCF210,30851,20,23,3,109.5616,18.27396,1713
8425,64309,015CDEB9169BCE5537ABAE49B6A63F2B,31071,0,5,5,109.58257,18.28458,1815
8426,64310,015CDEB9169BCE5537ABAE49B6A63F2B,30854,8,17,9,109.56889,18.27076,1763
8427,64311,015CDEB9169BCE5537ABAE49B6A63F2B,60661,18,19,1,109.548,18.2377,1657
8435,64331,C3071072DB6684DC75BE160268E6323C,30854,1,7,6,109.56889,18.27076,1763
8436,64332,C3071072DB6684DC75BE160268E6323C,60631,11,12,1,109.57778,18.27583,1814
8437,64333,C3071072DB6684DC75BE160268E6323C,30854,12,14,2,109.56889,18.27076,1763
8438,64334,C3071072DB6684DC75BE160268E6323C,31071,16,17,1,109.58257,18.28458,1815
8439,64335,C3071072DB6684DC75BE160268E6323C,30084,21,23,2,109.50118,18.26972,1513
8440,64355,7024F3A14F6F554DC6E80063E30315F0,31561,0,9,9,109.56792,18.28479,1765
8441,64356,7024F3A14F6F554DC6E80063E30315F0,39183,9,18,9,109.55542,18.28208,1715
8442,64373,C336D6DCC64E1B6DB7364EB12E8E8722,31864,18,19,1,109.49014,18.28333,1465
8443,64374,C336D6DCC64E1B6DB7364EB12E8E8722,38094,20,23,3,109.45403,18.28778,1316
8444,64380,BE586ACB441383CC10D7CF3923850B73,60371,16,18,2,109.53063,18.30056,1618
8445,64381,BE586ACB441383CC10D7CF3923850B73,31931,19,21,2,109.54771,18.29403,1667
8446,64382,BE586ACB441383CC10D7CF3923850B73,60371,21,22,1,109.53063,18.30056,1618
8447,64446,F6B0C4B9BFBC5C0F5D704098C64B8B01,31864,8,11,3,109.49014,18.28333,1465
8448,64451,11136C83CACE9221E59CD40325571723,30854,11,13,2,109.56889,18.27076,1763
8449,64452,11136C83CACE9221E59CD40325571723,30571,15,16,1,109.50243,18.21861,1504
8453,64474,87FB240A931190D7195CA3A485DD9E27,60351,0,7,7,109.58403,18.28958,1816
8454,64475,87FB240A931190D7195CA3A485DD9E27,31421,10,11,1,109.55382,18.22347,1705
8455,64476,87FB240A931190D7195CA3A485DD9E27,30951,13,17,4,109.56208,18.25667,1761
8456,64477,87FB240A931190D7195CA3A485DD9E27,60351,19,23,4,109.58403,18.28958,1816
8457,64480,567BF1868FBA42FA9B3B29F2CA13F65D,30221,0,1,1,109.57833,18.20222,1802
8458,64481,567BF1868FBA42FA9B3B29F2CA13F65D,31931,2,11,9,109.54771,18.29403,1667
8459,64482,567BF1868FBA42FA9B3B29F2CA13F65D,30921,16,19,3,109.53903,18.29451,1667
8460,64483,567BF1868FBA42FA9B3B29F2CA13F65D,31931,19,20,1,109.54771,18.29403,1667
8461,64484,567BF1868FBA42FA9B3B29F2CA13F65D,30221,20,22,2,109.57833,18.20222,1802
8462,64485,BD16D1AE4BEC916A65CAE508C1E18FE2,38315,14,16,2,109.48979,18.29764,1467
8463,64486,BD16D1AE4BEC916A65CAE508C1E18FE2,31861,18,19,1,109.49042,18.27549,1464
8464,64487,BD16D1AE4BEC916A65CAE508C1E18FE2,30771,20,22,2,109.49938,18.26042,1511
8465,64498,4D30F99963F81430D842605075346DD5,30361,18,20,2,109.50347,18.24,1508
8466,64499,4D30F99963F81430D842605075346DD5,31431,21,23,2,109.44639,18.29042,1316
8467,64500,F00821368F615DCDAF214035D8EC4A44,31071,2,5,3,109.58257,18.28458,1815
8468,64501,F00821368F615DCDAF214035D8EC4A44,30854,8,17,9,109.56889,18.27076,1763
8469,64502,0B2CDE43D7DE290E07FF365A2D22E5DE,30854,11,12,1,109.56889,18.27076,1763
8481,64603,17AC4F8E6659EB7FBFD30E5467A1D200,38971,0,6,6,109.50743,18.25125,1510
8482,64604,17AC4F8E6659EB7FBFD30E5467A1D200,60571,7,9,2,109.50722,18.25056,1510
8483,64605,17AC4F8E6659EB7FBFD30E5467A1D200,30711,10,11,1,109.50271,18.25347,1510
8484,64606,17AC4F8E6659EB7FBFD30E5467A1D200,31864,12,14,2,109.49014,18.28333,1465
8485,64607,17AC4F8E6659EB7FBFD30E5467A1D200,30711,14,18,4,109.50271,18.25347,1510
8486,64608,17AC4F8E6659EB7FBFD30E5467A1D200,31864,19,20,1,109.49014,18.28333,1465
8487,64609,17AC4F8E6659EB7FBFD30E5467A1D200,30711,21,23,2,109.50271,18.25347,1510
8488,64613,D73D0E1690714CD7F442C709F67E4771,30851,10,13,3,109.5616,18.27396,1713
8489,64614,D73D0E1690714CD7F442C709F67E4771,60361,18,23,5,109.51938,18.29681,1567
8490,64650,F0E7859D5BD715E48CC584AE72D7999E,30121,4,10,6,109.52861,18.27222,1613
8491,64651,F0E7859D5BD715E48CC584AE72D7999E,30854,13,17,4,109.56889,18.27076,1763
8492,64652,F84D949DDCBF25D5530F771BC55E0B9D,61011,0,5,5,109.60653,18.19076,1900
8493,64654,F84D949DDCBF25D5530F771BC55E0B9D,61011,13,21,8,109.60653,18.19076,1900
8494,64655,AD39A6F857F8E578E6A2D9E072C4613F,30201,18,20,2,109.4909,18.26465,1462
8495,64656,AD39A6F857F8E578E6A2D9E072C4613F,30351,20,22,2,109.41701,18.29292,1217
8500,64669,6E2021B014C4D0B652A2E4FE8D2CF038,31071,0,7,7,109.58257,18.28458,1815
8501,64670,6E2021B014C4D0B652A2E4FE8D2CF038,30854,10,15,5,109.56889,18.27076,1763
8502,64671,75BB5F056A285E641293B913E6CE7C17,31351,19,20,1,109.4959,18.28417,1465
8503,64672,75BB5F056A285E641293B913E6CE7C17,30201,21,23,2,109.4909,18.26465,1462
8504,64683,C75C3F9BB96630EE8B7793004C08C0A4,31021,0,11,11,109.49021,18.27,1463
8505,64684,C75C3F9BB96630EE8B7793004C08C0A4,39183,13,17,4,109.55542,18.28208,1715
8506,64700,72412073C8C31099732BE7BF67B866F5,31531,1,11,10,109.49583,18.25972,1461
8507,64701,72412073C8C31099732BE7BF67B866F5,38484,13,16,3,109.53028,18.31528,1620
8508,64702,72412073C8C31099732BE7BF67B866F5,38251,20,21,1,109.49618,18.25493,1510
8509,64719,5E58B9A5D572F3495DB1095E03ED0539,31551,0,4,4,109.55868,18.24222,1708
8510,64720,5E58B9A5D572F3495DB1095E03ED0539,60594,7,23,16,109.62694,18.22799,1956
8511,64721,9C1407835BC54BEBDB541F52E1DA1820,61011,2,5,3,109.60653,18.19076,1900
8512,64723,9C1407835BC54BEBDB541F52E1DA1820,61011,8,18,10,109.60653,18.19076,1900
8513,64738,DF7A11C5ED41023DC32CA06344F5707F,38871,0,2,2,109.44681,18.28625,1316
8514,64739,DF7A11C5ED41023DC32CA06344F5707F,31861,4,5,1,109.49042,18.27549,1464
8515,64740,DF7A11C5ED41023DC32CA06344F5707F,31021,6,7,1,109.49021,18.27,1463
8516,64741,DF7A11C5ED41023DC32CA06344F5707F,60401,7,9,2,109.47444,18.27583,1414
8517,64742,DF7A11C5ED41023DC32CA06344F5707F,38334,14,23,9,109.65035,18.23785,2057
8518,64749,9051969BBCBF8B78870D88A07EF566D6,60381,20,22,2,109.5241,18.22458,1605
8522,64864,8799356B7181F28146A203E5F86C52F0,31351,0,7,7,109.4959,18.28417,1465
8523,64865,8799356B7181F28146A203E5F86C52F0,38834,8,21,13,109.47639,18.21146,1403
8524,64866,8799356B7181F28146A203E5F86C52F0,31351,22,23,1,109.4959,18.28417,1465
8525,64867,41F3C3B484933318A782EA0B7EF5AC36,31071,14,16,2,109.58257,18.28458,1815
8526,64868,41F3C3B484933318A782EA0B7EF5AC36,30854,17,23,6,109.56889,18.27076,1763
8527,64872,DC29C676832347947F366933ECB88090,31561,12,13,1,109.56792,18.28479,1765
8528,64873,DC29C676832347947F366933ECB88090,39183,14,17,3,109.55542,18.28208,1715
8529,64874,DC29C676832347947F366933ECB88090,31561,18,23,5,109.56792,18.28479,1765
8530,64895,99CBAA6A65A50998F0A10B72B36210E4,60231,0,6,6,109.49903,18.21972,1504
8531,64896,99CBAA6A65A50998F0A10B72B36210E4,31361,8,9,1,109.47417,18.28292,1415
8532,64897,99CBAA6A65A50998F0A10B72B36210E4,60161,11,12,1,109.49174,18.26181,1461
8533,64923,15D59418DD5A1D712EB453306C200F13,38251,0,7,7,109.49618,18.25493,1510
8534,64924,15D59418DD5A1D712EB453306C200F13,30731,8,10,2,109.50944,18.22306,1555
8535,64925,15D59418DD5A1D712EB453306C200F13,31145,13,15,2,109.20431,18.30479,369
8536,64931,671490F49BCE8273E41F25414F74FB54,60221,0,11,11,109.52569,18.29188,1616
8537,64932,671490F49BCE8273E41F25414F74FB54,31851,15,17,2,109.71736,18.29007,2316
8538,64933,671490F49BCE8273E41F25414F74FB54,60371,18,23,5,109.53063,18.30056,1618
8539,64952,37D38EF0062E64D55C94EB554B76F9EE,30854,12,14,2,109.56889,18.27076,1763
8540,64953,37D38EF0062E64D55C94EB554B76F9EE,31071,19,20,1,109.58257,18.28458,1815
8541,64954,37D38EF0062E64D55C94EB554B76F9EE,30854,21,22,1,109.56889,18.27076,1763
8542,64961,E00EF22F493557E868E52C93194870CF,30854,8,9,1,109.56889,18.27076,1763
8543,64962,E00EF22F493557E868E52C93194870CF,31071,9,11,2,109.58257,18.28458,1815
8544,64963,E00EF22F493557E868E52C93194870CF,30854,12,14,2,109.56889,18.27076,1763
8545,64964,E00EF22F493557E868E52C93194870CF,31071,15,19,4,109.58257,18.28458,1815
8546,65011,7784022BDEFABB0258B32ABBB5E13027,31891,14,16,2,109.71326,18.37569,2330
8547,65012,7784022BDEFABB0258B32ABBB5E13027,38171,21,23,2,109.50799,18.28139,1515
8554,65082,F9B937F9F26C2F09039C158F4674A0AD,30711,0,11,11,109.50271,18.25347,1510
8555,65083,F9B937F9F26C2F09039C158F4674A0AD,60571,11,12,1,109.50722,18.25056,1510
8556,65084,F9B937F9F26C2F09039C158F4674A0AD,30711,12,14,2,109.50271,18.25347,1510
8557,65085,F9B937F9F26C2F09039C158F4674A0AD,60571,14,15,1,109.50722,18.25056,1510
8558,65086,F9B937F9F26C2F09039C158F4674A0AD,30711,15,19,4,109.50271,18.25347,1510
8559,65087,F9B937F9F26C2F09039C158F4674A0AD,30711,19,23,4,109.50271,18.25347,1510
8560,65183,56F818D0924E7BDB02CCC04065747626,38205,0,10,10,109.62743,18.23139,1956
8561,65184,56F818D0924E7BDB02CCC04065747626,38171,14,15,1,109.50799,18.28139,1515
8562,65185,56F818D0924E7BDB02CCC04065747626,38205,18,23,5,109.62743,18.23139,1956
8570,65197,7235447B1B76CF7498ADD1835D8DDC17,38111,1,6,5,109.52007,18.22403,1555
8571,65198,7235447B1B76CF7498ADD1835D8DDC17,38111,7,22,15,109.52007,18.22403,1555
8578,65223,7FC41386BF666F159E200B23AD07CE36,30084,0,7,7,109.50118,18.26972,1513
8579,65224,7FC41386BF666F159E200B23AD07CE36,60117,10,11,1,109.73604,18.35681,2427
8580,65225,7FC41386BF666F159E200B23AD07CE36,38754,11,14,3,109.74667,18.37382,2430
8581,65226,7FC41386BF666F159E200B23AD07CE36,30281,19,20,1,109.50597,18.27583,1514
8582,65227,7FC41386BF666F159E200B23AD07CE36,30084,20,22,2,109.50118,18.26972,1513
8583,65240,7BFBDB733951E97CDC6510F1C40B7948,30661,13,15,2,109.37028,18.24361,1008
8584,65241,7BFBDB733951E97CDC6510F1C40B7948,60411,17,23,6,109.32514,18.30854,869
8589,65266,65ED412303B1E82EB00C534CD3433EAC,38251,17,18,1,109.49618,18.25493,1510
8590,65267,65ED412303B1E82EB00C534CD3433EAC,30161,18,19,1,109.50042,18.24389,1508
8591,65268,65ED412303B1E82EB00C534CD3433EAC,38111,20,23,3,109.52007,18.22403,1555
8598,65304,ACC390C77025BECAF4CD259D41E8F314,30232,2,14,12,109.6191,18.31701,1971
8599,65305,ACC390C77025BECAF4CD259D41E8F314,30854,16,20,4,109.56889,18.27076,1763
8603,65335,FA0EB766C44C307B69FC2247C53C674E,39151,0,7,7,109.49875,18.25097,1510
8604,65336,FA0EB766C44C307B69FC2247C53C674E,31031,9,12,3,109.49979,18.25382,1510
8605,65337,FA0EB766C44C307B69FC2247C53C674E,39091,12,15,3,109.50097,18.25222,1510
8606,65338,FA0EB766C44C307B69FC2247C53C674E,39151,18,19,1,109.49875,18.25097,1510
8607,65339,FA0EB766C44C307B69FC2247C53C674E,60131,21,23,2,109.49819,18.24778,1509
8612,65412,2371AF49C13083A9B56BAFD9F258B46A,30071,0,1,1,109.52819,18.30472,1619
8613,65413,2371AF49C13083A9B56BAFD9F258B46A,60381,2,4,2,109.5241,18.22458,1605
8614,65414,2371AF49C13083A9B56BAFD9F258B46A,30721,7,14,7,109.51597,18.28257,1565
8615,65436,653802FBFFAEB319D5E2987830A7AC5C,38881,0,7,7,109.51618,18.26431,1562
8616,65437,653802FBFFAEB319D5E2987830A7AC5C,60281,8,10,2,109.51743,18.25924,1561
8617,65438,653802FBFFAEB319D5E2987830A7AC5C,38754,11,13,2,109.74667,18.37382,2430
8618,65439,653802FBFFAEB319D5E2987830A7AC5C,31071,13,14,1,109.58257,18.28458,1815
8619,65440,653802FBFFAEB319D5E2987830A7AC5C,31061,15,16,1,109.53333,18.23257,1607
8620,65441,653802FBFFAEB319D5E2987830A7AC5C,30571,17,19,2,109.50243,18.21861,1504
8621,65442,92E14A6094471B9C1A50CE8585136EC6,30211,0,1,1,109.49882,18.23931,1508
8622,65443,92E14A6094471B9C1A50CE8585136EC6,30161,2,3,1,109.50042,18.24389,1508
8623,65444,92E14A6094471B9C1A50CE8585136EC6,60087,4,11,7,109.50688,18.22299,1505
8624,65445,92E14A6094471B9C1A50CE8585136EC6,30421,13,16,3,109.50021,18.25861,1511
8625,65446,92E14A6094471B9C1A50CE8585136EC6,30861,19,23,4,109.52722,18.22743,1606
8626,65466,12D8E06C2EC8C969710FB791DF137B2B,31071,0,14,14,109.58257,18.28458,1815
8627,65467,12D8E06C2EC8C969710FB791DF137B2B,30854,17,18,1,109.56889,18.27076,1763
8628,65513,7BBB2DDEDB0AE43F8CE7FBD1FCB52741,31071,1,3,2,109.58257,18.28458,1815
8629,65514,7BBB2DDEDB0AE43F8CE7FBD1FCB52741,30854,7,12,5,109.56889,18.27076,1763
8630,65515,7BBB2DDEDB0AE43F8CE7FBD1FCB52741,30571,16,18,2,109.50243,18.21861,1504
8631,65556,51161D5D6D1A3B73044835EE003078F8,31531,0,1,1,109.49583,18.25972,1461
8632,65557,51161D5D6D1A3B73044835EE003078F8,30201,2,9,7,109.4909,18.26465,1462
8633,65558,51161D5D6D1A3B73044835EE003078F8,31561,9,10,1,109.56792,18.28479,1765
8634,65559,51161D5D6D1A3B73044835EE003078F8,30201,14,20,6,109.4909,18.26465,1462
8635,65564,2A5282CF2D793BD3891BB31CAD86ADB8,31471,14,16,2,109.34583,18.29563,917
8636,65565,2A5282CF2D793BD3891BB31CAD86ADB8,31031,17,19,2,109.49979,18.25382,1510
8637,65566,2A5282CF2D793BD3891BB31CAD86ADB8,30271,20,21,1,109.49132,18.23153,1456
8641,65593,377A324496E54511961704972731A3D5,38297,14,16,2,109.52576,18.24965,1609
8642,65594,377A324496E54511961704972731A3D5,31261,20,23,3,109.51174,18.2466,1559
8643,65645,89048436012E137B6C20E2880EE91E56,31471,14,16,2,109.34583,18.29563,917
8644,65646,89048436012E137B6C20E2880EE91E56,60161,21,23,2,109.49174,18.26181,1461
8645,65667,664AAF94F095BCD14233E5648F0324F0,30671,18,20,2,109.43611,18.30139,1268
8646,65712,267866E3C16D42B6BB8A9DF9FAF7C41F,30051,15,16,1,109.48917,18.21215,1453
8647,65713,267866E3C16D42B6BB8A9DF9FAF7C41F,60401,18,19,1,109.47444,18.27583,1414
8648,65714,267866E3C16D42B6BB8A9DF9FAF7C41F,30711,19,23,4,109.50271,18.25347,1510
8649,65727,ED6F7009636BD3F67073E899290E8706,38251,0,8,8,109.49618,18.25493,1510
8650,65728,ED6F7009636BD3F67073E899290E8706,38754,10,11,1,109.74667,18.37382,2430
8651,65729,ED6F7009636BD3F67073E899290E8706,38251,12,23,11,109.49618,18.25493,1510
8652,65779,97310D96003EB3F80B00200829A6C917,31531,0,9,9,109.49583,18.25972,1461
8653,65780,97310D96003EB3F80B00200829A6C917,33051,11,12,1,109.6475,18.46618,2096
8654,65781,97310D96003EB3F80B00200829A6C917,31031,14,15,1,109.49979,18.25382,1510
8655,65782,97310D96003EB3F80B00200829A6C917,31531,15,18,3,109.49583,18.25972,1461
8656,65783,97310D96003EB3F80B00200829A6C917,31534,21,22,1,109.49368,18.25806,1461
8660,65797,32D0EBFA645FCE8DAD65D018847E5043,30232,0,6,6,109.6191,18.31701,1971
8661,65798,32D0EBFA645FCE8DAD65D018847E5043,30854,9,17,8,109.56889,18.27076,1763
8662,65799,32D0EBFA645FCE8DAD65D018847E5043,38171,19,20,1,109.50799,18.28139,1515
8663,65800,32D0EBFA645FCE8DAD65D018847E5043,30854,21,22,1,109.56889,18.27076,1763
8667,65932,9E8746086915F9D4A063A74CF0B5B7AB,39183,16,18,2,109.55542,18.28208,1715
8668,65933,9E8746086915F9D4A063A74CF0B5B7AB,31561,20,22,2,109.56792,18.28479,1765
8669,65964,83F5F6CBF2A63352524671B510BBFB08,30191,0,18,18,109.50361,18.22701,1506
8670,65965,83F5F6CBF2A63352524671B510BBFB08,30854,19,20,1,109.56889,18.27076,1763
8671,65966,83F5F6CBF2A63352524671B510BBFB08,30191,21,23,2,109.50361,18.22701,1506
8672,65979,30D8A678A1441E4FFDF2E3F44AE24060,31071,0,6,6,109.58257,18.28458,1815
8673,65980,30D8A678A1441E4FFDF2E3F44AE24060,30681,9,10,1,109.48493,18.26917,1463
8677,66050,6D9BDE6CAD0A1D083E1A3525B2ECC955,31471,12,14,2,109.34583,18.29563,917
8678,66051,6D9BDE6CAD0A1D083E1A3525B2ECC955,38361,19,21,2,109.43667,18.29201,1267
8679,66054,B7C4E049ABEA8BC374DE2818E1AEEA50,30711,10,14,4,109.50271,18.25347,1510
8680,66055,B7C4E049ABEA8BC374DE2818E1AEEA50,30232,15,16,1,109.6191,18.31701,1971
8681,66056,B7C4E049ABEA8BC374DE2818E1AEEA50,31941,17,18,1,109.62451,18.31222,1970
8685,66085,11111C6844101386CE50DF2BBF6A2434,30181,18,19,1,109.51597,18.23313,1557
8686,66086,11111C6844101386CE50DF2BBF6A2434,31461,21,23,2,109.5091,18.25389,1510
8687,66098,08A066736557478B1013C0CF834491DF,31931,14,15,1,109.54771,18.29403,1667
8688,66099,08A066736557478B1013C0CF834491DF,30921,16,23,7,109.53903,18.29451,1667
8696,66231,2AE38FAF341950B0B91404FFCE5A0F3E,30921,6,18,12,109.53903,18.29451,1667
8697,66232,2AE38FAF341950B0B91404FFCE5A0F3E,31931,19,22,3,109.54771,18.29403,1667
8698,66236,39F25FE146A03325C93C111F2A943B6C,31945,0,7,7,109.58021,18.29403,1817
8699,66237,39F25FE146A03325C93C111F2A943B6C,31221,9,10,1,109.61333,18.26833,1913
8700,66238,39F25FE146A03325C93C111F2A943B6C,31945,12,13,1,109.58021,18.29403,1817
8701,66239,39F25FE146A03325C93C111F2A943B6C,30854,15,16,1,109.56889,18.27076,1763
8702,66240,39F25FE146A03325C93C111F2A943B6C,31071,16,17,1,109.58257,18.28458,1815
8703,66241,39F25FE146A03325C93C111F2A943B6C,31945,19,20,1,109.58021,18.29403,1817
8704,66245,8DA877D3A30401F86E81FB7BC1CA2A00,30854,0,2,2,109.56889,18.27076,1763
8705,66246,8DA877D3A30401F86E81FB7BC1CA2A00,31071,2,3,1,109.58257,18.28458,1815
8706,66247,8DA877D3A30401F86E81FB7BC1CA2A00,30854,4,6,2,109.56889,18.27076,1763
8707,66248,8DA877D3A30401F86E81FB7BC1CA2A00,31561,9,10,1,109.56792,18.28479,1765
8708,66249,8DA877D3A30401F86E81FB7BC1CA2A00,31071,11,12,1,109.58257,18.28458,1815
8709,66250,8DA877D3A30401F86E81FB7BC1CA2A00,30854,12,19,7,109.56889,18.27076,1763
8710,66326,1E36640BE395A4EE8CCB2697222419A5,30191,0,1,1,109.50361,18.22701,1506
8711,66327,1E36640BE395A4EE8CCB2697222419A5,31071,2,7,5,109.58257,18.28458,1815
8712,66328,1E36640BE395A4EE8CCB2697222419A5,30854,8,11,3,109.56889,18.27076,1763
8713,66329,14AE6C820CE45F96077630992CABD33D,30951,0,18,18,109.56208,18.25667,1761
8714,66330,14AE6C820CE45F96077630992CABD33D,31421,19,23,4,109.55382,18.22347,1705
8721,66359,97F47D5DCCBDDBBC4776678A182515C7,30421,12,14,2,109.50021,18.25861,1511
8722,66360,97F47D5DCCBDDBBC4776678A182515C7,31531,18,23,5,109.49583,18.25972,1461
8727,66423,EC4B90EDBF35256FDB4D4F8B87DB8A04,31071,0,7,7,109.58257,18.28458,1815
8728,66424,EC4B90EDBF35256FDB4D4F8B87DB8A04,30854,10,22,12,109.56889,18.27076,1763
8733,66466,5A1FDC762E3A00EF6FB4C515806ADF6A,38911,1,2,1,109.51674,18.24965,1559
8734,66467,5A1FDC762E3A00EF6FB4C515806ADF6A,31261,2,7,5,109.51174,18.2466,1559
8735,66468,5A1FDC762E3A00EF6FB4C515806ADF6A,38291,11,12,1,109.51618,18.24313,1558
8736,66469,5A1FDC762E3A00EF6FB4C515806ADF6A,31261,12,14,2,109.51174,18.2466,1559
8737,66470,5A1FDC762E3A00EF6FB4C515806ADF6A,38911,15,17,2,109.51674,18.24965,1559
8738,66471,5A1FDC762E3A00EF6FB4C515806ADF6A,38291,18,19,1,109.51618,18.24313,1558
8739,66472,5A1FDC762E3A00EF6FB4C515806ADF6A,38911,22,23,1,109.51674,18.24965,1559
8740,66493,0D69669D4DBC1CEB06269A084D86E853,30661,11,12,1,109.37028,18.24361,1008
8741,66494,0D69669D4DBC1CEB06269A084D86E853,31471,13,14,1,109.34583,18.29563,917
8742,66495,0D69669D4DBC1CEB06269A084D86E853,31571,16,17,1,109.61563,18.23326,1957
8743,66496,0D69669D4DBC1CEB06269A084D86E853,60214,19,20,1,109.63104,18.24493,2009
8744,66497,0D69669D4DBC1CEB06269A084D86E853,31571,21,23,2,109.61563,18.23326,1957
8745,66498,1FF4421A750C813FA8447B1B3F4E4C2B,31471,14,16,2,109.34583,18.29563,917
8746,66499,1FF4421A750C813FA8447B1B3F4E4C2B,30361,19,21,2,109.50347,18.24,1508
8747,66500,1FF4421A750C813FA8447B1B3F4E4C2B,60614,21,23,2,109.48799,18.29521,1467
8748,66551,59CD1D4AEF7EA7DE0994909193B0D818,30681,0,6,6,109.48493,18.26917,1463
8749,66559,9390F3530298874939B7DDA5575429FD,60401,0,1,1,109.47444,18.27583,1414
8750,66560,9390F3530298874939B7DDA5575429FD,60201,2,8,6,109.5041,18.2509,1510
8751,66561,9390F3530298874939B7DDA5575429FD,39151,9,10,1,109.49875,18.25097,1510
8752,66562,9390F3530298874939B7DDA5575429FD,38251,11,13,2,109.49618,18.25493,1510
8753,66563,9390F3530298874939B7DDA5575429FD,31521,15,17,2,109.51458,18.22542,1555
8754,66564,9390F3530298874939B7DDA5575429FD,60201,17,19,2,109.5041,18.2509,1510
8755,66565,9390F3530298874939B7DDA5575429FD,30421,19,21,2,109.50021,18.25861,1511
8763,66654,38CF8AD578A393476F29705A4599B8B1,39191,0,1,1,109.51493,18.23472,1557
8764,66655,38CF8AD578A393476F29705A4599B8B1,38891,1,8,7,109.51486,18.24118,1558
8765,66656,38CF8AD578A393476F29705A4599B8B1,60291,12,14,2,109.50826,18.24639,1509
8766,66657,38CF8AD578A393476F29705A4599B8B1,38291,17,18,1,109.51618,18.24313,1558
8767,66658,38CF8AD578A393476F29705A4599B8B1,38271,19,21,2,109.62632,18.23049,1956
8768,66702,AF125EFCC483E24833CBDDBC7248BDF1,31861,18,19,1,109.49042,18.27549,1464
8769,66703,AF125EFCC483E24833CBDDBC7248BDF1,39111,21,23,2,109.5191,18.22597,1555
8770,66708,1B274DBCA220CD483DF90BC3189A9C97,31303,0,7,7,109.15826,18.29549,217
8771,66709,1B274DBCA220CD483DF90BC3189A9C97,60552,9,10,1,109.41729,18.30014,1218
8772,66710,1B274DBCA220CD483DF90BC3189A9C97,30731,14,16,2,109.50944,18.22306,1555
8773,66741,E218C587552A5DADC05C4E69685FE374,30854,19,20,1,109.56889,18.27076,1763
8774,66742,E218C587552A5DADC05C4E69685FE374,39183,21,23,2,109.55542,18.28208,1715
8775,66794,1D8B814EC83D52D7C5F3FED99C129EE0,60631,2,7,5,109.57778,18.27583,1814
8776,66795,1D8B814EC83D52D7C5F3FED99C129EE0,38271,10,19,9,109.62632,18.23049,1956
8777,66811,BE3CBAB86B8807A2A34FBDD31F67422E,31701,17,18,1,109.44132,18.28833,1266
8778,66812,BE3CBAB86B8807A2A34FBDD31F67422E,30201,20,23,3,109.4909,18.26465,1462
8782,66984,2D115D52FDAB55086A12D742071FDFC9,30854,1,7,6,109.56889,18.27076,1763
8783,66985,2D115D52FDAB55086A12D742071FDFC9,30232,9,10,1,109.6191,18.31701,1971
8784,66986,2D115D52FDAB55086A12D742071FDFC9,30854,11,14,3,109.56889,18.27076,1763
8785,66987,2D115D52FDAB55086A12D742071FDFC9,30232,14,17,3,109.6191,18.31701,1971
8786,66988,2D115D52FDAB55086A12D742071FDFC9,30854,18,20,2,109.56889,18.27076,1763
8787,66989,2D115D52FDAB55086A12D742071FDFC9,30232,21,23,2,109.6191,18.31701,1971
8788,67052,0D1E951D9B5BE78A6173DA9864BDF954,30151,3,4,1,109.50986,18.25083,1560
8789,67053,0D1E951D9B5BE78A6173DA9864BDF954,60311,4,14,10,109.52097,18.24319,1558
8790,67054,0D1E951D9B5BE78A6173DA9864BDF954,31261,16,17,1,109.51174,18.2466,1559
8791,67055,0D1E951D9B5BE78A6173DA9864BDF954,30511,17,18,1,109.51069,18.24208,1558
8792,67056,0D1E951D9B5BE78A6173DA9864BDF954,39191,19,21,2,109.51493,18.23472,1557
8793,67097,B29F33564DDA3CFA905BF42633BA4302,60311,14,16,2,109.52097,18.24319,1558
8794,67098,B29F33564DDA3CFA905BF42633BA4302,30151,19,20,1,109.50986,18.25083,1560
8795,67099,B29F33564DDA3CFA905BF42633BA4302,30151,21,22,1,109.50986,18.25083,1560
8799,67108,F8D799D9161B0143E0D71C40472A357E,30071,0,4,4,109.52819,18.30472,1619
8800,67109,F8D799D9161B0143E0D71C40472A357E,31951,5,6,1,109.52174,18.30299,1568
8801,67110,F8D799D9161B0143E0D71C40472A357E,30071,6,11,5,109.52819,18.30472,1619
8802,67111,F8D799D9161B0143E0D71C40472A357E,30071,11,12,1,109.52819,18.30472,1619
8803,67112,F8D799D9161B0143E0D71C40472A357E,31951,12,14,2,109.52174,18.30299,1568
8804,67113,F8D799D9161B0143E0D71C40472A357E,30071,14,16,2,109.52819,18.30472,1619
8805,67120,4DB51FB607DF400B9FA557F761A7BFBF,31701,0,5,5,109.44132,18.28833,1266
8806,67121,4DB51FB607DF400B9FA557F761A7BFBF,38391,6,14,8,109.44111,18.29083,1266
8807,67122,4DB51FB607DF400B9FA557F761A7BFBF,31071,16,17,1,109.58257,18.28458,1815
8808,67147,7BF65E5054DA81A230AB5423620158E1,60631,0,5,5,109.57778,18.27583,1814
8809,67148,7BF65E5054DA81A230AB5423620158E1,30854,7,19,12,109.56889,18.27076,1763
8816,67218,CBA3C8B9B43EEE6240912BCCD5614505,31534,17,19,2,109.49368,18.25806,1461
8817,67219,CBA3C8B9B43EEE6240912BCCD5614505,30391,21,22,1,109.4975,18.27118,1513
8822,67275,AAC7E9546787DDB508C41969C1E453E7,30421,0,10,10,109.50021,18.25861,1511
8823,67276,AAC7E9546787DDB508C41969C1E453E7,30711,11,15,4,109.50271,18.25347,1510
8824,67293,2115670ECBCEFE4CA16C55F5204DF607,38127,19,20,1,109.50833,18.27222,1513
8825,67294,2115670ECBCEFE4CA16C55F5204DF607,30721,22,23,1,109.51597,18.28257,1565
8826,67321,A46BA306DAEA889FAC7ACE9E5FD6A1FF,30911,0,2,2,109.50493,18.26181,1511
8827,67322,A46BA306DAEA889FAC7ACE9E5FD6A1FF,39154,3,4,1,109.50201,18.25681,1511
8828,67323,A46BA306DAEA889FAC7ACE9E5FD6A1FF,30911,8,10,2,109.50493,18.26181,1511
8829,67324,A46BA306DAEA889FAC7ACE9E5FD6A1FF,30371,11,12,1,109.51,18.24771,1559
8830,67325,A46BA306DAEA889FAC7ACE9E5FD6A1FF,30911,12,14,2,109.50493,18.26181,1511
8831,67326,A46BA306DAEA889FAC7ACE9E5FD6A1FF,30361,17,18,1,109.50347,18.24,1508
8832,67327,E649CF84A26278291AA1A5B5C5D01FCA,31561,1,7,6,109.56792,18.28479,1765
8833,67328,E649CF84A26278291AA1A5B5C5D01FCA,30854,9,23,14,109.56889,18.27076,1763
8834,67331,6C44DD6A334FD8F5ED58CBD00D571465,39111,0,6,6,109.5191,18.22597,1555
8835,67332,6C44DD6A334FD8F5ED58CBD00D571465,31521,7,9,2,109.51458,18.22542,1555
8836,67333,6C44DD6A334FD8F5ED58CBD00D571465,31311,10,12,2,109.72299,18.27438,2364
8840,67367,14F21534C21254001A38352AD4BB0EF6,31071,0,14,14,109.58257,18.28458,1815
8841,67368,14F21534C21254001A38352AD4BB0EF6,31561,15,20,5,109.56792,18.28479,1765
8849,67462,E5223925311928E13AD79849D459FACD,31864,0,8,8,109.49014,18.28333,1465
8850,67463,E5223925311928E13AD79849D459FACD,31471,9,11,2,109.34583,18.29563,917
8851,67464,E5223925311928E13AD79849D459FACD,30661,14,16,2,109.37028,18.24361,1008
8852,67503,8DEBA8F3DD446F0F0680296AB7E73431,60441,4,5,1,109.46792,18.28604,1366
8853,67504,8DEBA8F3DD446F0F0680296AB7E73431,60472,7,22,15,109.46625,18.29542,1367
8854,67522,6CBD210FE212796CEDBD8FF4BC0A58A4,39183,0,5,5,109.55542,18.28208,1715
8855,67523,6CBD210FE212796CEDBD8FF4BC0A58A4,31931,9,16,7,109.54771,18.29403,1667
8856,67524,6CBD210FE212796CEDBD8FF4BC0A58A4,39183,18,20,2,109.55542,18.28208,1715
8857,67525,6CBD210FE212796CEDBD8FF4BC0A58A4,31931,20,22,2,109.54771,18.29403,1667
8858,67526,6CBD210FE212796CEDBD8FF4BC0A58A4,39183,22,23,1,109.55542,18.28208,1715
8859,67530,FF811E88FEA9CBDF12E5CC54DEE7CCA1,30951,18,20,2,109.56208,18.25667,1761
8860,67531,FF811E88FEA9CBDF12E5CC54DEE7CCA1,30232,21,23,2,109.6191,18.31701,1971
8864,67610,55795AC975E109597451A352D4BE3C61,38911,0,18,18,109.51674,18.24965,1559
8865,67611,55795AC975E109597451A352D4BE3C61,38291,21,22,1,109.51618,18.24313,1558
8866,67617,A515C2BA2B0AE21CADC42FF4E7FC0007,38484,14,15,1,109.53028,18.31528,1620
8867,67618,A515C2BA2B0AE21CADC42FF4E7FC0007,39181,19,22,3,109.55153,18.28035,1715
8872,67623,98298A3B656BE6FF1B8BB54146834A14,39101,0,8,8,109.50132,18.24931,1509
8873,67624,98298A3B656BE6FF1B8BB54146834A14,60671,10,11,1,109.52979,18.31757,1621
8874,67625,98298A3B656BE6FF1B8BB54146834A14,60291,13,14,1,109.50826,18.24639,1509
8875,67626,98298A3B656BE6FF1B8BB54146834A14,39101,18,23,5,109.50132,18.24931,1509
8876,67665,FC8552628F8A5A5219C1C30314657039,60661,0,4,4,109.548,18.2377,1657
8877,67666,FC8552628F8A5A5219C1C30314657039,30271,8,9,1,109.49132,18.23153,1456
8881,67696,E8BAAF476E8FE57075BAB1A8D4FF1780,30232,0,5,5,109.6191,18.31701,1971
8882,67697,E8BAAF476E8FE57075BAB1A8D4FF1780,30854,9,21,12,109.56889,18.27076,1763
8883,67698,E8BAAF476E8FE57075BAB1A8D4FF1780,30232,21,23,2,109.6191,18.31701,1971
8884,67728,EBB8C4DC19F3856E93F775E3331F31B3,31521,0,1,1,109.51458,18.22542,1555
8885,67729,EBB8C4DC19F3856E93F775E3331F31B3,30081,1,9,8,109.50243,18.26632,1512
8886,67730,EBB8C4DC19F3856E93F775E3331F31B3,60311,12,14,2,109.52097,18.24319,1558
8887,67731,EBB8C4DC19F3856E93F775E3331F31B3,30181,14,16,2,109.51597,18.23313,1557
8888,67732,EBB8C4DC19F3856E93F775E3331F31B3,30081,18,20,2,109.50243,18.26632,1512
8889,67742,E2A254B664D603859C9454241D0A5D2B,30351,0,6,6,109.41701,18.29292,1217
8890,67743,E2A254B664D603859C9454241D0A5D2B,60381,10,11,1,109.5241,18.22458,1605
8891,67744,E2A254B664D603859C9454241D0A5D2B,39321,12,14,2,109.529,18.2167,1604
8892,67745,E2A254B664D603859C9454241D0A5D2B,31521,15,21,6,109.51458,18.22542,1555
8897,67820,01661942FCE90AF8E243ED68E3EDED24,30861,0,7,7,109.52722,18.22743,1606
8898,67821,01661942FCE90AF8E243ED68E3EDED24,31091,9,10,1,109.41201,18.31222,1170
8899,67822,01661942FCE90AF8E243ED68E3EDED24,31701,11,12,1,109.44132,18.28833,1266
8900,67849,36D79DC35161ADC015B71969A834709A,31841,0,10,10,109.73201,18.33382,2373
8901,67850,36D79DC35161ADC015B71969A834709A,31521,13,14,1,109.51458,18.22542,1555
8902,67853,B03EB6B394C6FA523E27D03BBB015313,30771,14,15,1,109.49938,18.26042,1511
8903,67854,B03EB6B394C6FA523E27D03BBB015313,39154,17,23,6,109.50201,18.25681,1511
8904,67888,CEB7EA5D037E7DFD2A157DEECC6ACC53,31121,3,13,10,109.16292,18.37063,230
8905,67889,CEB7EA5D037E7DFD2A157DEECC6ACC53,30961,15,23,8,109.74042,18.37903,2431
8906,67935,9B979E9430BCD0DDB6C78BBE525EBD2D,60631,2,6,4,109.57778,18.27583,1814
8907,67936,9B979E9430BCD0DDB6C78BBE525EBD2D,30854,8,22,14,109.56889,18.27076,1763
8908,67952,E4C7AB656E412C7E33554D18277C9478,60201,0,1,1,109.5041,18.2509,1510
8909,67953,E4C7AB656E412C7E33554D18277C9478,60291,1,6,5,109.50826,18.24639,1509
8910,67954,E4C7AB656E412C7E33554D18277C9478,30911,8,10,2,109.50493,18.26181,1511
8911,67955,E4C7AB656E412C7E33554D18277C9478,60291,12,14,2,109.50826,18.24639,1509
8912,67956,E4C7AB656E412C7E33554D18277C9478,30511,18,19,1,109.51069,18.24208,1558
8913,67957,E4C7AB656E412C7E33554D18277C9478,31461,20,22,2,109.5091,18.25389,1510
8914,68001,1370C2C3031B43C481D89C3608A5C347,38094,18,23,5,109.45403,18.28778,1316
8915,68015,F82B3BBB77C5FF41C0BBD473F847E370,30891,2,6,4,109.59431,18.28389,1865
8916,68016,F82B3BBB77C5FF41C0BBD473F847E370,39183,10,11,1,109.55542,18.28208,1715
8917,68069,8CD2F16F090DFFBF34897CAC847CB1B1,38991,19,23,4,109.52681,18.30368,1618
8918,68079,1B6EBBFF3B9D8A3E18753343B6A29EAE,31071,0,6,6,109.58257,18.28458,1815
8919,68080,1B6EBBFF3B9D8A3E18753343B6A29EAE,30851,7,11,4,109.5616,18.27396,1713
8920,68081,1B6EBBFF3B9D8A3E18753343B6A29EAE,31071,12,14,2,109.58257,18.28458,1815
8921,68082,1B6EBBFF3B9D8A3E18753343B6A29EAE,30851,15,17,2,109.5616,18.27396,1713
8922,68083,1B6EBBFF3B9D8A3E18753343B6A29EAE,31071,18,23,5,109.58257,18.28458,1815
8923,68084,EC89B2FFE00F967E6D0A3B697A6D636D,30191,0,1,1,109.50361,18.22701,1506
8924,68085,EC89B2FFE00F967E6D0A3B697A6D636D,31201,2,8,6,109.51042,18.23819,1558
8925,68086,EC89B2FFE00F967E6D0A3B697A6D636D,30854,11,16,5,109.56889,18.27076,1763
8926,68087,EC89B2FFE00F967E6D0A3B697A6D636D,31071,16,23,7,109.58257,18.28458,1815
8930,68127,4D4289AE0DFBF4B5C79A47559DC2EBDD,30854,3,16,13,109.56889,18.27076,1763
8931,68128,4D4289AE0DFBF4B5C79A47559DC2EBDD,30741,17,21,4,109.49833,18.28681,1516
8935,68164,D88AE248BE01D22E4DE2A4B556E71166,60054,13,14,1,109.3016,18.31229,770
8936,68165,D88AE248BE01D22E4DE2A4B556E71166,31531,18,23,5,109.49583,18.25972,1461
8937,68172,74206C862E4BA6236E7F7978D63D1D7D,38153,8,11,3,109.51819,18.25736,1561
8938,68173,74206C862E4BA6236E7F7978D63D1D7D,39091,12,13,1,109.50097,18.25222,1510
8939,68174,74206C862E4BA6236E7F7978D63D1D7D,30854,15,18,3,109.56889,18.27076,1763
8940,68191,AF7F14400E2F4B8DDF9B93D022E57629,30561,14,17,3,109.52778,18.31938,1621
8941,68192,AF7F14400E2F4B8DDF9B93D022E57629,30561,20,22,2,109.52778,18.31938,1621
8942,68231,E8DB631088E68D5FF25F35789654CC79,30581,0,14,14,109.62257,18.24951,1959
8943,68232,E8DB631088E68D5FF25F35789654CC79,30391,16,19,3,109.4975,18.27118,1513
8947,68316,066CC6CBB5ADF978A93AF5D0C3292806,30241,2,3,1,109.26174,18.3275,622
8948,68317,066CC6CBB5ADF978A93AF5D0C3292806,31931,4,9,5,109.54771,18.29403,1667
8949,68318,066CC6CBB5ADF978A93AF5D0C3292806,31561,13,16,3,109.56792,18.28479,1765
8950,68319,066CC6CBB5ADF978A93AF5D0C3292806,31931,19,21,2,109.54771,18.29403,1667
8951,68320,066CC6CBB5ADF978A93AF5D0C3292806,30071,22,23,1,109.52819,18.30472,1619
8955,68386,222E0B6922623CE9FBB280F81068D40E,30731,6,7,1,109.50944,18.22306,1555
8956,68387,222E0B6922623CE9FBB280F81068D40E,30571,11,15,4,109.50243,18.21861,1504
8957,68406,46D10B971C10D2856504DC61068F66E7,30281,19,20,1,109.50597,18.27583,1514
8958,68407,46D10B971C10D2856504DC61068F66E7,38991,22,23,1,109.52681,18.30368,1618
8963,68425,0550FDCD60CACF2E05F552DF9A576106,31861,12,16,4,109.49042,18.27549,1464
8964,68426,0550FDCD60CACF2E05F552DF9A576106,30171,16,23,7,109.48458,18.27139,1463
8968,68441,EA4EEEA6F324C3F08DBAE63BA2B33BB6,31261,11,12,1,109.51174,18.2466,1559
8969,68442,EA4EEEA6F324C3F08DBAE63BA2B33BB6,30084,14,23,9,109.50118,18.26972,1513
8973,68472,1C9664F68A8624049BECAF58706F2981,31271,0,10,10,109.48958,18.26257,1462
8974,68473,1C9664F68A8624049BECAF58706F2981,30761,11,13,2,109.45201,18.3,1318
8975,68474,1C9664F68A8624049BECAF58706F2981,60381,14,15,1,109.5241,18.22458,1605
8976,68475,1C9664F68A8624049BECAF58706F2981,38754,16,17,1,109.74667,18.37382,2430
8977,68476,1C9664F68A8624049BECAF58706F2981,60161,20,21,1,109.49174,18.26181,1461
8978,68477,1C9664F68A8624049BECAF58706F2981,60431,21,23,2,109.46139,18.32861,1373
8979,68530,3720DDB8E91BF73FF05637BA50F0661B,31521,0,7,7,109.51458,18.22542,1555
8980,68531,3720DDB8E91BF73FF05637BA50F0661B,30511,9,10,1,109.51069,18.24208,1558
8981,68532,3720DDB8E91BF73FF05637BA50F0661B,31521,11,12,1,109.51458,18.22542,1555
8982,68533,3720DDB8E91BF73FF05637BA50F0661B,30511,12,14,2,109.51069,18.24208,1558
8983,68534,3720DDB8E91BF73FF05637BA50F0661B,31521,14,23,9,109.51458,18.22542,1555
8984,68558,BD5D5103B08534F20AF53FB58E9A43CA,31931,1,3,2,109.54771,18.29403,1667
8985,68559,BD5D5103B08534F20AF53FB58E9A43CA,38241,3,4,1,109.54111,18.30542,1669
8986,68560,BD5D5103B08534F20AF53FB58E9A43CA,31931,5,10,5,109.54771,18.29403,1667
8987,68561,BD5D5103B08534F20AF53FB58E9A43CA,31031,19,20,1,109.49979,18.25382,1510
8988,68562,BD5D5103B08534F20AF53FB58E9A43CA,31931,22,23,1,109.54771,18.29403,1667
8996,68609,D54FF92D90E0CD41A304344578DE281C,60541,0,6,6,109.4084,18.29208,1167
8997,68610,D54FF92D90E0CD41A304344578DE281C,31091,9,10,1,109.41201,18.31222,1170
8998,68611,D54FF92D90E0CD41A304344578DE281C,30581,15,16,1,109.62257,18.24951,1959
8999,68612,D54FF92D90E0CD41A304344578DE281C,60541,21,23,2,109.4084,18.29208,1167
9000,68644,B023927CBEC0A8053CBDF64A5B76E367,30571,0,3,3,109.50243,18.21861,1504
9001,68645,B023927CBEC0A8053CBDF64A5B76E367,30571,4,7,3,109.50243,18.21861,1504
9002,68646,B023927CBEC0A8053CBDF64A5B76E367,30921,9,11,2,109.53903,18.29451,1667
9003,68647,B023927CBEC0A8053CBDF64A5B76E367,31931,14,17,3,109.54771,18.29403,1667
9004,68668,6815588633DF1E7C6974D1816808CD27,31521,0,10,10,109.51458,18.22542,1555
9005,68669,6815588633DF1E7C6974D1816808CD27,30421,12,13,1,109.50021,18.25861,1511
9006,68670,6815588633DF1E7C6974D1816808CD27,30851,14,15,1,109.5616,18.27396,1713
9010,68758,D4EE8E1A4C04A1FF0596E4221D0B8B42,30854,0,5,5,109.56889,18.27076,1763
9011,68759,D4EE8E1A4C04A1FF0596E4221D0B8B42,31071,6,7,1,109.58257,18.28458,1815
9012,68760,D4EE8E1A4C04A1FF0596E4221D0B8B42,30854,7,17,10,109.56889,18.27076,1763
9013,68761,D4EE8E1A4C04A1FF0596E4221D0B8B42,31071,18,21,3,109.58257,18.28458,1815
9014,68762,D4EE8E1A4C04A1FF0596E4221D0B8B42,30854,21,22,1,109.56889,18.27076,1763
9015,68779,98029F333AC5519D4BA1B7A7F8079304,30861,18,20,2,109.52722,18.22743,1606
9016,68780,98029F333AC5519D4BA1B7A7F8079304,30861,20,23,3,109.52722,18.22743,1606
9020,68902,EA88ED728918442D87692D43C7401C41,31521,15,18,3,109.51458,18.22542,1555
9021,68903,EA88ED728918442D87692D43C7401C41,30191,19,20,1,109.50361,18.22701,1506
9025,69072,737EEDA02FEB0FD167FBB0A5DFAF2866,60361,6,9,3,109.51938,18.29681,1567
9026,69073,737EEDA02FEB0FD167FBB0A5DFAF2866,60581,11,12,1,109.59785,18.29931,1868
9027,69074,737EEDA02FEB0FD167FBB0A5DFAF2866,60241,14,23,9,109.53319,18.28667,1616
9028,69151,F8290DFC7AD7A3BC6FCA7482642F724C,31701,0,1,1,109.44132,18.28833,1266
9029,69152,F8290DFC7AD7A3BC6FCA7482642F724C,38871,1,7,6,109.44681,18.28625,1316
9030,69153,F8290DFC7AD7A3BC6FCA7482642F724C,31781,11,12,1,109.19847,18.2975,367
9034,69188,24E98C0EC4A6054CC486A2611C493128,30854,17,19,2,109.56889,18.27076,1763
9035,69189,24E98C0EC4A6054CC486A2611C493128,38961,22,23,1,109.50847,18.23514,1507
9040,69265,0714D7583345BD7D9A70C3B1EBB51F43,38484,6,7,1,109.53028,18.31528,1620
9041,69277,22B987DE38F8C4435934FE5E6190C4A2,60631,2,5,3,109.57778,18.27583,1814
9042,69278,22B987DE38F8C4435934FE5E6190C4A2,31571,8,21,13,109.61563,18.23326,1957
9051,69350,7BADC73A7F08A10826F163710F0B362C,60401,0,8,8,109.47444,18.27583,1414
9052,69351,7BADC73A7F08A10826F163710F0B362C,30341,8,9,1,109.3625,18.29167,966
9053,69352,7BADC73A7F08A10826F163710F0B362C,30661,10,15,5,109.37028,18.24361,1008
9054,69353,7BADC73A7F08A10826F163710F0B362C,60401,20,22,2,109.47444,18.27583,1414
9055,69354,7BADC73A7F08A10826F163710F0B362C,60161,22,23,1,109.49174,18.26181,1461
9056,69367,8B3125BACE32612AE7F9DC5599DC75E6,60081,0,7,7,109.51097,18.22639,1556
9057,69368,8B3125BACE32612AE7F9DC5599DC75E6,60331,12,15,3,109.505,18.26507,1512
9058,69369,8B3125BACE32612AE7F9DC5599DC75E6,30661,16,17,1,109.37028,18.24361,1008
9059,69370,8B3125BACE32612AE7F9DC5599DC75E6,60081,20,23,3,109.51097,18.22639,1556
9060,69393,BA0C44295D246224E442075F9885D682,39151,0,6,6,109.49875,18.25097,1510
9061,69394,BA0C44295D246224E442075F9885D682,60201,8,9,1,109.5041,18.2509,1510
9062,69395,BA0C44295D246224E442075F9885D682,31471,11,13,2,109.34583,18.29563,917
9063,69396,BA0C44295D246224E442075F9885D682,60201,15,23,8,109.5041,18.2509,1510
9064,69428,2E29BE7E21F829BB8E4505964B146371,31561,9,10,1,109.56792,18.28479,1765
9065,69429,2E29BE7E21F829BB8E4505964B146371,30854,10,12,2,109.56889,18.27076,1763
9066,69430,2E29BE7E21F829BB8E4505964B146371,31561,15,16,1,109.56792,18.28479,1765
9067,69431,2E29BE7E21F829BB8E4505964B146371,30854,20,22,2,109.56889,18.27076,1763
9068,69456,2AC2732C54885D0DFCC0189356186E57,60101,20,22,2,109.75465,18.40139,2485
9069,69469,EB316856896788EC8FD871E122E95728,30701,3,7,4,109.59313,18.32007,1871
9070,69470,EB316856896788EC8FD871E122E95728,31811,7,10,3,109.54201,18.31806,1671
9071,69471,EB316856896788EC8FD871E122E95728,30701,12,14,2,109.59313,18.32007,1871
9072,69472,EB316856896788EC8FD871E122E95728,31811,16,19,3,109.54201,18.31806,1671
9073,69473,EB316856896788EC8FD871E122E95728,30701,20,22,2,109.59313,18.32007,1871
9077,69618,FB16AA24AD94D8CC7E1110E44BD68910,60631,19,21,2,109.57778,18.27583,1814
9078,69619,FB16AA24AD94D8CC7E1110E44BD68910,31945,21,23,2,109.58021,18.29403,1817
9087,69674,D8898064D7FB8C9B8CE800B6EE2F87B6,30232,0,1,1,109.6191,18.31701,1971
9088,69675,D8898064D7FB8C9B8CE800B6EE2F87B6,30854,2,5,3,109.56889,18.27076,1763
9089,69676,D8898064D7FB8C9B8CE800B6EE2F87B6,39183,6,10,4,109.55542,18.28208,1715
9090,69677,D8898064D7FB8C9B8CE800B6EE2F87B6,30232,14,22,8,109.6191,18.31701,1971
9094,69727,1E3543DF0B1169B9C568FFE53CC2BD25,39321,11,12,1,109.529,18.2167,1604
9095,69728,1E3543DF0B1169B9C568FFE53CC2BD25,39111,13,14,1,109.5191,18.22597,1555
9096,69729,1E3543DF0B1169B9C568FFE53CC2BD25,60054,16,17,1,109.3016,18.31229,770
9101,69760,66C57C174C13228C3B069E7F4C411F81,31021,4,9,5,109.49021,18.27,1463
9102,69761,66C57C174C13228C3B069E7F4C411F81,60381,13,15,2,109.5241,18.22458,1605
9103,69762,66C57C174C13228C3B069E7F4C411F81,60594,16,17,1,109.62694,18.22799,1956
9107,69776,BCA20A8B84D9B121C8D359C3C95F0C11,39183,15,17,2,109.55542,18.28208,1715
9108,69777,BCA20A8B84D9B121C8D359C3C95F0C11,30854,18,19,1,109.56889,18.27076,1763
9109,69778,BCA20A8B84D9B121C8D359C3C95F0C11,39183,20,23,3,109.55542,18.28208,1715
9113,69823,42C8D372D859B07C8E4F0E073BF1E7C9,31071,6,12,6,109.58257,18.28458,1815
9114,69824,42C8D372D859B07C8E4F0E073BF1E7C9,60631,13,23,10,109.57778,18.27583,1814
9123,69837,A1E318C80BE4457762B208DEDA1DAC8C,60201,0,3,3,109.5041,18.2509,1510
9124,69838,A1E318C80BE4457762B208DEDA1DAC8C,60281,3,16,13,109.51743,18.25924,1561
9128,69860,5CD05C4F3FA986DCFEC1824F9E061C0E,60281,19,22,3,109.51743,18.25924,1561
9129,69861,5CD05C4F3FA986DCFEC1824F9E061C0E,38291,22,23,1,109.51618,18.24313,1558
9130,69868,7B1A07C39637E996C01DF0A3D287D3C6,30854,2,13,11,109.56889,18.27076,1763
9131,69869,7B1A07C39637E996C01DF0A3D287D3C6,31071,16,17,1,109.58257,18.28458,1815
9132,69877,DB4DF566D4757FF3BB488F82DE126248,30851,7,13,6,109.5616,18.27396,1713
9133,69878,DB4DF566D4757FF3BB488F82DE126248,31561,13,17,4,109.56792,18.28479,1765
9134,69879,DB4DF566D4757FF3BB488F82DE126248,38121,19,21,2,109.51361,18.27813,1564
9135,69880,DB4DF566D4757FF3BB488F82DE126248,31561,21,23,2,109.56792,18.28479,1765
9139,69907,FBC323A047041F71D8997C22FDE88F17,31521,12,13,1,109.51458,18.22542,1555
9140,69908,FBC323A047041F71D8997C22FDE88F17,30171,15,17,2,109.48458,18.27139,1463
9141,69909,FBC323A047041F71D8997C22FDE88F17,60381,20,21,1,109.5241,18.22458,1605
9148,69979,6AA41B84CB33A922FFCBD7C059C1E8E3,30711,18,20,2,109.50271,18.25347,1510
9149,70040,546CDF54295FA26EB9BE77C234A54BAC,38241,0,8,8,109.54111,18.30542,1669
9150,70041,546CDF54295FA26EB9BE77C234A54BAC,30854,8,18,10,109.56889,18.27076,1763
9151,70122,94C3DFE92C5BC50C77E9644C9B093F96,30511,0,3,3,109.51069,18.24208,1558
9152,70123,94C3DFE92C5BC50C77E9644C9B093F96,60087,3,6,3,109.50688,18.22299,1505
9153,70171,B7A2800FDF738E1064EAD2A5E58F7A3C,61011,0,14,14,109.60653,18.19076,1900
9158,70197,B91A19B1FD9FC6BA8C6D18C2634BCD94,60594,0,11,11,109.62694,18.22799,1956
9159,70198,B91A19B1FD9FC6BA8C6D18C2634BCD94,38052,13,15,2,109.62618,18.23042,1956
9163,70210,CA3896FB33E9BC68E91955EDFF5D709B,31945,9,10,1,109.58021,18.29403,1817
9164,70211,CA3896FB33E9BC68E91955EDFF5D709B,60631,11,13,2,109.57778,18.27583,1814
9165,70224,64F4CDF664AA04E7B79DE93C57128CF6,31931,0,6,6,109.54771,18.29403,1667
9166,70225,64F4CDF664AA04E7B79DE93C57128CF6,39183,7,10,3,109.55542,18.28208,1715
9167,70226,64F4CDF664AA04E7B79DE93C57128CF6,31931,12,13,1,109.54771,18.29403,1667
9168,70227,64F4CDF664AA04E7B79DE93C57128CF6,30071,16,17,1,109.52819,18.30472,1619
9169,70228,64F4CDF664AA04E7B79DE93C57128CF6,60361,19,20,1,109.51938,18.29681,1567
9174,70260,DE5024DB59D5BF6AE5857A85EB7680EA,31071,2,7,5,109.58257,18.28458,1815
9175,70261,DE5024DB59D5BF6AE5857A85EB7680EA,30854,9,19,10,109.56889,18.27076,1763
9176,70279,D97A48FFEC6EDAD02D62F5D217EED3AD,60161,0,1,1,109.49174,18.26181,1461
9177,70280,D97A48FFEC6EDAD02D62F5D217EED3AD,60401,2,8,6,109.47444,18.27583,1414
9178,70281,D97A48FFEC6EDAD02D62F5D217EED3AD,60161,8,11,3,109.49174,18.26181,1461
9179,70282,D97A48FFEC6EDAD02D62F5D217EED3AD,30711,13,17,4,109.50271,18.25347,1510
9180,70283,D97A48FFEC6EDAD02D62F5D217EED3AD,31031,19,21,2,109.49979,18.25382,1510
9181,70284,D97A48FFEC6EDAD02D62F5D217EED3AD,60401,22,23,1,109.47444,18.27583,1414
9182,70350,617D274C6203C3080475711DB0A2A53F,60381,16,18,2,109.5241,18.22458,1605
9183,70351,617D274C6203C3080475711DB0A2A53F,31521,19,20,1,109.51458,18.22542,1555
9184,70352,617D274C6203C3080475711DB0A2A53F,31521,22,23,1,109.51458,18.22542,1555
9185,70383,E65658506C2BF9C993BA69EE6D38B3C6,30771,10,14,4,109.49938,18.26042,1511
9186,70384,E65658506C2BF9C993BA69EE6D38B3C6,31561,19,20,1,109.56792,18.28479,1765
9187,70408,B3A1AC27CB357708CE63D3E4F68BF2E7,31071,7,9,2,109.58257,18.28458,1815
9188,70409,B3A1AC27CB357708CE63D3E4F68BF2E7,30854,10,11,1,109.56889,18.27076,1763
9189,70410,B3A1AC27CB357708CE63D3E4F68BF2E7,31071,13,22,9,109.58257,18.28458,1815
9190,70413,E292D83051830D054E89D209EEABA4B9,39183,0,2,2,109.55542,18.28208,1715
9191,70414,E292D83051830D054E89D209EEABA4B9,31561,4,23,19,109.56792,18.28479,1765
9195,70570,2B8C748A18FA7D08D4335AD7C9DEF01B,31761,0,5,5,109.60521,18.27965,1914
9196,70571,2B8C748A18FA7D08D4335AD7C9DEF01B,31421,7,8,1,109.55382,18.22347,1705
9197,70572,2B8C748A18FA7D08D4335AD7C9DEF01B,30851,11,13,2,109.5616,18.27396,1713
9198,70573,2B8C748A18FA7D08D4335AD7C9DEF01B,30951,13,15,2,109.56208,18.25667,1761
9199,70574,2B8C748A18FA7D08D4335AD7C9DEF01B,31761,18,23,5,109.60521,18.27965,1914
9200,70644,95D10836D378F422E54903464C65FC37,60221,18,21,3,109.52569,18.29188,1616
9201,70645,95D10836D378F422E54903464C65FC37,60524,22,23,1,109.42951,18.28993,1216
9202,70655,3977578BE56276DA0700B04B81DC1356,30851,13,14,1,109.5616,18.27396,1713
9203,70656,3977578BE56276DA0700B04B81DC1356,31561,14,23,9,109.56792,18.28479,1765
9204,70709,AD608A919061B1C684914F8654FB2493,60231,10,11,1,109.49903,18.21972,1504
9205,70710,AD608A919061B1C684914F8654FB2493,30271,12,14,2,109.49132,18.23153,1456
9210,70730,44A75810FF8F9221047E9675BDBF60A2,31071,0,17,17,109.58257,18.28458,1815
9211,70731,44A75810FF8F9221047E9675BDBF60A2,30854,19,21,2,109.56889,18.27076,1763
9212,70746,B5111A17FE99EC54DAC2FDD550B4E7BA,38017,0,5,5,109.49729,18.21424,1504
9213,70747,B5111A17FE99EC54DAC2FDD550B4E7BA,31781,8,13,5,109.19847,18.2975,367
9214,70748,B5111A17FE99EC54DAC2FDD550B4E7BA,38017,15,17,2,109.49729,18.21424,1504
9215,70749,B5111A17FE99EC54DAC2FDD550B4E7BA,30711,19,20,1,109.50271,18.25347,1510
9216,70750,B5111A17FE99EC54DAC2FDD550B4E7BA,38013,21,22,1,109.49514,18.21951,1454
9217,70760,CD3792A09620ACF9CFFC016A0AC519A8,31864,11,13,2,109.49014,18.28333,1465
9218,70761,CD3792A09620ACF9CFFC016A0AC519A8,38951,13,18,5,109.48097,18.28868,1416
9219,70777,0E129C09250C0D46273B4BD7E5225556,30151,0,6,6,109.50986,18.25083,1560
9220,70778,0E129C09250C0D46273B4BD7E5225556,60201,6,9,3,109.5041,18.2509,1510
9221,70779,0E129C09250C0D46273B4BD7E5225556,60441,13,15,2,109.46792,18.28604,1366
9222,70780,0E129C09250C0D46273B4BD7E5225556,60281,18,20,2,109.51743,18.25924,1561
9223,70781,0E129C09250C0D46273B4BD7E5225556,30421,21,23,2,109.50021,18.25861,1511
9224,70800,34CF23DE302849FAEFC3E94752360498,60171,0,8,8,109.51292,18.30694,1569
9225,70801,34CF23DE302849FAEFC3E94752360498,38754,12,14,2,109.74667,18.37382,2430
9226,70802,34CF23DE302849FAEFC3E94752360498,60171,15,23,8,109.51292,18.30694,1569
9227,70818,E6312CBC8153A9C6DAB83670095D0D25,33051,13,14,1,109.6475,18.46618,2096
9228,70819,E6312CBC8153A9C6DAB83670095D0D25,38951,15,23,8,109.48097,18.28868,1416
9229,70824,60EEF6C7C67C0F42D81D84D28D87EF6D,60054,13,14,1,109.3016,18.31229,770
9230,70825,60EEF6C7C67C0F42D81D84D28D87EF6D,60541,16,21,5,109.4084,18.29208,1167
9231,70829,3F80F6C7ECC59E36D89C8EF1746C8724,60081,0,3,3,109.51097,18.22639,1556
9232,70830,3F80F6C7ECC59E36D89C8EF1746C8724,38121,4,13,9,109.51361,18.27813,1564
9233,70831,3F80F6C7ECC59E36D89C8EF1746C8724,31021,16,17,1,109.49021,18.27,1463
9234,70832,3F80F6C7ECC59E36D89C8EF1746C8724,31205,19,20,1,109.51111,18.23736,1557
9235,70833,3F80F6C7ECC59E36D89C8EF1746C8724,38061,21,23,2,109.50597,18.23118,1506
9245,70897,451E2BF48CD7B253EB0892324E679BCC,31461,0,2,2,109.5091,18.25389,1510
9246,70898,451E2BF48CD7B253EB0892324E679BCC,38291,7,23,16,109.51618,18.24313,1558
9247,70907,4DB778A581941E2A7955D8DA3B7ADAFE,31931,2,7,5,109.54771,18.29403,1667
9248,70908,4DB778A581941E2A7955D8DA3B7ADAFE,60114,9,17,8,109.73028,18.33847,2374
9249,70936,387C2BFABED9CD0C7C45EBAD5F5242F9,31431,19,23,4,109.44639,18.29042,1316
9250,70983,DDE77D3A656666992FC3458B84010D43,39183,13,14,1,109.55542,18.28208,1715
9251,70984,DDE77D3A656666992FC3458B84010D43,31561,18,19,1,109.56792,18.28479,1765
9252,71019,23637043AC9FEDF453218B0EC2A97702,38801,0,14,14,109.51472,18.2584,1561
9253,71020,23637043AC9FEDF453218B0EC2A97702,31061,14,16,2,109.53333,18.23257,1607
9254,71021,38A8595594DC26AD8BE733FC85DB4CA6,31631,0,9,9,109.59542,18.36826,1879
9255,71022,38A8595594DC26AD8BE733FC85DB4CA6,30101,9,11,2,109.57299,18.33333,1773
9256,71023,38A8595594DC26AD8BE733FC85DB4CA6,31631,11,16,5,109.59542,18.36826,1879
9257,71024,38A8595594DC26AD8BE733FC85DB4CA6,30101,17,18,1,109.57299,18.33333,1773
9258,71025,38A8595594DC26AD8BE733FC85DB4CA6,31631,19,23,4,109.59542,18.36826,1879
9262,71065,521A7ED98375837397B112E54A372514,31431,0,4,4,109.44639,18.29042,1316
9263,71066,521A7ED98375837397B112E54A372514,60234,7,11,4,109.49577,18.2096,1453
9264,71067,521A7ED98375837397B112E54A372514,38017,12,14,2,109.49729,18.21424,1504
9265,71068,521A7ED98375837397B112E54A372514,38017,16,18,2,109.49729,18.21424,1504
9266,71069,521A7ED98375837397B112E54A372514,38017,19,20,1,109.49729,18.21424,1504
9267,71070,521A7ED98375837397B112E54A372514,38291,21,22,1,109.51618,18.24313,1558
9268,71074,DB0EF690DC781F73956987AB22EA398D,38361,1,8,7,109.43667,18.29201,1267
9269,71075,DB0EF690DC781F73956987AB22EA398D,60131,12,13,1,109.49819,18.24778,1509
9270,71076,DB0EF690DC781F73956987AB22EA398D,38251,14,16,2,109.49618,18.25493,1510
9271,71077,DB0EF690DC781F73956987AB22EA398D,60081,17,19,2,109.51097,18.22639,1556
9272,71078,DB0EF690DC781F73956987AB22EA398D,39151,20,21,1,109.49875,18.25097,1510
9273,71079,DB0EF690DC781F73956987AB22EA398D,38361,22,23,1,109.43667,18.29201,1267
9274,71099,283001ED673D8EDBEF7EEB00BDB31533,31181,6,18,12,109.50382,18.24813,1509
9275,71100,283001ED673D8EDBEF7EEB00BDB31533,30571,19,22,3,109.50243,18.21861,1504
9279,71121,42923D86FCA39B981325B127230BF145,30232,0,2,2,109.6191,18.31701,1971
9280,71122,42923D86FCA39B981325B127230BF145,39183,3,6,3,109.55542,18.28208,1715
9281,71123,42923D86FCA39B981325B127230BF145,60084,8,9,1,109.4984,18.2334,1507
9282,71124,42923D86FCA39B981325B127230BF145,30232,13,15,2,109.6191,18.31701,1971
9283,71125,42923D86FCA39B981325B127230BF145,30854,16,22,6,109.56889,18.27076,1763
9284,71172,0E1B3CFC64EBB658DA96D0DCA834701E,61011,14,18,4,109.60653,18.19076,1900
9285,71174,0E1B3CFC64EBB658DA96D0DCA834701E,61011,21,23,2,109.60653,18.19076,1900
9286,71212,202870BA524F8D7E9C1B66336BF1F034,38991,0,1,1,109.52681,18.30368,1618
9287,71213,202870BA524F8D7E9C1B66336BF1F034,31951,2,5,3,109.52174,18.30299,1568
9288,71214,202870BA524F8D7E9C1B66336BF1F034,30854,6,8,2,109.56889,18.27076,1763
9289,71215,202870BA524F8D7E9C1B66336BF1F034,60631,8,10,2,109.57778,18.27583,1814
9290,71216,202870BA524F8D7E9C1B66336BF1F034,30854,11,12,1,109.56889,18.27076,1763
9291,71217,202870BA524F8D7E9C1B66336BF1F034,60631,14,18,4,109.57778,18.27583,1814
9292,71238,D39D64452E6BBEF7B3056CA239E1B86E,30854,0,8,8,109.56889,18.27076,1763
9293,71239,D39D64452E6BBEF7B3056CA239E1B86E,31561,10,12,2,109.56792,18.28479,1765
9294,71240,D39D64452E6BBEF7B3056CA239E1B86E,30854,12,14,2,109.56889,18.27076,1763
9295,71241,D39D64452E6BBEF7B3056CA239E1B86E,31561,16,17,1,109.56792,18.28479,1765
9296,71242,D39D64452E6BBEF7B3056CA239E1B86E,30854,18,23,5,109.56889,18.27076,1763
9297,71275,FC294DFCE86FDA84EAB1A8B689598D0A,31061,0,7,7,109.53333,18.23257,1607
9298,71276,FC294DFCE86FDA84EAB1A8B689598D0A,31421,8,9,1,109.55382,18.22347,1705
9299,71277,FC294DFCE86FDA84EAB1A8B689598D0A,31471,12,14,2,109.34583,18.29563,917
9300,71278,FC294DFCE86FDA84EAB1A8B689598D0A,31061,18,22,4,109.53333,18.23257,1607
9301,71333,1FE2866848043A2C10AD87212485FE15,31071,1,6,5,109.58257,18.28458,1815
9302,71334,1FE2866848043A2C10AD87212485FE15,30854,7,23,16,109.56889,18.27076,1763
9303,71335,E83EC074941D17DADC663DD9B609F59B,60594,0,11,11,109.62694,18.22799,1956
9304,71336,E83EC074941D17DADC663DD9B609F59B,31221,12,14,2,109.61333,18.26833,1913
9305,71337,E83EC074941D17DADC663DD9B609F59B,38052,14,15,1,109.62618,18.23042,1956
9306,71338,E83EC074941D17DADC663DD9B609F59B,38315,16,17,1,109.48979,18.29764,1467
9307,71349,EE2D2ED68925B4E9F21AFD9C2C986E95,39091,17,19,2,109.50097,18.25222,1510
9308,71365,EE9ED89488CC5A6EB73A10F5D2E75FDB,60131,0,9,9,109.49819,18.24778,1509
9309,71366,EE9ED89488CC5A6EB73A10F5D2E75FDB,33051,13,16,3,109.6475,18.46618,2096
9310,71367,EE9ED89488CC5A6EB73A10F5D2E75FDB,38017,19,23,4,109.49729,18.21424,1504
9311,71410,CD576F1C1CDFB89E6A99A20E65927346,30854,1,2,1,109.56889,18.27076,1763
9312,71411,CD576F1C1CDFB89E6A99A20E65927346,31071,3,4,1,109.58257,18.28458,1815
9313,71412,CD576F1C1CDFB89E6A99A20E65927346,31561,7,11,4,109.56792,18.28479,1765
9314,71413,CD576F1C1CDFB89E6A99A20E65927346,30854,12,13,1,109.56889,18.27076,1763
9315,71414,CD576F1C1CDFB89E6A99A20E65927346,31561,13,18,5,109.56792,18.28479,1765
9319,71459,DBF0ED639264742A7D5519236AB61C61,60071,0,11,11,109.75674,18.31583,2470
9320,71460,DBF0ED639264742A7D5519236AB61C61,30211,14,16,2,109.49882,18.23931,1508
9321,71461,DBF0ED639264742A7D5519236AB61C61,39151,18,21,3,109.49875,18.25097,1510
9322,71467,DC2D9D389C76C3C3F81B17488EA05107,60201,15,19,4,109.5041,18.2509,1510
9323,71468,DC2D9D389C76C3C3F81B17488EA05107,30201,20,21,1,109.4909,18.26465,1462
9324,71469,DC2D9D389C76C3C3F81B17488EA05107,60201,21,23,2,109.5041,18.2509,1510
9325,71485,63FBAC0202144B00077561285E6A7F87,30651,0,3,3,109.42611,18.385,1232
9326,71486,63FBAC0202144B00077561285E6A7F87,30821,3,6,3,109.43681,18.33639,1274
9327,71487,63FBAC0202144B00077561285E6A7F87,30651,8,9,1,109.42611,18.385,1232
9328,71488,63FBAC0202144B00077561285E6A7F87,30821,9,15,6,109.43681,18.33639,1274
9329,71489,63FBAC0202144B00077561285E6A7F87,30651,15,17,2,109.42611,18.385,1232
9330,71490,63FBAC0202144B00077561285E6A7F87,30821,19,23,4,109.43681,18.33639,1274
9331,71508,070984703178D21DC5287E457C03691A,39183,14,15,1,109.55542,18.28208,1715
9332,71509,070984703178D21DC5287E457C03691A,39181,19,23,4,109.55153,18.28035,1715
9333,71572,9E2CAA912E7C38B3460AB2C8B985CA0D,31761,18,20,2,109.60521,18.27965,1914
9334,71573,9E2CAA912E7C38B3460AB2C8B985CA0D,31071,21,23,2,109.58257,18.28458,1815
9335,71577,A1DF9124AA1AFE28F8679C4665FBFAB7,30771,0,1,1,109.49938,18.26042,1511
9336,71578,A1DF9124AA1AFE28F8679C4665FBFAB7,31534,1,6,5,109.49368,18.25806,1461
9337,71579,A1DF9124AA1AFE28F8679C4665FBFAB7,30421,6,8,2,109.50021,18.25861,1511
9338,71580,A1DF9124AA1AFE28F8679C4665FBFAB7,60201,8,9,1,109.5041,18.2509,1510
9339,71581,A1DF9124AA1AFE28F8679C4665FBFAB7,60441,13,15,2,109.46792,18.28604,1366
9340,71582,A1DF9124AA1AFE28F8679C4665FBFAB7,60401,16,17,1,109.47444,18.27583,1414
9341,71583,A1DF9124AA1AFE28F8679C4665FBFAB7,30771,21,22,1,109.49938,18.26042,1511
9345,71662,FF389E4ACCCAE9E25F55121145744220,31421,0,19,19,109.55382,18.22347,1705
9346,71663,FF389E4ACCCAE9E25F55121145744220,38484,20,21,1,109.53028,18.31528,1620
9347,71664,FF389E4ACCCAE9E25F55121145744220,31421,22,23,1,109.55382,18.22347,1705
9351,71684,0ACD42FBA28A767F44D73783967C8C23,30084,12,14,2,109.50118,18.26972,1513
9352,71685,0ACD42FBA28A767F44D73783967C8C23,31864,18,22,4,109.49014,18.28333,1465
9353,71695,3842150E551101E5C7EA3E39AF0BFFE0,31061,18,19,1,109.53333,18.23257,1607
9354,71717,B47BACC30D9A35D35F1E9FB0E5DF7D48,30854,15,17,2,109.56889,18.27076,1763
9355,71718,B47BACC30D9A35D35F1E9FB0E5DF7D48,31071,17,22,5,109.58257,18.28458,1815
9356,71726,48C2384D12D5B16772007E35CE360CBB,30721,0,7,7,109.51597,18.28257,1565
9357,71727,48C2384D12D5B16772007E35CE360CBB,38105,10,11,1,109.40299,18.29229,1117
9358,71728,48C2384D12D5B16772007E35CE360CBB,38754,12,14,2,109.74667,18.37382,2430
9359,71729,48C2384D12D5B16772007E35CE360CBB,31864,17,18,1,109.49014,18.28333,1465
9360,71730,48C2384D12D5B16772007E35CE360CBB,30721,20,21,1,109.51597,18.28257,1565
9361,71738,66CF9E87749B47E4EA7738B8F9FD88BA,31521,0,11,11,109.51458,18.22542,1555
9362,71739,66CF9E87749B47E4EA7738B8F9FD88BA,31471,13,14,1,109.34583,18.29563,917
9363,71740,66CF9E87749B47E4EA7738B8F9FD88BA,38071,19,22,3,109.40722,18.30938,1169
9364,71759,C84F6E3CAF0EAE725088ED441618D6C7,30181,0,6,6,109.51597,18.23313,1557
9365,71760,C84F6E3CAF0EAE725088ED441618D6C7,30851,8,9,1,109.5616,18.27396,1713
9366,71761,C84F6E3CAF0EAE725088ED441618D6C7,30951,9,16,7,109.56208,18.25667,1761
9367,71762,C84F6E3CAF0EAE725088ED441618D6C7,30851,18,19,1,109.5616,18.27396,1713
9368,71763,C84F6E3CAF0EAE725088ED441618D6C7,30181,20,23,3,109.51597,18.23313,1557
9369,71782,02789FFFF0828D5AC1FE96B1CA16BB9C,38951,8,9,1,109.48097,18.28868,1416
9370,71783,02789FFFF0828D5AC1FE96B1CA16BB9C,30661,13,14,1,109.37028,18.24361,1008
9371,71784,02789FFFF0828D5AC1FE96B1CA16BB9C,38291,16,17,1,109.51618,18.24313,1558
9372,71785,02789FFFF0828D5AC1FE96B1CA16BB9C,60221,18,21,3,109.52569,18.29188,1616
9373,71786,02789FFFF0828D5AC1FE96B1CA16BB9C,38951,21,23,2,109.48097,18.28868,1416
9374,71831,A928E9F6C796FE1A60807BA003DE87BB,31071,0,6,6,109.58257,18.28458,1815
9375,71832,A928E9F6C796FE1A60807BA003DE87BB,39183,8,9,1,109.55542,18.28208,1715
9376,71909,8586C09CC5E6256A8D795F3F0A4D8307,60472,6,7,1,109.46625,18.29542,1367
9377,71910,8586C09CC5E6256A8D795F3F0A4D8307,30111,8,10,2,109.47583,18.30542,1419
9378,71911,8586C09CC5E6256A8D795F3F0A4D8307,31931,11,16,5,109.54771,18.29403,1667
9379,71912,8586C09CC5E6256A8D795F3F0A4D8307,60371,18,19,1,109.53063,18.30056,1618
9389,71982,E4B522EF4348156010E5C578EC13D60F,30854,12,16,4,109.56889,18.27076,1763
9390,71983,E4B522EF4348156010E5C578EC13D60F,31521,19,20,1,109.51458,18.22542,1555
9391,71984,E4B522EF4348156010E5C578EC13D60F,30191,21,23,2,109.50361,18.22701,1506
9392,71985,231D1D293780C68FF3AD9DEADFFFB64D,31761,15,17,2,109.60521,18.27965,1914
9393,71986,231D1D293780C68FF3AD9DEADFFFB64D,30771,21,22,1,109.49938,18.26042,1511
9398,72004,3D5A468E02E58892BB875A2C29BFAFBA,60281,0,8,8,109.51743,18.25924,1561
9399,72005,3D5A468E02E58892BB875A2C29BFAFBA,31821,8,9,1,109.51181,18.24924,1559
9400,72006,3D5A468E02E58892BB875A2C29BFAFBA,33354,12,13,1,109.67465,18.44583,2192
9401,72009,DCD137352B900F9F43521E37884B7F13,60054,0,6,6,109.3016,18.31229,770
9402,72010,DCD137352B900F9F43521E37884B7F13,30661,6,13,7,109.37028,18.24361,1008
9403,72011,DCD137352B900F9F43521E37884B7F13,60054,13,23,10,109.3016,18.31229,770
9404,72033,11644F1AC47F305D43A6A2C9763997F5,31231,0,8,8,109.42597,18.29292,1217
9405,72034,11644F1AC47F305D43A6A2C9763997F5,30711,9,12,3,109.50271,18.25347,1510
9406,72035,11644F1AC47F305D43A6A2C9763997F5,30351,13,18,5,109.41701,18.29292,1217
9407,72036,11644F1AC47F305D43A6A2C9763997F5,30711,18,21,3,109.50271,18.25347,1510
9408,72037,11644F1AC47F305D43A6A2C9763997F5,30351,21,22,1,109.41701,18.29292,1217
9413,72066,9EC5739B5E32B42E49B9FB860139AB72,38052,16,19,3,109.62618,18.23042,1956
9414,72067,9EC5739B5E32B42E49B9FB860139AB72,60594,20,23,3,109.62694,18.22799,1956
9415,72078,85586D73EA48B4F4D520D899B0BE0554,31071,10,12,2,109.58257,18.28458,1815
9416,72079,85586D73EA48B4F4D520D899B0BE0554,39181,15,18,3,109.55153,18.28035,1715
9417,72080,85586D73EA48B4F4D520D899B0BE0554,30291,19,23,4,109.50403,18.27028,1513
9418,72102,10EBF762D28520B09848288F7052CFDE,31071,0,6,6,109.58257,18.28458,1815
9419,72103,10EBF762D28520B09848288F7052CFDE,30854,6,7,1,109.56889,18.27076,1763
9420,72104,10EBF762D28520B09848288F7052CFDE,39101,7,11,4,109.50132,18.24931,1509
9421,72105,10EBF762D28520B09848288F7052CFDE,39101,13,17,4,109.50132,18.24931,1509
9422,72106,10EBF762D28520B09848288F7052CFDE,31071,21,23,2,109.58257,18.28458,1815
9423,72135,C61360C6C8202A54143E165C2C08120B,30232,20,22,2,109.6191,18.31701,1971
9424,72136,C61360C6C8202A54143E165C2C08120B,30951,22,23,1,109.56208,18.25667,1761
9425,72183,065F1687C35F3C827A2EA4A378A0E2C6,30851,8,12,4,109.5616,18.27396,1713
9426,72184,065F1687C35F3C827A2EA4A378A0E2C6,31071,16,17,1,109.58257,18.28458,1815
9427,72185,065F1687C35F3C827A2EA4A378A0E2C6,30851,17,22,5,109.5616,18.27396,1713
9428,72213,B61666307486DD531F980787F0F8A7B7,60631,3,7,4,109.57778,18.27583,1814
9429,72214,B61666307486DD531F980787F0F8A7B7,31571,9,17,8,109.61563,18.23326,1957
9430,72215,B61666307486DD531F980787F0F8A7B7,30854,17,19,2,109.56889,18.27076,1763
9434,72300,77F5A37783010C53E376197FE3F1043D,38991,6,9,3,109.52681,18.30368,1618
9435,72301,77F5A37783010C53E376197FE3F1043D,60371,10,12,2,109.53063,18.30056,1618
9436,72356,7421066246AAD1C230E7E2A7ADF06E9D,60631,0,6,6,109.57778,18.27583,1814
9437,72357,7421066246AAD1C230E7E2A7ADF06E9D,30854,7,21,14,109.56889,18.27076,1763
9438,72362,A4823EEC9A8E697E80697432C029B488,60331,6,9,3,109.505,18.26507,1512
9439,72363,A4823EEC9A8E697E80697432C029B488,30391,10,11,1,109.4975,18.27118,1513
9440,72364,A4823EEC9A8E697E80697432C029B488,31021,14,16,2,109.49021,18.27,1463
9441,72365,A4823EEC9A8E697E80697432C029B488,30391,16,19,3,109.4975,18.27118,1513
9442,72366,A4823EEC9A8E697E80697432C029B488,31561,20,21,1,109.56792,18.28479,1765
9443,72391,A01B4012B619D942E7CC3AC9B78722B4,39183,13,15,2,109.55542,18.28208,1715
9444,72392,A01B4012B619D942E7CC3AC9B78722B4,31931,15,17,2,109.54771,18.29403,1667
9445,72393,A01B4012B619D942E7CC3AC9B78722B4,31561,18,23,5,109.56792,18.28479,1765
9446,72411,A01E2FD84FFE4D782E40311D1ABC1ECB,30281,13,14,1,109.50597,18.27583,1514
9447,72412,A01E2FD84FFE4D782E40311D1ABC1ECB,30721,17,20,3,109.51597,18.28257,1565
9448,72413,7D13454F622056C17C98DB56E3E88A4B,31521,0,1,1,109.51458,18.22542,1555
9449,72414,7D13454F622056C17C98DB56E3E88A4B,31261,2,3,1,109.51174,18.2466,1559
9450,72415,7D13454F622056C17C98DB56E3E88A4B,31521,3,13,10,109.51458,18.22542,1555
9451,72416,7D13454F622056C17C98DB56E3E88A4B,30201,17,19,2,109.4909,18.26465,1462
9452,72417,7D13454F622056C17C98DB56E3E88A4B,31271,20,23,3,109.48958,18.26257,1462
9453,72418,DF46DA0955594B99E73FB26D3951FE40,60631,11,15,4,109.57778,18.27583,1814
9454,72419,DF46DA0955594B99E73FB26D3951FE40,30854,19,23,4,109.56889,18.27076,1763
9455,72429,AC3C2B82ADBE2E4EBD30C091CA841570,39091,17,18,1,109.50097,18.25222,1510
9456,72430,AC3C2B82ADBE2E4EBD30C091CA841570,30371,20,23,3,109.51,18.24771,1559
9457,72499,8C1117E4F5AA76BB724506FFA6757C9B,30861,0,4,4,109.52722,18.22743,1606
9458,72500,8C1117E4F5AA76BB724506FFA6757C9B,60641,5,6,1,109.53854,18.2359,1657
9459,72501,8C1117E4F5AA76BB724506FFA6757C9B,31471,10,12,2,109.34583,18.29563,917
9460,72505,AAD294F97E8F953422B544ED61B36D13,30951,13,15,2,109.56208,18.25667,1761
9461,72506,AAD294F97E8F953422B544ED61B36D13,31071,18,20,2,109.58257,18.28458,1815
9462,72515,A0546DF6E12B7EBA6A12345D0ECBA027,31351,0,7,7,109.4959,18.28417,1465
9463,72516,A0546DF6E12B7EBA6A12345D0ECBA027,38706,9,11,2,109.74625,18.37097,2430
9464,72517,A0546DF6E12B7EBA6A12345D0ECBA027,31351,12,14,2,109.4959,18.28417,1465
9465,72518,A0546DF6E12B7EBA6A12345D0ECBA027,31271,14,16,2,109.48958,18.26257,1462
9466,72519,A0546DF6E12B7EBA6A12345D0ECBA027,30201,16,18,2,109.4909,18.26465,1462
9467,72520,A0546DF6E12B7EBA6A12345D0ECBA027,31351,18,23,5,109.4959,18.28417,1465
9468,72533,F866B6E34CEF853A6497211DD74A607E,31071,0,7,7,109.58257,18.28458,1815
9469,72534,F866B6E34CEF853A6497211DD74A607E,31851,8,9,1,109.71736,18.29007,2316
9470,72535,F866B6E34CEF853A6497211DD74A607E,31071,10,17,7,109.58257,18.28458,1815
9471,72536,F866B6E34CEF853A6497211DD74A607E,60131,19,20,1,109.49819,18.24778,1509
9472,72554,EFFEF00C078D502D6D0D1D469ACBA466,30421,0,7,7,109.50021,18.25861,1511
9473,72555,EFFEF00C078D502D6D0D1D469ACBA466,31471,9,11,2,109.34583,18.29563,917
9474,72556,EFFEF00C078D502D6D0D1D469ACBA466,39041,12,14,2,109.40021,18.29278,1117
9475,72557,EFFEF00C078D502D6D0D1D469ACBA466,31471,15,17,2,109.34583,18.29563,917
9476,72558,EFFEF00C078D502D6D0D1D469ACBA466,38325,18,20,2,109.39792,18.2909,1116
9477,72559,EFFEF00C078D502D6D0D1D469ACBA466,60551,20,22,2,109.42722,18.30111,1218
9485,72603,8DD23AA43C0F7967C45F7488D66F9159,31945,2,7,5,109.58021,18.29403,1817
9486,72604,8DD23AA43C0F7967C45F7488D66F9159,30854,8,16,8,109.56889,18.27076,1763
9487,72605,8DD23AA43C0F7967C45F7488D66F9159,60381,20,22,2,109.5241,18.22458,1605
9488,72612,BD4652414D5C17466BA36FD4BD943A94,39183,12,14,2,109.55542,18.28208,1715
9489,72613,BD4652414D5C17466BA36FD4BD943A94,30281,19,20,1,109.50597,18.27583,1514
9490,72691,D3A66AED8A4C1CC9A2E3EF71AAE97E84,60411,18,20,2,109.32514,18.30854,869
9491,72692,D3A66AED8A4C1CC9A2E3EF71AAE97E84,30661,20,23,3,109.37028,18.24361,1008
9492,72737,1D8B56371E487F3812C9965576175C8D,38361,0,9,9,109.43667,18.29201,1267
9493,72738,1D8B56371E487F3812C9965576175C8D,30171,12,13,1,109.48458,18.27139,1463
9494,72739,1D8B56371E487F3812C9965576175C8D,31521,15,16,1,109.51458,18.22542,1555
9495,72740,1D8B56371E487F3812C9965576175C8D,38361,18,20,2,109.43667,18.29201,1267
9496,72741,1D8B56371E487F3812C9965576175C8D,31231,20,21,1,109.42597,18.29292,1217
9497,72742,1D8B56371E487F3812C9965576175C8D,38361,22,23,1,109.43667,18.29201,1267
9498,72759,C85D0B931BEF54F05B9ABBBB03212DB7,30854,2,3,1,109.56889,18.27076,1763
9499,72760,C85D0B931BEF54F05B9ABBBB03212DB7,31561,4,9,5,109.56792,18.28479,1765
9500,72761,C85D0B931BEF54F05B9ABBBB03212DB7,30854,11,13,2,109.56889,18.27076,1763
9501,72762,C85D0B931BEF54F05B9ABBBB03212DB7,31561,14,18,4,109.56792,18.28479,1765
9502,72763,C85D0B931BEF54F05B9ABBBB03212DB7,30854,18,21,3,109.56889,18.27076,1763
9507,72790,CBC603DF99C1D6981715077F3EA24CB6,30232,0,6,6,109.6191,18.31701,1971
9508,72791,CBC603DF99C1D6981715077F3EA24CB6,30854,9,11,2,109.56889,18.27076,1763
9509,72792,CBC603DF99C1D6981715077F3EA24CB6,60054,14,16,2,109.3016,18.31229,770
9510,72793,CBC603DF99C1D6981715077F3EA24CB6,31031,18,21,3,109.49979,18.25382,1510
9511,72794,CBC603DF99C1D6981715077F3EA24CB6,30854,22,23,1,109.56889,18.27076,1763
9516,72853,EBF906C5498076BCFA3E97DF6001B4F3,30854,15,16,1,109.56889,18.27076,1763
9517,72854,EBF906C5498076BCFA3E97DF6001B4F3,60631,19,20,1,109.57778,18.27583,1814
9525,72927,75817DB682187A07461734D66E1E6492,60631,0,4,4,109.57778,18.27583,1814
9526,72928,75817DB682187A07461734D66E1E6492,30854,5,7,2,109.56889,18.27076,1763
9527,72929,75817DB682187A07461734D66E1E6492,31071,7,9,2,109.58257,18.28458,1815
9528,72930,75817DB682187A07461734D66E1E6492,30854,9,12,3,109.56889,18.27076,1763
9529,72931,75817DB682187A07461734D66E1E6492,30851,17,19,2,109.5616,18.27396,1713
9530,72932,75817DB682187A07461734D66E1E6492,60631,21,23,2,109.57778,18.27583,1814
9531,72935,980F93ED36601960C6F1553EF4F4BC27,30161,18,19,1,109.50042,18.24389,1508
9532,72948,E16204D131FCD957D5ADB9592C1DD0ED,31761,0,8,8,109.60521,18.27965,1914
9533,72949,E16204D131FCD957D5ADB9592C1DD0ED,31561,13,14,1,109.56792,18.28479,1765
9534,72950,E16204D131FCD957D5ADB9592C1DD0ED,31761,14,15,1,109.60521,18.27965,1914
9535,72951,E16204D131FCD957D5ADB9592C1DD0ED,31071,17,20,3,109.58257,18.28458,1815
9536,72952,E16204D131FCD957D5ADB9592C1DD0ED,31521,21,22,1,109.51458,18.22542,1555
9537,73010,3B0DECA794F20C5FB710516C02569281,60131,20,21,1,109.49819,18.24778,1509
9538,73012,BB31C40AF9668A41ED1DCCB876852450,31061,18,20,2,109.53333,18.23257,1607
9539,73059,8D8AA41210FC9E2D5DD4D81CF4DB18D7,60361,0,8,8,109.51938,18.29681,1567
9540,73060,8D8AA41210FC9E2D5DD4D81CF4DB18D7,60084,11,12,1,109.4984,18.2334,1507
9541,73061,8D8AA41210FC9E2D5DD4D81CF4DB18D7,60381,15,18,3,109.5241,18.22458,1605
9542,73062,8D8AA41210FC9E2D5DD4D81CF4DB18D7,60361,21,23,2,109.51938,18.29681,1567
9543,73074,4DA47CA7E0DF1887A4FCFA8DEF75F8FC,31761,0,7,7,109.60521,18.27965,1914
9544,73075,4DA47CA7E0DF1887A4FCFA8DEF75F8FC,31551,10,11,1,109.55868,18.24222,1708
9545,73076,4DA47CA7E0DF1887A4FCFA8DEF75F8FC,30951,12,17,5,109.56208,18.25667,1761
9546,73077,4DA47CA7E0DF1887A4FCFA8DEF75F8FC,31761,19,23,4,109.60521,18.27965,1914
9547,73090,A952750F25C558E5C17B3EB7DD935431,31931,9,14,5,109.54771,18.29403,1667
9548,73091,A952750F25C558E5C17B3EB7DD935431,60371,16,22,6,109.53063,18.30056,1618
9552,73103,85E9F50B5ABCB1024F25DC89F0D41C6E,60281,2,4,2,109.51743,18.25924,1561
9553,73104,85E9F50B5ABCB1024F25DC89F0D41C6E,31041,7,12,5,109.50278,18.23701,1507
9554,73105,85E9F50B5ABCB1024F25DC89F0D41C6E,60281,12,13,1,109.51743,18.25924,1561
9555,73106,85E9F50B5ABCB1024F25DC89F0D41C6E,30361,16,18,2,109.50347,18.24,1508
9556,73107,85E9F50B5ABCB1024F25DC89F0D41C6E,60281,19,22,3,109.51743,18.25924,1561
9557,73150,9EB99F27F9127F01C16DB7BA7D10B6E0,31561,0,8,8,109.56792,18.28479,1765
9558,73151,9EB99F27F9127F01C16DB7BA7D10B6E0,30854,8,20,12,109.56889,18.27076,1763
9559,73170,B643AC77F8D8498A9694D45BA8B0F75F,60631,0,17,17,109.57778,18.27583,1814
9560,73171,B643AC77F8D8498A9694D45BA8B0F75F,31561,17,20,3,109.56792,18.28479,1765
9561,73175,8C84F1CB6E49AC2736E89C4CFE87B2BD,31391,0,7,7,109.50382,18.24285,1508
9562,73176,8C84F1CB6E49AC2736E89C4CFE87B2BD,30711,8,9,1,109.50271,18.25347,1510
9563,73177,8C84F1CB6E49AC2736E89C4CFE87B2BD,31521,11,13,2,109.51458,18.22542,1555
9564,73178,8C84F1CB6E49AC2736E89C4CFE87B2BD,38094,15,16,1,109.45403,18.28778,1316
9565,73179,8C84F1CB6E49AC2736E89C4CFE87B2BD,31391,18,23,5,109.50382,18.24285,1508
9570,73202,7252A0F90E29EC78621699C082578EF7,30831,20,21,1,109.69813,18.32076,2271
9571,73203,7252A0F90E29EC78621699C082578EF7,31361,22,23,1,109.47417,18.28292,1415
9575,73302,785F09140A3E8EDC8952D5DB7DB13B12,38911,6,9,3,109.51674,18.24965,1559
9576,73303,785F09140A3E8EDC8952D5DB7DB13B12,31261,9,11,2,109.51174,18.2466,1559
9577,73304,785F09140A3E8EDC8952D5DB7DB13B12,38291,11,17,6,109.51618,18.24313,1558
9578,73305,785F09140A3E8EDC8952D5DB7DB13B12,38911,19,22,3,109.51674,18.24965,1559
9579,73312,439C404954398764464D854D76F475D8,38961,1,9,8,109.50847,18.23514,1507
9580,73313,439C404954398764464D854D76F475D8,30761,12,23,11,109.45201,18.3,1318
9584,73348,91EC74D2B208A10BECBB101C6735C578,31864,1,8,7,109.49014,18.28333,1465
9585,73349,91EC74D2B208A10BECBB101C6735C578,60281,12,14,2,109.51743,18.25924,1561
9586,73350,91EC74D2B208A10BECBB101C6735C578,31031,14,17,3,109.49979,18.25382,1510
9587,73351,91EC74D2B208A10BECBB101C6735C578,38094,19,20,1,109.45403,18.28778,1316
9588,73352,91EC74D2B208A10BECBB101C6735C578,31864,22,23,1,109.49014,18.28333,1465
9592,73366,CF2A30FDEEDE024C38B6F95A666F3725,60491,16,18,2,109.43354,18.30847,1269
9593,73367,CF2A30FDEEDE024C38B6F95A666F3725,38141,19,21,2,109.39479,18.2916,1116
9594,73377,4E94ADAE7ABEB20EEFAF67519DFCC1BE,31081,0,9,9,109.44639,18.30181,1318
9595,73378,4E94ADAE7ABEB20EEFAF67519DFCC1BE,31031,10,17,7,109.49979,18.25382,1510
9596,73379,4E94ADAE7ABEB20EEFAF67519DFCC1BE,31031,17,21,4,109.49979,18.25382,1510
9597,73408,B6F891F287DE899812D485CDAA950BB5,31303,0,7,7,109.15826,18.29549,217
9598,73409,B6F891F287DE899812D485CDAA950BB5,31091,8,9,1,109.41201,18.31222,1170
9599,73410,B6F891F287DE899812D485CDAA950BB5,31321,11,12,1,109.63799,18.23201,2007
9600,73411,B6F891F287DE899812D485CDAA950BB5,30821,17,19,2,109.43681,18.33639,1274
9601,73412,B6F891F287DE899812D485CDAA950BB5,30761,20,23,3,109.45201,18.3,1318
9602,73463,996C0D9500BF90CC0E7F5A04C49A464B,39183,0,5,5,109.55542,18.28208,1715
9603,73464,996C0D9500BF90CC0E7F5A04C49A464B,31931,6,23,17,109.54771,18.29403,1667
9604,73468,14A60C3EE7AB19A3980CCA0FE9C293B4,30101,0,8,8,109.57299,18.33333,1773
9605,73469,14A60C3EE7AB19A3980CCA0FE9C293B4,31631,12,14,2,109.59542,18.36826,1879
9606,73470,14A60C3EE7AB19A3980CCA0FE9C293B4,31251,19,23,4,109.18528,18.2975,317
9610,73500,F198CAA1F49ACA5D003FD8F8473B3798,60661,19,20,1,109.548,18.2377,1657
9611,73501,F198CAA1F49ACA5D003FD8F8473B3798,30191,21,23,2,109.50361,18.22701,1506
9612,73537,C860767955774E3494068CF38C009FB6,60391,0,7,7,109.47667,18.28757,1416
9613,73538,C860767955774E3494068CF38C009FB6,31061,9,11,2,109.53333,18.23257,1607
9614,73539,C860767955774E3494068CF38C009FB6,60391,12,14,2,109.47667,18.28757,1416
9615,73549,99986625C7CCD4CB0440D77966EC82F7,31521,0,16,16,109.51458,18.22542,1555
9616,73550,99986625C7CCD4CB0440D77966EC82F7,30361,17,18,1,109.50347,18.24,1508
9617,73577,94A0A464F14C2924A0C00CE569871CAB,33051,13,15,2,109.6475,18.46618,2096
9618,73578,94A0A464F14C2924A0C00CE569871CAB,38017,18,21,3,109.49729,18.21424,1504
9619,73579,8C5A16299A6D294198C90C34C25C5949,31561,18,21,3,109.56792,18.28479,1765
9620,73580,8C5A16299A6D294198C90C34C25C5949,30854,22,23,1,109.56889,18.27076,1763
9624,73589,35C6EDC8AAC6B5ABA770190223528BA2,60381,0,8,8,109.5241,18.22458,1605
9625,73590,35C6EDC8AAC6B5ABA770190223528BA2,60211,10,11,1,109.63549,18.26049,2011
9629,73629,B43DB539B5964E15F0064080164C40C1,60631,0,7,7,109.57778,18.27583,1814
9630,73630,B43DB539B5964E15F0064080164C40C1,38085,8,9,1,109.6291,18.23625,2007
9631,73631,B43DB539B5964E15F0064080164C40C1,38052,11,16,5,109.62618,18.23042,1956
9632,73632,B43DB539B5964E15F0064080164C40C1,30854,18,19,1,109.56889,18.27076,1763
9633,73633,B43DB539B5964E15F0064080164C40C1,60631,22,23,1,109.57778,18.27583,1814
9637,73687,EB92ED6162DE5D09C3C6A535524882F3,31091,21,22,1,109.41201,18.31222,1170
9638,73704,FB69127E95B4D9EC5AF61282F8D7EEB7,31071,0,6,6,109.58257,18.28458,1815
9639,73705,FB69127E95B4D9EC5AF61282F8D7EEB7,30854,7,22,15,109.56889,18.27076,1763
9644,73719,4BE8FEB7C7A1255367E8FF1F934ACEB2,38754,12,14,2,109.74667,18.37382,2430
9645,73721,362594BCB737E6CB215B010FAC348A61,60361,0,7,7,109.51938,18.29681,1567
9646,73722,362594BCB737E6CB215B010FAC348A61,60054,12,14,2,109.3016,18.31229,770
9647,73723,362594BCB737E6CB215B010FAC348A61,60361,17,23,6,109.51938,18.29681,1567
9656,73773,289C96166B72325FF931BEE9E63A948B,60121,18,19,1,109.74507,18.37472,2430
9657,73774,289C96166B72325FF931BEE9E63A948B,39191,21,23,2,109.51493,18.23472,1557
9658,73779,C1F9914EF577AE2A8300B1A3945A50FF,31561,18,20,2,109.56792,18.28479,1765
9659,73780,C1F9914EF577AE2A8300B1A3945A50FF,30851,21,23,2,109.5616,18.27396,1713
9660,73781,44F505B3929E26B4B29F00CC284F3084,31071,1,5,4,109.58257,18.28458,1815
9661,73782,44F505B3929E26B4B29F00CC284F3084,30854,8,23,15,109.56889,18.27076,1763
9665,73865,957C9474071297AA10C21C33173742BB,60621,0,10,10,109.48354,18.27451,1464
9666,73866,957C9474071297AA10C21C33173742BB,31551,12,17,5,109.55868,18.24222,1708
9667,73867,957C9474071297AA10C21C33173742BB,60621,21,23,2,109.48354,18.27451,1464
9671,73949,BE8220A49F1231C0A022F4AA2075503E,38094,0,1,1,109.45403,18.28778,1316
9672,73950,BE8220A49F1231C0A022F4AA2075503E,31945,4,13,9,109.58021,18.29403,1817
9673,73951,BE8220A49F1231C0A022F4AA2075503E,31071,14,16,2,109.58257,18.28458,1815
9674,73952,5B0D8910FEAC5D70C091A0F76A27F5FB,31551,0,8,8,109.55868,18.24222,1708
9675,73953,5B0D8910FEAC5D70C091A0F76A27F5FB,30711,9,17,8,109.50271,18.25347,1510
9676,74056,A68637AA89BD62624E677D9E66C32FAD,30161,0,9,9,109.50042,18.24389,1508
9677,74057,A68637AA89BD62624E677D9E66C32FAD,30161,9,23,14,109.50042,18.24389,1508
9684,74145,2E31826F518B91677E3401BE3F9A1AF2,60371,16,17,1,109.53063,18.30056,1618
9685,74146,2E31826F518B91677E3401BE3F9A1AF2,60281,18,20,2,109.51743,18.25924,1561
9686,74147,2E31826F518B91677E3401BE3F9A1AF2,60371,21,23,2,109.53063,18.30056,1618
9690,74165,2297ECCBAEAEEAB6F486010C8882DE44,60614,16,17,1,109.48799,18.29521,1467
9691,74166,2297ECCBAEAEEAB6F486010C8882DE44,60581,21,23,2,109.59785,18.29931,1868
9695,74208,EE972DDDB0EBA2B6E0C8E188BA31FBAC,31231,20,23,3,109.42597,18.29292,1217
9696,74222,05F9648883BF713D4E846B58647DFC7D,60524,14,15,1,109.42951,18.28993,1216
9697,74223,05F9648883BF713D4E846B58647DFC7D,60552,15,18,3,109.41729,18.30014,1218
9698,74224,05F9648883BF713D4E846B58647DFC7D,30361,20,21,1,109.50347,18.24,1508
9699,74291,FC6A614D4965712344FE973AE5D670AE,60084,4,5,1,109.4984,18.2334,1507
9700,74292,FC6A614D4965712344FE973AE5D670AE,60291,7,8,1,109.50826,18.24639,1509
9701,74293,FC6A614D4965712344FE973AE5D670AE,33481,9,10,1,109.67278,18.41278,2187
9702,74320,0D3DA8126B134D203BB35373EAFFB116,31071,0,16,16,109.58257,18.28458,1815
9703,74321,0D3DA8126B134D203BB35373EAFFB116,30361,18,22,4,109.50347,18.24,1508
9708,74374,BA12B1DD26AEACA59B8A6ED0F5A5E23C,30071,16,17,1,109.52819,18.30472,1619
9709,74375,BA12B1DD26AEACA59B8A6ED0F5A5E23C,30071,20,23,3,109.52819,18.30472,1619
9710,74384,1E8223F636C151EB082F0819A60E04D9,30771,13,15,2,109.49938,18.26042,1511
9711,74385,1E8223F636C151EB082F0819A60E04D9,39154,17,23,6,109.50201,18.25681,1511
9712,74397,2154632B956236CC440F4F0AD5DD5113,60561,0,8,8,109.38229,18.29785,1067
9713,74398,2154632B956236CC440F4F0AD5DD5113,31251,9,10,1,109.18528,18.2975,317
9714,74399,2154632B956236CC440F4F0AD5DD5113,30661,11,17,6,109.37028,18.24361,1008
9715,74400,2154632B956236CC440F4F0AD5DD5113,60561,19,23,4,109.38229,18.29785,1067
9716,74423,F6F55191BE81ACEA146530C2DC4B16FD,31101,1,8,7,109.65389,18.23403,2057
9721,74441,235EF2BFA7E42A5306921E51D3359C28,31421,3,8,5,109.55382,18.22347,1705
9722,74442,235EF2BFA7E42A5306921E51D3359C28,31781,11,12,1,109.19847,18.2975,367
9723,74443,235EF2BFA7E42A5306921E51D3359C28,31471,14,15,1,109.34583,18.29563,917
9724,74468,74AD1AF2EA5153BD40BCF9A3F3F2C4E3,30854,8,13,5,109.56889,18.27076,1763
9725,74469,74AD1AF2EA5153BD40BCF9A3F3F2C4E3,31071,13,20,7,109.58257,18.28458,1815
9729,74488,B663EE883B81AEB709AC84DCCEC3D38E,31945,1,7,6,109.58021,18.29403,1817
9730,74489,B663EE883B81AEB709AC84DCCEC3D38E,30854,10,12,2,109.56889,18.27076,1763
9731,74490,B663EE883B81AEB709AC84DCCEC3D38E,31945,13,14,1,109.58021,18.29403,1817
9732,74491,B663EE883B81AEB709AC84DCCEC3D38E,30854,14,17,3,109.56889,18.27076,1763
9733,74492,B663EE883B81AEB709AC84DCCEC3D38E,31421,18,19,1,109.55382,18.22347,1705
9734,74493,B663EE883B81AEB709AC84DCCEC3D38E,30191,21,23,2,109.50361,18.22701,1506
9735,74502,D9FE6A07B455464CAD7EA907A485A370,30211,0,7,7,109.49882,18.23931,1508
9736,74503,D9FE6A07B455464CAD7EA907A485A370,31145,9,11,2,109.20431,18.30479,369
9737,74504,D9FE6A07B455464CAD7EA907A485A370,31781,11,12,1,109.19847,18.2975,367
9738,74505,D9FE6A07B455464CAD7EA907A485A370,31471,13,15,2,109.34583,18.29563,917
9746,74575,8E06EAC16B0EF776FA1BAAC5B9747325,60201,0,6,6,109.5041,18.2509,1510
9747,74576,8E06EAC16B0EF776FA1BAAC5B9747325,60571,10,21,11,109.50722,18.25056,1510
9751,74606,015CDEB9169BCE5537ABAE49B6A63F2B,31071,0,12,12,109.58257,18.28458,1815
9752,74607,015CDEB9169BCE5537ABAE49B6A63F2B,30854,15,17,2,109.56889,18.27076,1763
9753,74608,015CDEB9169BCE5537ABAE49B6A63F2B,30861,22,23,1,109.52722,18.22743,1606
9754,74621,1FA4B82215610E27D44D7E787BF2CCFC,60614,0,6,6,109.48799,18.29521,1467
9755,74622,1FA4B82215610E27D44D7E787BF2CCFC,38951,9,11,2,109.48097,18.28868,1416
9756,74623,1FA4B82215610E27D44D7E787BF2CCFC,30971,11,12,1,109.48708,18.29319,1467
9757,74624,1FA4B82215610E27D44D7E787BF2CCFC,38951,13,18,5,109.48097,18.28868,1416
9758,74625,1FA4B82215610E27D44D7E787BF2CCFC,30971,19,21,2,109.48708,18.29319,1467
9759,74626,1FA4B82215610E27D44D7E787BF2CCFC,38951,21,23,2,109.48097,18.28868,1416
9760,74627,C1B96048BA2CA99CE8708F27699E42B6,38094,16,17,1,109.45403,18.28778,1316
9761,74628,C1B96048BA2CA99CE8708F27699E42B6,31231,17,18,1,109.42597,18.29292,1217
9762,74629,C1B96048BA2CA99CE8708F27699E42B6,38754,19,21,2,109.74667,18.37382,2430
9763,74657,56193BC7F4FC1B40D2007E4D562DF4BA,30581,12,19,7,109.62257,18.24951,1959
9764,74658,56193BC7F4FC1B40D2007E4D562DF4BA,31571,20,22,2,109.61563,18.23326,1957
9765,74661,8DBF34B975C421A689FCCF3E317AEF1B,30361,19,21,2,109.50347,18.24,1508
9766,74662,8DBF34B975C421A689FCCF3E317AEF1B,30161,21,23,2,109.50042,18.24389,1508
9767,74687,7024F3A14F6F554DC6E80063E30315F0,30854,2,4,2,109.56889,18.27076,1763
9768,74688,7024F3A14F6F554DC6E80063E30315F0,39183,7,11,4,109.55542,18.28208,1715
9769,74689,7024F3A14F6F554DC6E80063E30315F0,31561,12,14,2,109.56792,18.28479,1765
9770,74690,7024F3A14F6F554DC6E80063E30315F0,39183,14,17,3,109.55542,18.28208,1715
9771,74691,7024F3A14F6F554DC6E80063E30315F0,31561,21,23,2,109.56792,18.28479,1765
9775,74706,5F5F21B79C1AD0925177661E61E6C3C9,30351,17,19,2,109.41701,18.29292,1217
9776,74707,5F5F21B79C1AD0925177661E61E6C3C9,60401,20,21,1,109.47444,18.27583,1414
9777,74731,247A25792C12411554236EBA19A3EA86,60161,10,11,1,109.49174,18.26181,1461
9778,74732,247A25792C12411554236EBA19A3EA86,38251,12,14,2,109.49618,18.25493,1510
9779,74733,247A25792C12411554236EBA19A3EA86,30271,16,17,1,109.49132,18.23153,1456
9780,74744,08C064FB6DA5328247D353622FFCC8EE,31521,2,3,1,109.51458,18.22542,1555
9781,74745,08C064FB6DA5328247D353622FFCC8EE,31521,4,9,5,109.51458,18.22542,1555
9782,74746,08C064FB6DA5328247D353622FFCC8EE,31781,11,13,2,109.19847,18.2975,367
9783,74747,08C064FB6DA5328247D353622FFCC8EE,31145,13,15,2,109.20431,18.30479,369
9788,74774,0D00E0CA974DDA00224ACCD00B993468,30851,0,5,5,109.5616,18.27396,1713
9789,74775,0D00E0CA974DDA00224ACCD00B993468,30854,9,11,2,109.56889,18.27076,1763
9790,74776,0D00E0CA974DDA00224ACCD00B993468,31561,12,14,2,109.56792,18.28479,1765
9791,74777,0D00E0CA974DDA00224ACCD00B993468,30854,15,16,1,109.56889,18.27076,1763
9792,74778,0D00E0CA974DDA00224ACCD00B993468,31071,19,22,3,109.58257,18.28458,1815
9797,74814,F00821368F615DCDAF214035D8EC4A44,30854,7,15,8,109.56889,18.27076,1763
9798,74815,F00821368F615DCDAF214035D8EC4A44,31071,19,21,2,109.58257,18.28458,1815
9799,74816,F00821368F615DCDAF214035D8EC4A44,31761,21,23,2,109.60521,18.27965,1914
9803,74853,8D7B9451E0189947198D6AC9CE51CFEE,30764,0,1,1,109.45806,18.29486,1367
9804,74854,8D7B9451E0189947198D6AC9CE51CFEE,60391,1,4,3,109.47667,18.28757,1416
9805,74855,8D7B9451E0189947198D6AC9CE51CFEE,31091,5,17,12,109.41201,18.31222,1170
9806,74856,8D7B9451E0189947198D6AC9CE51CFEE,30111,18,20,2,109.47583,18.30542,1419
9807,74857,8D7B9451E0189947198D6AC9CE51CFEE,60441,22,23,1,109.46792,18.28604,1366
9808,74877,513924E5F8EAB458027327A1E2BAE9DB,31071,17,19,2,109.58257,18.28458,1815
9809,74878,513924E5F8EAB458027327A1E2BAE9DB,31761,20,21,1,109.60521,18.27965,1914
9810,74881,D947D8D9432E18EA6A214259B6E2987E,60411,0,6,6,109.32514,18.30854,869
9811,74882,D947D8D9432E18EA6A214259B6E2987E,30661,7,11,4,109.37028,18.24361,1008
9812,74883,D947D8D9432E18EA6A214259B6E2987E,60411,11,16,5,109.32514,18.30854,869
9813,74884,D947D8D9432E18EA6A214259B6E2987E,30661,16,18,2,109.37028,18.24361,1008
9814,74885,D947D8D9432E18EA6A214259B6E2987E,60411,20,23,3,109.32514,18.30854,869
9815,74901,CB2B883155D37146FD4D4AA009B8CC00,30771,0,16,16,109.49938,18.26042,1511
9816,74920,D73D0E1690714CD7F442C709F67E4771,60361,0,6,6,109.51938,18.29681,1567
9817,74921,D73D0E1690714CD7F442C709F67E4771,30851,7,9,2,109.5616,18.27396,1713
9818,74922,D73D0E1690714CD7F442C709F67E4771,31421,9,11,2,109.55382,18.22347,1705
9819,74923,D73D0E1690714CD7F442C709F67E4771,30951,11,14,3,109.56208,18.25667,1761
9820,74924,D73D0E1690714CD7F442C709F67E4771,30851,14,17,3,109.5616,18.27396,1713
9821,74925,D73D0E1690714CD7F442C709F67E4771,60361,19,23,4,109.51938,18.29681,1567
9822,74965,A14C813C3E3A7182759DA822342505B5,30851,11,15,4,109.5616,18.27396,1713
9823,74966,A14C813C3E3A7182759DA822342505B5,39181,17,23,6,109.55153,18.28035,1715
9827,74978,00E4BC24F22404A2FC4D45749054257A,31071,2,7,5,109.58257,18.28458,1815
9828,74979,00E4BC24F22404A2FC4D45749054257A,60631,11,13,2,109.57778,18.27583,1814
9829,74980,00E4BC24F22404A2FC4D45749054257A,31071,15,18,3,109.58257,18.28458,1815
9830,74981,00E4BC24F22404A2FC4D45749054257A,30854,20,22,2,109.56889,18.27076,1763
9831,74982,00E4BC24F22404A2FC4D45749054257A,31071,22,23,1,109.58257,18.28458,1815
9832,74984,AD39A6F857F8E578E6A2D9E072C4613F,60381,17,19,2,109.5241,18.22458,1605
9833,74985,AD39A6F857F8E578E6A2D9E072C4613F,30361,19,20,1,109.50347,18.24,1508
9834,74989,53490AD77ACCA93C3ED0F3DE79CA488B,31071,6,11,5,109.58257,18.28458,1815
9835,74990,53490AD77ACCA93C3ED0F3DE79CA488B,30854,12,13,1,109.56889,18.27076,1763
9836,74991,53490AD77ACCA93C3ED0F3DE79CA488B,31071,17,18,1,109.58257,18.28458,1815
9837,74993,07169E7114E4F14C073261BAAC0D4491,61011,6,13,7,109.60653,18.19076,1900
9838,74998,6E2021B014C4D0B652A2E4FE8D2CF038,31071,16,18,2,109.58257,18.28458,1815
9839,74999,6E2021B014C4D0B652A2E4FE8D2CF038,30151,18,20,2,109.50986,18.25083,1560
9843,75083,F8DC3D69A4622DB1668B3873D901107A,31561,12,14,2,109.56792,18.28479,1765
9844,75084,F8DC3D69A4622DB1668B3873D901107A,30321,15,23,8,109.49563,18.29611,1467
9849,75255,8799356B7181F28146A203E5F86C52F0,31351,0,7,7,109.4959,18.28417,1465
9850,75256,8799356B7181F28146A203E5F86C52F0,38834,8,21,13,109.47639,18.21146,1403
9851,75257,8799356B7181F28146A203E5F86C52F0,31351,22,23,1,109.4959,18.28417,1465
9852,75318,99CBAA6A65A50998F0A10B72B36210E4,60161,13,17,4,109.49174,18.26181,1461
9853,75319,99CBAA6A65A50998F0A10B72B36210E4,38903,19,21,2,109.39229,18.29243,1117
9857,75364,37D38EF0062E64D55C94EB554B76F9EE,30854,0,1,1,109.56889,18.27076,1763
9858,75365,37D38EF0062E64D55C94EB554B76F9EE,31945,2,3,1,109.58021,18.29403,1817
9859,75366,37D38EF0062E64D55C94EB554B76F9EE,30234,5,7,2,109.60681,18.29979,1918
9860,75367,37D38EF0062E64D55C94EB554B76F9EE,30854,7,9,2,109.56889,18.27076,1763
9861,75368,37D38EF0062E64D55C94EB554B76F9EE,31521,18,20,2,109.51458,18.22542,1555
9862,75369,37D38EF0062E64D55C94EB554B76F9EE,30191,21,23,2,109.50361,18.22701,1506
9863,75392,6D9D9FEF6E1E2A39B00A5482D8A29C71,39091,8,14,6,109.50097,18.25222,1510
9864,75414,F44476C9516E6E288D806E3D0B273E0A,31471,14,16,2,109.34583,18.29563,917
9865,75415,F44476C9516E6E288D806E3D0B273E0A,31345,19,20,1,109.39,18.29,1066
9866,75416,F44476C9516E6E288D806E3D0B273E0A,60561,21,22,1,109.38229,18.29785,1067
9867,75467,CE2F298C1C14AD427DCFEBFF75DC6584,30421,18,20,2,109.50021,18.25861,1511
9868,75468,CE2F298C1C14AD427DCFEBFF75DC6584,38157,21,22,1,109.51483,18.26958,1563
9873,75482,919C0AB7D96F3D131A084E8BF1825A69,60131,20,21,1,109.49819,18.24778,1509
9874,75483,919C0AB7D96F3D131A084E8BF1825A69,31521,22,23,1,109.51458,18.22542,1555
9875,75502,4DA30323E7F41DDF0DBBA18594C0CD8F,31061,18,20,2,109.53333,18.23257,1607
9876,75503,4DA30323E7F41DDF0DBBA18594C0CD8F,60381,20,22,2,109.5241,18.22458,1605
9877,75513,BACB6801ACA2D5F4ABE5F40B34865F7A,30854,2,7,5,109.56889,18.27076,1763
9878,75514,BACB6801ACA2D5F4ABE5F40B34865F7A,30851,8,13,5,109.5616,18.27396,1713
9879,75577,01442FD72D1925EC8735B9DA554C8CD5,60131,20,21,1,109.49819,18.24778,1509
9880,75578,01442FD72D1925EC8735B9DA554C8CD5,31521,22,23,1,109.51458,18.22542,1555
9885,75594,65E833AB8D38C5DD26B8A2EAC456C351,30921,0,8,8,109.53903,18.29451,1667
9886,75595,65E833AB8D38C5DD26B8A2EAC456C351,31931,11,20,9,109.54771,18.29403,1667
9887,75596,F6351E53B2F29216163605AA9329821D,38111,0,8,8,109.52007,18.22403,1555
9888,75597,F6351E53B2F29216163605AA9329821D,31781,10,12,2,109.19847,18.2975,367
9889,75598,F6351E53B2F29216163605AA9329821D,38111,17,23,6,109.52007,18.22403,1555
9893,75602,A8E9C7BB918ADAD29A3EA7ACDDCD32D7,38951,0,8,8,109.48097,18.28868,1416
9894,75603,A8E9C7BB918ADAD29A3EA7ACDDCD32D7,60041,9,16,7,109.39889,18.31944,1121
9895,75604,A8E9C7BB918ADAD29A3EA7ACDDCD32D7,38951,17,18,1,109.48097,18.28868,1416
9896,75605,A8E9C7BB918ADAD29A3EA7ACDDCD32D7,30771,19,20,1,109.49938,18.26042,1511
9897,75606,A8E9C7BB918ADAD29A3EA7ACDDCD32D7,38951,21,23,2,109.48097,18.28868,1416
9898,75641,B21CF160B0E7B775D7A1529C97D6304D,31521,0,8,8,109.51458,18.22542,1555
9899,75642,B21CF160B0E7B775D7A1529C97D6304D,31031,11,13,2,109.49979,18.25382,1510
9900,75643,B21CF160B0E7B775D7A1529C97D6304D,31521,13,18,5,109.51458,18.22542,1555
9901,75644,B21CF160B0E7B775D7A1529C97D6304D,30421,19,20,1,109.50021,18.25861,1511
9902,75645,B21CF160B0E7B775D7A1529C97D6304D,31521,21,23,2,109.51458,18.22542,1555
9903,75646,1980C8D409DE9551539224B3D393CDAA,30071,1,16,15,109.52819,18.30472,1619
9904,75647,1980C8D409DE9551539224B3D393CDAA,30071,17,20,3,109.52819,18.30472,1619
9905,75648,8D2C5669816EE4B35A62B874D2922CB5,30151,0,9,9,109.50986,18.25083,1560
9906,75649,8D2C5669816EE4B35A62B874D2922CB5,31471,11,13,2,109.34583,18.29563,917
9907,75650,8D2C5669816EE4B35A62B874D2922CB5,60371,14,15,1,109.53063,18.30056,1618
9908,75678,0C37E18D596D090857038629F350C2E6,30434,12,13,1,109.17083,18.35861,278
9909,75679,0C37E18D596D090857038629F350C2E6,38484,14,17,3,109.53028,18.31528,1620
9910,75697,84E955A0550DCD4ABBE7AEDF9211B01F,38334,0,7,7,109.65035,18.23785,2057
9911,75699,84E955A0550DCD4ABBE7AEDF9211B01F,30854,12,16,4,109.56889,18.27076,1763
9912,75700,84E955A0550DCD4ABBE7AEDF9211B01F,31101,18,19,1,109.65389,18.23403,2057
9913,75701,84E955A0550DCD4ABBE7AEDF9211B01F,38334,21,23,2,109.65035,18.23785,2057
9914,75709,D9AE11CD16B231308C3F0FB3F53BC3E9,31071,0,13,13,109.58257,18.28458,1815
9915,75710,D9AE11CD16B231308C3F0FB3F53BC3E9,30854,14,16,2,109.56889,18.27076,1763
9916,75746,372B6FDE38B899AE3F54A72097165114,39183,0,6,6,109.55542,18.28208,1715
9917,75747,372B6FDE38B899AE3F54A72097165114,31561,6,10,4,109.56792,18.28479,1765
9918,75748,372B6FDE38B899AE3F54A72097165114,39183,13,14,1,109.55542,18.28208,1715
9919,75749,372B6FDE38B899AE3F54A72097165114,31561,15,16,1,109.56792,18.28479,1765
9920,75750,372B6FDE38B899AE3F54A72097165114,39183,17,23,6,109.55542,18.28208,1715
9921,75764,AAB9A05CF7766CAFD5189A62C8D82C8E,30854,11,12,1,109.56889,18.27076,1763
9922,75765,AAB9A05CF7766CAFD5189A62C8D82C8E,30121,13,16,3,109.52861,18.27222,1613
9923,75766,AAB9A05CF7766CAFD5189A62C8D82C8E,30854,19,23,4,109.56889,18.27076,1763
9924,75802,7D4E42032F4B262311ED923AB8EE3966,31781,11,12,1,109.19847,18.2975,367
9925,75803,7D4E42032F4B262311ED923AB8EE3966,30051,14,15,1,109.48917,18.21215,1453
9926,75804,7D4E42032F4B262311ED923AB8EE3966,30711,19,20,1,109.50271,18.25347,1510
9927,75805,7D4E42032F4B262311ED923AB8EE3966,60231,21,22,1,109.49903,18.21972,1504
9928,75822,9915B6FF17BD3BF50FFC7042D095278F,31851,15,17,2,109.71736,18.29007,2316
9929,75823,9915B6FF17BD3BF50FFC7042D095278F,30854,19,21,2,109.56889,18.27076,1763
9930,75861,8752BC71725B50257436D50C6598F252,30854,11,18,7,109.56889,18.27076,1763
9931,75862,8752BC71725B50257436D50C6598F252,31071,20,22,2,109.58257,18.28458,1815
9932,75863,653802FBFFAEB319D5E2987830A7AC5C,60281,0,11,11,109.51743,18.25924,1561
9933,75864,653802FBFFAEB319D5E2987830A7AC5C,60491,15,22,7,109.43354,18.30847,1269
9934,75884,12D8E06C2EC8C969710FB791DF137B2B,31071,0,18,18,109.58257,18.28458,1815
9935,75885,12D8E06C2EC8C969710FB791DF137B2B,30854,20,22,2,109.56889,18.27076,1763
9936,76012,51161D5D6D1A3B73044835EE003078F8,31531,0,1,1,109.49583,18.25972,1461
9937,76013,51161D5D6D1A3B73044835EE003078F8,30201,1,8,7,109.4909,18.26465,1462
9938,76014,51161D5D6D1A3B73044835EE003078F8,30361,10,11,1,109.50347,18.24,1508
9939,76015,51161D5D6D1A3B73044835EE003078F8,31821,12,14,2,109.51181,18.24924,1559
9940,76016,51161D5D6D1A3B73044835EE003078F8,30201,18,23,5,109.4909,18.26465,1462
9941,76030,8FE97C1052D63DE830211C405D8F5442,60631,1,7,6,109.57778,18.27583,1814
9942,76031,8FE97C1052D63DE830211C405D8F5442,30854,8,19,11,109.56889,18.27076,1763
9943,76064,6422CB87ACC55DDEF6EBE8946593C808,38171,0,7,7,109.50799,18.28139,1515
9944,76065,6422CB87ACC55DDEF6EBE8946593C808,38834,11,12,1,109.47639,18.21146,1403
9945,76066,6422CB87ACC55DDEF6EBE8946593C808,60231,16,17,1,109.49903,18.21972,1504
9946,76067,6422CB87ACC55DDEF6EBE8946593C808,38834,18,19,1,109.47639,18.21146,1403
9947,76068,6422CB87ACC55DDEF6EBE8946593C808,31351,21,23,2,109.4959,18.28417,1465
9948,76123,9AA959ED87D1ECC3053DED17290EFCBD,39183,0,3,3,109.55542,18.28208,1715
9949,76124,9AA959ED87D1ECC3053DED17290EFCBD,31561,4,23,19,109.56792,18.28479,1765
9953,76149,C1F80FD61770F46AF18F3BEF2B67E7ED,31551,0,8,8,109.55868,18.24222,1708
9954,76150,C1F80FD61770F46AF18F3BEF2B67E7ED,31781,11,13,2,109.19847,18.2975,367
9955,76151,C1F80FD61770F46AF18F3BEF2B67E7ED,31551,15,23,8,109.55868,18.24222,1708
9956,76222,32D0EBFA645FCE8DAD65D018847E5043,30232,0,6,6,109.6191,18.31701,1971
9957,76223,32D0EBFA645FCE8DAD65D018847E5043,30854,6,19,13,109.56889,18.27076,1763
9958,76224,32D0EBFA645FCE8DAD65D018847E5043,30232,20,21,1,109.6191,18.31701,1971
9959,76225,5AE7D6F49D49A5EB75903602796D6641,60524,3,5,2,109.42951,18.28993,1216
9960,76226,5AE7D6F49D49A5EB75903602796D6641,60401,6,8,2,109.47444,18.27583,1414
9961,76227,5AE7D6F49D49A5EB75903602796D6641,31701,10,11,1,109.44132,18.28833,1266
9962,76228,5AE7D6F49D49A5EB75903602796D6641,31101,13,14,1,109.65389,18.23403,2057
9963,76229,5AE7D6F49D49A5EB75903602796D6641,31061,18,19,1,109.53333,18.23257,1607
9964,76237,A3F1A757214C25A449688115E5C4321B,60371,0,4,4,109.53063,18.30056,1618
9965,76238,A3F1A757214C25A449688115E5C4321B,31931,4,6,2,109.54771,18.29403,1667
9966,76239,7A0882E1E0002B59317F5484D01238B3,31521,0,9,9,109.51458,18.22542,1555
9967,76240,7A0882E1E0002B59317F5484D01238B3,60381,9,11,2,109.5241,18.22458,1605
9968,76241,7A0882E1E0002B59317F5484D01238B3,31521,12,17,5,109.51458,18.22542,1555
9969,76242,7A0882E1E0002B59317F5484D01238B3,30161,18,20,2,109.50042,18.24389,1508
9970,76243,7A0882E1E0002B59317F5484D01238B3,31031,20,21,1,109.49979,18.25382,1510
9971,76247,D12813139FDE232B707FEA7A6291700B,30321,0,17,17,109.49563,18.29611,1467
9972,76248,D12813139FDE232B707FEA7A6291700B,31091,19,20,1,109.41201,18.31222,1170
9973,76249,D12813139FDE232B707FEA7A6291700B,30361,22,23,1,109.50347,18.24,1508
9974,76261,C1DFDFC110B50DFE0D66E47848759FB2,39183,9,12,3,109.55542,18.28208,1715
9975,76263,C1DFDFC110B50DFE0D66E47848759FB2,38961,19,20,1,109.50847,18.23514,1507
9976,76282,B8EC831ABF4906CAA75AE857A37BEB34,31571,0,12,12,109.61563,18.23326,1957
9977,76283,B8EC831ABF4906CAA75AE857A37BEB34,60211,13,16,3,109.63549,18.26049,2011
9978,76284,B8EC831ABF4906CAA75AE857A37BEB34,38071,18,19,1,109.40722,18.30938,1169
9982,76355,C8922FAF66F21ECAECB6B717FCD5A53B,60614,15,17,2,109.48799,18.29521,1467
9983,76356,C8922FAF66F21ECAECB6B717FCD5A53B,60391,17,19,2,109.47667,18.28757,1416
9984,76357,C8922FAF66F21ECAECB6B717FCD5A53B,60614,20,23,3,109.48799,18.29521,1467
9985,76379,9E8746086915F9D4A063A74CF0B5B7AB,31561,0,1,1,109.56792,18.28479,1765
9986,76380,9E8746086915F9D4A063A74CF0B5B7AB,30851,1,2,1,109.5616,18.27396,1713
9987,76381,9E8746086915F9D4A063A74CF0B5B7AB,31561,3,5,2,109.56792,18.28479,1765
9988,76382,9E8746086915F9D4A063A74CF0B5B7AB,39183,8,17,9,109.55542,18.28208,1715
9989,76383,9E8746086915F9D4A063A74CF0B5B7AB,31561,18,23,5,109.56792,18.28479,1765
9990,76410,85E3E19546A8845252074D0B609723D5,30951,12,13,1,109.56208,18.25667,1761
9991,76411,85E3E19546A8845252074D0B609723D5,30854,17,18,1,109.56889,18.27076,1763
9992,76412,85E3E19546A8845252074D0B609723D5,30951,21,23,2,109.56208,18.25667,1761
9996,76486,8B67CA01C44A0A9FF0492771727FF584,30854,0,16,16,109.56889,18.27076,1763
9997,76487,8B67CA01C44A0A9FF0492771727FF584,38241,16,19,3,109.54111,18.30542,1669
9998,76509,103ECFAC0852C7C647F1E538F02D4D90,60211,12,14,2,109.63549,18.26049,2011
9999,76510,103ECFAC0852C7C647F1E538F02D4D90,30501,15,19,4,109.72,18.34951,2326
10000,76511,103ECFAC0852C7C647F1E538F02D4D90,31841,22,23,1,109.73201,18.33382,2373
10001,76534,5CFFF8D919E96524101209E188C669B3,31951,19,23,4,109.52174,18.30299,1568
10002,76547,11111C6844101386CE50DF2BBF6A2434,60101,17,19,2,109.75465,18.40139,2485
10003,76548,11111C6844101386CE50DF2BBF6A2434,31461,20,22,2,109.5091,18.25389,1510
10004,76603,06540DDC6C869D24F26FD34ED45D168E,31345,14,18,4,109.39,18.29,1066
10005,76604,06540DDC6C869D24F26FD34ED45D168E,30661,22,23,1,109.37028,18.24361,1008
10006,76611,E75CF54BA14775FEDD26504F9F6B7365,31945,0,6,6,109.58021,18.29403,1817
10007,76612,E75CF54BA14775FEDD26504F9F6B7365,31561,6,14,8,109.56792,18.28479,1765
10008,76613,E75CF54BA14775FEDD26504F9F6B7365,30854,16,17,1,109.56889,18.27076,1763
10009,76614,E75CF54BA14775FEDD26504F9F6B7365,31561,17,18,1,109.56792,18.28479,1765
10010,76615,E75CF54BA14775FEDD26504F9F6B7365,31945,21,23,2,109.58021,18.29403,1817
10011,76647,D04CD9DD8CE80FB000DDFF2A9F0DD83D,60131,0,7,7,109.49819,18.24778,1509
10012,76648,D04CD9DD8CE80FB000DDFF2A9F0DD83D,60117,9,15,6,109.73604,18.35681,2427
10013,76649,D04CD9DD8CE80FB000DDFF2A9F0DD83D,30771,16,18,2,109.49938,18.26042,1511
10014,76650,D04CD9DD8CE80FB000DDFF2A9F0DD83D,60131,18,19,1,109.49819,18.24778,1509
10015,76651,D04CD9DD8CE80FB000DDFF2A9F0DD83D,30421,20,21,1,109.50021,18.25861,1511
10016,76652,D04CD9DD8CE80FB000DDFF2A9F0DD83D,60131,22,23,1,109.49819,18.24778,1509
10017,76699,C24CAAFE002C4A637E7D01C4B7549E3D,30271,0,6,6,109.49132,18.23153,1456
10018,76701,C24CAAFE002C4A637E7D01C4B7549E3D,30271,14,23,9,109.49132,18.23153,1456
10022,76719,2AE38FAF341950B0B91404FFCE5A0F3E,30921,6,18,12,109.53903,18.29451,1667
10023,76720,2AE38FAF341950B0B91404FFCE5A0F3E,31931,19,23,4,109.54771,18.29403,1667
10024,76724,39F25FE146A03325C93C111F2A943B6C,30854,13,14,1,109.56889,18.27076,1763
10025,76725,39F25FE146A03325C93C111F2A943B6C,31071,15,19,4,109.58257,18.28458,1815
10029,76775,7FD6B252EEC1A25653323974CFE380D9,30181,0,6,6,109.51597,18.23313,1557
10030,76776,7FD6B252EEC1A25653323974CFE380D9,30191,6,8,2,109.50361,18.22701,1506
10031,76777,7FD6B252EEC1A25653323974CFE380D9,60231,9,12,3,109.49903,18.21972,1504
10032,76778,7FD6B252EEC1A25653323974CFE380D9,30181,13,14,1,109.51597,18.23313,1557
10033,76779,7FD6B252EEC1A25653323974CFE380D9,38132,15,23,8,109.64632,18.23417,2057
10034,76833,4E5E7B62F697D24D87C90994BD547EC8,38271,14,16,2,109.62632,18.23049,1956
10035,76836,DFFF17B7FE30E79B8AABBB5CE171272F,31561,4,5,1,109.56792,18.28479,1765
10036,76837,DFFF17B7FE30E79B8AABBB5CE171272F,39183,6,11,5,109.55542,18.28208,1715
10037,76863,0F91AB88D936BFA1E1D2836B4DAF2D14,30854,0,6,6,109.56889,18.27076,1763
10038,76864,0F91AB88D936BFA1E1D2836B4DAF2D14,30531,8,18,10,109.53271,18.21472,1604
10046,76974,0D69669D4DBC1CEB06269A084D86E853,60631,1,2,1,109.57778,18.27583,1814
10047,76975,0D69669D4DBC1CEB06269A084D86E853,30232,3,9,6,109.6191,18.31701,1971
10048,76976,0D69669D4DBC1CEB06269A084D86E853,60631,11,16,5,109.57778,18.27583,1814
10049,77024,319629CFCE811660E456414DCC11FF06,31421,18,19,1,109.55382,18.22347,1705
10050,77025,319629CFCE811660E456414DCC11FF06,31861,20,23,3,109.49042,18.27549,1464
10051,77036,C7CE46A68B16C88AA10A9267A7FDF653,60524,0,10,10,109.42951,18.28993,1216
10052,77037,C7CE46A68B16C88AA10A9267A7FDF653,31101,13,14,1,109.65389,18.23403,2057
10053,77038,C7CE46A68B16C88AA10A9267A7FDF653,31061,15,23,8,109.53333,18.23257,1607
10054,77079,9390F3530298874939B7DDA5575429FD,60401,3,5,2,109.47444,18.27583,1414
10055,77080,9390F3530298874939B7DDA5575429FD,60201,7,9,2,109.5041,18.2509,1510
10056,77081,9390F3530298874939B7DDA5575429FD,38754,12,14,2,109.74667,18.37382,2430
10057,77082,9390F3530298874939B7DDA5575429FD,31701,16,17,1,109.44132,18.28833,1266
10061,77227,77A5CD8493B54A67E96B189E9753DE10,31231,0,7,7,109.42597,18.29292,1217
10062,77228,77A5CD8493B54A67E96B189E9753DE10,38025,7,9,2,109.36903,18.29167,1016
10063,77229,77A5CD8493B54A67E96B189E9753DE10,60561,9,11,2,109.38229,18.29785,1067
10064,77230,77A5CD8493B54A67E96B189E9753DE10,31231,12,14,2,109.42597,18.29292,1217
10065,77231,77A5CD8493B54A67E96B189E9753DE10,60552,14,16,2,109.41729,18.30014,1218
10066,77232,77A5CD8493B54A67E96B189E9753DE10,31231,18,20,2,109.42597,18.29292,1217
10070,77258,2E37B6A823BB12DF110868FD413961C7,30931,17,19,2,109.55653,18.32722,1722
10071,77259,2E37B6A823BB12DF110868FD413961C7,60361,20,23,3,109.51938,18.29681,1567
10072,77270,14F1CC63CDA098F9694EAC8584B9C7A5,30051,0,1,1,109.48917,18.21215,1453
10073,77271,14F1CC63CDA098F9694EAC8584B9C7A5,31561,2,21,19,109.56792,18.28479,1765
10074,77274,B16977B88DE920FADD302624AE75E34D,31761,0,4,4,109.60521,18.27965,1914
10075,77275,B16977B88DE920FADD302624AE75E34D,31071,4,6,2,109.58257,18.28458,1815
10076,77276,B16977B88DE920FADD302624AE75E34D,31561,6,7,1,109.56792,18.28479,1765
10077,77277,B16977B88DE920FADD302624AE75E34D,30851,8,17,9,109.5616,18.27396,1713
10078,77278,B16977B88DE920FADD302624AE75E34D,31945,20,23,3,109.58021,18.29403,1817
10079,77301,E218C587552A5DADC05C4E69685FE374,30854,18,19,1,109.56889,18.27076,1763
10080,77302,E218C587552A5DADC05C4E69685FE374,39183,21,22,1,109.55542,18.28208,1715
10081,77316,12D34EABAB055EE48AA4835BB7A9952C,30421,0,8,8,109.50021,18.25861,1511
10082,77317,12D34EABAB055EE48AA4835BB7A9952C,31541,10,11,1,109.1809,18.36722,329
10083,77318,12D34EABAB055EE48AA4835BB7A9952C,30451,12,13,1,109.1791,18.36229,278
10084,77319,12D34EABAB055EE48AA4835BB7A9952C,30421,17,23,6,109.50021,18.25861,1511
10092,77481,4C15740C85B7C75F2E990BCFA0AEA625,38251,1,2,1,109.49618,18.25493,1510
10093,77482,4C15740C85B7C75F2E990BCFA0AEA625,60401,6,9,3,109.47444,18.27583,1414
10094,77483,4C15740C85B7C75F2E990BCFA0AEA625,31031,9,11,2,109.49979,18.25382,1510
10095,77484,4C15740C85B7C75F2E990BCFA0AEA625,31031,20,21,1,109.49979,18.25382,1510
10096,77485,4C15740C85B7C75F2E990BCFA0AEA625,60401,21,23,2,109.47444,18.27583,1414
10097,77488,0C3DD1EABA2D708A2506DA8150CEC148,31561,0,6,6,109.56792,18.28479,1765
10098,77489,0C3DD1EABA2D708A2506DA8150CEC148,30854,8,10,2,109.56889,18.27076,1763
10099,77490,0C3DD1EABA2D708A2506DA8150CEC148,31561,10,13,3,109.56792,18.28479,1765
10100,77491,0C3DD1EABA2D708A2506DA8150CEC148,30854,15,16,1,109.56889,18.27076,1763
10101,77492,0C3DD1EABA2D708A2506DA8150CEC148,31561,17,22,5,109.56792,18.28479,1765
10106,77562,5B058EBBD270D4814B560F0B36F48A4A,31561,12,14,2,109.56792,18.28479,1765
10107,77563,5B058EBBD270D4814B560F0B36F48A4A,30321,15,22,7,109.49563,18.29611,1467
10108,77590,FCFB14BA36BDB7CD6A39612B9AE933B2,38127,0,7,7,109.50833,18.27222,1513
10109,77591,FCFB14BA36BDB7CD6A39612B9AE933B2,31931,9,11,2,109.54771,18.29403,1667
10110,77592,FCFB14BA36BDB7CD6A39612B9AE933B2,39183,12,13,1,109.55542,18.28208,1715
10111,77593,FCFB14BA36BDB7CD6A39612B9AE933B2,31931,14,16,2,109.54771,18.29403,1667
10112,77594,FCFB14BA36BDB7CD6A39612B9AE933B2,30081,20,22,2,109.50243,18.26632,1512
10113,77595,72839B8F6256E6FF641405D4832BF569,31071,0,7,7,109.58257,18.28458,1815
10114,77596,72839B8F6256E6FF641405D4832BF569,30854,11,12,1,109.56889,18.27076,1763
10115,77609,599AFAF71D30C85AA4E0085C43FF5E03,60221,0,1,1,109.52569,18.29188,1616
10116,77610,599AFAF71D30C85AA4E0085C43FF5E03,31206,1,2,1,109.50819,18.23549,1507
10117,77611,599AFAF71D30C85AA4E0085C43FF5E03,31206,3,6,3,109.50819,18.23549,1507
10118,77612,599AFAF71D30C85AA4E0085C43FF5E03,38291,13,15,2,109.51618,18.24313,1558
10119,77613,599AFAF71D30C85AA4E0085C43FF5E03,31421,15,21,6,109.55382,18.22347,1705
10120,77625,9F0C410FCC258D7DDDE61AECD9DDED82,30854,0,7,7,109.56889,18.27076,1763
10121,77627,9F0C410FCC258D7DDDE61AECD9DDED82,30854,11,23,12,109.56889,18.27076,1763
10129,77661,D8757A808F606352AF3AC0BD9CD2C12A,31101,17,19,2,109.65389,18.23403,2057
10130,77662,D8757A808F606352AF3AC0BD9CD2C12A,30854,20,21,1,109.56889,18.27076,1763
10131,77691,B432C0186449A28ED200760F76E06147,60524,0,9,9,109.42951,18.28993,1216
10132,77692,B432C0186449A28ED200760F76E06147,39151,13,15,2,109.49875,18.25097,1510
10133,77693,B432C0186449A28ED200760F76E06147,38251,16,17,1,109.49618,18.25493,1510
10134,77694,B432C0186449A28ED200760F76E06147,60401,18,20,2,109.47444,18.27583,1414
10135,77695,B432C0186449A28ED200760F76E06147,60524,21,23,2,109.42951,18.28993,1216
10136,77699,E6651E3C6D8FEA2077D9EFC6D097D06C,38251,0,13,13,109.49618,18.25493,1510
10137,77700,E6651E3C6D8FEA2077D9EFC6D097D06C,30711,17,23,6,109.50271,18.25347,1510
10138,77724,079A114D194FE2EFB0C89059CA4EBC03,31251,0,2,2,109.18528,18.2975,317
10139,77726,079A114D194FE2EFB0C89059CA4EBC03,31251,9,12,3,109.18528,18.2975,317
10143,77824,DEB0ECEC5EC593548F1436EFB82D45FB,60361,0,6,6,109.51938,18.29681,1567
10144,77825,DEB0ECEC5EC593548F1436EFB82D45FB,60331,9,10,1,109.505,18.26507,1512
10145,77826,DEB0ECEC5EC593548F1436EFB82D45FB,31421,11,13,2,109.55382,18.22347,1705
10146,77827,DEB0ECEC5EC593548F1436EFB82D45FB,31551,14,16,2,109.55868,18.24222,1708
10147,77828,DEB0ECEC5EC593548F1436EFB82D45FB,60361,19,23,4,109.51938,18.29681,1567
10151,77833,C9A6646B972DBA0085DABB092A32801A,38127,19,21,2,109.50833,18.27222,1513
10152,77834,C9A6646B972DBA0085DABB092A32801A,30081,22,23,1,109.50243,18.26632,1512
10153,77835,E649CF84A26278291AA1A5B5C5D01FCA,30854,0,16,16,109.56889,18.27076,1763
10154,77836,E649CF84A26278291AA1A5B5C5D01FCA,31561,16,23,7,109.56792,18.28479,1765
10159,77892,A316D0DC5964BFEDB6CDF37499B8E5FF,60631,0,7,7,109.57778,18.27583,1814
10160,77893,A316D0DC5964BFEDB6CDF37499B8E5FF,30851,8,17,9,109.5616,18.27396,1713
10161,77897,6C0260646767B781577B5B8CE2471E51,38484,6,17,11,109.53028,18.31528,1620
10162,77898,6C0260646767B781577B5B8CE2471E51,30071,20,22,2,109.52819,18.30472,1619
10163,77899,6C0260646767B781577B5B8CE2471E51,38484,22,23,1,109.53028,18.31528,1620
10167,77962,7D7F0272C9EBC060D193BEFCF3336FD2,60551,1,6,5,109.42722,18.30111,1218
10168,77963,7D7F0272C9EBC060D193BEFCF3336FD2,60552,7,8,1,109.41729,18.30014,1218
10169,77971,B4D2B6FFD1C494680FE0C505C6C9A74D,60361,0,10,10,109.51938,18.29681,1567
10170,77972,B4D2B6FFD1C494680FE0C505C6C9A74D,31931,12,19,7,109.54771,18.29403,1667
10171,77988,4BDDDFE5CA0514443B2B3ACDA26168C5,31421,7,10,3,109.55382,18.22347,1705
10172,77989,4BDDDFE5CA0514443B2B3ACDA26168C5,30951,10,14,4,109.56208,18.25667,1761
10173,77990,4BDDDFE5CA0514443B2B3ACDA26168C5,31421,14,19,5,109.55382,18.22347,1705
10174,77991,4BDDDFE5CA0514443B2B3ACDA26168C5,30951,20,22,2,109.56208,18.25667,1761
10175,77992,4BDDDFE5CA0514443B2B3ACDA26168C5,30851,22,23,1,109.5616,18.27396,1713
10179,78041,CFFDD1BF3134B9FDD71614F40E1DE0FD,31071,6,13,7,109.58257,18.28458,1815
10180,78042,CFFDD1BF3134B9FDD71614F40E1DE0FD,60241,16,19,3,109.53319,18.28667,1616
10184,78068,8AABF5FDF2B06EB445749240A3894969,31851,16,18,2,109.71736,18.29007,2316
10185,78069,8AABF5FDF2B06EB445749240A3894969,31071,18,20,2,109.58257,18.28458,1815
10193,78133,13926428EBE13B4BB9E89F09B3402551,31531,0,7,7,109.49583,18.25972,1461
10194,78134,13926428EBE13B4BB9E89F09B3402551,31301,9,12,3,109.14493,18.31222,170
10195,78135,13926428EBE13B4BB9E89F09B3402551,31471,12,14,2,109.34583,18.29563,917
10196,78136,13926428EBE13B4BB9E89F09B3402551,30771,18,20,2,109.49938,18.26042,1511
10197,78137,13926428EBE13B4BB9E89F09B3402551,38251,21,22,1,109.49618,18.25493,1510
10198,78148,FD9120CA3F85D3F015CEFB66B9BF2F3D,30721,0,6,6,109.51597,18.28257,1565
10199,78149,FD9120CA3F85D3F015CEFB66B9BF2F3D,60301,8,11,3,109.60715,18.30993,1919
10200,78150,FD9120CA3F85D3F015CEFB66B9BF2F3D,38891,12,18,6,109.51486,18.24118,1558
10201,78156,FC8552628F8A5A5219C1C30314657039,60661,0,4,4,109.548,18.2377,1657
10202,78157,FC8552628F8A5A5219C1C30314657039,30854,8,10,2,109.56889,18.27076,1763
10203,78158,FC8552628F8A5A5219C1C30314657039,30271,12,18,6,109.49132,18.23153,1456
10204,78159,FC8552628F8A5A5219C1C30314657039,31031,19,20,1,109.49979,18.25382,1510
10205,78160,FC8552628F8A5A5219C1C30314657039,60661,21,22,1,109.548,18.2377,1657
10206,78179,86360CBE83A45C2F8F04805EB9121831,38157,0,7,7,109.51483,18.26958,1563
10207,78180,86360CBE83A45C2F8F04805EB9121831,60331,8,11,3,109.505,18.26507,1512
10208,78181,86360CBE83A45C2F8F04805EB9121831,38157,13,14,1,109.51483,18.26958,1563
10209,78182,86360CBE83A45C2F8F04805EB9121831,60381,18,20,2,109.5241,18.22458,1605
10210,78183,86360CBE83A45C2F8F04805EB9121831,30251,21,22,1,109.50611,18.26653,1512
10215,78221,30CE72A519D49881F23B8123486E3A02,60411,0,2,2,109.32514,18.30854,869
10216,78222,30CE72A519D49881F23B8123486E3A02,30661,2,4,2,109.37028,18.24361,1008
10217,78223,30CE72A519D49881F23B8123486E3A02,60054,5,6,1,109.3016,18.31229,770
10218,78224,30CE72A519D49881F23B8123486E3A02,60411,7,10,3,109.32514,18.30854,869
10219,78225,30CE72A519D49881F23B8123486E3A02,31471,16,18,2,109.34583,18.29563,917
10220,78226,30CE72A519D49881F23B8123486E3A02,60411,18,19,1,109.32514,18.30854,869
10221,78239,E2A254B664D603859C9454241D0A5D2B,30181,16,17,1,109.51597,18.23313,1557
10222,78240,E2A254B664D603859C9454241D0A5D2B,31521,18,23,5,109.51458,18.22542,1555
10223,78268,7D9D1B6AF5E36EC156BCC81EE5745CAE,31031,11,12,1,109.49979,18.25382,1510
10224,78269,7D9D1B6AF5E36EC156BCC81EE5745CAE,38251,15,16,1,109.49618,18.25493,1510
10225,78270,7D9D1B6AF5E36EC156BCC81EE5745CAE,30271,17,18,1,109.49132,18.23153,1456
10230,78343,02B6B5412B758335455F3642E59B11F1,38127,0,1,1,109.50833,18.27222,1513
10231,78344,02B6B5412B758335455F3642E59B11F1,38951,1,7,6,109.48097,18.28868,1416
10232,78345,02B6B5412B758335455F3642E59B11F1,60552,8,10,2,109.41729,18.30014,1218
10236,78403,0C70A52F592FCFAC1CDC42762C9A17A0,60614,0,17,17,109.48799,18.29521,1467
10237,78404,0C70A52F592FCFAC1CDC42762C9A17A0,31206,19,20,1,109.50819,18.23549,1507
10238,78421,89C2F48F3C187B81197D45E0E1289EA8,30851,2,7,5,109.5616,18.27396,1713
10239,78422,89C2F48F3C187B81197D45E0E1289EA8,30854,7,11,4,109.56889,18.27076,1763
10243,78508,530ABDCB6E5C0FF39924B84145065468,30361,0,13,13,109.50347,18.24,1508
10244,78509,530ABDCB6E5C0FF39924B84145065468,38061,17,18,1,109.50597,18.23118,1506
10245,78522,0E2E791F47920A60A5F7E41FFDC79CF5,31071,12,13,1,109.58257,18.28458,1815
10246,78523,0E2E791F47920A60A5F7E41FFDC79CF5,39101,13,17,4,109.50132,18.24931,1509
10247,78546,145444E87E9AD1AA916406CE6DA79363,31471,13,15,2,109.34583,18.29563,917
10248,78547,145444E87E9AD1AA916406CE6DA79363,60221,18,21,3,109.52569,18.29188,1616
10249,78548,145444E87E9AD1AA916406CE6DA79363,31864,21,23,2,109.49014,18.28333,1465
10250,78566,1B6EBBFF3B9D8A3E18753343B6A29EAE,31561,13,14,1,109.56792,18.28479,1765
10251,78567,1B6EBBFF3B9D8A3E18753343B6A29EAE,30854,15,16,1,109.56889,18.27076,1763
10252,78568,1B6EBBFF3B9D8A3E18753343B6A29EAE,31071,19,23,4,109.58257,18.28458,1815
10253,78575,EC89B2FFE00F967E6D0A3B697A6D636D,31071,3,6,3,109.58257,18.28458,1815
10254,78576,EC89B2FFE00F967E6D0A3B697A6D636D,30854,7,17,10,109.56889,18.27076,1763
10255,78577,EC89B2FFE00F967E6D0A3B697A6D636D,60281,19,21,2,109.51743,18.25924,1561
10256,78578,EC89B2FFE00F967E6D0A3B697A6D636D,30211,22,23,1,109.49882,18.23931,1508
10257,78594,64232E916CD3E53F0C7902BD5EE111F8,31781,13,15,2,109.19847,18.2975,367
10258,78600,31D93E56E65CB3BFF8E1D9727D47FCD1,38991,0,7,7,109.52681,18.30368,1618
10259,78601,31D93E56E65CB3BFF8E1D9727D47FCD1,60361,9,12,3,109.51938,18.29681,1567
10260,78602,31D93E56E65CB3BFF8E1D9727D47FCD1,30071,14,15,1,109.52819,18.30472,1619
10261,78603,31D93E56E65CB3BFF8E1D9727D47FCD1,38991,16,17,1,109.52681,18.30368,1618
10262,78604,31D93E56E65CB3BFF8E1D9727D47FCD1,30561,18,19,1,109.52778,18.31938,1621
10263,78617,4D4289AE0DFBF4B5C79A47559DC2EBDD,30854,1,19,18,109.56889,18.27076,1763
10264,78618,4D4289AE0DFBF4B5C79A47559DC2EBDD,60381,20,22,2,109.5241,18.22458,1605
10271,78660,74206C862E4BA6236E7F7978D63D1D7D,30854,15,16,1,109.56889,18.27076,1763
10272,78661,74206C862E4BA6236E7F7978D63D1D7D,31021,19,20,1,109.49021,18.27,1463
10273,78662,74206C862E4BA6236E7F7978D63D1D7D,30191,21,23,2,109.50361,18.22701,1506
10274,78674,A3770B0865AC4E52928450D9302DBAEF,60221,2,7,5,109.52569,18.29188,1616
10275,78675,A3770B0865AC4E52928450D9302DBAEF,31145,12,13,1,109.20431,18.30479,369
10287,78717,BD38467346E00D9FC913492A38FA335E,31071,1,5,4,109.58257,18.28458,1815
10288,78718,BD38467346E00D9FC913492A38FA335E,31761,6,7,1,109.60521,18.27965,1914
10289,78719,BD38467346E00D9FC913492A38FA335E,31561,8,10,2,109.56792,18.28479,1765
10290,78720,BD38467346E00D9FC913492A38FA335E,31071,15,16,1,109.58257,18.28458,1815
10291,78721,BD38467346E00D9FC913492A38FA335E,31945,19,20,1,109.58021,18.29403,1817
10295,78743,2193DBFF071303BC78357ADF9D951389,30854,3,9,6,109.56889,18.27076,1763
10296,78744,2193DBFF071303BC78357ADF9D951389,60591,11,12,1,109.61118,18.21715,1904
10297,78745,2193DBFF071303BC78357ADF9D951389,60631,14,15,1,109.57778,18.27583,1814
10298,78746,2193DBFF071303BC78357ADF9D951389,30851,18,21,3,109.5616,18.27396,1713
10299,78747,2193DBFF071303BC78357ADF9D951389,60631,22,23,1,109.57778,18.27583,1814
10300,78748,172CB232BBE684655CFBDFD055BB1CB5,30771,0,7,7,109.49938,18.26042,1511
10301,78749,172CB232BBE684655CFBDFD055BB1CB5,31231,8,9,1,109.42597,18.29292,1217
10302,78750,172CB232BBE684655CFBDFD055BB1CB5,30241,11,21,10,109.26174,18.3275,622
10303,78763,24C0932BD5754CA1476755EEBD27CEBD,30084,19,20,1,109.50118,18.26972,1513
10304,78764,24C0932BD5754CA1476755EEBD27CEBD,31811,21,23,2,109.54201,18.31806,1671
10308,78869,CC02FF405B205BC11ABABAB0E9CD605B,31473,16,17,1,109.34792,18.29465,917
10309,78870,CC02FF405B205BC11ABABAB0E9CD605B,30731,18,23,5,109.50944,18.22306,1555
10310,78929,B02D7A3F297B377D646E0F85B7C19006,61011,6,17,11,109.60653,18.19076,1900
10311,78930,B02D7A3F297B377D646E0F85B7C19006,30151,18,20,2,109.50986,18.25083,1560
10312,78938,3720DDB8E91BF73FF05637BA50F0661B,31521,17,18,1,109.51458,18.22542,1555
10313,78939,3720DDB8E91BF73FF05637BA50F0661B,30511,21,22,1,109.51069,18.24208,1558
10314,78942,246EF4D95FA494895EFB2D649512DAE7,60081,0,3,3,109.51097,18.22639,1556
10315,78943,246EF4D95FA494895EFB2D649512DAE7,60381,3,4,1,109.5241,18.22458,1605
10316,78944,246EF4D95FA494895EFB2D649512DAE7,61011,8,10,2,109.60653,18.19076,1900
10317,78968,080247CC19405F981D4BEFE1A1E9D339,31931,1,5,4,109.54771,18.29403,1667
10318,78969,080247CC19405F981D4BEFE1A1E9D339,39181,5,16,11,109.55153,18.28035,1715
10326,79018,F95E8C48F26FEDEBE2F61D5B3778D40A,60641,11,16,5,109.53854,18.2359,1657
10327,79019,F95E8C48F26FEDEBE2F61D5B3778D40A,31421,19,20,1,109.55382,18.22347,1705
10328,79020,F95E8C48F26FEDEBE2F61D5B3778D40A,38541,21,23,2,109.73715,18.34875,2426
10329,79166,45FA8AF959A216E06C82392E21728E7F,31561,0,9,9,109.56792,18.28479,1765
10330,79167,45FA8AF959A216E06C82392E21728E7F,30851,10,11,1,109.5616,18.27396,1713
10331,79168,45FA8AF959A216E06C82392E21728E7F,31071,13,14,1,109.58257,18.28458,1815
10332,79169,45FA8AF959A216E06C82392E21728E7F,30851,15,18,3,109.5616,18.27396,1713
10333,79170,45FA8AF959A216E06C82392E21728E7F,31561,20,23,3,109.56792,18.28479,1765
10334,79171,F5241F30A5380EF6C0AA7917E77D8230,60371,0,6,6,109.53063,18.30056,1618
10335,79211,FF8CB3D02361FAEBFE418108180099D8,60201,0,12,12,109.5041,18.2509,1510
10336,79212,FF8CB3D02361FAEBFE418108180099D8,30711,14,21,7,109.50271,18.25347,1510
10341,79242,E2875F3D6B45C4D271B5DDC71A8A371B,38754,14,18,4,109.74667,18.37382,2430
10342,79243,E2875F3D6B45C4D271B5DDC71A8A371B,60291,21,22,1,109.50826,18.24639,1509
10357,79402,546BD11519F9A54B0591AC07E93BC6C8,30571,0,8,8,109.50243,18.21861,1504
10358,79403,546BD11519F9A54B0591AC07E93BC6C8,31471,12,14,2,109.34583,18.29563,917
10359,79404,546BD11519F9A54B0591AC07E93BC6C8,38023,17,18,1,109.37132,18.28993,1016
10360,79405,546BD11519F9A54B0591AC07E93BC6C8,30571,21,23,2,109.50243,18.21861,1504
10361,79406,9B389AE8E9B004176803CCEAFF69104A,31071,3,4,1,109.58257,18.28458,1815
10362,79407,9B389AE8E9B004176803CCEAFF69104A,60631,5,19,14,109.57778,18.27583,1814
10363,79455,8877F0646282478FC034CF7A2CC8A7FE,31521,0,19,19,109.51458,18.22542,1555
10364,79456,8877F0646282478FC034CF7A2CC8A7FE,30361,19,21,2,109.50347,18.24,1508
10371,79490,80779C982E47128931C5479B9B9DAF80,30421,0,9,9,109.50021,18.25861,1511
10372,79491,80779C982E47128931C5479B9B9DAF80,30711,9,10,1,109.50271,18.25347,1510
10373,79492,80779C982E47128931C5479B9B9DAF80,30151,12,14,2,109.50986,18.25083,1560
10374,79493,80779C982E47128931C5479B9B9DAF80,38157,15,20,5,109.51483,18.26958,1563
10375,79494,80779C982E47128931C5479B9B9DAF80,30421,21,23,2,109.50021,18.25861,1511
10379,79519,AC138466D01C962CA6314931C59248B4,30861,0,3,3,109.52722,18.22743,1606
10380,79520,AC138466D01C962CA6314931C59248B4,30861,4,8,4,109.52722,18.22743,1606
10381,79521,AC138466D01C962CA6314931C59248B4,31781,11,14,3,109.19847,18.2975,367
10385,79587,7112BF910BB8852FB892FD72D6683B89,30161,19,20,1,109.50042,18.24389,1508
10386,79588,7112BF910BB8852FB892FD72D6683B89,38291,21,23,2,109.51618,18.24313,1558
10387,79640,C358285726113434A30FBBA8DED710E7,60371,0,9,9,109.53063,18.30056,1618
10388,79641,C358285726113434A30FBBA8DED710E7,60552,12,13,1,109.41729,18.30014,1218
10389,79658,F8290DFC7AD7A3BC6FCA7482642F724C,38871,5,6,1,109.44681,18.28625,1316
10390,79659,F8290DFC7AD7A3BC6FCA7482642F724C,31701,6,8,2,109.44132,18.28833,1266
10391,79668,DE841C2C767041F00D7DAF75FFC633F6,30771,1,5,4,109.49938,18.26042,1511
10392,79669,DE841C2C767041F00D7DAF75FFC633F6,30421,6,21,15,109.50021,18.25861,1511
10393,79707,24E98C0EC4A6054CC486A2611C493128,30854,1,2,1,109.56889,18.27076,1763
10394,79708,24E98C0EC4A6054CC486A2611C493128,31071,3,18,15,109.58257,18.28458,1815
10395,79709,24E98C0EC4A6054CC486A2611C493128,30361,21,23,2,109.50347,18.24,1508
10400,79790,22B987DE38F8C4435934FE5E6190C4A2,60631,0,5,5,109.57778,18.27583,1814
10401,79791,22B987DE38F8C4435934FE5E6190C4A2,31101,8,9,1,109.65389,18.23403,2057
10402,79792,22B987DE38F8C4435934FE5E6190C4A2,38271,11,13,2,109.62632,18.23049,1956
10403,79793,22B987DE38F8C4435934FE5E6190C4A2,60591,15,17,2,109.61118,18.21715,1904
10404,79797,BE7763F8096EB5A037146E1CC4190538,30854,6,7,1,109.56889,18.27076,1763
10405,79798,BE7763F8096EB5A037146E1CC4190538,31561,10,19,9,109.56792,18.28479,1765
10406,79799,BE7763F8096EB5A037146E1CC4190538,30854,22,23,1,109.56889,18.27076,1763
10410,79874,8B3125BACE32612AE7F9DC5599DC75E6,60081,0,3,3,109.51097,18.22639,1556
10411,79875,8B3125BACE32612AE7F9DC5599DC75E6,30661,5,10,5,109.37028,18.24361,1008
10412,79876,8B3125BACE32612AE7F9DC5599DC75E6,60081,12,17,5,109.51097,18.22639,1556
10413,79877,8B3125BACE32612AE7F9DC5599DC75E6,60381,18,23,5,109.5241,18.22458,1605
10414,79919,BA0C44295D246224E442075F9885D682,30581,18,19,1,109.62257,18.24951,1959
10415,79920,BA0C44295D246224E442075F9885D682,38283,20,22,2,109.62229,18.22618,1956
10416,79931,2E29BE7E21F829BB8E4505964B146371,30854,1,2,1,109.56889,18.27076,1763
10417,79932,2E29BE7E21F829BB8E4505964B146371,31561,2,13,11,109.56792,18.28479,1765
10418,79954,0EEF00D524FC221E0814F0ECEF97AD09,31521,0,9,9,109.51458,18.22542,1555
10422,80014,CD3BCBAB8571FB81953C842A434E5DB8,30854,7,12,5,109.56889,18.27076,1763
10423,80015,CD3BCBAB8571FB81953C842A434E5DB8,31071,13,21,8,109.58257,18.28458,1815
10424,80074,FB16AA24AD94D8CC7E1110E44BD68910,30861,12,15,3,109.52722,18.22743,1606
10425,80075,FB16AA24AD94D8CC7E1110E44BD68910,31945,18,20,2,109.58021,18.29403,1817
10426,80092,C08AC91C10840D760EE6198DD08AFEC8,39101,1,8,7,109.50132,18.24931,1509
10427,80093,C08AC91C10840D760EE6198DD08AFEC8,31145,12,14,2,109.20431,18.30479,369
10428,80094,C08AC91C10840D760EE6198DD08AFEC8,31391,19,21,2,109.50382,18.24285,1508
10429,80095,C08AC91C10840D760EE6198DD08AFEC8,39101,21,23,2,109.50132,18.24931,1509
10430,80112,C164C30B5AB18A9045271D53A346B477,60381,19,21,2,109.5241,18.22458,1605
10431,80113,C164C30B5AB18A9045271D53A346B477,60411,22,23,1,109.32514,18.30854,869
10432,80118,8EA475D017A01807E97E34F719EA95E4,31421,4,16,12,109.55382,18.22347,1705
10433,80119,8EA475D017A01807E97E34F719EA95E4,30851,18,21,3,109.5616,18.27396,1713
10434,80120,E79FCCBA9F6300DF5C81A804945B477E,31071,1,4,3,109.58257,18.28458,1815
10435,80121,E79FCCBA9F6300DF5C81A804945B477E,30854,5,7,2,109.56889,18.27076,1763
10436,80122,E79FCCBA9F6300DF5C81A804945B477E,31071,10,13,3,109.58257,18.28458,1815
10437,80123,E79FCCBA9F6300DF5C81A804945B477E,31945,14,15,1,109.58021,18.29403,1817
10438,80124,E79FCCBA9F6300DF5C81A804945B477E,31071,15,17,2,109.58257,18.28458,1815
10439,80125,D8898064D7FB8C9B8CE800B6EE2F87B6,30232,0,6,6,109.6191,18.31701,1971
10440,80126,D8898064D7FB8C9B8CE800B6EE2F87B6,30854,7,12,5,109.56889,18.27076,1763
10441,80127,D8898064D7FB8C9B8CE800B6EE2F87B6,39183,14,16,2,109.55542,18.28208,1715
10442,80128,D8898064D7FB8C9B8CE800B6EE2F87B6,30854,19,20,1,109.56889,18.27076,1763
10443,80135,C3D97A298AB6EB8497D0CC432E6DD8A2,61011,12,15,3,109.60653,18.19076,1900
10444,80136,C3D97A298AB6EB8497D0CC432E6DD8A2,30151,18,20,2,109.50986,18.25083,1560
10445,80137,C3D97A298AB6EB8497D0CC432E6DD8A2,60114,22,23,1,109.73028,18.33847,2374
10446,80156,34A1BA5A97F90C4ABB34EDC7004774A9,31071,12,14,2,109.58257,18.28458,1815
10447,80157,34A1BA5A97F90C4ABB34EDC7004774A9,30851,17,23,6,109.5616,18.27396,1713
10448,80167,9B43F93397D8AD2193F77AAD4D6186E5,30721,18,23,5,109.51597,18.28257,1565
10449,80172,F6517175486155917A178CA148E820EF,31701,0,9,9,109.44132,18.28833,1266
10450,80173,F6517175486155917A178CA148E820EF,31471,12,14,2,109.34583,18.29563,917
10451,80174,F6517175486155917A178CA148E820EF,60054,15,16,1,109.3016,18.31229,770
10452,80175,F6517175486155917A178CA148E820EF,31701,18,23,5,109.44132,18.28833,1266
10453,80182,C0F04DA5BBC3EA089436357A9062298C,31521,2,9,7,109.51458,18.22542,1555
10454,80183,C0F04DA5BBC3EA089436357A9062298C,39081,12,13,1,109.19382,18.29111,366
10455,80184,C0F04DA5BBC3EA089436357A9062298C,31781,13,15,2,109.19847,18.2975,367
10456,80185,C0F04DA5BBC3EA089436357A9062298C,31521,19,23,4,109.51458,18.22542,1555
10460,80217,0547C7536E43628EF24935F0C2BF5E2C,60241,1,6,5,109.53319,18.28667,1616
10461,80218,0547C7536E43628EF24935F0C2BF5E2C,31931,7,10,3,109.54771,18.29403,1667
10465,80227,FD67FE4B7E9CF4CE22EB70AA68B16AE3,60331,1,5,4,109.505,18.26507,1512
10466,80228,FD67FE4B7E9CF4CE22EB70AA68B16AE3,31461,5,9,4,109.5091,18.25389,1510
10467,80229,FD67FE4B7E9CF4CE22EB70AA68B16AE3,31471,12,15,3,109.34583,18.29563,917
10468,80230,FD67FE4B7E9CF4CE22EB70AA68B16AE3,30421,18,19,1,109.50021,18.25861,1511
10469,80231,FD67FE4B7E9CF4CE22EB70AA68B16AE3,60331,20,23,3,109.505,18.26507,1512
10470,80242,5EBEA276FCB4A19AC5C987F5C7CC8908,60504,1,8,7,109.47917,18.28903,1416
10471,80243,5EBEA276FCB4A19AC5C987F5C7CC8908,38361,9,11,2,109.43667,18.29201,1267
10472,80244,5EBEA276FCB4A19AC5C987F5C7CC8908,60401,11,13,2,109.47444,18.27583,1414
10473,80245,5EBEA276FCB4A19AC5C987F5C7CC8908,60552,13,15,2,109.41729,18.30014,1218
10474,80246,5EBEA276FCB4A19AC5C987F5C7CC8908,60504,16,17,1,109.47917,18.28903,1416
10475,80247,5EBEA276FCB4A19AC5C987F5C7CC8908,60552,19,20,1,109.41729,18.30014,1218
10479,80259,028777DBF8176CB8A735B293EDB3D71F,31931,0,17,17,109.54771,18.29403,1667
10480,80260,028777DBF8176CB8A735B293EDB3D71F,39181,19,20,1,109.55153,18.28035,1715
10481,80271,7B1A07C39637E996C01DF0A3D287D3C6,31071,0,4,4,109.58257,18.28458,1815
10482,80272,7B1A07C39637E996C01DF0A3D287D3C6,30854,4,23,19,109.56889,18.27076,1763
10483,80276,F0815D578D26B350DB87D25249BACE31,30351,17,18,1,109.41701,18.29292,1217
10484,80277,F0815D578D26B350DB87D25249BACE31,60221,19,21,2,109.52569,18.29188,1616
10485,80278,DB4DF566D4757FF3BB488F82DE126248,31561,18,19,1,109.56792,18.28479,1765
10486,80279,DB4DF566D4757FF3BB488F82DE126248,60351,20,23,3,109.58403,18.28958,1816
10487,80288,FBC323A047041F71D8997C22FDE88F17,38017,0,2,2,109.49729,18.21424,1504
10488,80289,FBC323A047041F71D8997C22FDE88F17,30181,2,10,8,109.51597,18.23313,1557
10489,80290,FBC323A047041F71D8997C22FDE88F17,31041,12,13,1,109.50278,18.23701,1507
10490,80291,FBC323A047041F71D8997C22FDE88F17,38336,15,17,2,109.61111,18.21806,1904
10491,80292,FBC323A047041F71D8997C22FDE88F17,30281,19,21,2,109.50597,18.27583,1514
10492,80295,0312B43ACF9ED1D8304E325E851AEE29,30851,4,12,8,109.5616,18.27396,1713
10493,80296,0312B43ACF9ED1D8304E325E851AEE29,31561,13,21,8,109.56792,18.28479,1765
10494,80305,76E12A118C330D9C1C9FA24D20FBD536,31864,18,20,2,109.49014,18.28333,1465
10495,80306,76E12A118C330D9C1C9FA24D20FBD536,31181,21,23,2,109.50382,18.24813,1509
10504,80328,CE6CEE81590042CA6F5DB32658274CD4,60161,19,20,1,109.49174,18.26181,1461
10505,80329,CE6CEE81590042CA6F5DB32658274CD4,30711,20,22,2,109.50271,18.25347,1510
10506,80348,59E923A20262174FA0932772270B33BC,60201,2,6,4,109.5041,18.2509,1510
10507,80349,59E923A20262174FA0932772270B33BC,31031,7,12,5,109.49979,18.25382,1510
10508,80350,59E923A20262174FA0932772270B33BC,31471,15,18,3,109.34583,18.29563,917
10509,80351,59E923A20262174FA0932772270B33BC,60201,19,22,3,109.5041,18.2509,1510
10510,80388,54010DBEF2CEA9E14DD9AB244385D257,60054,12,13,1,109.3016,18.31229,770
10511,80389,54010DBEF2CEA9E14DD9AB244385D257,30341,14,15,1,109.3625,18.29167,966
10512,80390,54010DBEF2CEA9E14DD9AB244385D257,31521,19,20,1,109.51458,18.22542,1555
10513,80419,C8135D3E403B7CC96352A41CBCD291A7,31571,15,16,1,109.61563,18.23326,1957
10514,80420,C8135D3E403B7CC96352A41CBCD291A7,31931,20,21,1,109.54771,18.29403,1667
10515,80421,5D3FF793EF0DA0E8CE0DBE9C3E8AB37A,60631,1,18,17,109.57778,18.27583,1814
10516,80422,5D3FF793EF0DA0E8CE0DBE9C3E8AB37A,31071,21,23,2,109.58257,18.28458,1815
10517,80434,09390A13C8E5C15C1E5674E3DB9139EC,60201,6,8,2,109.5041,18.2509,1510
10518,80435,09390A13C8E5C15C1E5674E3DB9139EC,60161,11,16,5,109.49174,18.26181,1461
10519,80436,09390A13C8E5C15C1E5674E3DB9139EC,60084,17,19,2,109.4984,18.2334,1507
10520,80464,8A13D51E493E320785CD9E0AA80310AA,38052,1,9,8,109.62618,18.23042,1956
10521,80465,8A13D51E493E320785CD9E0AA80310AA,33101,10,12,2,109.68438,18.44368,2242
10522,80466,8A13D51E493E320785CD9E0AA80310AA,60381,17,19,2,109.5241,18.22458,1605
10523,80506,44B51AB0086A395492A545161BBB3047,39111,0,5,5,109.5191,18.22597,1555
10524,80507,44B51AB0086A395492A545161BBB3047,39321,6,7,1,109.529,18.2167,1604
10525,80508,44B51AB0086A395492A545161BBB3047,31521,7,14,7,109.51458,18.22542,1555
10526,80509,44B51AB0086A395492A545161BBB3047,60381,14,15,1,109.5241,18.22458,1605
10527,80510,44B51AB0086A395492A545161BBB3047,31521,16,20,4,109.51458,18.22542,1555
10528,80511,44B51AB0086A395492A545161BBB3047,60381,20,22,2,109.5241,18.22458,1605
10529,80544,B7A2800FDF738E1064EAD2A5E58F7A3C,61011,0,9,9,109.60653,18.19076,1900
10530,80546,B7A2800FDF738E1064EAD2A5E58F7A3C,30151,19,20,1,109.50986,18.25083,1560
10531,80568,09934B270C1497807C20E80EA18E32E2,31071,0,8,8,109.58257,18.28458,1815
10532,80569,09934B270C1497807C20E80EA18E32E2,30771,8,10,2,109.49938,18.26042,1511
10533,80570,09934B270C1497807C20E80EA18E32E2,31071,11,18,7,109.58257,18.28458,1815
10534,80571,09934B270C1497807C20E80EA18E32E2,38241,18,21,3,109.54111,18.30542,1669
10535,80580,07B1B28EECDA8CD620E38389A07DCD5A,38484,11,12,1,109.53028,18.31528,1620
10536,80581,07B1B28EECDA8CD620E38389A07DCD5A,38484,15,18,3,109.53028,18.31528,1620
10537,80586,CA3896FB33E9BC68E91955EDFF5D709B,30854,15,17,2,109.56889,18.27076,1763
10538,80587,CA3896FB33E9BC68E91955EDFF5D709B,31821,19,20,1,109.51181,18.24924,1559
10539,80603,45CCFCD3EBDF941E1C92B70ED06E8B5E,31561,3,4,1,109.56792,18.28479,1765
10540,80604,45CCFCD3EBDF941E1C92B70ED06E8B5E,30854,7,9,2,109.56889,18.27076,1763
10541,80605,45CCFCD3EBDF941E1C92B70ED06E8B5E,31945,9,10,1,109.58021,18.29403,1817
10542,80606,45CCFCD3EBDF941E1C92B70ED06E8B5E,30854,11,12,1,109.56889,18.27076,1763
10543,80607,45CCFCD3EBDF941E1C92B70ED06E8B5E,31071,12,14,2,109.58257,18.28458,1815
10544,80608,45CCFCD3EBDF941E1C92B70ED06E8B5E,31945,14,17,3,109.58021,18.29403,1817
10545,80609,45CCFCD3EBDF941E1C92B70ED06E8B5E,30854,21,22,1,109.56889,18.27076,1763
10546,80613,F355EF146BFAB3F3C8540E3056B68987,30861,0,8,8,109.52722,18.22743,1606
10547,80614,F355EF146BFAB3F3C8540E3056B68987,31471,11,12,1,109.34583,18.29563,917
10548,80615,F355EF146BFAB3F3C8540E3056B68987,38754,16,17,1,109.74667,18.37382,2430
10549,80616,F355EF146BFAB3F3C8540E3056B68987,30361,21,22,1,109.50347,18.24,1508
10554,80647,DE5024DB59D5BF6AE5857A85EB7680EA,31071,0,6,6,109.58257,18.28458,1815
10555,80648,DE5024DB59D5BF6AE5857A85EB7680EA,30854,7,20,13,109.56889,18.27076,1763
10556,80793,B3A1AC27CB357708CE63D3E4F68BF2E7,30854,0,7,7,109.56889,18.27076,1763
10557,80794,B3A1AC27CB357708CE63D3E4F68BF2E7,31071,7,19,12,109.58257,18.28458,1815
10561,80930,2B8C748A18FA7D08D4335AD7C9DEF01B,31761,0,6,6,109.60521,18.27965,1914
10562,80931,2B8C748A18FA7D08D4335AD7C9DEF01B,30951,8,10,2,109.56208,18.25667,1761
10563,80932,2B8C748A18FA7D08D4335AD7C9DEF01B,31551,11,12,1,109.55868,18.24222,1708
10564,80933,2B8C748A18FA7D08D4335AD7C9DEF01B,31421,13,14,1,109.55382,18.22347,1705
10565,80934,2B8C748A18FA7D08D4335AD7C9DEF01B,30951,16,17,1,109.56208,18.25667,1761
10566,80935,2B8C748A18FA7D08D4335AD7C9DEF01B,31761,18,23,5,109.60521,18.27965,1914
10573,81189,1612722AB217C3A27FE84944E5D72456,30771,18,23,5,109.49938,18.26042,1511
10574,81202,173CD7A2B7B334BC53A50A1D248FBCFE,30854,9,11,2,109.56889,18.27076,1763
10575,81203,173CD7A2B7B334BC53A50A1D248FBCFE,31071,12,13,1,109.58257,18.28458,1815
10576,81204,173CD7A2B7B334BC53A50A1D248FBCFE,30854,15,19,4,109.56889,18.27076,1763
10577,81205,173CD7A2B7B334BC53A50A1D248FBCFE,31071,19,22,3,109.58257,18.28458,1815
10586,81274,0E00D7E0174B24239144B08D52B998E8,31124,12,13,1,109.17069,18.35,276
10587,81275,0E00D7E0174B24239144B08D52B998E8,30451,14,16,2,109.1791,18.36229,278
10588,81276,0E00D7E0174B24239144B08D52B998E8,31124,17,18,1,109.17069,18.35,276
10589,81277,0E00D7E0174B24239144B08D52B998E8,30421,20,21,1,109.50021,18.25861,1511
10590,81283,DDE77D3A656666992FC3458B84010D43,31561,12,16,4,109.56792,18.28479,1765
10591,81284,DDE77D3A656666992FC3458B84010D43,39183,18,23,5,109.55542,18.28208,1715
10592,81323,753A7CFE9D5A49374C0CE033D581B67F,38361,0,9,9,109.43667,18.29201,1267
10593,81324,753A7CFE9D5A49374C0CE033D581B67F,31701,9,10,1,109.44132,18.28833,1266
10597,81341,807F73DE76DFE56E472FA61396F0887C,38171,15,17,2,109.50799,18.28139,1515
10598,81342,807F73DE76DFE56E472FA61396F0887C,30861,19,22,3,109.52722,18.22743,1606
10599,81362,521A7ED98375837397B112E54A372514,60281,0,1,1,109.51743,18.25924,1561
10600,81363,521A7ED98375837397B112E54A372514,60234,2,10,8,109.49577,18.2096,1453
10601,81364,521A7ED98375837397B112E54A372514,38017,11,13,2,109.49729,18.21424,1504
10602,81380,DB0EF690DC781F73956987AB22EA398D,38361,0,8,8,109.43667,18.29201,1267
10603,81381,DB0EF690DC781F73956987AB22EA398D,31321,12,13,1,109.63799,18.23201,2007
10604,81382,DB0EF690DC781F73956987AB22EA398D,60291,15,17,2,109.50826,18.24639,1509
10605,81383,DB0EF690DC781F73956987AB22EA398D,60381,19,21,2,109.5241,18.22458,1605
10610,81411,AD12F364CB1EB1AF88909B637B7422CD,31471,17,18,1,109.34583,18.29563,917
10611,81412,AD12F364CB1EB1AF88909B637B7422CD,30201,21,23,2,109.4909,18.26465,1462
10612,81413,0187C68AAA5B8B5AFE4438278EB6AFB0,31561,12,14,2,109.56792,18.28479,1765
10613,81414,0187C68AAA5B8B5AFE4438278EB6AFB0,30851,15,18,3,109.5616,18.27396,1713
10614,81455,CB1C8502149DACE0B32B2F7416279EF2,31071,9,19,10,109.58257,18.28458,1815
10615,81456,CB1C8502149DACE0B32B2F7416279EF2,30854,19,20,1,109.56889,18.27076,1763
10616,81562,1FE2866848043A2C10AD87212485FE15,31181,0,2,2,109.50382,18.24813,1509
10617,81563,1FE2866848043A2C10AD87212485FE15,31071,4,7,3,109.58257,18.28458,1815
10618,81564,1FE2866848043A2C10AD87212485FE15,30854,8,10,2,109.56889,18.27076,1763
10623,81591,B5686BCA7E4C74E299FC4E3D24CAC39C,31031,13,17,4,109.49979,18.25382,1510
10624,81592,B5686BCA7E4C74E299FC4E3D24CAC39C,39151,19,23,4,109.49875,18.25097,1510
10625,81645,CD576F1C1CDFB89E6A99A20E65927346,30854,4,5,1,109.56889,18.27076,1763
10626,81646,CD576F1C1CDFB89E6A99A20E65927346,31561,6,9,3,109.56792,18.28479,1765
10627,81647,CD576F1C1CDFB89E6A99A20E65927346,30854,11,12,1,109.56889,18.27076,1763
10628,81648,CD576F1C1CDFB89E6A99A20E65927346,31561,14,16,2,109.56792,18.28479,1765
10629,81649,CD576F1C1CDFB89E6A99A20E65927346,30854,19,21,2,109.56889,18.27076,1763
10630,81691,B712327B6033C61F37801CFD6DAC08AD,38484,0,1,1,109.53028,18.31528,1620
10631,81692,B712327B6033C61F37801CFD6DAC08AD,31951,1,5,4,109.52174,18.30299,1568
10632,81693,B712327B6033C61F37801CFD6DAC08AD,30561,8,9,1,109.52778,18.31938,1621
10633,81694,B712327B6033C61F37801CFD6DAC08AD,38484,17,20,3,109.53028,18.31528,1620
10634,81695,B712327B6033C61F37801CFD6DAC08AD,30561,20,23,3,109.52778,18.31938,1621
10635,81701,DBF0ED639264742A7D5519236AB61C61,39151,0,4,4,109.49875,18.25097,1510
10636,81702,DBF0ED639264742A7D5519236AB61C61,31031,8,9,1,109.49979,18.25382,1510
10637,81727,A7B3BDD8DC79485BA41EC7F220A41345,30854,13,20,7,109.56889,18.27076,1763
10638,81728,A7B3BDD8DC79485BA41EC7F220A41345,60631,21,22,1,109.57778,18.27583,1814
10639,81732,B6378A75CA0A699A2E978F82FF1B5F9B,30321,0,2,2,109.49563,18.29611,1467
10640,81733,B6378A75CA0A699A2E978F82FF1B5F9B,31621,3,22,19,109.51035,18.29826,1568
10645,81756,79AB721DDB2EAA1CD0308535004E6A67,31071,0,8,8,109.58257,18.28458,1815
10646,81757,79AB721DDB2EAA1CD0308535004E6A67,31561,9,11,2,109.56792,18.28479,1765
10647,81758,79AB721DDB2EAA1CD0308535004E6A67,30854,13,16,3,109.56889,18.27076,1763
10648,81759,79AB721DDB2EAA1CD0308535004E6A67,60291,18,21,3,109.50826,18.24639,1509
10649,81760,79AB721DDB2EAA1CD0308535004E6A67,31181,21,23,2,109.50382,18.24813,1509
10650,81805,9E2CAA912E7C38B3460AB2C8B985CA0D,31071,17,19,2,109.58257,18.28458,1815
10651,81806,9E2CAA912E7C38B3460AB2C8B985CA0D,31761,20,22,2,109.60521,18.27965,1914
10656,81842,AEA3E45BA06B234C15322E381D44AC89,31201,0,2,2,109.51042,18.23819,1558
10657,81843,AEA3E45BA06B234C15322E381D44AC89,30031,5,18,13,109.53681,18.33313,1673
10658,81852,7D632B68A96EBB9D6582527232D6634C,39154,0,7,7,109.50201,18.25681,1511
10659,81853,7D632B68A96EBB9D6582527232D6634C,31461,8,9,1,109.5091,18.25389,1510
10660,81854,7D632B68A96EBB9D6582527232D6634C,31291,14,18,4,109.30375,18.40729,786
10661,81855,7D632B68A96EBB9D6582527232D6634C,39191,22,23,1,109.51493,18.23472,1557
10665,81926,06CCC403601D7C9C1AA6BF102B163D95,39151,3,6,3,109.49875,18.25097,1510
10666,81927,06CCC403601D7C9C1AA6BF102B163D95,60161,8,13,5,109.49174,18.26181,1461
10667,81928,B78E7295CB13532B4E2C30EF158E297F,31931,0,1,1,109.54771,18.29403,1667
10668,81929,B78E7295CB13532B4E2C30EF158E297F,30851,1,3,2,109.5616,18.27396,1713
10669,81930,B78E7295CB13532B4E2C30EF158E297F,31931,3,7,4,109.54771,18.29403,1667
10670,81931,B78E7295CB13532B4E2C30EF158E297F,30854,13,14,1,109.56889,18.27076,1763
10671,81932,B78E7295CB13532B4E2C30EF158E297F,39183,16,19,3,109.55542,18.28208,1715
10672,81933,0ACD42FBA28A767F44D73783967C8C23,31864,0,8,8,109.49014,18.28333,1465
10673,81934,0ACD42FBA28A767F44D73783967C8C23,31941,11,13,2,109.62451,18.31222,1970
10674,81935,0ACD42FBA28A767F44D73783967C8C23,30851,14,15,1,109.5616,18.27396,1713
10675,81941,066E3B290AAC556F650E56DD0F693AB2,30581,14,15,1,109.62257,18.24951,1959
10676,81942,066E3B290AAC556F650E56DD0F693AB2,38251,17,22,5,109.49618,18.25493,1510
10677,81953,F47C4E1E39056C43B0AD32AC994AB7C0,60361,0,1,1,109.51938,18.29681,1567
10678,81954,F47C4E1E39056C43B0AD32AC994AB7C0,31931,1,22,21,109.54771,18.29403,1667
10679,81984,0AA81D37A252701034C59AB1A32AA9FA,31145,12,13,1,109.20431,18.30479,369
10680,81985,0AA81D37A252701034C59AB1A32AA9FA,60054,15,17,2,109.3016,18.31229,770
10681,81986,0AA81D37A252701034C59AB1A32AA9FA,30711,20,22,2,109.50271,18.25347,1510
10682,82028,624AAF23364B08A587E603D133DAA33C,31471,14,16,2,109.34583,18.29563,917
10683,82029,624AAF23364B08A587E603D133DAA33C,38094,17,18,1,109.45403,18.28778,1316
10687,82069,414763BCFC53367965A980F3BA7D5EA5,31091,16,19,3,109.41201,18.31222,1170
10695,82229,E1108DE9382EA6DD2052A0875C7E83C6,31161,19,23,4,109.70229,18.31361,2270
10696,82251,E4B522EF4348156010E5C578EC13D60F,31945,2,9,7,109.58021,18.29403,1817
10697,82252,E4B522EF4348156010E5C578EC13D60F,30854,10,17,7,109.56889,18.27076,1763
10708,82294,6A910172B0D8A7BBC31B1CD07364D7F6,30361,20,21,1,109.50347,18.24,1508
10709,82295,6A910172B0D8A7BBC31B1CD07364D7F6,31206,22,23,1,109.50819,18.23549,1507
10710,82321,1EBF477B1EE6E13F6E111854406233C6,38251,0,8,8,109.49618,18.25493,1510
10711,82322,1EBF477B1EE6E13F6E111854406233C6,33051,11,14,3,109.6475,18.46618,2096
10712,82323,1EBF477B1EE6E13F6E111854406233C6,38251,16,23,7,109.49618,18.25493,1510
10713,82338,DF7FEE90C3CFDF2E89602A7FE1135E8F,30221,0,7,7,109.57833,18.20222,1802
10714,82339,DF7FEE90C3CFDF2E89602A7FE1135E8F,31561,7,8,1,109.56792,18.28479,1765
10715,82340,DF7FEE90C3CFDF2E89602A7FE1135E8F,31041,11,13,2,109.50278,18.23701,1507
10719,82387,658407C6560C95E096BFBAE8616B0914,60291,0,10,10,109.50826,18.24639,1509
10720,82388,658407C6560C95E096BFBAE8616B0914,31471,13,15,2,109.34583,18.29563,917
10721,82389,71A18A4A1ADC968891F09220AD0BF67D,31071,10,11,1,109.58257,18.28458,1815
10722,82390,71A18A4A1ADC968891F09220AD0BF67D,30854,14,17,3,109.56889,18.27076,1763
10723,82391,71A18A4A1ADC968891F09220AD0BF67D,31071,18,20,2,109.58257,18.28458,1815
10724,82392,71A18A4A1ADC968891F09220AD0BF67D,38754,20,21,1,109.74667,18.37382,2430
10725,82405,5E6F81A7DA23F57413C15AC7514275E5,30851,1,3,2,109.5616,18.27396,1713
10726,82406,5E6F81A7DA23F57413C15AC7514275E5,31945,5,17,12,109.58021,18.29403,1817
10731,82429,065F1687C35F3C827A2EA4A378A0E2C6,30851,11,14,3,109.5616,18.27396,1713
10732,82430,065F1687C35F3C827A2EA4A378A0E2C6,31561,16,18,2,109.56792,18.28479,1765
10733,82431,065F1687C35F3C827A2EA4A378A0E2C6,30851,18,21,3,109.5616,18.27396,1713
10734,82457,817705C0BB74FA2761454F22705597E3,31781,13,14,1,109.19847,18.2975,367
10735,82458,817705C0BB74FA2761454F22705597E3,31471,16,17,1,109.34583,18.29563,917
10736,82459,13166628932DF36C0AD7B1DB5811240A,60591,0,6,6,109.61118,18.21715,1904
10737,82460,13166628932DF36C0AD7B1DB5811240A,30854,10,16,6,109.56889,18.27076,1763
10738,82461,13166628932DF36C0AD7B1DB5811240A,60591,19,23,4,109.61118,18.21715,1904
10739,82494,6DF7485545B790F22810B0EDD8F1B356,31945,0,7,7,109.58021,18.29403,1817
10740,82495,6DF7485545B790F22810B0EDD8F1B356,30854,8,10,2,109.56889,18.27076,1763
10741,82496,6DF7485545B790F22810B0EDD8F1B356,31945,12,13,1,109.58021,18.29403,1817
10742,82497,6DF7485545B790F22810B0EDD8F1B356,30854,16,17,1,109.56889,18.27076,1763
10743,82498,6DF7485545B790F22810B0EDD8F1B356,31761,19,22,3,109.60521,18.27965,1914
10744,82531,157D967BA2CB68D4813192367156AA3F,31534,0,9,9,109.49368,18.25806,1461
10745,82532,157D967BA2CB68D4813192367156AA3F,38315,10,12,2,109.48979,18.29764,1467
10753,82611,7421066246AAD1C230E7E2A7ADF06E9D,31071,1,2,1,109.58257,18.28458,1815
10754,82612,7421066246AAD1C230E7E2A7ADF06E9D,60631,3,6,3,109.57778,18.27583,1814
10755,82613,7421066246AAD1C230E7E2A7ADF06E9D,30854,7,10,3,109.56889,18.27076,1763
10756,82614,7421066246AAD1C230E7E2A7ADF06E9D,60631,12,13,1,109.57778,18.27583,1814
10757,82615,7421066246AAD1C230E7E2A7ADF06E9D,30854,13,21,8,109.56889,18.27076,1763
10758,82616,7421066246AAD1C230E7E2A7ADF06E9D,60631,21,23,2,109.57778,18.27583,1814
10762,82645,C153552CEA2677B0FF473AE565EA979E,30821,0,12,12,109.43681,18.33639,1274
10763,82646,C153552CEA2677B0FF473AE565EA979E,30651,12,13,1,109.42611,18.385,1232
10764,82647,C153552CEA2677B0FF473AE565EA979E,30821,13,14,1,109.43681,18.33639,1274
10765,82648,C153552CEA2677B0FF473AE565EA979E,30651,18,19,1,109.42611,18.385,1232
10766,82649,C153552CEA2677B0FF473AE565EA979E,30821,21,23,2,109.43681,18.33639,1274
10771,82664,DF46DA0955594B99E73FB26D3951FE40,30854,2,6,4,109.56889,18.27076,1763
10772,82665,DF46DA0955594B99E73FB26D3951FE40,30232,6,12,6,109.6191,18.31701,1971
10773,82666,DF46DA0955594B99E73FB26D3951FE40,30854,13,23,10,109.56889,18.27076,1763
10774,82752,1BDE433888973A22F2D9A5CC8B5A34FF,30221,0,14,14,109.57833,18.20222,1802
10775,82753,1BDE433888973A22F2D9A5CC8B5A34FF,38127,18,19,1,109.50833,18.27222,1513
10776,82754,1BDE433888973A22F2D9A5CC8B5A34FF,30221,21,23,2,109.57833,18.20222,1802
10777,82764,EFFEF00C078D502D6D0D1D469ACBA466,30421,0,7,7,109.50021,18.25861,1511
10778,82765,EFFEF00C078D502D6D0D1D469ACBA466,31471,9,10,1,109.34583,18.29563,917
10779,82766,EFFEF00C078D502D6D0D1D469ACBA466,39041,12,14,2,109.40021,18.29278,1117
10780,82767,EFFEF00C078D502D6D0D1D469ACBA466,31471,15,17,2,109.34583,18.29563,917
10781,82784,7D4FF7DC44030D76F91C2D27A16541A1,60463,0,2,2,109.52507,18.22438,1605
10782,82788,3541891770D5E46642FA2F10632E5CD4,39111,1,5,4,109.5191,18.22597,1555
10783,82789,3541891770D5E46642FA2F10632E5CD4,30221,7,11,4,109.57833,18.20222,1802
10784,82790,3541891770D5E46642FA2F10632E5CD4,31521,11,12,1,109.51458,18.22542,1555
10785,82791,3541891770D5E46642FA2F10632E5CD4,31781,13,14,1,109.19847,18.2975,367
10786,82792,3541891770D5E46642FA2F10632E5CD4,31521,17,19,2,109.51458,18.22542,1555
10787,82793,3541891770D5E46642FA2F10632E5CD4,30221,22,23,1,109.57833,18.20222,1802
10788,82842,C1602FB5A20BD98313F7CC13F431D061,30421,13,18,5,109.50021,18.25861,1511
10789,82843,C1602FB5A20BD98313F7CC13F431D061,30911,20,21,1,109.50493,18.26181,1511
10793,82860,BD4652414D5C17466BA36FD4BD943A94,31931,13,15,2,109.54771,18.29403,1667
10794,82861,BD4652414D5C17466BA36FD4BD943A94,39183,17,18,1,109.55542,18.28208,1715
10795,82883,B421B0364BC07B443944D07A1DCB065A,60201,0,9,9,109.5041,18.2509,1510
10796,82884,B421B0364BC07B443944D07A1DCB065A,60291,13,15,2,109.50826,18.24639,1509
10797,82919,F7ABE1A2051D725D70F50CD6183F5B8A,38054,0,12,12,109.63479,18.23097,2006
10798,82920,F7ABE1A2051D725D70F50CD6183F5B8A,30361,13,23,10,109.50347,18.24,1508
10799,82926,CA629265321FCE7203917445EFF19E66,30771,0,6,6,109.49938,18.26042,1511
10800,82927,CA629265321FCE7203917445EFF19E66,31781,10,11,1,109.19847,18.2975,367
10801,82928,CA629265321FCE7203917445EFF19E66,31471,15,17,2,109.34583,18.29563,917
10802,82929,CA629265321FCE7203917445EFF19E66,30421,18,23,5,109.50021,18.25861,1511
10813,82998,B37777551ADDE84A1FDFE1FF465C24DC,31931,0,8,8,109.54771,18.29403,1667
10814,82999,B37777551ADDE84A1FDFE1FF465C24DC,38821,11,14,3,109.50354,18.25243,1510
10815,83000,CBC603DF99C1D6981715077F3EA24CB6,30854,0,1,1,109.56889,18.27076,1763
10816,83001,CBC603DF99C1D6981715077F3EA24CB6,30232,2,7,5,109.6191,18.31701,1971
10817,83002,CBC603DF99C1D6981715077F3EA24CB6,39183,10,11,1,109.55542,18.28208,1715
10818,83003,CBC603DF99C1D6981715077F3EA24CB6,31521,15,16,1,109.51458,18.22542,1555
10819,83004,CBC603DF99C1D6981715077F3EA24CB6,39183,19,23,4,109.55542,18.28208,1715
10820,83006,EE0804F129D0F96C287A44865905653C,30711,8,9,1,109.50271,18.25347,1510
10821,83058,324899445F811D5785FB336DE18DAC0E,31531,0,5,5,109.49583,18.25972,1461
10825,83070,7B2AEE2086698683607EDDDB4B678234,60371,0,6,6,109.53063,18.30056,1618
10826,83071,7B2AEE2086698683607EDDDB4B678234,60241,7,8,1,109.53319,18.28667,1616
10827,83072,7B2AEE2086698683607EDDDB4B678234,60221,8,9,1,109.52569,18.29188,1616
10828,83073,7B2AEE2086698683607EDDDB4B678234,60201,9,13,4,109.5041,18.2509,1510
10832,83120,2A6BA0678DDF16AF08BAC9E3FA3C9391,31561,0,6,6,109.56792,18.28479,1765
10833,83121,2A6BA0678DDF16AF08BAC9E3FA3C9391,30854,9,19,10,109.56889,18.27076,1763
10834,83152,8E3A30A4D1E8F550E98C2EF7500D367D,30084,2,8,6,109.50118,18.26972,1513
10835,83153,8E3A30A4D1E8F550E98C2EF7500D367D,31145,11,14,3,109.20431,18.30479,369
10836,83154,8E3A30A4D1E8F550E98C2EF7500D367D,30084,16,18,2,109.50118,18.26972,1513
10837,83155,8E3A30A4D1E8F550E98C2EF7500D367D,30081,19,23,4,109.50243,18.26632,1512
10845,83190,E16204D131FCD957D5ADB9592C1DD0ED,60311,13,14,1,109.52097,18.24319,1558
10846,83191,E16204D131FCD957D5ADB9592C1DD0ED,31071,17,19,2,109.58257,18.28458,1815
10847,83248,B3D869AADCF0B90715B79410877850C1,30351,0,2,2,109.41701,18.29292,1217
10848,83249,B3D869AADCF0B90715B79410877850C1,31231,2,4,2,109.42597,18.29292,1217
10849,83250,B3D869AADCF0B90715B79410877850C1,30351,6,8,2,109.41701,18.29292,1217
10850,83251,B3D869AADCF0B90715B79410877850C1,31781,10,14,4,109.19847,18.2975,367
10851,83252,B3D869AADCF0B90715B79410877850C1,30351,17,20,3,109.41701,18.29292,1217
10852,83276,53875E69050EC42E511A64D3211FA7B3,31561,13,15,2,109.56792,18.28479,1765
10853,83277,53875E69050EC42E511A64D3211FA7B3,30851,19,21,2,109.5616,18.27396,1713
10860,83332,5E97A4561E11AAC4FBC53FD068EAA52B,30854,0,6,6,109.56889,18.27076,1763
10861,83333,5E97A4561E11AAC4FBC53FD068EAA52B,30531,8,18,10,109.53271,18.21472,1604
10862,83334,5E97A4561E11AAC4FBC53FD068EAA52B,30854,21,22,1,109.56889,18.27076,1763
10867,83374,B643AC77F8D8498A9694D45BA8B0F75F,60631,0,16,16,109.57778,18.27583,1814
10868,83375,B643AC77F8D8498A9694D45BA8B0F75F,31561,17,21,4,109.56792,18.28479,1765
10869,83488,5426296000364EE32711CD0E73D782C8,31561,12,16,4,109.56792,18.28479,1765
10870,83489,5426296000364EE32711CD0E73D782C8,30854,19,21,2,109.56889,18.27076,1763
10871,83501,0C6C0D19798B06A61B30F115931FC215,31801,14,15,1,109.20417,18.32118,371
10872,83504,2361E8D6BAB0231B2E8E3C0F34517282,30291,6,8,2,109.50403,18.27028,1513
10873,83505,2361E8D6BAB0231B2E8E3C0F34517282,38171,9,13,4,109.50799,18.28139,1515
10874,83506,2361E8D6BAB0231B2E8E3C0F34517282,30291,17,20,3,109.50403,18.27028,1513
10875,83570,09C311D86737E534420F351D48938D74,60201,16,17,1,109.5041,18.2509,1510
10876,83571,09C311D86737E534420F351D48938D74,30281,20,23,3,109.50597,18.27583,1514
10877,83590,EE10AC6477FFD3D50107E111E624E05D,60211,15,17,2,109.63549,18.26049,2011
10878,83591,EE10AC6477FFD3D50107E111E624E05D,31351,19,22,3,109.4959,18.28417,1465
10879,83615,996C0D9500BF90CC0E7F5A04C49A464B,31931,0,8,8,109.54771,18.29403,1667
10880,83616,996C0D9500BF90CC0E7F5A04C49A464B,30921,8,21,13,109.53903,18.29451,1667
10881,83626,B340EDEF4A878E8DF5CBEC25E465EACE,30854,2,10,8,109.56889,18.27076,1763
10882,83627,B340EDEF4A878E8DF5CBEC25E465EACE,60631,10,11,1,109.57778,18.27583,1814
10883,83628,B340EDEF4A878E8DF5CBEC25E465EACE,30854,11,15,4,109.56889,18.27076,1763
10884,83629,B340EDEF4A878E8DF5CBEC25E465EACE,30084,18,19,1,109.50118,18.26972,1513
10885,83630,B340EDEF4A878E8DF5CBEC25E465EACE,31201,20,23,3,109.51042,18.23819,1558
10886,83638,F198CAA1F49ACA5D003FD8F8473B3798,30731,14,16,2,109.50944,18.22306,1555
10887,83639,F198CAA1F49ACA5D003FD8F8473B3798,30854,17,18,1,109.56889,18.27076,1763
10888,83668,C860767955774E3494068CF38C009FB6,60463,0,2,2,109.52507,18.22438,1605
10889,83669,C860767955774E3494068CF38C009FB6,60391,2,15,13,109.47667,18.28757,1416
10890,83670,C860767955774E3494068CF38C009FB6,38251,17,19,2,109.49618,18.25493,1510
10891,83671,C860767955774E3494068CF38C009FB6,60391,19,23,4,109.47667,18.28757,1416
10892,83728,662D882A6A10D0E6C3566690F0A40636,30854,0,13,13,109.56889,18.27076,1763
10893,83729,662D882A6A10D0E6C3566690F0A40636,31071,17,19,2,109.58257,18.28458,1815
10894,83775,8BB035B44D009B4E567D4EFF10F50E4D,30854,0,7,7,109.56889,18.27076,1763
10895,83776,8BB035B44D009B4E567D4EFF10F50E4D,31311,10,11,1,109.72299,18.27438,2364
10896,83777,8BB035B44D009B4E567D4EFF10F50E4D,31071,14,15,1,109.58257,18.28458,1815
10897,83778,8BB035B44D009B4E567D4EFF10F50E4D,30854,17,21,4,109.56889,18.27076,1763
10898,83782,E2CFBC4AD8BA700D32898ABFA9A0C849,31071,0,3,3,109.58257,18.28458,1815
10899,83783,E2CFBC4AD8BA700D32898ABFA9A0C849,30851,3,4,1,109.5616,18.27396,1713
10900,83784,E2CFBC4AD8BA700D32898ABFA9A0C849,30854,5,14,9,109.56889,18.27076,1763
10901,83785,E2CFBC4AD8BA700D32898ABFA9A0C849,30081,19,20,1,109.50243,18.26632,1512
10902,83786,E2CFBC4AD8BA700D32898ABFA9A0C849,30191,22,23,1,109.50361,18.22701,1506
10903,83844,405CDAA480A91B52CBB74C6B8C550FA6,31181,1,3,2,109.50382,18.24813,1509
10904,83845,405CDAA480A91B52CBB74C6B8C550FA6,60291,3,5,2,109.50826,18.24639,1509
10905,83846,405CDAA480A91B52CBB74C6B8C550FA6,60131,6,9,3,109.49819,18.24778,1509
10906,83847,405CDAA480A91B52CBB74C6B8C550FA6,31181,11,14,3,109.50382,18.24813,1509
10907,83848,405CDAA480A91B52CBB74C6B8C550FA6,60291,16,18,2,109.50826,18.24639,1509
10911,83910,44F505B3929E26B4B29F00CC284F3084,60361,10,12,2,109.51938,18.29681,1567
10912,83911,44F505B3929E26B4B29F00CC284F3084,30854,13,15,2,109.56889,18.27076,1763
10913,83912,44F505B3929E26B4B29F00CC284F3084,31071,19,22,3,109.58257,18.28458,1815
10914,83915,289C96166B72325FF931BEE9E63A948B,39191,0,6,6,109.51493,18.23472,1557
10915,83918,289C96166B72325FF931BEE9E63A948B,39191,19,23,4,109.51493,18.23472,1557
10916,83926,A53D76C44A71267FF477911E38598EC8,31561,17,20,3,109.56792,18.28479,1765
10917,83927,A53D76C44A71267FF477911E38598EC8,30854,20,23,3,109.56889,18.27076,1763
10926,84021,DC0EB400EA24BEE9EB39D315B0E6AEF0,31431,16,20,4,109.44639,18.29042,1316
10927,84022,DC0EB400EA24BEE9EB39D315B0E6AEF0,31701,21,22,1,109.44132,18.28833,1266
10931,84048,F605546ADA1ADB3E2AF3E74D19682812,31931,14,15,1,109.54771,18.29403,1667
10932,84049,F605546ADA1ADB3E2AF3E74D19682812,60221,20,22,2,109.52569,18.29188,1616
10933,84050,EF43F60CF9BD4AC27FA4A9E23A6B17C7,31821,20,21,1,109.51181,18.24924,1559
10934,84051,EF43F60CF9BD4AC27FA4A9E23A6B17C7,31521,21,23,2,109.51458,18.22542,1555
10935,84065,F640E2D98187FE602EA0B6D8FEAF6E35,31031,13,14,1,109.49979,18.25382,1510
10936,84098,BE8220A49F1231C0A022F4AA2075503E,30854,14,17,3,109.56889,18.27076,1763
10937,84099,BE8220A49F1231C0A022F4AA2075503E,31945,21,23,2,109.58021,18.29403,1817
10938,84104,94C4D5691F7DFC1AB38806AFFAC1389E,31931,3,7,4,109.54771,18.29403,1667
10939,84105,94C4D5691F7DFC1AB38806AFFAC1389E,30921,8,10,2,109.53903,18.29451,1667
10940,84106,94C4D5691F7DFC1AB38806AFFAC1389E,31931,13,14,1,109.54771,18.29403,1667
10941,84107,94C4D5691F7DFC1AB38806AFFAC1389E,39091,18,19,1,109.50097,18.25222,1510
10942,84108,C9524866A6E9E0E3158261DBB1EE420F,30581,14,15,1,109.62257,18.24951,1959
10943,84109,C9524866A6E9E0E3158261DBB1EE420F,38951,17,23,6,109.48097,18.28868,1416
10950,84187,A68637AA89BD62624E677D9E66C32FAD,30161,0,18,18,109.50042,18.24389,1508
10951,84188,A68637AA89BD62624E677D9E66C32FAD,30161,20,23,3,109.50042,18.24389,1508
10952,84219,65ACBAAF6AD7CF9530991E30B1E393C6,31181,17,19,2,109.50382,18.24813,1509
10953,84220,65ACBAAF6AD7CF9530991E30B1E393C6,38291,19,21,2,109.51618,18.24313,1558
10954,84259,8554F0A178316702A9146AC053A2336A,60161,3,6,3,109.49174,18.26181,1461
10955,84260,8554F0A178316702A9146AC053A2336A,31031,6,8,2,109.49979,18.25382,1510
10956,84261,2297ECCBAEAEEAB6F486010C8882DE44,60581,0,8,8,109.59785,18.29931,1868
10957,84262,2297ECCBAEAEEAB6F486010C8882DE44,38185,12,16,4,109.51333,18.27347,1563
10958,84318,90B0A60855A43B2DB99A0964CE51D3AF,31861,18,19,1,109.49042,18.27549,1464
10959,84319,90B0A60855A43B2DB99A0964CE51D3AF,30201,20,21,1,109.4909,18.26465,1462
10960,84330,05F9648883BF713D4E846B58647DFC7D,60552,0,4,4,109.41729,18.30014,1218
10961,84331,05F9648883BF713D4E846B58647DFC7D,60524,5,6,1,109.42951,18.28993,1216
10962,84332,05F9648883BF713D4E846B58647DFC7D,60552,7,9,2,109.41729,18.30014,1218
10963,84333,05F9648883BF713D4E846B58647DFC7D,31091,9,10,1,109.41201,18.31222,1170
10964,84334,05F9648883BF713D4E846B58647DFC7D,30671,11,13,2,109.43611,18.30139,1268
10965,84335,05F9648883BF713D4E846B58647DFC7D,60552,16,17,1,109.41729,18.30014,1218
10966,84425,0D3DA8126B134D203BB35373EAFFB116,30361,0,1,1,109.50347,18.24,1508
10967,84426,0D3DA8126B134D203BB35373EAFFB116,31071,2,21,19,109.58257,18.28458,1815
10979,84531,B663EE883B81AEB709AC84DCCEC3D38E,31945,4,14,10,109.58021,18.29403,1817
10980,84532,B663EE883B81AEB709AC84DCCEC3D38E,30854,16,17,1,109.56889,18.27076,1763
10981,84533,B663EE883B81AEB709AC84DCCEC3D38E,31071,19,20,1,109.58257,18.28458,1815
10982,84534,B663EE883B81AEB709AC84DCCEC3D38E,30191,21,23,2,109.50361,18.22701,1506
10983,84592,524D453DEC27C2232F819E60169E1FC2,30741,0,8,8,109.49833,18.28681,1516
10984,84593,524D453DEC27C2232F819E60169E1FC2,30941,8,10,2,109.5559,18.33938,1724
10985,84594,524D453DEC27C2232F819E60169E1FC2,39183,14,16,2,109.55542,18.28208,1715
10986,84595,524D453DEC27C2232F819E60169E1FC2,30101,18,19,1,109.57299,18.33333,1773
10987,84596,524D453DEC27C2232F819E60169E1FC2,31461,19,20,1,109.5091,18.25389,1510
10988,84597,524D453DEC27C2232F819E60169E1FC2,30741,21,23,2,109.49833,18.28681,1516
10999,84761,867CD177C4F4B0DA2800BA7613DC965C,31061,0,12,12,109.53333,18.23257,1607
11000,84763,867CD177C4F4B0DA2800BA7613DC965C,30211,18,23,5,109.49882,18.23931,1508
11001,84788,13ABA70DC1B5E636027143D57A5DAAA1,31421,1,6,5,109.55382,18.22347,1705
11002,84789,13ABA70DC1B5E636027143D57A5DAAA1,31061,7,8,1,109.53333,18.23257,1607
11006,84805,F00821368F615DCDAF214035D8EC4A44,31071,2,7,5,109.58257,18.28458,1815
11007,84806,F00821368F615DCDAF214035D8EC4A44,30854,8,15,7,109.56889,18.27076,1763
11008,84807,F00821368F615DCDAF214035D8EC4A44,31071,15,17,2,109.58257,18.28458,1815
11009,84808,F00821368F615DCDAF214035D8EC4A44,60463,19,21,2,109.52507,18.22438,1605
11010,84810,0B2CDE43D7DE290E07FF365A2D22E5DE,30854,13,21,8,109.56889,18.27076,1763
11011,84821,6FE9D30AF9D5BAD1F717916B377146E9,38961,0,8,8,109.50847,18.23514,1507
11012,84822,6FE9D30AF9D5BAD1F717916B377146E9,31781,11,13,2,109.19847,18.2975,367
11013,84823,6FE9D30AF9D5BAD1F717916B377146E9,31471,14,16,2,109.34583,18.29563,917
11014,84824,6FE9D30AF9D5BAD1F717916B377146E9,31201,18,22,4,109.51042,18.23819,1558
11015,84828,8D7B9451E0189947198D6AC9CE51CFEE,60391,0,1,1,109.47667,18.28757,1416
11016,84829,8D7B9451E0189947198D6AC9CE51CFEE,31091,2,11,9,109.41201,18.31222,1170
11017,84830,8D7B9451E0189947198D6AC9CE51CFEE,31081,12,14,2,109.44639,18.30181,1318
11018,84831,8D7B9451E0189947198D6AC9CE51CFEE,31091,16,20,4,109.41201,18.31222,1170
11019,84832,8D7B9451E0189947198D6AC9CE51CFEE,30761,22,23,1,109.45201,18.3,1318
11020,84854,934029FB5F97BCE114EDCE88F0393A63,31071,12,14,2,109.58257,18.28458,1815
11021,84855,934029FB5F97BCE114EDCE88F0393A63,30854,17,18,1,109.56889,18.27076,1763
11022,84856,96F98526707B06BE1263CCD4F72E07A1,31071,0,6,6,109.58257,18.28458,1815
11023,84857,96F98526707B06BE1263CCD4F72E07A1,30854,11,22,11,109.56889,18.27076,1763
11024,84862,513924E5F8EAB458027327A1E2BAE9DB,31071,0,7,7,109.58257,18.28458,1815
11025,84863,513924E5F8EAB458027327A1E2BAE9DB,30854,7,9,2,109.56889,18.27076,1763
11026,84864,513924E5F8EAB458027327A1E2BAE9DB,31031,11,13,2,109.49979,18.25382,1510
11027,84865,513924E5F8EAB458027327A1E2BAE9DB,30854,16,17,1,109.56889,18.27076,1763
11028,84866,513924E5F8EAB458027327A1E2BAE9DB,31071,18,20,2,109.58257,18.28458,1815
11029,84867,513924E5F8EAB458027327A1E2BAE9DB,30854,21,23,2,109.56889,18.27076,1763
11030,84887,24B9CD23EC5587BA3102D06F602ACE38,31951,0,2,2,109.52174,18.30299,1568
11031,84888,24B9CD23EC5587BA3102D06F602ACE38,60171,2,22,20,109.51292,18.30694,1569
11032,84923,90247A6FCE5F317B4B054CEB03D32D7B,31671,21,22,1,109.38965,18.29813,1068
11033,84958,F84D949DDCBF25D5530F771BC55E0B9D,61011,0,19,19,109.60653,18.19076,1900
11034,84979,53490AD77ACCA93C3ED0F3DE79CA488B,30854,7,10,3,109.56889,18.27076,1763
11035,84980,53490AD77ACCA93C3ED0F3DE79CA488B,31071,14,16,2,109.58257,18.28458,1815
11036,84981,53490AD77ACCA93C3ED0F3DE79CA488B,30854,19,20,1,109.56889,18.27076,1763
11037,84990,6E2021B014C4D0B652A2E4FE8D2CF038,31861,18,19,1,109.49042,18.27549,1464
11038,84991,6E2021B014C4D0B652A2E4FE8D2CF038,30201,20,21,1,109.4909,18.26465,1462
11039,85015,07169E7114E4F14C073261BAAC0D4491,61011,0,4,4,109.60653,18.19076,1900
11040,85017,07169E7114E4F14C073261BAAC0D4491,61011,12,23,11,109.60653,18.19076,1900
11041,85055,9C1407835BC54BEBDB541F52E1DA1820,61011,0,4,4,109.60653,18.19076,1900
11042,85057,9C1407835BC54BEBDB541F52E1DA1820,61011,17,20,3,109.60653,18.19076,1900
11043,85075,D2BE39F7C6BE2553FAEEB8E39136B40A,60361,17,23,6,109.51938,18.29681,1567
11044,85079,4E29CE086935B3CD8038A4A6640FE864,30321,0,8,8,109.49563,18.29611,1467
11045,85080,4E29CE086935B3CD8038A4A6640FE864,60041,9,11,2,109.39889,18.31944,1121
11046,85081,4E29CE086935B3CD8038A4A6640FE864,31321,13,18,5,109.63799,18.23201,2007
11047,85082,4E29CE086935B3CD8038A4A6640FE864,31181,19,21,2,109.50382,18.24813,1509
11052,85134,45535CEC214473A10AF775FE26E0DA0C,31471,17,19,2,109.34583,18.29563,917
11053,85135,45535CEC214473A10AF775FE26E0DA0C,31021,20,21,1,109.49021,18.27,1463
11054,85136,45535CEC214473A10AF775FE26E0DA0C,31531,22,23,1,109.49583,18.25972,1461
11066,85196,EF3F5D47F696D0CEE9F7620E432B3BA9,60381,16,18,2,109.5241,18.22458,1605
11067,85197,EF3F5D47F696D0CEE9F7620E432B3BA9,38105,19,21,2,109.40299,18.29229,1117
11068,85215,C82725A09C032EE9BFF2088FCCC60D1D,30854,13,14,1,109.56889,18.27076,1763
11069,85216,C82725A09C032EE9BFF2088FCCC60D1D,31071,17,23,6,109.58257,18.28458,1815
11070,85227,DBB710D279E76C79F1E4B0766F579F8A,31071,0,1,1,109.58257,18.28458,1815
11071,85228,DBB710D279E76C79F1E4B0766F579F8A,60211,3,5,2,109.63549,18.26049,2011
11072,85229,DBB710D279E76C79F1E4B0766F579F8A,30854,8,9,1,109.56889,18.27076,1763
11073,85230,DBB710D279E76C79F1E4B0766F579F8A,31071,12,14,2,109.58257,18.28458,1815
11074,85231,DBB710D279E76C79F1E4B0766F579F8A,30854,14,15,1,109.56889,18.27076,1763
11075,85234,B80D4B4CDBD08237A9C4254F8883AEF4,39151,0,5,5,109.49875,18.25097,1510
11076,85235,B80D4B4CDBD08237A9C4254F8883AEF4,60201,8,11,3,109.5041,18.2509,1510
11077,85236,B80D4B4CDBD08237A9C4254F8883AEF4,39151,12,14,2,109.49875,18.25097,1510
11078,85237,B80D4B4CDBD08237A9C4254F8883AEF4,31181,14,18,4,109.50382,18.24813,1509
11079,85238,B80D4B4CDBD08237A9C4254F8883AEF4,39091,18,22,4,109.50097,18.25222,1510
11083,85254,8799356B7181F28146A203E5F86C52F0,31351,0,7,7,109.4959,18.28417,1465
11084,85255,8799356B7181F28146A203E5F86C52F0,38834,8,14,6,109.47639,18.21146,1403
11085,85256,8799356B7181F28146A203E5F86C52F0,31351,18,20,2,109.4959,18.28417,1465
11089,85317,7EBC20D0E5F0FBA046CA1D08E7FF47C1,60631,1,8,7,109.57778,18.27583,1814
11090,85318,7EBC20D0E5F0FBA046CA1D08E7FF47C1,30854,8,22,14,109.56889,18.27076,1763
11091,85336,55FA72F7A9567EE8C2569F2A3640F92B,31931,5,7,2,109.54771,18.29403,1667
11092,85337,55FA72F7A9567EE8C2569F2A3640F92B,39181,8,17,9,109.55153,18.28035,1715
11093,85348,7084CDA7D62E3DD208E80D2A88147652,30281,0,7,7,109.50597,18.27583,1514
11094,85349,7084CDA7D62E3DD208E80D2A88147652,31161,8,9,1,109.70229,18.31361,2270
11095,85350,7084CDA7D62E3DD208E80D2A88147652,30281,13,15,2,109.50597,18.27583,1514
11096,85351,7084CDA7D62E3DD208E80D2A88147652,60391,18,21,3,109.47667,18.28757,1416
11097,85352,7084CDA7D62E3DD208E80D2A88147652,38127,21,22,1,109.50833,18.27222,1513
11098,85361,37D38EF0062E64D55C94EB554B76F9EE,30854,16,17,1,109.56889,18.27076,1763
11099,85362,37D38EF0062E64D55C94EB554B76F9EE,31945,21,23,2,109.58021,18.29403,1817
11100,85380,3CCEADBA2BEBED7AF2D4B52641EA740D,39063,0,3,3,109.386,18.2919,1066
11101,85381,3CCEADBA2BEBED7AF2D4B52641EA740D,38145,3,6,3,109.378,18.2912,1066
11102,85482,BACB6801ACA2D5F4ABE5F40B34865F7A,30854,1,12,11,109.56889,18.27076,1763
11103,85483,BACB6801ACA2D5F4ABE5F40B34865F7A,60631,14,18,4,109.57778,18.27583,1814
11104,85552,012ABD06F231728C214A4BA917E75B1C,31561,0,3,3,109.56792,18.28479,1765
11105,85553,012ABD06F231728C214A4BA917E75B1C,30851,5,6,1,109.5616,18.27396,1713
11106,85554,012ABD06F231728C214A4BA917E75B1C,31561,6,8,2,109.56792,18.28479,1765
11107,85555,012ABD06F231728C214A4BA917E75B1C,30851,9,10,1,109.5616,18.27396,1713
11108,85556,012ABD06F231728C214A4BA917E75B1C,31561,12,13,1,109.56792,18.28479,1765
11109,85557,012ABD06F231728C214A4BA917E75B1C,30851,15,16,1,109.5616,18.27396,1713
11110,85558,012ABD06F231728C214A4BA917E75B1C,31561,17,19,2,109.56792,18.28479,1765
11115,85565,A8E9C7BB918ADAD29A3EA7ACDDCD32D7,38951,1,6,5,109.48097,18.28868,1416
11116,85566,A8E9C7BB918ADAD29A3EA7ACDDCD32D7,60041,8,15,7,109.39889,18.31944,1121
11117,85567,A8E9C7BB918ADAD29A3EA7ACDDCD32D7,38951,17,23,6,109.48097,18.28868,1416
11118,85581,7215C0D18BC61D4D8430855FAFDC2BFE,30421,17,19,2,109.50021,18.25861,1511
11119,85582,7215C0D18BC61D4D8430855FAFDC2BFE,30391,21,22,1,109.4975,18.27118,1513
11120,85611,1980C8D409DE9551539224B3D393CDAA,30071,0,5,5,109.52819,18.30472,1619
11121,85612,1980C8D409DE9551539224B3D393CDAA,30071,5,8,3,109.52819,18.30472,1619
11122,85613,1980C8D409DE9551539224B3D393CDAA,31951,8,9,1,109.52174,18.30299,1568
11123,85614,1980C8D409DE9551539224B3D393CDAA,30071,11,13,2,109.52819,18.30472,1619
11124,85615,1980C8D409DE9551539224B3D393CDAA,31951,13,15,2,109.52174,18.30299,1568
11125,85616,1980C8D409DE9551539224B3D393CDAA,30071,15,17,2,109.52819,18.30472,1619
11126,85617,1980C8D409DE9551539224B3D393CDAA,31951,18,19,1,109.52174,18.30299,1568
11127,85618,1980C8D409DE9551539224B3D393CDAA,30071,20,21,1,109.52819,18.30472,1619
11128,85619,1980C8D409DE9551539224B3D393CDAA,31951,22,23,1,109.52174,18.30299,1568
11129,85707,782BCA908252809750EF6B8020D2A86A,30181,2,4,2,109.51597,18.23313,1557
11130,85708,782BCA908252809750EF6B8020D2A86A,31201,5,8,3,109.51042,18.23819,1558
11131,85709,782BCA908252809750EF6B8020D2A86A,31781,10,13,3,109.19847,18.2975,367
11132,85710,782BCA908252809750EF6B8020D2A86A,31471,15,16,1,109.34583,18.29563,917
11133,85711,782BCA908252809750EF6B8020D2A86A,30361,19,21,2,109.50347,18.24,1508
11134,85712,782BCA908252809750EF6B8020D2A86A,31201,21,23,2,109.51042,18.23819,1558
11143,85849,5B1793F390E8BE5126CF433016029F77,60131,0,1,1,109.49819,18.24778,1509
11144,85850,5B1793F390E8BE5126CF433016029F77,31161,2,9,7,109.70229,18.31361,2270
11145,85851,5B1793F390E8BE5126CF433016029F77,60111,10,11,1,109.72556,18.31924,2371
11146,85852,5B1793F390E8BE5126CF433016029F77,60291,13,14,1,109.50826,18.24639,1509
11150,85921,549FEB02FDCB1D950404939A4A6496A0,30921,1,6,5,109.53903,18.29451,1667
11151,85939,6277C6831CAADB3DB04E9A9E196CCA2C,31945,0,2,2,109.58021,18.29403,1817
11152,85940,6277C6831CAADB3DB04E9A9E196CCA2C,31071,2,12,10,109.58257,18.28458,1815
11153,85962,6422CB87ACC55DDEF6EBE8946593C808,31351,0,7,7,109.4959,18.28417,1465
11154,85963,6422CB87ACC55DDEF6EBE8946593C808,30161,12,13,1,109.50042,18.24389,1508
11155,85964,6422CB87ACC55DDEF6EBE8946593C808,38834,13,21,8,109.47639,18.21146,1403
11156,85965,6422CB87ACC55DDEF6EBE8946593C808,31351,22,23,1,109.4959,18.28417,1465
11160,86009,5B52C71F88DF5C7017D89C4E504F495B,31236,0,1,1,109.42965,18.29111,1216
11161,86010,5B52C71F88DF5C7017D89C4E504F495B,60552,1,2,1,109.41729,18.30014,1218
11162,86011,5B52C71F88DF5C7017D89C4E504F495B,60551,3,7,4,109.42722,18.30111,1218
11163,86012,5B52C71F88DF5C7017D89C4E504F495B,31781,11,13,2,109.19847,18.2975,367
11164,86013,5B52C71F88DF5C7017D89C4E504F495B,60054,15,16,1,109.3016,18.31229,770
11165,86014,5B52C71F88DF5C7017D89C4E504F495B,60551,18,20,2,109.42722,18.30111,1218
11166,86015,5B52C71F88DF5C7017D89C4E504F495B,30351,21,23,2,109.41701,18.29292,1217
11171,86144,32D0EBFA645FCE8DAD65D018847E5043,30232,0,6,6,109.6191,18.31701,1971
11172,86145,32D0EBFA645FCE8DAD65D018847E5043,30854,8,10,2,109.56889,18.27076,1763
11173,86146,32D0EBFA645FCE8DAD65D018847E5043,30232,13,14,1,109.6191,18.31701,1971
11177,86166,D12813139FDE232B707FEA7A6291700B,39281,14,15,1,109.21333,18.30271,418
11178,86167,D12813139FDE232B707FEA7A6291700B,30421,16,18,2,109.50021,18.25861,1511
11179,86168,D12813139FDE232B707FEA7A6291700B,31621,19,23,4,109.51035,18.29826,1568
11180,86177,C1DFDFC110B50DFE0D66E47848759FB2,30741,13,15,2,109.49833,18.28681,1516
11181,86178,C1DFDFC110B50DFE0D66E47848759FB2,60381,16,17,1,109.5241,18.22458,1605
11182,86179,C1DFDFC110B50DFE0D66E47848759FB2,39191,18,21,3,109.51493,18.23472,1557
11183,86200,40285EE8CCE25C38988EC087545664EC,31071,0,7,7,109.58257,18.28458,1815
11184,86201,40285EE8CCE25C38988EC087545664EC,30854,7,20,13,109.56889,18.27076,1763
11185,86216,BBE4D8242EE46AE73AD69A56A00F4408,31271,0,6,6,109.48958,18.26257,1462
11186,86217,BBE4D8242EE46AE73AD69A56A00F4408,30201,9,12,3,109.4909,18.26465,1462
11187,86218,BBE4D8242EE46AE73AD69A56A00F4408,31271,16,18,2,109.48958,18.26257,1462
11188,86219,BBE4D8242EE46AE73AD69A56A00F4408,30201,19,20,1,109.4909,18.26465,1462
11189,86220,BBE4D8242EE46AE73AD69A56A00F4408,30201,20,22,2,109.4909,18.26465,1462
11190,86260,567998B0F4E9D4CBDA657DF09C8BFBAD,30084,15,17,2,109.50118,18.26972,1513
11194,86312,8A4DC99751E6013D4EE08DF4252C43C8,38141,5,9,4,109.39479,18.2916,1116
11195,86313,8A4DC99751E6013D4EE08DF4252C43C8,31781,10,13,3,109.19847,18.2975,367
11196,86314,8A4DC99751E6013D4EE08DF4252C43C8,31471,14,15,1,109.34583,18.29563,917
11201,86355,F09B4ACB705B8CF3054D70A74071C53C,30611,0,9,9,109.74958,18.40188,2485
11202,86356,F09B4ACB705B8CF3054D70A74071C53C,30721,10,11,1,109.51597,18.28257,1565
11203,86357,F09B4ACB705B8CF3054D70A74071C53C,60201,14,16,2,109.5041,18.2509,1510
11204,86358,F09B4ACB705B8CF3054D70A74071C53C,38154,20,23,3,109.5266,18.28278,1615
11208,86430,95471D684DB585D0049B7AB0C8B83123,30771,0,6,6,109.49938,18.26042,1511
11209,86459,BA444E3EED1E8BBD92378A028029977A,60621,15,17,2,109.48354,18.27451,1464
11210,86461,E9E473F09C342630187345312F4A31D8,39181,0,19,19,109.55153,18.28035,1715
11211,86462,E9E473F09C342630187345312F4A31D8,39181,20,23,3,109.55153,18.28035,1715
11212,86464,104AF40065ED94F83A7A7970F3C770A2,31101,8,9,1,109.65389,18.23403,2057
11213,86465,104AF40065ED94F83A7A7970F3C770A2,30581,10,12,2,109.62257,18.24951,1959
11214,86466,104AF40065ED94F83A7A7970F3C770A2,31521,13,16,3,109.51458,18.22542,1555
11215,86467,104AF40065ED94F83A7A7970F3C770A2,30731,17,20,3,109.50944,18.22306,1555
11219,86527,00FC332040A284DA251A8D0705989FE9,31071,0,8,8,109.58257,18.28458,1815
11220,86528,00FC332040A284DA251A8D0705989FE9,30854,8,16,8,109.56889,18.27076,1763
11221,86586,2AE38FAF341950B0B91404FFCE5A0F3E,31931,0,6,6,109.54771,18.29403,1667
11222,86587,2AE38FAF341950B0B91404FFCE5A0F3E,30921,7,17,10,109.53903,18.29451,1667
11226,86700,2C9F9127F2AECFBA8069624790D23C60,30771,19,20,1,109.49938,18.26042,1511
11227,86708,0F91AB88D936BFA1E1D2836B4DAF2D14,30854,0,1,1,109.56889,18.27076,1763
11228,86709,0F91AB88D936BFA1E1D2836B4DAF2D14,30891,1,6,5,109.59431,18.28389,1865
11229,86710,0F91AB88D936BFA1E1D2836B4DAF2D14,30531,8,17,9,109.53271,18.21472,1604
11230,86711,0F91AB88D936BFA1E1D2836B4DAF2D14,30854,19,21,2,109.56889,18.27076,1763
11231,86718,0CD3A9451B945A7EABB5A7155C5317AC,30271,17,19,2,109.49132,18.23153,1456
11232,86719,0CD3A9451B945A7EABB5A7155C5317AC,31231,22,23,1,109.42597,18.29292,1217
11233,86739,EC4B90EDBF35256FDB4D4F8B87DB8A04,30854,18,19,1,109.56889,18.27076,1763
11237,86798,0D69669D4DBC1CEB06269A084D86E853,30854,8,9,1,109.56889,18.27076,1763
11238,86799,0D69669D4DBC1CEB06269A084D86E853,31101,13,20,7,109.65389,18.23403,2057
11239,86814,64A6FE91570DC5F61A373BFD19D6603B,60491,16,17,1,109.43354,18.30847,1269
11240,86815,64A6FE91570DC5F61A373BFD19D6603B,30671,18,22,4,109.43611,18.30139,1268
11241,86887,F613CC88D209D7DC1A4E289F7CE1FEAE,38951,7,17,10,109.48097,18.28868,1416
11242,86888,F613CC88D209D7DC1A4E289F7CE1FEAE,30281,17,19,2,109.50597,18.27583,1514
11243,86889,F613CC88D209D7DC1A4E289F7CE1FEAE,38951,20,23,3,109.48097,18.28868,1416
11244,86908,622234A65D292D040A9E438A2770674C,30851,0,7,7,109.5616,18.27396,1713
11245,86909,622234A65D292D040A9E438A2770674C,31561,7,11,4,109.56792,18.28479,1765
11246,86910,622234A65D292D040A9E438A2770674C,30851,11,14,3,109.5616,18.27396,1713
11247,86911,622234A65D292D040A9E438A2770674C,31561,16,17,1,109.56792,18.28479,1765
11248,86912,622234A65D292D040A9E438A2770674C,30851,18,23,5,109.5616,18.27396,1713
11253,86989,27229B6D41BD7CDDDAA38911093865DB,31071,0,4,4,109.58257,18.28458,1815
11254,86990,27229B6D41BD7CDDDAA38911093865DB,38085,5,13,8,109.6291,18.23625,2007
11255,86991,27229B6D41BD7CDDDAA38911093865DB,30854,15,16,1,109.56889,18.27076,1763
11256,86992,27229B6D41BD7CDDDAA38911093865DB,31071,16,17,1,109.58257,18.28458,1815
11257,86993,27229B6D41BD7CDDDAA38911093865DB,30854,19,20,1,109.56889,18.27076,1763
11258,87011,14F1CC63CDA098F9694EAC8584B9C7A5,31561,5,6,1,109.56792,18.28479,1765
11259,87012,14F1CC63CDA098F9694EAC8584B9C7A5,30854,10,16,6,109.56889,18.27076,1763
11260,87020,B16977B88DE920FADD302624AE75E34D,31945,0,5,5,109.58021,18.29403,1817
11261,87021,B16977B88DE920FADD302624AE75E34D,30851,7,11,4,109.5616,18.27396,1713
11262,87022,B16977B88DE920FADD302624AE75E34D,31561,12,14,2,109.56792,18.28479,1765
11263,87023,B16977B88DE920FADD302624AE75E34D,30854,14,15,1,109.56889,18.27076,1763
11264,87024,B16977B88DE920FADD302624AE75E34D,31561,15,17,2,109.56792,18.28479,1765
11265,87025,B16977B88DE920FADD302624AE75E34D,30854,17,18,1,109.56889,18.27076,1763
11266,87026,B16977B88DE920FADD302624AE75E34D,31945,20,23,3,109.58021,18.29403,1817
11267,87109,1D8B814EC83D52D7C5F3FED99C129EE0,30854,2,7,5,109.56889,18.27076,1763
11268,87110,1D8B814EC83D52D7C5F3FED99C129EE0,38271,8,11,3,109.62632,18.23049,1956
11269,87111,1D8B814EC83D52D7C5F3FED99C129EE0,39151,15,16,1,109.49875,18.25097,1510
11270,87112,1D8B814EC83D52D7C5F3FED99C129EE0,38271,20,21,1,109.62632,18.23049,1956
11271,87206,40A0E1FD3CD6EB88C3D6A6AB137FEE15,31431,0,8,8,109.44639,18.29042,1316
11272,87207,40A0E1FD3CD6EB88C3D6A6AB137FEE15,33051,11,12,1,109.6475,18.46618,2096
11273,87208,40A0E1FD3CD6EB88C3D6A6AB137FEE15,31101,14,15,1,109.65389,18.23403,2057
11274,87209,40A0E1FD3CD6EB88C3D6A6AB137FEE15,31431,19,22,3,109.44639,18.29042,1316
11275,87230,3C987E7C80A67E39D0CEFBFF3DF2E11E,60551,0,3,3,109.42722,18.30111,1218
11276,87231,3C987E7C80A67E39D0CEFBFF3DF2E11E,30354,4,7,3,109.42813,18.29076,1216
11277,87232,3C987E7C80A67E39D0CEFBFF3DF2E11E,30351,7,8,1,109.41701,18.29292,1217
11278,87233,3C987E7C80A67E39D0CEFBFF3DF2E11E,31781,11,13,2,109.19847,18.2975,367
11279,87234,3C987E7C80A67E39D0CEFBFF3DF2E11E,31471,14,16,2,109.34583,18.29563,917
11280,87235,3C987E7C80A67E39D0CEFBFF3DF2E11E,60551,18,22,4,109.42722,18.30111,1218
11281,87270,2D115D52FDAB55086A12D742071FDFC9,30232,0,1,1,109.6191,18.31701,1971
11282,87271,2D115D52FDAB55086A12D742071FDFC9,30854,3,22,19,109.56889,18.27076,1763
11283,87275,4C15740C85B7C75F2E990BCFA0AEA625,60524,2,5,3,109.42951,18.28993,1216
11284,87276,4C15740C85B7C75F2E990BCFA0AEA625,60401,7,8,1,109.47444,18.27583,1414
11285,87277,4C15740C85B7C75F2E990BCFA0AEA625,31031,8,14,6,109.49979,18.25382,1510
11286,87278,4C15740C85B7C75F2E990BCFA0AEA625,60401,14,17,3,109.47444,18.27583,1414
11287,87279,4C15740C85B7C75F2E990BCFA0AEA625,38251,18,19,1,109.49618,18.25493,1510
11288,87280,4C15740C85B7C75F2E990BCFA0AEA625,60131,19,20,1,109.49819,18.24778,1509
11289,87281,4C15740C85B7C75F2E990BCFA0AEA625,31031,20,23,3,109.49979,18.25382,1510
11296,87363,23019CE071DC0B0CEC6E78ADA422CE57,31461,0,10,10,109.5091,18.25389,1510
11297,87365,23019CE071DC0B0CEC6E78ADA422CE57,38973,21,23,2,109.51097,18.25389,1560
11298,87370,036DFEF8CA623F9034F928149FE2468D,30821,2,3,1,109.43681,18.33639,1274
11299,87371,036DFEF8CA623F9034F928149FE2468D,30651,6,9,3,109.42611,18.385,1232
11300,87372,036DFEF8CA623F9034F928149FE2468D,30821,12,16,4,109.43681,18.33639,1274
11301,87373,036DFEF8CA623F9034F928149FE2468D,60011,18,19,1,109.48965,18.30222,1468
11302,87374,036DFEF8CA623F9034F928149FE2468D,30821,22,23,1,109.43681,18.33639,1274
11306,87427,5EE25A6E7DD554FFDA0C9C1A504114B7,38127,18,19,1,109.50833,18.27222,1513
11307,87428,5EE25A6E7DD554FFDA0C9C1A504114B7,30221,20,22,2,109.57833,18.20222,1802
11308,87433,C0CA4E58B15F58D7F48B8BEF10CEB35A,30891,0,5,5,109.59431,18.28389,1865
11309,87434,C0CA4E58B15F58D7F48B8BEF10CEB35A,60591,10,17,7,109.61118,18.21715,1904
11310,87435,E7DB0F55EDE33BB4C08C98B80B7173BF,30071,15,16,1,109.52819,18.30472,1619
11311,87436,E7DB0F55EDE33BB4C08C98B80B7173BF,60371,18,22,4,109.53063,18.30056,1618
11312,87437,7BF65E5054DA81A230AB5423620158E1,60631,1,6,5,109.57778,18.27583,1814
11313,87438,7BF65E5054DA81A230AB5423620158E1,30854,10,15,5,109.56889,18.27076,1763
11314,87439,7BF65E5054DA81A230AB5423620158E1,31071,19,20,1,109.58257,18.28458,1815
11315,87440,7BF65E5054DA81A230AB5423620158E1,30191,21,23,2,109.50361,18.22701,1506
11316,87449,D8757A808F606352AF3AC0BD9CD2C12A,31071,0,5,5,109.58257,18.28458,1815
11317,87450,D8757A808F606352AF3AC0BD9CD2C12A,30854,8,9,1,109.56889,18.27076,1763
11318,87451,D8757A808F606352AF3AC0BD9CD2C12A,30671,13,14,1,109.43611,18.30139,1268
11319,87452,D8757A808F606352AF3AC0BD9CD2C12A,60491,15,16,1,109.43354,18.30847,1269
11320,87453,D8757A808F606352AF3AC0BD9CD2C12A,30671,17,19,2,109.43611,18.30139,1268
11321,87454,D8757A808F606352AF3AC0BD9CD2C12A,60491,21,22,1,109.43354,18.30847,1269
11322,87467,C58D0182BFC61ED113EE3B09763C30B2,38185,0,7,7,109.51333,18.27347,1563
11323,87468,C58D0182BFC61ED113EE3B09763C30B2,38127,8,9,1,109.50833,18.27222,1513
11324,87469,C58D0182BFC61ED113EE3B09763C30B2,31931,10,11,1,109.54771,18.29403,1667
11325,87470,C58D0182BFC61ED113EE3B09763C30B2,38127,13,18,5,109.50833,18.27222,1513
11326,87471,C58D0182BFC61ED113EE3B09763C30B2,38185,20,22,2,109.51333,18.27347,1563
11327,87489,B432C0186449A28ED200760F76E06147,31471,14,17,3,109.34583,18.29563,917
11328,87490,B432C0186449A28ED200760F76E06147,60524,18,23,5,109.42951,18.28993,1216
11329,87516,079A114D194FE2EFB0C89059CA4EBC03,31251,1,7,6,109.18528,18.2975,317
11330,87518,079A114D194FE2EFB0C89059CA4EBC03,31251,21,23,2,109.18528,18.2975,317
11331,87587,52A7280BA3A0FD171DDC8618F647763C,60084,0,1,1,109.4984,18.2334,1507
11332,87588,52A7280BA3A0FD171DDC8618F647763C,30271,1,2,1,109.49132,18.23153,1456
11333,87589,52A7280BA3A0FD171DDC8618F647763C,60084,3,5,2,109.4984,18.2334,1507
11334,87590,52A7280BA3A0FD171DDC8618F647763C,31781,9,12,3,109.19847,18.2975,367
11335,87591,52A7280BA3A0FD171DDC8618F647763C,60084,13,15,2,109.4984,18.2334,1507
11336,87592,52A7280BA3A0FD171DDC8618F647763C,30271,17,18,1,109.49132,18.23153,1456
11340,87610,E649CF84A26278291AA1A5B5C5D01FCA,31561,3,4,1,109.56792,18.28479,1765
11341,87611,E649CF84A26278291AA1A5B5C5D01FCA,30854,8,9,1,109.56889,18.27076,1763
11342,87612,E649CF84A26278291AA1A5B5C5D01FCA,31071,9,11,2,109.58257,18.28458,1815
11343,87613,E649CF84A26278291AA1A5B5C5D01FCA,30854,13,14,1,109.56889,18.27076,1763
11344,87614,E649CF84A26278291AA1A5B5C5D01FCA,30161,17,20,3,109.50042,18.24389,1508
11349,87666,6C0260646767B781577B5B8CE2471E51,38484,0,8,8,109.53028,18.31528,1620
11350,87667,6C0260646767B781577B5B8CE2471E51,38484,9,11,2,109.53028,18.31528,1620
11351,87668,6C0260646767B781577B5B8CE2471E51,38484,13,16,3,109.53028,18.31528,1620
11352,87669,6C0260646767B781577B5B8CE2471E51,30071,19,21,2,109.52819,18.30472,1619
11353,87670,6C0260646767B781577B5B8CE2471E51,31951,21,22,1,109.52174,18.30299,1568
11354,87674,67C2E924C3DAE66F90EC1C8F2F79B902,31531,0,9,9,109.49583,18.25972,1461
11355,87675,67C2E924C3DAE66F90EC1C8F2F79B902,60054,11,12,1,109.3016,18.31229,770
11356,87676,67C2E924C3DAE66F90EC1C8F2F79B902,31471,12,13,1,109.34583,18.29563,917
11357,87677,67C2E924C3DAE66F90EC1C8F2F79B902,60161,17,19,2,109.49174,18.26181,1461
11358,87678,67C2E924C3DAE66F90EC1C8F2F79B902,31531,21,23,2,109.49583,18.25972,1461
11359,87696,8F6EA1C108FADA76A214A7ED71ECE3D1,30851,0,4,4,109.5616,18.27396,1713
11360,87697,8F6EA1C108FADA76A214A7ED71ECE3D1,30854,6,17,11,109.56889,18.27076,1763
11361,87698,8F6EA1C108FADA76A214A7ED71ECE3D1,30232,20,22,2,109.6191,18.31701,1971
11362,87699,BE24D518A0B386C325D30CFE9CBEF7B9,30891,4,7,3,109.59431,18.28389,1865
11363,87700,BE24D518A0B386C325D30CFE9CBEF7B9,61011,9,12,3,109.60653,18.19076,1900
11364,87702,BE24D518A0B386C325D30CFE9CBEF7B9,30232,19,23,4,109.6191,18.31701,1971
11365,87711,A1C95B17C868D553635D99A0D1B2A324,39041,13,21,8,109.40021,18.29278,1117
11366,87731,7409CD873716B8BE8EEC7DA694433A5F,60641,0,1,1,109.53854,18.2359,1657
11367,87732,7409CD873716B8BE8EEC7DA694433A5F,30861,2,6,4,109.52722,18.22743,1606
11372,87764,8039EB5AFB4AD782481BED6ABCE4707B,31201,0,8,8,109.51042,18.23819,1558
11373,87765,8039EB5AFB4AD782481BED6ABCE4707B,31781,10,13,3,109.19847,18.2975,367
11374,87766,8039EB5AFB4AD782481BED6ABCE4707B,60054,15,16,1,109.3016,18.31229,770
11375,87767,8039EB5AFB4AD782481BED6ABCE4707B,30361,20,21,1,109.50347,18.24,1508
11376,87768,8039EB5AFB4AD782481BED6ABCE4707B,31206,22,23,1,109.50819,18.23549,1507
11380,87822,1A267E022EDC4D8D9AD3710AD25160F4,60391,4,5,1,109.47667,18.28757,1416
11381,87823,1A267E022EDC4D8D9AD3710AD25160F4,60391,6,8,2,109.47667,18.28757,1416
11382,87824,1A267E022EDC4D8D9AD3710AD25160F4,31471,10,11,1,109.34583,18.29563,917
11383,87825,8AABF5FDF2B06EB445749240A3894969,31071,0,8,8,109.58257,18.28458,1815
11384,87826,8AABF5FDF2B06EB445749240A3894969,30854,8,16,8,109.56889,18.27076,1763
11385,87827,8AABF5FDF2B06EB445749240A3894969,31851,16,17,1,109.71736,18.29007,2316
11386,87828,8AABF5FDF2B06EB445749240A3894969,31071,18,20,2,109.58257,18.28458,1815
11387,87882,FE95B3A32EFBC2838F293DF38F55FDD1,39183,3,4,1,109.55542,18.28208,1715
11388,87883,FE95B3A32EFBC2838F293DF38F55FDD1,31561,5,7,2,109.56792,18.28479,1765
11389,87922,E8BAAF476E8FE57075BAB1A8D4FF1780,30232,1,6,5,109.6191,18.31701,1971
11390,87923,E8BAAF476E8FE57075BAB1A8D4FF1780,30854,8,17,9,109.56889,18.27076,1763
11391,87924,E8BAAF476E8FE57075BAB1A8D4FF1780,60381,19,20,1,109.5241,18.22458,1605
11392,87925,E8BAAF476E8FE57075BAB1A8D4FF1780,30232,21,22,1,109.6191,18.31701,1971
11393,87978,7C16827D646BDC874DE2BD7EE32189C5,30854,1,11,10,109.56889,18.27076,1763
11394,87979,7C16827D646BDC874DE2BD7EE32189C5,60631,12,21,9,109.57778,18.27583,1814
11395,88028,02B6B5412B758335455F3642E59B11F1,38951,0,8,8,109.48097,18.28868,1416
11396,88029,02B6B5412B758335455F3642E59B11F1,38754,12,13,1,109.74667,18.37382,2430
11397,88030,02B6B5412B758335455F3642E59B11F1,38951,15,19,4,109.48097,18.28868,1416
11398,88031,02B6B5412B758335455F3642E59B11F1,38071,21,22,1,109.40722,18.30938,1169
11399,88041,BDA2B6FCF35F47A82B74AE9C94731204,38054,0,9,9,109.63479,18.23097,2006
11400,88042,BDA2B6FCF35F47A82B74AE9C94731204,31471,11,12,1,109.34583,18.29563,917
11401,88043,BDA2B6FCF35F47A82B74AE9C94731204,60411,14,15,1,109.32514,18.30854,869
11402,88044,BDA2B6FCF35F47A82B74AE9C94731204,31781,16,17,1,109.19847,18.2975,367
11403,88045,BDA2B6FCF35F47A82B74AE9C94731204,38054,21,23,2,109.63479,18.23097,2006
11404,88079,9EA825CA50A62195A51752F975FDCF57,31071,3,7,4,109.58257,18.28458,1815
11405,88080,9EA825CA50A62195A51752F975FDCF57,30854,8,23,15,109.56889,18.27076,1763
11406,88093,89C2F48F3C187B81197D45E0E1289EA8,31571,10,11,1,109.61563,18.23326,1957
11407,88094,89C2F48F3C187B81197D45E0E1289EA8,30581,11,12,1,109.62257,18.24951,1959
11408,88095,89C2F48F3C187B81197D45E0E1289EA8,31571,13,14,1,109.61563,18.23326,1957
11409,88097,3559FC617E0C604C72AAF44A4C6A495C,31321,12,18,6,109.63799,18.23201,2007
11410,88098,3559FC617E0C604C72AAF44A4C6A495C,31041,20,21,1,109.50278,18.23701,1507
11411,88117,9B979E9430BCD0DDB6C78BBE525EBD2D,60631,3,6,3,109.57778,18.27583,1814
11412,88118,9B979E9430BCD0DDB6C78BBE525EBD2D,30854,8,22,14,109.56889,18.27076,1763
11416,88138,C1793DCC823463513E28F999E76F9ADC,60054,0,6,6,109.3016,18.31229,770
11417,88139,C1793DCC823463513E28F999E76F9ADC,31471,7,9,2,109.34583,18.29563,917
11418,88140,C1793DCC823463513E28F999E76F9ADC,60054,10,13,3,109.3016,18.31229,770
11419,88141,C1793DCC823463513E28F999E76F9ADC,60661,16,19,3,109.548,18.2377,1657
11420,88142,C1793DCC823463513E28F999E76F9ADC,60054,21,23,2,109.3016,18.31229,770
11421,88164,9D84057972B69A5E23018ED19BFE5178,31231,13,16,3,109.42597,18.29292,1217
11422,88165,9D84057972B69A5E23018ED19BFE5178,31231,17,23,6,109.42597,18.29292,1217
11423,88240,1B6EBBFF3B9D8A3E18753343B6A29EAE,31071,0,6,6,109.58257,18.28458,1815
11424,88241,1B6EBBFF3B9D8A3E18753343B6A29EAE,30851,8,11,3,109.5616,18.27396,1713
11425,88242,1B6EBBFF3B9D8A3E18753343B6A29EAE,31071,12,14,2,109.58257,18.28458,1815
11426,88243,1B6EBBFF3B9D8A3E18753343B6A29EAE,31561,14,15,1,109.56792,18.28479,1765
11427,88244,1B6EBBFF3B9D8A3E18753343B6A29EAE,30851,15,17,2,109.5616,18.27396,1713
11428,88245,1B6EBBFF3B9D8A3E18753343B6A29EAE,31071,19,23,4,109.58257,18.28458,1815
11445,88371,74206C862E4BA6236E7F7978D63D1D7D,30191,0,1,1,109.50361,18.22701,1506
11446,88372,74206C862E4BA6236E7F7978D63D1D7D,60631,3,7,4,109.57778,18.27583,1814
11447,88373,74206C862E4BA6236E7F7978D63D1D7D,30854,9,12,3,109.56889,18.27076,1763
11448,88374,74206C862E4BA6236E7F7978D63D1D7D,60631,14,15,1,109.57778,18.27583,1814
11449,88404,2D8DAA5F24A7C71335ED6C7E0756CEA1,60241,16,18,2,109.53319,18.28667,1616
11450,88405,2D8DAA5F24A7C71335ED6C7E0756CEA1,60131,20,22,2,109.49819,18.24778,1509
11451,88408,E8DB631088E68D5FF25F35789654CC79,30581,0,10,10,109.62257,18.24951,1959
11452,88409,E8DB631088E68D5FF25F35789654CC79,38336,11,16,5,109.61111,18.21806,1904
11456,88479,2193DBFF071303BC78357ADF9D951389,30854,4,8,4,109.56889,18.27076,1763
11457,88480,2193DBFF071303BC78357ADF9D951389,33051,12,14,2,109.6475,18.46618,2096
11458,88481,2193DBFF071303BC78357ADF9D951389,31031,18,21,3,109.49979,18.25382,1510
11459,88482,2193DBFF071303BC78357ADF9D951389,60631,22,23,1,109.57778,18.27583,1814
11460,88509,CF1922E57BC1E2D5DC4336E820C48B77,31471,2,8,6,109.34583,18.29563,917
11461,88510,CF1922E57BC1E2D5DC4336E820C48B77,60411,11,22,11,109.32514,18.30854,869
11462,88511,CF1922E57BC1E2D5DC4336E820C48B77,30661,22,23,1,109.37028,18.24361,1008
11463,88516,066CC6CBB5ADF978A93AF5D0C3292806,30321,13,14,1,109.49563,18.29611,1467
11464,88517,066CC6CBB5ADF978A93AF5D0C3292806,31931,18,23,5,109.54771,18.29403,1667
11465,88522,26F72B0B992AAD04E729F6A1E4F85ECE,60381,19,21,2,109.5241,18.22458,1605
11466,88523,26F72B0B992AAD04E729F6A1E4F85ECE,38241,22,23,1,109.54111,18.30542,1669
11467,88560,10B66D855AEA437CF12F1E3706E70AE7,60291,0,9,9,109.50826,18.24639,1509
11468,88561,10B66D855AEA437CF12F1E3706E70AE7,31471,12,14,2,109.34583,18.29563,917
11469,88562,10B66D855AEA437CF12F1E3706E70AE7,31521,17,19,2,109.51458,18.22542,1555
11470,88648,90D91A493F9482486DCC3B27CF3F61EE,31071,15,17,2,109.58257,18.28458,1815
11471,88649,90D91A493F9482486DCC3B27CF3F61EE,30854,18,20,2,109.56889,18.27076,1763
11472,88650,90D91A493F9482486DCC3B27CF3F61EE,31071,20,22,2,109.58257,18.28458,1815
11473,88666,7C68E1F4B8B2F3CBBD5427BF66BF9C2E,39191,14,16,2,109.51493,18.23472,1557
11474,88667,7C68E1F4B8B2F3CBBD5427BF66BF9C2E,31571,20,22,2,109.61563,18.23326,1957
11475,88700,B02D7A3F297B377D646E0F85B7C19006,61011,0,3,3,109.60653,18.19076,1900
11476,88702,B02D7A3F297B377D646E0F85B7C19006,61011,12,23,11,109.60653,18.19076,1900
11477,88712,246EF4D95FA494895EFB2D649512DAE7,60081,0,6,6,109.51097,18.22639,1556
11478,88714,246EF4D95FA494895EFB2D649512DAE7,60081,21,23,2,109.51097,18.22639,1556
11479,88734,ADF0A7CED2B8DFD757D8FCA8B507C37E,30854,15,16,1,109.56889,18.27076,1763
11480,88735,ADF0A7CED2B8DFD757D8FCA8B507C37E,38283,19,20,1,109.62229,18.22618,1956
11481,88736,F941446F9B0207C03AB7C20D9AC6A7F4,31931,6,15,9,109.54771,18.29403,1667
11482,88737,F941446F9B0207C03AB7C20D9AC6A7F4,60361,19,20,1,109.51938,18.29681,1567
11483,88738,F941446F9B0207C03AB7C20D9AC6A7F4,31931,21,23,2,109.54771,18.29403,1667
11484,88739,DD8DCE806AFFEAC5D779812E5F8F2B3D,31561,7,10,3,109.56792,18.28479,1765
11485,88740,DD8DCE806AFFEAC5D779812E5F8F2B3D,31071,11,12,1,109.58257,18.28458,1815
11486,88741,DD8DCE806AFFEAC5D779812E5F8F2B3D,31561,12,15,3,109.56792,18.28479,1765
11487,88784,19F803FB996471824A8A9928BBFAB433,31931,14,17,3,109.54771,18.29403,1667
11488,88785,19F803FB996471824A8A9928BBFAB433,39181,20,22,2,109.55153,18.28035,1715
11489,88788,E6546ADDD2155B08063BE71A9EAB8C5E,31031,11,13,2,109.49979,18.25382,1510
11490,88789,E6546ADDD2155B08063BE71A9EAB8C5E,38071,14,16,2,109.40722,18.30938,1169
11491,88790,E6546ADDD2155B08063BE71A9EAB8C5E,38251,17,19,2,109.49618,18.25493,1510
11492,88791,E6546ADDD2155B08063BE71A9EAB8C5E,60401,20,23,3,109.47444,18.27583,1414
11493,88828,77414D14BE59EC89504916C6ECC18D2C,38251,13,16,3,109.49618,18.25493,1510
11494,88829,77414D14BE59EC89504916C6ECC18D2C,60331,18,20,2,109.505,18.26507,1512
11495,88870,B5232BF64D4E4122D35EC2DC26B51D2A,38052,17,18,1,109.62618,18.23042,1956
11496,88871,B5232BF64D4E4122D35EC2DC26B51D2A,30441,19,21,2,109.64021,18.25424,2010
11497,88872,B5232BF64D4E4122D35EC2DC26B51D2A,60594,21,23,2,109.62694,18.22799,1956
11498,88884,B023927CBEC0A8053CBDF64A5B76E367,30051,0,6,6,109.48917,18.21215,1453
11499,88885,B023927CBEC0A8053CBDF64A5B76E367,31931,9,10,1,109.54771,18.29403,1667
11500,88886,B023927CBEC0A8053CBDF64A5B76E367,30921,11,12,1,109.53903,18.29451,1667
11501,88887,B023927CBEC0A8053CBDF64A5B76E367,31931,14,15,1,109.54771,18.29403,1667
11502,88926,F95E8C48F26FEDEBE2F61D5B3778D40A,38541,0,10,10,109.73715,18.34875,2426
11503,88927,F95E8C48F26FEDEBE2F61D5B3778D40A,30421,13,15,2,109.50021,18.25861,1511
11504,88928,F95E8C48F26FEDEBE2F61D5B3778D40A,30711,19,22,3,109.50271,18.25347,1510
11505,88960,45FA8AF959A216E06C82392E21728E7F,31561,2,16,14,109.56792,18.28479,1765
11506,88961,45FA8AF959A216E06C82392E21728E7F,39183,20,21,1,109.55542,18.28208,1715
11511,88983,B172E1B17A92EA23226EC822FB6F7B82,39191,0,8,8,109.51493,18.23472,1557
11512,88984,B172E1B17A92EA23226EC822FB6F7B82,31561,9,11,2,109.56792,18.28479,1765
11513,88985,B172E1B17A92EA23226EC822FB6F7B82,30181,12,15,3,109.51597,18.23313,1557
11514,88986,B172E1B17A92EA23226EC822FB6F7B82,60131,18,19,1,109.49819,18.24778,1509
11515,88987,B172E1B17A92EA23226EC822FB6F7B82,39191,21,23,2,109.51493,18.23472,1557
11516,89001,FF8CB3D02361FAEBFE418108180099D8,30421,1,5,4,109.50021,18.25861,1511
11517,89002,FF8CB3D02361FAEBFE418108180099D8,60201,6,7,1,109.5041,18.2509,1510
11518,89003,FF8CB3D02361FAEBFE418108180099D8,31261,9,12,3,109.51174,18.2466,1559
11519,89004,FF8CB3D02361FAEBFE418108180099D8,60201,13,14,1,109.5041,18.2509,1510
11520,89005,FF8CB3D02361FAEBFE418108180099D8,30711,15,22,7,109.50271,18.25347,1510
11521,89016,D4EE8E1A4C04A1FF0596E4221D0B8B42,30854,13,15,2,109.56889,18.27076,1763
11522,89017,D4EE8E1A4C04A1FF0596E4221D0B8B42,31071,15,17,2,109.58257,18.28458,1815
11523,89018,D4EE8E1A4C04A1FF0596E4221D0B8B42,30854,20,22,2,109.56889,18.27076,1763
11534,89244,FD741240540EA611084A00540F097CB4,30854,0,8,8,109.56889,18.27076,1763
11535,89245,FD741240540EA611084A00540F097CB4,31431,10,11,1,109.44639,18.29042,1316
11536,89246,FD741240540EA611084A00540F097CB4,30854,13,22,9,109.56889,18.27076,1763
11543,89292,C17F2EF1DEA79C8C951E3013EE071B2C,31071,16,17,1,109.58257,18.28458,1815
11544,89293,C17F2EF1DEA79C8C951E3013EE071B2C,30854,20,22,2,109.56889,18.27076,1763
11548,89318,80F0DD5FB175B0969C97D8701F196498,38251,0,12,12,109.49618,18.25493,1510
11549,89319,80F0DD5FB175B0969C97D8701F196498,30854,14,15,1,109.56889,18.27076,1763
11550,89320,80F0DD5FB175B0969C97D8701F196498,31071,18,19,1,109.58257,18.28458,1815
11551,89321,9324CC6DBC2BEA36F562F7A9DE6CA338,31521,0,5,5,109.51458,18.22542,1555
11552,89322,9324CC6DBC2BEA36F562F7A9DE6CA338,30221,5,6,1,109.57833,18.20222,1802
11553,89323,9324CC6DBC2BEA36F562F7A9DE6CA338,31521,7,9,2,109.51458,18.22542,1555
11554,89324,9324CC6DBC2BEA36F562F7A9DE6CA338,31561,10,12,2,109.56792,18.28479,1765
11555,89325,9324CC6DBC2BEA36F562F7A9DE6CA338,31521,13,17,4,109.51458,18.22542,1555
11556,89326,9324CC6DBC2BEA36F562F7A9DE6CA338,60221,17,21,4,109.52569,18.29188,1616
11557,89327,9324CC6DBC2BEA36F562F7A9DE6CA338,31521,21,23,2,109.51458,18.22542,1555
11558,89328,B16A2ACE703D283A7DD000484B3D1777,30421,0,12,12,109.50021,18.25861,1511
11559,89329,B16A2ACE703D283A7DD000484B3D1777,31031,15,17,2,109.49979,18.25382,1510
11560,89333,17D13F6A66037B54FAB5668CDC734401,30721,0,8,8,109.51597,18.28257,1565
11561,89334,17D13F6A66037B54FAB5668CDC734401,31931,9,10,1,109.54771,18.29403,1667
11562,89335,17D13F6A66037B54FAB5668CDC734401,30071,14,16,2,109.52819,18.30472,1619
11563,89336,17D13F6A66037B54FAB5668CDC734401,31931,16,18,2,109.54771,18.29403,1667
11564,89337,17D13F6A66037B54FAB5668CDC734401,30721,19,23,4,109.51597,18.28257,1565
11565,89432,C358285726113434A30FBBA8DED710E7,31621,17,18,1,109.51035,18.29826,1568
11566,89433,C358285726113434A30FBBA8DED710E7,30281,19,20,1,109.50597,18.27583,1514
11567,89503,24E98C0EC4A6054CC486A2611C493128,33051,13,15,2,109.6475,18.46618,2096
11568,89504,24E98C0EC4A6054CC486A2611C493128,31071,16,18,2,109.58257,18.28458,1815
11569,89505,24E98C0EC4A6054CC486A2611C493128,30891,19,20,1,109.59431,18.28389,1865
11570,89510,1A55CEB18A726CCE74CF0F2DC867FF78,60501,18,20,2,109.48701,18.29021,1466
11571,89511,1A55CEB18A726CCE74CF0F2DC867FF78,31864,21,23,2,109.49014,18.28333,1465
11572,89512,8621CFDF1B89A83351494618C53D033F,31071,0,5,5,109.58257,18.28458,1815
11573,89513,8621CFDF1B89A83351494618C53D033F,39181,10,22,12,109.55153,18.28035,1715
11574,89581,22B987DE38F8C4435934FE5E6190C4A2,30581,19,20,1,109.62257,18.24951,1959
11575,89582,22B987DE38F8C4435934FE5E6190C4A2,31571,20,22,2,109.61563,18.23326,1957
11576,89583,BE7763F8096EB5A037146E1CC4190538,30854,1,6,5,109.56889,18.27076,1763
11577,89584,BE7763F8096EB5A037146E1CC4190538,39181,7,8,1,109.55153,18.28035,1715
11578,89585,BE7763F8096EB5A037146E1CC4190538,39183,9,10,1,109.55542,18.28208,1715
11579,89586,BE7763F8096EB5A037146E1CC4190538,31561,11,12,1,109.56792,18.28479,1765
11580,89587,BE7763F8096EB5A037146E1CC4190538,39181,15,17,2,109.55153,18.28035,1715
11581,89588,BE7763F8096EB5A037146E1CC4190538,31071,19,20,1,109.58257,18.28458,1815
11582,89607,B76381FBDC68F2B2041DDEC63195F0A7,31931,0,4,4,109.54771,18.29403,1667
11583,89608,B76381FBDC68F2B2041DDEC63195F0A7,39181,8,23,15,109.55153,18.28035,1715
11584,89611,D44F04C671F28AD094462A9D39B67104,60614,0,8,8,109.48799,18.29521,1467
11585,89612,D44F04C671F28AD094462A9D39B67104,30971,9,10,1,109.48708,18.29319,1467
11589,89699,F3E280D806C0279BCC08880D6A71DAC7,30861,17,18,1,109.52722,18.22743,1606
11590,89700,F3E280D806C0279BCC08880D6A71DAC7,31031,20,21,1,109.49979,18.25382,1510
11591,89701,F3E280D806C0279BCC08880D6A71DAC7,31261,21,23,2,109.51174,18.2466,1559
11592,89720,EB316856896788EC8FD871E122E95728,60361,0,5,5,109.51938,18.29681,1567
11593,89721,EB316856896788EC8FD871E122E95728,30931,5,6,1,109.55653,18.32722,1722
11594,89722,EB316856896788EC8FD871E122E95728,31811,8,11,3,109.54201,18.31806,1671
11595,89723,EB316856896788EC8FD871E122E95728,30701,12,14,2,109.59313,18.32007,1871
11596,89724,EB316856896788EC8FD871E122E95728,31811,14,18,4,109.54201,18.31806,1671
11597,89725,EB316856896788EC8FD871E122E95728,30701,19,22,3,109.59313,18.32007,1871
11598,89728,8F3DE08315D720DC64DC898C5903196E,31164,8,9,1,109.69993,18.27215,2263
11599,89729,8F3DE08315D720DC64DC898C5903196E,30854,11,12,1,109.56889,18.27076,1763
11600,89730,8F3DE08315D720DC64DC898C5903196E,60131,15,16,1,109.49819,18.24778,1509
11601,89731,8F3DE08315D720DC64DC898C5903196E,60631,18,19,1,109.57778,18.27583,1814
11602,89732,8F3DE08315D720DC64DC898C5903196E,30854,19,22,3,109.56889,18.27076,1763
11603,89733,74A9CCA48CD6C2DA9FC7DFDB8817D50B,30854,9,21,12,109.56889,18.27076,1763
11604,89734,74A9CCA48CD6C2DA9FC7DFDB8817D50B,30851,22,23,1,109.5616,18.27396,1713
11605,89831,9DE8C13901CC7D63E2F1A6CC92603604,31071,0,15,15,109.58257,18.28458,1815
11606,89832,9DE8C13901CC7D63E2F1A6CC92603604,30731,16,18,2,109.50944,18.22306,1555
11607,89851,D5ED0B56415F07DD214B0DC3E9293672,30854,0,7,7,109.56889,18.27076,1763
11608,89852,D5ED0B56415F07DD214B0DC3E9293672,30232,11,14,3,109.6191,18.31701,1971
11609,89853,D5ED0B56415F07DD214B0DC3E9293672,30854,16,19,3,109.56889,18.27076,1763
11610,89854,D5ED0B56415F07DD214B0DC3E9293672,30232,20,21,1,109.6191,18.31701,1971
11611,89860,2DDF3A993BD69F79020EB97CF3A71819,38171,0,6,6,109.50799,18.28139,1515
11612,89861,2DDF3A993BD69F79020EB97CF3A71819,30161,7,10,3,109.50042,18.24389,1508
11613,89862,2DDF3A993BD69F79020EB97CF3A71819,30161,12,16,4,109.50042,18.24389,1508
11614,89863,2DDF3A993BD69F79020EB97CF3A71819,38251,18,19,1,109.49618,18.25493,1510
11615,89864,2DDF3A993BD69F79020EB97CF3A71819,38171,22,23,1,109.50799,18.28139,1515
11616,89882,8EA475D017A01807E97E34F719EA95E4,31421,1,3,2,109.55382,18.22347,1705
11617,89883,8EA475D017A01807E97E34F719EA95E4,30851,3,10,7,109.5616,18.27396,1713
11618,89884,8EA475D017A01807E97E34F719EA95E4,31421,12,14,2,109.55382,18.22347,1705
11619,89885,8EA475D017A01807E97E34F719EA95E4,30851,15,17,2,109.5616,18.27396,1713
11620,89886,8EA475D017A01807E97E34F719EA95E4,39183,17,19,2,109.55542,18.28208,1715
11621,89887,8EA475D017A01807E97E34F719EA95E4,31421,19,21,2,109.55382,18.22347,1705
11622,89888,8EA475D017A01807E97E34F719EA95E4,30851,21,23,2,109.5616,18.27396,1713
11626,89915,EBD16061EA20EE33D9344D33735E5205,38891,0,6,6,109.51486,18.24118,1558
11627,89916,EBD16061EA20EE33D9344D33735E5205,31261,7,11,4,109.51174,18.2466,1559
11628,89917,EBD16061EA20EE33D9344D33735E5205,38291,13,16,3,109.51618,18.24313,1558
11629,89918,EBD16061EA20EE33D9344D33735E5205,31201,18,21,3,109.51042,18.23819,1558
11630,89919,EBD16061EA20EE33D9344D33735E5205,38891,21,23,2,109.51486,18.24118,1558
11634,89964,534C5FC5CDFDB7797BE5619911FA1868,31781,11,13,2,109.19847,18.2975,367
11635,89965,534C5FC5CDFDB7797BE5619911FA1868,31471,14,16,2,109.34583,18.29563,917
11636,89966,534C5FC5CDFDB7797BE5619911FA1868,30721,20,23,3,109.51597,18.28257,1565
11640,89994,7070286B0061F5DABCD5BBE90834E157,30121,0,8,8,109.52861,18.27222,1613
11641,89995,7070286B0061F5DABCD5BBE90834E157,38241,13,15,2,109.54111,18.30542,1669
11642,89996,7070286B0061F5DABCD5BBE90834E157,30791,18,19,1,109.72333,18.40889,2386
11643,89997,5264833F0013AE6B294396000613EF89,60201,0,8,8,109.5041,18.2509,1510
11644,89998,5264833F0013AE6B294396000613EF89,60581,11,13,2,109.59785,18.29931,1868
11645,89999,5264833F0013AE6B294396000613EF89,60201,14,15,1,109.5041,18.2509,1510
11646,90000,5264833F0013AE6B294396000613EF89,60131,18,19,1,109.49819,18.24778,1509
11647,90001,5264833F0013AE6B294396000613EF89,60201,21,23,2,109.5041,18.2509,1510
11651,90018,92F9F53206FAF7EB9CC354C3DBB7190F,60221,16,17,1,109.52569,18.29188,1616
11652,90019,92F9F53206FAF7EB9CC354C3DBB7190F,31271,18,22,4,109.48958,18.26257,1462
11656,90041,2F440A235E684ECEDD042B3100A4AE95,31071,1,7,6,109.58257,18.28458,1815
11657,90042,2F440A235E684ECEDD042B3100A4AE95,30854,7,8,1,109.56889,18.27076,1763
11658,90043,2F440A235E684ECEDD042B3100A4AE95,30101,10,14,4,109.57299,18.33333,1773
11659,90044,2F440A235E684ECEDD042B3100A4AE95,30854,16,18,2,109.56889,18.27076,1763
11660,90045,2F440A235E684ECEDD042B3100A4AE95,31071,19,23,4,109.58257,18.28458,1815
11665,90093,5EBEA276FCB4A19AC5C987F5C7CC8908,38361,1,7,6,109.43667,18.29201,1267
11666,90094,5EBEA276FCB4A19AC5C987F5C7CC8908,60504,8,10,2,109.47917,18.28903,1416
11667,90095,5EBEA276FCB4A19AC5C987F5C7CC8908,38361,10,15,5,109.43667,18.29201,1267
11668,90096,5EBEA276FCB4A19AC5C987F5C7CC8908,60552,18,20,2,109.41729,18.30014,1218
11669,90097,5EBEA276FCB4A19AC5C987F5C7CC8908,60401,22,23,1,109.47444,18.27583,1414
11670,90100,93EAC7B29C41BCCE26391CB550587732,30891,0,3,3,109.59431,18.28389,1865
11671,90101,93EAC7B29C41BCCE26391CB550587732,30854,3,5,2,109.56889,18.27076,1763
11672,90102,93EAC7B29C41BCCE26391CB550587732,31071,7,8,1,109.58257,18.28458,1815
11673,90103,93EAC7B29C41BCCE26391CB550587732,30854,14,18,4,109.56889,18.27076,1763
11674,90104,93EAC7B29C41BCCE26391CB550587732,31071,18,20,2,109.58257,18.28458,1815
11678,90138,DB4DF566D4757FF3BB488F82DE126248,31561,12,17,5,109.56792,18.28479,1765
11679,90139,DB4DF566D4757FF3BB488F82DE126248,30851,17,19,2,109.5616,18.27396,1713
11680,90140,DB4DF566D4757FF3BB488F82DE126248,31561,22,23,1,109.56792,18.28479,1765
11681,90144,FBC323A047041F71D8997C22FDE88F17,39191,1,2,1,109.51493,18.23472,1557
11682,90145,FBC323A047041F71D8997C22FDE88F17,30181,5,11,6,109.51597,18.23313,1557
11683,90146,FBC323A047041F71D8997C22FDE88F17,38341,13,15,2,109.49965,18.21299,1503
11684,90147,FBC323A047041F71D8997C22FDE88F17,38341,16,19,3,109.49965,18.21299,1503
11685,90148,FBC323A047041F71D8997C22FDE88F17,48574,20,22,2,109.48931,18.28458,1465
11686,90151,0312B43ACF9ED1D8304E325E851AEE29,31561,8,10,2,109.56792,18.28479,1765
11687,90152,0312B43ACF9ED1D8304E325E851AEE29,30851,10,13,3,109.5616,18.27396,1713
11688,90153,0312B43ACF9ED1D8304E325E851AEE29,31561,13,17,4,109.56792,18.28479,1765
11689,90154,0312B43ACF9ED1D8304E325E851AEE29,30851,20,21,1,109.5616,18.27396,1713
11693,90202,06DB20C95BA695C08831082FE672B8D5,60641,0,13,13,109.53854,18.2359,1657
11694,90203,06DB20C95BA695C08831082FE672B8D5,31471,16,17,1,109.34583,18.29563,917
11695,90204,06DB20C95BA695C08831082FE672B8D5,60641,21,23,2,109.53854,18.2359,1657
11696,90269,09390A13C8E5C15C1E5674E3DB9139EC,60201,9,10,1,109.5041,18.2509,1510
11697,90270,09390A13C8E5C15C1E5674E3DB9139EC,60501,11,12,1,109.48701,18.29021,1466
11698,90271,09390A13C8E5C15C1E5674E3DB9139EC,60084,14,15,1,109.4984,18.2334,1507
11699,90272,09390A13C8E5C15C1E5674E3DB9139EC,60231,15,16,1,109.49903,18.21972,1504
11700,90273,09390A13C8E5C15C1E5674E3DB9139EC,60161,17,18,1,109.49174,18.26181,1461
11701,90327,B45CD38CC32587777540C23B64B330A4,31701,0,10,10,109.44132,18.28833,1266
11702,90328,B45CD38CC32587777540C23B64B330A4,31781,13,15,2,109.19847,18.2975,367
11703,90329,B45CD38CC32587777540C23B64B330A4,31701,19,23,4,109.44132,18.28833,1266
11704,90377,B7A2800FDF738E1064EAD2A5E58F7A3C,61011,5,14,9,109.60653,18.19076,1900
11705,90409,7D506D14278B6F252BAE69DB8A578C01,38334,17,20,3,109.65035,18.23785,2057
11706,90410,7D506D14278B6F252BAE69DB8A578C01,31071,21,22,1,109.58257,18.28458,1815
11711,90435,CA3896FB33E9BC68E91955EDFF5D709B,31945,18,19,1,109.58021,18.29403,1817
11712,90436,CA3896FB33E9BC68E91955EDFF5D709B,30854,20,21,1,109.56889,18.27076,1763
11716,90453,0878243E331032B9659EF30304C4F81B,30241,12,13,1,109.26174,18.3275,622
11717,90454,0878243E331032B9659EF30304C4F81B,30661,13,15,2,109.37028,18.24361,1008
11718,90455,0878243E331032B9659EF30304C4F81B,30151,18,23,5,109.50986,18.25083,1560
11719,90456,45CCFCD3EBDF941E1C92B70ED06E8B5E,31561,0,4,4,109.56792,18.28479,1765
11720,90457,45CCFCD3EBDF941E1C92B70ED06E8B5E,30854,5,8,3,109.56889,18.27076,1763
11721,90458,45CCFCD3EBDF941E1C92B70ED06E8B5E,31945,8,9,1,109.58021,18.29403,1817
11722,90459,45CCFCD3EBDF941E1C92B70ED06E8B5E,30854,13,17,4,109.56889,18.27076,1763
11723,90460,45CCFCD3EBDF941E1C92B70ED06E8B5E,31561,21,22,1,109.56792,18.28479,1765
11724,90492,6B806948BC9187A91D033B4096721B00,31561,2,6,4,109.56792,18.28479,1765
11725,90493,6B806948BC9187A91D033B4096721B00,31071,9,20,11,109.58257,18.28458,1815
11729,90499,A2F498F18C66416187F7445E3041DB7D,60281,15,17,2,109.51743,18.25924,1561
11730,90500,A2F498F18C66416187F7445E3041DB7D,38154,18,23,5,109.5266,18.28278,1615
11731,90513,D97A48FFEC6EDAD02D62F5D217EED3AD,31271,0,7,7,109.48958,18.26257,1462
11732,90514,D97A48FFEC6EDAD02D62F5D217EED3AD,31471,9,12,3,109.34583,18.29563,917
11733,90515,D97A48FFEC6EDAD02D62F5D217EED3AD,30661,13,15,2,109.37028,18.24361,1008
11734,90516,D97A48FFEC6EDAD02D62F5D217EED3AD,30361,19,20,1,109.50347,18.24,1508
11735,90525,933C30058B1CA246EC59609197D7CAAB,31071,0,9,9,109.58257,18.28458,1815
11736,90526,933C30058B1CA246EC59609197D7CAAB,31931,13,14,1,109.54771,18.29403,1667
11737,90527,933C30058B1CA246EC59609197D7CAAB,31071,15,17,2,109.58257,18.28458,1815
11738,90528,933C30058B1CA246EC59609197D7CAAB,30281,19,20,1,109.50597,18.27583,1514
11739,90529,933C30058B1CA246EC59609197D7CAAB,31931,21,22,1,109.54771,18.29403,1667
11743,90617,8045363099E728AC2850786DE02A569F,30854,14,16,2,109.56889,18.27076,1763
11744,90618,8045363099E728AC2850786DE02A569F,31071,20,23,3,109.58257,18.28458,1815
11748,90647,E292D83051830D054E89D209EEABA4B9,31561,6,8,2,109.56792,18.28479,1765
11749,90648,E292D83051830D054E89D209EEABA4B9,39183,12,14,2,109.55542,18.28208,1715
11750,90649,E292D83051830D054E89D209EEABA4B9,31561,14,16,2,109.56792,18.28479,1765
11751,90650,E292D83051830D054E89D209EEABA4B9,39183,18,20,2,109.55542,18.28208,1715
11752,90652,B3B41C629129E9D549CC4811391929CA,31861,11,12,1,109.49042,18.27549,1464
11753,90678,6AF6E3AFD18EC04099B3351F858D9C1A,30711,13,18,5,109.50271,18.25347,1510
11754,90679,6AF6E3AFD18EC04099B3351F858D9C1A,31031,18,22,4,109.49979,18.25382,1510
11759,90779,BD3F86FBF6DE2F542A29594C2469D37F,30071,0,6,6,109.52819,18.30472,1619
11760,90780,BD3F86FBF6DE2F542A29594C2469D37F,60551,9,10,1,109.42722,18.30111,1218
11761,90781,BD3F86FBF6DE2F542A29594C2469D37F,60491,13,14,1,109.43354,18.30847,1269
11762,90782,BD3F86FBF6DE2F542A29594C2469D37F,31931,19,21,2,109.54771,18.29403,1667
11763,90783,BD3F86FBF6DE2F542A29594C2469D37F,60371,21,23,2,109.53063,18.30056,1618
11764,90793,2B8C748A18FA7D08D4335AD7C9DEF01B,31551,12,13,1,109.55868,18.24222,1708
11765,90794,2B8C748A18FA7D08D4335AD7C9DEF01B,30951,14,15,1,109.56208,18.25667,1761
11766,90795,2B8C748A18FA7D08D4335AD7C9DEF01B,31071,19,21,2,109.58257,18.28458,1815
11767,90796,2B8C748A18FA7D08D4335AD7C9DEF01B,31761,22,23,1,109.60521,18.27965,1914
11768,90800,CA9DF84C64B1C31A61B42BDFD659A4B0,31945,0,5,5,109.58021,18.29403,1817
11769,90801,CA9DF84C64B1C31A61B42BDFD659A4B0,30581,7,14,7,109.62257,18.24951,1959
11770,90802,CA9DF84C64B1C31A61B42BDFD659A4B0,30854,18,20,2,109.56889,18.27076,1763
11771,90803,CA9DF84C64B1C31A61B42BDFD659A4B0,31945,21,23,2,109.58021,18.29403,1817
11772,90844,6587551DA47309E484D1302521C8D417,30851,16,17,1,109.5616,18.27396,1713
11776,90878,3977578BE56276DA0700B04B81DC1356,30851,1,6,5,109.5616,18.27396,1713
11777,90879,3977578BE56276DA0700B04B81DC1356,31561,8,23,15,109.56792,18.28479,1765
11778,90947,66290D92C6D91C5C0C9CFEAA9F85388C,38185,9,11,2,109.51333,18.27347,1563
11779,90948,66290D92C6D91C5C0C9CFEAA9F85388C,30854,14,23,9,109.56889,18.27076,1763
11780,90952,7107EBA4D088604148F017F0D0BAED38,39111,0,5,5,109.5191,18.22597,1555
11781,90953,7107EBA4D088604148F017F0D0BAED38,31521,6,9,3,109.51458,18.22542,1555
11782,90954,7107EBA4D088604148F017F0D0BAED38,60381,9,11,2,109.5241,18.22458,1605
11783,90955,7107EBA4D088604148F017F0D0BAED38,38754,12,15,3,109.74667,18.37382,2430
11784,90956,7107EBA4D088604148F017F0D0BAED38,31521,18,21,3,109.51458,18.22542,1555
11785,90957,7107EBA4D088604148F017F0D0BAED38,60291,21,23,2,109.50826,18.24639,1509
11786,90981,AD608A919061B1C684914F8654FB2493,60231,9,10,1,109.49903,18.21972,1504
11787,90982,AD608A919061B1C684914F8654FB2493,60161,14,19,5,109.49174,18.26181,1461
11788,90983,AD608A919061B1C684914F8654FB2493,60084,19,21,2,109.4984,18.2334,1507
11789,91004,F2DDFA8B80CE24F358EB38920C9A6AA9,31304,1,2,1,109.15903,18.32854,223
11790,91005,F2DDFA8B80CE24F358EB38920C9A6AA9,31121,6,8,2,109.16292,18.37063,230
11791,91006,F2DDFA8B80CE24F358EB38920C9A6AA9,31304,9,11,2,109.15903,18.32854,223
11792,91007,F2DDFA8B80CE24F358EB38920C9A6AA9,31145,13,15,2,109.20431,18.30479,369
11793,91008,F2DDFA8B80CE24F358EB38920C9A6AA9,31345,17,18,1,109.39,18.29,1066
11794,91009,F2DDFA8B80CE24F358EB38920C9A6AA9,30201,19,20,1,109.4909,18.26465,1462
11795,91045,A554960249CDEC56FA40CC752E4537D2,30861,19,21,2,109.52722,18.22743,1606
11796,91055,0E129C09250C0D46273B4BD7E5225556,30421,0,10,10,109.50021,18.25861,1511
11797,91056,0E129C09250C0D46273B4BD7E5225556,60401,12,14,2,109.47444,18.27583,1414
11798,91057,0E129C09250C0D46273B4BD7E5225556,60441,14,15,1,109.46792,18.28604,1366
11799,91058,0E129C09250C0D46273B4BD7E5225556,60281,18,20,2,109.51743,18.25924,1561
11800,91059,0E129C09250C0D46273B4BD7E5225556,30421,21,23,2,109.50021,18.25861,1511
11809,91150,44CB5F545D2E3587ACF209AB2414C1A1,31071,1,17,16,109.58257,18.28458,1815
11810,91151,44CB5F545D2E3587ACF209AB2414C1A1,38127,19,20,1,109.50833,18.27222,1513
11811,91161,5AA4ADF792DAED16A91C4BAE80AADC51,31571,0,7,7,109.61563,18.23326,1957
11812,91162,5AA4ADF792DAED16A91C4BAE80AADC51,38054,10,12,2,109.63479,18.23097,2006
11813,91163,5AA4ADF792DAED16A91C4BAE80AADC51,38165,17,19,2,109.44847,18.28896,1316
11814,91164,5AA4ADF792DAED16A91C4BAE80AADC51,30361,20,22,2,109.50347,18.24,1508
11819,91225,8883DF5E66B5FC284A8EF97DE8EAAAB3,31321,11,15,4,109.63799,18.23201,2007
11820,91226,8883DF5E66B5FC284A8EF97DE8EAAAB3,60214,20,21,1,109.63104,18.24493,2009
11821,91227,8883DF5E66B5FC284A8EF97DE8EAAAB3,31571,21,22,1,109.61563,18.23326,1957
11822,91235,4F3A073B0E00F2C591EAC7CA3550DBAE,31071,20,21,1,109.58257,18.28458,1815
11823,91236,4F3A073B0E00F2C591EAC7CA3550DBAE,30851,21,22,1,109.5616,18.27396,1713
11824,91260,0E5593A90D661690BE3DAAA17AD936E2,38127,0,10,10,109.50833,18.27222,1513
11825,91261,0E5593A90D661690BE3DAAA17AD936E2,38073,12,13,1,109.40813,18.30958,1169
11826,91262,0E5593A90D661690BE3DAAA17AD936E2,38127,15,16,1,109.50833,18.27222,1513
11827,91263,0E5593A90D661690BE3DAAA17AD936E2,30281,18,20,2,109.50597,18.27583,1514
11831,91276,07FD145FE6C81328C98C6C5C8452E794,30854,2,3,1,109.56889,18.27076,1763
11832,91277,07FD145FE6C81328C98C6C5C8452E794,30232,5,10,5,109.6191,18.31701,1971
11833,91278,07FD145FE6C81328C98C6C5C8452E794,30854,11,12,1,109.56889,18.27076,1763
11834,91279,07FD145FE6C81328C98C6C5C8452E794,30232,13,23,10,109.6191,18.31701,1971
11835,91290,2E10AE81CA4EDA6CD33CFF9EBE881FD8,60084,0,7,7,109.4984,18.2334,1507
11836,91291,2E10AE81CA4EDA6CD33CFF9EBE881FD8,30854,10,11,1,109.56889,18.27076,1763
11837,91293,2E10AE81CA4EDA6CD33CFF9EBE881FD8,39151,18,19,1,109.49875,18.25097,1510
11838,91294,2E10AE81CA4EDA6CD33CFF9EBE881FD8,30711,20,22,2,109.50271,18.25347,1510
11839,91358,807F73DE76DFE56E472FA61396F0887C,60291,0,15,15,109.50826,18.24639,1509
11840,91359,807F73DE76DFE56E472FA61396F0887C,60201,15,17,2,109.5041,18.2509,1510
11841,91366,E12BF6F292017B631FE5B39504EB53C3,30121,18,23,5,109.52861,18.27222,1613
11842,91392,DB0EF690DC781F73956987AB22EA398D,38361,0,8,8,109.43667,18.29201,1267
11843,91393,DB0EF690DC781F73956987AB22EA398D,38754,11,13,2,109.74667,18.37382,2430
11844,91394,DB0EF690DC781F73956987AB22EA398D,30161,15,17,2,109.50042,18.24389,1508
11845,91395,DB0EF690DC781F73956987AB22EA398D,30731,20,22,2,109.50944,18.22306,1555
11846,91399,913AFF9774BDE45ED2E6C1B86D772D8F,31061,17,23,6,109.53333,18.23257,1607
11851,91416,0187C68AAA5B8B5AFE4438278EB6AFB0,31931,6,9,3,109.54771,18.29403,1667
11852,91417,0187C68AAA5B8B5AFE4438278EB6AFB0,30851,9,10,1,109.5616,18.27396,1713
11853,91418,0187C68AAA5B8B5AFE4438278EB6AFB0,31561,10,11,1,109.56792,18.28479,1765
11854,91419,0187C68AAA5B8B5AFE4438278EB6AFB0,30851,11,21,10,109.5616,18.27396,1713
11862,91515,D39D64452E6BBEF7B3056CA239E1B86E,30854,0,8,8,109.56889,18.27076,1763
11863,91516,D39D64452E6BBEF7B3056CA239E1B86E,31561,8,10,2,109.56792,18.28479,1765
11864,91517,D39D64452E6BBEF7B3056CA239E1B86E,30854,10,11,1,109.56889,18.27076,1763
11865,91518,D39D64452E6BBEF7B3056CA239E1B86E,31561,14,15,1,109.56792,18.28479,1765
11866,91519,D39D64452E6BBEF7B3056CA239E1B86E,30854,15,23,8,109.56889,18.27076,1763
11867,91564,FC294DFCE86FDA84EAB1A8B689598D0A,38111,16,17,1,109.52007,18.22403,1555
11868,91565,FC294DFCE86FDA84EAB1A8B689598D0A,31061,19,21,2,109.53333,18.23257,1607
11882,91679,CD576F1C1CDFB89E6A99A20E65927346,31071,5,6,1,109.58257,18.28458,1815
11883,91680,CD576F1C1CDFB89E6A99A20E65927346,30854,6,7,1,109.56889,18.27076,1763
11884,91681,CD576F1C1CDFB89E6A99A20E65927346,31561,8,9,1,109.56792,18.28479,1765
11885,91682,CD576F1C1CDFB89E6A99A20E65927346,30854,11,12,1,109.56889,18.27076,1763
11886,91683,CD576F1C1CDFB89E6A99A20E65927346,31561,14,15,1,109.56792,18.28479,1765
11887,91684,CD576F1C1CDFB89E6A99A20E65927346,30854,18,21,3,109.56889,18.27076,1763
11888,91713,0AD99509D112B17EDC0942E5CD8E86E4,30921,11,13,2,109.53903,18.29451,1667
11889,91714,0AD99509D112B17EDC0942E5CD8E86E4,31931,14,17,3,109.54771,18.29403,1667
11890,91715,0AD99509D112B17EDC0942E5CD8E86E4,30071,19,23,4,109.52819,18.30472,1619
11891,91730,B712327B6033C61F37801CFD6DAC08AD,31951,1,3,2,109.52174,18.30299,1568
11892,91731,B712327B6033C61F37801CFD6DAC08AD,38484,6,9,3,109.53028,18.31528,1620
11893,91732,B712327B6033C61F37801CFD6DAC08AD,38484,12,13,1,109.53028,18.31528,1620
11894,91733,B712327B6033C61F37801CFD6DAC08AD,30071,13,14,1,109.52819,18.30472,1619
11895,91734,B712327B6033C61F37801CFD6DAC08AD,38484,15,17,2,109.53028,18.31528,1620
11896,91735,B712327B6033C61F37801CFD6DAC08AD,38484,18,21,3,109.53028,18.31528,1620
11901,91753,63FBAC0202144B00077561285E6A7F87,30651,2,3,1,109.42611,18.385,1232
11902,91754,63FBAC0202144B00077561285E6A7F87,30821,4,23,19,109.43681,18.33639,1274
11906,91835,89362A3CA3AE6F5B75871F2110924F99,30951,14,17,3,109.56208,18.25667,1761
11907,91836,89362A3CA3AE6F5B75871F2110924F99,30851,19,21,2,109.5616,18.27396,1713
11908,91864,7D632B68A96EBB9D6582527232D6634C,31461,1,8,7,109.5091,18.25389,1510
11909,91865,7D632B68A96EBB9D6582527232D6634C,31291,9,12,3,109.30375,18.40729,786
11910,91866,7D632B68A96EBB9D6582527232D6634C,31231,14,19,5,109.42597,18.29292,1217
11921,91968,066E3B290AAC556F650E56DD0F693AB2,38251,0,7,7,109.49618,18.25493,1510
11922,91969,066E3B290AAC556F650E56DD0F693AB2,33481,9,13,4,109.67278,18.41278,2187
11923,91970,066E3B290AAC556F650E56DD0F693AB2,38251,16,19,3,109.49618,18.25493,1510
11924,91971,066E3B290AAC556F650E56DD0F693AB2,31181,19,23,4,109.50382,18.24813,1509
11925,91995,B47BACC30D9A35D35F1E9FB0E5DF7D48,30854,4,7,3,109.56889,18.27076,1763
11926,91996,B47BACC30D9A35D35F1E9FB0E5DF7D48,31071,7,8,1,109.58257,18.28458,1815
11927,91997,B47BACC30D9A35D35F1E9FB0E5DF7D48,30854,9,14,5,109.56889,18.27076,1763
11928,91998,B47BACC30D9A35D35F1E9FB0E5DF7D48,31071,16,19,3,109.58257,18.28458,1815
11929,91999,B47BACC30D9A35D35F1E9FB0E5DF7D48,30854,20,23,3,109.56889,18.27076,1763
11934,92157,A928E9F6C796FE1A60807BA003DE87BB,30854,0,12,12,109.56889,18.27076,1763
11935,92158,A928E9F6C796FE1A60807BA003DE87BB,30361,14,16,2,109.50347,18.24,1508
11936,92159,A928E9F6C796FE1A60807BA003DE87BB,30854,20,23,3,109.56889,18.27076,1763
11937,92200,568827877C6CA7A0BC5DC0EF910BF7F5,31236,0,8,8,109.42965,18.29111,1216
11938,92201,568827877C6CA7A0BC5DC0EF910BF7F5,31031,13,14,1,109.49979,18.25382,1510
11939,92202,568827877C6CA7A0BC5DC0EF910BF7F5,31231,18,19,1,109.42597,18.29292,1217
11940,92203,568827877C6CA7A0BC5DC0EF910BF7F5,30671,20,21,1,109.43611,18.30139,1268
11941,92204,568827877C6CA7A0BC5DC0EF910BF7F5,31231,21,23,2,109.42597,18.29292,1217
11945,92209,3F320FCC97654DBDACE66BB1BF09E301,38754,9,10,1,109.74667,18.37382,2430
11946,92210,3F320FCC97654DBDACE66BB1BF09E301,38484,12,13,1,109.53028,18.31528,1620
11947,92241,A549C024E6F63EDBD3DC866F10DB11CE,31071,12,14,2,109.58257,18.28458,1815
11948,92242,A549C024E6F63EDBD3DC866F10DB11CE,30854,17,19,2,109.56889,18.27076,1763
11952,92257,9770385BF52AD3BEBCA7962FCA51DE84,60221,17,19,2,109.52569,18.29188,1616
11953,92258,9770385BF52AD3BEBCA7962FCA51DE84,60381,20,21,1,109.5241,18.22458,1605
11957,92304,E4B522EF4348156010E5C578EC13D60F,30854,3,13,10,109.56889,18.27076,1763
11958,92305,E4B522EF4348156010E5C578EC13D60F,31071,15,16,1,109.58257,18.28458,1815
11959,92306,8ED1BCC2D2A319298B3669D3F81BDCBA,31181,19,21,2,109.50382,18.24813,1509
11960,92307,8ED1BCC2D2A319298B3669D3F81BDCBA,30391,22,23,1,109.4975,18.27118,1513
11961,92308,990E16E6526CF60DC36C2ECCED74BC82,31031,1,9,8,109.49979,18.25382,1510
11962,92310,990E16E6526CF60DC36C2ECCED74BC82,31561,19,20,1,109.56792,18.28479,1765
11963,92320,9AF351B3CC27394DFED45513F0E32162,60351,0,6,6,109.58403,18.28958,1816
11964,92321,9AF351B3CC27394DFED45513F0E32162,30851,7,9,2,109.5616,18.27396,1713
11965,92322,9AF351B3CC27394DFED45513F0E32162,30951,13,17,4,109.56208,18.25667,1761
11966,92323,9AF351B3CC27394DFED45513F0E32162,31071,18,20,2,109.58257,18.28458,1815
11967,92324,9AF351B3CC27394DFED45513F0E32162,60351,21,22,1,109.58403,18.28958,1816
11971,92373,1EBF477B1EE6E13F6E111854406233C6,31101,15,16,1,109.65389,18.23403,2057
11972,92374,1EBF477B1EE6E13F6E111854406233C6,60131,17,19,2,109.49819,18.24778,1509
11973,92375,1EBF477B1EE6E13F6E111854406233C6,38251,20,22,2,109.49618,18.25493,1510
11977,92434,3E01B14B28C0FDBF8BB343D61C8AA7D8,60331,13,16,3,109.505,18.26507,1512
11978,92435,3E01B14B28C0FDBF8BB343D61C8AA7D8,60361,17,18,1,109.51938,18.29681,1567
11979,92436,3E01B14B28C0FDBF8BB343D61C8AA7D8,60241,19,20,1,109.53319,18.28667,1616
11980,92459,CB18F4578E52530026F2A384EBEE805A,30854,13,16,3,109.56889,18.27076,1763
11981,92460,CB18F4578E52530026F2A384EBEE805A,31161,20,23,3,109.70229,18.31361,2270
11982,92464,9A369E1280A8BB5227D2B6A5698033ED,31521,0,11,11,109.51458,18.22542,1555
11986,92481,BC698E1FFA446375C97B9B7301DE31FA,60221,16,19,3,109.52569,18.29188,1616
11987,92482,BC698E1FFA446375C97B9B7301DE31FA,30854,20,23,3,109.56889,18.27076,1763
11988,92498,487FC583F0AF1414583ADA3127598053,60631,1,7,6,109.57778,18.27583,1814
11989,92499,487FC583F0AF1414583ADA3127598053,31071,9,10,1,109.58257,18.28458,1815
11990,92500,487FC583F0AF1414583ADA3127598053,31321,14,16,2,109.63799,18.23201,2007
11991,92501,487FC583F0AF1414583ADA3127598053,31071,20,21,1,109.58257,18.28458,1815
11992,92552,065F1687C35F3C827A2EA4A378A0E2C6,30851,6,8,2,109.5616,18.27396,1713
11993,92553,065F1687C35F3C827A2EA4A378A0E2C6,30951,8,10,2,109.56208,18.25667,1761
11994,92554,065F1687C35F3C827A2EA4A378A0E2C6,30851,11,21,10,109.5616,18.27396,1713
11995,92575,3C09A11C854CBC0803237DC7A23AB0BC,31164,0,5,5,109.69993,18.27215,2263
11996,92576,3C09A11C854CBC0803237DC7A23AB0BC,31851,6,9,3,109.71736,18.29007,2316
11997,92577,3C09A11C854CBC0803237DC7A23AB0BC,38754,12,14,2,109.74667,18.37382,2430
11998,92584,13166628932DF36C0AD7B1DB5811240A,30854,15,16,1,109.56889,18.27076,1763
11999,92585,13166628932DF36C0AD7B1DB5811240A,60591,19,23,4,109.61118,18.21715,1904
12000,92601,2DA5948E96121EADE6CCFA0D33794EFE,38251,2,10,8,109.49618,18.25493,1510
12001,92602,2DA5948E96121EADE6CCFA0D33794EFE,31471,13,15,2,109.34583,18.29563,917
12002,92603,2DA5948E96121EADE6CCFA0D33794EFE,31531,18,19,1,109.49583,18.25972,1461
12003,92604,2DA5948E96121EADE6CCFA0D33794EFE,31031,19,23,4,109.49979,18.25382,1510
12007,92621,6DF7485545B790F22810B0EDD8F1B356,31945,0,7,7,109.58021,18.29403,1817
12008,92622,6DF7485545B790F22810B0EDD8F1B356,30854,10,11,1,109.56889,18.27076,1763
12009,92623,6DF7485545B790F22810B0EDD8F1B356,31945,12,13,1,109.58021,18.29403,1817
12010,92624,6DF7485545B790F22810B0EDD8F1B356,30854,14,16,2,109.56889,18.27076,1763
12011,92625,6DF7485545B790F22810B0EDD8F1B356,31945,18,23,5,109.58021,18.29403,1817
12012,92660,15A2A8790389D1537721C21B141A7A31,31071,9,14,5,109.58257,18.28458,1815
12013,92661,15A2A8790389D1537721C21B141A7A31,61011,15,21,6,109.60653,18.19076,1900
12014,92663,33608FFC68C65F89820708A4BDA9517A,60631,0,6,6,109.57778,18.27583,1814
12015,92664,33608FFC68C65F89820708A4BDA9517A,31091,8,9,1,109.41201,18.31222,1170
12016,92665,33608FFC68C65F89820708A4BDA9517A,30854,10,11,1,109.56889,18.27076,1763
12017,92672,6D02659C8AB6FF777A098A468ACF74DA,31021,15,16,1,109.49021,18.27,1463
12018,92673,6D02659C8AB6FF777A098A468ACF74DA,30461,19,20,1,109.5116,18.26313,1562
12019,92704,77F5A37783010C53E376197FE3F1043D,30071,6,14,8,109.52819,18.30472,1619
12020,92738,0F558B6653C655C7F0BAEA9D66B33F57,31071,0,7,7,109.58257,18.28458,1815
12021,92739,0F558B6653C655C7F0BAEA9D66B33F57,30854,12,21,9,109.56889,18.27076,1763
12033,92804,8394F4F81295DA567F75BB12D1616CF3,60361,0,6,6,109.51938,18.29681,1567
12034,92805,8394F4F81295DA567F75BB12D1616CF3,39111,8,11,3,109.5191,18.22597,1555
12035,92806,8394F4F81295DA567F75BB12D1616CF3,38911,11,13,2,109.51674,18.24965,1559
12036,92807,8394F4F81295DA567F75BB12D1616CF3,31521,13,16,3,109.51458,18.22542,1555
12037,92808,8394F4F81295DA567F75BB12D1616CF3,31521,19,21,2,109.51458,18.22542,1555
12038,92809,8394F4F81295DA567F75BB12D1616CF3,60361,22,23,1,109.51938,18.29681,1567
12039,92855,28F7DFD4A036DBA4E68AFC71762D44D7,30851,0,5,5,109.5616,18.27396,1713
12040,92856,28F7DFD4A036DBA4E68AFC71762D44D7,30951,8,9,1,109.56208,18.25667,1761
12041,92857,28F7DFD4A036DBA4E68AFC71762D44D7,31421,9,10,1,109.55382,18.22347,1705
12042,92858,28F7DFD4A036DBA4E68AFC71762D44D7,30951,11,12,1,109.56208,18.25667,1761
12043,92859,28F7DFD4A036DBA4E68AFC71762D44D7,31421,13,15,2,109.55382,18.22347,1705
12047,92897,84633D8BA654ABD696C26ED03FF61CB6,30084,0,8,8,109.50118,18.26972,1513
12048,92898,84633D8BA654ABD696C26ED03FF61CB6,30771,8,13,5,109.49938,18.26042,1511
12049,92899,84633D8BA654ABD696C26ED03FF61CB6,60111,14,15,1,109.72556,18.31924,2371
12050,92900,84633D8BA654ABD696C26ED03FF61CB6,30151,18,19,1,109.50986,18.25083,1560
12051,92901,84633D8BA654ABD696C26ED03FF61CB6,60381,19,21,2,109.5241,18.22458,1605
12052,92902,D537779863674D03BD86E245F9738004,38941,0,8,8,109.49625,18.25451,1510
12053,92903,D537779863674D03BD86E245F9738004,30661,10,16,6,109.37028,18.24361,1008
12054,92904,D537779863674D03BD86E245F9738004,38251,18,23,5,109.49618,18.25493,1510
12055,92965,BD4652414D5C17466BA36FD4BD943A94,60221,2,3,1,109.52569,18.29188,1616
12056,92966,BD4652414D5C17466BA36FD4BD943A94,30721,5,7,2,109.51597,18.28257,1565
12057,92967,BD4652414D5C17466BA36FD4BD943A94,39183,9,11,2,109.55542,18.28208,1715
12058,92968,BD4652414D5C17466BA36FD4BD943A94,39181,15,17,2,109.55153,18.28035,1715
12059,92969,BD4652414D5C17466BA36FD4BD943A94,30421,18,20,2,109.50021,18.25861,1511
12060,93037,FA1E5CA356F8B43CC7D8561CCE648EA2,31164,0,13,13,109.69993,18.27215,2263
12061,93044,C64E9A6979E0B94B1A1E04B18E8DF9D7,30441,14,15,1,109.64021,18.25424,2010
12062,93045,C64E9A6979E0B94B1A1E04B18E8DF9D7,31061,20,23,3,109.53333,18.23257,1607
12067,93086,4EC6B926136B0B67456F56C4DC11DD27,38325,17,19,2,109.39792,18.2909,1116
12068,93087,4EC6B926136B0B67456F56C4DC11DD27,30351,19,21,2,109.41701,18.29292,1217
12069,93096,9BD0746EAD915C7FE62E448DC71186FA,30854,9,10,1,109.56889,18.27076,1763
12070,93097,9BD0746EAD915C7FE62E448DC71186FA,30111,11,12,1,109.47583,18.30542,1419
12071,93098,9BD0746EAD915C7FE62E448DC71186FA,31071,15,16,1,109.58257,18.28458,1815
12072,93099,9BD0746EAD915C7FE62E448DC71186FA,30854,19,23,4,109.56889,18.27076,1763
12073,93110,C85D0B931BEF54F05B9ABBBB03212DB7,30854,0,9,9,109.56889,18.27076,1763
12074,93111,C85D0B931BEF54F05B9ABBBB03212DB7,31561,9,12,3,109.56792,18.28479,1765
12075,93112,C85D0B931BEF54F05B9ABBBB03212DB7,30854,12,13,1,109.56889,18.27076,1763
12076,93113,C85D0B931BEF54F05B9ABBBB03212DB7,31561,14,15,1,109.56792,18.28479,1765
12077,93114,C85D0B931BEF54F05B9ABBBB03212DB7,30854,17,21,4,109.56889,18.27076,1763
12078,93133,0E1DB444F47235AEDAD0A0404A7B75B4,31561,1,17,16,109.56792,18.28479,1765
12079,93134,0E1DB444F47235AEDAD0A0404A7B75B4,39183,19,20,1,109.55542,18.28208,1715
12080,93143,CBC603DF99C1D6981715077F3EA24CB6,31071,5,6,1,109.58257,18.28458,1815
12081,93144,CBC603DF99C1D6981715077F3EA24CB6,30854,9,22,13,109.56889,18.27076,1763
12082,93145,B37777551ADDE84A1FDFE1FF465C24DC,30921,0,1,1,109.53903,18.29451,1667
12083,93146,B37777551ADDE84A1FDFE1FF465C24DC,31931,2,16,14,109.54771,18.29403,1667
12084,93214,5053F169E26BA3D25B0C6902CA24AB79,31236,0,6,6,109.42965,18.29111,1216
12085,93215,5053F169E26BA3D25B0C6902CA24AB79,31145,8,10,2,109.20431,18.30479,369
12086,93216,5053F169E26BA3D25B0C6902CA24AB79,60054,13,14,1,109.3016,18.31229,770
12087,93217,5053F169E26BA3D25B0C6902CA24AB79,31431,18,19,1,109.44639,18.29042,1316
12088,93218,5053F169E26BA3D25B0C6902CA24AB79,31231,20,23,3,109.42597,18.29292,1217
12089,93232,EBF906C5498076BCFA3E97DF6001B4F3,31206,0,1,1,109.50819,18.23549,1507
12090,93233,EBF906C5498076BCFA3E97DF6001B4F3,60631,2,8,6,109.57778,18.27583,1814
12091,93234,EBF906C5498076BCFA3E97DF6001B4F3,30854,8,11,3,109.56889,18.27076,1763
12092,93235,EBF906C5498076BCFA3E97DF6001B4F3,60631,14,15,1,109.57778,18.27583,1814
12093,93236,EBF906C5498076BCFA3E97DF6001B4F3,31561,16,17,1,109.56792,18.28479,1765
12094,93239,856FED43C24F39C7284040D716161D86,60501,0,8,8,109.48701,18.29021,1466
12095,93240,856FED43C24F39C7284040D716161D86,31081,8,19,11,109.44639,18.30181,1318
12099,93281,928DF0385E8541CFD2F5858501C04155,30234,1,6,5,109.60681,18.29979,1918
12100,93282,928DF0385E8541CFD2F5858501C04155,30854,9,22,13,109.56889,18.27076,1763
12101,93283,E50C3F5EAF024523809A782B7E9AE8AE,60524,0,8,8,109.42951,18.28993,1216
12102,93284,E50C3F5EAF024523809A782B7E9AE8AE,60131,9,11,2,109.49819,18.24778,1509
12103,93285,E50C3F5EAF024523809A782B7E9AE8AE,30211,12,14,2,109.49882,18.23931,1508
12104,93304,4847B7EE1BA09BE4FECC9A6B93CA773D,60054,13,15,2,109.3016,18.31229,770
12105,93305,4847B7EE1BA09BE4FECC9A6B93CA773D,60491,19,23,4,109.43354,18.30847,1269
12106,93315,75817DB682187A07461734D66E1E6492,60631,0,4,4,109.57778,18.27583,1814
12107,93316,75817DB682187A07461734D66E1E6492,30854,6,12,6,109.56889,18.27076,1763
12108,93317,75817DB682187A07461734D66E1E6492,30851,17,18,1,109.5616,18.27396,1713
12109,93318,75817DB682187A07461734D66E1E6492,31061,19,20,1,109.53333,18.23257,1607
12110,93319,75817DB682187A07461734D66E1E6492,60631,22,23,1,109.57778,18.27583,1814
12114,93346,E16204D131FCD957D5ADB9592C1DD0ED,31761,0,8,8,109.60521,18.27965,1914
12115,93347,E16204D131FCD957D5ADB9592C1DD0ED,31071,11,23,12,109.58257,18.28458,1815
12116,93415,ECCCA5770AD6AA7162B63EC395B55856,30854,16,19,3,109.56889,18.27076,1763
12117,93416,ECCCA5770AD6AA7162B63EC395B55856,60631,20,23,3,109.57778,18.27583,1814
12118,93420,34F3D64B41C252481F72E5CF931AC833,30854,2,10,8,109.56889,18.27076,1763
12119,93421,34F3D64B41C252481F72E5CF931AC833,31071,11,22,11,109.58257,18.28458,1815
12120,93474,95E09A72760B2799C2CC9BD7AF527107,31271,10,11,1,109.48958,18.26257,1462
12121,93475,95E09A72760B2799C2CC9BD7AF527107,30854,12,23,11,109.56889,18.27076,1763
12122,93499,4DA47CA7E0DF1887A4FCFA8DEF75F8FC,31761,0,7,7,109.60521,18.27965,1914
12123,93500,4DA47CA7E0DF1887A4FCFA8DEF75F8FC,31421,8,10,2,109.55382,18.22347,1705
12124,93501,4DA47CA7E0DF1887A4FCFA8DEF75F8FC,31551,12,13,1,109.55868,18.24222,1708
12125,93502,4DA47CA7E0DF1887A4FCFA8DEF75F8FC,30951,14,15,1,109.56208,18.25667,1761
12126,93503,4DA47CA7E0DF1887A4FCFA8DEF75F8FC,31421,15,17,2,109.55382,18.22347,1705
12127,93504,4DA47CA7E0DF1887A4FCFA8DEF75F8FC,31761,18,23,5,109.60521,18.27965,1914
12128,93513,A952750F25C558E5C17B3EB7DD935431,60371,0,12,12,109.53063,18.30056,1618
12129,93514,A952750F25C558E5C17B3EB7DD935431,31931,16,18,2,109.54771,18.29403,1667
12133,93525,5E97A4561E11AAC4FBC53FD068EAA52B,30854,0,1,1,109.56889,18.27076,1763
12134,93526,5E97A4561E11AAC4FBC53FD068EAA52B,60631,1,6,5,109.57778,18.27583,1814
12135,93527,5E97A4561E11AAC4FBC53FD068EAA52B,30854,6,8,2,109.56889,18.27076,1763
12136,93528,5E97A4561E11AAC4FBC53FD068EAA52B,30531,8,18,10,109.53271,18.21472,1604
12137,93529,5E97A4561E11AAC4FBC53FD068EAA52B,30854,19,21,2,109.56889,18.27076,1763
12138,93536,D4C207A48CDA21DC9FBF47210897D49C,31261,20,23,3,109.51174,18.2466,1559
12139,93537,15C6F0FDB0D12A4BF39783021C367350,38281,0,2,2,109.6525,18.23403,2057
12140,93538,15C6F0FDB0D12A4BF39783021C367350,31321,2,7,5,109.63799,18.23201,2007
12141,93539,15C6F0FDB0D12A4BF39783021C367350,31101,8,11,3,109.65389,18.23403,2057
12142,93540,15C6F0FDB0D12A4BF39783021C367350,38281,15,17,2,109.6525,18.23403,2057
12143,93541,15C6F0FDB0D12A4BF39783021C367350,30581,18,20,2,109.62257,18.24951,1959
12144,93542,15C6F0FDB0D12A4BF39783021C367350,31101,20,22,2,109.65389,18.23403,2057
12145,93568,E6541B4F346982101D887BAAF0315541,30854,0,1,1,109.56889,18.27076,1763
12146,93569,E6541B4F346982101D887BAAF0315541,31931,1,2,1,109.54771,18.29403,1667
12147,93570,E6541B4F346982101D887BAAF0315541,30854,4,5,1,109.56889,18.27076,1763
12148,93571,E6541B4F346982101D887BAAF0315541,30232,5,7,2,109.6191,18.31701,1971
12149,93572,E6541B4F346982101D887BAAF0315541,30854,12,14,2,109.56889,18.27076,1763
12150,93573,E6541B4F346982101D887BAAF0315541,31561,15,17,2,109.56792,18.28479,1765
12151,93574,E6541B4F346982101D887BAAF0315541,30854,18,19,1,109.56889,18.27076,1763
12152,93579,D74E82C8588C75233DBA0141E4C07F1A,31251,0,10,10,109.18528,18.2975,317
12153,93581,D74E82C8588C75233DBA0141E4C07F1A,31251,17,23,6,109.18528,18.2975,317
12154,93593,37B1280251A3C52411E939549A58D078,38991,11,12,1,109.52681,18.30368,1618
12155,93594,37B1280251A3C52411E939549A58D078,39183,12,23,11,109.55542,18.28208,1715
12156,93609,8C84F1CB6E49AC2736E89C4CFE87B2BD,38094,16,17,1,109.45403,18.28778,1316
12157,93610,8C84F1CB6E49AC2736E89C4CFE87B2BD,31391,19,23,4,109.50382,18.24285,1508
12158,93630,7252A0F90E29EC78621699C082578EF7,31361,0,7,7,109.47417,18.28292,1415
12159,93631,7252A0F90E29EC78621699C082578EF7,60111,12,13,1,109.72556,18.31924,2371
12160,93632,7252A0F90E29EC78621699C082578EF7,60504,17,18,1,109.47917,18.28903,1416
12161,93633,7252A0F90E29EC78621699C082578EF7,31361,21,23,2,109.47417,18.28292,1415
12169,93769,5426296000364EE32711CD0E73D782C8,30854,18,19,1,109.56889,18.27076,1763
12170,93770,5426296000364EE32711CD0E73D782C8,31071,19,20,1,109.58257,18.28458,1815
12171,93779,07015E22078E542DFD52967694C61F1D,30581,9,10,1,109.62257,18.24951,1959
12172,93780,07015E22078E542DFD52967694C61F1D,31781,13,14,1,109.19847,18.2975,367
12173,93781,07015E22078E542DFD52967694C61F1D,60054,16,17,1,109.3016,18.31229,770
12174,93782,07015E22078E542DFD52967694C61F1D,60201,20,23,3,109.5041,18.2509,1510
12175,93812,91EC74D2B208A10BECBB101C6735C578,38251,19,20,1,109.49618,18.25493,1510
12176,93813,91EC74D2B208A10BECBB101C6735C578,31864,20,23,3,109.49014,18.28333,1465
12177,93816,87C7A513DDAF08C0EAFDEC3998FDF6C5,30991,0,9,9,109.30847,18.44139,791
12178,93817,87C7A513DDAF08C0EAFDEC3998FDF6C5,38754,13,15,2,109.74667,18.37382,2430
12179,93818,87C7A513DDAF08C0EAFDEC3998FDF6C5,30991,18,23,5,109.30847,18.44139,791
12180,93822,4995463B780282C9C030A19D9F49AEAC,31071,0,9,9,109.58257,18.28458,1815
12181,93823,4995463B780282C9C030A19D9F49AEAC,30854,14,18,4,109.56889,18.27076,1763
12182,93851,4E94ADAE7ABEB20EEFAF67519DFCC1BE,31081,0,8,8,109.44639,18.30181,1318
12183,93852,4E94ADAE7ABEB20EEFAF67519DFCC1BE,31031,9,21,12,109.49979,18.25382,1510
12188,93931,6F0540B756080DEA0630ADD22B34EFCA,30371,0,7,7,109.51,18.24771,1559
12189,93932,6F0540B756080DEA0630ADD22B34EFCA,38801,8,17,9,109.51472,18.2584,1561
12190,93933,6F0540B756080DEA0630ADD22B34EFCA,30421,18,19,1,109.50021,18.25861,1511
12191,93934,6F0540B756080DEA0630ADD22B34EFCA,60201,19,21,2,109.5041,18.2509,1510
12192,93935,6F0540B756080DEA0630ADD22B34EFCA,30371,21,23,2,109.51,18.24771,1559
12193,93943,996C0D9500BF90CC0E7F5A04C49A464B,39183,0,7,7,109.55542,18.28208,1715
12194,93944,996C0D9500BF90CC0E7F5A04C49A464B,31931,9,23,14,109.54771,18.29403,1667
12195,93951,8C8DB7A18864109B823771C405E00B29,60351,0,6,6,109.58403,18.28958,1816
12196,93952,8C8DB7A18864109B823771C405E00B29,30951,8,10,2,109.56208,18.25667,1761
12197,93953,8C8DB7A18864109B823771C405E00B29,31421,12,14,2,109.55382,18.22347,1705
12198,93954,8C8DB7A18864109B823771C405E00B29,30951,14,18,4,109.56208,18.25667,1761
12199,93958,B340EDEF4A878E8DF5CBEC25E465EACE,31205,0,2,2,109.51111,18.23736,1557
12200,93959,B340EDEF4A878E8DF5CBEC25E465EACE,30854,4,12,8,109.56889,18.27076,1763
12201,93960,B340EDEF4A878E8DF5CBEC25E465EACE,31071,12,14,2,109.58257,18.28458,1815
12202,93961,B340EDEF4A878E8DF5CBEC25E465EACE,30854,14,18,4,109.56889,18.27076,1763
12207,94036,C860767955774E3494068CF38C009FB6,30711,14,16,2,109.50271,18.25347,1510
12208,94037,C860767955774E3494068CF38C009FB6,60391,20,23,3,109.47667,18.28757,1416
12209,94038,81877C19279066FF0F7BD49ABDF1498F,31571,0,8,8,109.61563,18.23326,1957
12210,94039,81877C19279066FF0F7BD49ABDF1498F,38271,9,10,1,109.62632,18.23049,1956
12211,94040,81877C19279066FF0F7BD49ABDF1498F,31571,11,12,1,109.61563,18.23326,1957
12212,94041,81877C19279066FF0F7BD49ABDF1498F,38271,12,18,6,109.62632,18.23049,1956
12213,94042,81877C19279066FF0F7BD49ABDF1498F,31571,18,19,1,109.61563,18.23326,1957
12214,94043,81877C19279066FF0F7BD49ABDF1498F,38271,19,21,2,109.62632,18.23049,1956
12215,94064,7334BFE245C0E1675EC3C07645407CF3,30661,0,2,2,109.37028,18.24361,1008
12216,94065,7334BFE245C0E1675EC3C07645407CF3,60411,4,6,2,109.32514,18.30854,869
12217,94066,7334BFE245C0E1675EC3C07645407CF3,30661,7,15,8,109.37028,18.24361,1008
12218,94067,7334BFE245C0E1675EC3C07645407CF3,60411,19,21,2,109.32514,18.30854,869
12219,94083,662D882A6A10D0E6C3566690F0A40636,31071,18,19,1,109.58257,18.28458,1815
12220,94084,662D882A6A10D0E6C3566690F0A40636,30854,21,22,1,109.56889,18.27076,1763
12221,94092,35C6EDC8AAC6B5ABA770190223528BA2,31061,0,7,7,109.53333,18.23257,1607
12222,94093,35C6EDC8AAC6B5ABA770190223528BA2,60211,12,13,1,109.63549,18.26049,2011
12223,94094,A9A791307A5B7D4473ED005FB1373B0C,38111,16,17,1,109.52007,18.22403,1555
12224,94095,A9A791307A5B7D4473ED005FB1373B0C,60081,19,20,1,109.51097,18.22639,1556
12225,94096,4FBCB285D931FD2B95794D1337FFA573,31351,20,21,1,109.4959,18.28417,1465
12226,94097,4FBCB285D931FD2B95794D1337FFA573,48574,22,23,1,109.48931,18.28458,1465
12227,94103,096D8D59612F82CD076740A6D0A18387,31181,0,6,6,109.50382,18.24813,1509
12228,94104,096D8D59612F82CD076740A6D0A18387,31781,9,11,2,109.19847,18.2975,367
12229,94105,096D8D59612F82CD076740A6D0A18387,60201,12,13,1,109.5041,18.2509,1510
12230,94106,096D8D59612F82CD076740A6D0A18387,60221,19,20,1,109.52569,18.29188,1616
12231,94107,096D8D59612F82CD076740A6D0A18387,60201,21,23,2,109.5041,18.2509,1510
12232,94112,D9791177063A443C55FA7ED4CB011C40,31071,0,3,3,109.58257,18.28458,1815
12233,94113,D9791177063A443C55FA7ED4CB011C40,30891,4,5,1,109.59431,18.28389,1865
12234,94144,E2CFBC4AD8BA700D32898ABFA9A0C849,30191,0,1,1,109.50361,18.22701,1506
12235,94145,E2CFBC4AD8BA700D32898ABFA9A0C849,30854,2,20,18,109.56889,18.27076,1763
12236,94151,B43DB539B5964E15F0064080164C40C1,60631,0,8,8,109.57778,18.27583,1814
12237,94152,B43DB539B5964E15F0064080164C40C1,38052,10,15,5,109.62618,18.23042,1956
12238,94153,B43DB539B5964E15F0064080164C40C1,60631,19,20,1,109.57778,18.27583,1814
12239,94154,B43DB539B5964E15F0064080164C40C1,30854,21,22,1,109.56889,18.27076,1763
12240,94168,1C9FB52F3215AC60A67CACDC4AFA4355,60411,0,8,8,109.32514,18.30854,869
12241,94169,1C9FB52F3215AC60A67CACDC4AFA4355,30901,8,20,12,109.27597,18.3134,670
12242,94177,C7DDA9E77F8C62BD8452CDC497E27C81,39091,14,16,2,109.50097,18.25222,1510
12243,94178,C7DDA9E77F8C62BD8452CDC497E27C81,30511,16,23,7,109.51069,18.24208,1558
12244,94180,AE9453D604AF88F4293DEF99463B2345,31021,8,9,1,109.49021,18.27,1463
12245,94181,AE9453D604AF88F4293DEF99463B2345,30809,11,14,3,109.4891,18.28229,1465
12246,94182,AE9453D604AF88F4293DEF99463B2345,30721,16,17,1,109.51597,18.28257,1565
12251,94236,0E0D6E55BB1995EBF85F6B7AA8765E55,60631,16,17,1,109.57778,18.27583,1814
12252,94237,0E0D6E55BB1995EBF85F6B7AA8765E55,30854,21,22,1,109.56889,18.27076,1763
12253,94264,C89001997385112DD8652171E248C7E4,31471,14,16,2,109.34583,18.29563,917
12254,94265,C89001997385112DD8652171E248C7E4,30354,17,18,1,109.42813,18.29076,1216
12255,94282,9BF5426DFC0160A2D3B0FE19AE17D04F,30611,0,18,18,109.74958,18.40188,2485
12256,94283,9BF5426DFC0160A2D3B0FE19AE17D04F,30101,22,23,1,109.57299,18.33333,1773
12257,94287,C1F9914EF577AE2A8300B1A3945A50FF,30851,4,20,16,109.5616,18.27396,1713
12258,94288,C1F9914EF577AE2A8300B1A3945A50FF,31561,21,22,1,109.56792,18.28479,1765
12259,94293,13D237E410EAFBC4C2D6799D5A976ACC,31303,0,7,7,109.15826,18.29549,217
12260,94294,13D237E410EAFBC4C2D6799D5A976ACC,31091,8,10,2,109.41201,18.31222,1170
12261,94295,13D237E410EAFBC4C2D6799D5A976ACC,31101,13,14,1,109.65389,18.23403,2057
12262,94364,DC0EB400EA24BEE9EB39D315B0E6AEF0,31701,0,7,7,109.44132,18.28833,1266
12263,94365,DC0EB400EA24BEE9EB39D315B0E6AEF0,31431,8,9,1,109.44639,18.29042,1316
12264,94366,DC0EB400EA24BEE9EB39D315B0E6AEF0,60381,10,11,1,109.5241,18.22458,1605
12269,94383,9FEA4B85EAE4FAEE1CAF0EABFF2FAEA1,31561,6,7,1,109.56792,18.28479,1765
12270,94384,9FEA4B85EAE4FAEE1CAF0EABFF2FAEA1,39183,9,11,2,109.55542,18.28208,1715
12271,94385,9FEA4B85EAE4FAEE1CAF0EABFF2FAEA1,31561,16,23,7,109.56792,18.28479,1765
12272,94430,D076CF507E3E56063777BA96227D5E4D,60101,0,8,8,109.75465,18.40139,2485
12273,94465,94C4D5691F7DFC1AB38806AFFAC1389E,31931,0,9,9,109.54771,18.29403,1667
12274,94466,94C4D5691F7DFC1AB38806AFFAC1389E,39101,12,18,6,109.50132,18.24931,1509
12275,94467,94C4D5691F7DFC1AB38806AFFAC1389E,30921,22,23,1,109.53903,18.29451,1667
12279,94524,3B61FEBF5683B498FDAA439DDB94BF3B,60381,19,20,1,109.5241,18.22458,1605
12280,94525,3B61FEBF5683B498FDAA439DDB94BF3B,30731,21,23,2,109.50944,18.22306,1555
12281,94530,A68637AA89BD62624E677D9E66C32FAD,30161,0,12,12,109.50042,18.24389,1508
12282,94531,A68637AA89BD62624E677D9E66C32FAD,31391,12,16,4,109.50382,18.24285,1508
12283,94534,E4199729A84482014747EE1ECF3FF7D9,30701,0,6,6,109.59313,18.32007,1871
12284,94535,E4199729A84482014747EE1ECF3FF7D9,30931,7,23,16,109.55653,18.32722,1722
12285,94550,3C7B93BB0A27C1CE56C61B7C28661B4D,31521,0,9,9,109.51458,18.22542,1555
12286,94551,3C7B93BB0A27C1CE56C61B7C28661B4D,39081,12,15,3,109.19382,18.29111,366
12287,94552,3C7B93BB0A27C1CE56C61B7C28661B4D,31521,18,19,1,109.51458,18.22542,1555
12288,94553,3C7B93BB0A27C1CE56C61B7C28661B4D,30211,20,21,1,109.49882,18.23931,1508
12289,94554,3C7B93BB0A27C1CE56C61B7C28661B4D,31521,22,23,1,109.51458,18.22542,1555
12290,94561,CFCFA94681CDD57855D6405C244168DD,38291,0,1,1,109.51618,18.24313,1558
12291,94562,CFCFA94681CDD57855D6405C244168DD,60381,2,4,2,109.5241,18.22458,1605
12292,94563,CFCFA94681CDD57855D6405C244168DD,31521,4,5,1,109.51458,18.22542,1555
12293,94564,CFCFA94681CDD57855D6405C244168DD,38891,12,17,5,109.51486,18.24118,1558
12294,94565,CFCFA94681CDD57855D6405C244168DD,30511,21,23,2,109.51069,18.24208,1558
12295,94566,B5EEA30F2FFAABF51AE99311CDE9203E,39111,0,15,15,109.5191,18.22597,1555
12296,94577,5C958E9FBADCA0FB00CA547ED9076A9C,60463,15,17,2,109.52507,18.22438,1605
12297,94612,F5339F338C91A3D42D29DA47F2F626F1,60552,0,1,1,109.41729,18.30014,1218
12298,94613,F5339F338C91A3D42D29DA47F2F626F1,60081,2,4,2,109.51097,18.22639,1556
12299,94614,F5339F338C91A3D42D29DA47F2F626F1,60551,5,9,4,109.42722,18.30111,1218
12300,94617,8554F0A178316702A9146AC053A2336A,31231,0,5,5,109.42597,18.29292,1217
12301,94618,8554F0A178316702A9146AC053A2336A,60401,6,7,1,109.47444,18.27583,1414
12302,94619,8554F0A178316702A9146AC053A2336A,60161,7,8,1,109.49174,18.26181,1461
12303,94620,8554F0A178316702A9146AC053A2336A,31251,12,14,2,109.18528,18.2975,317
12304,94621,8554F0A178316702A9146AC053A2336A,31031,14,16,2,109.49979,18.25382,1510
12305,94622,8554F0A178316702A9146AC053A2336A,30421,16,17,1,109.50021,18.25861,1511
12306,94623,8554F0A178316702A9146AC053A2336A,31231,20,21,1,109.42597,18.29292,1217
12307,94679,E6F5FC1A2EE909681CFC0853089D56BB,31471,13,15,2,109.34583,18.29563,917
12308,94680,E6F5FC1A2EE909681CFC0853089D56BB,60054,16,18,2,109.3016,18.31229,770
12309,94681,E6F5FC1A2EE909681CFC0853089D56BB,60491,19,23,4,109.43354,18.30847,1269
12310,94699,F0C8EDCD3FE95FB2FF48130C40BB6671,60054,8,9,1,109.3016,18.31229,770
12311,94700,F0C8EDCD3FE95FB2FF48130C40BB6671,31571,9,10,1,109.61563,18.23326,1957
12312,94701,F0C8EDCD3FE95FB2FF48130C40BB6671,31761,11,12,1,109.60521,18.27965,1914
12313,94702,F0C8EDCD3FE95FB2FF48130C40BB6671,30101,12,14,2,109.57299,18.33333,1773
12314,94703,F0C8EDCD3FE95FB2FF48130C40BB6671,60054,14,15,1,109.3016,18.31229,770
12315,94704,F0C8EDCD3FE95FB2FF48130C40BB6671,31124,16,18,2,109.17069,18.35,276
12320,94741,7108C89027EB031E7A5F6707D053C8A4,38061,0,7,7,109.50597,18.23118,1506
12321,94742,7108C89027EB031E7A5F6707D053C8A4,30501,8,18,10,109.72,18.34951,2326
12322,94743,7108C89027EB031E7A5F6707D053C8A4,38061,20,23,3,109.50597,18.23118,1506
12323,94750,39997DEFFD87AA0C9D18E1194544E438,30854,0,18,18,109.56889,18.27076,1763
12324,94751,39997DEFFD87AA0C9D18E1194544E438,30891,19,20,1,109.59431,18.28389,1865
12336,94893,A9FCE0049DB44FE004EAFBF5B783F4A5,39091,18,20,2,109.50097,18.25222,1510
12337,94894,A9FCE0049DB44FE004EAFBF5B783F4A5,39091,21,22,1,109.50097,18.25222,1510
12338,94897,CCBF1BE99DA9F84ADB162A21804AB04F,39183,15,17,2,109.55542,18.28208,1715
12339,94898,CCBF1BE99DA9F84ADB162A21804AB04F,60361,19,22,3,109.51938,18.29681,1567
12340,94919,7F592F4B1327F7868A94B76F9B2A9CA1,39191,0,7,7,109.51493,18.23472,1557
12341,94920,7F592F4B1327F7868A94B76F9B2A9CA1,31781,11,13,2,109.19847,18.2975,367
12342,94921,7F592F4B1327F7868A94B76F9B2A9CA1,31201,18,20,2,109.51042,18.23819,1558
12343,94922,7F592F4B1327F7868A94B76F9B2A9CA1,39191,20,21,1,109.51493,18.23472,1557
12344,94923,7F592F4B1327F7868A94B76F9B2A9CA1,31201,21,23,2,109.51042,18.23819,1558
12345,94945,83644E968E3567A6F84BB990AA7D4C72,31841,16,18,2,109.73201,18.33382,2373
12346,94965,2CE19795F2549AFE8556FD3526787FA2,31561,16,18,2,109.56792,18.28479,1765
12347,94966,2CE19795F2549AFE8556FD3526787FA2,31071,20,23,3,109.58257,18.28458,1815
12348,94967,CD910BF673AA13391E641010B292AF0E,39154,0,6,6,109.50201,18.25681,1511
12349,94968,CD910BF673AA13391E641010B292AF0E,31461,6,7,1,109.5091,18.25389,1510
12350,94969,CD910BF673AA13391E641010B292AF0E,31471,10,12,2,109.34583,18.29563,917
12351,94970,CD910BF673AA13391E641010B292AF0E,31781,14,16,2,109.19847,18.2975,367
12352,94971,CD910BF673AA13391E641010B292AF0E,38094,17,19,2,109.45403,18.28778,1316
12353,94974,12A0D13AED64522A8A0ABBA021E92F4C,31811,0,1,1,109.54201,18.31806,1671
12354,94975,12A0D13AED64522A8A0ABBA021E92F4C,60361,1,9,8,109.51938,18.29681,1567
12355,94976,12A0D13AED64522A8A0ABBA021E92F4C,30391,10,17,7,109.4975,18.27118,1513
12356,94977,12A0D13AED64522A8A0ABBA021E92F4C,60361,18,23,5,109.51938,18.29681,1567
12364,95017,43018FB39803E31509A90CB37A66655B,31561,1,2,1,109.56792,18.28479,1765
12365,95018,43018FB39803E31509A90CB37A66655B,31945,3,6,3,109.58021,18.29403,1817
12366,95019,43018FB39803E31509A90CB37A66655B,33051,9,14,5,109.6475,18.46618,2096
12367,95020,43018FB39803E31509A90CB37A66655B,60221,18,21,3,109.52569,18.29188,1616
12368,95023,A94F66C88B84FF0658441320CD9F667C,31071,0,16,16,109.58257,18.28458,1815
12369,95024,A94F66C88B84FF0658441320CD9F667C,30854,16,18,2,109.56889,18.27076,1763
12373,95065,C316CE65034FB3C77BE459147CBF943A,60291,0,7,7,109.50826,18.24639,1509
12374,95066,C316CE65034FB3C77BE459147CBF943A,30161,10,12,2,109.50042,18.24389,1508
12375,95067,C316CE65034FB3C77BE459147CBF943A,30161,14,16,2,109.50042,18.24389,1508
12376,95068,C316CE65034FB3C77BE459147CBF943A,30161,16,17,1,109.50042,18.24389,1508
12377,95069,C316CE65034FB3C77BE459147CBF943A,60291,20,23,3,109.50826,18.24639,1509
12378,95116,D6A345956751BA2ACC5430EDF68A104F,39181,14,15,1,109.55153,18.28035,1715
12379,95117,D6A345956751BA2ACC5430EDF68A104F,31931,16,18,2,109.54771,18.29403,1667
12380,95118,D6A345956751BA2ACC5430EDF68A104F,39181,19,23,4,109.55153,18.28035,1715
12385,95161,0D00E0CA974DDA00224ACCD00B993468,30851,0,1,1,109.5616,18.27396,1713
12386,95162,0D00E0CA974DDA00224ACCD00B993468,30854,2,3,1,109.56889,18.27076,1763
12387,95163,0D00E0CA974DDA00224ACCD00B993468,30851,3,6,3,109.5616,18.27396,1713
12388,95164,0D00E0CA974DDA00224ACCD00B993468,30854,7,10,3,109.56889,18.27076,1763
12389,95165,0D00E0CA974DDA00224ACCD00B993468,31561,12,13,1,109.56792,18.28479,1765
12390,95166,0D00E0CA974DDA00224ACCD00B993468,30854,16,18,2,109.56889,18.27076,1763
12391,95167,0D00E0CA974DDA00224ACCD00B993468,30851,21,23,2,109.5616,18.27396,1713
12392,95182,5D6F65BD095966D13536BBBA7220DB9D,60371,1,7,6,109.53063,18.30056,1618
12393,95183,5D6F65BD095966D13536BBBA7220DB9D,30071,9,11,2,109.52819,18.30472,1619
12397,95198,F00821368F615DCDAF214035D8EC4A44,30854,14,16,2,109.56889,18.27076,1763
12398,95199,F00821368F615DCDAF214035D8EC4A44,60631,20,21,1,109.57778,18.27583,1814
12399,95220,934029FB5F97BCE114EDCE88F0393A63,31071,0,6,6,109.58257,18.28458,1815
12400,95221,934029FB5F97BCE114EDCE88F0393A63,30854,10,11,1,109.56889,18.27076,1763
12401,95222,934029FB5F97BCE114EDCE88F0393A63,31071,12,14,2,109.58257,18.28458,1815
12402,95223,934029FB5F97BCE114EDCE88F0393A63,30234,15,17,2,109.60681,18.29979,1918
12403,95224,934029FB5F97BCE114EDCE88F0393A63,31031,18,20,2,109.49979,18.25382,1510
12404,95225,934029FB5F97BCE114EDCE88F0393A63,30854,20,22,2,109.56889,18.27076,1763
12408,95237,96F98526707B06BE1263CCD4F72E07A1,30854,8,17,9,109.56889,18.27076,1763
12409,95238,96F98526707B06BE1263CCD4F72E07A1,31071,17,18,1,109.58257,18.28458,1815
12410,95239,513924E5F8EAB458027327A1E2BAE9DB,31071,2,7,5,109.58257,18.28458,1815
12411,95240,513924E5F8EAB458027327A1E2BAE9DB,30854,8,23,15,109.56889,18.27076,1763
12412,95249,D947D8D9432E18EA6A214259B6E2987E,60054,1,5,4,109.3016,18.31229,770
12413,95250,D947D8D9432E18EA6A214259B6E2987E,30661,8,10,2,109.37028,18.24361,1008
12414,95251,D947D8D9432E18EA6A214259B6E2987E,60411,12,18,6,109.32514,18.30854,869
12415,95252,D947D8D9432E18EA6A214259B6E2987E,30661,19,23,4,109.37028,18.24361,1008
12422,95263,24B9CD23EC5587BA3102D06F602ACE38,60171,0,6,6,109.51292,18.30694,1569
12423,95264,24B9CD23EC5587BA3102D06F602ACE38,31561,7,8,1,109.56792,18.28479,1765
12424,95265,24B9CD23EC5587BA3102D06F602ACE38,60171,8,11,3,109.51292,18.30694,1569
12425,95266,24B9CD23EC5587BA3102D06F602ACE38,39183,12,13,1,109.55542,18.28208,1715
12426,95267,24B9CD23EC5587BA3102D06F602ACE38,60171,13,21,8,109.51292,18.30694,1569
12427,95286,D73D0E1690714CD7F442C709F67E4771,60361,0,6,6,109.51938,18.29681,1567
12428,95287,D73D0E1690714CD7F442C709F67E4771,30851,8,9,1,109.5616,18.27396,1713
12429,95288,D73D0E1690714CD7F442C709F67E4771,30951,12,15,3,109.56208,18.25667,1761
12430,95289,D73D0E1690714CD7F442C709F67E4771,60361,19,23,4,109.51938,18.29681,1567
12431,95321,A14C813C3E3A7182759DA822342505B5,31071,14,15,1,109.58257,18.28458,1815
12432,95322,A14C813C3E3A7182759DA822342505B5,39183,18,23,5,109.55542,18.28208,1715
12433,95329,F84D949DDCBF25D5530F771BC55E0B9D,61011,0,9,9,109.60653,18.19076,1900
12434,95331,00E4BC24F22404A2FC4D45749054257A,31071,12,14,2,109.58257,18.28458,1815
12435,95332,00E4BC24F22404A2FC4D45749054257A,60221,15,19,4,109.52569,18.29188,1616
12436,95333,00E4BC24F22404A2FC4D45749054257A,30854,20,21,1,109.56889,18.27076,1763
12437,95334,5EB38BD215239D8B45DDA43E874110D7,60641,0,7,7,109.53854,18.2359,1657
12438,95345,07169E7114E4F14C073261BAAC0D4491,61011,1,3,2,109.60653,18.19076,1900
12439,95347,07169E7114E4F14C073261BAAC0D4491,61011,19,23,4,109.60653,18.19076,1900
12440,95355,6EF68F35CE79552C1164E70C67C72C02,30121,0,9,9,109.52861,18.27222,1613
12441,95356,6EF68F35CE79552C1164E70C67C72C02,60031,10,11,1,109.49694,18.31632,1521
12442,95357,6EF68F35CE79552C1164E70C67C72C02,30854,12,14,2,109.56889,18.27076,1763
12443,95358,6EF68F35CE79552C1164E70C67C72C02,30121,17,23,6,109.52861,18.27222,1613
12444,95373,6F590AF2C10C4B9F0F4E76B8E922550E,30854,15,19,4,109.56889,18.27076,1763
12445,95374,6F590AF2C10C4B9F0F4E76B8E922550E,31945,21,23,2,109.58021,18.29403,1817
12446,95424,8AE1DEDFE1A65A29B5153547EEA03A21,31071,1,7,6,109.58257,18.28458,1815
12447,95425,8AE1DEDFE1A65A29B5153547EEA03A21,39183,9,20,11,109.55542,18.28208,1715
12448,95430,9C1407835BC54BEBDB541F52E1DA1820,61011,14,23,9,109.60653,18.19076,1900
12449,95512,8C3D244B6DAAE8C73F174808255E03C6,60011,0,1,1,109.48965,18.30222,1468
12450,95513,8C3D244B6DAAE8C73F174808255E03C6,30111,3,11,8,109.47583,18.30542,1419
12451,95514,8C3D244B6DAAE8C73F174808255E03C6,60011,12,13,1,109.48965,18.30222,1468
12452,95515,8C3D244B6DAAE8C73F174808255E03C6,30764,14,15,1,109.45806,18.29486,1367
12453,95516,8C3D244B6DAAE8C73F174808255E03C6,30111,15,17,2,109.47583,18.30542,1419
12454,95517,8C3D244B6DAAE8C73F174808255E03C6,60011,21,23,2,109.48965,18.30222,1468
12455,95523,0F082D992D3A79023540780AB4E5166C,61011,6,12,6,109.60653,18.19076,1900
12456,95525,0F082D992D3A79023540780AB4E5166C,31071,18,20,2,109.58257,18.28458,1815
12457,95526,0F082D992D3A79023540780AB4E5166C,61011,20,23,3,109.60653,18.19076,1900
12458,95534,0A987E09994A8BF75281CD6678876931,30221,0,1,1,109.57833,18.20222,1802
12459,95535,0A987E09994A8BF75281CD6678876931,30571,3,7,4,109.50243,18.21861,1504
12460,95536,0A987E09994A8BF75281CD6678876931,30531,8,9,1,109.53271,18.21472,1604
12461,95537,0A987E09994A8BF75281CD6678876931,30221,9,11,2,109.57833,18.20222,1802
12462,95538,0A987E09994A8BF75281CD6678876931,31421,15,23,8,109.55382,18.22347,1705
12463,95542,C054F0F1F6DF018C36D80DAC513476F7,60331,3,11,8,109.505,18.26507,1512
12464,95543,C054F0F1F6DF018C36D80DAC513476F7,30151,11,12,1,109.50986,18.25083,1560
12465,95544,C054F0F1F6DF018C36D80DAC513476F7,38754,13,15,2,109.74667,18.37382,2430
12466,95545,C054F0F1F6DF018C36D80DAC513476F7,30151,16,18,2,109.50986,18.25083,1560
12467,95551,47B1458A9E02196E213461CE7E46A4B3,31945,0,8,8,109.58021,18.29403,1817
12468,95552,47B1458A9E02196E213461CE7E46A4B3,31071,12,14,2,109.58257,18.28458,1815
12469,95553,47B1458A9E02196E213461CE7E46A4B3,30854,14,15,1,109.56889,18.27076,1763
12470,95554,47B1458A9E02196E213461CE7E46A4B3,30711,17,18,1,109.50271,18.25347,1510
12471,95555,47B1458A9E02196E213461CE7E46A4B3,31071,19,20,1,109.58257,18.28458,1815
12475,95605,8799356B7181F28146A203E5F86C52F0,31351,0,9,9,109.4959,18.28417,1465
12476,95606,8799356B7181F28146A203E5F86C52F0,38185,9,11,2,109.51333,18.27347,1563
12477,95607,8799356B7181F28146A203E5F86C52F0,38834,12,13,1,109.47639,18.21146,1403
12478,95613,73EAC1341C5005A58B26B1A52457F38B,39091,0,2,2,109.50097,18.25222,1510
12479,95614,73EAC1341C5005A58B26B1A52457F38B,30161,2,17,15,109.50042,18.24389,1508
12483,95650,84D09807769454188E86D49181B1B5D0,30421,0,8,8,109.50021,18.25861,1511
12484,95651,84D09807769454188E86D49181B1B5D0,31145,10,15,5,109.20431,18.30479,369
12485,95652,84D09807769454188E86D49181B1B5D0,30421,17,18,1,109.50021,18.25861,1511
12486,95653,84D09807769454188E86D49181B1B5D0,60571,21,22,1,109.50722,18.25056,1510
12487,95654,7EBC20D0E5F0FBA046CA1D08E7FF47C1,60631,0,7,7,109.57778,18.27583,1814
12488,95655,7EBC20D0E5F0FBA046CA1D08E7FF47C1,30854,8,15,7,109.56889,18.27076,1763
12489,95695,3A429390E0D19C5F409E32660585ED7B,31931,5,19,14,109.54771,18.29403,1667
12490,95709,E00EF22F493557E868E52C93194870CF,31945,5,6,1,109.58021,18.29403,1817
12491,95710,E00EF22F493557E868E52C93194870CF,30854,8,19,11,109.56889,18.27076,1763
12492,95711,E00EF22F493557E868E52C93194870CF,39111,19,20,1,109.5191,18.22597,1555
12493,95853,76F6A54588C8DF7DDADFC50CAA11D44C,31071,6,7,1,109.58257,18.28458,1815
12494,95854,76F6A54588C8DF7DDADFC50CAA11D44C,30854,9,11,2,109.56889,18.27076,1763
12495,95855,76F6A54588C8DF7DDADFC50CAA11D44C,38085,15,19,4,109.6291,18.23625,2007
12503,95916,46C761D2C5BB3E9FC0E036B374FF60F4,30171,1,10,9,109.48458,18.27139,1463
12504,95917,46C761D2C5BB3E9FC0E036B374FF60F4,30854,12,22,10,109.56889,18.27076,1763
12505,95937,51061B3DE820AF1C1C713EF684728003,31071,0,8,8,109.58257,18.28458,1815
12506,95938,51061B3DE820AF1C1C713EF684728003,30854,8,11,3,109.56889,18.27076,1763
12507,95939,51061B3DE820AF1C1C713EF684728003,31071,12,14,2,109.58257,18.28458,1815
12508,95940,51061B3DE820AF1C1C713EF684728003,30854,14,15,1,109.56889,18.27076,1763
12509,95941,51061B3DE820AF1C1C713EF684728003,30221,16,17,1,109.57833,18.20222,1802
12510,95942,51061B3DE820AF1C1C713EF684728003,30854,17,23,6,109.56889,18.27076,1763
12511,95943,012ABD06F231728C214A4BA917E75B1C,31561,2,5,3,109.56792,18.28479,1765
12512,95944,012ABD06F231728C214A4BA917E75B1C,30851,6,7,1,109.5616,18.27396,1713
12513,95945,012ABD06F231728C214A4BA917E75B1C,31561,8,10,2,109.56792,18.28479,1765
12514,95946,012ABD06F231728C214A4BA917E75B1C,30851,11,12,1,109.5616,18.27396,1713
12515,95947,012ABD06F231728C214A4BA917E75B1C,31561,12,17,5,109.56792,18.28479,1765
12516,95948,012ABD06F231728C214A4BA917E75B1C,30851,22,23,1,109.5616,18.27396,1713
12517,95949,A8E9C7BB918ADAD29A3EA7ACDDCD32D7,38951,0,20,20,109.48097,18.28868,1416
12518,95950,A8E9C7BB918ADAD29A3EA7ACDDCD32D7,38951,22,23,1,109.48097,18.28868,1416
12519,95966,F07DEBB70735DF37AC0D6CB973B7F289,30161,13,16,3,109.50042,18.24389,1508
12520,95967,F07DEBB70735DF37AC0D6CB973B7F289,31951,17,19,2,109.52174,18.30299,1568
12524,96009,CA63110F88D6457AD774A164FA870244,60231,3,9,6,109.49903,18.21972,1504
12525,96010,CA63110F88D6457AD774A164FA870244,30661,11,12,1,109.37028,18.24361,1008
12526,96011,CA63110F88D6457AD774A164FA870244,60231,15,20,5,109.49903,18.21972,1504
12527,96020,BEE3A0C9BB09D7F210E3490BED90A1BE,30791,0,5,5,109.72333,18.40889,2386
12528,96021,BEE3A0C9BB09D7F210E3490BED90A1BE,30071,7,10,3,109.52819,18.30472,1619
12529,96022,BEE3A0C9BB09D7F210E3490BED90A1BE,30071,11,12,1,109.52819,18.30472,1619
12530,96023,BEE3A0C9BB09D7F210E3490BED90A1BE,60371,12,14,2,109.53063,18.30056,1618
12531,96024,BEE3A0C9BB09D7F210E3490BED90A1BE,30071,19,22,3,109.52819,18.30472,1619
12532,96037,A50885B0567921CDC52AB88137329206,39321,16,18,2,109.529,18.2167,1604
12533,96038,A50885B0567921CDC52AB88137329206,60381,18,20,2,109.5241,18.22458,1605
12534,96039,A50885B0567921CDC52AB88137329206,31521,21,23,2,109.51458,18.22542,1555
12535,96066,BCF2A283AE0436F3C991D66E0EA13EC0,31534,0,2,2,109.49368,18.25806,1461
12536,96067,BCF2A283AE0436F3C991D66E0EA13EC0,30771,3,7,4,109.49938,18.26042,1511
12537,96068,BCF2A283AE0436F3C991D66E0EA13EC0,31531,8,9,1,109.49583,18.25972,1461
12538,96069,BCF2A283AE0436F3C991D66E0EA13EC0,31471,12,13,1,109.34583,18.29563,917
12539,96070,BCF2A283AE0436F3C991D66E0EA13EC0,31471,15,16,1,109.34583,18.29563,917
12540,96071,BCF2A283AE0436F3C991D66E0EA13EC0,30771,17,20,3,109.49938,18.26042,1511
12541,96072,BCF2A283AE0436F3C991D66E0EA13EC0,31534,21,23,2,109.49368,18.25806,1461
12545,96110,2AA430AFC7D9CDE5B5FC859F65FEFEA7,31521,12,15,3,109.51458,18.22542,1555
12546,96111,2AA430AFC7D9CDE5B5FC859F65FEFEA7,30201,19,20,1,109.4909,18.26465,1462
12547,96112,2AA430AFC7D9CDE5B5FC859F65FEFEA7,31521,21,23,2,109.51458,18.22542,1555
12548,96126,81C892F4C735FEF892157743AFC50956,30201,20,21,1,109.4909,18.26465,1462
12549,96127,81C892F4C735FEF892157743AFC50956,31021,22,23,1,109.49021,18.27,1463
12550,96174,9915B6FF17BD3BF50FFC7042D095278F,31851,11,15,4,109.71736,18.29007,2316
12551,96175,9915B6FF17BD3BF50FFC7042D095278F,30854,19,20,1,109.56889,18.27076,1763
12552,96185,2371AF49C13083A9B56BAFD9F258B46A,30721,1,7,6,109.51597,18.28257,1565
12553,96186,2371AF49C13083A9B56BAFD9F258B46A,30341,10,17,7,109.3625,18.29167,966
12554,96187,2371AF49C13083A9B56BAFD9F258B46A,30121,19,21,2,109.52861,18.27222,1613
12559,96292,D4AA3869830031578B573FD0033C24A8,60371,2,8,6,109.53063,18.30056,1618
12560,96293,D4AA3869830031578B573FD0033C24A8,31931,9,23,14,109.54771,18.29403,1667
12561,96294,33A62A8066AF8B1342859DF4B906FBD2,30351,0,14,14,109.41701,18.29292,1217
12566,96324,4639E7F597994307D62A7FF9CC65CC1D,31071,13,14,1,109.58257,18.28458,1815
12567,96325,4639E7F597994307D62A7FF9CC65CC1D,30854,15,17,2,109.56889,18.27076,1763
12568,96326,4639E7F597994307D62A7FF9CC65CC1D,31071,21,22,1,109.58257,18.28458,1815
12569,96340,549FEB02FDCB1D950404939A4A6496A0,31931,0,6,6,109.54771,18.29403,1667
12570,96371,89048436012E137B6C20E2880EE91E56,30201,0,8,8,109.4909,18.26465,1462
12574,96394,6D2A0FF2CE3C55DB71755FD38AD58190,31206,0,6,6,109.50819,18.23549,1507
12575,96395,6D2A0FF2CE3C55DB71755FD38AD58190,31781,8,12,4,109.19847,18.2975,367
12576,96396,6D2A0FF2CE3C55DB71755FD38AD58190,31201,16,17,1,109.51042,18.23819,1558
12577,96397,6D2A0FF2CE3C55DB71755FD38AD58190,38094,17,19,2,109.45403,18.28778,1316
12578,96398,6D2A0FF2CE3C55DB71755FD38AD58190,31206,20,23,3,109.50819,18.23549,1507
12579,96421,A2698C501FCA00D8683EBFD8421BD0E5,31031,0,6,6,109.49979,18.25382,1510
12580,96422,A2698C501FCA00D8683EBFD8421BD0E5,31021,11,23,12,109.49021,18.27,1463
12585,96455,9EBFE19AEC38C3A6F47AE2D903294BAE,30854,0,15,15,109.56889,18.27076,1763
12586,96456,9EBFE19AEC38C3A6F47AE2D903294BAE,31071,19,23,4,109.58257,18.28458,1815
12587,96459,7890099D98AA300C5BF12527E7372DB0,60631,0,7,7,109.57778,18.27583,1814
12588,96460,7890099D98AA300C5BF12527E7372DB0,30854,8,9,1,109.56889,18.27076,1763
12589,96461,7890099D98AA300C5BF12527E7372DB0,31071,9,10,1,109.58257,18.28458,1815
12590,96462,7890099D98AA300C5BF12527E7372DB0,60631,12,14,2,109.57778,18.27583,1814
12591,96463,7890099D98AA300C5BF12527E7372DB0,30854,15,17,2,109.56889,18.27076,1763
12592,96464,7890099D98AA300C5BF12527E7372DB0,60631,18,23,5,109.57778,18.27583,1814
12593,96470,C1F80FD61770F46AF18F3BEF2B67E7ED,31551,0,8,8,109.55868,18.24222,1708
12594,96471,C1F80FD61770F46AF18F3BEF2B67E7ED,30511,12,14,2,109.51069,18.24208,1558
12595,96472,C1F80FD61770F46AF18F3BEF2B67E7ED,30251,18,19,1,109.50611,18.26653,1512
12596,96473,C1F80FD61770F46AF18F3BEF2B67E7ED,31091,21,22,1,109.41201,18.31222,1170
12597,96516,C2AA18BC64931E724BDFB06A100ECEC3,31521,3,10,7,109.51458,18.22542,1555
12598,96517,C2AA18BC64931E724BDFB06A100ECEC3,31781,13,15,2,109.19847,18.2975,367
12599,96518,C2AA18BC64931E724BDFB06A100ECEC3,60381,19,22,3,109.5241,18.22458,1605
12600,96538,C6FE4CF0CD47303AD7F7EC5A71315B10,31391,17,19,2,109.50382,18.24285,1508
12601,96539,C6FE4CF0CD47303AD7F7EC5A71315B10,39101,19,21,2,109.50132,18.24931,1509
12602,96555,32D0EBFA645FCE8DAD65D018847E5043,30232,0,3,3,109.6191,18.31701,1971
12603,96556,32D0EBFA645FCE8DAD65D018847E5043,31071,3,5,2,109.58257,18.28458,1815
12604,96557,32D0EBFA645FCE8DAD65D018847E5043,30232,6,7,1,109.6191,18.31701,1971
12605,96558,32D0EBFA645FCE8DAD65D018847E5043,30854,10,23,13,109.56889,18.27076,1763
12609,96612,BBE4D8242EE46AE73AD69A56A00F4408,30201,9,10,1,109.4909,18.26465,1462
12610,96613,BBE4D8242EE46AE73AD69A56A00F4408,31271,12,16,4,109.48958,18.26257,1462
12611,96614,BBE4D8242EE46AE73AD69A56A00F4408,31021,18,19,1,109.49021,18.27,1463
12612,96615,BBE4D8242EE46AE73AD69A56A00F4408,30201,19,23,4,109.4909,18.26465,1462
12616,96628,8476D98176DA2968291F6BE79BE2B5AE,38903,0,6,6,109.39229,18.29243,1117
12617,96629,8476D98176DA2968291F6BE79BE2B5AE,30854,8,9,1,109.56889,18.27076,1763
12618,96630,8476D98176DA2968291F6BE79BE2B5AE,31071,14,15,1,109.58257,18.28458,1815
12619,96631,8476D98176DA2968291F6BE79BE2B5AE,30854,16,17,1,109.56889,18.27076,1763
12620,96632,8476D98176DA2968291F6BE79BE2B5AE,30271,21,22,1,109.49132,18.23153,1456
12621,96686,00262F856825A94933CC2BDE5C3D9737,31421,0,9,9,109.55382,18.22347,1705
12622,96687,00262F856825A94933CC2BDE5C3D9737,60581,14,16,2,109.59785,18.29931,1868
12623,96688,00262F856825A94933CC2BDE5C3D9737,30951,16,22,6,109.56208,18.25667,1761
12624,96722,C8922FAF66F21ECAECB6B717FCD5A53B,60391,0,1,1,109.47667,18.28757,1416
12625,96723,C8922FAF66F21ECAECB6B717FCD5A53B,60614,1,6,5,109.48799,18.29521,1467
12626,96724,C8922FAF66F21ECAECB6B717FCD5A53B,30761,6,9,3,109.45201,18.3,1318
12627,96725,C8922FAF66F21ECAECB6B717FCD5A53B,60614,12,13,1,109.48799,18.29521,1467
12628,96726,C8922FAF66F21ECAECB6B717FCD5A53B,60504,14,17,3,109.47917,18.28903,1416
12629,96727,C8922FAF66F21ECAECB6B717FCD5A53B,60391,18,19,1,109.47667,18.28757,1416
12630,96734,7D1ED6067ECBD941EFC43CE0A6ADAE71,30854,0,2,2,109.56889,18.27076,1763
12631,96735,7D1ED6067ECBD941EFC43CE0A6ADAE71,31945,2,6,4,109.58021,18.29403,1817
12632,96736,7D1ED6067ECBD941EFC43CE0A6ADAE71,30854,7,19,12,109.56889,18.27076,1763
12633,96737,7D1ED6067ECBD941EFC43CE0A6ADAE71,31945,20,21,1,109.58021,18.29403,1817
12634,96738,7D1ED6067ECBD941EFC43CE0A6ADAE71,30854,21,23,2,109.56889,18.27076,1763
12638,96771,30D8A678A1441E4FFDF2E3F44AE24060,31071,1,15,14,109.58257,18.28458,1815
12639,96772,30D8A678A1441E4FFDF2E3F44AE24060,30854,19,21,2,109.56889,18.27076,1763
12640,96833,564220533658012885D64AC3FDD81E22,31701,17,18,1,109.44132,18.28833,1266
12641,96834,564220533658012885D64AC3FDD81E22,60641,21,23,2,109.53854,18.2359,1657
12642,96858,104AF40065ED94F83A7A7970F3C770A2,31521,0,8,8,109.51458,18.22542,1555
12643,96859,104AF40065ED94F83A7A7970F3C770A2,31471,9,12,3,109.34583,18.29563,917
12644,96860,104AF40065ED94F83A7A7970F3C770A2,31145,14,15,1,109.20431,18.30479,369
12645,96861,104AF40065ED94F83A7A7970F3C770A2,38754,18,19,1,109.74667,18.37382,2430
12649,96925,E75CF54BA14775FEDD26504F9F6B7365,30854,12,16,4,109.56889,18.27076,1763
12650,96926,E75CF54BA14775FEDD26504F9F6B7365,31561,17,18,1,109.56792,18.28479,1765
12651,96927,E75CF54BA14775FEDD26504F9F6B7365,31071,20,21,1,109.58257,18.28458,1815
12652,96928,E75CF54BA14775FEDD26504F9F6B7365,31945,22,23,1,109.58021,18.29403,1817
12653,96929,00FC332040A284DA251A8D0705989FE9,31071,9,17,8,109.58257,18.28458,1815
12654,96930,00FC332040A284DA251A8D0705989FE9,30421,19,22,3,109.50021,18.25861,1511
12655,96995,7AEB94813E5780CDA0309050B78B09DB,31781,10,12,2,109.19847,18.2975,367
12656,96996,7AEB94813E5780CDA0309050B78B09DB,31521,15,16,1,109.51458,18.22542,1555
12657,96997,7AEB94813E5780CDA0309050B78B09DB,38094,17,19,2,109.45403,18.28778,1316
12658,96998,7AEB94813E5780CDA0309050B78B09DB,30181,21,23,2,109.51597,18.23313,1557
12659,97005,C24CAAFE002C4A637E7D01C4B7549E3D,30271,0,6,6,109.49132,18.23153,1456
12660,97008,C24CAAFE002C4A637E7D01C4B7549E3D,30271,13,23,10,109.49132,18.23153,1456
12661,97040,2AE38FAF341950B0B91404FFCE5A0F3E,30921,7,17,10,109.53903,18.29451,1667
12662,97041,2AE38FAF341950B0B91404FFCE5A0F3E,31931,20,22,2,109.54771,18.29403,1667
12666,97050,58418A9EA4A7DC03127CB79C039A5185,31071,0,14,14,109.58257,18.28458,1815
12667,97051,58418A9EA4A7DC03127CB79C039A5185,30711,18,21,3,109.50271,18.25347,1510
12668,97095,9ECDB9C3F97E311C1827C02496967431,60371,0,12,12,109.53063,18.30056,1618
12669,97096,9ECDB9C3F97E311C1827C02496967431,30701,17,22,5,109.59313,18.32007,1871
12670,97120,77A63CEB987CF3B94BF0EF731BFDDB75,30731,0,5,5,109.50944,18.22306,1555
12671,97121,77A63CEB987CF3B94BF0EF731BFDDB75,31521,8,10,2,109.51458,18.22542,1555
12672,97122,77A63CEB987CF3B94BF0EF731BFDDB75,31521,11,13,2,109.51458,18.22542,1555
12673,97123,77A63CEB987CF3B94BF0EF731BFDDB75,38111,14,16,2,109.52007,18.22403,1555
12674,97124,77A63CEB987CF3B94BF0EF731BFDDB75,31521,17,18,1,109.51458,18.22542,1555
12675,97125,77A63CEB987CF3B94BF0EF731BFDDB75,38071,20,21,1,109.40722,18.30938,1169
12676,97133,A6C9F0B973397747F0214C9B247DCED3,31471,11,12,1,109.34583,18.29563,917
12684,97173,B34415F599F0ED7D1A073EE314A60B9B,60041,3,4,1,109.39889,18.31944,1121
12685,97174,B34415F599F0ED7D1A073EE314A60B9B,31671,8,22,14,109.38965,18.29813,1068
12686,97191,2C9F9127F2AECFBA8069624790D23C60,30771,0,6,6,109.49938,18.26042,1511
12687,97205,0CD3A9451B945A7EABB5A7155C5317AC,60401,2,8,6,109.47444,18.27583,1414
12688,97206,0CD3A9451B945A7EABB5A7155C5317AC,60161,9,10,1,109.49174,18.26181,1461
12689,97207,0CD3A9451B945A7EABB5A7155C5317AC,31251,12,14,2,109.18528,18.2975,317
12690,97208,0CD3A9451B945A7EABB5A7155C5317AC,30421,14,17,3,109.50021,18.25861,1511
12691,97209,0CD3A9451B945A7EABB5A7155C5317AC,38251,18,19,1,109.49618,18.25493,1510
12698,97281,B5D993AEFE332BB553AF00D1A5E8D804,31031,0,12,12,109.49979,18.25382,1510
12699,97282,B5D993AEFE332BB553AF00D1A5E8D804,60411,16,23,7,109.32514,18.30854,869
12703,97359,D6B53309590D99FCA390E7D5BEFA02F3,38331,3,11,8,109.62465,18.22736,1956
12704,97360,D6B53309590D99FCA390E7D5BEFA02F3,60441,15,16,1,109.46792,18.28604,1366
12705,97430,F613CC88D209D7DC1A4E289F7CE1FEAE,38951,0,10,10,109.48097,18.28868,1416
12706,97431,F613CC88D209D7DC1A4E289F7CE1FEAE,30731,11,15,4,109.50944,18.22306,1555
12707,97432,F613CC88D209D7DC1A4E289F7CE1FEAE,30861,18,19,1,109.52722,18.22743,1606
12711,97504,D5EC7DA388CFD5E0C4727105FD53AF35,31471,13,15,2,109.34583,18.29563,917
12712,97505,D5EC7DA388CFD5E0C4727105FD53AF35,60491,19,22,3,109.43354,18.30847,1269
12713,97524,7D3290551DAEC31B514E4A342C73F8C1,60221,16,18,2,109.52569,18.29188,1616
12714,97525,7D3290551DAEC31B514E4A342C73F8C1,60381,20,21,1,109.5241,18.22458,1605
12715,97570,EB0FCA476C45C6CACE4A77D6A3C2F286,30661,12,14,2,109.37028,18.24361,1008
12716,97571,EB0FCA476C45C6CACE4A77D6A3C2F286,60054,14,15,1,109.3016,18.31229,770
12717,97572,EB0FCA476C45C6CACE4A77D6A3C2F286,30854,19,21,2,109.56889,18.27076,1763
12718,97581,A630522B62E8A37999528F086521024C,30771,8,10,2,109.49938,18.26042,1511
12719,97582,A630522B62E8A37999528F086521024C,31931,14,22,8,109.54771,18.29403,1667
12720,97583,27229B6D41BD7CDDDAA38911093865DB,31071,3,4,1,109.58257,18.28458,1815
12721,97584,27229B6D41BD7CDDDAA38911093865DB,38085,5,16,11,109.6291,18.23625,2007
12722,97585,27229B6D41BD7CDDDAA38911093865DB,30854,18,23,5,109.56889,18.27076,1763
12723,97597,14F1CC63CDA098F9694EAC8584B9C7A5,31561,3,7,4,109.56792,18.28479,1765
12724,97598,14F1CC63CDA098F9694EAC8584B9C7A5,30854,8,11,3,109.56889,18.27076,1763
12725,97599,14F1CC63CDA098F9694EAC8584B9C7A5,31561,12,13,1,109.56792,18.28479,1765
12726,97600,14F1CC63CDA098F9694EAC8584B9C7A5,31071,13,15,2,109.58257,18.28458,1815
12727,97601,14F1CC63CDA098F9694EAC8584B9C7A5,30854,16,18,2,109.56889,18.27076,1763
12731,97647,2AA3869C77C7C14130E5A08E136B3824,30661,11,13,2,109.37028,18.24361,1008
12732,97666,C80166F5FFCB47450453FB0F444BF2BD,60311,0,7,7,109.52097,18.24319,1558
12733,97667,C80166F5FFCB47450453FB0F444BF2BD,30181,9,12,3,109.51597,18.23313,1557
12734,97668,C80166F5FFCB47450453FB0F444BF2BD,60311,13,14,1,109.52097,18.24319,1558
12735,97669,C80166F5FFCB47450453FB0F444BF2BD,38291,18,20,2,109.51618,18.24313,1558
12736,97670,C80166F5FFCB47450453FB0F444BF2BD,60311,21,23,2,109.52097,18.24319,1558
12737,97674,C8501DFE42E6954852B7593EDA5D3099,31304,9,13,4,109.15903,18.32854,223
12738,97675,C8501DFE42E6954852B7593EDA5D3099,60381,18,21,3,109.5241,18.22458,1605
12742,97716,D02479913B5C50E5D55D6F7DB176A542,31931,12,19,7,109.54771,18.29403,1667
12743,97717,D02479913B5C50E5D55D6F7DB176A542,39183,20,21,1,109.55542,18.28208,1715
12744,97755,C28CDF8C9B6CD50A00572DC343140C65,31321,0,13,13,109.63799,18.23201,2007
12745,97756,C28CDF8C9B6CD50A00572DC343140C65,30921,13,14,1,109.53903,18.29451,1667
12746,97757,C28CDF8C9B6CD50A00572DC343140C65,31321,17,23,6,109.63799,18.23201,2007
12747,97805,6876B785B3B8E427F5B0017E0B0EC706,60391,0,8,8,109.47667,18.28757,1416
12748,97806,6876B785B3B8E427F5B0017E0B0EC706,30434,11,12,1,109.17083,18.35861,278
12749,97807,6876B785B3B8E427F5B0017E0B0EC706,30111,12,14,2,109.47583,18.30542,1419
12750,97833,2D115D52FDAB55086A12D742071FDFC9,30232,0,3,3,109.6191,18.31701,1971
12751,97834,2D115D52FDAB55086A12D742071FDFC9,30854,3,13,10,109.56889,18.27076,1763
12752,97835,2D115D52FDAB55086A12D742071FDFC9,30232,14,20,6,109.6191,18.31701,1971
12753,97844,0C3DD1EABA2D708A2506DA8150CEC148,31561,0,6,6,109.56792,18.28479,1765
12754,97845,0C3DD1EABA2D708A2506DA8150CEC148,30854,8,9,1,109.56889,18.27076,1763
12755,97846,0C3DD1EABA2D708A2506DA8150CEC148,31561,11,13,2,109.56792,18.28479,1765
12756,97847,0C3DD1EABA2D708A2506DA8150CEC148,30854,14,17,3,109.56889,18.27076,1763
12757,97848,0C3DD1EABA2D708A2506DA8150CEC148,31561,18,22,4,109.56792,18.28479,1765
12758,97875,E844868356E195B198CAAC9A1F9C6634,31301,13,14,1,109.14493,18.31222,170
12759,97876,E844868356E195B198CAAC9A1F9C6634,31471,15,17,2,109.34583,18.29563,917
12760,97877,E844868356E195B198CAAC9A1F9C6634,31081,18,23,5,109.44639,18.30181,1318
12761,97886,29EC5157E5B1494DF69814EF16E86079,30581,11,12,1,109.62257,18.24951,1959
12762,97887,29EC5157E5B1494DF69814EF16E86079,31471,16,18,2,109.34583,18.29563,917
12763,97899,2F64FEF19C86AA0A8AA3E3FA37CC4F2D,30854,0,16,16,109.56889,18.27076,1763
12764,97900,2F64FEF19C86AA0A8AA3E3FA37CC4F2D,60631,18,20,2,109.57778,18.27583,1814
12771,97963,8C65C7C4D4426221B9BBF10610754805,38251,2,10,8,109.49618,18.25493,1510
12772,97964,8C65C7C4D4426221B9BBF10610754805,31471,13,16,3,109.34583,18.29563,917
12773,97965,8C65C7C4D4426221B9BBF10610754805,60524,19,21,2,109.42951,18.28993,1216
12774,97966,8C65C7C4D4426221B9BBF10610754805,38251,21,22,1,109.49618,18.25493,1510
12775,97974,FCFB14BA36BDB7CD6A39612B9AE933B2,39181,12,13,1,109.55153,18.28035,1715
12776,97975,FCFB14BA36BDB7CD6A39612B9AE933B2,31931,14,15,1,109.54771,18.29403,1667
12777,97976,FCFB14BA36BDB7CD6A39612B9AE933B2,38127,18,23,5,109.50833,18.27222,1513
12782,98003,5EE25A6E7DD554FFDA0C9C1A504114B7,30221,0,18,18,109.57833,18.20222,1802
12783,98004,5EE25A6E7DD554FFDA0C9C1A504114B7,60291,20,23,3,109.50826,18.24639,1509
12784,98013,C0CA4E58B15F58D7F48B8BEF10CEB35A,30891,0,5,5,109.59431,18.28389,1865
12785,98014,C0CA4E58B15F58D7F48B8BEF10CEB35A,60591,9,12,3,109.61118,18.21715,1904
12790,98050,D1A5E6081E70F748BFD3C6895B141C01,30661,0,4,4,109.37028,18.24361,1008
12791,98051,D1A5E6081E70F748BFD3C6895B141C01,60411,7,13,6,109.32514,18.30854,869
12792,98052,D1A5E6081E70F748BFD3C6895B141C01,30661,13,18,5,109.37028,18.24361,1008
12793,98053,D1A5E6081E70F748BFD3C6895B141C01,30901,19,20,1,109.27597,18.3134,670
12794,98062,FCF69C4EB20A61D7801C0D8953A36537,31071,0,6,6,109.58257,18.28458,1815
12795,98063,FCF69C4EB20A61D7801C0D8953A36537,30851,8,9,1,109.5616,18.27396,1713
12796,98064,FCF69C4EB20A61D7801C0D8953A36537,31071,11,13,2,109.58257,18.28458,1815
12797,98065,FCF69C4EB20A61D7801C0D8953A36537,30851,15,17,2,109.5616,18.27396,1713
12798,98066,FCF69C4EB20A61D7801C0D8953A36537,31071,18,22,4,109.58257,18.28458,1815
12799,98126,C58D0182BFC61ED113EE3B09763C30B2,38185,0,6,6,109.51333,18.27347,1563
12800,98127,C58D0182BFC61ED113EE3B09763C30B2,38127,9,13,4,109.50833,18.27222,1513
12801,98128,C58D0182BFC61ED113EE3B09763C30B2,30291,16,18,2,109.50403,18.27028,1513
12802,98129,C58D0182BFC61ED113EE3B09763C30B2,30281,18,19,1,109.50597,18.27583,1514
12803,98130,C58D0182BFC61ED113EE3B09763C30B2,38185,20,23,3,109.51333,18.27347,1563
12804,98156,079A114D194FE2EFB0C89059CA4EBC03,31251,0,4,4,109.18528,18.2975,317
12805,98158,079A114D194FE2EFB0C89059CA4EBC03,31251,15,19,4,109.18528,18.2975,317
12806,98167,E3C1178CAC9A3E9411032B65DEB10C88,31021,0,8,8,109.49021,18.27,1463
12807,98168,E3C1178CAC9A3E9411032B65DEB10C88,30171,8,13,5,109.48458,18.27139,1463
12808,98202,299097E06448608D5CB166194604D1AB,60401,0,6,6,109.47444,18.27583,1414
12809,98203,299097E06448608D5CB166194604D1AB,31031,8,9,1,109.49979,18.25382,1510
12810,98204,299097E06448608D5CB166194604D1AB,30241,12,13,1,109.26174,18.3275,622
12811,98213,2115670ECBCEFE4CA16C55F5204DF607,31761,0,5,5,109.60521,18.27965,1914
12812,98214,2115670ECBCEFE4CA16C55F5204DF607,30854,7,16,9,109.56889,18.27076,1763
12813,98250,A09B207C65A3863769CA2406970EB62C,31031,2,9,7,109.49979,18.25382,1510
12814,98251,A09B207C65A3863769CA2406970EB62C,60054,11,13,2,109.3016,18.31229,770
12815,98252,A09B207C65A3863769CA2406970EB62C,60381,17,21,4,109.5241,18.22458,1605
12816,98255,E649CF84A26278291AA1A5B5C5D01FCA,30854,1,15,14,109.56889,18.27076,1763
12817,98256,E649CF84A26278291AA1A5B5C5D01FCA,31561,17,18,1,109.56792,18.28479,1765
12818,98257,284AAA7F5DD511A2BA368F86EB7F7C95,30171,0,1,1,109.48458,18.27139,1463
12819,98258,284AAA7F5DD511A2BA368F86EB7F7C95,31021,4,6,2,109.49021,18.27,1463
12820,98277,9FF85E4A9ADF25BDF242774543CAC5B0,31251,1,16,15,109.18528,18.2975,317
12821,98278,9FF85E4A9ADF25BDF242774543CAC5B0,30781,17,18,1,109.3275,18.37847,881
12825,98330,66A967284CA30127D78C6190FA59CDE5,30931,15,16,1,109.55653,18.32722,1722
12826,98331,66A967284CA30127D78C6190FA59CDE5,31811,16,19,3,109.54201,18.31806,1671
12827,98346,6C0260646767B781577B5B8CE2471E51,38484,7,8,1,109.53028,18.31528,1620
12828,98347,6C0260646767B781577B5B8CE2471E51,38241,8,9,1,109.54111,18.30542,1669
12829,98348,6C0260646767B781577B5B8CE2471E51,38484,12,15,3,109.53028,18.31528,1620
12830,98377,23D7FC719D517701236EF9ECE32A2B81,31571,15,16,1,109.61563,18.23326,1957
12831,98378,23D7FC719D517701236EF9ECE32A2B81,31461,20,23,3,109.5091,18.25389,1510
12832,98381,8F6EA1C108FADA76A214A7ED71ECE3D1,30232,0,1,1,109.6191,18.31701,1971
12833,98382,8F6EA1C108FADA76A214A7ED71ECE3D1,39183,2,5,3,109.55542,18.28208,1715
12834,98383,8F6EA1C108FADA76A214A7ED71ECE3D1,30854,8,13,5,109.56889,18.27076,1763
12835,98418,A1C95B17C868D553635D99A0D1B2A324,39041,0,9,9,109.40021,18.29278,1117
12836,98419,A1C95B17C868D553635D99A0D1B2A324,31041,12,13,1,109.50278,18.23701,1507
12837,98420,A0680D5ED0E388BA19F0AA347FA69FA3,30361,18,20,2,109.50347,18.24,1508
12838,98421,A0680D5ED0E388BA19F0AA347FA69FA3,39091,20,23,3,109.50097,18.25222,1510
12839,98432,63B5E489F3503F8EC6E40A38F9D2117C,31951,11,14,3,109.52174,18.30299,1568
12840,98433,63B5E489F3503F8EC6E40A38F9D2117C,60361,15,16,1,109.51938,18.29681,1567
12841,98434,63B5E489F3503F8EC6E40A38F9D2117C,60171,20,22,2,109.51292,18.30694,1569
12842,98456,4BDDDFE5CA0514443B2B3ACDA26168C5,31551,15,16,1,109.55868,18.24222,1708
12843,98457,4BDDDFE5CA0514443B2B3ACDA26168C5,39183,19,20,1,109.55542,18.28208,1715
12844,98466,FAC035CAF00431CACD74AF53D18C4996,60011,1,6,5,109.48965,18.30222,1468
12845,98467,FAC035CAF00431CACD74AF53D18C4996,30111,7,10,3,109.47583,18.30542,1419
12846,98468,FAC035CAF00431CACD74AF53D18C4996,60011,12,13,1,109.48965,18.30222,1468
12847,98469,FAC035CAF00431CACD74AF53D18C4996,30764,14,18,4,109.45806,18.29486,1367
12848,98470,FAC035CAF00431CACD74AF53D18C4996,60011,19,23,4,109.48965,18.30222,1468
12849,98496,CFFDD1BF3134B9FDD71614F40E1DE0FD,31561,3,4,1,109.56792,18.28479,1765
12850,98497,CFFDD1BF3134B9FDD71614F40E1DE0FD,31071,4,10,6,109.58257,18.28458,1815
12851,98498,CFFDD1BF3134B9FDD71614F40E1DE0FD,30161,12,14,2,109.50042,18.24389,1508
12852,98499,CFFDD1BF3134B9FDD71614F40E1DE0FD,30421,15,16,1,109.50021,18.25861,1511
12853,98500,CFFDD1BF3134B9FDD71614F40E1DE0FD,31071,18,21,3,109.58257,18.28458,1815
12854,98504,CF23638AEC60DB02FD0EB5D279C2EB23,60054,13,15,2,109.3016,18.31229,770
12855,98505,CF23638AEC60DB02FD0EB5D279C2EB23,60401,19,20,1,109.47444,18.27583,1414
12856,98506,CF23638AEC60DB02FD0EB5D279C2EB23,60641,21,23,2,109.53854,18.2359,1657
12857,98524,075F360F88180B9A93BF11A5704B49F3,30961,16,17,1,109.74042,18.37903,2431
12858,98525,075F360F88180B9A93BF11A5704B49F3,31351,18,23,5,109.4959,18.28417,1465
12859,98528,31D00DA149ED0F3AB2E104B2D0E7E9F8,31931,14,16,2,109.54771,18.29403,1667
12860,98529,31D00DA149ED0F3AB2E104B2D0E7E9F8,31864,16,18,2,109.49014,18.28333,1465
12861,98530,31D00DA149ED0F3AB2E104B2D0E7E9F8,31761,21,23,2,109.60521,18.27965,1914
12862,98550,F2E4A1707C14AD7AF444AE9628A7C8BD,31531,17,18,1,109.49583,18.25972,1461
12863,98551,F2E4A1707C14AD7AF444AE9628A7C8BD,30711,19,21,2,109.50271,18.25347,1510
12864,98576,FE95B3A32EFBC2838F293DF38F55FDD1,39183,2,3,1,109.55542,18.28208,1715
12865,98577,FE95B3A32EFBC2838F293DF38F55FDD1,31931,6,8,2,109.54771,18.29403,1667
12866,98578,FE95B3A32EFBC2838F293DF38F55FDD1,31561,8,10,2,109.56792,18.28479,1765
12867,98579,FE95B3A32EFBC2838F293DF38F55FDD1,31931,14,16,2,109.54771,18.29403,1667
12868,98580,FE95B3A32EFBC2838F293DF38F55FDD1,31561,17,19,2,109.56792,18.28479,1765
12869,98607,FD9120CA3F85D3F015CEFB66B9BF2F3D,30721,0,6,6,109.51597,18.28257,1565
12870,98608,FD9120CA3F85D3F015CEFB66B9BF2F3D,60301,8,15,7,109.60715,18.30993,1919
12871,98609,FD9120CA3F85D3F015CEFB66B9BF2F3D,38291,19,21,2,109.51618,18.24313,1558
12872,98610,FD9120CA3F85D3F015CEFB66B9BF2F3D,30721,22,23,1,109.51597,18.28257,1565
12876,98662,E8BAAF476E8FE57075BAB1A8D4FF1780,30232,5,7,2,109.6191,18.31701,1971
12877,98663,E8BAAF476E8FE57075BAB1A8D4FF1780,30854,7,10,3,109.56889,18.27076,1763
12878,98664,E8BAAF476E8FE57075BAB1A8D4FF1780,30232,12,13,1,109.6191,18.31701,1971
12879,98665,E8BAAF476E8FE57075BAB1A8D4FF1780,30854,14,17,3,109.56889,18.27076,1763
12880,98666,E8BAAF476E8FE57075BAB1A8D4FF1780,60631,19,21,2,109.57778,18.27583,1814
12881,98727,408C4FED868686E7B96333835F4C4205,30854,0,11,11,109.56889,18.27076,1763
12882,98728,408C4FED868686E7B96333835F4C4205,31071,14,22,8,109.58257,18.28458,1815
12883,98803,2377954659CB8C9B4B8B2CCE299C9CD9,31431,9,10,1,109.44639,18.29042,1316
12884,98804,2377954659CB8C9B4B8B2CCE299C9CD9,31471,11,14,3,109.34583,18.29563,917
12885,98805,2377954659CB8C9B4B8B2CCE299C9CD9,31431,15,23,8,109.44639,18.29042,1316
12889,98840,9B979E9430BCD0DDB6C78BBE525EBD2D,30854,8,12,4,109.56889,18.27076,1763
12890,98841,9B979E9430BCD0DDB6C78BBE525EBD2D,60631,12,14,2,109.57778,18.27583,1814
12891,98842,9B979E9430BCD0DDB6C78BBE525EBD2D,30854,15,22,7,109.56889,18.27076,1763
12892,98848,E4C7AB656E412C7E33554D18277C9478,60201,20,21,1,109.5041,18.2509,1510
12893,98849,E4C7AB656E412C7E33554D18277C9478,30421,22,23,1,109.50021,18.25861,1511
12894,98862,C1793DCC823463513E28F999E76F9ADC,31471,13,18,5,109.34583,18.29563,917
12895,98863,C1793DCC823463513E28F999E76F9ADC,60054,19,23,4,109.3016,18.31229,770
12896,98941,CB5F007F76485F10B183BBAD16560B77,31521,0,7,7,109.51458,18.22542,1555
12897,98942,CB5F007F76485F10B183BBAD16560B77,30661,12,13,1,109.37028,18.24361,1008
12898,98943,CB5F007F76485F10B183BBAD16560B77,31521,17,20,3,109.51458,18.22542,1555
12899,98944,CB5F007F76485F10B183BBAD16560B77,31521,21,23,2,109.51458,18.22542,1555
12900,98961,7F632B4875B2736225CD6D350CD25670,31221,9,11,2,109.61333,18.26833,1913
12901,98962,7F632B4875B2736225CD6D350CD25670,30854,14,22,8,109.56889,18.27076,1763
12902,98966,7F632B4875B2736225CD6D350CD25670,31071,3,7,4,109.58257,18.28458,1815
12903,98967,7F632B4875B2736225CD6D350CD25670,30854,9,20,11,109.56889,18.27076,1763
12904,98972,145444E87E9AD1AA916406CE6DA79363,60594,14,16,2,109.62694,18.22799,1956
12905,98973,145444E87E9AD1AA916406CE6DA79363,38052,16,19,3,109.62618,18.23042,1956
12906,98974,145444E87E9AD1AA916406CE6DA79363,60594,22,23,1,109.62694,18.22799,1956
12913,99059,6E2CBF10F3FC7D7D7BBE8854343B165A,31521,2,12,10,109.51458,18.22542,1555
12914,99060,6E2CBF10F3FC7D7D7BBE8854343B165A,31521,17,23,6,109.51458,18.22542,1555
12915,99074,1CC4F70EB8D0B0448C9D518105647173,31561,1,7,6,109.56792,18.28479,1765
12916,99075,1CC4F70EB8D0B0448C9D518105647173,31071,8,11,3,109.58257,18.28458,1815
12917,99076,1CC4F70EB8D0B0448C9D518105647173,30421,13,14,1,109.50021,18.25861,1511
12918,99077,1CC4F70EB8D0B0448C9D518105647173,31561,18,20,2,109.56792,18.28479,1765
12919,99078,1CC4F70EB8D0B0448C9D518105647173,30854,21,23,2,109.56889,18.27076,1763
12920,99079,23AE593C8624C8825587FC4F2A6916C1,31081,0,7,7,109.44639,18.30181,1318
12924,99105,22CF7007721E0F1D863F25E4633BE1AD,60311,0,6,6,109.52097,18.24319,1558
12925,99106,22CF7007721E0F1D863F25E4633BE1AD,31151,8,10,2,109.75549,18.4191,2488
12926,99107,22CF7007721E0F1D863F25E4633BE1AD,31861,12,13,1,109.49042,18.27549,1464
12927,99108,22CF7007721E0F1D863F25E4633BE1AD,38291,14,16,2,109.51618,18.24313,1558
12928,99109,22CF7007721E0F1D863F25E4633BE1AD,30381,19,23,4,109.52521,18.24507,1609
12933,99200,CF1922E57BC1E2D5DC4336E820C48B77,30361,18,20,2,109.50347,18.24,1508
12934,99201,CF1922E57BC1E2D5DC4336E820C48B77,60411,22,23,1,109.32514,18.30854,869
12935,99208,066CC6CBB5ADF978A93AF5D0C3292806,60361,18,19,1,109.51938,18.29681,1567
12936,99209,066CC6CBB5ADF978A93AF5D0C3292806,31931,22,23,1,109.54771,18.29403,1667
12937,99218,0EA31DC24D5B7028E03AA286B0DB11EF,60631,8,9,1,109.57778,18.27583,1814
12938,99219,0EA31DC24D5B7028E03AA286B0DB11EF,31071,13,14,1,109.58257,18.28458,1815
12939,99220,0EA31DC24D5B7028E03AA286B0DB11EF,30854,15,16,1,109.56889,18.27076,1763
12940,99221,0EA31DC24D5B7028E03AA286B0DB11EF,60631,16,17,1,109.57778,18.27583,1814
12941,99222,0EA31DC24D5B7028E03AA286B0DB11EF,31071,20,21,1,109.58257,18.28458,1815
12942,99225,5D5B29A994BBA3635D38463A75BE58F6,30201,0,12,12,109.4909,18.26465,1462
12943,99226,5D5B29A994BBA3635D38463A75BE58F6,31471,13,17,4,109.34583,18.29563,917
12944,99227,5D5B29A994BBA3635D38463A75BE58F6,31206,21,22,1,109.50819,18.23549,1507
12945,99231,25BF6C9BAFD17B1DFC50AB9CDF5F4CEE,31821,20,23,3,109.51181,18.24924,1559
12946,99263,10B66D855AEA437CF12F1E3706E70AE7,31521,0,7,7,109.51458,18.22542,1555
12947,99264,10B66D855AEA437CF12F1E3706E70AE7,39111,8,10,2,109.5191,18.22597,1555
12948,99265,10B66D855AEA437CF12F1E3706E70AE7,31521,14,16,2,109.51458,18.22542,1555
12949,99266,10B66D855AEA437CF12F1E3706E70AE7,60291,18,19,1,109.50826,18.24639,1509
12950,99267,10B66D855AEA437CF12F1E3706E70AE7,60381,22,23,1,109.5241,18.22458,1605
12951,99295,B175A0347ABEEA30E818C5CCD25E280F,30821,0,15,15,109.43681,18.33639,1274
12952,99296,B175A0347ABEEA30E818C5CCD25E280F,30651,18,20,2,109.42611,18.385,1232
12956,99389,5BDB0B1B9F95859E0A3FF07772D3E435,39154,0,6,6,109.50201,18.25681,1511
12957,99390,5BDB0B1B9F95859E0A3FF07772D3E435,31931,8,10,2,109.54771,18.29403,1667
12958,99391,5BDB0B1B9F95859E0A3FF07772D3E435,39181,10,12,2,109.55153,18.28035,1715
12959,99392,5BDB0B1B9F95859E0A3FF07772D3E435,39181,13,15,2,109.55153,18.28035,1715
12960,99393,5BDB0B1B9F95859E0A3FF07772D3E435,39181,17,19,2,109.55153,18.28035,1715
12961,99394,7171A8398911756415ECFCDCF96F249B,30121,0,6,6,109.52861,18.27222,1613
12962,99395,7171A8398911756415ECFCDCF96F249B,31421,8,10,2,109.55382,18.22347,1705
12963,99396,7171A8398911756415ECFCDCF96F249B,30851,11,22,11,109.5616,18.27396,1713
12964,99409,246EF4D95FA494895EFB2D649512DAE7,60081,0,6,6,109.51097,18.22639,1556
12965,99411,246EF4D95FA494895EFB2D649512DAE7,61011,11,16,5,109.60653,18.19076,1900
12966,99413,246EF4D95FA494895EFB2D649512DAE7,60081,20,22,2,109.51097,18.22639,1556
12974,99487,E6546ADDD2155B08063BE71A9EAB8C5E,60401,0,3,3,109.47444,18.27583,1414
12975,99488,E6546ADDD2155B08063BE71A9EAB8C5E,31031,3,7,4,109.49979,18.25382,1510
12976,99489,E6546ADDD2155B08063BE71A9EAB8C5E,38251,8,10,2,109.49618,18.25493,1510
12977,99490,E6546ADDD2155B08063BE71A9EAB8C5E,33101,11,12,1,109.68438,18.44368,2242
12978,99491,E6546ADDD2155B08063BE71A9EAB8C5E,38251,15,16,1,109.49618,18.25493,1510
12979,99492,E6546ADDD2155B08063BE71A9EAB8C5E,30711,17,19,2,109.50271,18.25347,1510
12980,99602,45FA8AF959A216E06C82392E21728E7F,31071,0,4,4,109.58257,18.28458,1815
12981,99603,45FA8AF959A216E06C82392E21728E7F,31561,5,6,1,109.56792,18.28479,1765
12982,99604,45FA8AF959A216E06C82392E21728E7F,30851,9,10,1,109.5616,18.27396,1713
12983,99605,45FA8AF959A216E06C82392E21728E7F,31561,13,18,5,109.56792,18.28479,1765
12984,99606,45FA8AF959A216E06C82392E21728E7F,30851,20,21,1,109.5616,18.27396,1713
12985,99647,D4EE8E1A4C04A1FF0596E4221D0B8B42,31071,0,7,7,109.58257,18.28458,1815
12986,99648,D4EE8E1A4C04A1FF0596E4221D0B8B42,30854,9,22,13,109.56889,18.27076,1763
12993,99700,45FC4D7B7AEB1BB8222449DDC064C06B,30854,7,9,2,109.56889,18.27076,1763
12994,99701,45FC4D7B7AEB1BB8222449DDC064C06B,31945,9,11,2,109.58021,18.29403,1817
12995,99702,45FC4D7B7AEB1BB8222449DDC064C06B,39091,13,15,2,109.50097,18.25222,1510
12996,99703,45FC4D7B7AEB1BB8222449DDC064C06B,31945,18,23,5,109.58021,18.29403,1817
12997,99717,97CE5C717545A1CABCE7AAB167BFAFA3,31521,0,9,9,109.51458,18.22542,1555
12998,99718,97CE5C717545A1CABCE7AAB167BFAFA3,38951,10,12,2,109.48097,18.28868,1416
12999,99719,97CE5C717545A1CABCE7AAB167BFAFA3,38951,12,15,3,109.48097,18.28868,1416
13000,99720,97CE5C717545A1CABCE7AAB167BFAFA3,60221,16,18,2,109.52569,18.29188,1616
13001,99721,97CE5C717545A1CABCE7AAB167BFAFA3,38951,21,23,2,109.48097,18.28868,1416
13002,99733,8CF08DEE8EF83AC7333B837D79034776,38171,1,6,5,109.50799,18.28139,1515
13003,99735,8CF08DEE8EF83AC7333B837D79034776,30721,18,23,5,109.51597,18.28257,1565
13007,99794,6733B324E753B6172A50174A4CB1E5C2,31251,0,4,4,109.18528,18.2975,317
13008,99796,6733B324E753B6172A50174A4CB1E5C2,31251,11,17,6,109.18528,18.2975,317
13009,99827,60089DFF68909103D9A6D1DCB7C683F5,31864,12,13,1,109.49014,18.28333,1465
13010,99880,B55755EE77AAB7159A5530B30083F834,60411,0,1,1,109.32514,18.30854,869
13011,99881,B55755EE77AAB7159A5530B30083F834,30661,2,4,2,109.37028,18.24361,1008
13012,99882,B55755EE77AAB7159A5530B30083F834,31471,4,7,3,109.34583,18.29563,917
13013,99883,B55755EE77AAB7159A5530B30083F834,30661,8,13,5,109.37028,18.24361,1008
13014,99886,C17F2EF1DEA79C8C951E3013EE071B2C,31071,2,8,6,109.58257,18.28458,1815
13015,99887,C17F2EF1DEA79C8C951E3013EE071B2C,60421,8,9,1,109.46333,18.31743,1371
13016,99888,C17F2EF1DEA79C8C951E3013EE071B2C,31071,10,15,5,109.58257,18.28458,1815
13017,99919,D91289410D46E2838A7CD67AF8E32DCF,39091,16,18,2,109.50097,18.25222,1510
13018,99920,D91289410D46E2838A7CD67AF8E32DCF,38185,18,23,5,109.51333,18.27347,1563
13019,99983,A9C7C0A15D485E40B43093FA63B4F0D5,31521,0,8,8,109.51458,18.22542,1555
13023,100010,6B56111B79E5EDEBB9E11EFC0935D50B,60131,0,7,7,109.49819,18.24778,1509
13024,100011,6B56111B79E5EDEBB9E11EFC0935D50B,31781,9,12,3,109.19847,18.2975,367
13025,100012,6B56111B79E5EDEBB9E11EFC0935D50B,31031,16,20,4,109.49979,18.25382,1510
13026,100013,6B56111B79E5EDEBB9E11EFC0935D50B,60131,20,23,3,109.49819,18.24778,1509
13027,100063,A5CE8EC163B2D3DFB2CA8F669B7180D4,31531,14,15,1,109.49583,18.25972,1461
13028,100064,A5CE8EC163B2D3DFB2CA8F669B7180D4,31861,16,17,1,109.49042,18.27549,1464
13029,100065,A5CE8EC163B2D3DFB2CA8F669B7180D4,30151,18,23,5,109.50986,18.25083,1560
13037,100094,93A3718C0EC450CC77C4756F930E9D7C,39151,7,9,2,109.49875,18.25097,1510
13038,100095,93A3718C0EC450CC77C4756F930E9D7C,60161,9,10,1,109.49174,18.26181,1461
13039,100096,93A3718C0EC450CC77C4756F930E9D7C,38251,10,12,2,109.49618,18.25493,1510
13040,100097,93A3718C0EC450CC77C4756F930E9D7C,60401,17,19,2,109.47444,18.27583,1414
13041,100098,93A3718C0EC450CC77C4756F930E9D7C,60291,20,21,1,109.50826,18.24639,1509
13042,100160,F6A539AAED9AF63EFFEF4F07EA46DEF3,60054,14,16,2,109.3016,18.31229,770
13043,100161,F6A539AAED9AF63EFFEF4F07EA46DEF3,60621,21,23,2,109.48354,18.27451,1464
13044,100162,BE7763F8096EB5A037146E1CC4190538,30854,20,21,1,109.56889,18.27076,1763
13045,100163,BE7763F8096EB5A037146E1CC4190538,31561,21,23,2,109.56792,18.28479,1765
13046,100168,E8BE10EF1C0A6A216F7B6C008ED029A8,60371,0,8,8,109.53063,18.30056,1618
13047,100169,E8BE10EF1C0A6A216F7B6C008ED029A8,31571,9,10,1,109.61563,18.23326,1957
13048,100170,E8BE10EF1C0A6A216F7B6C008ED029A8,38991,12,13,1,109.52681,18.30368,1618
13049,100171,E8BE10EF1C0A6A216F7B6C008ED029A8,60226,17,18,1,109.5175,18.28778,1566
13050,100172,E8BE10EF1C0A6A216F7B6C008ED029A8,38251,19,21,2,109.49618,18.25493,1510
13051,100177,5A52D514A004C406B3CAF14D74C40F10,30461,13,17,4,109.5116,18.26313,1562
13052,100178,85C1BD53669C6AB80E634D25EC9D5396,30711,17,18,1,109.50271,18.25347,1510
13053,100179,85C1BD53669C6AB80E634D25EC9D5396,30711,21,23,2,109.50271,18.25347,1510
13054,100191,B76381FBDC68F2B2041DDEC63195F0A7,39181,11,18,7,109.55153,18.28035,1715
13055,100192,B76381FBDC68F2B2041DDEC63195F0A7,39181,19,21,2,109.55153,18.28035,1715
13056,100193,B76381FBDC68F2B2041DDEC63195F0A7,31931,21,22,1,109.54771,18.29403,1667
13057,100245,8B3125BACE32612AE7F9DC5599DC75E6,31521,0,7,7,109.51458,18.22542,1555
13058,100246,8B3125BACE32612AE7F9DC5599DC75E6,30661,9,17,8,109.37028,18.24361,1008
13059,100247,8B3125BACE32612AE7F9DC5599DC75E6,60081,18,23,5,109.51097,18.22639,1556
13060,100313,F3E280D806C0279BCC08880D6A71DAC7,31031,20,21,1,109.49979,18.25382,1510
13061,100314,F3E280D806C0279BCC08880D6A71DAC7,60621,22,23,1,109.48354,18.27451,1464
13062,100319,D34A34E9CA4518B994A07E07D99BC875,31471,12,14,2,109.34583,18.29563,917
13063,100320,D34A34E9CA4518B994A07E07D99BC875,60054,14,15,1,109.3016,18.31229,770
13064,100321,D34A34E9CA4518B994A07E07D99BC875,31231,18,19,1,109.42597,18.29292,1217
13065,100322,D34A34E9CA4518B994A07E07D99BC875,30351,20,23,3,109.41701,18.29292,1217
13066,100325,EB316856896788EC8FD871E122E95728,30931,0,6,6,109.55653,18.32722,1722
13067,100326,EB316856896788EC8FD871E122E95728,31811,11,12,1,109.54201,18.31806,1671
13068,100327,EB316856896788EC8FD871E122E95728,30701,12,16,4,109.59313,18.32007,1871
13069,100328,EB316856896788EC8FD871E122E95728,31811,17,18,1,109.54201,18.31806,1671
13070,100329,EB316856896788EC8FD871E122E95728,30701,19,20,1,109.59313,18.32007,1871
13071,100334,8F3DE08315D720DC64DC898C5903196E,30854,6,15,9,109.56889,18.27076,1763
13072,100335,8F3DE08315D720DC64DC898C5903196E,60631,17,18,1,109.57778,18.27583,1814
13079,100404,3C6C31F30579C628F9EDFADEE409AE9F,60241,14,15,1,109.53319,18.28667,1616
13080,100405,3C6C31F30579C628F9EDFADEE409AE9F,30071,17,18,1,109.52819,18.30472,1619
13081,100406,3C6C31F30579C628F9EDFADEE409AE9F,30711,18,21,3,109.50271,18.25347,1510
13082,100491,5D06B39D1C4AAC35B6AB826D6203C7C7,31031,12,14,2,109.49979,18.25382,1510
13083,100492,5D06B39D1C4AAC35B6AB826D6203C7C7,60401,16,17,1,109.47444,18.27583,1414
13084,100493,5D06B39D1C4AAC35B6AB826D6203C7C7,31031,18,20,2,109.49979,18.25382,1510
13085,100494,5D06B39D1C4AAC35B6AB826D6203C7C7,60401,21,23,2,109.47444,18.27583,1414
13090,100544,632A9EB46E40EB8DE8C99AAD5A0CDFB2,30221,0,13,13,109.57833,18.20222,1802
13091,100545,632A9EB46E40EB8DE8C99AAD5A0CDFB2,30854,14,15,1,109.56889,18.27076,1763
13092,100546,632A9EB46E40EB8DE8C99AAD5A0CDFB2,30221,18,23,5,109.57833,18.20222,1802
13093,100570,8EA475D017A01807E97E34F719EA95E4,30361,12,14,2,109.50347,18.24,1508
13094,100571,8EA475D017A01807E97E34F719EA95E4,38315,15,17,2,109.48979,18.29764,1467
13101,100602,34A1BA5A97F90C4ABB34EDC7004774A9,30851,0,17,17,109.5616,18.27396,1713
13102,100603,34A1BA5A97F90C4ABB34EDC7004774A9,39371,19,21,2,109.56627,18.2646,1762
13103,100612,5A848609D5F7F3D6FA074D3A44427904,30671,0,7,7,109.43611,18.30139,1268
13104,100613,5A848609D5F7F3D6FA074D3A44427904,30321,7,9,2,109.49563,18.29611,1467
13105,100633,4C18D34133535C99A4487BE59B40CD43,31421,0,7,7,109.55382,18.22347,1705
13106,100634,4C18D34133535C99A4487BE59B40CD43,31781,9,11,2,109.19847,18.2975,367
13107,100635,4C18D34133535C99A4487BE59B40CD43,31471,14,15,1,109.34583,18.29563,917
13108,100688,92F9F53206FAF7EB9CC354C3DBB7190F,38212,0,8,8,109.48889,18.26306,1462
13109,100689,92F9F53206FAF7EB9CC354C3DBB7190F,30851,11,13,2,109.5616,18.27396,1713
13110,100690,92F9F53206FAF7EB9CC354C3DBB7190F,31561,14,15,1,109.56792,18.28479,1765
13111,100691,92F9F53206FAF7EB9CC354C3DBB7190F,30361,19,20,1,109.50347,18.24,1508
13112,100692,92F9F53206FAF7EB9CC354C3DBB7190F,38212,21,23,2,109.48889,18.26306,1462
13116,100718,0607630771850E9B096589D3130ADE6B,60631,18,19,1,109.57778,18.27583,1814
13117,100728,ACDEAAF45B65DE48CF80A48DBD3C775E,30854,10,21,11,109.56889,18.27076,1763
13118,100729,ACDEAAF45B65DE48CF80A48DBD3C775E,31071,21,23,2,109.58257,18.28458,1815
13119,100734,CA0CAB48AE6A9854AFA11ACF88A2CB9C,30281,16,17,1,109.50597,18.27583,1514
13120,100735,CA0CAB48AE6A9854AFA11ACF88A2CB9C,30281,20,23,3,109.50597,18.27583,1514
13121,100744,A0F32304B8707E330B50C46F2DA1FB4F,31561,1,6,5,109.56792,18.28479,1765
13122,100745,A0F32304B8707E330B50C46F2DA1FB4F,30854,7,9,2,109.56889,18.27076,1763
13123,100778,3ED95B3B7DE39D1CC7F37C685EFCA5A0,31781,10,11,1,109.19847,18.2975,367
13124,100779,3ED95B3B7DE39D1CC7F37C685EFCA5A0,31471,15,16,1,109.34583,18.29563,917
13125,100780,3ED95B3B7DE39D1CC7F37C685EFCA5A0,60381,19,21,2,109.5241,18.22458,1605
13126,100781,3ED95B3B7DE39D1CC7F37C685EFCA5A0,31521,21,23,2,109.51458,18.22542,1555
13127,100799,7B1A07C39637E996C01DF0A3D287D3C6,30854,14,17,3,109.56889,18.27076,1763
13128,100800,7B1A07C39637E996C01DF0A3D287D3C6,31071,21,22,1,109.58257,18.28458,1815
13129,100803,DB4DF566D4757FF3BB488F82DE126248,31561,4,7,3,109.56792,18.28479,1765
13130,100804,DB4DF566D4757FF3BB488F82DE126248,30851,7,9,2,109.5616,18.27396,1713
13131,100805,DB4DF566D4757FF3BB488F82DE126248,31561,11,12,1,109.56792,18.28479,1765
13132,100806,DB4DF566D4757FF3BB488F82DE126248,30851,17,18,1,109.5616,18.27396,1713
13133,100807,DB4DF566D4757FF3BB488F82DE126248,60117,20,22,2,109.73604,18.35681,2427
13134,100827,0312B43ACF9ED1D8304E325E851AEE29,30851,11,13,2,109.5616,18.27396,1713
13135,100828,0312B43ACF9ED1D8304E325E851AEE29,31561,14,16,2,109.56792,18.28479,1765
13136,100829,0312B43ACF9ED1D8304E325E851AEE29,30851,16,17,1,109.5616,18.27396,1713
13137,100830,0312B43ACF9ED1D8304E325E851AEE29,31561,17,20,3,109.56792,18.28479,1765
13141,100893,67D30B307FD4639F5D7DA8C23EB3E033,60291,19,20,1,109.50826,18.24639,1509
13142,100943,09390A13C8E5C15C1E5674E3DB9139EC,60201,8,10,2,109.5041,18.2509,1510
13143,100944,09390A13C8E5C15C1E5674E3DB9139EC,30711,13,20,7,109.50271,18.25347,1510
13144,101053,4F877A4B395C9E22C3B85958392F2EAB,30381,18,20,2,109.52521,18.24507,1609
13145,101054,4F877A4B395C9E22C3B85958392F2EAB,31181,21,23,2,109.50382,18.24813,1509
13156,101097,554561FEA364578E822ED5561D209EEA,30221,0,13,13,109.57833,18.20222,1802
13157,101098,554561FEA364578E822ED5561D209EEA,30854,14,15,1,109.56889,18.27076,1763
13158,101099,554561FEA364578E822ED5561D209EEA,30221,18,23,5,109.57833,18.20222,1802
13159,101100,0878243E331032B9659EF30304C4F81B,30151,0,8,8,109.50986,18.25083,1560
13160,101101,0878243E331032B9659EF30304C4F81B,60054,9,10,1,109.3016,18.31229,770
13161,101102,0878243E331032B9659EF30304C4F81B,30661,12,14,2,109.37028,18.24361,1008
13162,101103,0878243E331032B9659EF30304C4F81B,60201,19,21,2,109.5041,18.2509,1510
13163,101104,0878243E331032B9659EF30304C4F81B,30151,21,23,2,109.50986,18.25083,1560
13167,101146,6B806948BC9187A91D033B4096721B00,31071,13,20,7,109.58257,18.28458,1815
13168,101147,6B806948BC9187A91D033B4096721B00,31561,21,22,1,109.56792,18.28479,1765
13169,101148,DE5024DB59D5BF6AE5857A85EB7680EA,30854,11,13,2,109.56889,18.27076,1763
13170,101149,DE5024DB59D5BF6AE5857A85EB7680EA,60631,13,15,2,109.57778,18.27583,1814
13171,101150,DE5024DB59D5BF6AE5857A85EB7680EA,30854,18,20,2,109.56889,18.27076,1763
13172,101163,7B6FDF5112B5C4A0BB0F3BA724E8ED45,60081,17,19,2,109.51097,18.22639,1556
13173,101164,7B6FDF5112B5C4A0BB0F3BA724E8ED45,31236,20,23,3,109.42965,18.29111,1216
13177,101192,5A7A3D5F722F0EB2695C45BF16BBC483,38157,0,7,7,109.51483,18.26958,1563
13178,101193,5A7A3D5F722F0EB2695C45BF16BBC483,60661,8,10,2,109.548,18.2377,1657
13179,101194,5A7A3D5F722F0EB2695C45BF16BBC483,38271,14,15,1,109.62632,18.23049,1956
13180,101195,5A7A3D5F722F0EB2695C45BF16BBC483,30861,17,19,2,109.52722,18.22743,1606
13181,101196,5A7A3D5F722F0EB2695C45BF16BBC483,31206,20,22,2,109.50819,18.23549,1507
13182,101250,2183AF5A97756EB05E1459D1CE0BD7C7,38251,19,21,2,109.49618,18.25493,1510
13183,101251,2183AF5A97756EB05E1459D1CE0BD7C7,60371,22,23,1,109.53063,18.30056,1618
13184,101263,D85BA1E720DE38375E6105B94C5C6FB9,30771,0,13,13,109.49938,18.26042,1511
13185,101264,D85BA1E720DE38375E6105B94C5C6FB9,39321,13,16,3,109.529,18.2167,1604
13186,101265,D85BA1E720DE38375E6105B94C5C6FB9,31671,17,18,1,109.38965,18.29813,1068
13187,101266,D85BA1E720DE38375E6105B94C5C6FB9,60541,18,20,2,109.4084,18.29208,1167
13188,101299,149F44702DEC8C73589BE6524F0A1FFD,30854,2,20,18,109.56889,18.27076,1763
13189,101300,149F44702DEC8C73589BE6524F0A1FFD,39183,20,22,2,109.55542,18.28208,1715
13190,101339,DD9F75DC35C7510FCB052A20368D2852,60381,13,15,2,109.5241,18.22458,1605
13191,101340,DD9F75DC35C7510FCB052A20368D2852,31091,19,20,1,109.41201,18.31222,1170
13192,101354,36ECFE49831F53ABE6FBD1CCA4C1DFA7,60391,0,2,2,109.47667,18.28757,1416
13193,101355,36ECFE49831F53ABE6FBD1CCA4C1DFA7,60391,3,9,6,109.47667,18.28757,1416
13194,101364,01FF2C535995B14A04DDA79B1FD40766,38903,0,1,1,109.39229,18.29243,1117
13195,101365,01FF2C535995B14A04DDA79B1FD40766,38145,2,4,2,109.378,18.2912,1066
13196,101366,01FF2C535995B14A04DDA79B1FD40766,31081,8,10,2,109.44639,18.30181,1318
13197,101367,01FF2C535995B14A04DDA79B1FD40766,31101,13,16,3,109.65389,18.23403,2057
13201,101417,0D23DA79DAEC5FDA0A3AFC440101E568,31231,0,7,7,109.42597,18.29292,1217
13202,101418,0D23DA79DAEC5FDA0A3AFC440101E568,31781,11,14,3,109.19847,18.2975,367
13206,101431,DCF02478AC5ACC5C3190CEB09210F280,60361,15,18,3,109.51938,18.29681,1567
13207,101432,DCF02478AC5ACC5C3190CEB09210F280,31351,19,23,4,109.4959,18.28417,1465
13208,101471,01C3A40E8C2D18FB80BE4CD2C78B4B61,39091,13,16,3,109.50097,18.25222,1510
13209,101472,01C3A40E8C2D18FB80BE4CD2C78B4B61,39091,20,23,3,109.50097,18.25222,1510
13210,101484,7B596B6BEF2AFA6C9AB0582C35D0C3A4,30361,20,22,2,109.50347,18.24,1508
13211,101510,F7F87EAB6A1C95FDC3321C58C5D1E097,60281,13,16,3,109.51743,18.25924,1561
13212,101515,73E2E1BE5471172391E67FF4D9056766,60231,0,1,1,109.49903,18.21972,1504
13213,101516,73E2E1BE5471172391E67FF4D9056766,30051,5,6,1,109.48917,18.21215,1453
13214,101517,73E2E1BE5471172391E67FF4D9056766,39301,8,10,2,109.48361,18.21153,1453
13215,101518,73E2E1BE5471172391E67FF4D9056766,60054,12,14,2,109.3016,18.31229,770
13216,101570,66290D92C6D91C5C0C9CFEAA9F85388C,31071,1,8,7,109.58257,18.28458,1815
13217,101571,66290D92C6D91C5C0C9CFEAA9F85388C,30854,9,11,2,109.56889,18.27076,1763
13218,101572,66290D92C6D91C5C0C9CFEAA9F85388C,30421,12,13,1,109.50021,18.25861,1511
13219,101573,66290D92C6D91C5C0C9CFEAA9F85388C,30854,15,17,2,109.56889,18.27076,1763
13220,101574,66290D92C6D91C5C0C9CFEAA9F85388C,30891,18,21,3,109.59431,18.28389,1865
13221,101575,66290D92C6D91C5C0C9CFEAA9F85388C,30854,21,23,2,109.56889,18.27076,1763
13222,101585,F925AC8C169C2BA20A1C0DA2437ACAA9,30854,8,9,1,109.56889,18.27076,1763
13223,101586,F925AC8C169C2BA20A1C0DA2437ACAA9,39371,10,23,13,109.56627,18.2646,1762
13231,101624,B55112D1732F2CB737866DB64BBAC4BE,60054,13,15,2,109.3016,18.31229,770
13232,101625,B55112D1732F2CB737866DB64BBAC4BE,30731,19,23,4,109.50944,18.22306,1555
13233,101627,38670F0FEE8D96783B5FC6DF69F10DA0,31145,12,13,1,109.20431,18.30479,369
13234,101628,38670F0FEE8D96783B5FC6DF69F10DA0,31534,15,16,1,109.49368,18.25806,1461
13235,101629,38670F0FEE8D96783B5FC6DF69F10DA0,31534,18,23,5,109.49368,18.25806,1461
13236,101675,0E129C09250C0D46273B4BD7E5225556,30771,0,7,7,109.49938,18.26042,1511
13237,101676,0E129C09250C0D46273B4BD7E5225556,60201,8,10,2,109.5041,18.2509,1510
13238,101677,0E129C09250C0D46273B4BD7E5225556,31303,12,15,3,109.15826,18.29549,217
13239,101694,A2D836A887588298B0C011C476E5DB59,38951,2,9,7,109.48097,18.28868,1416
13240,101695,A2D836A887588298B0C011C476E5DB59,30361,10,12,2,109.50347,18.24,1508
13241,101696,A2D836A887588298B0C011C476E5DB59,38951,12,23,11,109.48097,18.28868,1416
13242,101706,01BB30E777A61FC32E55053983D0DA10,30661,13,15,2,109.37028,18.24361,1008
13243,101707,01BB30E777A61FC32E55053983D0DA10,60411,19,22,3,109.32514,18.30854,869
13244,101708,28A014E28BF177F21531ACBF364A202D,31471,0,7,7,109.34583,18.29563,917
13245,101709,28A014E28BF177F21531ACBF364A202D,60201,9,10,1,109.5041,18.2509,1510
13246,101715,5D256FA5279A932380FCBD0E1600B3E5,31864,0,7,7,109.49014,18.28333,1465
13247,101716,5D256FA5279A932380FCBD0E1600B3E5,30791,12,17,5,109.72333,18.40889,2386
13248,101717,5D256FA5279A932380FCBD0E1600B3E5,30771,20,22,2,109.49938,18.26042,1511
13249,101718,5D256FA5279A932380FCBD0E1600B3E5,31864,22,23,1,109.49014,18.28333,1465
13250,101732,90E761563218966BF6DD1FD6E24DA0E3,60321,0,10,10,109.63611,18.24306,2008
13251,101736,90E761563218966BF6DD1FD6E24DA0E3,60321,21,23,2,109.63611,18.24306,2008
13252,101742,65DB2325B6E1E7A0D88A5D2D920F9EA1,31081,0,3,3,109.44639,18.30181,1318
13253,101743,65DB2325B6E1E7A0D88A5D2D920F9EA1,60552,6,9,3,109.41729,18.30014,1218
13254,101744,65DB2325B6E1E7A0D88A5D2D920F9EA1,30821,13,17,4,109.43681,18.33639,1274
13255,101745,65DB2325B6E1E7A0D88A5D2D920F9EA1,30671,19,20,1,109.43611,18.30139,1268
13256,101746,65DB2325B6E1E7A0D88A5D2D920F9EA1,30761,20,22,2,109.45201,18.3,1318
13257,101757,44CB5F545D2E3587ACF209AB2414C1A1,31071,0,7,7,109.58257,18.28458,1815
13258,101758,44CB5F545D2E3587ACF209AB2414C1A1,30854,11,12,1,109.56889,18.27076,1763
13259,101759,44CB5F545D2E3587ACF209AB2414C1A1,31071,16,18,2,109.58257,18.28458,1815
13260,101760,44CB5F545D2E3587ACF209AB2414C1A1,31061,19,20,1,109.53333,18.23257,1607
13261,101764,C709D01469E0800AF998DFAF42105CDC,31561,9,15,6,109.56792,18.28479,1765
13262,101765,C709D01469E0800AF998DFAF42105CDC,30854,17,19,2,109.56889,18.27076,1763
13263,101769,FE1EC0E71A7AFD40F1435A5CA011EA80,30111,0,1,1,109.47583,18.30542,1419
13264,101770,FE1EC0E71A7AFD40F1435A5CA011EA80,60671,2,6,4,109.52979,18.31757,1621
13265,101771,FE1EC0E71A7AFD40F1435A5CA011EA80,30111,7,9,2,109.47583,18.30542,1419
13266,101772,FE1EC0E71A7AFD40F1435A5CA011EA80,31101,11,14,3,109.65389,18.23403,2057
13267,101773,FE1EC0E71A7AFD40F1435A5CA011EA80,31031,15,17,2,109.49979,18.25382,1510
13268,101774,FE1EC0E71A7AFD40F1435A5CA011EA80,38094,17,22,5,109.45403,18.28778,1316
13269,101775,FE1EC0E71A7AFD40F1435A5CA011EA80,30111,22,23,1,109.47583,18.30542,1419
13276,101831,93715618B304E009FF2F157425BB5843,60504,0,6,6,109.47917,18.28903,1416
13277,101832,93715618B304E009FF2F157425BB5843,38951,8,14,6,109.48097,18.28868,1416
13278,101833,93715618B304E009FF2F157425BB5843,30421,16,18,2,109.50021,18.25861,1511
13279,101834,93715618B304E009FF2F157425BB5843,38171,19,20,1,109.50799,18.28139,1515
13280,101835,93715618B304E009FF2F157425BB5843,60504,20,23,3,109.47917,18.28903,1416
13281,101858,0E5593A90D661690BE3DAAA17AD936E2,38127,1,3,2,109.50833,18.27222,1513
13282,101859,0E5593A90D661690BE3DAAA17AD936E2,30281,4,7,3,109.50597,18.27583,1514
13283,101860,0E5593A90D661690BE3DAAA17AD936E2,31801,9,12,3,109.20417,18.32118,371
13284,101861,0E5593A90D661690BE3DAAA17AD936E2,38127,14,23,9,109.50833,18.27222,1513
13285,101877,E8477DE34FB2A9C1B10F75E5CA292C71,60311,0,7,7,109.52097,18.24319,1558
13286,101878,E8477DE34FB2A9C1B10F75E5CA292C71,31931,8,16,8,109.54771,18.29403,1667
13287,101884,07FD145FE6C81328C98C6C5C8452E794,30854,1,8,7,109.56889,18.27076,1763
13288,101885,07FD145FE6C81328C98C6C5C8452E794,39371,13,18,5,109.56627,18.2646,1762
13289,101886,07FD145FE6C81328C98C6C5C8452E794,30232,19,22,3,109.6191,18.31701,1971
13294,101891,529A14F498129B0238F7B12A9FC7F6F7,39101,14,17,3,109.50132,18.24931,1509
13295,101892,529A14F498129B0238F7B12A9FC7F6F7,31411,18,19,1,109.5016,18.23576,1507
13296,101893,529A14F498129B0238F7B12A9FC7F6F7,60381,22,23,1,109.5241,18.22458,1605
13297,101895,EE70B470BE9E6D12149AAA71474AD3EA,60551,19,20,1,109.42722,18.30111,1218
13298,101934,8FAAC7EA21AE7BB6F52A4D0F285944CD,38721,0,8,8,109.50368,18.27542,1514
13299,101935,8FAAC7EA21AE7BB6F52A4D0F285944CD,30051,10,11,1,109.48917,18.21215,1453
13300,101936,8FAAC7EA21AE7BB6F52A4D0F285944CD,30281,12,13,1,109.50597,18.27583,1514
13301,101937,8FAAC7EA21AE7BB6F52A4D0F285944CD,30051,17,19,2,109.48917,18.21215,1453
13302,101938,8FAAC7EA21AE7BB6F52A4D0F285944CD,60463,19,20,1,109.52507,18.22438,1605
13303,101939,8FAAC7EA21AE7BB6F52A4D0F285944CD,30281,21,23,2,109.50597,18.27583,1514
13304,101940,807F73DE76DFE56E472FA61396F0887C,31461,0,7,7,109.5091,18.25389,1510
13308,101951,9C692D39B6FC0B82D57A48E7E89CEB65,31521,14,17,3,109.51458,18.22542,1555
13309,101952,9C692D39B6FC0B82D57A48E7E89CEB65,60381,20,23,3,109.5241,18.22458,1605
13310,101960,EACA311BE126BD9A58956463BF0B58C2,30631,0,9,9,109.34382,18.32778,922
13311,101961,EACA311BE126BD9A58956463BF0B58C2,31691,10,11,1,109.36604,18.3075,1019
13312,101962,EACA311BE126BD9A58956463BF0B58C2,30631,12,15,3,109.34382,18.32778,922
13313,101963,EACA311BE126BD9A58956463BF0B58C2,31691,15,18,3,109.36604,18.3075,1019
13314,101964,EACA311BE126BD9A58956463BF0B58C2,30631,19,20,1,109.34382,18.32778,922
13315,101965,EACA311BE126BD9A58956463BF0B58C2,60201,21,23,2,109.5041,18.2509,1510
13316,101969,866460FA5062A635337B6369BB2AADDA,39183,4,5,1,109.55542,18.28208,1715
13317,101970,866460FA5062A635337B6369BB2AADDA,30854,6,17,11,109.56889,18.27076,1763
13318,101980,0BAC26B2F5D5282A940EADE88973B981,30854,0,8,8,109.56889,18.27076,1763
13319,101981,0BAC26B2F5D5282A940EADE88973B981,30731,11,17,6,109.50944,18.22306,1555
13329,102061,8DC3C0D11AFCC61DD6CB6DBA295B4AE4,30711,11,15,4,109.50271,18.25347,1510
13330,102062,8DC3C0D11AFCC61DD6CB6DBA295B4AE4,31521,15,20,5,109.51458,18.22542,1555
13338,102155,903541A899A8579F62DD9230101F46FC,31521,0,8,8,109.51458,18.22542,1555
13339,102156,903541A899A8579F62DD9230101F46FC,38951,10,11,1,109.48097,18.28868,1416
13340,102157,903541A899A8579F62DD9230101F46FC,38951,11,14,3,109.48097,18.28868,1416
13341,102158,903541A899A8579F62DD9230101F46FC,60221,15,19,4,109.52569,18.29188,1616
13342,102159,903541A899A8579F62DD9230101F46FC,38951,20,23,3,109.48097,18.28868,1416
13343,102195,D1B09D14086A317457A98E1E3E3BED6B,39181,0,14,14,109.55153,18.28035,1715
13344,102196,D1B09D14086A317457A98E1E3E3BED6B,39181,15,23,8,109.55153,18.28035,1715
13348,102251,051FE6263045C46039F2A055A3D59821,30361,16,17,1,109.50347,18.24,1508
13349,102252,051FE6263045C46039F2A055A3D59821,38951,19,21,2,109.48097,18.28868,1416
13350,102253,051FE6263045C46039F2A055A3D59821,38951,21,22,1,109.48097,18.28868,1416
13372,102414,DE752C5E8A13F8A5D5BD49C4D2C8009D,38881,0,18,18,109.51618,18.26431,1562
13373,102415,DE752C5E8A13F8A5D5BD49C4D2C8009D,31031,20,21,1,109.49979,18.25382,1510
13374,102416,87ADC98470D754E65D1F229228B379D5,30854,4,6,2,109.56889,18.27076,1763
13375,102417,87ADC98470D754E65D1F229228B379D5,30851,7,8,1,109.5616,18.27396,1713
13376,102418,87ADC98470D754E65D1F229228B379D5,39183,10,12,2,109.55542,18.28208,1715
13377,102419,87ADC98470D754E65D1F229228B379D5,31561,15,16,1,109.56792,18.28479,1765
13378,102420,87ADC98470D754E65D1F229228B379D5,39183,16,18,2,109.55542,18.28208,1715
13379,102421,87ADC98470D754E65D1F229228B379D5,30851,20,23,3,109.5616,18.27396,1713
13380,102468,47C8C71AB8A291B23C6D0393C8109E46,38261,0,8,8,109.50361,18.28153,1515
13381,102469,47C8C71AB8A291B23C6D0393C8109E46,31301,10,11,1,109.14493,18.31222,170
13382,102470,47C8C71AB8A291B23C6D0393C8109E46,38171,15,17,2,109.50799,18.28139,1515
13383,102471,47C8C71AB8A291B23C6D0393C8109E46,38261,18,23,5,109.50361,18.28153,1515
13384,102492,47B3B30463DFC561429E6F7DBFD3AC56,31431,0,12,12,109.44639,18.29042,1316
13385,102493,47B3B30463DFC561429E6F7DBFD3AC56,31561,14,15,1,109.56792,18.28479,1765
13386,102494,47B3B30463DFC561429E6F7DBFD3AC56,31431,16,18,2,109.44639,18.29042,1316
13387,102495,47B3B30463DFC561429E6F7DBFD3AC56,30361,19,20,1,109.50347,18.24,1508
13388,102496,47B3B30463DFC561429E6F7DBFD3AC56,31431,21,23,2,109.44639,18.29042,1316
13389,102499,5BC3B77CE4C9E3D80CA1E3D2AEFD4FF6,60381,18,19,1,109.5241,18.22458,1605
13390,102500,5BC3B77CE4C9E3D80CA1E3D2AEFD4FF6,31271,20,22,2,109.48958,18.26257,1462
13391,102503,89362A3CA3AE6F5B75871F2110924F99,30851,0,6,6,109.5616,18.27396,1713
13392,102504,89362A3CA3AE6F5B75871F2110924F99,30951,10,11,1,109.56208,18.25667,1761
13393,102505,89362A3CA3AE6F5B75871F2110924F99,39371,12,13,1,109.56627,18.2646,1762
13394,102506,89362A3CA3AE6F5B75871F2110924F99,30951,13,17,4,109.56208,18.25667,1761
13395,102507,89362A3CA3AE6F5B75871F2110924F99,30851,17,23,6,109.5616,18.27396,1713
13399,102551,E7B24ADBE691139494F24A8AB7EDA359,30854,19,20,1,109.56889,18.27076,1763
13400,102552,E7B24ADBE691139494F24A8AB7EDA359,31761,21,23,2,109.60521,18.27965,1914
13405,102608,7FF3C6569A3990C03CAF6C52D3C8BC6C,30921,0,18,18,109.53903,18.29451,1667
13406,102609,7FF3C6569A3990C03CAF6C52D3C8BC6C,60241,19,20,1,109.53319,18.28667,1616
13407,102642,E46795A590C643FCDE6B993B35621D2F,31931,1,5,4,109.54771,18.29403,1667
13408,102643,E46795A590C643FCDE6B993B35621D2F,60552,8,9,1,109.41729,18.30014,1218
13409,102644,1321BCF14E61D6FFFB82331DABDFE27C,31271,0,6,6,109.48958,18.26257,1462
13410,102645,1321BCF14E61D6FFFB82331DABDFE27C,31781,9,12,3,109.19847,18.2975,367
13411,102646,1321BCF14E61D6FFFB82331DABDFE27C,31145,12,13,1,109.20431,18.30479,369
13412,102647,1321BCF14E61D6FFFB82331DABDFE27C,31471,14,16,2,109.34583,18.29563,917
13413,102648,1321BCF14E61D6FFFB82331DABDFE27C,31271,19,23,4,109.48958,18.26257,1462
13418,102671,5DE74CB2B600155A1EC2F7D01E1A8413,30731,0,10,10,109.50944,18.22306,1555
13419,102672,5DE74CB2B600155A1EC2F7D01E1A8413,30581,13,15,2,109.62257,18.24951,1959
13420,102673,5DE74CB2B600155A1EC2F7D01E1A8413,31345,16,23,7,109.39,18.29,1066
13421,102674,B47BACC30D9A35D35F1E9FB0E5DF7D48,30854,0,2,2,109.56889,18.27076,1763
13422,102675,B47BACC30D9A35D35F1E9FB0E5DF7D48,31071,2,4,2,109.58257,18.28458,1815
13423,102699,9C3178C4C19F2E39C3D11C3827A035D5,30661,14,15,1,109.37028,18.24361,1008
13424,102700,9C3178C4C19F2E39C3D11C3827A035D5,38071,18,20,2,109.40722,18.30938,1169
13425,102701,48C2384D12D5B16772007E35CE360CBB,30721,0,8,8,109.51597,18.28257,1565
13426,102702,48C2384D12D5B16772007E35CE360CBB,38105,8,17,9,109.40299,18.29229,1117
13427,102703,48C2384D12D5B16772007E35CE360CBB,30421,18,20,2,109.50021,18.25861,1511
13428,102704,48C2384D12D5B16772007E35CE360CBB,31345,21,22,1,109.39,18.29,1066
13429,102776,18073AD9E71B8DFC1E520C5E3653B1BD,30721,0,6,6,109.51597,18.28257,1565
13430,102778,18073AD9E71B8DFC1E520C5E3653B1BD,38881,15,22,7,109.51618,18.26431,1562
13431,102781,30F5D42A1A8F1CF26F5C9617FCB06C4F,39181,8,11,3,109.55153,18.28035,1715
13432,102782,30F5D42A1A8F1CF26F5C9617FCB06C4F,39183,15,17,2,109.55542,18.28208,1715
13433,102783,30F5D42A1A8F1CF26F5C9617FCB06C4F,31561,18,19,1,109.56792,18.28479,1765
13434,102806,5CB395EE61B203CDEC22915C029A400C,38325,16,19,3,109.39792,18.2909,1116
13435,102807,5CB395EE61B203CDEC22915C029A400C,38105,21,23,2,109.40299,18.29229,1117
13436,102827,A928E9F6C796FE1A60807BA003DE87BB,31071,2,5,3,109.58257,18.28458,1815
13437,102828,A928E9F6C796FE1A60807BA003DE87BB,30854,6,8,2,109.56889,18.27076,1763
13438,102829,A928E9F6C796FE1A60807BA003DE87BB,39181,8,16,8,109.55153,18.28035,1715
13439,102830,A928E9F6C796FE1A60807BA003DE87BB,31071,18,20,2,109.58257,18.28458,1815
13440,102831,A928E9F6C796FE1A60807BA003DE87BB,30854,21,23,2,109.56889,18.27076,1763
13445,102848,975CB35586D2D95A387E2AA86A5AB719,30121,15,17,2,109.52861,18.27222,1613
13446,102849,975CB35586D2D95A387E2AA86A5AB719,38154,18,23,5,109.5266,18.28278,1615
13447,102859,D980F71EB1AF0D70119633B043EFD554,38334,1,11,10,109.65035,18.23785,2057
13448,102860,D980F71EB1AF0D70119633B043EFD554,31071,13,14,1,109.58257,18.28458,1815
13449,102861,D980F71EB1AF0D70119633B043EFD554,31101,15,17,2,109.65389,18.23403,2057
13457,102935,807332CEC38772FA8DF98C48FBD8DD1E,31561,4,15,11,109.56792,18.28479,1765
13458,102936,807332CEC38772FA8DF98C48FBD8DD1E,31071,19,22,3,109.58257,18.28458,1815
13459,102943,A549C024E6F63EDBD3DC866F10DB11CE,30234,2,4,2,109.60681,18.29979,1918
13460,102944,A549C024E6F63EDBD3DC866F10DB11CE,30854,7,23,16,109.56889,18.27076,1763
13461,102984,A749E400BFD3B5908671E939EC104DEE,31071,0,6,6,109.58257,18.28458,1815
13462,102985,A749E400BFD3B5908671E939EC104DEE,30854,8,18,10,109.56889,18.27076,1763
13463,102986,A749E400BFD3B5908671E939EC104DEE,60084,19,20,1,109.4984,18.2334,1507
13464,102987,A749E400BFD3B5908671E939EC104DEE,30854,22,23,1,109.56889,18.27076,1763
13468,103006,7168F7EAD82B76A2A520C85DAB769D72,39183,0,16,16,109.55542,18.28208,1715
13469,103007,7168F7EAD82B76A2A520C85DAB769D72,31561,18,19,1,109.56792,18.28479,1765
13473,103047,7AFCA6A0135DD4739529823E28C762E3,30711,0,9,9,109.50271,18.25347,1510
13474,103067,6A910172B0D8A7BBC31B1CD07364D7F6,31206,0,8,8,109.50819,18.23549,1507
13475,103068,6A910172B0D8A7BBC31B1CD07364D7F6,30661,11,14,3,109.37028,18.24361,1008
13476,103069,6A910172B0D8A7BBC31B1CD07364D7F6,31201,16,18,2,109.51042,18.23819,1558
13477,103070,6A910172B0D8A7BBC31B1CD07364D7F6,60291,18,20,2,109.50826,18.24639,1509
13478,103071,6A910172B0D8A7BBC31B1CD07364D7F6,31206,22,23,1,109.50819,18.23549,1507
13479,103072,D5FE874FE4A1FA8F436099DBE974EE76,38951,0,8,8,109.48097,18.28868,1416
13480,103073,D5FE874FE4A1FA8F436099DBE974EE76,30441,11,12,1,109.64021,18.25424,2010
13481,103074,D5FE874FE4A1FA8F436099DBE974EE76,38951,15,23,8,109.48097,18.28868,1416
13482,103077,1EBF477B1EE6E13F6E111854406233C6,38325,0,2,2,109.39792,18.2909,1116
13483,103078,1EBF477B1EE6E13F6E111854406233C6,38251,4,5,1,109.49618,18.25493,1510
13484,103079,1EBF477B1EE6E13F6E111854406233C6,31145,9,11,2,109.20431,18.30479,369
13485,103080,1EBF477B1EE6E13F6E111854406233C6,31781,11,12,1,109.19847,18.2975,367
13486,103139,10EBF762D28520B09848288F7052CFDE,30854,2,5,3,109.56889,18.27076,1763
13487,103140,10EBF762D28520B09848288F7052CFDE,30161,8,11,3,109.50042,18.24389,1508
13488,103141,10EBF762D28520B09848288F7052CFDE,39101,14,17,3,109.50132,18.24931,1509
13489,103142,10EBF762D28520B09848288F7052CFDE,31561,19,21,2,109.56792,18.28479,1765
13500,103266,13166628932DF36C0AD7B1DB5811240A,60591,0,6,6,109.61118,18.21715,1904
13501,103267,13166628932DF36C0AD7B1DB5811240A,30854,8,15,7,109.56889,18.27076,1763
13502,103268,13166628932DF36C0AD7B1DB5811240A,60631,15,17,2,109.57778,18.27583,1814
13503,103269,13166628932DF36C0AD7B1DB5811240A,60591,19,23,4,109.61118,18.21715,1904
13504,103294,2DA5948E96121EADE6CCFA0D33794EFE,38251,0,8,8,109.49618,18.25493,1510
13505,103295,2DA5948E96121EADE6CCFA0D33794EFE,33051,13,16,3,109.6475,18.46618,2096
13506,103296,2DA5948E96121EADE6CCFA0D33794EFE,38251,20,23,3,109.49618,18.25493,1510
13510,103341,1B54321AAE3CB452580C4C49E7007657,38281,0,8,8,109.6525,18.23403,2057
13511,103342,1B54321AAE3CB452580C4C49E7007657,30661,12,15,3,109.37028,18.24361,1008
13512,103343,1B54321AAE3CB452580C4C49E7007657,38251,18,19,1,109.49618,18.25493,1510
13513,103344,1B54321AAE3CB452580C4C49E7007657,31101,20,23,3,109.65389,18.23403,2057
13514,103352,15A2A8790389D1537721C21B141A7A31,61011,12,21,9,109.60653,18.19076,1900
13515,103360,6D02659C8AB6FF777A098A468ACF74DA,31021,14,17,3,109.49021,18.27,1463
13516,103361,6D02659C8AB6FF777A098A468ACF74DA,31201,19,20,1,109.51042,18.23819,1558
13517,103362,6D02659C8AB6FF777A098A468ACF74DA,60551,21,23,2,109.42722,18.30111,1218
13522,103448,0F558B6653C655C7F0BAEA9D66B33F57,31071,2,6,4,109.58257,18.28458,1815
13523,103449,0F558B6653C655C7F0BAEA9D66B33F57,30854,10,12,2,109.56889,18.27076,1763
13524,103450,588D854C36F4A36488FDCCD50B5D19DD,31071,0,6,6,109.58257,18.28458,1815
13525,103451,588D854C36F4A36488FDCCD50B5D19DD,30854,11,13,2,109.56889,18.27076,1763
13526,103459,932D308A47BD924E11B570EA7CB7901D,31521,11,12,1,109.51458,18.22542,1555
13534,103577,28F7DFD4A036DBA4E68AFC71762D44D7,31421,8,9,1,109.55382,18.22347,1705
13535,103578,28F7DFD4A036DBA4E68AFC71762D44D7,30951,11,13,2,109.56208,18.25667,1761
13536,103579,28F7DFD4A036DBA4E68AFC71762D44D7,31421,15,18,3,109.55382,18.22347,1705
13537,103580,28F7DFD4A036DBA4E68AFC71762D44D7,30951,18,20,2,109.56208,18.25667,1761
13542,103607,D537779863674D03BD86E245F9738004,38251,6,14,8,109.49618,18.25493,1510
13543,103608,D537779863674D03BD86E245F9738004,38941,17,18,1,109.49625,18.25451,1510
13544,103609,D537779863674D03BD86E245F9738004,38251,20,22,2,109.49618,18.25493,1510
13545,103632,EFFEF00C078D502D6D0D1D469ACBA466,30421,9,15,6,109.50021,18.25861,1511
13546,103633,EFFEF00C078D502D6D0D1D469ACBA466,39151,19,21,2,109.49875,18.25097,1510
13547,103634,EFFEF00C078D502D6D0D1D469ACBA466,30421,21,23,2,109.50021,18.25861,1511
13548,103649,8351D15B3D6A299C2AB7E9544D4F31B1,60551,19,20,1,109.42722,18.30111,1218
13549,103650,8351D15B3D6A299C2AB7E9544D4F31B1,60631,22,23,1,109.57778,18.27583,1814
13550,103682,DF49F834C08C7E8FA6D78272EE1FB651,60361,0,7,7,109.51938,18.29681,1567
13551,103683,DF49F834C08C7E8FA6D78272EE1FB651,30951,7,17,10,109.56208,18.25667,1761
13552,103684,DF49F834C08C7E8FA6D78272EE1FB651,60361,19,23,4,109.51938,18.29681,1567
13553,103701,8DD23AA43C0F7967C45F7488D66F9159,30854,15,17,2,109.56889,18.27076,1763
13554,103702,8DD23AA43C0F7967C45F7488D66F9159,31071,18,21,3,109.58257,18.28458,1815
13555,103703,8DD23AA43C0F7967C45F7488D66F9159,30854,21,23,2,109.56889,18.27076,1763
13556,103715,39D0B119BCF23E40EF7A286F6A03CC6A,30201,0,9,9,109.4909,18.26465,1462
13557,103716,39D0B119BCF23E40EF7A286F6A03CC6A,31271,10,11,1,109.48958,18.26257,1462
13558,103717,39D0B119BCF23E40EF7A286F6A03CC6A,60594,13,16,3,109.62694,18.22799,1956
13559,103718,39D0B119BCF23E40EF7A286F6A03CC6A,38052,17,23,6,109.62618,18.23042,1956
13560,103725,3920BAEB33CD0C1B51E7B924FE380948,60401,0,7,7,109.47444,18.27583,1414
13561,103726,3920BAEB33CD0C1B51E7B924FE380948,38251,7,8,1,109.49618,18.25493,1510
13562,103727,3920BAEB33CD0C1B51E7B924FE380948,31781,13,14,1,109.19847,18.2975,367
13563,103779,5AAB2BA860639221A739FD874CEC6C5E,30861,0,7,7,109.52722,18.22743,1606
13564,103780,5AAB2BA860639221A739FD874CEC6C5E,31781,11,13,2,109.19847,18.2975,367
13565,103781,5AAB2BA860639221A739FD874CEC6C5E,31471,13,15,2,109.34583,18.29563,917
13566,103782,5AAB2BA860639221A739FD874CEC6C5E,60221,17,21,4,109.52569,18.29188,1616
13567,103783,5AAB2BA860639221A739FD874CEC6C5E,30861,21,22,1,109.52722,18.22743,1606
13571,103805,05C5BAA3E14983E15142EDC7A25768B1,31391,3,5,2,109.50382,18.24285,1508
13572,103806,05C5BAA3E14983E15142EDC7A25768B1,30361,8,11,3,109.50347,18.24,1508
13573,103807,05C5BAA3E14983E15142EDC7A25768B1,60371,11,13,2,109.53063,18.30056,1618
13577,103834,C85D0B931BEF54F05B9ABBBB03212DB7,31071,2,3,1,109.58257,18.28458,1815
13578,103835,C85D0B931BEF54F05B9ABBBB03212DB7,30854,3,6,3,109.56889,18.27076,1763
13579,103836,C85D0B931BEF54F05B9ABBBB03212DB7,31561,6,15,9,109.56792,18.28479,1765
13580,103837,C85D0B931BEF54F05B9ABBBB03212DB7,30854,15,18,3,109.56889,18.27076,1763
13581,103838,C85D0B931BEF54F05B9ABBBB03212DB7,31071,19,20,1,109.58257,18.28458,1815
13582,103839,C85D0B931BEF54F05B9ABBBB03212DB7,31561,20,22,2,109.56792,18.28479,1765
13583,103853,EF4E8B2B57B33802A459B5C67E5DD022,38951,2,9,7,109.48097,18.28868,1416
13584,103854,EF4E8B2B57B33802A459B5C67E5DD022,30361,11,12,1,109.50347,18.24,1508
13585,103855,EF4E8B2B57B33802A459B5C67E5DD022,38951,12,23,11,109.48097,18.28868,1416
13586,103874,CDA1EB7B89E47C48A7CAC823B0773234,38127,12,13,1,109.50833,18.27222,1513
13587,103875,CDA1EB7B89E47C48A7CAC823B0773234,38871,15,18,3,109.44681,18.28625,1316
13588,103876,CDA1EB7B89E47C48A7CAC823B0773234,31351,18,20,2,109.4959,18.28417,1465
13589,103888,0E1DB444F47235AEDAD0A0404A7B75B4,31931,20,21,1,109.54771,18.29403,1667
13590,103895,F6300B72B7EF2FA11171AFA8CE8E07F1,60401,3,5,2,109.47444,18.27583,1414
13591,103896,F6300B72B7EF2FA11171AFA8CE8E07F1,30731,5,7,2,109.50944,18.22306,1555
13592,103897,F6300B72B7EF2FA11171AFA8CE8E07F1,30051,9,12,3,109.48917,18.21215,1453
13593,103898,F6300B72B7EF2FA11171AFA8CE8E07F1,60524,15,22,7,109.42951,18.28993,1216
13597,103949,EA3A8DA5F296698D9CCABAE2F2FD40FF,38754,13,14,1,109.74667,18.37382,2430
13598,103950,EA3A8DA5F296698D9CCABAE2F2FD40FF,31521,16,17,1,109.51458,18.22542,1555
13599,103951,EA3A8DA5F296698D9CCABAE2F2FD40FF,31521,18,23,5,109.51458,18.22542,1555
13603,103973,EBF906C5498076BCFA3E97DF6001B4F3,60631,18,19,1,109.57778,18.27583,1814
13604,103974,EBF906C5498076BCFA3E97DF6001B4F3,30854,21,22,1,109.56889,18.27076,1763
13609,104008,C5A446AC7123103DC030E8D43C03C155,60221,0,8,8,109.52569,18.29188,1616
13610,104009,C5A446AC7123103DC030E8D43C03C155,38111,9,12,3,109.52007,18.22403,1555
13611,104010,C5A446AC7123103DC030E8D43C03C155,60221,14,17,3,109.52569,18.29188,1616
13612,104011,C5A446AC7123103DC030E8D43C03C155,30071,18,19,1,109.52819,18.30472,1619
13613,104012,C5A446AC7123103DC030E8D43C03C155,60221,20,21,1,109.52569,18.29188,1616
13614,104048,75817DB682187A07461734D66E1E6492,60631,0,4,4,109.57778,18.27583,1814
13615,104049,75817DB682187A07461734D66E1E6492,30854,6,17,11,109.56889,18.27076,1763
13616,104050,75817DB682187A07461734D66E1E6492,31061,19,20,1,109.53333,18.23257,1607
13617,104051,75817DB682187A07461734D66E1E6492,60631,21,23,2,109.57778,18.27583,1814
13618,104127,E8A62C362548F9D5791FD06549C42092,60054,0,12,12,109.3016,18.31229,770
13619,104128,E8A62C362548F9D5791FD06549C42092,30661,12,14,2,109.37028,18.24361,1008
13620,104129,E8A62C362548F9D5791FD06549C42092,60054,14,16,2,109.3016,18.31229,770
13621,104130,E8A62C362548F9D5791FD06549C42092,60411,19,22,3,109.32514,18.30854,869
13622,104142,38A4ADCA8BA2F0AA89E61BE32DF08B77,30181,13,14,1,109.51597,18.23313,1557
13623,104143,38A4ADCA8BA2F0AA89E61BE32DF08B77,30361,15,16,1,109.50347,18.24,1508
13624,104144,38A4ADCA8BA2F0AA89E61BE32DF08B77,30181,17,18,1,109.51597,18.23313,1557
13625,104145,38A4ADCA8BA2F0AA89E61BE32DF08B77,30181,19,20,1,109.51597,18.23313,1557
13626,104146,38A4ADCA8BA2F0AA89E61BE32DF08B77,31521,21,23,2,109.51458,18.22542,1555
13627,104174,34F3D64B41C252481F72E5CF931AC833,30851,0,6,6,109.5616,18.27396,1713
13628,104175,34F3D64B41C252481F72E5CF931AC833,31071,7,8,1,109.58257,18.28458,1815
13629,104176,34F3D64B41C252481F72E5CF931AC833,60381,13,14,1,109.5241,18.22458,1605
13630,104181,12D6F1B589329281D7FEE105AB4A11AB,31231,0,12,12,109.42597,18.29292,1217
13631,104182,12D6F1B589329281D7FEE105AB4A11AB,31031,12,14,2,109.49979,18.25382,1510
13632,104183,12D6F1B589329281D7FEE105AB4A11AB,38754,15,17,2,109.74667,18.37382,2430
13633,104184,12D6F1B589329281D7FEE105AB4A11AB,30711,19,21,2,109.50271,18.25347,1510
13634,104187,E6A26FB3A5537CE712195E9460AB99FB,30854,0,1,1,109.56889,18.27076,1763
13635,104188,E6A26FB3A5537CE712195E9460AB99FB,60631,3,8,5,109.57778,18.27583,1814
13636,104189,E6A26FB3A5537CE712195E9460AB99FB,30854,8,9,1,109.56889,18.27076,1763
13637,104190,E6A26FB3A5537CE712195E9460AB99FB,38271,11,14,3,109.62632,18.23049,1956
13638,104193,53875E69050EC42E511A64D3211FA7B3,30854,14,15,1,109.56889,18.27076,1763
13639,104194,53875E69050EC42E511A64D3211FA7B3,31561,16,17,1,109.56792,18.28479,1765
13640,104195,53875E69050EC42E511A64D3211FA7B3,60631,22,23,1,109.57778,18.27583,1814
13641,104202,95E09A72760B2799C2CC9BD7AF527107,30854,0,3,3,109.56889,18.27076,1763
13642,104203,95E09A72760B2799C2CC9BD7AF527107,31071,6,23,17,109.58257,18.28458,1815
13643,104207,4DA47CA7E0DF1887A4FCFA8DEF75F8FC,39371,12,17,5,109.56627,18.2646,1762
13644,104208,4DA47CA7E0DF1887A4FCFA8DEF75F8FC,31761,19,23,4,109.60521,18.27965,1914
13645,104226,A952750F25C558E5C17B3EB7DD935431,60371,3,12,9,109.53063,18.30056,1618
13646,104227,A952750F25C558E5C17B3EB7DD935431,31931,14,16,2,109.54771,18.29403,1667
13651,104284,2BEDA68024795D9EC2B7C1E361D17605,39151,13,14,1,109.49875,18.25097,1510
13652,104285,2BEDA68024795D9EC2B7C1E361D17605,30211,15,16,1,109.49882,18.23931,1508
13653,104286,2BEDA68024795D9EC2B7C1E361D17605,30271,18,20,2,109.49132,18.23153,1456
13660,104324,9D637EBA8B134F982FFF63FD06C371B9,38111,0,11,11,109.52007,18.22403,1555
13661,104325,9D637EBA8B134F982FFF63FD06C371B9,60381,12,14,2,109.5241,18.22458,1605
13662,104326,9D637EBA8B134F982FFF63FD06C371B9,31521,15,17,2,109.51458,18.22542,1555
13663,104327,9D637EBA8B134F982FFF63FD06C371B9,30711,17,18,1,109.50271,18.25347,1510
13664,104328,9D637EBA8B134F982FFF63FD06C371B9,60221,19,21,2,109.52569,18.29188,1616
13669,104367,824DCA8F3B3A2543DC4C6574433D7232,30361,15,16,1,109.50347,18.24,1508
13670,104368,824DCA8F3B3A2543DC4C6574433D7232,30441,19,23,4,109.64021,18.25424,2010
13671,104432,27BCEF3137923B84211F08830816C810,31561,18,20,2,109.56792,18.28479,1765
13676,104453,896E70230E917230ACB2F2222A93F438,30771,0,8,8,109.49938,18.26042,1511
13680,104472,07015E22078E542DFD52967694C61F1D,30711,18,23,5,109.50271,18.25347,1510
13681,104479,4D944399BAAD1AD37CC1D68A51FA53FD,30161,0,10,10,109.50042,18.24389,1508
13682,104480,4D944399BAAD1AD37CC1D68A51FA53FD,30161,11,18,7,109.50042,18.24389,1508
13683,104483,91EC74D2B208A10BECBB101C6735C578,30171,13,14,1,109.48458,18.27139,1463
13684,104484,91EC74D2B208A10BECBB101C6735C578,60171,17,18,1,109.51292,18.30694,1569
13685,104485,91EC74D2B208A10BECBB101C6735C578,60161,21,23,2,109.49174,18.26181,1461
13686,104491,87C7A513DDAF08C0EAFDEC3998FDF6C5,31291,19,21,2,109.30375,18.40729,786
13687,104492,87C7A513DDAF08C0EAFDEC3998FDF6C5,30991,21,23,2,109.30847,18.44139,791
13691,104506,22654C8C41FD843CC6C6A76B44EF7C2F,31781,18,23,5,109.19847,18.2975,367
13692,104550,66F8B9488B97AC9181E1428AD12A7C79,38951,11,15,4,109.48097,18.28868,1416
13693,104551,66F8B9488B97AC9181E1428AD12A7C79,38951,16,17,1,109.48097,18.28868,1416
13694,104552,66F8B9488B97AC9181E1428AD12A7C79,38951,21,22,1,109.48097,18.28868,1416
13699,104614,8C8DB7A18864109B823771C405E00B29,31421,2,7,5,109.55382,18.22347,1705
13700,104615,8C8DB7A18864109B823771C405E00B29,30951,10,15,5,109.56208,18.25667,1761
13701,104616,8C8DB7A18864109B823771C405E00B29,31071,19,23,4,109.58257,18.28458,1815
13706,104648,F198CAA1F49ACA5D003FD8F8473B3798,31561,20,21,1,109.56792,18.28479,1765
13707,104649,F198CAA1F49ACA5D003FD8F8473B3798,30854,22,23,1,109.56889,18.27076,1763
13708,104650,C4BE65FD2368546A4993D06B712375A3,38211,18,19,1,109.49042,18.2625,1462
13709,104651,C4BE65FD2368546A4993D06B712375A3,38094,20,23,3,109.45403,18.28778,1316
13710,104694,7334BFE245C0E1675EC3C07645407CF3,30781,0,1,1,109.3275,18.37847,881
13711,104695,7334BFE245C0E1675EC3C07645407CF3,60411,2,9,7,109.32514,18.30854,869
13712,104696,7334BFE245C0E1675EC3C07645407CF3,30661,11,12,1,109.37028,18.24361,1008
13713,104697,7334BFE245C0E1675EC3C07645407CF3,60054,15,17,2,109.3016,18.31229,770
13714,104698,7334BFE245C0E1675EC3C07645407CF3,60411,19,20,1,109.32514,18.30854,869
13715,104709,8A4E28BD435508BC5C081482DC8F5BBF,60391,20,22,2,109.47667,18.28757,1416
13716,104712,9E3B1AC6114967CC1D1D48B3C4AF21E5,31521,0,13,13,109.51458,18.22542,1555
13717,104713,9E3B1AC6114967CC1D1D48B3C4AF21E5,31471,15,17,2,109.34583,18.29563,917
13718,104714,9E3B1AC6114967CC1D1D48B3C4AF21E5,30711,18,20,2,109.50271,18.25347,1510
13719,104715,9E3B1AC6114967CC1D1D48B3C4AF21E5,38071,22,23,1,109.40722,18.30938,1169
13720,104716,8C5A16299A6D294198C90C34C25C5949,39183,16,17,1,109.55542,18.28208,1715
13721,104717,8C5A16299A6D294198C90C34C25C5949,31561,18,19,1,109.56792,18.28479,1765
13722,104718,8C5A16299A6D294198C90C34C25C5949,39183,20,21,1,109.55542,18.28208,1715
13726,104724,35C6EDC8AAC6B5ABA770190223528BA2,33521,8,9,1,109.66313,18.45174,2143
13727,104725,35C6EDC8AAC6B5ABA770190223528BA2,60381,14,15,1,109.5241,18.22458,1605
13728,104726,35C6EDC8AAC6B5ABA770190223528BA2,60121,19,22,3,109.74507,18.37472,2430
13729,104747,096D8D59612F82CD076740A6D0A18387,38971,0,4,4,109.50743,18.25125,1510
13730,104748,096D8D59612F82CD076740A6D0A18387,31461,5,8,3,109.5091,18.25389,1510
13731,104749,096D8D59612F82CD076740A6D0A18387,33481,10,13,3,109.67278,18.41278,2187
13732,104750,096D8D59612F82CD076740A6D0A18387,60201,16,18,2,109.5041,18.2509,1510
13733,104751,096D8D59612F82CD076740A6D0A18387,30421,19,22,3,109.50021,18.25861,1511
13734,104789,8BB035B44D009B4E567D4EFF10F50E4D,30854,19,23,4,109.56889,18.27076,1763
13735,104813,AE9453D604AF88F4293DEF99463B2345,30281,14,15,1,109.50597,18.27583,1514
13736,104814,AE9453D604AF88F4293DEF99463B2345,38754,19,21,2,109.74667,18.37382,2430
13740,104851,0E0D6E55BB1995EBF85F6B7AA8765E55,30854,2,9,7,109.56889,18.27076,1763
13741,104852,0E0D6E55BB1995EBF85F6B7AA8765E55,31851,14,15,1,109.71736,18.29007,2316
13742,104853,0E0D6E55BB1995EBF85F6B7AA8765E55,60631,18,20,2,109.57778,18.27583,1814
13743,104854,0E0D6E55BB1995EBF85F6B7AA8765E55,30854,21,22,1,109.56889,18.27076,1763
13744,104872,2D39AE6120F2674000C6DBB8A6E572A0,31945,0,7,7,109.58021,18.29403,1817
13745,104873,2D39AE6120F2674000C6DBB8A6E572A0,30854,7,14,7,109.56889,18.27076,1763
13746,104912,C1F9914EF577AE2A8300B1A3945A50FF,30854,12,14,2,109.56889,18.27076,1763
13747,104913,C1F9914EF577AE2A8300B1A3945A50FF,31561,18,19,1,109.56792,18.28479,1765
13748,104914,C1F9914EF577AE2A8300B1A3945A50FF,30851,21,23,2,109.5616,18.27396,1713
13753,104949,F5FE23BF42FC224C310CD42E08B0B950,31431,0,7,7,109.44639,18.29042,1316
13754,104950,F5FE23BF42FC224C310CD42E08B0B950,38094,10,14,4,109.45403,18.28778,1316
13755,104951,F5FE23BF42FC224C310CD42E08B0B950,60441,14,15,1,109.46792,18.28604,1366
13756,104952,F5FE23BF42FC224C310CD42E08B0B950,38094,16,18,2,109.45403,18.28778,1316
13757,104953,F5FE23BF42FC224C310CD42E08B0B950,31431,18,19,1,109.44639,18.29042,1316
13758,104954,F5FE23BF42FC224C310CD42E08B0B950,31701,19,23,4,109.44132,18.28833,1266
13762,105109,BE8220A49F1231C0A022F4AA2075503E,31945,0,15,15,109.58021,18.29403,1817
13763,105110,BE8220A49F1231C0A022F4AA2075503E,30854,15,22,7,109.56889,18.27076,1763
13764,105111,F63244589FF36E109B6C600055B0AD94,31521,0,8,8,109.51458,18.22542,1555
13765,105121,C3EF49B0098C6C3C4B26CC8869DE86AF,38271,12,17,5,109.62632,18.23049,1956
13766,105122,C3EF49B0098C6C3C4B26CC8869DE86AF,30854,21,23,2,109.56889,18.27076,1763
13767,105136,A1DF55C42D8446F7B3BDC698ADD3A56E,31071,2,7,5,109.58257,18.28458,1815
13768,105137,A1DF55C42D8446F7B3BDC698ADD3A56E,30854,9,10,1,109.56889,18.27076,1763
13769,105138,A1DF55C42D8446F7B3BDC698ADD3A56E,30421,12,13,1,109.50021,18.25861,1511
13770,105139,A1DF55C42D8446F7B3BDC698ADD3A56E,30891,18,21,3,109.59431,18.28389,1865
13771,105140,A1DF55C42D8446F7B3BDC698ADD3A56E,30854,21,22,1,109.56889,18.27076,1763
13779,105187,67559C1EAE3B44D5B9638E1FCA4353EA,60614,17,18,1,109.48799,18.29521,1467
13780,105188,67559C1EAE3B44D5B9638E1FCA4353EA,31206,21,22,1,109.50819,18.23549,1507
13781,105205,E4199729A84482014747EE1ECF3FF7D9,30701,0,2,2,109.59313,18.32007,1871
13782,105206,E4199729A84482014747EE1ECF3FF7D9,30931,2,22,20,109.55653,18.32722,1722
13783,105229,2C0209770A37CBC62C92C1A37F9CD2E2,31521,14,19,5,109.51458,18.22542,1555
13784,105230,2C0209770A37CBC62C92C1A37F9CD2E2,30361,19,21,2,109.50347,18.24,1508
13791,105266,E38DC10DFD2C557684F4AC8C62B66FC7,31101,13,14,1,109.65389,18.23403,2057
13792,105267,E38DC10DFD2C557684F4AC8C62B66FC7,30854,17,21,4,109.56889,18.27076,1763
13796,105311,9A1C08A25191CFE5C0B470C25F3A19FD,31181,0,7,7,109.50382,18.24813,1509
13797,105312,9A1C08A25191CFE5C0B470C25F3A19FD,31473,10,12,2,109.34792,18.29465,917
13798,105313,9A1C08A25191CFE5C0B470C25F3A19FD,31471,12,14,2,109.34583,18.29563,917
13799,105314,9A1C08A25191CFE5C0B470C25F3A19FD,31701,16,18,2,109.44132,18.28833,1266
13800,105315,9A1C08A25191CFE5C0B470C25F3A19FD,38391,20,22,2,109.44111,18.29083,1266
13804,105369,90B0A60855A43B2DB99A0964CE51D3AF,31071,0,6,6,109.58257,18.28458,1815
13805,105370,90B0A60855A43B2DB99A0964CE51D3AF,30854,8,16,8,109.56889,18.27076,1763
13806,105371,90B0A60855A43B2DB99A0964CE51D3AF,60463,19,21,2,109.52507,18.22438,1605
13807,105445,E9166100808A4A843C75242C298C8C5D,38251,16,18,2,109.49618,18.25493,1510
13808,105446,E9166100808A4A843C75242C298C8C5D,30361,19,20,1,109.50347,18.24,1508
13809,105455,39997DEFFD87AA0C9D18E1194544E438,30854,5,6,1,109.56889,18.27076,1763
13810,105456,39997DEFFD87AA0C9D18E1194544E438,39371,10,23,13,109.56627,18.2646,1762
13811,105463,4DC58212A02FE5940554514185F78FA7,31521,0,13,13,109.51458,18.22542,1555
13812,105464,4DC58212A02FE5940554514185F78FA7,38331,16,19,3,109.62465,18.22736,1956
13813,105465,4DC58212A02FE5940554514185F78FA7,30581,20,21,1,109.62257,18.24951,1959
13814,105466,4DC58212A02FE5940554514185F78FA7,31571,22,23,1,109.61563,18.23326,1957
13821,105527,2F3F10722345B5DB33B8FB4B7FFFF613,30854,12,14,2,109.56889,18.27076,1763
13822,105528,2F3F10722345B5DB33B8FB4B7FFFF613,31521,16,23,7,109.51458,18.22542,1555
13826,105629,B663EE883B81AEB709AC84DCCEC3D38E,31945,0,7,7,109.58021,18.29403,1817
13827,105630,B663EE883B81AEB709AC84DCCEC3D38E,30854,8,12,4,109.56889,18.27076,1763
13828,105631,B663EE883B81AEB709AC84DCCEC3D38E,31945,13,14,1,109.58021,18.29403,1817
13829,105632,B663EE883B81AEB709AC84DCCEC3D38E,30854,16,18,2,109.56889,18.27076,1763
13830,105633,B663EE883B81AEB709AC84DCCEC3D38E,31945,21,23,2,109.58021,18.29403,1817
13831,105659,FB7BFB65FDD11A55BD33FE9788F97BC2,30854,20,21,1,109.56889,18.27076,1763
13832,105660,FB7BFB65FDD11A55BD33FE9788F97BC2,31071,22,23,1,109.58257,18.28458,1815
13833,105687,EFFD4571117B023D4BFFAE2F1C9E1510,39191,3,6,3,109.51493,18.23472,1557
13834,105688,EFFD4571117B023D4BFFAE2F1C9E1510,31201,7,10,3,109.51042,18.23819,1558
13835,105689,EFFD4571117B023D4BFFAE2F1C9E1510,30661,13,14,1,109.37028,18.24361,1008
13836,105690,EFFD4571117B023D4BFFAE2F1C9E1510,31201,16,18,2,109.51042,18.23819,1558
13837,105691,EFFD4571117B023D4BFFAE2F1C9E1510,60291,18,20,2,109.50826,18.24639,1509
13838,105692,EFFD4571117B023D4BFFAE2F1C9E1510,38961,21,23,2,109.50847,18.23514,1507
13842,105721,C0D9A8D1FC57A96EA766A127A0E8EAAC,60591,13,14,1,109.61118,18.21715,1904
13843,105722,C0D9A8D1FC57A96EA766A127A0E8EAAC,30581,16,18,2,109.62257,18.24951,1959
13844,105727,015CDEB9169BCE5537ABAE49B6A63F2B,31071,0,12,12,109.58257,18.28458,1815
13845,105728,015CDEB9169BCE5537ABAE49B6A63F2B,30854,14,17,3,109.56889,18.27076,1763
13846,105729,015CDEB9169BCE5537ABAE49B6A63F2B,38111,20,21,1,109.52007,18.22403,1555
13856,105760,A94F66C88B84FF0658441320CD9F667C,30854,0,12,12,109.56889,18.27076,1763
13857,105761,A94F66C88B84FF0658441320CD9F667C,31761,12,14,2,109.60521,18.27965,1914
13858,105762,A94F66C88B84FF0658441320CD9F667C,31071,14,16,2,109.58257,18.28458,1815
13859,105763,A94F66C88B84FF0658441320CD9F667C,30854,17,20,3,109.56889,18.27076,1763
13860,105764,A94F66C88B84FF0658441320CD9F667C,31071,21,23,2,109.58257,18.28458,1815
13861,105814,8CE55AC8BC984D52D16D6CE4872EB6FC,31391,16,23,7,109.50382,18.24285,1508
13862,105865,D6A345956751BA2ACC5430EDF68A104F,39181,0,6,6,109.55153,18.28035,1715
13863,105866,D6A345956751BA2ACC5430EDF68A104F,31931,6,10,4,109.54771,18.29403,1667
13864,105867,D6A345956751BA2ACC5430EDF68A104F,39181,11,13,2,109.55153,18.28035,1715
13865,105868,D6A345956751BA2ACC5430EDF68A104F,31931,13,17,4,109.54771,18.29403,1667
13866,105869,D6A345956751BA2ACC5430EDF68A104F,31071,19,23,4,109.58257,18.28458,1815
13867,105870,812708400337F675A87A189BADB470F9,30854,0,13,13,109.56889,18.27076,1763
13868,105871,812708400337F675A87A189BADB470F9,31071,14,23,9,109.58257,18.28458,1815
13876,105913,561522A1ED5FFA63DCA382D0CB310A1A,30171,0,15,15,109.48458,18.27139,1463
13877,105914,561522A1ED5FFA63DCA382D0CB310A1A,30171,17,23,6,109.48458,18.27139,1463
13878,105918,AEED1E225CF3D1399AAF76E61B9A21EB,38951,0,6,6,109.48097,18.28868,1416
13879,105919,AEED1E225CF3D1399AAF76E61B9A21EB,38951,7,8,1,109.48097,18.28868,1416
13880,105920,AEED1E225CF3D1399AAF76E61B9A21EB,39321,9,10,1,109.529,18.2167,1604
13881,105921,AEED1E225CF3D1399AAF76E61B9A21EB,60381,11,13,2,109.5241,18.22458,1605
13882,105922,AEED1E225CF3D1399AAF76E61B9A21EB,38951,13,21,8,109.48097,18.28868,1416
13883,105923,AEED1E225CF3D1399AAF76E61B9A21EB,38951,21,23,2,109.48097,18.28868,1416
13890,105961,0B0A4C0A7E61899F2C378BD8BB49E626,30661,15,16,1,109.37028,18.24361,1008
13891,105962,0B0A4C0A7E61899F2C378BD8BB49E626,38071,19,20,1,109.40722,18.30938,1169
13905,106005,513924E5F8EAB458027327A1E2BAE9DB,30854,0,7,7,109.56889,18.27076,1763
13906,106006,513924E5F8EAB458027327A1E2BAE9DB,30731,12,17,5,109.50944,18.22306,1555
13913,106041,AA17C9279A63248D7DCDF49F93EB8817,30854,0,6,6,109.56889,18.27076,1763
13914,106042,AA17C9279A63248D7DCDF49F93EB8817,38275,8,16,8,109.62875,18.22938,2006
13915,106068,D73D0E1690714CD7F442C709F67E4771,60361,0,7,7,109.51938,18.29681,1567
13916,106069,D73D0E1690714CD7F442C709F67E4771,30851,8,10,2,109.5616,18.27396,1713
13917,106070,D73D0E1690714CD7F442C709F67E4771,31551,10,12,2,109.55868,18.24222,1708
13918,106071,D73D0E1690714CD7F442C709F67E4771,30951,14,17,3,109.56208,18.25667,1761
13919,106072,D73D0E1690714CD7F442C709F67E4771,60361,18,23,5,109.51938,18.29681,1567
13924,106123,F84D949DDCBF25D5530F771BC55E0B9D,61011,0,16,16,109.60653,18.19076,1900
13934,106162,F2D05E21011627911E032EF5E2881C02,60054,12,14,2,109.3016,18.31229,770
13935,106163,F2D05E21011627911E032EF5E2881C02,31521,17,23,6,109.51458,18.22542,1555
13936,106197,0F5941C6E62F3F6BC38896A58D777D2A,30211,0,1,1,109.49882,18.23931,1508
13937,106198,0F5941C6E62F3F6BC38896A58D777D2A,30211,3,7,4,109.49882,18.23931,1508
13938,106199,0F5941C6E62F3F6BC38896A58D777D2A,31781,12,13,1,109.19847,18.2975,367
13939,106200,0F5941C6E62F3F6BC38896A58D777D2A,31471,15,16,1,109.34583,18.29563,917
13940,106201,0F5941C6E62F3F6BC38896A58D777D2A,60221,18,21,3,109.52569,18.29188,1616
13947,106274,A7B1A0DED13DE1A6767943346C42150E,38361,0,9,9,109.43667,18.29201,1267
13948,106275,A7B1A0DED13DE1A6767943346C42150E,30661,11,13,2,109.37028,18.24361,1008
13949,106299,231B029CF9822C5AF0B9A3E57B6E3364,60411,0,6,6,109.32514,18.30854,869
13950,106300,231B029CF9822C5AF0B9A3E57B6E3364,31471,10,11,1,109.34583,18.29563,917
13951,106301,231B029CF9822C5AF0B9A3E57B6E3364,60411,12,14,2,109.32514,18.30854,869
13952,106302,231B029CF9822C5AF0B9A3E57B6E3364,31781,16,17,1,109.19847,18.2975,367
13953,106303,231B029CF9822C5AF0B9A3E57B6E3364,60411,19,23,4,109.32514,18.30854,869
13954,106334,6F5AC3BF8416D28CECE26673BD19B71D,38334,0,11,11,109.65035,18.23785,2057
13955,106335,6F5AC3BF8416D28CECE26673BD19B71D,39183,13,14,1,109.55542,18.28208,1715
13956,106336,6F5AC3BF8416D28CECE26673BD19B71D,31101,16,18,2,109.65389,18.23403,2057
13960,106363,2A699167E9D3E245FFAC98B0B1AFC37B,30854,0,10,10,109.56889,18.27076,1763
13961,106364,2A699167E9D3E245FFAC98B0B1AFC37B,31101,13,15,2,109.65389,18.23403,2057
13962,106365,2A699167E9D3E245FFAC98B0B1AFC37B,30854,15,23,8,109.56889,18.27076,1763
13963,106373,10BB72F4E7990A3695C663829F0D188E,30081,9,13,4,109.50243,18.26632,1512
13964,106374,10BB72F4E7990A3695C663829F0D188E,31201,14,16,2,109.51042,18.23819,1558
13965,106375,10BB72F4E7990A3695C663829F0D188E,30421,19,21,2,109.50021,18.25861,1511
13966,106378,602A18E3D49AF3E12266148924C74085,30171,12,13,1,109.48458,18.27139,1463
13967,106379,602A18E3D49AF3E12266148924C74085,38111,15,19,4,109.52007,18.22403,1555
13968,106380,602A18E3D49AF3E12266148924C74085,30361,19,21,2,109.50347,18.24,1508
13973,106419,777EC08CE4A1629F92050B8E45D8DE2E,38141,0,9,9,109.39479,18.2916,1116
13974,106420,777EC08CE4A1629F92050B8E45D8DE2E,31471,13,14,1,109.34583,18.29563,917
13975,106421,777EC08CE4A1629F92050B8E45D8DE2E,31391,18,19,1,109.50382,18.24285,1508
13976,106422,777EC08CE4A1629F92050B8E45D8DE2E,38141,22,23,1,109.39479,18.2916,1116
13981,106445,8799356B7181F28146A203E5F86C52F0,31351,2,7,5,109.4959,18.28417,1465
13982,106446,8799356B7181F28146A203E5F86C52F0,38834,8,21,13,109.47639,18.21146,1403
13983,106450,5B89269E4A739CCC648F48BDED79AD0C,31561,1,5,4,109.56792,18.28479,1765
13984,106451,5B89269E4A739CCC648F48BDED79AD0C,30854,8,11,3,109.56889,18.27076,1763
13985,106460,73EAC1341C5005A58B26B1A52457F38B,39101,0,2,2,109.50132,18.24931,1509
13986,106461,73EAC1341C5005A58B26B1A52457F38B,31181,2,18,16,109.50382,18.24813,1509
13990,106485,99CBAA6A65A50998F0A10B72B36210E4,30661,13,14,1,109.37028,18.24361,1008
13991,106486,99CBAA6A65A50998F0A10B72B36210E4,60231,14,22,8,109.49903,18.21972,1504
13992,106487,2FE0F3A82C27452F04A6B927F514EFA7,31551,3,8,5,109.55868,18.24222,1708
13993,106488,2FE0F3A82C27452F04A6B927F514EFA7,31554,11,12,1,109.55521,18.2459,1709
13994,106489,2FE0F3A82C27452F04A6B927F514EFA7,38541,15,17,2,109.73715,18.34875,2426
13995,106490,2FE0F3A82C27452F04A6B927F514EFA7,31551,19,23,4,109.55868,18.24222,1708
13996,106515,17367053A58C1678FB35004807ED1753,31031,6,18,12,109.49979,18.25382,1510
13997,106516,17367053A58C1678FB35004807ED1753,38251,18,22,4,109.49618,18.25493,1510
13998,106546,37D38EF0062E64D55C94EB554B76F9EE,31071,0,7,7,109.58257,18.28458,1815
13999,106547,37D38EF0062E64D55C94EB554B76F9EE,30854,11,13,2,109.56889,18.27076,1763
14000,106548,37D38EF0062E64D55C94EB554B76F9EE,31071,17,18,1,109.58257,18.28458,1815
14001,106549,37D38EF0062E64D55C94EB554B76F9EE,31164,18,20,2,109.69993,18.27215,2263
14002,106577,DF1914B7230B32BA806E8A8749CAD846,60491,1,16,15,109.43354,18.30847,1269
14003,106578,DF1914B7230B32BA806E8A8749CAD846,60261,18,22,4,109.44326,18.3075,1319
14010,106649,A85947777B4AC51D2273D90B9113A029,30561,0,6,6,109.52778,18.31938,1621
14011,106650,A85947777B4AC51D2273D90B9113A029,31951,7,9,2,109.52174,18.30299,1568
14012,106651,A85947777B4AC51D2273D90B9113A029,30561,11,15,4,109.52778,18.31938,1621
14013,106652,A85947777B4AC51D2273D90B9113A029,38484,15,16,1,109.53028,18.31528,1620
14014,106653,A85947777B4AC51D2273D90B9113A029,30421,18,20,2,109.50021,18.25861,1511
14015,106654,A85947777B4AC51D2273D90B9113A029,30561,21,23,2,109.52778,18.31938,1621
14016,106672,020753EF78F0A0C39658113A3377EA1E,31561,3,8,5,109.56792,18.28479,1765
14017,106673,020753EF78F0A0C39658113A3377EA1E,31931,8,10,2,109.54771,18.29403,1667
14018,106675,05A57DE8DC0D94268B97E02566D1A0C9,60351,18,22,4,109.58403,18.28958,1816
14019,106689,49B83C7F9A6DE289690C374F9AA78932,31151,0,17,17,109.75549,18.4191,2488
14020,106690,49B83C7F9A6DE289690C374F9AA78932,30421,18,21,3,109.50021,18.25861,1511
14021,106691,3971E288F0FB50DDE06A11C534E966DA,30854,0,16,16,109.56889,18.27076,1763
14022,106692,3971E288F0FB50DDE06A11C534E966DA,30191,21,23,2,109.50361,18.22701,1506
14023,106757,4A5667D82CB3C711D86862CBE82C4E19,38325,18,19,1,109.39792,18.2909,1116
14024,106758,4A5667D82CB3C711D86862CBE82C4E19,38027,19,23,4,109.38833,18.2909,1066
14025,106779,A55D4129A4D1B105629D337545083A9E,39183,0,11,11,109.55542,18.28208,1715
14026,106780,A55D4129A4D1B105629D337545083A9E,31561,16,23,7,109.56792,18.28479,1765
14027,106783,46FB195BB21573CE6CD85D42D7B06C1A,31071,2,8,6,109.58257,18.28458,1815
14028,106784,46FB195BB21573CE6CD85D42D7B06C1A,30854,11,16,5,109.56889,18.27076,1763
14032,106826,56F818D0924E7BDB02CCC04065747626,38205,1,16,15,109.62743,18.23139,1956
14033,106827,56F818D0924E7BDB02CCC04065747626,31181,21,23,2,109.50382,18.24813,1509
14034,106828,51061B3DE820AF1C1C713EF684728003,31071,1,3,2,109.58257,18.28458,1815
14035,106829,51061B3DE820AF1C1C713EF684728003,30854,3,23,20,109.56889,18.27076,1763
14040,106834,213AF2099653A4ADAEF799CCC144B279,30021,0,21,21,109.12014,18.40986,86
14041,106836,A8E9C7BB918ADAD29A3EA7ACDDCD32D7,38951,0,8,8,109.48097,18.28868,1416
14042,106837,A8E9C7BB918ADAD29A3EA7ACDDCD32D7,39041,8,14,6,109.40021,18.29278,1117
14043,106838,A8E9C7BB918ADAD29A3EA7ACDDCD32D7,60041,15,16,1,109.39889,18.31944,1121
14044,106839,A8E9C7BB918ADAD29A3EA7ACDDCD32D7,38951,18,22,4,109.48097,18.28868,1416
14045,106845,ED52FAA860ECB2F5A4527D53311E0122,31071,6,7,1,109.58257,18.28458,1815
14046,106846,ED52FAA860ECB2F5A4527D53311E0122,30854,7,13,6,109.56889,18.27076,1763
14047,106877,1980C8D409DE9551539224B3D393CDAA,30071,1,17,16,109.52819,18.30472,1619
14048,106878,1980C8D409DE9551539224B3D393CDAA,30071,18,23,5,109.52819,18.30472,1619
14049,106912,635914FBAF9BDB855B8CB450E2AE782A,38834,0,1,1,109.47639,18.21146,1403
14050,106913,635914FBAF9BDB855B8CB450E2AE782A,30051,4,7,3,109.48917,18.21215,1453
14051,106914,635914FBAF9BDB855B8CB450E2AE782A,31031,11,13,2,109.49979,18.25382,1510
14052,106915,635914FBAF9BDB855B8CB450E2AE782A,38315,14,17,3,109.48979,18.29764,1467
14053,106930,BEE3A0C9BB09D7F210E3490BED90A1BE,60371,0,4,4,109.53063,18.30056,1618
14054,106931,BEE3A0C9BB09D7F210E3490BED90A1BE,30071,4,7,3,109.52819,18.30472,1619
14055,106932,BEE3A0C9BB09D7F210E3490BED90A1BE,30791,10,23,13,109.72333,18.40889,2386
14056,106981,19528C4631F1EE713711638CA8EA470F,30111,6,15,9,109.47583,18.30542,1419
14057,106982,19528C4631F1EE713711638CA8EA470F,31431,16,17,1,109.44639,18.29042,1316
14058,106983,19528C4631F1EE713711638CA8EA470F,31521,17,19,2,109.51458,18.22542,1555
14059,106984,19528C4631F1EE713711638CA8EA470F,31431,20,21,1,109.44639,18.29042,1316
14063,107010,782BCA908252809750EF6B8020D2A86A,39191,0,3,3,109.51493,18.23472,1557
14064,107011,782BCA908252809750EF6B8020D2A86A,31201,3,10,7,109.51042,18.23819,1558
14065,107012,782BCA908252809750EF6B8020D2A86A,30661,12,15,3,109.37028,18.24361,1008
14066,107013,782BCA908252809750EF6B8020D2A86A,31201,16,18,2,109.51042,18.23819,1558
14067,107014,782BCA908252809750EF6B8020D2A86A,60291,19,20,1,109.50826,18.24639,1509
14068,107015,782BCA908252809750EF6B8020D2A86A,31201,21,23,2,109.51042,18.23819,1558
14069,107079,6ADBEFDC21CA46F051933BF984A8E255,60631,0,5,5,109.57778,18.27583,1814
14070,107080,6ADBEFDC21CA46F051933BF984A8E255,30961,7,9,2,109.74042,18.37903,2431
14071,107081,6ADBEFDC21CA46F051933BF984A8E255,38706,11,13,2,109.74625,18.37097,2430
14075,107138,EAA278A02518264B6E4A1535EA0B5763,31471,14,15,1,109.34583,18.29563,917
14076,107139,EAA278A02518264B6E4A1535EA0B5763,30421,18,23,5,109.50021,18.25861,1511
14077,107143,9D52111AAF3CBA9B2742D7EEE49670D6,60381,0,8,8,109.5241,18.22458,1605
14078,107144,9D52111AAF3CBA9B2742D7EEE49670D6,31301,9,12,3,109.14493,18.31222,170
14079,107145,9D52111AAF3CBA9B2742D7EEE49670D6,31471,13,15,2,109.34583,18.29563,917
14080,107146,9D52111AAF3CBA9B2742D7EEE49670D6,30421,20,21,1,109.50021,18.25861,1511
14081,107147,9D52111AAF3CBA9B2742D7EEE49670D6,60381,22,23,1,109.5241,18.22458,1605
14082,107153,08077B5D5F0A9938A81D328635D03C8B,30854,0,6,6,109.56889,18.27076,1763
14083,107154,08077B5D5F0A9938A81D328635D03C8B,30851,7,8,1,109.5616,18.27396,1713
14084,107155,08077B5D5F0A9938A81D328635D03C8B,31071,10,12,2,109.58257,18.28458,1815
14085,107156,08077B5D5F0A9938A81D328635D03C8B,30851,12,14,2,109.5616,18.27396,1713
14086,107157,08077B5D5F0A9938A81D328635D03C8B,30854,16,17,1,109.56889,18.27076,1763
14087,107158,08077B5D5F0A9938A81D328635D03C8B,38185,18,21,3,109.51333,18.27347,1563
14091,107227,33A62A8066AF8B1342859DF4B906FBD2,31031,18,20,2,109.49979,18.25382,1510
14092,107228,33A62A8066AF8B1342859DF4B906FBD2,30351,21,23,2,109.41701,18.29292,1217
14097,107307,6422CB87ACC55DDEF6EBE8946593C808,31351,0,7,7,109.4959,18.28417,1465
14098,107308,6422CB87ACC55DDEF6EBE8946593C808,38834,12,22,10,109.47639,18.21146,1403
14099,107347,5B52C71F88DF5C7017D89C4E504F495B,33481,13,15,2,109.67278,18.41278,2187
14100,107348,5B52C71F88DF5C7017D89C4E504F495B,31236,18,20,2,109.42965,18.29111,1216
14101,107349,5B52C71F88DF5C7017D89C4E504F495B,30351,21,22,1,109.41701,18.29292,1217
14102,107350,5E8B5EFA266A23DFEAAD400692EAF0EB,31071,0,9,9,109.58257,18.28458,1815
14103,107351,5E8B5EFA266A23DFEAAD400692EAF0EB,30731,13,14,1,109.50944,18.22306,1555
14104,107352,9AA959ED87D1ECC3053DED17290EFCBD,39181,13,16,3,109.55153,18.28035,1715
14105,107353,9AA959ED87D1ECC3053DED17290EFCBD,31561,17,20,3,109.56792,18.28479,1765
14106,107377,C1F80FD61770F46AF18F3BEF2B67E7ED,60291,0,1,1,109.50826,18.24639,1509
14107,107378,C1F80FD61770F46AF18F3BEF2B67E7ED,31554,3,4,1,109.55521,18.2459,1709
14108,107379,C1F80FD61770F46AF18F3BEF2B67E7ED,31551,6,8,2,109.55868,18.24222,1708
14109,107380,C1F80FD61770F46AF18F3BEF2B67E7ED,60291,11,13,2,109.50826,18.24639,1509
14110,107381,C1F80FD61770F46AF18F3BEF2B67E7ED,31781,14,16,2,109.19847,18.2975,367
14111,107382,C1F80FD61770F46AF18F3BEF2B67E7ED,31551,19,21,2,109.55868,18.24222,1708
14112,107426,18BFFD22383048F5AB93537F321F279D,31181,0,9,9,109.50382,18.24813,1509
14113,107427,18BFFD22383048F5AB93537F321F279D,30661,12,13,1,109.37028,18.24361,1008
14114,107428,18BFFD22383048F5AB93537F321F279D,31471,13,15,2,109.34583,18.29563,917
14115,107429,18BFFD22383048F5AB93537F321F279D,31471,16,17,1,109.34583,18.29563,917
14116,107430,18BFFD22383048F5AB93537F321F279D,31181,20,23,3,109.50382,18.24813,1509
14120,107526,C1DFDFC110B50DFE0D66E47848759FB2,39183,0,8,8,109.55542,18.28208,1715
14121,107527,C1DFDFC110B50DFE0D66E47848759FB2,31071,12,22,10,109.58257,18.28458,1815
14126,107557,40285EE8CCE25C38988EC087545664EC,31071,1,7,6,109.58257,18.28458,1815
14127,107558,40285EE8CCE25C38988EC087545664EC,30854,10,17,7,109.56889,18.27076,1763
14128,107594,6EA0FFE27EED64A0685E81DBC5C13BFD,31521,0,10,10,109.51458,18.22542,1555
14129,107595,6EA0FFE27EED64A0685E81DBC5C13BFD,31521,10,12,2,109.51458,18.22542,1555
14130,107596,6EA0FFE27EED64A0685E81DBC5C13BFD,38754,12,13,1,109.74667,18.37382,2430
14131,107597,6EA0FFE27EED64A0685E81DBC5C13BFD,30791,14,17,3,109.72333,18.40889,2386
14132,107598,6EA0FFE27EED64A0685E81DBC5C13BFD,31521,18,20,2,109.51458,18.22542,1555
14133,107599,6EA0FFE27EED64A0685E81DBC5C13BFD,30511,20,22,2,109.51069,18.24208,1558
14134,107664,D9359F177293DE6337F7CC97B1116186,38052,13,17,4,109.62618,18.23042,1956
14135,107665,D9359F177293DE6337F7CC97B1116186,60211,18,19,1,109.63549,18.26049,2011
14136,107666,D9359F177293DE6337F7CC97B1116186,60594,21,23,2,109.62694,18.22799,1956
14137,107682,C8922FAF66F21ECAECB6B717FCD5A53B,60614,7,8,1,109.48799,18.29521,1467
14138,107683,C8922FAF66F21ECAECB6B717FCD5A53B,60391,8,10,2,109.47667,18.28757,1416
14139,107684,C8922FAF66F21ECAECB6B717FCD5A53B,60614,10,14,4,109.48799,18.29521,1467
14140,107685,C8922FAF66F21ECAECB6B717FCD5A53B,60391,15,19,4,109.47667,18.28757,1416
14141,107686,C8922FAF66F21ECAECB6B717FCD5A53B,60391,22,23,1,109.47667,18.28757,1416
14142,107690,017BB493E18067371C6FAA1A30D4BA4B,60231,14,15,1,109.49903,18.21972,1504
14143,107691,017BB493E18067371C6FAA1A30D4BA4B,60201,16,18,2,109.5041,18.2509,1510
14151,107802,E9E473F09C342630187345312F4A31D8,39181,0,14,14,109.55153,18.28035,1715
14152,107803,E9E473F09C342630187345312F4A31D8,39181,15,23,8,109.55153,18.28035,1715
14153,107829,08A066736557478B1013C0CF834491DF,30921,0,6,6,109.53903,18.29451,1667
14154,107830,08A066736557478B1013C0CF834491DF,31931,9,11,2,109.54771,18.29403,1667
14158,107863,00FC332040A284DA251A8D0705989FE9,31071,1,7,6,109.58257,18.28458,1815
14159,107864,00FC332040A284DA251A8D0705989FE9,30854,7,22,15,109.56889,18.27076,1763
14164,107894,FD03438E223C0F6B143E4444189350B6,31931,16,18,2,109.54771,18.29403,1667
14173,107962,39F25FE146A03325C93C111F2A943B6C,31945,0,7,7,109.58021,18.29403,1817
14174,107963,39F25FE146A03325C93C111F2A943B6C,30854,7,10,3,109.56889,18.27076,1763
14175,107964,39F25FE146A03325C93C111F2A943B6C,31945,12,13,1,109.58021,18.29403,1817
14176,107965,39F25FE146A03325C93C111F2A943B6C,30854,13,15,2,109.56889,18.27076,1763
14177,107966,39F25FE146A03325C93C111F2A943B6C,31071,15,17,2,109.58257,18.28458,1815
14184,107982,5E45AD18E230EC804DA95D38FE90826D,30661,14,16,2,109.37028,18.24361,1008
14185,107983,5E45AD18E230EC804DA95D38FE90826D,31021,18,19,1,109.49021,18.27,1463
14186,108004,D07D8903CFEE851EFB894ED4A1E91CC9,60621,0,7,7,109.48354,18.27451,1464
14187,108005,D07D8903CFEE851EFB894ED4A1E91CC9,60401,7,8,1,109.47444,18.27583,1414
14188,108006,D07D8903CFEE851EFB894ED4A1E91CC9,31781,13,15,2,109.19847,18.2975,367
14189,108007,D07D8903CFEE851EFB894ED4A1E91CC9,60381,19,21,2,109.5241,18.22458,1605
14190,108024,9ECDB9C3F97E311C1827C02496967431,30701,12,13,1,109.59313,18.32007,1871
14191,108025,9ECDB9C3F97E311C1827C02496967431,60371,14,16,2,109.53063,18.30056,1618
14192,108026,9ECDB9C3F97E311C1827C02496967431,38484,20,23,3,109.53028,18.31528,1620
14193,108033,A8122698FABBA2048A3896136E8B0BD3,39091,15,17,2,109.50097,18.25222,1510
14194,108034,A8122698FABBA2048A3896136E8B0BD3,31561,20,23,3,109.56792,18.28479,1765
14195,108046,1E36640BE395A4EE8CCB2697222419A5,38171,1,2,1,109.50799,18.28139,1515
14196,108047,1E36640BE395A4EE8CCB2697222419A5,60631,3,4,1,109.57778,18.27583,1814
14197,108048,1E36640BE395A4EE8CCB2697222419A5,31071,6,8,2,109.58257,18.28458,1815
14198,108049,1E36640BE395A4EE8CCB2697222419A5,30854,12,13,1,109.56889,18.27076,1763
14199,108050,1E36640BE395A4EE8CCB2697222419A5,31071,15,16,1,109.58257,18.28458,1815
14200,108051,1E36640BE395A4EE8CCB2697222419A5,60631,16,18,2,109.57778,18.27583,1814
14201,108052,14AE6C820CE45F96077630992CABD33D,31551,0,8,8,109.55868,18.24222,1708
14202,108053,14AE6C820CE45F96077630992CABD33D,31421,9,10,1,109.55382,18.22347,1705
14203,108054,14AE6C820CE45F96077630992CABD33D,30851,10,11,1,109.5616,18.27396,1713
14204,108055,14AE6C820CE45F96077630992CABD33D,30951,12,17,5,109.56208,18.25667,1761
14205,108056,14AE6C820CE45F96077630992CABD33D,31421,18,23,5,109.55382,18.22347,1705
14209,108109,0CD3A9451B945A7EABB5A7155C5317AC,39151,3,8,5,109.49875,18.25097,1510
14210,108110,0CD3A9451B945A7EABB5A7155C5317AC,60161,9,10,1,109.49174,18.26181,1461
14211,108111,0CD3A9451B945A7EABB5A7155C5317AC,38754,12,14,2,109.74667,18.37382,2430
14212,108112,0CD3A9451B945A7EABB5A7155C5317AC,38251,18,19,1,109.49618,18.25493,1510
14213,108113,0CD3A9451B945A7EABB5A7155C5317AC,60161,20,21,1,109.49174,18.26181,1461
14217,108146,F24FBE95123F70461DE48D51FEF5DE97,39183,5,7,2,109.55542,18.28208,1715
14218,108147,F24FBE95123F70461DE48D51FEF5DE97,30854,10,11,1,109.56889,18.27076,1763
14219,108153,E0A24740E2C54F3B77DB561A91D2BED7,30151,0,1,1,109.50986,18.25083,1560
14220,108154,E0A24740E2C54F3B77DB561A91D2BED7,31821,3,8,5,109.51181,18.24924,1559
14221,108155,E0A24740E2C54F3B77DB561A91D2BED7,30251,8,12,4,109.50611,18.26653,1512
14222,108156,E0A24740E2C54F3B77DB561A91D2BED7,30251,12,17,5,109.50611,18.26653,1512
14223,108157,E0A24740E2C54F3B77DB561A91D2BED7,30151,18,23,5,109.50986,18.25083,1560
14224,108173,9FC826BE95FBAE5773887F54D86740C8,31101,0,10,10,109.65389,18.23403,2057
14225,108174,9FC826BE95FBAE5773887F54D86740C8,30854,14,16,2,109.56889,18.27076,1763
14226,108175,9FC826BE95FBAE5773887F54D86740C8,60631,20,21,1,109.57778,18.27583,1814
14227,108305,69998C60A6E00459C2EA67259A550AAF,31271,15,17,2,109.48958,18.26257,1462
14228,108306,69998C60A6E00459C2EA67259A550AAF,31271,18,23,5,109.48958,18.26257,1462
14229,108324,622234A65D292D040A9E438A2770674C,30851,0,7,7,109.5616,18.27396,1713
14230,108325,622234A65D292D040A9E438A2770674C,31561,7,9,2,109.56792,18.28479,1765
14231,108326,622234A65D292D040A9E438A2770674C,30851,11,14,3,109.5616,18.27396,1713
14232,108327,622234A65D292D040A9E438A2770674C,31561,15,16,1,109.56792,18.28479,1765
14233,108328,622234A65D292D040A9E438A2770674C,30851,17,23,6,109.5616,18.27396,1713
14234,108354,EA446444DFE25212830F95291C13D19D,31931,0,6,6,109.54771,18.29403,1667
14235,108355,EA446444DFE25212830F95291C13D19D,39181,7,9,2,109.55153,18.28035,1715
14236,108356,EA446444DFE25212830F95291C13D19D,39181,14,15,1,109.55153,18.28035,1715
14237,108357,EA446444DFE25212830F95291C13D19D,30071,17,18,1,109.52819,18.30472,1619
14238,108358,EA446444DFE25212830F95291C13D19D,31931,20,23,3,109.54771,18.29403,1667
14243,108409,1CBE5FAAC6CDC5A885E2AFCD14FDBBB1,31031,13,14,1,109.49979,18.25382,1510
14244,108410,1CBE5FAAC6CDC5A885E2AFCD14FDBBB1,60401,15,17,2,109.47444,18.27583,1414
14245,108445,27229B6D41BD7CDDDAA38911093865DB,30854,0,5,5,109.56889,18.27076,1763
14246,108446,27229B6D41BD7CDDDAA38911093865DB,38085,5,13,8,109.6291,18.23625,2007
14247,108447,27229B6D41BD7CDDDAA38911093865DB,30854,14,16,2,109.56889,18.27076,1763
14248,108448,27229B6D41BD7CDDDAA38911093865DB,30891,16,23,7,109.59431,18.28389,1865
14249,108473,E218C587552A5DADC05C4E69685FE374,31561,12,13,1,109.56792,18.28479,1765
14250,108474,E218C587552A5DADC05C4E69685FE374,30854,17,19,2,109.56889,18.27076,1763
14251,108475,E218C587552A5DADC05C4E69685FE374,39183,21,23,2,109.55542,18.28208,1715
14258,108676,6876B785B3B8E427F5B0017E0B0EC706,60472,0,8,8,109.46625,18.29542,1367
14259,108677,6876B785B3B8E427F5B0017E0B0EC706,30181,8,10,2,109.51597,18.23313,1557
14260,108678,6876B785B3B8E427F5B0017E0B0EC706,38291,10,11,1,109.51618,18.24313,1558
14261,108679,6876B785B3B8E427F5B0017E0B0EC706,31861,12,13,1,109.49042,18.27549,1464
14262,108680,6876B785B3B8E427F5B0017E0B0EC706,60391,18,20,2,109.47667,18.28757,1416
14263,108681,6876B785B3B8E427F5B0017E0B0EC706,60391,22,23,1,109.47667,18.28757,1416
14264,108688,E5B6732ECAB7D8ED8984846CAF5B9677,60411,1,2,1,109.32514,18.30854,869
14265,108689,E5B6732ECAB7D8ED8984846CAF5B9677,30661,3,14,11,109.37028,18.24361,1008
14266,108690,E5B6732ECAB7D8ED8984846CAF5B9677,60411,18,19,1,109.32514,18.30854,869
14267,108691,E5B6732ECAB7D8ED8984846CAF5B9677,31471,20,22,2,109.34583,18.29563,917
14274,108877,F8D799D9161B0143E0D71C40472A357E,38991,1,2,1,109.52681,18.30368,1618
14275,108878,F8D799D9161B0143E0D71C40472A357E,30071,3,13,10,109.52819,18.30472,1619
14276,108879,F8D799D9161B0143E0D71C40472A357E,60371,14,16,2,109.53063,18.30056,1618
14277,108880,F8D799D9161B0143E0D71C40472A357E,30071,16,17,1,109.52819,18.30472,1619
14278,108881,F8D799D9161B0143E0D71C40472A357E,60371,17,20,3,109.53063,18.30056,1618
14279,108882,F8D799D9161B0143E0D71C40472A357E,30071,20,23,3,109.52819,18.30472,1619
14280,108887,5EE25A6E7DD554FFDA0C9C1A504114B7,30221,0,17,17,109.57833,18.20222,1802
14281,108888,5EE25A6E7DD554FFDA0C9C1A504114B7,30281,18,20,2,109.50597,18.27583,1514
14282,108889,8BDE8C6966F9C7122ABA59EA6C195945,30201,0,6,6,109.4909,18.26465,1462
14283,108890,8BDE8C6966F9C7122ABA59EA6C195945,60552,9,10,1,109.41729,18.30014,1218
14284,108891,8BDE8C6966F9C7122ABA59EA6C195945,31081,12,23,11,109.44639,18.30181,1318
14285,108900,599AFAF71D30C85AA4E0085C43FF5E03,31291,16,19,3,109.30375,18.40729,786
14286,108901,599AFAF71D30C85AA4E0085C43FF5E03,30191,21,23,2,109.50361,18.22701,1506
14287,108905,E7DB0F55EDE33BB4C08C98B80B7173BF,60371,0,15,15,109.53063,18.30056,1618
14288,108906,E7DB0F55EDE33BB4C08C98B80B7173BF,30711,16,17,1,109.50271,18.25347,1510
14289,108907,E7DB0F55EDE33BB4C08C98B80B7173BF,60371,21,23,2,109.53063,18.30056,1618
14296,108990,079A114D194FE2EFB0C89059CA4EBC03,31251,8,11,3,109.18528,18.2975,317
14297,108992,079A114D194FE2EFB0C89059CA4EBC03,31251,21,23,2,109.18528,18.2975,317
14298,109011,41C1A1FB9866C68EBD84D3368C71BD84,60361,0,1,1,109.51938,18.29681,1567
14299,109012,41C1A1FB9866C68EBD84D3368C71BD84,38991,3,4,1,109.52681,18.30368,1618
14303,109067,B918E6C7FDB4745FD59F18F0F2FA3EBF,60561,0,9,9,109.38229,18.29785,1067
14304,109068,B918E6C7FDB4745FD59F18F0F2FA3EBF,31301,12,13,1,109.14493,18.31222,170
14305,109069,B918E6C7FDB4745FD59F18F0F2FA3EBF,31471,14,16,2,109.34583,18.29563,917
14306,109070,B918E6C7FDB4745FD59F18F0F2FA3EBF,31345,20,21,1,109.39,18.29,1066
14307,109071,B918E6C7FDB4745FD59F18F0F2FA3EBF,60561,22,23,1,109.38229,18.29785,1067
14308,109080,07E6DBC1CBF6E28010B852A4869AF3C1,38117,0,1,1,109.51611,18.22354,1555
14309,109081,07E6DBC1CBF6E28010B852A4869AF3C1,31521,2,9,7,109.51458,18.22542,1555
14310,109082,07E6DBC1CBF6E28010B852A4869AF3C1,31781,14,15,1,109.19847,18.2975,367
14311,109083,07E6DBC1CBF6E28010B852A4869AF3C1,31521,19,20,1,109.51458,18.22542,1555
14312,109091,0E8B1439B24B1B4D8878744BF677E6B0,31081,0,7,7,109.44639,18.30181,1318
14313,109112,C6C3BC01E542B810EF853FEEB6C81198,60361,0,18,18,109.51938,18.29681,1567
14314,109113,C6C3BC01E542B810EF853FEEB6C81198,31561,19,21,2,109.56792,18.28479,1765
14315,109139,6C0260646767B781577B5B8CE2471E51,60361,8,9,1,109.51938,18.29681,1567
14316,109140,6C0260646767B781577B5B8CE2471E51,38484,9,12,3,109.53028,18.31528,1620
14317,109141,6C0260646767B781577B5B8CE2471E51,30561,13,17,4,109.52778,18.31938,1621
14318,109142,6C0260646767B781577B5B8CE2471E51,38484,18,23,5,109.53028,18.31528,1620
14319,109143,D8FC06AF709B18887F7AC647DFC080AD,31071,3,4,1,109.58257,18.28458,1815
14320,109144,D8FC06AF709B18887F7AC647DFC080AD,30854,7,8,1,109.56889,18.27076,1763
14321,109189,A1C95B17C868D553635D99A0D1B2A324,39041,0,10,10,109.40021,18.29278,1117
14322,109191,A1C95B17C868D553635D99A0D1B2A324,60321,19,22,3,109.63611,18.24306,2008
14323,109192,A1C95B17C868D553635D99A0D1B2A324,30441,22,23,1,109.64021,18.25424,2010
14324,109238,FAC035CAF00431CACD74AF53D18C4996,60011,0,5,5,109.48965,18.30222,1468
14325,109239,FAC035CAF00431CACD74AF53D18C4996,30764,8,9,1,109.45806,18.29486,1367
14326,109240,FAC035CAF00431CACD74AF53D18C4996,60011,12,13,1,109.48965,18.30222,1468
14327,109241,FAC035CAF00431CACD74AF53D18C4996,30111,14,20,6,109.47583,18.30542,1419
14328,109242,FAC035CAF00431CACD74AF53D18C4996,60011,22,23,1,109.48965,18.30222,1468
14329,109243,8039EB5AFB4AD782481BED6ABCE4707B,38961,0,7,7,109.50847,18.23514,1507
14330,109244,8039EB5AFB4AD782481BED6ABCE4707B,31201,8,10,2,109.51042,18.23819,1558
14331,109245,8039EB5AFB4AD782481BED6ABCE4707B,30661,11,14,3,109.37028,18.24361,1008
14332,109246,8039EB5AFB4AD782481BED6ABCE4707B,60291,19,20,1,109.50826,18.24639,1509
14333,109247,8039EB5AFB4AD782481BED6ABCE4707B,60081,22,23,1,109.51097,18.22639,1556
14334,109255,A59893CF63A9A48BE0D9E2ED611A9BB2,30721,10,11,1,109.51597,18.28257,1565
14335,109256,A59893CF63A9A48BE0D9E2ED611A9BB2,30361,14,15,1,109.50347,18.24,1508
14336,109257,A59893CF63A9A48BE0D9E2ED611A9BB2,31181,15,16,1,109.50382,18.24813,1509
14337,109280,7D72A79F2F964580140FF5C346A60898,30351,1,9,8,109.41701,18.29292,1217
14338,109281,7D72A79F2F964580140FF5C346A60898,38951,11,22,11,109.48097,18.28868,1416
14339,109310,8AABF5FDF2B06EB445749240A3894969,31851,14,16,2,109.71736,18.29007,2316
14340,109311,8AABF5FDF2B06EB445749240A3894969,39183,18,19,1,109.55542,18.28208,1715
14341,109312,8AABF5FDF2B06EB445749240A3894969,31071,21,22,1,109.58257,18.28458,1815
14342,109378,1BFCB821873EA5E9C4E86C2745A476F9,31021,0,7,7,109.49021,18.27,1463
14343,109379,1BFCB821873EA5E9C4E86C2745A476F9,38291,10,22,12,109.51618,18.24313,1558
14344,109411,86360CBE83A45C2F8F04805EB9121831,31231,2,3,1,109.42597,18.29292,1217
14345,109412,86360CBE83A45C2F8F04805EB9121831,60552,3,9,6,109.41729,18.30014,1218
14346,109413,86360CBE83A45C2F8F04805EB9121831,31251,12,14,2,109.18528,18.2975,317
14347,109414,86360CBE83A45C2F8F04805EB9121831,38157,15,17,2,109.51483,18.26958,1563
14348,109415,86360CBE83A45C2F8F04805EB9121831,31061,19,21,2,109.53333,18.23257,1607
14349,109416,86360CBE83A45C2F8F04805EB9121831,38157,22,23,1,109.51483,18.26958,1563
14350,109417,61D3315701F57B042BD8C284665DED51,30181,0,9,9,109.51597,18.23313,1557
14351,109418,61D3315701F57B042BD8C284665DED51,31521,10,14,4,109.51458,18.22542,1555
14352,109419,61D3315701F57B042BD8C284665DED51,30181,14,16,2,109.51597,18.23313,1557
14353,109420,61D3315701F57B042BD8C284665DED51,31521,19,20,1,109.51458,18.22542,1555
14354,109421,61D3315701F57B042BD8C284665DED51,30181,21,23,2,109.51597,18.23313,1557
14355,109438,E8BAAF476E8FE57075BAB1A8D4FF1780,60631,0,2,2,109.57778,18.27583,1814
14356,109439,E8BAAF476E8FE57075BAB1A8D4FF1780,31071,2,5,3,109.58257,18.28458,1815
14357,109440,E8BAAF476E8FE57075BAB1A8D4FF1780,30232,5,7,2,109.6191,18.31701,1971
14358,109441,E8BAAF476E8FE57075BAB1A8D4FF1780,30151,19,21,2,109.50986,18.25083,1560
14359,109442,E8BAAF476E8FE57075BAB1A8D4FF1780,39371,21,23,2,109.56627,18.2646,1762
14360,109532,7C16827D646BDC874DE2BD7EE32189C5,30854,0,14,14,109.56889,18.27076,1763
14361,109533,7C16827D646BDC874DE2BD7EE32189C5,30711,18,19,1,109.50271,18.25347,1510
14362,109541,10BCCD747640470AAA03DB965CE24293,31931,18,19,1,109.54771,18.29403,1667
14363,109542,10BCCD747640470AAA03DB965CE24293,30084,20,23,3,109.50118,18.26972,1513
14364,109544,798BF3B08F72A16A6DEAAA235F1899BB,61011,1,10,9,109.60653,18.19076,1900
14365,109590,078D60DC1D1055276AB6F3C64302289E,39191,0,2,2,109.51493,18.23472,1557
14366,109591,078D60DC1D1055276AB6F3C64302289E,38157,2,9,7,109.51483,18.26958,1563
14367,109595,209DF6A91F218920F5741E5EF3086DD3,60131,19,20,1,109.49819,18.24778,1509
14368,109596,209DF6A91F218920F5741E5EF3086DD3,31071,22,23,1,109.58257,18.28458,1815
14369,109622,D56A67341D1DA856D04BC2181FD404FB,60552,15,17,2,109.41729,18.30014,1218
14370,109623,D56A67341D1DA856D04BC2181FD404FB,60541,21,23,2,109.4084,18.29208,1167
14378,109809,59F29435D748531F416A4F1636997ECF,31071,2,5,3,109.58257,18.28458,1815
14379,109810,59F29435D748531F416A4F1636997ECF,60631,6,7,1,109.57778,18.27583,1814
14380,109811,59F29435D748531F416A4F1636997ECF,30854,10,12,2,109.56889,18.27076,1763
14381,109812,59F29435D748531F416A4F1636997ECF,60631,17,19,2,109.57778,18.27583,1814
14382,109813,59F29435D748531F416A4F1636997ECF,30854,19,22,3,109.56889,18.27076,1763
14399,109920,90EBD51E9F0794ACBFB06B2CFE74F920,38951,0,7,7,109.48097,18.28868,1416
14400,109921,90EBD51E9F0794ACBFB06B2CFE74F920,30101,11,12,1,109.57299,18.33333,1773
14401,109922,90EBD51E9F0794ACBFB06B2CFE74F920,30941,14,22,8,109.5559,18.33938,1724
14402,109957,CF1922E57BC1E2D5DC4336E820C48B77,60411,1,19,18,109.32514,18.30854,869
14403,109958,CF1922E57BC1E2D5DC4336E820C48B77,30711,21,23,2,109.50271,18.25347,1510
14404,110036,16CCFF81838B15A70A44E8C4B6CCB914,30771,10,13,3,109.49938,18.26042,1511
14405,110039,222E0B6922623CE9FBB280F81068D40E,60084,0,1,1,109.4984,18.2334,1507
14406,110040,222E0B6922623CE9FBB280F81068D40E,30731,5,8,3,109.50944,18.22306,1555
14407,110041,222E0B6922623CE9FBB280F81068D40E,60631,10,12,2,109.57778,18.27583,1814
14408,110068,3A7681A070628480C91E38C95BBBD8F4,38185,0,6,6,109.51333,18.27347,1563
14409,110087,90D91A493F9482486DCC3B27CF3F61EE,31071,10,12,2,109.58257,18.28458,1815
14410,110088,90D91A493F9482486DCC3B27CF3F61EE,30854,15,17,2,109.56889,18.27076,1763
14411,110089,90D91A493F9482486DCC3B27CF3F61EE,31071,21,22,1,109.58257,18.28458,1815
14412,110095,7C68E1F4B8B2F3CBBD5427BF66BF9C2E,30854,2,5,3,109.56889,18.27076,1763
14413,110096,7C68E1F4B8B2F3CBBD5427BF66BF9C2E,31571,8,11,3,109.61563,18.23326,1957
14414,110097,7C68E1F4B8B2F3CBBD5427BF66BF9C2E,60214,15,16,1,109.63104,18.24493,2009
14415,110139,7F6E66BC10419161F6457A6D79258EDB,31361,1,7,6,109.47417,18.28292,1415
14416,110140,7F6E66BC10419161F6457A6D79258EDB,31431,8,10,2,109.44639,18.29042,1316
14417,110141,7F6E66BC10419161F6457A6D79258EDB,38094,10,11,1,109.45403,18.28778,1316
14418,110142,7F6E66BC10419161F6457A6D79258EDB,38251,11,13,2,109.49618,18.25493,1510
14419,110143,7F6E66BC10419161F6457A6D79258EDB,30341,14,17,3,109.3625,18.29167,966
14420,110144,7F6E66BC10419161F6457A6D79258EDB,60621,19,23,4,109.48354,18.27451,1464
14425,110273,B530FB0D6C312ECBD89B74FD22C716DB,30361,11,14,3,109.50347,18.24,1508
14426,110274,B530FB0D6C312ECBD89B74FD22C716DB,30181,18,19,1,109.51597,18.23313,1557
14427,110275,B530FB0D6C312ECBD89B74FD22C716DB,30361,20,22,2,109.50347,18.24,1508
14432,110310,C925EDC1C2C39BAEC75090090BF059D6,30741,0,9,9,109.49833,18.28681,1516
14433,110311,C925EDC1C2C39BAEC75090090BF059D6,30741,11,12,1,109.49833,18.28681,1516
14434,110312,C925EDC1C2C39BAEC75090090BF059D6,60472,13,15,2,109.46625,18.29542,1367
14435,110313,C925EDC1C2C39BAEC75090090BF059D6,60381,18,21,3,109.5241,18.22458,1605
14436,110317,F95DF9F1082F8C3737D4149B9D06BBC7,31031,13,15,2,109.49979,18.25382,1510
14437,110345,D4EE8E1A4C04A1FF0596E4221D0B8B42,31071,0,7,7,109.58257,18.28458,1815
14438,110346,D4EE8E1A4C04A1FF0596E4221D0B8B42,30581,9,11,2,109.62257,18.24951,1959
14439,110347,D4EE8E1A4C04A1FF0596E4221D0B8B42,30854,13,14,1,109.56889,18.27076,1763
14440,110348,D4EE8E1A4C04A1FF0596E4221D0B8B42,31071,16,17,1,109.58257,18.28458,1815
14441,110349,D4EE8E1A4C04A1FF0596E4221D0B8B42,30854,17,19,2,109.56889,18.27076,1763
14442,110353,DA63805BBCE023D492D9D90DCDDBF5FA,31521,2,19,17,109.51458,18.22542,1555
14443,110354,DA63805BBCE023D492D9D90DCDDBF5FA,30421,20,21,1,109.50021,18.25861,1511
14444,110370,5A888DC7A3AA300CC584D9862C5384A1,60361,0,5,5,109.51938,18.29681,1567
14445,110371,5A888DC7A3AA300CC584D9862C5384A1,60221,6,8,2,109.52569,18.29188,1616
14446,110372,5A888DC7A3AA300CC584D9862C5384A1,30421,9,11,2,109.50021,18.25861,1511
14447,110373,5A888DC7A3AA300CC584D9862C5384A1,39183,15,17,2,109.55542,18.28208,1715
14448,110374,5A888DC7A3AA300CC584D9862C5384A1,30421,21,23,2,109.50021,18.25861,1511
14449,110394,0978FEE828281B6259B40272A2C5BBE2,38251,0,11,11,109.49618,18.25493,1510
14450,110395,0978FEE828281B6259B40272A2C5BBE2,31031,11,23,12,109.49979,18.25382,1510
14454,110494,6733B324E753B6172A50174A4CB1E5C2,31251,10,23,13,109.18528,18.2975,317
14455,110542,8877F0646282478FC034CF7A2CC8A7FE,31521,18,19,1,109.51458,18.22542,1555
14456,110543,8877F0646282478FC034CF7A2CC8A7FE,31031,20,21,1,109.49979,18.25382,1510
14461,110669,A9C7C0A15D485E40B43093FA63B4F0D5,31521,0,8,8,109.51458,18.22542,1555
14462,110670,A9C7C0A15D485E40B43093FA63B4F0D5,31521,8,13,5,109.51458,18.22542,1555
14463,110671,A9C7C0A15D485E40B43093FA63B4F0D5,30201,13,15,2,109.4909,18.26465,1462
14464,110672,A9C7C0A15D485E40B43093FA63B4F0D5,31521,17,19,2,109.51458,18.22542,1555
14465,110673,A9C7C0A15D485E40B43093FA63B4F0D5,31521,19,23,4,109.51458,18.22542,1555
14469,110702,81D70A3ED522BA9C5A3A11D0C612F029,30191,2,7,5,109.50361,18.22701,1506
14470,110703,81D70A3ED522BA9C5A3A11D0C612F029,30661,12,16,4,109.37028,18.24361,1008
14471,110704,81D70A3ED522BA9C5A3A11D0C612F029,30191,19,22,3,109.50361,18.22701,1506
14472,110722,DE841C2C767041F00D7DAF75FFC633F6,30771,2,4,2,109.49938,18.26042,1511
14473,110723,DE841C2C767041F00D7DAF75FFC633F6,30421,5,21,16,109.50021,18.25861,1511
14478,110791,115CE8C7CCAA1288E5461F613949EE4B,60231,0,1,1,109.49903,18.21972,1504
14479,110792,115CE8C7CCAA1288E5461F613949EE4B,60084,5,7,2,109.4984,18.2334,1507
14480,110793,115CE8C7CCAA1288E5461F613949EE4B,60161,11,13,2,109.49174,18.26181,1461
14481,110794,115CE8C7CCAA1288E5461F613949EE4B,30571,19,20,1,109.50243,18.21861,1504
14482,110795,115CE8C7CCAA1288E5461F613949EE4B,60231,21,23,2,109.49903,18.21972,1504
14483,110833,63CB222117AB8A54673799718246EF46,60211,0,1,1,109.63549,18.26049,2011
14484,110834,63CB222117AB8A54673799718246EF46,30084,2,8,6,109.50118,18.26972,1513
14485,110835,63CB222117AB8A54673799718246EF46,31031,9,12,3,109.49979,18.25382,1510
14486,110836,63CB222117AB8A54673799718246EF46,30081,12,18,6,109.50243,18.26632,1512
14487,110837,63CB222117AB8A54673799718246EF46,31041,18,19,1,109.50278,18.23701,1507
14488,110838,63CB222117AB8A54673799718246EF46,39021,20,21,1,109.40368,18.41035,1186
14489,110843,B76381FBDC68F2B2041DDEC63195F0A7,39181,0,13,13,109.55153,18.28035,1715
14490,110844,B76381FBDC68F2B2041DDEC63195F0A7,39181,18,23,5,109.55153,18.28035,1715
14491,110851,E88B3320D5DB9B353136C87713851D2A,31521,2,6,4,109.51458,18.22542,1555
14492,110989,536FDE9EE57B9B41900B9D9A3C619439,38951,0,5,5,109.48097,18.28868,1416
14493,110990,536FDE9EE57B9B41900B9D9A3C619439,38951,5,7,2,109.48097,18.28868,1416
14494,110991,536FDE9EE57B9B41900B9D9A3C619439,30101,8,10,2,109.57299,18.33333,1773
14495,110992,536FDE9EE57B9B41900B9D9A3C619439,30941,15,17,2,109.5559,18.33938,1724
14496,110993,536FDE9EE57B9B41900B9D9A3C619439,31031,18,19,1,109.49979,18.25382,1510
14497,110994,536FDE9EE57B9B41900B9D9A3C619439,30941,21,22,1,109.5559,18.33938,1724
14498,111014,BC81783A71088C7320F6E595223A70F0,38017,17,21,4,109.49729,18.21424,1504
14499,111015,BC81783A71088C7320F6E595223A70F0,38017,22,23,1,109.49729,18.21424,1504
14500,111023,CD3BCBAB8571FB81953C842A434E5DB8,31071,0,2,2,109.58257,18.28458,1815
14501,111024,CD3BCBAB8571FB81953C842A434E5DB8,39371,2,3,1,109.56627,18.2646,1762
14502,111025,CD3BCBAB8571FB81953C842A434E5DB8,31071,3,6,3,109.58257,18.28458,1815
14503,111026,CD3BCBAB8571FB81953C842A434E5DB8,30854,6,11,5,109.56889,18.27076,1763
14504,111027,CD3BCBAB8571FB81953C842A434E5DB8,31071,12,14,2,109.58257,18.28458,1815
14505,111028,CD3BCBAB8571FB81953C842A434E5DB8,30854,16,18,2,109.56889,18.27076,1763
14506,111029,50AA1262E2A8C18D2F0FC1A87B60622A,31101,13,14,1,109.65389,18.23403,2057
14507,111030,50AA1262E2A8C18D2F0FC1A87B60622A,31391,14,16,2,109.50382,18.24285,1508
14508,111031,50AA1262E2A8C18D2F0FC1A87B60622A,30761,17,22,5,109.45201,18.3,1318
14512,111094,5D06B39D1C4AAC35B6AB826D6203C7C7,60401,0,4,4,109.47444,18.27583,1414
14513,111095,5D06B39D1C4AAC35B6AB826D6203C7C7,39151,4,7,3,109.49875,18.25097,1510
14514,111096,5D06B39D1C4AAC35B6AB826D6203C7C7,30051,10,11,1,109.48917,18.21215,1453
14515,111097,5D06B39D1C4AAC35B6AB826D6203C7C7,60081,12,13,1,109.51097,18.22639,1556
14520,111132,278D81878D480BD6212A8447217A6EDC,30941,14,16,2,109.5559,18.33938,1724
14521,111133,278D81878D480BD6212A8447217A6EDC,38951,19,23,4,109.48097,18.28868,1416
14526,111168,B29EF08BE3B3DB2A02535CE10F50F893,31931,9,19,10,109.54771,18.29403,1667
14527,111169,B29EF08BE3B3DB2A02535CE10F50F893,30921,20,21,1,109.53903,18.29451,1667
14528,111202,C0F04DA5BBC3EA089436357A9062298C,38117,1,3,2,109.51611,18.22354,1555
14529,111203,C0F04DA5BBC3EA089436357A9062298C,31521,5,10,5,109.51458,18.22542,1555
14530,111204,C0F04DA5BBC3EA089436357A9062298C,39321,11,13,2,109.529,18.2167,1604
14531,111205,C0F04DA5BBC3EA089436357A9062298C,31521,14,16,2,109.51458,18.22542,1555
14532,111206,C0F04DA5BBC3EA089436357A9062298C,38071,21,23,2,109.40722,18.30938,1169
14533,111219,EE235D4EDEAD413BED10164C21875CA9,60551,0,7,7,109.42722,18.30111,1218
14534,111220,EE235D4EDEAD413BED10164C21875CA9,30941,11,17,6,109.5559,18.33938,1724
14535,111221,EE235D4EDEAD413BED10164C21875CA9,31031,20,23,3,109.49979,18.25382,1510
14536,111226,5264833F0013AE6B294396000613EF89,30211,18,21,3,109.49882,18.23931,1508
14537,111227,5264833F0013AE6B294396000613EF89,60201,21,23,2,109.5041,18.2509,1510
14541,111270,2F440A235E684ECEDD042B3100A4AE95,30854,13,18,5,109.56889,18.27076,1763
14542,111271,2F440A235E684ECEDD042B3100A4AE95,31561,18,19,1,109.56792,18.28479,1765
14543,111272,2F440A235E684ECEDD042B3100A4AE95,31071,21,23,2,109.58257,18.28458,1815
14551,111318,028777DBF8176CB8A735B293EDB3D71F,31931,0,1,1,109.54771,18.29403,1667
14552,111319,028777DBF8176CB8A735B293EDB3D71F,39181,3,4,1,109.55153,18.28035,1715
14553,111320,028777DBF8176CB8A735B293EDB3D71F,31931,6,9,3,109.54771,18.29403,1667
14554,111321,028777DBF8176CB8A735B293EDB3D71F,39181,10,11,1,109.55153,18.28035,1715
14555,111322,028777DBF8176CB8A735B293EDB3D71F,39181,17,19,2,109.55153,18.28035,1715
14556,111323,028777DBF8176CB8A735B293EDB3D71F,31931,21,23,2,109.54771,18.29403,1667
14557,111331,5395D4F841A8132E16F3DF02F491AC07,39191,0,1,1,109.51493,18.23472,1557
14558,111332,5395D4F841A8132E16F3DF02F491AC07,31521,2,4,2,109.51458,18.22542,1555
14559,111333,5395D4F841A8132E16F3DF02F491AC07,30181,5,7,2,109.51597,18.23313,1557
14560,111334,5395D4F841A8132E16F3DF02F491AC07,31521,7,8,1,109.51458,18.22542,1555
14561,111335,5395D4F841A8132E16F3DF02F491AC07,30181,9,23,14,109.51597,18.23313,1557
14565,111379,0312B43ACF9ED1D8304E325E851AEE29,31561,9,16,7,109.56792,18.28479,1765
14566,111380,0312B43ACF9ED1D8304E325E851AEE29,30851,19,20,1,109.5616,18.27396,1713
14570,111423,67D30B307FD4639F5D7DA8C23EB3E033,30941,9,10,1,109.5559,18.33938,1724
14571,111424,67D30B307FD4639F5D7DA8C23EB3E033,60291,12,14,2,109.50826,18.24639,1509
14572,111425,67D30B307FD4639F5D7DA8C23EB3E033,31145,16,17,1,109.20431,18.30479,369
14573,111427,AF8951243335C5641CA49F5E1C1B4359,30921,1,8,7,109.53903,18.29451,1667
14574,111428,AF8951243335C5641CA49F5E1C1B4359,31931,9,10,1,109.54771,18.29403,1667
14575,111429,AF8951243335C5641CA49F5E1C1B4359,30921,11,12,1,109.53903,18.29451,1667
14576,111430,AF8951243335C5641CA49F5E1C1B4359,30721,19,20,1,109.51597,18.28257,1565
14577,111431,AF8951243335C5641CA49F5E1C1B4359,30921,21,22,1,109.53903,18.29451,1667
14578,111475,5CC1762A5E087A77C8027D2CC6A16A88,60371,15,16,1,109.53063,18.30056,1618
14579,111476,5CC1762A5E087A77C8027D2CC6A16A88,38991,17,23,6,109.52681,18.30368,1618
14584,111499,95995BA11779CD05AD5B8FAE514E91EC,60361,0,3,3,109.51938,18.29681,1567
14585,111500,95995BA11779CD05AD5B8FAE514E91EC,30921,4,5,1,109.53903,18.29451,1667
14586,111501,95995BA11779CD05AD5B8FAE514E91EC,30324,8,9,1,109.50326,18.29257,1517
14587,111502,95995BA11779CD05AD5B8FAE514E91EC,60361,10,12,2,109.51938,18.29681,1567
14588,111503,95995BA11779CD05AD5B8FAE514E91EC,30324,14,18,4,109.50326,18.29257,1517
14589,111504,95995BA11779CD05AD5B8FAE514E91EC,60361,19,23,4,109.51938,18.29681,1567
14596,111615,0226E559545DD94A540AD0319E8FE2BE,31701,0,8,8,109.44132,18.28833,1266
14597,111620,45CCFCD3EBDF941E1C92B70ED06E8B5E,31561,0,5,5,109.56792,18.28479,1765
14598,111621,45CCFCD3EBDF941E1C92B70ED06E8B5E,30854,9,10,1,109.56889,18.27076,1763
14599,111622,45CCFCD3EBDF941E1C92B70ED06E8B5E,31071,12,14,2,109.58257,18.28458,1815
14600,111623,45CCFCD3EBDF941E1C92B70ED06E8B5E,30854,14,16,2,109.56889,18.27076,1763
14601,111624,45CCFCD3EBDF941E1C92B70ED06E8B5E,38991,18,19,1,109.52681,18.30368,1618
14602,111625,45CCFCD3EBDF941E1C92B70ED06E8B5E,31561,21,22,1,109.56792,18.28479,1765
14603,111648,0004E9A02B9F97024FE46D8B36381EE9,31031,18,19,1,109.49979,18.25382,1510
14604,111649,6B806948BC9187A91D033B4096721B00,30854,5,6,1,109.56889,18.27076,1763
14605,111650,6B806948BC9187A91D033B4096721B00,31071,11,19,8,109.58257,18.28458,1815
14606,111659,F621296F333E8058687ACD884B135C6E,30504,2,5,3,109.705,18.35368,2277
14607,111660,F621296F333E8058687ACD884B135C6E,31181,6,7,1,109.50382,18.24813,1509
14608,111661,F621296F333E8058687ACD884B135C6E,60291,8,9,1,109.50826,18.24639,1509
14609,111724,1CB7DA025FB95AE18ED5AC1449EEA03C,31081,1,10,9,109.44639,18.30181,1318
14610,111725,1CB7DA025FB95AE18ED5AC1449EEA03C,31145,12,15,3,109.20431,18.30479,369
14611,111726,1CB7DA025FB95AE18ED5AC1449EEA03C,38754,16,17,1,109.74667,18.37382,2430
14612,111727,1CB7DA025FB95AE18ED5AC1449EEA03C,30151,19,21,2,109.50986,18.25083,1560
14613,111741,A378B693C957D4993D23498947213CD6,31181,18,19,1,109.50382,18.24813,1509
14614,111754,E65658506C2BF9C993BA69EE6D38B3C6,60361,0,1,1,109.51938,18.29681,1567
14615,111755,E65658506C2BF9C993BA69EE6D38B3C6,31951,2,3,1,109.52174,18.30299,1568
14616,111756,E65658506C2BF9C993BA69EE6D38B3C6,60361,4,5,1,109.51938,18.29681,1567
14617,111757,E65658506C2BF9C993BA69EE6D38B3C6,31951,6,14,8,109.52174,18.30299,1568
14618,111758,E65658506C2BF9C993BA69EE6D38B3C6,60361,16,18,2,109.51938,18.29681,1567
14619,111811,14DC9638CB494ECD60B58F300BAA61B6,39181,0,6,6,109.55153,18.28035,1715
14620,111812,14DC9638CB494ECD60B58F300BAA61B6,39181,9,22,13,109.55153,18.28035,1715
14621,111844,11150C7195A88F4196F1FFE1C448FD6F,31945,15,16,1,109.58021,18.29403,1817
14622,111845,11150C7195A88F4196F1FFE1C448FD6F,60501,18,20,2,109.48701,18.29021,1466
14623,111846,11150C7195A88F4196F1FFE1C448FD6F,31521,21,23,2,109.51458,18.22542,1555
14635,111912,57E5041E0C0E731808C5DA6C9EE240E2,31521,14,20,6,109.51458,18.22542,1555
14636,111913,57E5041E0C0E731808C5DA6C9EE240E2,38071,21,22,1,109.40722,18.30938,1169
14641,111943,6587551DA47309E484D1302521C8D417,60631,1,3,2,109.57778,18.27583,1814
14642,111944,6587551DA47309E484D1302521C8D417,38275,7,11,4,109.62875,18.22938,2006
14643,111945,6587551DA47309E484D1302521C8D417,60631,14,15,1,109.57778,18.27583,1814
14644,111946,6587551DA47309E484D1302521C8D417,38275,17,22,5,109.62875,18.22938,2006
14648,111985,73E2E1BE5471172391E67FF4D9056766,60401,0,7,7,109.47444,18.27583,1414
14649,111986,73E2E1BE5471172391E67FF4D9056766,31031,11,12,1,109.49979,18.25382,1510
14650,111998,3977578BE56276DA0700B04B81DC1356,30851,0,1,1,109.5616,18.27396,1713
14651,111999,3977578BE56276DA0700B04B81DC1356,31561,2,3,1,109.56792,18.28479,1765
14652,112000,3977578BE56276DA0700B04B81DC1356,30851,3,6,3,109.5616,18.27396,1713
14653,112001,3977578BE56276DA0700B04B81DC1356,31561,6,15,9,109.56792,18.28479,1765
14654,112002,3977578BE56276DA0700B04B81DC1356,31071,19,20,1,109.58257,18.28458,1815
14655,112083,AD608A919061B1C684914F8654FB2493,30101,17,18,1,109.57299,18.33333,1773
14656,112084,AD608A919061B1C684914F8654FB2493,30241,20,22,2,109.26174,18.3275,622
14657,112157,42815E00E74F2DEE06DE8ADA6B858662,30854,9,10,1,109.56889,18.27076,1763
14658,112158,42815E00E74F2DEE06DE8ADA6B858662,31561,11,12,1,109.56792,18.28479,1765
14659,112159,42815E00E74F2DEE06DE8ADA6B858662,30854,14,16,2,109.56889,18.27076,1763
14660,112196,44CB5F545D2E3587ACF209AB2414C1A1,30854,14,16,2,109.56889,18.27076,1763
14661,112197,44CB5F545D2E3587ACF209AB2414C1A1,31071,18,20,2,109.58257,18.28458,1815
14662,112198,56C8C781972E8BFAF8A768A19AD7F590,31861,0,1,1,109.49042,18.27549,1464
14663,112199,56C8C781972E8BFAF8A768A19AD7F590,30281,1,7,6,109.50597,18.27583,1514
14664,112210,5D4E252AC551D7DB97A6F7C764F981F2,31351,0,8,8,109.4959,18.28417,1465
14665,112211,5D4E252AC551D7DB97A6F7C764F981F2,38127,10,12,2,109.50833,18.27222,1513
14666,112212,5D4E252AC551D7DB97A6F7C764F981F2,30291,14,15,1,109.50403,18.27028,1513
14667,112213,5D4E252AC551D7DB97A6F7C764F981F2,38127,15,17,2,109.50833,18.27222,1513
14668,112214,5D4E252AC551D7DB97A6F7C764F981F2,31861,20,23,3,109.49042,18.27549,1464
14669,112228,FE1EC0E71A7AFD40F1435A5CA011EA80,30111,0,21,21,109.47583,18.30542,1419
14670,112229,FE1EC0E71A7AFD40F1435A5CA011EA80,38094,22,23,1,109.45403,18.28778,1316
14671,112233,173CD7A2B7B334BC53A50A1D248FBCFE,30854,3,8,5,109.56889,18.27076,1763
14672,112234,173CD7A2B7B334BC53A50A1D248FBCFE,31071,9,10,1,109.58257,18.28458,1815
14673,112235,173CD7A2B7B334BC53A50A1D248FBCFE,30854,10,11,1,109.56889,18.27076,1763
14674,112236,173CD7A2B7B334BC53A50A1D248FBCFE,31071,12,13,1,109.58257,18.28458,1815
14675,112237,173CD7A2B7B334BC53A50A1D248FBCFE,30854,13,20,7,109.56889,18.27076,1763
14676,112238,451E2BF48CD7B253EB0892324E679BCC,30711,16,17,1,109.50271,18.25347,1510
14677,112239,451E2BF48CD7B253EB0892324E679BCC,38297,21,23,2,109.52576,18.24965,1609
14678,112316,DDE77D3A656666992FC3458B84010D43,39183,0,5,5,109.55542,18.28208,1715
14679,112317,DDE77D3A656666992FC3458B84010D43,31561,8,9,1,109.56792,18.28479,1765
14680,112318,DDE77D3A656666992FC3458B84010D43,39183,11,14,3,109.55542,18.28208,1715
14681,112319,DDE77D3A656666992FC3458B84010D43,31561,14,15,1,109.56792,18.28479,1765
14682,112320,DDE77D3A656666992FC3458B84010D43,31931,15,17,2,109.54771,18.29403,1667
14683,112321,DDE77D3A656666992FC3458B84010D43,31561,18,19,1,109.56792,18.28479,1765
14688,112351,5CF4A8FAA851F08835C66E9B9D9918DE,31521,12,14,2,109.51458,18.22542,1555
14689,112352,5CF4A8FAA851F08835C66E9B9D9918DE,31471,16,17,1,109.34583,18.29563,917
14690,112353,5CF4A8FAA851F08835C66E9B9D9918DE,60381,20,22,2,109.5241,18.22458,1605
14694,112388,9646DACA260879D32095F9107B2CAA8C,31411,20,22,2,109.5016,18.23576,1507
14695,112398,866460FA5062A635337B6369BB2AADDA,30854,15,20,5,109.56889,18.27076,1763
14696,112399,866460FA5062A635337B6369BB2AADDA,60631,22,23,1,109.57778,18.27583,1814
14705,112453,074529940A21272589048F79E19D41E0,30441,0,6,6,109.64021,18.25424,2010
14706,112454,074529940A21272589048F79E19D41E0,38275,8,9,1,109.62875,18.22938,2006
14707,112455,074529940A21272589048F79E19D41E0,31321,11,14,3,109.63799,18.23201,2007
14708,112456,074529940A21272589048F79E19D41E0,60381,19,22,3,109.5241,18.22458,1605
14709,112466,B5D5F035B558647FF9F44A76F16A1183,31041,1,8,7,109.50278,18.23701,1507
14710,112468,B5D5F035B558647FF9F44A76F16A1183,31201,16,22,6,109.51042,18.23819,1558
14711,112489,4E9347808E8F02AFB816F8344D637F34,31206,0,1,1,109.50819,18.23549,1507
14712,112490,4E9347808E8F02AFB816F8344D637F34,31701,4,5,1,109.44132,18.28833,1266
14713,112491,4E9347808E8F02AFB816F8344D637F34,30741,5,22,17,109.49833,18.28681,1516
14721,112585,D6B54C643B88B86782DC30A38AD291FD,31561,2,8,6,109.56792,18.28479,1765
14722,112586,D6B54C643B88B86782DC30A38AD291FD,30854,9,11,2,109.56889,18.27076,1763
14723,112609,1FE2866848043A2C10AD87212485FE15,31071,1,7,6,109.58257,18.28458,1815
14724,112610,1FE2866848043A2C10AD87212485FE15,30854,7,21,14,109.56889,18.27076,1763
14725,112692,DE3ACBBFFF90250B316F62451B8DF01D,31781,17,20,3,109.19847,18.2975,367
14726,112693,DE3ACBBFFF90250B316F62451B8DF01D,31781,21,22,1,109.19847,18.2975,367
14730,112712,0695D4E7B3E726CA09D841B87798B560,30854,1,10,9,109.56889,18.27076,1763
14731,112713,0695D4E7B3E726CA09D841B87798B560,30271,12,13,1,109.49132,18.23153,1456
14732,112714,0695D4E7B3E726CA09D841B87798B560,31561,14,15,1,109.56792,18.28479,1765
14733,112715,0695D4E7B3E726CA09D841B87798B560,30854,17,19,2,109.56889,18.27076,1763
14734,112739,B712327B6033C61F37801CFD6DAC08AD,31951,5,6,1,109.52174,18.30299,1568
14735,112740,B712327B6033C61F37801CFD6DAC08AD,38484,7,11,4,109.53028,18.31528,1620
14736,112741,B712327B6033C61F37801CFD6DAC08AD,31951,13,14,1,109.52174,18.30299,1568
14737,112742,B712327B6033C61F37801CFD6DAC08AD,38484,14,18,4,109.53028,18.31528,1620
14738,112743,B712327B6033C61F37801CFD6DAC08AD,38484,18,21,3,109.53028,18.31528,1620
14739,112744,234DDB978581BC47A9F93772F013DD01,60221,0,16,16,109.52569,18.29188,1616
14740,112745,234DDB978581BC47A9F93772F013DD01,31181,19,22,3,109.50382,18.24813,1509
14750,112840,530F0AE3A2D48DD91CDC3A17D13BA70F,38707,0,21,21,109.73778,18.35368,2427
14751,112841,530F0AE3A2D48DD91CDC3A17D13BA70F,60221,22,23,1,109.52569,18.29188,1616
14752,112848,47C8C71AB8A291B23C6D0393C8109E46,38261,0,7,7,109.50361,18.28153,1515
14753,112849,47C8C71AB8A291B23C6D0393C8109E46,31311,9,13,4,109.72299,18.27438,2364
14754,112850,47C8C71AB8A291B23C6D0393C8109E46,38185,14,15,1,109.51333,18.27347,1563
14755,112851,47C8C71AB8A291B23C6D0393C8109E46,38261,17,23,6,109.50361,18.28153,1515
14756,112852,FD348BFB9AA55FE65CC3992170FAFF82,30241,11,14,3,109.26174,18.3275,622
14757,112853,FD348BFB9AA55FE65CC3992170FAFF82,60614,17,18,1,109.48799,18.29521,1467
14761,112950,7FF3C6569A3990C03CAF6C52D3C8BC6C,30921,1,2,1,109.53903,18.29451,1667
14762,112951,7FF3C6569A3990C03CAF6C52D3C8BC6C,31931,7,8,1,109.54771,18.29403,1667
14763,112952,7FF3C6569A3990C03CAF6C52D3C8BC6C,30921,9,10,1,109.53903,18.29451,1667
14764,112953,7FF3C6569A3990C03CAF6C52D3C8BC6C,60241,11,13,2,109.53319,18.28667,1616
14765,112954,7FF3C6569A3990C03CAF6C52D3C8BC6C,31931,17,19,2,109.54771,18.29403,1667
14766,112967,B78E7295CB13532B4E2C30EF158E297F,31931,0,6,6,109.54771,18.29403,1667
14767,112968,B78E7295CB13532B4E2C30EF158E297F,39183,7,23,16,109.55542,18.28208,1715
14768,112993,AA2A5396AD753E9245AC53C94BAEDECD,61011,0,19,19,109.60653,18.19076,1900
14769,113035,192815485DBBC485508837480A81E25C,30051,0,8,8,109.48917,18.21215,1453
14770,113036,192815485DBBC485508837480A81E25C,30571,11,16,5,109.50243,18.21861,1504
14771,113037,192815485DBBC485508837480A81E25C,30571,17,18,1,109.50243,18.21861,1504
14772,113038,192815485DBBC485508837480A81E25C,30051,18,20,2,109.48917,18.21215,1453
14773,113039,192815485DBBC485508837480A81E25C,38881,21,23,2,109.51618,18.26431,1562
14774,113043,48C2384D12D5B16772007E35CE360CBB,30721,0,7,7,109.51597,18.28257,1565
14775,113044,48C2384D12D5B16772007E35CE360CBB,38105,8,10,2,109.40299,18.29229,1117
14776,113045,48C2384D12D5B16772007E35CE360CBB,60541,14,17,3,109.4084,18.29208,1167
14777,113046,48C2384D12D5B16772007E35CE360CBB,31345,21,22,1,109.39,18.29,1066
14781,113139,A928E9F6C796FE1A60807BA003DE87BB,39181,8,10,2,109.55153,18.28035,1715
14782,113140,A928E9F6C796FE1A60807BA003DE87BB,30854,13,14,1,109.56889,18.27076,1763
14783,113141,A928E9F6C796FE1A60807BA003DE87BB,39183,14,16,2,109.55542,18.28208,1715
14784,113142,A928E9F6C796FE1A60807BA003DE87BB,30854,20,23,3,109.56889,18.27076,1763
14785,113197,F7E62C7FDB1E97C4DC2EC3F48A6FAADB,30232,0,5,5,109.6191,18.31701,1971
14786,113198,F7E62C7FDB1E97C4DC2EC3F48A6FAADB,30891,6,9,3,109.59431,18.28389,1865
14787,113199,F7E62C7FDB1E97C4DC2EC3F48A6FAADB,31321,11,12,1,109.63799,18.23201,2007
14788,113200,F7E62C7FDB1E97C4DC2EC3F48A6FAADB,60381,14,15,1,109.5241,18.22458,1605
14789,113201,F7E62C7FDB1E97C4DC2EC3F48A6FAADB,60381,18,19,1,109.5241,18.22458,1605
14790,113202,F7E62C7FDB1E97C4DC2EC3F48A6FAADB,31521,20,22,2,109.51458,18.22542,1555
14795,113269,A749E400BFD3B5908671E939EC104DEE,30854,0,8,8,109.56889,18.27076,1763
14796,113271,A749E400BFD3B5908671E939EC104DEE,30854,16,18,2,109.56889,18.27076,1763
14797,113284,9AF351B3CC27394DFED45513F0E32162,60351,0,7,7,109.58403,18.28958,1816
14798,113285,9AF351B3CC27394DFED45513F0E32162,31061,9,11,2,109.53333,18.23257,1607
14799,113286,9AF351B3CC27394DFED45513F0E32162,39371,14,17,3,109.56627,18.2646,1762
14800,113287,9AF351B3CC27394DFED45513F0E32162,60351,19,23,4,109.58403,18.28958,1816
14804,113308,608A55C14BAB2A5B627ACC1F39B89FB6,31945,0,7,7,109.58021,18.29403,1817
14805,113309,608A55C14BAB2A5B627ACC1F39B89FB6,30854,8,9,1,109.56889,18.27076,1763
14806,113310,608A55C14BAB2A5B627ACC1F39B89FB6,31945,12,13,1,109.58021,18.29403,1817
14807,113311,608A55C14BAB2A5B627ACC1F39B89FB6,30854,15,17,2,109.56889,18.27076,1763
14808,113312,608A55C14BAB2A5B627ACC1F39B89FB6,31945,19,23,4,109.58021,18.29403,1817
14809,113338,F2620FCAAD481C8B0F3979FFE2786ED4,38017,0,4,4,109.49729,18.21424,1504
14810,113339,F2620FCAAD481C8B0F3979FFE2786ED4,38356,5,6,1,109.50201,18.21486,1504
14811,113340,F2620FCAAD481C8B0F3979FFE2786ED4,38017,6,12,6,109.49729,18.21424,1504
14812,113341,F2620FCAAD481C8B0F3979FFE2786ED4,30571,13,15,2,109.50243,18.21861,1504
14813,113342,F2620FCAAD481C8B0F3979FFE2786ED4,38356,19,21,2,109.50201,18.21486,1504
14814,113349,6631651FB15573A8B0C781F858B82603,31231,0,10,10,109.42597,18.29292,1217
14815,113350,6631651FB15573A8B0C781F858B82603,31391,11,12,1,109.50382,18.24285,1508
14816,113351,6631651FB15573A8B0C781F858B82603,33481,14,15,1,109.67278,18.41278,2187
14817,113352,6631651FB15573A8B0C781F858B82603,30271,19,20,1,109.49132,18.23153,1456
14818,113353,6631651FB15573A8B0C781F858B82603,31231,20,22,2,109.42597,18.29292,1217
14819,113354,E232785024C88A21117B5209B44DB58B,31231,17,18,1,109.42597,18.29292,1217
14820,113355,E232785024C88A21117B5209B44DB58B,30681,20,21,1,109.48493,18.26917,1463
14821,113356,E232785024C88A21117B5209B44DB58B,31231,21,23,2,109.42597,18.29292,1217
14822,113362,E8460AE5EC97FDCA776388340866C418,30854,13,15,2,109.56889,18.27076,1763
14823,113363,E8460AE5EC97FDCA776388340866C418,31861,17,23,6,109.49042,18.27549,1464
14827,113511,13166628932DF36C0AD7B1DB5811240A,60631,13,15,2,109.57778,18.27583,1814
14828,113512,13166628932DF36C0AD7B1DB5811240A,60591,18,23,5,109.61118,18.21715,1904
14832,113530,6DF7485545B790F22810B0EDD8F1B356,31945,0,13,13,109.58021,18.29403,1817
14833,113531,6DF7485545B790F22810B0EDD8F1B356,30854,14,22,8,109.56889,18.27076,1763
14834,113532,29C138323F7793FA5DE28E5154764E0B,60381,14,16,2,109.5241,18.22458,1605
14835,113555,15A2A8790389D1537721C21B141A7A31,61011,3,8,5,109.60653,18.19076,1900
14836,113556,15A2A8790389D1537721C21B141A7A31,31071,9,12,3,109.58257,18.28458,1815
14837,113557,15A2A8790389D1537721C21B141A7A31,31571,13,14,1,109.61563,18.23326,1957
14838,113559,15A2A8790389D1537721C21B141A7A31,61011,17,19,2,109.60653,18.19076,1900
14846,113630,7421066246AAD1C230E7E2A7ADF06E9D,30721,0,1,1,109.51597,18.28257,1565
14847,113631,7421066246AAD1C230E7E2A7ADF06E9D,60631,2,6,4,109.57778,18.27583,1814
14848,113632,7421066246AAD1C230E7E2A7ADF06E9D,30854,7,10,3,109.56889,18.27076,1763
14849,113633,7421066246AAD1C230E7E2A7ADF06E9D,60631,12,13,1,109.57778,18.27583,1814
14850,113634,7421066246AAD1C230E7E2A7ADF06E9D,31071,17,18,1,109.58257,18.28458,1815
14851,113635,7421066246AAD1C230E7E2A7ADF06E9D,30854,18,20,2,109.56889,18.27076,1763
14852,113636,7421066246AAD1C230E7E2A7ADF06E9D,60631,21,23,2,109.57778,18.27583,1814
14853,113659,A01B4012B619D942E7CC3AC9B78722B4,30851,20,21,1,109.5616,18.27396,1713
14854,113660,A01B4012B619D942E7CC3AC9B78722B4,31561,21,23,2,109.56792,18.28479,1765
14855,113663,417408FFDA93B177641D270D3A5C4B2D,31071,0,5,5,109.58257,18.28458,1815
14856,113664,417408FFDA93B177641D270D3A5C4B2D,60631,7,9,2,109.57778,18.27583,1814
14857,113665,417408FFDA93B177641D270D3A5C4B2D,31071,12,13,1,109.58257,18.28458,1815
14858,113666,417408FFDA93B177641D270D3A5C4B2D,60631,15,17,2,109.57778,18.27583,1814
14859,113667,417408FFDA93B177641D270D3A5C4B2D,30854,18,19,1,109.56889,18.27076,1763
14860,113668,417408FFDA93B177641D270D3A5C4B2D,31071,20,21,1,109.58257,18.28458,1815
14861,113669,417408FFDA93B177641D270D3A5C4B2D,30854,21,23,2,109.56889,18.27076,1763
14868,113739,EA27C1DACC015E381783BB03940DBA88,38484,0,1,1,109.53028,18.31528,1620
14869,113740,EA27C1DACC015E381783BB03940DBA88,31951,2,6,4,109.52174,18.30299,1568
14870,113772,EFFEF00C078D502D6D0D1D469ACBA466,39154,0,7,7,109.50201,18.25681,1511
14871,113773,EFFEF00C078D502D6D0D1D469ACBA466,31471,10,11,1,109.34583,18.29563,917
14872,113774,EFFEF00C078D502D6D0D1D469ACBA466,38321,12,14,2,109.39854,18.29132,1116
14873,113775,EFFEF00C078D502D6D0D1D469ACBA466,39151,19,20,1,109.49875,18.25097,1510
14874,113776,EFFEF00C078D502D6D0D1D469ACBA466,39041,21,23,2,109.40021,18.29278,1117
14875,113807,D2A5F87218CF25385163A2F3C4229CB8,30851,1,6,5,109.5616,18.27396,1713
14876,113808,D2A5F87218CF25385163A2F3C4229CB8,31561,6,9,3,109.56792,18.28479,1765
14877,113809,D2A5F87218CF25385163A2F3C4229CB8,30851,12,13,1,109.5616,18.27396,1713
14878,113810,D2A5F87218CF25385163A2F3C4229CB8,31271,18,20,2,109.48958,18.26257,1462
14879,113811,D2A5F87218CF25385163A2F3C4229CB8,31561,20,22,2,109.56792,18.28479,1765
14880,113835,675E351075D065B9BC87550D5606DD5B,60621,0,9,9,109.48354,18.27451,1464
14881,113836,675E351075D065B9BC87550D5606DD5B,31864,9,10,1,109.49014,18.28333,1465
14885,113851,BD4652414D5C17466BA36FD4BD943A94,30721,1,7,6,109.51597,18.28257,1565
14886,113852,BD4652414D5C17466BA36FD4BD943A94,31931,8,10,2,109.54771,18.29403,1667
14887,113853,BD4652414D5C17466BA36FD4BD943A94,39183,11,12,1,109.55542,18.28208,1715
14888,113854,BD4652414D5C17466BA36FD4BD943A94,31931,13,14,1,109.54771,18.29403,1667
14889,113855,BD4652414D5C17466BA36FD4BD943A94,39183,16,18,2,109.55542,18.28208,1715
14890,113888,598A5BC9BEA86E74379689160E91B24E,30854,0,6,6,109.56889,18.27076,1763
14891,113889,598A5BC9BEA86E74379689160E91B24E,31071,7,9,2,109.58257,18.28458,1815
14892,113890,598A5BC9BEA86E74379689160E91B24E,30854,10,13,3,109.56889,18.27076,1763
14893,113891,598A5BC9BEA86E74379689160E91B24E,39371,15,18,3,109.56627,18.2646,1762
14894,113892,598A5BC9BEA86E74379689160E91B24E,30854,20,22,2,109.56889,18.27076,1763
14895,113914,528F99F7FD8CA49B85B45B64A5D784BA,39181,12,13,1,109.55153,18.28035,1715
14896,113915,528F99F7FD8CA49B85B45B64A5D784BA,30851,14,17,3,109.5616,18.27396,1713
14897,113935,68D54610D4145F71460044C254B0ACFF,38951,0,7,7,109.48097,18.28868,1416
14898,113936,68D54610D4145F71460044C254B0ACFF,30661,10,11,1,109.37028,18.24361,1008
14899,113937,68D54610D4145F71460044C254B0ACFF,31471,15,17,2,109.34583,18.29563,917
14900,113962,0E1DB444F47235AEDAD0A0404A7B75B4,31561,1,4,3,109.56792,18.28479,1765
14901,113963,0E1DB444F47235AEDAD0A0404A7B75B4,39183,4,7,3,109.55542,18.28208,1715
14902,113964,0E1DB444F47235AEDAD0A0404A7B75B4,31181,10,12,2,109.50382,18.24813,1509
14903,113965,0E1DB444F47235AEDAD0A0404A7B75B4,31181,12,13,1,109.50382,18.24813,1509
14904,113966,0E1DB444F47235AEDAD0A0404A7B75B4,31181,14,16,2,109.50382,18.24813,1509
14905,113967,0E1DB444F47235AEDAD0A0404A7B75B4,31561,19,20,1,109.56792,18.28479,1765
14906,113968,0E1DB444F47235AEDAD0A0404A7B75B4,39183,22,23,1,109.55542,18.28208,1715
14907,113992,88518ED3B6347887E74E353A92E1996C,31421,0,7,7,109.55382,18.22347,1705
14908,113993,88518ED3B6347887E74E353A92E1996C,30631,8,12,4,109.34382,18.32778,922
14909,113994,88518ED3B6347887E74E353A92E1996C,31261,15,16,1,109.51174,18.2466,1559
14910,113995,88518ED3B6347887E74E353A92E1996C,31421,19,22,3,109.55382,18.22347,1705
14911,114005,EA3A8DA5F296698D9CCABAE2F2FD40FF,31521,17,21,4,109.51458,18.22542,1555
14912,114006,EA3A8DA5F296698D9CCABAE2F2FD40FF,31391,21,22,1,109.50382,18.24285,1508
14917,114020,258F9A09B3B0048D107FC9EF9EB27CDE,31521,0,6,6,109.51458,18.22542,1555
14918,114021,258F9A09B3B0048D107FC9EF9EB27CDE,30941,11,13,2,109.5559,18.33938,1724
14919,114022,258F9A09B3B0048D107FC9EF9EB27CDE,30421,15,17,2,109.50021,18.25861,1511
14920,114023,258F9A09B3B0048D107FC9EF9EB27CDE,38251,18,21,3,109.49618,18.25493,1510
14925,114055,2A6BA0678DDF16AF08BAC9E3FA3C9391,31561,0,5,5,109.56792,18.28479,1765
14926,114056,2A6BA0678DDF16AF08BAC9E3FA3C9391,30854,8,16,8,109.56889,18.27076,1763
14931,114108,8BB15E7C959475309A269AAF24FD7109,60201,0,2,2,109.5041,18.2509,1510
14932,114109,8BB15E7C959475309A269AAF24FD7109,39111,3,8,5,109.5191,18.22597,1555
14933,114110,8BB15E7C959475309A269AAF24FD7109,38153,9,12,3,109.51819,18.25736,1561
14934,114111,8BB15E7C959475309A269AAF24FD7109,60291,14,15,1,109.50826,18.24639,1509
14935,114112,8BB15E7C959475309A269AAF24FD7109,60381,18,20,2,109.5241,18.22458,1605
14936,114113,8BB15E7C959475309A269AAF24FD7109,60201,22,23,1,109.5041,18.2509,1510
14940,114176,E8A62C362548F9D5791FD06549C42092,60054,0,3,3,109.3016,18.31229,770
14941,114177,E8A62C362548F9D5791FD06549C42092,31251,4,6,2,109.18528,18.2975,317
14942,114178,E8A62C362548F9D5791FD06549C42092,30661,8,11,3,109.37028,18.24361,1008
14943,114179,E8A62C362548F9D5791FD06549C42092,60054,13,23,10,109.3016,18.31229,770
14944,114192,B3AE4D148E8E9AC234F14BAF6D4A9D67,31621,3,14,11,109.51035,18.29826,1568
14945,114193,B3AE4D148E8E9AC234F14BAF6D4A9D67,60371,15,16,1,109.53063,18.30056,1618
14949,114204,E6A26FB3A5537CE712195E9460AB99FB,30854,8,18,10,109.56889,18.27076,1763
14950,114205,E6A26FB3A5537CE712195E9460AB99FB,60631,20,22,2,109.57778,18.27583,1814
14951,114206,53875E69050EC42E511A64D3211FA7B3,60631,0,6,6,109.57778,18.27583,1814
14952,114207,53875E69050EC42E511A64D3211FA7B3,30854,8,13,5,109.56889,18.27076,1763
14953,114257,85E9F50B5ABCB1024F25DC89F0D41C6E,30151,0,1,1,109.50986,18.25083,1560
14954,114258,85E9F50B5ABCB1024F25DC89F0D41C6E,60281,2,7,5,109.51743,18.25924,1561
14955,114259,85E9F50B5ABCB1024F25DC89F0D41C6E,31041,7,8,1,109.50278,18.23701,1507
14956,114260,85E9F50B5ABCB1024F25DC89F0D41C6E,60211,13,19,6,109.63549,18.26049,2011
14957,114261,85E9F50B5ABCB1024F25DC89F0D41C6E,60551,21,22,1,109.42722,18.30111,1218
14958,114266,5E97A4561E11AAC4FBC53FD068EAA52B,30854,0,6,6,109.56889,18.27076,1763
14959,114267,5E97A4561E11AAC4FBC53FD068EAA52B,30531,8,18,10,109.53271,18.21472,1604
14960,114268,5E97A4561E11AAC4FBC53FD068EAA52B,30854,20,22,2,109.56889,18.27076,1763
14961,114277,1DCF37EE2927C479B1032CB369D26049,31534,1,7,6,109.49368,18.25806,1461
14962,114278,1DCF37EE2927C479B1032CB369D26049,31331,10,11,1,109.38417,18.44111,1091
14963,114279,1DCF37EE2927C479B1032CB369D26049,39021,12,14,2,109.40368,18.41035,1186
14964,114280,1DCF37EE2927C479B1032CB369D26049,38991,16,17,1,109.52681,18.30368,1618
14965,114281,1DCF37EE2927C479B1032CB369D26049,31534,21,23,2,109.49368,18.25806,1461
14966,114282,C19430CE8DF26BDEF43903E57E682236,31561,0,6,6,109.56792,18.28479,1765
14967,114283,C19430CE8DF26BDEF43903E57E682236,30854,7,9,2,109.56889,18.27076,1763
14968,114284,C19430CE8DF26BDEF43903E57E682236,30271,11,13,2,109.49132,18.23153,1456
14969,114285,C19430CE8DF26BDEF43903E57E682236,31561,14,15,1,109.56792,18.28479,1765
14970,114286,C19430CE8DF26BDEF43903E57E682236,30854,16,18,2,109.56889,18.27076,1763
14971,114287,C19430CE8DF26BDEF43903E57E682236,31561,21,23,2,109.56792,18.28479,1765
14972,114313,F2DB26AB62973FED3773C4EB9C268E84,30271,16,18,2,109.49132,18.23153,1456
14973,114314,F2DB26AB62973FED3773C4EB9C268E84,30371,20,22,2,109.51,18.24771,1559
14974,114415,97C90F1B15489B9330C93C4DFFAA8B6A,38283,11,15,4,109.62229,18.22618,1956
14975,114416,97C90F1B15489B9330C93C4DFFAA8B6A,31221,20,22,2,109.61333,18.26833,1913
14976,114420,30CAD64949610A59C64AA42715A6D4D2,38951,0,6,6,109.48097,18.28868,1416
14977,114421,30CAD64949610A59C64AA42715A6D4D2,30101,7,9,2,109.57299,18.33333,1773
14978,114422,30CAD64949610A59C64AA42715A6D4D2,30931,12,13,1,109.55653,18.32722,1722
14979,114423,30CAD64949610A59C64AA42715A6D4D2,38951,15,21,6,109.48097,18.28868,1416
14980,114424,30CAD64949610A59C64AA42715A6D4D2,38951,21,23,2,109.48097,18.28868,1416
14981,114436,27BCEF3137923B84211F08830816C810,60211,18,20,2,109.63549,18.26049,2011
14982,114437,27BCEF3137923B84211F08830816C810,31206,22,23,1,109.50819,18.23549,1507
14983,114445,5B4DC5AF57F8411F4FD156D83C128739,31531,0,8,8,109.49583,18.25972,1461
14984,114449,D78BEC45274E639A1BD4DE3D90911CD3,60501,1,2,1,109.48701,18.29021,1466
14985,114450,D78BEC45274E639A1BD4DE3D90911CD3,38951,5,6,1,109.48097,18.28868,1416
14986,114451,D78BEC45274E639A1BD4DE3D90911CD3,30941,8,9,1,109.5559,18.33938,1724
14987,114452,D78BEC45274E639A1BD4DE3D90911CD3,30161,11,12,1,109.50042,18.24389,1508
14988,114453,D78BEC45274E639A1BD4DE3D90911CD3,60614,13,16,3,109.48799,18.29521,1467
14989,114454,D78BEC45274E639A1BD4DE3D90911CD3,38951,19,20,1,109.48097,18.28868,1416
14990,114455,D78BEC45274E639A1BD4DE3D90911CD3,38951,20,21,1,109.48097,18.28868,1416
14991,114456,D78BEC45274E639A1BD4DE3D90911CD3,60614,21,23,2,109.48799,18.29521,1467
14992,114466,1113DCEA20D725C81D58CC73EC20150A,30421,13,14,1,109.50021,18.25861,1511
14993,114469,A909026355FEE8A2304F7999D83D79B3,31571,0,12,12,109.61563,18.23326,1957
14994,114470,A909026355FEE8A2304F7999D83D79B3,38754,14,16,2,109.74667,18.37382,2430
14995,114471,A909026355FEE8A2304F7999D83D79B3,31231,17,19,2,109.42597,18.29292,1217
14996,114480,5426296000364EE32711CD0E73D782C8,30854,1,7,6,109.56889,18.27076,1763
14997,114481,5426296000364EE32711CD0E73D782C8,31561,10,16,6,109.56792,18.28479,1765
14998,114515,91EC74D2B208A10BECBB101C6735C578,60161,0,4,4,109.49174,18.26181,1461
14999,114516,91EC74D2B208A10BECBB101C6735C578,31864,4,9,5,109.49014,18.28333,1465
15000,114517,91EC74D2B208A10BECBB101C6735C578,60171,10,14,4,109.51292,18.30694,1569
15001,114518,91EC74D2B208A10BECBB101C6735C578,30921,15,16,1,109.53903,18.29451,1667
15002,114519,91EC74D2B208A10BECBB101C6735C578,60171,17,18,1,109.51292,18.30694,1569
15003,114520,91EC74D2B208A10BECBB101C6735C578,31864,18,20,2,109.49014,18.28333,1465
15004,114529,4995463B780282C9C030A19D9F49AEAC,31071,3,6,3,109.58257,18.28458,1815
15005,114530,4995463B780282C9C030A19D9F49AEAC,30854,7,12,5,109.56889,18.27076,1763
15006,114531,4995463B780282C9C030A19D9F49AEAC,31071,12,13,1,109.58257,18.28458,1815
15007,114532,4995463B780282C9C030A19D9F49AEAC,30854,13,15,2,109.56889,18.27076,1763
15008,114533,4995463B780282C9C030A19D9F49AEAC,31561,16,17,1,109.56792,18.28479,1765
15009,114534,4995463B780282C9C030A19D9F49AEAC,31071,19,21,2,109.58257,18.28458,1815
15010,114535,CF2A30FDEEDE024C38B6F95A666F3725,60491,0,15,15,109.43354,18.30847,1269
15011,114536,CF2A30FDEEDE024C38B6F95A666F3725,38141,20,21,1,109.39479,18.2916,1116
15012,114579,66F8B9488B97AC9181E1428AD12A7C79,60614,0,4,4,109.48799,18.29521,1467
15013,114580,66F8B9488B97AC9181E1428AD12A7C79,38951,5,6,1,109.48097,18.28868,1416
15014,114581,66F8B9488B97AC9181E1428AD12A7C79,30101,10,11,1,109.57299,18.33333,1773
15015,114582,72D984C8386A232B13E9D168E7A1C5F8,60084,6,9,3,109.4984,18.2334,1507
15016,114583,72D984C8386A232B13E9D168E7A1C5F8,30671,12,14,2,109.43611,18.30139,1268
15017,114584,72D984C8386A232B13E9D168E7A1C5F8,60551,17,19,2,109.42722,18.30111,1218
15018,114585,937F0B31443CC6355891AA9D2DB0C670,30854,20,22,2,109.56889,18.27076,1763
15019,114586,937F0B31443CC6355891AA9D2DB0C670,31561,22,23,1,109.56792,18.28479,1765
15024,114639,996C0D9500BF90CC0E7F5A04C49A464B,31931,14,17,3,109.54771,18.29403,1667
15025,114640,996C0D9500BF90CC0E7F5A04C49A464B,30921,19,22,3,109.53903,18.29451,1667
15032,114705,C860767955774E3494068CF38C009FB6,60391,0,8,8,109.47667,18.28757,1416
15033,114706,C860767955774E3494068CF38C009FB6,30191,12,13,1,109.50361,18.22701,1506
15034,114707,C860767955774E3494068CF38C009FB6,31061,14,15,1,109.53333,18.23257,1607
15035,114728,B2447A087C8F374ABEBA0025E60F3E7C,31521,0,7,7,109.51458,18.22542,1555
15036,114729,B2447A087C8F374ABEBA0025E60F3E7C,30731,9,11,2,109.50944,18.22306,1555
15037,114730,B2447A087C8F374ABEBA0025E60F3E7C,38111,11,13,2,109.52007,18.22403,1555
15038,114731,B2447A087C8F374ABEBA0025E60F3E7C,30201,13,15,2,109.4909,18.26465,1462
15039,114732,B2447A087C8F374ABEBA0025E60F3E7C,60381,17,18,1,109.5241,18.22458,1605
15040,114733,B2447A087C8F374ABEBA0025E60F3E7C,31521,19,23,4,109.51458,18.22542,1555
15041,114736,DAB08D254D49BF150533311BD904D49C,39321,0,12,12,109.529,18.2167,1604
15042,114737,DAB08D254D49BF150533311BD904D49C,38881,13,15,2,109.51618,18.26431,1562
15053,114826,AE9453D604AF88F4293DEF99463B2345,30421,17,20,3,109.50021,18.25861,1511
15054,114831,51015BF65833D98716A0309741D1F1C2,38871,3,4,1,109.44681,18.28625,1316
15055,114832,51015BF65833D98716A0309741D1F1C2,39151,5,8,3,109.49875,18.25097,1510
15056,114833,51015BF65833D98716A0309741D1F1C2,30854,13,15,2,109.56889,18.27076,1763
15057,114834,51015BF65833D98716A0309741D1F1C2,60381,19,21,2,109.5241,18.22458,1605
15068,114909,C1F9914EF577AE2A8300B1A3945A50FF,31561,2,3,1,109.56792,18.28479,1765
15069,114910,C1F9914EF577AE2A8300B1A3945A50FF,30851,3,6,3,109.5616,18.27396,1713
15070,114911,C1F9914EF577AE2A8300B1A3945A50FF,31561,7,9,2,109.56792,18.28479,1765
15071,114912,C1F9914EF577AE2A8300B1A3945A50FF,31101,13,14,1,109.65389,18.23403,2057
15072,114952,B825FA0510D0C7066F611121CA360EF4,31071,12,18,6,109.58257,18.28458,1815
15073,114953,B825FA0510D0C7066F611121CA360EF4,60291,21,22,1,109.50826,18.24639,1509
15074,114974,9FEA4B85EAE4FAEE1CAF0EABFF2FAEA1,31561,0,6,6,109.56792,18.28479,1765
15075,114975,9FEA4B85EAE4FAEE1CAF0EABFF2FAEA1,39183,8,11,3,109.55542,18.28208,1715
15076,114976,9FEA4B85EAE4FAEE1CAF0EABFF2FAEA1,31561,12,13,1,109.56792,18.28479,1765
15077,114977,9FEA4B85EAE4FAEE1CAF0EABFF2FAEA1,39183,14,16,2,109.55542,18.28208,1715
15078,114978,9FEA4B85EAE4FAEE1CAF0EABFF2FAEA1,31561,17,19,2,109.56792,18.28479,1765
15079,115045,BE8220A49F1231C0A022F4AA2075503E,31945,0,7,7,109.58021,18.29403,1817
15080,115046,BE8220A49F1231C0A022F4AA2075503E,30854,8,11,3,109.56889,18.27076,1763
15081,115047,BE8220A49F1231C0A022F4AA2075503E,31945,13,14,1,109.58021,18.29403,1817
15082,115048,BE8220A49F1231C0A022F4AA2075503E,60463,19,20,1,109.52507,18.22438,1605
15083,115049,BE8220A49F1231C0A022F4AA2075503E,31945,21,23,2,109.58021,18.29403,1817
15084,115050,94C4D5691F7DFC1AB38806AFFAC1389E,31931,5,8,3,109.54771,18.29403,1667
15085,115051,94C4D5691F7DFC1AB38806AFFAC1389E,39101,11,12,1,109.50132,18.24931,1509
15086,115052,94C4D5691F7DFC1AB38806AFFAC1389E,31931,12,13,1,109.54771,18.29403,1667
15087,115055,C3EF49B0098C6C3C4B26CC8869DE86AF,30854,0,7,7,109.56889,18.27076,1763
15088,115056,C3EF49B0098C6C3C4B26CC8869DE86AF,38271,9,14,5,109.62632,18.23049,1956
15089,115057,C3EF49B0098C6C3C4B26CC8869DE86AF,31031,15,16,1,109.49979,18.25382,1510
15090,115058,C3EF49B0098C6C3C4B26CC8869DE86AF,30854,20,23,3,109.56889,18.27076,1763
15091,115071,A1DF55C42D8446F7B3BDC698ADD3A56E,31071,4,7,3,109.58257,18.28458,1815
15092,115072,A1DF55C42D8446F7B3BDC698ADD3A56E,30854,10,11,1,109.56889,18.27076,1763
15093,115073,A1DF55C42D8446F7B3BDC698ADD3A56E,31164,12,14,2,109.69993,18.27215,2263
15094,115074,A1DF55C42D8446F7B3BDC698ADD3A56E,38071,19,20,1,109.40722,18.30938,1169
15095,115083,D73FCA3456BB16A6D4FCD107B208A3A9,30661,20,21,1,109.37028,18.24361,1008
15096,115084,D73FCA3456BB16A6D4FCD107B208A3A9,30721,21,23,2,109.51597,18.28257,1565
15097,115141,C8344836EA156DB60E8D025C0A473C2E,31521,0,1,1,109.51458,18.22542,1555
15098,115142,C8344836EA156DB60E8D025C0A473C2E,30181,2,10,8,109.51597,18.23313,1557
15099,115143,C8344836EA156DB60E8D025C0A473C2E,31145,11,14,3,109.20431,18.30479,369
15100,115144,C8344836EA156DB60E8D025C0A473C2E,30181,15,23,8,109.51597,18.23313,1557
15101,115162,C98DECAAC7B1CEF53BA610BF4A518961,60331,0,1,1,109.505,18.26507,1512
15102,115163,C98DECAAC7B1CEF53BA610BF4A518961,39321,1,9,8,109.529,18.2167,1604
15103,115164,C98DECAAC7B1CEF53BA610BF4A518961,30731,9,10,1,109.50944,18.22306,1555
15104,115165,C98DECAAC7B1CEF53BA610BF4A518961,30161,12,13,1,109.50042,18.24389,1508
15108,115182,87FF4B28ACF2D28B36F6296AA66D2D6F,38707,0,4,4,109.73778,18.35368,2427
15109,115183,87FF4B28ACF2D28B36F6296AA66D2D6F,38541,4,9,5,109.73715,18.34875,2426
15110,115198,8554F0A178316702A9146AC053A2336A,38251,1,2,1,109.49618,18.25493,1510
15111,115199,8554F0A178316702A9146AC053A2336A,31231,2,7,5,109.42597,18.29292,1217
15112,115200,8554F0A178316702A9146AC053A2336A,60161,7,9,2,109.49174,18.26181,1461
15113,115201,8554F0A178316702A9146AC053A2336A,30711,15,16,1,109.50271,18.25347,1510
15114,115202,8554F0A178316702A9146AC053A2336A,31534,17,19,2,109.49368,18.25806,1461
15115,115203,8554F0A178316702A9146AC053A2336A,30421,20,23,3,109.50021,18.25861,1511
15116,115205,702E913D8A0DA920C3A5175221B874F5,60661,16,17,1,109.548,18.2377,1657
15117,115206,702E913D8A0DA920C3A5175221B874F5,38017,19,21,2,109.49729,18.21424,1504
15118,115207,702E913D8A0DA920C3A5175221B874F5,60661,21,23,2,109.548,18.2377,1657
15127,115270,41BFDF202AA15C7D0EC7487840A4D094,30854,8,22,14,109.56889,18.27076,1763
15128,115271,41BFDF202AA15C7D0EC7487840A4D094,60631,22,23,1,109.57778,18.27583,1814
15129,115287,30B65052F35DDEF849EA88BF5D44AAAC,60361,6,8,2,109.51938,18.29681,1567
15130,115288,30B65052F35DDEF849EA88BF5D44AAAC,31951,11,13,2,109.52174,18.30299,1568
15131,115289,30B65052F35DDEF849EA88BF5D44AAAC,60171,13,16,3,109.51292,18.30694,1569
15132,115341,099FE0090B4EE7DA6124F36A27A26FB9,60117,12,17,5,109.73604,18.35681,2427
15133,115347,C7D3CA692B6956D76CF35EE9AAABE2A2,60614,0,5,5,109.48799,18.29521,1467
15134,115348,C7D3CA692B6956D76CF35EE9AAABE2A2,38951,6,8,2,109.48097,18.28868,1416
15135,115349,C7D3CA692B6956D76CF35EE9AAABE2A2,30101,10,11,1,109.57299,18.33333,1773
15136,115350,C7D3CA692B6956D76CF35EE9AAABE2A2,30941,14,16,2,109.5559,18.33938,1724
15140,115378,D7B2DAA840D69B7CEAE96D3574ED744F,60401,18,20,2,109.47444,18.27583,1414
15141,115379,D7B2DAA840D69B7CEAE96D3574ED744F,31361,20,23,3,109.47417,18.28292,1415
15142,115416,97D875EE9D54268657EF259BD5962949,30854,14,15,1,109.56889,18.27076,1763
15143,115417,97D875EE9D54268657EF259BD5962949,31071,15,17,2,109.58257,18.28458,1815
15144,115454,4FBB8B54B037ADDE5478A2AF9D4004A8,31221,1,17,16,109.61333,18.26833,1913
15145,115455,4FBB8B54B037ADDE5478A2AF9D4004A8,30854,20,22,2,109.56889,18.27076,1763
15146,115458,A9FCE0049DB44FE004EAFBF5B783F4A5,31945,2,7,5,109.58021,18.29403,1817
15147,115459,A9FCE0049DB44FE004EAFBF5B783F4A5,30854,8,9,1,109.56889,18.27076,1763
15152,115537,C0D9A8D1FC57A96EA766A127A0E8EAAC,30854,0,6,6,109.56889,18.27076,1763
15153,115538,C0D9A8D1FC57A96EA766A127A0E8EAAC,60591,10,13,3,109.61118,18.21715,1904
15154,115539,C0D9A8D1FC57A96EA766A127A0E8EAAC,31101,17,18,1,109.65389,18.23403,2057
15155,115540,C0D9A8D1FC57A96EA766A127A0E8EAAC,60631,22,23,1,109.57778,18.27583,1814
15160,115562,43018FB39803E31509A90CB37A66655B,31071,1,5,4,109.58257,18.28458,1815
15161,115563,43018FB39803E31509A90CB37A66655B,31945,6,7,1,109.58021,18.29403,1817
15162,115564,43018FB39803E31509A90CB37A66655B,38754,12,14,2,109.74667,18.37382,2430
15163,115565,43018FB39803E31509A90CB37A66655B,31321,17,19,2,109.63799,18.23201,2007
15167,115600,8EB27D2E0095A9FF48E016863044B329,31945,0,8,8,109.58021,18.29403,1817
15168,115601,8EB27D2E0095A9FF48E016863044B329,30854,10,17,7,109.56889,18.27076,1763
15169,115602,8EB27D2E0095A9FF48E016863044B329,30371,21,22,1,109.51,18.24771,1559
15170,115618,5F5F21B79C1AD0925177661E61E6C3C9,31231,0,6,6,109.42597,18.29292,1217
15171,115619,5F5F21B79C1AD0925177661E61E6C3C9,30351,8,12,4,109.41701,18.29292,1217
15175,115652,40D62DAB923B148A7A4FFB3BCA6C7343,60501,0,8,8,109.48701,18.29021,1466
15176,115653,40D62DAB923B148A7A4FFB3BCA6C7343,38951,9,20,11,109.48097,18.28868,1416
15177,115654,F6B0C4B9BFBC5C0F5D704098C64B8B01,30711,13,15,2,109.50271,18.25347,1510
15178,115655,F6B0C4B9BFBC5C0F5D704098C64B8B01,31864,16,20,4,109.49014,18.28333,1465
15179,115667,9A00C7B4C2F6CD44CC775BCA8584229C,38754,13,14,1,109.74667,18.37382,2430
15180,115668,9A00C7B4C2F6CD44CC775BCA8584229C,60401,19,20,1,109.47444,18.27583,1414
15181,115669,70D1132966731D0A7E75BEB7E2796B8B,31521,0,7,7,109.51458,18.22542,1555
15182,115678,561522A1ED5FFA63DCA382D0CB310A1A,30171,0,8,8,109.48458,18.27139,1463
15183,115679,561522A1ED5FFA63DCA382D0CB310A1A,30941,9,10,1,109.5559,18.33938,1724
15184,115680,561522A1ED5FFA63DCA382D0CB310A1A,38271,14,15,1,109.62632,18.23049,1956
15185,115681,561522A1ED5FFA63DCA382D0CB310A1A,60221,19,20,1,109.52569,18.29188,1616
15186,115682,63B50A7073912A66CD527ABAF79EDA78,30351,0,7,7,109.41701,18.29292,1217
15187,115683,63B50A7073912A66CD527ABAF79EDA78,31231,8,13,5,109.42597,18.29292,1217
15188,115684,63B50A7073912A66CD527ABAF79EDA78,60291,13,14,1,109.50826,18.24639,1509
15189,115685,63B50A7073912A66CD527ABAF79EDA78,60401,18,19,1,109.47444,18.27583,1414
15190,115691,15CA17640E986E8C98B5D094DF385F19,31931,18,19,1,109.54771,18.29403,1667
15191,115692,F00821368F615DCDAF214035D8EC4A44,60631,2,3,1,109.57778,18.27583,1814
15192,115693,F00821368F615DCDAF214035D8EC4A44,31071,5,6,1,109.58257,18.28458,1815
15193,115694,F00821368F615DCDAF214035D8EC4A44,30854,7,9,2,109.56889,18.27076,1763
15194,115695,F00821368F615DCDAF214035D8EC4A44,31931,9,10,1,109.54771,18.29403,1667
15195,115696,F00821368F615DCDAF214035D8EC4A44,30854,11,15,4,109.56889,18.27076,1763
15196,115705,8D7B9451E0189947198D6AC9CE51CFEE,30764,0,1,1,109.45806,18.29486,1367
15197,115706,8D7B9451E0189947198D6AC9CE51CFEE,60391,2,4,2,109.47667,18.28757,1416
15198,115707,8D7B9451E0189947198D6AC9CE51CFEE,31091,4,18,14,109.41201,18.31222,1170
15199,115708,8D7B9451E0189947198D6AC9CE51CFEE,30764,19,21,2,109.45806,18.29486,1367
15200,115709,8D7B9451E0189947198D6AC9CE51CFEE,30111,21,23,2,109.47583,18.30542,1419
15204,115724,96F98526707B06BE1263CCD4F72E07A1,30854,1,2,1,109.56889,18.27076,1763
15205,115725,96F98526707B06BE1263CCD4F72E07A1,31071,4,5,1,109.58257,18.28458,1815
15206,115726,96F98526707B06BE1263CCD4F72E07A1,30854,5,7,2,109.56889,18.27076,1763
15207,115727,96F98526707B06BE1263CCD4F72E07A1,31071,11,12,1,109.58257,18.28458,1815
15208,115728,96F98526707B06BE1263CCD4F72E07A1,30854,15,21,6,109.56889,18.27076,1763
15209,115729,4521A8D92A7219267FD46990BC1A5213,30232,0,4,4,109.6191,18.31701,1971
15210,115730,4521A8D92A7219267FD46990BC1A5213,31561,5,6,1,109.56792,18.28479,1765
15211,115731,4521A8D92A7219267FD46990BC1A5213,30232,7,23,16,109.6191,18.31701,1971
15215,115744,E082FB5BD091C5B334EC1176FF352EE0,60371,14,15,1,109.53063,18.30056,1618
15216,115745,E082FB5BD091C5B334EC1176FF352EE0,31931,16,19,3,109.54771,18.29403,1667
15217,115746,E082FB5BD091C5B334EC1176FF352EE0,60371,21,22,1,109.53063,18.30056,1618
15218,115794,316EB27B7555943C1D6557CD7E5A08F6,60381,19,20,1,109.5241,18.22458,1605
15219,115799,B6B23D46E3670BB19F6DC30ED4B33D5E,31864,8,9,1,109.49014,18.28333,1465
15220,115800,B6B23D46E3670BB19F6DC30ED4B33D5E,31431,9,10,1,109.44639,18.29042,1316
15221,115801,B6B23D46E3670BB19F6DC30ED4B33D5E,39061,12,13,1,109.38222,18.28958,1066
15222,115802,B6B23D46E3670BB19F6DC30ED4B33D5E,30341,14,16,2,109.3625,18.29167,966
15223,115803,B6B23D46E3670BB19F6DC30ED4B33D5E,31431,17,18,1,109.44639,18.29042,1316
15224,115804,B6B23D46E3670BB19F6DC30ED4B33D5E,31031,18,20,2,109.49979,18.25382,1510
15225,115815,3E59E08BDB351E3995CE0492C62E7C87,60281,19,23,4,109.51743,18.25924,1561
15226,115816,F84D949DDCBF25D5530F771BC55E0B9D,61011,0,5,5,109.60653,18.19076,1900
15227,115818,F84D949DDCBF25D5530F771BC55E0B9D,31321,9,10,1,109.63799,18.23201,2007
15228,115820,A14C813C3E3A7182759DA822342505B5,30851,14,15,1,109.5616,18.27396,1713
15229,115821,A14C813C3E3A7182759DA822342505B5,39183,18,23,5,109.55542,18.28208,1715
15230,115873,6F590AF2C10C4B9F0F4E76B8E922550E,30854,9,11,2,109.56889,18.27076,1763
15231,115874,6F590AF2C10C4B9F0F4E76B8E922550E,31945,15,22,7,109.58021,18.29403,1817
15232,115894,07169E7114E4F14C073261BAAC0D4491,61011,6,13,7,109.60653,18.19076,1900
15233,115919,9C1407835BC54BEBDB541F52E1DA1820,61011,2,5,3,109.60653,18.19076,1900
15234,115921,9C1407835BC54BEBDB541F52E1DA1820,61011,7,9,2,109.60653,18.19076,1900
15241,116020,1F5A515C5AC85D4C79D71950DF5477FB,30571,1,7,6,109.50243,18.21861,1504
15242,116021,1F5A515C5AC85D4C79D71950DF5477FB,38347,8,10,2,109.4934,18.21444,1454
15243,116022,1F5A515C5AC85D4C79D71950DF5477FB,30571,11,14,3,109.50243,18.21861,1504
15244,116023,1F5A515C5AC85D4C79D71950DF5477FB,38347,14,16,2,109.4934,18.21444,1454
15245,116024,1F5A515C5AC85D4C79D71950DF5477FB,60381,17,20,3,109.5241,18.22458,1605
15246,116025,1F5A515C5AC85D4C79D71950DF5477FB,30571,20,22,2,109.50243,18.21861,1504
15247,116063,DBB710D279E76C79F1E4B0766F579F8A,31071,0,14,14,109.58257,18.28458,1815
15248,116064,DBB710D279E76C79F1E4B0766F579F8A,30854,14,15,1,109.56889,18.27076,1763
15249,116071,B7F915A1F0C284599515D9E8632C5B0A,30771,19,20,1,109.49938,18.26042,1511
15250,116072,B7F915A1F0C284599515D9E8632C5B0A,38941,21,23,2,109.49625,18.25451,1510
15254,116112,73EAC1341C5005A58B26B1A52457F38B,30361,0,2,2,109.50347,18.24,1508
15255,116113,73EAC1341C5005A58B26B1A52457F38B,30161,2,19,17,109.50042,18.24389,1508
15256,116137,99CBAA6A65A50998F0A10B72B36210E4,60161,19,21,2,109.49174,18.26181,1461
15257,116138,99CBAA6A65A50998F0A10B72B36210E4,38251,21,22,1,109.49618,18.25493,1510
15258,116199,37D38EF0062E64D55C94EB554B76F9EE,31945,1,8,7,109.58021,18.29403,1817
15259,116200,37D38EF0062E64D55C94EB554B76F9EE,30854,11,23,12,109.56889,18.27076,1763
15260,116205,3C5AEA306E8A69C707195C4150E77D90,60361,15,17,2,109.51938,18.29681,1567
15261,116206,3C5AEA306E8A69C707195C4150E77D90,31931,19,21,2,109.54771,18.29403,1667
15265,116245,7784022BDEFABB0258B32ABBB5E13027,30251,0,4,4,109.50611,18.26653,1512
15266,116246,7784022BDEFABB0258B32ABBB5E13027,31491,9,10,1,109.73042,18.38771,2382
15267,116247,7784022BDEFABB0258B32ABBB5E13027,31161,11,13,2,109.70229,18.31361,2270
15268,116248,7784022BDEFABB0258B32ABBB5E13027,38185,17,22,5,109.51333,18.27347,1563
15269,116253,DE44A87559E9DEE84B37BE840DB2C4AC,60054,0,3,3,109.3016,18.31229,770
15270,116254,DE44A87559E9DEE84B37BE840DB2C4AC,30661,5,7,2,109.37028,18.24361,1008
15271,116255,DE44A87559E9DEE84B37BE840DB2C4AC,60411,7,8,1,109.32514,18.30854,869
15272,116256,DE44A87559E9DEE84B37BE840DB2C4AC,60054,12,14,2,109.3016,18.31229,770
15273,116257,DE44A87559E9DEE84B37BE840DB2C4AC,31471,14,16,2,109.34583,18.29563,917
15274,116258,DE44A87559E9DEE84B37BE840DB2C4AC,60054,19,23,4,109.3016,18.31229,770
15275,116281,05A57DE8DC0D94268B97E02566D1A0C9,30851,0,1,1,109.5616,18.27396,1713
15276,116282,05A57DE8DC0D94268B97E02566D1A0C9,60631,1,2,1,109.57778,18.27583,1814
15277,116283,05A57DE8DC0D94268B97E02566D1A0C9,30851,2,4,2,109.5616,18.27396,1713
15278,116284,05A57DE8DC0D94268B97E02566D1A0C9,31071,5,9,4,109.58257,18.28458,1815
15279,116285,05A57DE8DC0D94268B97E02566D1A0C9,60351,11,14,3,109.58403,18.28958,1816
15280,116286,05A57DE8DC0D94268B97E02566D1A0C9,60463,15,17,2,109.52507,18.22438,1605
15281,116287,05A57DE8DC0D94268B97E02566D1A0C9,30421,18,19,1,109.50021,18.25861,1511
15282,116288,05A57DE8DC0D94268B97E02566D1A0C9,60381,20,21,1,109.5241,18.22458,1605
15283,116289,05A57DE8DC0D94268B97E02566D1A0C9,60631,21,23,2,109.57778,18.27583,1814
15287,116327,76F6A54588C8DF7DDADFC50CAA11D44C,30854,6,9,3,109.56889,18.27076,1763
15288,116328,76F6A54588C8DF7DDADFC50CAA11D44C,39183,12,14,2,109.55542,18.28208,1715
15289,116360,46FB195BB21573CE6CD85D42D7B06C1A,31945,2,7,5,109.58021,18.29403,1817
15290,116361,46FB195BB21573CE6CD85D42D7B06C1A,30854,8,10,2,109.56889,18.27076,1763
15291,116362,46FB195BB21573CE6CD85D42D7B06C1A,60381,12,13,1,109.5241,18.22458,1605
15292,116363,46FB195BB21573CE6CD85D42D7B06C1A,30361,18,20,2,109.50347,18.24,1508
15293,116383,55FA3BE97AB69587B64175CB8C2296AB,60031,16,19,3,109.49694,18.31632,1521
15294,116384,55FA3BE97AB69587B64175CB8C2296AB,60171,19,20,1,109.51292,18.30694,1569
15295,116411,012ABD06F231728C214A4BA917E75B1C,31561,0,21,21,109.56792,18.28479,1765
15296,116412,012ABD06F231728C214A4BA917E75B1C,30851,21,22,1,109.5616,18.27396,1713
15297,116413,51061B3DE820AF1C1C713EF684728003,31071,1,7,6,109.58257,18.28458,1815
15298,116414,51061B3DE820AF1C1C713EF684728003,30854,7,22,15,109.56889,18.27076,1763
15299,116417,213AF2099653A4ADAEF799CCC144B279,30021,0,18,18,109.12014,18.40986,86
15300,116435,F3652FF504BC297E68234A33C1877043,30854,1,2,1,109.56889,18.27076,1763
15301,116436,F3652FF504BC297E68234A33C1877043,31945,4,7,3,109.58021,18.29403,1817
15302,116437,F3652FF504BC297E68234A33C1877043,31561,8,9,1,109.56792,18.28479,1765
15303,116438,F3652FF504BC297E68234A33C1877043,31945,12,14,2,109.58021,18.29403,1817
15304,116439,F3652FF504BC297E68234A33C1877043,30854,14,16,2,109.56889,18.27076,1763
15309,116473,A0CFD24F8D50ABCF6002C5FC96CEAB76,39181,0,6,6,109.55153,18.28035,1715
15310,116474,A0CFD24F8D50ABCF6002C5FC96CEAB76,39183,9,23,14,109.55542,18.28208,1715
15311,116520,ED29249A053BF56728ABCAD759306411,31571,15,16,1,109.61563,18.23326,1957
15312,116521,ED29249A053BF56728ABCAD759306411,31554,18,21,3,109.55521,18.2459,1709
15313,116522,ED29249A053BF56728ABCAD759306411,60661,22,23,1,109.548,18.2377,1657
15314,116527,1B645349DC6CB7B3B9225190248F2C33,31431,0,8,8,109.44639,18.29042,1316
15315,116528,1B645349DC6CB7B3B9225190248F2C33,31471,11,12,1,109.34583,18.29563,917
15316,116529,1B645349DC6CB7B3B9225190248F2C33,31431,12,16,4,109.44639,18.29042,1316
15317,116530,1B645349DC6CB7B3B9225190248F2C33,30711,18,20,2,109.50271,18.25347,1510
15318,116531,1B645349DC6CB7B3B9225190248F2C33,38871,21,22,1,109.44681,18.28625,1316
15319,116552,FA0EB766C44C307B69FC2247C53C674E,31031,0,7,7,109.49979,18.25382,1510
15320,116553,FA0EB766C44C307B69FC2247C53C674E,60321,8,11,3,109.63611,18.24306,2008
15321,116554,FA0EB766C44C307B69FC2247C53C674E,30291,13,14,1,109.50403,18.27028,1513
15322,116555,FA0EB766C44C307B69FC2247C53C674E,31031,17,20,3,109.49979,18.25382,1510
15329,116615,9915B6FF17BD3BF50FFC7042D095278F,31851,10,17,7,109.71736,18.29007,2316
15330,116616,9915B6FF17BD3BF50FFC7042D095278F,30854,20,22,2,109.56889,18.27076,1763
15335,116667,0C200F5A8783CCD7D36445E86B433691,31351,3,7,4,109.4959,18.28417,1465
15336,116697,9D52111AAF3CBA9B2742D7EEE49670D6,60381,0,8,8,109.5241,18.22458,1605
15337,116698,9D52111AAF3CBA9B2742D7EEE49670D6,60552,9,10,1,109.41729,18.30014,1218
15338,116700,9D52111AAF3CBA9B2742D7EEE49670D6,60071,16,18,2,109.75674,18.31583,2470
15339,116701,9D52111AAF3CBA9B2742D7EEE49670D6,60381,20,22,2,109.5241,18.22458,1605
15344,116706,08077B5D5F0A9938A81D328635D03C8B,30854,8,13,5,109.56889,18.27076,1763
15345,116707,08077B5D5F0A9938A81D328635D03C8B,31071,14,16,2,109.58257,18.28458,1815
15346,116708,12D8E06C2EC8C969710FB791DF137B2B,31071,0,8,8,109.58257,18.28458,1815
15347,116709,12D8E06C2EC8C969710FB791DF137B2B,30854,8,10,2,109.56889,18.27076,1763
15348,116710,12D8E06C2EC8C969710FB791DF137B2B,31071,12,14,2,109.58257,18.28458,1815
15349,116711,12D8E06C2EC8C969710FB791DF137B2B,30854,17,19,2,109.56889,18.27076,1763
15350,116712,12D8E06C2EC8C969710FB791DF137B2B,31071,19,21,2,109.58257,18.28458,1815
15351,116724,C983E73D646629A775690ECA8920EB29,31631,6,7,1,109.59542,18.36826,1879
15352,116725,C983E73D646629A775690ECA8920EB29,30101,7,11,4,109.57299,18.33333,1773
15353,116726,C983E73D646629A775690ECA8920EB29,31631,12,21,9,109.59542,18.36826,1879
15354,116729,6ABF30CD5F14455AA21662324DAC8186,60431,5,9,4,109.46139,18.32861,1373
15355,116730,6ABF30CD5F14455AA21662324DAC8186,30421,10,11,1,109.50021,18.25861,1511
15356,116731,65E24749B82F3001547ADE54BE753319,60371,0,8,8,109.53063,18.30056,1618
15357,116769,9896B385073DFAEA729E29349544053D,31231,0,7,7,109.42597,18.29292,1217
15358,116770,9896B385073DFAEA729E29349544053D,31081,8,9,1,109.44639,18.30181,1318
15359,116771,9896B385073DFAEA729E29349544053D,33481,11,12,1,109.67278,18.41278,2187
15360,116804,377A324496E54511961704972731A3D5,30961,13,14,1,109.74042,18.37903,2431
15361,116805,377A324496E54511961704972731A3D5,39111,15,19,4,109.5191,18.22597,1555
15362,116806,377A324496E54511961704972731A3D5,31261,20,23,3,109.51174,18.2466,1559
15363,116820,01223FE8507EEE7E795307EF66CB7588,39091,18,20,2,109.50097,18.25222,1510
15364,116821,01223FE8507EEE7E795307EF66CB7588,30151,21,23,2,109.50986,18.25083,1560
15365,116834,6422CB87ACC55DDEF6EBE8946593C808,31351,0,6,6,109.4959,18.28417,1465
15366,116835,6422CB87ACC55DDEF6EBE8946593C808,31851,7,10,3,109.71736,18.29007,2316
15367,116836,6422CB87ACC55DDEF6EBE8946593C808,30571,12,18,6,109.50243,18.21861,1504
15368,116837,6422CB87ACC55DDEF6EBE8946593C808,31351,20,23,3,109.4959,18.28417,1465
15376,116898,117CDF2D41FFFF099F62724091D8605A,30854,8,16,8,109.56889,18.27076,1763
15377,116899,117CDF2D41FFFF099F62724091D8605A,30851,19,20,1,109.5616,18.27396,1713
15378,116900,5B52C71F88DF5C7017D89C4E504F495B,30351,0,1,1,109.41701,18.29292,1217
15379,116901,5B52C71F88DF5C7017D89C4E504F495B,60551,2,5,3,109.42722,18.30111,1218
15380,116902,5B52C71F88DF5C7017D89C4E504F495B,30351,8,11,3,109.41701,18.29292,1217
15381,116903,5B52C71F88DF5C7017D89C4E504F495B,31236,12,14,2,109.42965,18.29111,1216
15382,116904,5B52C71F88DF5C7017D89C4E504F495B,38071,16,17,1,109.40722,18.30938,1169
15387,116933,2573068C2CC7CB293855DF48A4D4CF2F,38484,18,19,1,109.53028,18.31528,1620
15388,116934,2573068C2CC7CB293855DF48A4D4CF2F,48621,19,21,2,109.52882,18.31743,1621
15389,116935,2573068C2CC7CB293855DF48A4D4CF2F,31951,21,23,2,109.52174,18.30299,1568
15390,116936,9EBFE19AEC38C3A6F47AE2D903294BAE,30854,0,7,7,109.56889,18.27076,1763
15391,116937,9EBFE19AEC38C3A6F47AE2D903294BAE,31164,8,10,2,109.69993,18.27215,2263
15392,116938,9EBFE19AEC38C3A6F47AE2D903294BAE,31761,12,13,1,109.60521,18.27965,1914
15393,116939,9EBFE19AEC38C3A6F47AE2D903294BAE,31164,16,18,2,109.69993,18.27215,2263
15394,116940,9EBFE19AEC38C3A6F47AE2D903294BAE,30854,19,20,1,109.56889,18.27076,1763
15395,116950,C1F80FD61770F46AF18F3BEF2B67E7ED,31554,0,8,8,109.55521,18.2459,1709
15396,116951,C1F80FD61770F46AF18F3BEF2B67E7ED,30511,12,13,1,109.51069,18.24208,1558
15397,116952,C1F80FD61770F46AF18F3BEF2B67E7ED,31781,14,17,3,109.19847,18.2975,367
15398,116953,C1F80FD61770F46AF18F3BEF2B67E7ED,31551,21,23,2,109.55868,18.24222,1708
15403,116991,66DE47A85B6B5866022FF6341586F6EA,60211,12,15,3,109.63549,18.26049,2011
15404,116992,66DE47A85B6B5866022FF6341586F6EA,30861,16,19,3,109.52722,18.22743,1606
15405,116993,66DE47A85B6B5866022FF6341586F6EA,30854,20,21,1,109.56889,18.27076,1763
15410,117020,A3F1A757214C25A449688115E5C4321B,31931,14,16,2,109.54771,18.29403,1667
15411,117021,A3F1A757214C25A449688115E5C4321B,38315,18,20,2,109.48979,18.29764,1467
15412,117072,40285EE8CCE25C38988EC087545664EC,31071,0,7,7,109.58257,18.28458,1815
15413,117073,40285EE8CCE25C38988EC087545664EC,30854,12,22,10,109.56889,18.27076,1763
15418,117085,06AC458FB19CD4D4F5767460007C5371,30181,0,9,9,109.51597,18.23313,1557
15419,117086,06AC458FB19CD4D4F5767460007C5371,38754,9,11,2,109.74667,18.37382,2430
15420,117087,06AC458FB19CD4D4F5767460007C5371,30964,12,16,4,109.73528,18.38875,2433
15421,117088,06AC458FB19CD4D4F5767460007C5371,30181,19,20,1,109.51597,18.23313,1557
15422,117093,6EA0FFE27EED64A0685E81DBC5C13BFD,31521,0,11,11,109.51458,18.22542,1555
15423,117116,107A36F770604E4BC54DCA0F196F27FF,31521,0,1,1,109.51458,18.22542,1555
15424,117117,107A36F770604E4BC54DCA0F196F27FF,30181,2,5,3,109.51597,18.23313,1557
15425,117118,107A36F770604E4BC54DCA0F196F27FF,60291,5,7,2,109.50826,18.24639,1509
15426,117119,107A36F770604E4BC54DCA0F196F27FF,30181,7,10,3,109.51597,18.23313,1557
15427,117120,107A36F770604E4BC54DCA0F196F27FF,31145,12,14,2,109.20431,18.30479,369
15428,117121,107A36F770604E4BC54DCA0F196F27FF,30181,16,23,7,109.51597,18.23313,1557
15429,117128,C8922FAF66F21ECAECB6B717FCD5A53B,60614,1,6,5,109.48799,18.29521,1467
15430,117129,C8922FAF66F21ECAECB6B717FCD5A53B,60391,6,10,4,109.47667,18.28757,1416
15431,117130,C8922FAF66F21ECAECB6B717FCD5A53B,60614,13,17,4,109.48799,18.29521,1467
15432,117131,C8922FAF66F21ECAECB6B717FCD5A53B,60391,18,19,1,109.47667,18.28757,1416
15433,117132,C8922FAF66F21ECAECB6B717FCD5A53B,60614,21,23,2,109.48799,18.29521,1467
15434,117156,D9359F177293DE6337F7CC97B1116186,31571,0,4,4,109.61563,18.23326,1957
15435,117157,D9359F177293DE6337F7CC97B1116186,60594,8,14,6,109.62694,18.22799,1956
15436,117164,017BB493E18067371C6FAA1A30D4BA4B,30571,13,15,2,109.50243,18.21861,1504
15437,117165,017BB493E18067371C6FAA1A30D4BA4B,60084,16,19,3,109.4984,18.2334,1507
15438,117226,04ABA8BFD5D63DDF1B83BA0577C9019C,30232,2,3,1,109.6191,18.31701,1971
15439,117227,04ABA8BFD5D63DDF1B83BA0577C9019C,31421,4,7,3,109.55382,18.22347,1705
15440,117228,04ABA8BFD5D63DDF1B83BA0577C9019C,31351,11,21,10,109.4959,18.28417,1465
15441,117272,F9DDAF94F02D470B0D29C2FB66604E6F,39063,0,1,1,109.386,18.2919,1066
15442,117273,F9DDAF94F02D470B0D29C2FB66604E6F,38145,2,6,4,109.378,18.2912,1066
15443,117274,F9DDAF94F02D470B0D29C2FB66604E6F,38325,8,9,1,109.39792,18.2909,1116
15444,117275,F9DDAF94F02D470B0D29C2FB66604E6F,38145,13,14,1,109.378,18.2912,1066
15445,117276,F9DDAF94F02D470B0D29C2FB66604E6F,31671,18,20,2,109.38965,18.29813,1068
15449,117300,08A066736557478B1013C0CF834491DF,30921,0,7,7,109.53903,18.29451,1667
15450,117301,08A066736557478B1013C0CF834491DF,31931,10,23,13,109.54771,18.29403,1667
15451,117343,E75CF54BA14775FEDD26504F9F6B7365,31945,0,5,5,109.58021,18.29403,1817
15452,117344,E75CF54BA14775FEDD26504F9F6B7365,31561,6,11,5,109.56792,18.28479,1765
15453,117345,00FC332040A284DA251A8D0705989FE9,31071,2,13,11,109.58257,18.28458,1815
15454,117346,00FC332040A284DA251A8D0705989FE9,30854,14,20,6,109.56889,18.27076,1763
15455,117378,5169AE4C4AE9067320D7FAAA8A39A4BE,31511,16,23,7,109.26326,18.40521,635
15456,117399,8DA877D3A30401F86E81FB7BC1CA2A00,31071,1,7,6,109.58257,18.28458,1815
15457,117400,8DA877D3A30401F86E81FB7BC1CA2A00,30854,12,13,1,109.56889,18.27076,1763
15458,117401,8DA877D3A30401F86E81FB7BC1CA2A00,31071,14,15,1,109.58257,18.28458,1815
15459,117402,8DA877D3A30401F86E81FB7BC1CA2A00,30854,16,17,1,109.56889,18.27076,1763
15460,117403,8DA877D3A30401F86E81FB7BC1CA2A00,31071,18,19,1,109.58257,18.28458,1815
15461,117408,39F25FE146A03325C93C111F2A943B6C,31945,1,7,6,109.58021,18.29403,1817
15462,117409,39F25FE146A03325C93C111F2A943B6C,30854,7,10,3,109.56889,18.27076,1763
15463,117410,39F25FE146A03325C93C111F2A943B6C,31945,12,13,1,109.58021,18.29403,1817
15464,117411,39F25FE146A03325C93C111F2A943B6C,30854,19,20,1,109.56889,18.27076,1763
15465,117412,39F25FE146A03325C93C111F2A943B6C,31945,22,23,1,109.58021,18.29403,1817
15466,117501,F96339A49EA24867AF66AA212A3AA3FA,30764,0,8,8,109.45806,18.29486,1367
15467,117502,F96339A49EA24867AF66AA212A3AA3FA,31231,8,9,1,109.42597,18.29292,1217
15468,117503,F96339A49EA24867AF66AA212A3AA3FA,39191,13,15,2,109.51493,18.23472,1557
15469,117504,F96339A49EA24867AF66AA212A3AA3FA,60381,15,18,3,109.5241,18.22458,1605
15470,117505,F96339A49EA24867AF66AA212A3AA3FA,30201,19,21,2,109.4909,18.26465,1462
15471,117506,1E36640BE395A4EE8CCB2697222419A5,60631,0,7,7,109.57778,18.27583,1814
15472,117507,1E36640BE395A4EE8CCB2697222419A5,30854,11,17,6,109.56889,18.27076,1763
15473,117508,1E36640BE395A4EE8CCB2697222419A5,30191,21,23,2,109.50361,18.22701,1506
15474,117509,14AE6C820CE45F96077630992CABD33D,31421,0,9,9,109.55382,18.22347,1705
15475,117510,14AE6C820CE45F96077630992CABD33D,30851,11,12,1,109.5616,18.27396,1713
15476,117511,DFFF17B7FE30E79B8AABBB5CE171272F,31561,0,1,1,109.56792,18.28479,1765
15477,117512,DFFF17B7FE30E79B8AABBB5CE171272F,30854,4,6,2,109.56889,18.27076,1763
15478,117513,DFFF17B7FE30E79B8AABBB5CE171272F,39183,10,11,1,109.55542,18.28208,1715
15479,117514,DFFF17B7FE30E79B8AABBB5CE171272F,31561,12,13,1,109.56792,18.28479,1765
15480,117515,DFFF17B7FE30E79B8AABBB5CE171272F,30854,15,16,1,109.56889,18.27076,1763
15484,117538,EBA892C672C9F4A4DF6308E74156462F,30854,1,2,1,109.56889,18.27076,1763
15485,117539,EBA892C672C9F4A4DF6308E74156462F,31071,4,23,19,109.58257,18.28458,1815
15486,117566,0CD3A9451B945A7EABB5A7155C5317AC,38251,0,2,2,109.49618,18.25493,1510
15487,117567,0CD3A9451B945A7EABB5A7155C5317AC,60161,3,8,5,109.49174,18.26181,1461
15488,117568,0CD3A9451B945A7EABB5A7155C5317AC,60401,9,10,1,109.47444,18.27583,1414
15489,117569,0CD3A9451B945A7EABB5A7155C5317AC,31534,18,20,2,109.49368,18.25806,1461
15490,117570,0CD3A9451B945A7EABB5A7155C5317AC,30421,20,23,3,109.50021,18.25861,1511
15491,117589,8CD15CF6B5FB4821940FF9AFE6D6CB84,31931,16,19,3,109.54771,18.29403,1667
15492,117590,8CD15CF6B5FB4821940FF9AFE6D6CB84,39181,21,22,1,109.55153,18.28035,1715
15500,117633,0D69669D4DBC1CEB06269A084D86E853,31571,10,16,6,109.61563,18.23326,1957
15501,117634,0D69669D4DBC1CEB06269A084D86E853,60631,20,22,2,109.57778,18.27583,1814
15502,117716,E99517AC3D59974611C317AE256FC926,60221,0,4,4,109.52569,18.29188,1616
15503,117717,E99517AC3D59974611C317AE256FC926,31671,7,9,2,109.38965,18.29813,1068
15504,117718,E99517AC3D59974611C317AE256FC926,30341,9,10,1,109.3625,18.29167,966
15505,117725,049185A0C662803A38BF69324E3059A7,30361,16,18,2,109.50347,18.24,1508
15506,117726,049185A0C662803A38BF69324E3059A7,38951,19,23,4,109.48097,18.28868,1416
15507,117765,1CBE5FAAC6CDC5A885E2AFCD14FDBBB1,31231,0,2,2,109.42597,18.29292,1217
15508,117766,1CBE5FAAC6CDC5A885E2AFCD14FDBBB1,60524,3,4,1,109.42951,18.28993,1216
15509,117767,1CBE5FAAC6CDC5A885E2AFCD14FDBBB1,60401,5,6,1,109.47444,18.27583,1414
15510,117768,1CBE5FAAC6CDC5A885E2AFCD14FDBBB1,60081,12,14,2,109.51097,18.22639,1556
15511,117769,1CBE5FAAC6CDC5A885E2AFCD14FDBBB1,60401,15,16,1,109.47444,18.27583,1414
15512,117770,1CBE5FAAC6CDC5A885E2AFCD14FDBBB1,38094,16,17,1,109.45403,18.28778,1316
15513,117771,1CBE5FAAC6CDC5A885E2AFCD14FDBBB1,60401,22,23,1,109.47444,18.27583,1414
15514,117774,D20C070E72B2E72E0898232810D95CC4,31521,0,9,9,109.51458,18.22542,1555
15515,117775,D20C070E72B2E72E0898232810D95CC4,30851,13,16,3,109.5616,18.27396,1713
15516,117776,D20C070E72B2E72E0898232810D95CC4,31521,18,23,5,109.51458,18.22542,1555
15517,117803,27229B6D41BD7CDDDAA38911093865DB,30891,0,4,4,109.59431,18.28389,1865
15518,117804,27229B6D41BD7CDDDAA38911093865DB,38085,5,17,12,109.6291,18.23625,2007
15519,117818,14F1CC63CDA098F9694EAC8584B9C7A5,31561,6,15,9,109.56792,18.28479,1765
15520,117819,14F1CC63CDA098F9694EAC8584B9C7A5,30854,17,18,1,109.56889,18.27076,1763
15521,117892,3B0211CCC2785B2EDDB7E5C34BFDD9A3,31236,0,1,1,109.42965,18.29111,1216
15522,117893,3B0211CCC2785B2EDDB7E5C34BFDD9A3,60524,2,9,7,109.42951,18.28993,1216
15523,117894,3B0211CCC2785B2EDDB7E5C34BFDD9A3,31231,10,13,3,109.42597,18.29292,1217
15524,117895,3B0211CCC2785B2EDDB7E5C34BFDD9A3,30211,14,15,1,109.49882,18.23931,1508
15525,117896,3B0211CCC2785B2EDDB7E5C34BFDD9A3,60161,17,18,1,109.49174,18.26181,1461
15526,117916,8F38E05146537B1A75A31B873BB68479,30854,20,21,1,109.56889,18.27076,1763
15527,117917,8F38E05146537B1A75A31B873BB68479,30891,21,23,2,109.59431,18.28389,1865
15528,117930,C881B9140448216999DAAEBF36FD2690,60171,13,19,6,109.51292,18.30694,1569
15529,117931,C881B9140448216999DAAEBF36FD2690,30351,20,22,2,109.41701,18.29292,1217
15530,117978,16C6AF30AB7E330E51881042B3420D65,30361,0,8,8,109.50347,18.24,1508
15531,117979,16C6AF30AB7E330E51881042B3420D65,31041,9,11,2,109.50278,18.23701,1507
15532,118068,7C4B45B599684104AFE3AA992CD3924A,60211,0,7,7,109.63549,18.26049,2011
15533,118069,7C4B45B599684104AFE3AA992CD3924A,30421,9,10,1,109.50021,18.25861,1511
15534,118070,7C4B45B599684104AFE3AA992CD3924A,31351,11,12,1,109.4959,18.28417,1465
15535,118071,7C4B45B599684104AFE3AA992CD3924A,30711,12,14,2,109.50271,18.25347,1510
15536,118072,7C4B45B599684104AFE3AA992CD3924A,31321,15,16,1,109.63799,18.23201,2007
15537,118073,7C4B45B599684104AFE3AA992CD3924A,60211,21,23,2,109.63549,18.26049,2011
15538,118111,FA51666CEC588E3810FF6A1AD2DC07A0,31521,1,10,9,109.51458,18.22542,1555
15539,118112,FA51666CEC588E3810FF6A1AD2DC07A0,38811,11,12,1,109.50875,18.2175,1504
15540,118113,FA51666CEC588E3810FF6A1AD2DC07A0,39183,15,17,2,109.55542,18.28208,1715
15541,118114,FA51666CEC588E3810FF6A1AD2DC07A0,31521,20,23,3,109.51458,18.22542,1555
15542,118124,752B4C65CCCA1EA27D3C6EA24E289B9C,30854,8,16,8,109.56889,18.27076,1763
15543,118125,752B4C65CCCA1EA27D3C6EA24E289B9C,39371,16,23,7,109.56627,18.2646,1762
15544,118134,36180D21AA0C286539A1A187C28A99B4,30421,0,6,6,109.50021,18.25861,1511
15545,118135,36180D21AA0C286539A1A187C28A99B4,30711,6,7,1,109.50271,18.25347,1510
15546,118136,36180D21AA0C286539A1A187C28A99B4,31781,10,12,2,109.19847,18.2975,367
15547,118137,36180D21AA0C286539A1A187C28A99B4,30421,17,19,2,109.50021,18.25861,1511
15548,118138,36180D21AA0C286539A1A187C28A99B4,30421,21,23,2,109.50021,18.25861,1511
15549,118147,BCC6D1A50E04898FABDF906024A98CE5,31761,0,10,10,109.60521,18.27965,1914
15550,118148,BCC6D1A50E04898FABDF906024A98CE5,30711,11,12,1,109.50271,18.25347,1510
15551,118149,BCC6D1A50E04898FABDF906024A98CE5,39091,14,16,2,109.50097,18.25222,1510
15552,118150,BCC6D1A50E04898FABDF906024A98CE5,31761,20,23,3,109.60521,18.27965,1914
15557,118218,F8D799D9161B0143E0D71C40472A357E,30071,0,14,14,109.52819,18.30472,1619
15558,118219,F8D799D9161B0143E0D71C40472A357E,60371,17,19,2,109.53063,18.30056,1618
15559,118220,FCFB14BA36BDB7CD6A39612B9AE933B2,39181,12,14,2,109.55153,18.28035,1715
15560,118221,FCFB14BA36BDB7CD6A39612B9AE933B2,38127,19,23,4,109.50833,18.27222,1513
15561,118244,CFE1C91972E0069E23C7B471A067D251,30251,0,8,8,109.50611,18.26653,1512
15562,118245,CFE1C91972E0069E23C7B471A067D251,38315,9,10,1,109.48979,18.29764,1467
15567,118284,C58D0182BFC61ED113EE3B09763C30B2,31931,9,11,2,109.54771,18.29403,1667
15568,118285,C58D0182BFC61ED113EE3B09763C30B2,38185,14,16,2,109.51333,18.27347,1563
15569,118317,079A114D194FE2EFB0C89059CA4EBC03,31251,0,8,8,109.18528,18.2975,317
15570,118319,079A114D194FE2EFB0C89059CA4EBC03,31251,10,23,13,109.18528,18.2975,317
15571,118364,362CF58B32D978DCF17B65B310F5E090,31181,18,20,2,109.50382,18.24813,1509
15572,118365,362CF58B32D978DCF17B65B310F5E090,30381,20,23,3,109.52521,18.24507,1609
15573,118373,B918E6C7FDB4745FD59F18F0F2FA3EBF,60561,0,7,7,109.38229,18.29785,1067
15574,118374,B918E6C7FDB4745FD59F18F0F2FA3EBF,31781,9,11,2,109.19847,18.2975,367
15575,118375,B918E6C7FDB4745FD59F18F0F2FA3EBF,60561,14,17,3,109.38229,18.29785,1067
15582,118412,6C0260646767B781577B5B8CE2471E51,38484,1,6,5,109.53028,18.31528,1620
15583,118413,6C0260646767B781577B5B8CE2471E51,38484,9,13,4,109.53028,18.31528,1620
15584,118414,6C0260646767B781577B5B8CE2471E51,38484,14,17,3,109.53028,18.31528,1620
15585,118415,6C0260646767B781577B5B8CE2471E51,30321,18,19,1,109.49563,18.29611,1467
15586,118416,6C0260646767B781577B5B8CE2471E51,38484,20,22,2,109.53028,18.31528,1620
15587,118456,63B5E489F3503F8EC6E40A38F9D2117C,31951,13,14,1,109.52174,18.30299,1568
15588,118457,63B5E489F3503F8EC6E40A38F9D2117C,60171,15,19,4,109.51292,18.30694,1569
15589,118458,63B5E489F3503F8EC6E40A38F9D2117C,60361,21,22,1,109.51938,18.29681,1567
15590,118488,7D72A79F2F964580140FF5C346A60898,60501,0,6,6,109.48701,18.29021,1466
15591,118489,7D72A79F2F964580140FF5C346A60898,30161,11,12,1,109.50042,18.24389,1508
15599,118536,36EE9562308F3103777DD131118390D9,30711,22,23,1,109.50271,18.25347,1510
15600,118537,4FAFA7B85E3244F55624961F3F495B99,30371,2,21,19,109.51,18.24771,1559
15601,118538,4FAFA7B85E3244F55624961F3F495B99,31821,22,23,1,109.51181,18.24924,1559
15602,118568,9EF6440DA421994ED152A57FAE59B45B,31261,12,15,3,109.51174,18.2466,1559
15603,118569,9EF6440DA421994ED152A57FAE59B45B,30861,17,21,4,109.52722,18.22743,1606
15604,118570,9EF6440DA421994ED152A57FAE59B45B,31261,21,23,2,109.51174,18.2466,1559
15608,118578,A515C2BA2B0AE21CADC42FF4E7FC0007,31931,13,14,1,109.54771,18.29403,1667
15609,118579,A515C2BA2B0AE21CADC42FF4E7FC0007,39181,15,23,8,109.55153,18.28035,1715
15617,118632,86360CBE83A45C2F8F04805EB9121831,38157,0,1,1,109.51483,18.26958,1563
15618,118633,86360CBE83A45C2F8F04805EB9121831,30741,2,7,5,109.49833,18.28681,1516
15619,118634,86360CBE83A45C2F8F04805EB9121831,31231,10,11,1,109.42597,18.29292,1217
15620,118635,86360CBE83A45C2F8F04805EB9121831,30721,14,23,9,109.51597,18.28257,1565
15621,118641,1F96BBD2F640FBF201B5039048AA680E,38951,17,20,3,109.48097,18.28868,1416
15622,118642,1F96BBD2F640FBF201B5039048AA680E,60614,21,23,2,109.48799,18.29521,1467
15623,118643,51ED683608E55A4EDEADC423E7C7B6C3,31471,13,15,2,109.34583,18.29563,917
15624,118644,51ED683608E55A4EDEADC423E7C7B6C3,30661,16,17,1,109.37028,18.24361,1008
15625,118645,E8BAAF476E8FE57075BAB1A8D4FF1780,39371,6,17,11,109.56627,18.2646,1762
15626,118646,E8BAAF476E8FE57075BAB1A8D4FF1780,31031,19,20,1,109.49979,18.25382,1510
15630,118800,8173BA5756C17B85ED9415F619E926FB,30201,0,10,10,109.4909,18.26465,1462
15634,118863,E4C7AB656E412C7E33554D18277C9478,60291,8,14,6,109.50826,18.24639,1509
15635,118864,E4C7AB656E412C7E33554D18277C9478,30181,17,18,1,109.51597,18.23313,1557
15636,118865,E4C7AB656E412C7E33554D18277C9478,31461,19,20,1,109.5091,18.25389,1510
15637,118877,C1793DCC823463513E28F999E76F9ADC,60054,0,3,3,109.3016,18.31229,770
15638,118878,C1793DCC823463513E28F999E76F9ADC,30661,3,6,3,109.37028,18.24361,1008
15639,118879,C1793DCC823463513E28F999E76F9ADC,31471,7,8,1,109.34583,18.29563,917
15640,118880,C1793DCC823463513E28F999E76F9ADC,60054,12,23,11,109.3016,18.31229,770
15641,118905,C6FE5B8DD9D562FE8289A1B2F6DDFCD0,31345,19,20,1,109.39,18.29,1066
15645,118942,2887AD84D7F343407DB74995AA80F829,30771,0,7,7,109.49938,18.26042,1511
15646,118943,2887AD84D7F343407DB74995AA80F829,30081,8,9,1,109.50243,18.26632,1512
15647,118944,7F632B4875B2736225CD6D350CD25670,31071,11,12,1,109.58257,18.28458,1815
15648,118945,7F632B4875B2736225CD6D350CD25670,30854,13,23,10,109.56889,18.27076,1763
15649,118949,7F632B4875B2736225CD6D350CD25670,30854,7,18,11,109.56889,18.27076,1763
15650,118950,7F632B4875B2736225CD6D350CD25670,31821,19,20,1,109.51181,18.24924,1559
15654,118982,E65D3D1BA13018960174E494A9D95E0B,38116,17,18,1,109.50799,18.21882,1504
15655,118983,E65D3D1BA13018960174E494A9D95E0B,31521,20,22,2,109.51458,18.22542,1555
15656,119018,004C4A1986E184D2F11887515F258CC6,60031,6,11,5,109.49694,18.31632,1521
15657,119028,39CA4FE8290F03A5AE8EA1D8371B2A6D,30121,0,7,7,109.52861,18.27222,1613
15658,119031,39CA4FE8290F03A5AE8EA1D8371B2A6D,30121,21,23,2,109.52861,18.27222,1613
15659,119083,4D4289AE0DFBF4B5C79A47559DC2EBDD,31945,2,6,4,109.58021,18.29403,1817
15660,119084,4D4289AE0DFBF4B5C79A47559DC2EBDD,30854,8,19,11,109.56889,18.27076,1763
15661,119092,59F29435D748531F416A4F1636997ECF,31071,0,6,6,109.58257,18.28458,1815
15662,119093,59F29435D748531F416A4F1636997ECF,30854,9,16,7,109.56889,18.27076,1763
15667,119178,22CF7007721E0F1D863F25E4633BE1AD,60311,0,8,8,109.52097,18.24319,1558
15668,119179,22CF7007721E0F1D863F25E4633BE1AD,30281,12,13,1,109.50597,18.27583,1514
15669,119180,22CF7007721E0F1D863F25E4633BE1AD,31261,14,15,1,109.51174,18.2466,1559
15670,119181,22CF7007721E0F1D863F25E4633BE1AD,38291,15,16,1,109.51618,18.24313,1558
15671,119182,22CF7007721E0F1D863F25E4633BE1AD,60311,19,23,4,109.52097,18.24319,1558
15672,119183,BCBE041A7FC025F9D2DFD86A6CB75E1D,30651,9,10,1,109.42611,18.385,1232
15673,119184,BCBE041A7FC025F9D2DFD86A6CB75E1D,30821,11,13,2,109.43681,18.33639,1274
15674,119208,C87F469509749B351A8671696022A99C,31561,0,20,20,109.56792,18.28479,1765
15675,119209,C87F469509749B351A8671696022A99C,31071,20,22,2,109.58257,18.28458,1815
15676,119236,7E95AEA91A37473FF71C625BDD54FD92,60226,7,16,9,109.5175,18.28778,1566
15677,119237,7E95AEA91A37473FF71C625BDD54FD92,60361,16,23,7,109.51938,18.29681,1567
15685,119280,066CC6CBB5ADF978A93AF5D0C3292806,31931,0,7,7,109.54771,18.29403,1667
15686,119281,066CC6CBB5ADF978A93AF5D0C3292806,38991,9,16,7,109.52681,18.30368,1618
15691,119302,E5A1549025A878E1962E8B6F03111655,30731,0,11,11,109.50944,18.22306,1555
15692,119303,E5A1549025A878E1962E8B6F03111655,30181,11,13,2,109.51597,18.23313,1557
15693,119304,E5A1549025A878E1962E8B6F03111655,30361,14,15,1,109.50347,18.24,1508
15694,119305,E5A1549025A878E1962E8B6F03111655,30181,15,17,2,109.51597,18.23313,1557
15695,119306,E5A1549025A878E1962E8B6F03111655,31201,17,18,1,109.51042,18.23819,1558
15696,119310,019CCF25DBCE9B21B5D2698F82FCE788,30234,0,6,6,109.60681,18.29979,1918
15697,119311,019CCF25DBCE9B21B5D2698F82FCE788,30391,11,12,1,109.4975,18.27118,1513
15698,119312,019CCF25DBCE9B21B5D2698F82FCE788,30234,14,16,2,109.60681,18.29979,1918
15699,119343,044D77694C91C25EFC530EE742974330,31071,14,15,1,109.58257,18.28458,1815
15700,119344,044D77694C91C25EFC530EE742974330,30854,18,21,3,109.56889,18.27076,1763
15705,119413,0497B45A677421313CD12BA36905EF33,30161,0,6,6,109.50042,18.24389,1508
15706,119430,46D10B971C10D2856504DC61068F66E7,60221,0,7,7,109.52569,18.29188,1616
15707,119431,46D10B971C10D2856504DC61068F66E7,30111,8,9,1,109.47583,18.30542,1419
15708,119514,E8AC07651C1D8B89FF48AC7202C59CAD,60381,16,17,1,109.5241,18.22458,1605
15709,119515,E8AC07651C1D8B89FF48AC7202C59CAD,30861,17,21,4,109.52722,18.22743,1606
15710,119524,21E7DFEFE05758D554D56FCB14C3C3E9,39091,17,19,2,109.50097,18.25222,1510
15711,119525,21E7DFEFE05758D554D56FCB14C3C3E9,31181,21,23,2,109.50382,18.24813,1509
15712,119528,5403ECE41AD9921A5DEF63FF6DE6A9D1,30854,11,12,1,109.56889,18.27076,1763
15713,119529,5403ECE41AD9921A5DEF63FF6DE6A9D1,31271,14,15,1,109.48958,18.26257,1462
15714,119530,5403ECE41AD9921A5DEF63FF6DE6A9D1,30854,17,22,5,109.56889,18.27076,1763
15718,119560,7171A8398911756415ECFCDCF96F249B,39183,1,3,2,109.55542,18.28208,1715
15719,119561,7171A8398911756415ECFCDCF96F249B,39371,5,6,1,109.56627,18.2646,1762
15720,119562,7171A8398911756415ECFCDCF96F249B,30851,7,11,4,109.5616,18.27396,1713
15721,119563,7171A8398911756415ECFCDCF96F249B,30121,16,21,5,109.52861,18.27222,1613
15722,119564,7171A8398911756415ECFCDCF96F249B,31521,21,22,1,109.51458,18.22542,1555
15723,119577,BD5D5103B08534F20AF53FB58E9A43CA,38171,14,15,1,109.50799,18.28139,1515
15724,119578,BD5D5103B08534F20AF53FB58E9A43CA,30321,19,20,1,109.49563,18.29611,1467
15725,119582,061A86146605D753C12EC5BC04F2EF03,38297,20,21,1,109.52576,18.24965,1609
15726,119583,061A86146605D753C12EC5BC04F2EF03,30381,21,22,1,109.52521,18.24507,1609
15727,119605,DD8DCE806AFFEAC5D779812E5F8F2B3D,30221,0,10,10,109.57833,18.20222,1802
15728,119606,DD8DCE806AFFEAC5D779812E5F8F2B3D,31561,12,16,4,109.56792,18.28479,1765
15729,119609,372A5433078073EAD18922D679CE0A73,60054,9,13,4,109.3016,18.31229,770
15730,119610,372A5433078073EAD18922D679CE0A73,60411,16,17,1,109.32514,18.30854,869
15731,119611,372A5433078073EAD18922D679CE0A73,60054,17,22,5,109.3016,18.31229,770
15739,119766,762ECFC7D57A8248759B8DD73DC6A9B3,38683,13,17,4,109.4266,18.29097,1216
15740,119767,762ECFC7D57A8248759B8DD73DC6A9B3,30151,18,20,2,109.50986,18.25083,1560
15741,119768,762ECFC7D57A8248759B8DD73DC6A9B3,38683,21,23,2,109.4266,18.29097,1216
15742,119776,BA987FAAC62A550769ECB5E13AC256A5,38261,0,8,8,109.50361,18.28153,1515
15743,119777,BA987FAAC62A550769ECB5E13AC256A5,31931,8,12,4,109.54771,18.29403,1667
15744,119778,BA987FAAC62A550769ECB5E13AC256A5,38171,13,15,2,109.50799,18.28139,1515
15745,119779,BA987FAAC62A550769ECB5E13AC256A5,31931,15,18,3,109.54771,18.29403,1667
15746,119780,BA987FAAC62A550769ECB5E13AC256A5,38171,21,23,2,109.50799,18.28139,1515
15747,119804,B172E1B17A92EA23226EC822FB6F7B82,60131,18,21,3,109.49819,18.24778,1509
15748,119805,B172E1B17A92EA23226EC822FB6F7B82,30181,22,23,1,109.51597,18.23313,1557
15749,119835,7BDC7962058E5B3507F7C37155585188,38157,2,7,5,109.51483,18.26958,1563
15750,119836,7BDC7962058E5B3507F7C37155585188,30121,12,23,11,109.52861,18.27222,1613
15751,119839,D4EE8E1A4C04A1FF0596E4221D0B8B42,30854,0,18,18,109.56889,18.27076,1763
15752,119840,D4EE8E1A4C04A1FF0596E4221D0B8B42,31164,20,21,1,109.69993,18.27215,2263
15753,119863,C8FB2E5ADC3F708918DEFE9C1D5B12F5,31461,0,1,1,109.5091,18.25389,1510
15754,119864,C8FB2E5ADC3F708918DEFE9C1D5B12F5,30421,2,10,8,109.50021,18.25861,1511
15755,119865,C8FB2E5ADC3F708918DEFE9C1D5B12F5,60331,10,13,3,109.505,18.26507,1512
15756,119866,C8FB2E5ADC3F708918DEFE9C1D5B12F5,60221,14,18,4,109.52569,18.29188,1616
15757,119867,C8FB2E5ADC3F708918DEFE9C1D5B12F5,60281,18,21,3,109.51743,18.25924,1561
15758,119877,5A888DC7A3AA300CC584D9862C5384A1,30421,0,2,2,109.50021,18.25861,1511
15759,119878,5A888DC7A3AA300CC584D9862C5384A1,31261,2,3,1,109.51174,18.2466,1559
15760,119879,5A888DC7A3AA300CC584D9862C5384A1,30421,4,7,3,109.50021,18.25861,1511
15761,119880,5A888DC7A3AA300CC584D9862C5384A1,39183,11,17,6,109.55542,18.28208,1715
15762,119881,5A888DC7A3AA300CC584D9862C5384A1,30421,22,23,1,109.50021,18.25861,1511
15766,120013,5FCC504E23B9FEA010C8EF1104C6415E,38334,0,9,9,109.65035,18.23785,2057
15767,120014,5FCC504E23B9FEA010C8EF1104C6415E,31471,12,15,3,109.34583,18.29563,917
15768,120015,5FCC504E23B9FEA010C8EF1104C6415E,38334,19,20,1,109.65035,18.23785,2057
15769,120016,5FCC504E23B9FEA010C8EF1104C6415E,38271,21,22,1,109.62632,18.23049,1956
15770,120051,6733B324E753B6172A50174A4CB1E5C2,31251,0,14,14,109.18528,18.2975,317
15771,120053,6733B324E753B6172A50174A4CB1E5C2,31251,18,22,4,109.18528,18.2975,317
15772,120092,02E6D039B6BFD47098D3B420FA457233,38961,0,8,8,109.50847,18.23514,1507
15773,120093,02E6D039B6BFD47098D3B420FA457233,31471,13,14,1,109.34583,18.29563,917
15774,120094,02E6D039B6BFD47098D3B420FA457233,38961,19,22,3,109.50847,18.23514,1507
15775,120095,3D06CD7850C0CF1D3ED2E185AFD87930,31521,14,16,2,109.51458,18.22542,1555
15776,120096,3D06CD7850C0CF1D3ED2E185AFD87930,31521,19,21,2,109.51458,18.22542,1555
15777,120110,FD741240540EA611084A00540F097CB4,39183,19,20,1,109.55542,18.28208,1715
15778,120111,FD741240540EA611084A00540F097CB4,38071,21,23,2,109.40722,18.30938,1169
15779,120148,B55755EE77AAB7159A5530B30083F834,30661,0,7,7,109.37028,18.24361,1008
15780,120149,B55755EE77AAB7159A5530B30083F834,31471,9,10,1,109.34583,18.29563,917
15781,120150,B55755EE77AAB7159A5530B30083F834,30661,12,13,1,109.37028,18.24361,1008
15782,120151,B55755EE77AAB7159A5530B30083F834,60411,16,18,2,109.32514,18.30854,869
15783,120152,B55755EE77AAB7159A5530B30083F834,31091,20,21,1,109.41201,18.31222,1170
15784,120159,887B4CB1328C20D61945E5BC833B406E,60371,11,20,9,109.53063,18.30056,1618
15785,120160,887B4CB1328C20D61945E5BC833B406E,30071,20,22,2,109.52819,18.30472,1619
15786,120167,C17F2EF1DEA79C8C951E3013EE071B2C,31071,1,15,14,109.58257,18.28458,1815
15787,120168,C17F2EF1DEA79C8C951E3013EE071B2C,38154,19,20,1,109.5266,18.28278,1615
15788,120169,C17F2EF1DEA79C8C951E3013EE071B2C,30771,21,22,1,109.49938,18.26042,1511
15789,120170,F266F55F764384E7872EAB5493D7B12B,38334,0,9,9,109.65035,18.23785,2057
15790,120171,F266F55F764384E7872EAB5493D7B12B,31471,12,15,3,109.34583,18.29563,917
15791,120172,F266F55F764384E7872EAB5493D7B12B,38334,19,20,1,109.65035,18.23785,2057
15792,120173,F266F55F764384E7872EAB5493D7B12B,38271,20,22,2,109.62632,18.23049,1956
15793,120179,8E244E94833DBF281BCBFE2F4A36E102,60641,0,16,16,109.53854,18.2359,1657
15794,120180,8E244E94833DBF281BCBFE2F4A36E102,30741,17,19,2,109.49833,18.28681,1516
15795,120181,8E244E94833DBF281BCBFE2F4A36E102,60641,20,22,2,109.53854,18.2359,1657
15796,120199,D91289410D46E2838A7CD67AF8E32DCF,30921,21,23,2,109.53903,18.29451,1667
15800,120263,1C67859AC074D33800F75471EB5E573E,60631,0,7,7,109.57778,18.27583,1814
15801,120264,1C67859AC074D33800F75471EB5E573E,31071,9,12,3,109.58257,18.28458,1815
15802,120265,1C67859AC074D33800F75471EB5E573E,60631,12,14,2,109.57778,18.27583,1814
15803,120266,1C67859AC074D33800F75471EB5E573E,30854,16,18,2,109.56889,18.27076,1763
15804,120267,1C67859AC074D33800F75471EB5E573E,60631,22,23,1,109.57778,18.27583,1814
15809,120336,F3BDE391723935123283DAC5132B46D2,31311,0,9,9,109.72299,18.27438,2364
15810,120338,F3BDE391723935123283DAC5132B46D2,31311,18,22,4,109.72299,18.27438,2364
15811,120340,F7AAD8355D0FB48A1E8C914954424109,31145,11,12,1,109.20431,18.30479,369
15812,120341,F7AAD8355D0FB48A1E8C914954424109,31861,16,23,7,109.49042,18.27549,1464
15813,120342,855D815DC19AA779325469411A9E7B8A,30251,1,13,12,109.50611,18.26653,1512
15814,120343,855D815DC19AA779325469411A9E7B8A,38157,13,17,4,109.51483,18.26958,1563
15818,120454,115CE8C7CCAA1288E5461F613949EE4B,31671,5,6,1,109.38965,18.29813,1068
15819,120455,115CE8C7CCAA1288E5461F613949EE4B,60231,6,7,1,109.49903,18.21972,1504
15820,120456,115CE8C7CCAA1288E5461F613949EE4B,30571,10,12,2,109.50243,18.21861,1504
15821,120476,08A627C32003E101BA399C2208217139,38251,0,8,8,109.49618,18.25493,1510
15822,120486,8D4ACBD3925B9BC67CB90B513BB008F6,60101,15,16,1,109.75465,18.40139,2485
15823,120487,8D4ACBD3925B9BC67CB90B513BB008F6,30961,17,20,3,109.74042,18.37903,2431
15824,120488,8D4ACBD3925B9BC67CB90B513BB008F6,31881,21,22,1,109.7441,18.40785,2436
15828,120492,BE7763F8096EB5A037146E1CC4190538,31561,1,2,1,109.56792,18.28479,1765
15829,120493,BE7763F8096EB5A037146E1CC4190538,30854,4,5,1,109.56889,18.27076,1763
15830,120494,BE7763F8096EB5A037146E1CC4190538,30161,8,9,1,109.50042,18.24389,1508
15831,120495,BE7763F8096EB5A037146E1CC4190538,30324,14,17,3,109.50326,18.29257,1517
15832,120496,BE7763F8096EB5A037146E1CC4190538,30854,21,23,2,109.56889,18.27076,1763
15833,120554,52D77D00506AFA664CC2385DBA703BDD,60111,0,7,7,109.72556,18.31924,2371
15834,120555,52D77D00506AFA664CC2385DBA703BDD,31161,8,11,3,109.70229,18.31361,2270
15835,120556,52D77D00506AFA664CC2385DBA703BDD,60381,12,15,3,109.5241,18.22458,1605
15836,120557,52D77D00506AFA664CC2385DBA703BDD,31181,15,17,2,109.50382,18.24813,1509
15837,120558,52D77D00506AFA664CC2385DBA703BDD,31161,19,23,4,109.70229,18.31361,2270
15838,120559,4D190727D19452A2A511EC780EEEE090,31931,1,16,15,109.54771,18.29403,1667
15839,120560,4D190727D19452A2A511EC780EEEE090,30921,17,20,3,109.53903,18.29451,1667
15840,120612,F3E280D806C0279BCC08880D6A71DAC7,60621,0,7,7,109.48354,18.27451,1464
15841,120613,F3E280D806C0279BCC08880D6A71DAC7,30861,8,10,2,109.52722,18.22743,1606
15842,120614,F3E280D806C0279BCC08880D6A71DAC7,30711,10,12,2,109.50271,18.25347,1510
15843,120615,F3E280D806C0279BCC08880D6A71DAC7,30861,12,14,2,109.52722,18.22743,1606
15844,120641,9702FCEDFD09C98955AD4D2BA1E889FB,30221,0,9,9,109.57833,18.20222,1802
15845,120642,9702FCEDFD09C98955AD4D2BA1E889FB,30161,12,15,3,109.50042,18.24389,1508
15846,120643,9702FCEDFD09C98955AD4D2BA1E889FB,60381,15,16,1,109.5241,18.22458,1605
15847,120651,EB316856896788EC8FD871E122E95728,31811,2,16,14,109.54201,18.31806,1671
15848,120652,EB316856896788EC8FD871E122E95728,30701,20,23,3,109.59313,18.32007,1871
15852,120698,878FC5EBB1B28FAABA6E6BFD01664318,30251,0,16,16,109.50611,18.26653,1512
15853,120699,878FC5EBB1B28FAABA6E6BFD01664318,30711,21,22,1,109.50271,18.25347,1510
15854,120711,BC81783A71088C7320F6E595223A70F0,39111,17,18,1,109.5191,18.22597,1555
15855,120712,BC81783A71088C7320F6E595223A70F0,30571,19,22,3,109.50243,18.21861,1504
15856,120720,50AA1262E2A8C18D2F0FC1A87B60622A,30761,0,7,7,109.45201,18.3,1318
15857,120721,50AA1262E2A8C18D2F0FC1A87B60622A,31473,9,10,1,109.34792,18.29465,917
15858,120722,50AA1262E2A8C18D2F0FC1A87B60622A,39281,11,13,2,109.21333,18.30271,418
15859,120723,50AA1262E2A8C18D2F0FC1A87B60622A,30504,13,14,1,109.705,18.35368,2277
15863,120837,278D81878D480BD6212A8447217A6EDC,38951,0,7,7,109.48097,18.28868,1416
15864,120838,278D81878D480BD6212A8447217A6EDC,30731,9,10,1,109.50944,18.22306,1555
15865,120840,278D81878D480BD6212A8447217A6EDC,38951,19,20,1,109.48097,18.28868,1416
15866,120843,D8898064D7FB8C9B8CE800B6EE2F87B6,39371,0,3,3,109.56627,18.2646,1762
15867,120844,D8898064D7FB8C9B8CE800B6EE2F87B6,30232,4,6,2,109.6191,18.31701,1971
15868,120845,C8A5539982743C3D86E28F8FF2DA3472,30851,0,1,1,109.5616,18.27396,1713
15869,120846,C8A5539982743C3D86E28F8FF2DA3472,39183,3,5,2,109.55542,18.28208,1715
15870,120847,C8A5539982743C3D86E28F8FF2DA3472,30851,5,9,4,109.5616,18.27396,1713
15871,120848,C8A5539982743C3D86E28F8FF2DA3472,30951,13,16,3,109.56208,18.25667,1761
15872,120849,C8A5539982743C3D86E28F8FF2DA3472,30851,16,18,2,109.5616,18.27396,1713
15873,120850,C8A5539982743C3D86E28F8FF2DA3472,30951,18,23,5,109.56208,18.25667,1761
15874,120871,0752016172D76C2FA5B502EA35B445D1,31061,13,15,2,109.53333,18.23257,1607
15875,120873,EBD16061EA20EE33D9344D33735E5205,60291,14,15,1,109.50826,18.24639,1509
15876,120874,EBD16061EA20EE33D9344D33735E5205,31261,16,18,2,109.51174,18.2466,1559
15877,120875,EBD16061EA20EE33D9344D33735E5205,31201,18,19,1,109.51042,18.23819,1558
15878,120890,E5683D11169421C37F2AD1C30BD8C50E,31701,12,13,1,109.44132,18.28833,1266
15879,120891,E5683D11169421C37F2AD1C30BD8C50E,38871,14,16,2,109.44681,18.28625,1316
15880,120892,E5683D11169421C37F2AD1C30BD8C50E,31701,17,23,6,109.44132,18.28833,1266
15881,120915,B164B8C0AEC0E295C9ED3DBE75B5D547,30391,0,7,7,109.4975,18.27118,1513
15882,120916,B164B8C0AEC0E295C9ED3DBE75B5D547,31145,11,14,3,109.20431,18.30479,369
15883,120917,B164B8C0AEC0E295C9ED3DBE75B5D547,60241,16,19,3,109.53319,18.28667,1616
15884,120918,6EC37ACBAC0C5AEE7B19344F1CE4D7FD,60371,1,10,9,109.53063,18.30056,1618
15885,120919,6EC37ACBAC0C5AEE7B19344F1CE4D7FD,30171,11,18,7,109.48458,18.27139,1463
15886,120946,227F65E7B24D316553263A366D9E7A26,60054,17,18,1,109.3016,18.31229,770
15887,120947,227F65E7B24D316553263A366D9E7A26,38316,19,20,1,109.48542,18.27424,1464
15888,120948,227F65E7B24D316553263A366D9E7A26,38361,21,23,2,109.43667,18.29201,1267
15889,120970,E0ECAC4E0CFA2260974D12289822AE4D,60344,13,14,1,109.68847,18.31931,2221
15890,120983,8BF73979F60E5F1BAAE4266406EB9535,31071,0,1,1,109.58257,18.28458,1815
15891,120984,8BF73979F60E5F1BAAE4266406EB9535,60631,6,14,8,109.57778,18.27583,1814
15892,121025,383B8096A1AEABDC9C7425EF83D01D0D,30764,0,5,5,109.45806,18.29486,1367
15893,121026,383B8096A1AEABDC9C7425EF83D01D0D,31145,10,13,3,109.20431,18.30479,369
15894,121027,383B8096A1AEABDC9C7425EF83D01D0D,38071,17,18,1,109.40722,18.30938,1169
15899,121069,7B1A07C39637E996C01DF0A3D287D3C6,30711,8,10,2,109.50271,18.25347,1510
15900,121070,7B1A07C39637E996C01DF0A3D287D3C6,30421,11,15,4,109.50021,18.25861,1511
15901,121071,7B1A07C39637E996C01DF0A3D287D3C6,30854,17,20,3,109.56889,18.27076,1763
15902,121072,7B1A07C39637E996C01DF0A3D287D3C6,31071,20,21,1,109.58257,18.28458,1815
15903,121077,A6EB260DA8BD57CCA91D7ED5707C036F,60551,19,20,1,109.42722,18.30111,1218
15904,121078,A6EB260DA8BD57CCA91D7ED5707C036F,31081,21,23,2,109.44639,18.30181,1318
15908,121096,FBC323A047041F71D8997C22FDE88F17,30181,0,9,9,109.51597,18.23313,1557
15909,121102,0312B43ACF9ED1D8304E325E851AEE29,30851,7,11,4,109.5616,18.27396,1713
15910,121103,0312B43ACF9ED1D8304E325E851AEE29,31561,14,17,3,109.56792,18.28479,1765
15911,121104,0312B43ACF9ED1D8304E325E851AEE29,30851,18,21,3,109.5616,18.27396,1713
15912,121148,67D30B307FD4639F5D7DA8C23EB3E033,31521,21,23,2,109.51458,18.22542,1555
15913,121239,4EEB87EFD2F33BBAF42BE530271C40CA,60211,0,11,11,109.63549,18.26049,2011
15914,121273,6D96BF634D820B0C16A2EAF0705D9C13,38105,0,9,9,109.40299,18.29229,1117
15915,121274,6D96BF634D820B0C16A2EAF0705D9C13,30711,10,13,3,109.50271,18.25347,1510
15916,121275,6D96BF634D820B0C16A2EAF0705D9C13,30351,18,19,1,109.41701,18.29292,1217
15917,121276,6D96BF634D820B0C16A2EAF0705D9C13,31236,19,21,2,109.42965,18.29111,1216
15918,121277,6D96BF634D820B0C16A2EAF0705D9C13,38105,21,23,2,109.40299,18.29229,1117
15919,121348,B4FB57E4B2E989AA5D9886D07ECD1856,31021,11,13,2,109.49021,18.27,1463
15927,121437,45CCFCD3EBDF941E1C92B70ED06E8B5E,30854,1,8,7,109.56889,18.27076,1763
15928,121447,FAEBF0037C912F8E011A2CDDDE2F2A72,31561,0,20,20,109.56792,18.28479,1765
15929,121448,FAEBF0037C912F8E011A2CDDDE2F2A72,31931,21,22,1,109.54771,18.29403,1667
15933,121519,35011D65DB8F346A960E649EB3FC56D5,30181,1,8,7,109.51597,18.23313,1557
15934,121520,35011D65DB8F346A960E649EB3FC56D5,31781,9,11,2,109.19847,18.2975,367
15935,121521,35011D65DB8F346A960E649EB3FC56D5,31471,12,14,2,109.34583,18.29563,917
15936,121522,35011D65DB8F346A960E649EB3FC56D5,60381,18,19,1,109.5241,18.22458,1605
15937,121677,6AF6E3AFD18EC04099B3351F858D9C1A,38251,1,5,4,109.49618,18.25493,1510
15938,121678,6AF6E3AFD18EC04099B3351F858D9C1A,30421,5,7,2,109.50021,18.25861,1511
15939,121679,6AF6E3AFD18EC04099B3351F858D9C1A,30941,8,11,3,109.5559,18.33938,1724
15940,121680,6AF6E3AFD18EC04099B3351F858D9C1A,30421,13,17,4,109.50021,18.25861,1511
15941,121681,6AF6E3AFD18EC04099B3351F858D9C1A,31031,17,18,1,109.49979,18.25382,1510
15942,121682,6AF6E3AFD18EC04099B3351F858D9C1A,38251,20,21,1,109.49618,18.25493,1510
15943,121683,6AF6E3AFD18EC04099B3351F858D9C1A,30421,22,23,1,109.50021,18.25861,1511
15948,121717,AF27DD9820BE593B2206448B2F0BE633,30731,16,17,1,109.50944,18.22306,1555
15949,121718,AF27DD9820BE593B2206448B2F0BE633,30421,21,23,2,109.50021,18.25861,1511
15950,121721,FD7C837735324857FB2455A0BEC9A52A,30771,0,6,6,109.49938,18.26042,1511
15951,121732,11150C7195A88F4196F1FFE1C448FD6F,60631,13,16,3,109.57778,18.27583,1814
15952,121733,11150C7195A88F4196F1FFE1C448FD6F,31521,19,23,4,109.51458,18.22542,1555
15960,121815,5DECC6165B3BF52A1C1296A87F7EEF96,60614,0,6,6,109.48799,18.29521,1467
15961,121816,5DECC6165B3BF52A1C1296A87F7EEF96,30731,9,10,1,109.50944,18.22306,1555
15965,121822,386A993804AE7686717510E63DEFF753,30161,20,21,1,109.50042,18.24389,1508
15966,121829,6922BA0A8A687E9D4AF0B3AA8BA87031,30371,11,12,1,109.51,18.24771,1559
15967,121870,7B596B6BEF2AFA6C9AB0582C35D0C3A4,30681,0,8,8,109.48493,18.26917,1463
15968,121871,7B596B6BEF2AFA6C9AB0582C35D0C3A4,31473,9,11,2,109.34792,18.29465,917
15969,121872,7B596B6BEF2AFA6C9AB0582C35D0C3A4,60121,12,13,1,109.74507,18.37472,2430
15970,121873,7B596B6BEF2AFA6C9AB0582C35D0C3A4,31931,17,20,3,109.54771,18.29403,1667
15971,121912,3977578BE56276DA0700B04B81DC1356,31561,10,20,10,109.56792,18.28479,1765
15972,121913,3977578BE56276DA0700B04B81DC1356,30851,20,23,3,109.5616,18.27396,1713
15973,121955,919B6D6CA33899F0F2E7C2D48DA4283C,39321,0,9,9,109.529,18.2167,1604
15974,121985,6587551DA47309E484D1302521C8D417,60381,18,19,1,109.5241,18.22458,1605
15975,121986,6587551DA47309E484D1302521C8D417,60631,20,21,1,109.57778,18.27583,1814
15976,121998,F906020841F7A567A604408BD6917A8B,30371,0,1,1,109.51,18.24771,1559
15977,121999,F906020841F7A567A604408BD6917A8B,31201,1,3,2,109.51042,18.23819,1558
15978,122000,F906020841F7A567A604408BD6917A8B,39191,3,7,4,109.51493,18.23472,1557
15979,122001,F906020841F7A567A604408BD6917A8B,31206,7,9,2,109.50819,18.23549,1507
15980,122002,F906020841F7A567A604408BD6917A8B,30361,10,11,1,109.50347,18.24,1508
15981,122003,F906020841F7A567A604408BD6917A8B,31205,17,19,2,109.51111,18.23736,1557
15982,122004,F906020841F7A567A604408BD6917A8B,31206,20,22,2,109.50819,18.23549,1507
15983,122024,AD608A919061B1C684914F8654FB2493,60041,0,1,1,109.39889,18.31944,1121
15984,122025,AD608A919061B1C684914F8654FB2493,30221,4,5,1,109.57833,18.20222,1802
15985,122026,AD608A919061B1C684914F8654FB2493,31471,7,9,2,109.34583,18.29563,917
15986,122027,AD608A919061B1C684914F8654FB2493,30651,11,15,4,109.42611,18.385,1232
15990,122033,A445ADAE9143F5DE61C0D7609DA16439,60131,0,6,6,109.49819,18.24778,1509
15991,122034,A445ADAE9143F5DE61C0D7609DA16439,30681,6,7,1,109.48493,18.26917,1463
15992,122035,A445ADAE9143F5DE61C0D7609DA16439,31781,11,13,2,109.19847,18.2975,367
15993,122036,A445ADAE9143F5DE61C0D7609DA16439,38754,16,19,3,109.74667,18.37382,2430
15994,122037,A445ADAE9143F5DE61C0D7609DA16439,30211,22,23,1,109.49882,18.23931,1508
15995,122099,9111D45CF0ACFF1F78F6B2A96D11CE9D,31145,13,15,2,109.20431,18.30479,369
15996,122100,9111D45CF0ACFF1F78F6B2A96D11CE9D,60431,16,19,3,109.46139,18.32861,1373
15997,122101,9111D45CF0ACFF1F78F6B2A96D11CE9D,31351,21,23,2,109.4959,18.28417,1465
15998,122105,0E129C09250C0D46273B4BD7E5225556,30151,0,7,7,109.50986,18.25083,1560
15999,122106,0E129C09250C0D46273B4BD7E5225556,60201,8,11,3,109.5041,18.2509,1510
16000,122107,0E129C09250C0D46273B4BD7E5225556,60441,14,16,2,109.46792,18.28604,1366
16001,122108,0E129C09250C0D46273B4BD7E5225556,30151,21,23,2,109.50986,18.25083,1560
16002,122123,42815E00E74F2DEE06DE8ADA6B858662,31561,0,2,2,109.56792,18.28479,1765
16003,122124,42815E00E74F2DEE06DE8ADA6B858662,31071,3,4,1,109.58257,18.28458,1815
16004,122125,42815E00E74F2DEE06DE8ADA6B858662,31561,5,8,3,109.56792,18.28479,1765
16005,122126,42815E00E74F2DEE06DE8ADA6B858662,30854,8,12,4,109.56889,18.27076,1763
16006,122127,42815E00E74F2DEE06DE8ADA6B858662,31561,15,17,2,109.56792,18.28479,1765
16007,122128,42815E00E74F2DEE06DE8ADA6B858662,30854,20,23,3,109.56889,18.27076,1763
16014,122162,56C8C781972E8BFAF8A768A19AD7F590,38127,19,23,4,109.50833,18.27222,1513
16015,122163,44CB5F545D2E3587ACF209AB2414C1A1,30854,16,18,2,109.56889,18.27076,1763
16016,122164,44CB5F545D2E3587ACF209AB2414C1A1,31071,18,20,2,109.58257,18.28458,1815
16023,122210,451E2BF48CD7B253EB0892324E679BCC,60281,7,9,2,109.51743,18.25924,1561
16024,122211,451E2BF48CD7B253EB0892324E679BCC,38291,9,13,4,109.51618,18.24313,1558
16025,122212,451E2BF48CD7B253EB0892324E679BCC,60281,13,18,5,109.51743,18.25924,1561
16026,122213,451E2BF48CD7B253EB0892324E679BCC,38291,18,21,3,109.51618,18.24313,1558
16027,122225,4DB778A581941E2A7955D8DA3B7ADAFE,30721,0,6,6,109.51597,18.28257,1565
16028,122226,4DB778A581941E2A7955D8DA3B7ADAFE,31521,10,11,1,109.51458,18.22542,1555
16029,122227,4DB778A581941E2A7955D8DA3B7ADAFE,31321,15,18,3,109.63799,18.23201,2007
16030,122228,4DB778A581941E2A7955D8DA3B7ADAFE,30721,20,23,3,109.51597,18.28257,1565
16034,122349,529A14F498129B0238F7B12A9FC7F6F7,31205,0,2,2,109.51111,18.23736,1557
16035,122350,529A14F498129B0238F7B12A9FC7F6F7,31671,3,6,3,109.38965,18.29813,1068
16036,122351,529A14F498129B0238F7B12A9FC7F6F7,60561,6,7,1,109.38229,18.29785,1067
16037,122364,38A8595594DC26AD8BE733FC85DB4CA6,31631,0,6,6,109.59542,18.36826,1879
16038,122365,38A8595594DC26AD8BE733FC85DB4CA6,30101,7,8,1,109.57299,18.33333,1773
16039,122366,38A8595594DC26AD8BE733FC85DB4CA6,31631,10,15,5,109.59542,18.36826,1879
16040,122367,38A8595594DC26AD8BE733FC85DB4CA6,30101,16,20,4,109.57299,18.33333,1773
16041,122368,38A8595594DC26AD8BE733FC85DB4CA6,31631,21,23,2,109.59542,18.36826,1879
16046,122405,9646DACA260879D32095F9107B2CAA8C,31861,0,8,8,109.49042,18.27549,1464
16047,122406,9646DACA260879D32095F9107B2CAA8C,30581,12,15,3,109.62257,18.24951,1959
16048,122407,9646DACA260879D32095F9107B2CAA8C,31101,15,17,2,109.65389,18.23403,2057
16049,122408,9646DACA260879D32095F9107B2CAA8C,60281,18,23,5,109.51743,18.25924,1561
16050,122432,6EA0DFD1737FA2AEC669564CE705470D,31471,12,15,3,109.34583,18.29563,917
16051,122433,6EA0DFD1737FA2AEC669564CE705470D,39321,18,23,5,109.529,18.2167,1604
16055,122459,6C7ED3624E68752261C6DDD9B9B25EC7,30771,0,6,6,109.49938,18.26042,1511
16056,122470,DBBA2FA4D62490D0FF290E7C10C068BA,33051,12,15,3,109.6475,18.46618,2096
16057,122471,DBBA2FA4D62490D0FF290E7C10C068BA,30361,18,20,2,109.50347,18.24,1508
16058,122529,B0D3EC92066D758E0973317388F707DC,31091,9,11,2,109.41201,18.31222,1170
16067,122596,9A97E6A6C28BF8601BAF2B58A288DD94,30181,0,8,8,109.51597,18.23313,1557
16068,122597,9A97E6A6C28BF8601BAF2B58A288DD94,31521,9,11,2,109.51458,18.22542,1555
16072,122639,27807A90EEF89DC13670DAE71E12FEAA,31021,1,5,4,109.49021,18.27,1463
16073,122640,27807A90EEF89DC13670DAE71E12FEAA,31861,5,8,3,109.49042,18.27549,1464
16074,122641,27807A90EEF89DC13670DAE71E12FEAA,31021,8,10,2,109.49021,18.27,1463
16075,122642,27807A90EEF89DC13670DAE71E12FEAA,31471,11,13,2,109.34583,18.29563,917
16076,122643,27807A90EEF89DC13670DAE71E12FEAA,30201,15,21,6,109.4909,18.26465,1462
16077,122657,40C57F24FE0409ABB752B2031C349577,38951,0,12,12,109.48097,18.28868,1416
16078,122658,40C57F24FE0409ABB752B2031C349577,60041,13,15,2,109.39889,18.31944,1121
16079,122659,40C57F24FE0409ABB752B2031C349577,31171,17,21,4,109.50938,18.24917,1559
16080,122728,1FE2866848043A2C10AD87212485FE15,31071,14,15,1,109.58257,18.28458,1815
16081,122729,1FE2866848043A2C10AD87212485FE15,30854,17,22,5,109.56889,18.27076,1763
16082,122730,34AB502A442AA8EA4A7FB30471B204DB,60621,0,7,7,109.48354,18.27451,1464
16083,122731,34AB502A442AA8EA4A7FB30471B204DB,31431,8,9,1,109.44639,18.29042,1316
16084,122732,34AB502A442AA8EA4A7FB30471B204DB,60441,10,14,4,109.46792,18.28604,1366
16085,122733,34AB502A442AA8EA4A7FB30471B204DB,38251,14,15,1,109.49618,18.25493,1510
16086,122734,34AB502A442AA8EA4A7FB30471B204DB,30341,16,17,1,109.3625,18.29167,966
16087,122735,34AB502A442AA8EA4A7FB30471B204DB,60621,21,23,2,109.48354,18.27451,1464
16088,122739,82591CF1D9AFC5ADCA95A1BAF87D07E3,60361,0,18,18,109.51938,18.29681,1567
16089,122740,82591CF1D9AFC5ADCA95A1BAF87D07E3,30771,20,23,3,109.49938,18.26042,1511
16090,122798,CD576F1C1CDFB89E6A99A20E65927346,30854,0,14,14,109.56889,18.27076,1763
16091,122799,CD576F1C1CDFB89E6A99A20E65927346,31561,14,18,4,109.56792,18.28479,1765
16092,122814,9C7AFD6F67C3677E74C4343080215938,60401,0,1,1,109.47444,18.27583,1414
16093,122815,9C7AFD6F67C3677E74C4343080215938,60621,1,7,6,109.48354,18.27451,1464
16094,122816,9C7AFD6F67C3677E74C4343080215938,60401,8,10,2,109.47444,18.27583,1414
16095,122817,9C7AFD6F67C3677E74C4343080215938,38754,13,17,4,109.74667,18.37382,2430
16096,122818,9C7AFD6F67C3677E74C4343080215938,31851,21,23,2,109.71736,18.29007,2316
16097,122854,DA3C0DB0AE9C0567FD2B83AC70391599,30084,20,23,3,109.50118,18.26972,1513
16098,122868,0695D4E7B3E726CA09D841B87798B560,31561,0,2,2,109.56792,18.28479,1765
16099,122869,0695D4E7B3E726CA09D841B87798B560,30854,5,21,16,109.56889,18.27076,1763
16100,122871,0DA898A124E97B49A3BF26529562DEF2,39091,8,11,3,109.50097,18.25222,1510
16108,122896,F03C6507100C5B3FC97B83BF7CB2B714,31201,1,3,2,109.51042,18.23819,1558
16109,122897,F03C6507100C5B3FC97B83BF7CB2B714,38094,4,8,4,109.45403,18.28778,1316
16110,122898,F03C6507100C5B3FC97B83BF7CB2B714,31431,10,11,1,109.44639,18.29042,1316
16111,122899,F03C6507100C5B3FC97B83BF7CB2B714,31031,12,13,1,109.49979,18.25382,1510
16112,122986,6E33AC2E8E3C9A7A56D11F6F1ADE42AD,31471,15,16,1,109.34583,18.29563,917
16113,122987,6E33AC2E8E3C9A7A56D11F6F1ADE42AD,30661,19,20,1,109.37028,18.24361,1008
16114,123124,7FF3C6569A3990C03CAF6C52D3C8BC6C,31931,9,10,1,109.54771,18.29403,1667
16115,123125,7FF3C6569A3990C03CAF6C52D3C8BC6C,60241,12,13,1,109.53319,18.28667,1616
16116,123126,7FF3C6569A3990C03CAF6C52D3C8BC6C,30921,15,17,2,109.53903,18.29451,1667
16117,123160,B78E7295CB13532B4E2C30EF158E297F,30851,0,1,1,109.5616,18.27396,1713
16118,123161,B78E7295CB13532B4E2C30EF158E297F,31931,2,6,4,109.54771,18.29403,1667
16119,123162,B78E7295CB13532B4E2C30EF158E297F,39183,9,10,1,109.55542,18.28208,1715
16120,123163,B78E7295CB13532B4E2C30EF158E297F,30854,12,13,1,109.56889,18.27076,1763
16121,123164,B78E7295CB13532B4E2C30EF158E297F,39183,16,18,2,109.55542,18.28208,1715
16122,123166,0ACD42FBA28A767F44D73783967C8C23,31561,10,11,1,109.56792,18.28479,1765
16123,123203,811CE7E060D5A10FC7748D88604CC4FD,31231,0,6,6,109.42597,18.29292,1217
16124,123204,811CE7E060D5A10FC7748D88604CC4FD,30351,7,8,1,109.41701,18.29292,1217
16125,123205,811CE7E060D5A10FC7748D88604CC4FD,30661,13,15,2,109.37028,18.24361,1008
16126,123206,811CE7E060D5A10FC7748D88604CC4FD,30351,18,19,1,109.41701,18.29292,1217
16127,123207,811CE7E060D5A10FC7748D88604CC4FD,31231,19,21,2,109.42597,18.29292,1217
16128,123208,811CE7E060D5A10FC7748D88604CC4FD,30351,21,23,2,109.41701,18.29292,1217
16135,123257,093E5BB31B9532442353DAE32D399080,30711,12,15,3,109.50271,18.25347,1510
16139,123330,3A5AE4532B56D7B0975BA947CDAB0880,30711,17,19,2,109.50271,18.25347,1510
16140,123331,3A5AE4532B56D7B0975BA947CDAB0880,38071,21,22,1,109.40722,18.30938,1169
16141,123355,A928E9F6C796FE1A60807BA003DE87BB,39181,8,11,3,109.55153,18.28035,1715
16142,123356,A928E9F6C796FE1A60807BA003DE87BB,30854,13,23,10,109.56889,18.27076,1763
16143,123361,90C3DF1010756987F34232E3F39A7CF0,38754,14,15,1,109.74667,18.37382,2430
16144,123380,80B72DFF870E58099F17893CA96A269C,31071,12,13,1,109.58257,18.28458,1815
16145,123381,80B72DFF870E58099F17893CA96A269C,30711,17,19,2,109.50271,18.25347,1510
16146,123382,80B72DFF870E58099F17893CA96A269C,31071,21,23,2,109.58257,18.28458,1815
16147,123389,C52340445432E2026C0064423DB01697,39091,20,21,1,109.50097,18.25222,1510
16148,123390,C52340445432E2026C0064423DB01697,30081,22,23,1,109.50243,18.26632,1512
16149,123444,807332CEC38772FA8DF98C48FBD8DD1E,31561,7,13,6,109.56792,18.28479,1765
16150,123445,807332CEC38772FA8DF98C48FBD8DD1E,39183,14,16,2,109.55542,18.28208,1715
16151,123446,807332CEC38772FA8DF98C48FBD8DD1E,31561,16,18,2,109.56792,18.28479,1765
16159,123457,D8681498A4BDCBE5A54E7CD864E651F0,38991,0,3,3,109.52681,18.30368,1618
16160,123458,D8681498A4BDCBE5A54E7CD864E651F0,60371,4,5,1,109.53063,18.30056,1618
16164,123522,608A55C14BAB2A5B627ACC1F39B89FB6,31945,0,7,7,109.58021,18.29403,1817
16165,123523,608A55C14BAB2A5B627ACC1F39B89FB6,30854,8,11,3,109.56889,18.27076,1763
16166,123524,608A55C14BAB2A5B627ACC1F39B89FB6,31945,12,13,1,109.58021,18.29403,1817
16167,123525,608A55C14BAB2A5B627ACC1F39B89FB6,30854,15,17,2,109.56889,18.27076,1763
16168,123526,608A55C14BAB2A5B627ACC1F39B89FB6,31041,19,21,2,109.50278,18.23701,1507
16169,123527,608A55C14BAB2A5B627ACC1F39B89FB6,31945,21,23,2,109.58021,18.29403,1817
16173,123545,331C93B6083F5634586EEDFC958D0A76,60361,18,23,5,109.51938,18.29681,1567
16174,123551,6631651FB15573A8B0C781F858B82603,38325,4,6,2,109.39792,18.2909,1116
16175,123552,6631651FB15573A8B0C781F858B82603,31231,7,9,2,109.42597,18.29292,1217
16176,123553,6631651FB15573A8B0C781F858B82603,38251,10,11,1,109.49618,18.25493,1510
16177,123554,6631651FB15573A8B0C781F858B82603,30441,14,22,8,109.64021,18.25424,2010
16178,123558,A42FFEAFA5B9964BE3187EAFF6B5CA9B,48647,0,9,9,109.48701,18.29042,1466
16179,123590,8827A35309A216F0F6E4CBB2FFAC456D,30581,0,9,9,109.62257,18.24951,1959
16180,123591,8827A35309A216F0F6E4CBB2FFAC456D,30441,10,12,2,109.64021,18.25424,2010
16181,123598,AAB15CE7237752BF27667A21F2C9A310,31143,0,11,11,109.19986,18.29875,368
16182,123599,AAB15CE7237752BF27667A21F2C9A310,31471,12,13,1,109.34583,18.29563,917
16183,123600,AAB15CE7237752BF27667A21F2C9A310,31701,17,23,6,109.44132,18.28833,1266
16184,123609,CFAA4900917F16A6BB33BA227F202636,30854,1,13,12,109.56889,18.27076,1763
16185,123610,CFAA4900917F16A6BB33BA227F202636,31071,16,17,1,109.58257,18.28458,1815
16190,123648,6E6193514D8E876D83956A94AD4F3FB1,31931,12,13,1,109.54771,18.29403,1667
16191,123649,6E6193514D8E876D83956A94AD4F3FB1,30921,14,15,1,109.53903,18.29451,1667
16192,123650,6E6193514D8E876D83956A94AD4F3FB1,31931,16,22,6,109.54771,18.29403,1667
16193,123691,319C385C256C2264D15D0D4ABF1C5A6B,60221,16,19,3,109.52569,18.29188,1616
16194,123692,319C385C256C2264D15D0D4ABF1C5A6B,31061,21,23,2,109.53333,18.23257,1607
16198,123716,BE84D9BAD945F657EF3BFD7A07C2842B,31145,12,15,3,109.20431,18.30479,369
16199,123717,BE84D9BAD945F657EF3BFD7A07C2842B,31321,18,20,2,109.63799,18.23201,2007
16200,123718,BE84D9BAD945F657EF3BFD7A07C2842B,38054,22,23,1,109.63479,18.23097,2006
16201,123732,39B496BBEDAF80FAB2852AC3F417A930,31021,9,10,1,109.49021,18.27,1463
16202,123790,3066D3BA0EF6F55E10FAD924A6ADDDEF,30381,21,22,1,109.52521,18.24507,1609
16203,123800,36CE0B7F7E529688FFEB22B8E93ED58F,30361,1,8,7,109.50347,18.24,1508
16204,123801,36CE0B7F7E529688FFEB22B8E93ED58F,30241,10,11,1,109.26174,18.3275,622
16205,123802,36CE0B7F7E529688FFEB22B8E93ED58F,31071,13,21,8,109.58257,18.28458,1815
16206,123803,13166628932DF36C0AD7B1DB5811240A,39371,12,13,1,109.56627,18.2646,1762
16207,123804,13166628932DF36C0AD7B1DB5811240A,30854,14,16,2,109.56889,18.27076,1763
16208,123805,13166628932DF36C0AD7B1DB5811240A,39183,16,17,1,109.55542,18.28208,1715
16209,123806,13166628932DF36C0AD7B1DB5811240A,60591,19,23,4,109.61118,18.21715,1904
16210,123829,E605B26D53F08A0D3360A4541E09F4E2,30121,0,7,7,109.52861,18.27222,1613
16211,123830,E605B26D53F08A0D3360A4541E09F4E2,38283,10,21,11,109.62229,18.22618,1956
16212,123834,6DF7485545B790F22810B0EDD8F1B356,31945,0,7,7,109.58021,18.29403,1817
16213,123835,6DF7485545B790F22810B0EDD8F1B356,30854,7,8,1,109.56889,18.27076,1763
16214,123836,6DF7485545B790F22810B0EDD8F1B356,31945,12,13,1,109.58021,18.29403,1817
16215,123837,6DF7485545B790F22810B0EDD8F1B356,30854,13,16,3,109.56889,18.27076,1763
16216,123838,6DF7485545B790F22810B0EDD8F1B356,30151,17,19,2,109.50986,18.25083,1560
16217,123839,6DF7485545B790F22810B0EDD8F1B356,31945,21,23,2,109.58021,18.29403,1817
16218,123843,9837FB962D7F62E426A73EBD66CBBE03,30271,20,21,1,109.49132,18.23153,1456
16219,123844,9837FB962D7F62E426A73EBD66CBBE03,30681,22,23,1,109.48493,18.26917,1463
16223,123851,DF410547949833E8F7EB071905643771,60524,1,3,2,109.42951,18.28993,1216
16224,123852,DF410547949833E8F7EB071905643771,31861,6,7,1,109.49042,18.27549,1464
16225,123853,DF410547949833E8F7EB071905643771,30441,11,13,2,109.64021,18.25424,2010
16226,123854,DF410547949833E8F7EB071905643771,60221,15,18,3,109.52569,18.29188,1616
16227,123855,DF410547949833E8F7EB071905643771,31861,19,23,4,109.49042,18.27549,1464
16228,123962,0F558B6653C655C7F0BAEA9D66B33F57,31071,2,7,5,109.58257,18.28458,1815
16229,123963,0F558B6653C655C7F0BAEA9D66B33F57,30854,7,22,15,109.56889,18.27076,1763
16236,123973,E732CF7BA1CEEB13C4CFF7B9D98D47F2,31181,14,15,1,109.50382,18.24813,1509
16237,123974,E732CF7BA1CEEB13C4CFF7B9D98D47F2,60371,15,19,4,109.53063,18.30056,1618
16238,123975,F9F2694056D54C70B8E94D439CF649C0,31571,1,9,8,109.61563,18.23326,1957
16239,123976,F9F2694056D54C70B8E94D439CF649C0,31471,11,15,4,109.34583,18.29563,917
16240,123977,F9F2694056D54C70B8E94D439CF649C0,30711,17,18,1,109.50271,18.25347,1510
16241,123978,F9F2694056D54C70B8E94D439CF649C0,31221,20,21,1,109.61333,18.26833,1913
16242,123979,F9F2694056D54C70B8E94D439CF649C0,38052,22,23,1,109.62618,18.23042,1956
16247,124016,635490684ED92BDBB56F8F8FF98E24D2,39091,0,8,8,109.50097,18.25222,1510
16248,124018,635490684ED92BDBB56F8F8FF98E24D2,30711,21,23,2,109.50271,18.25347,1510
16249,124019,10026EC528DC65E6B062D4E8B47727C1,30281,18,22,4,109.50597,18.27583,1514
16250,124020,10026EC528DC65E6B062D4E8B47727C1,31351,22,23,1,109.4959,18.28417,1465
16251,124037,A01B4012B619D942E7CC3AC9B78722B4,31561,0,13,13,109.56792,18.28479,1765
16252,124038,A01B4012B619D942E7CC3AC9B78722B4,39183,14,16,2,109.55542,18.28208,1715
16253,124053,417408FFDA93B177641D270D3A5C4B2D,30854,0,4,4,109.56889,18.27076,1763
16254,124054,417408FFDA93B177641D270D3A5C4B2D,31071,4,5,1,109.58257,18.28458,1815
16255,124055,417408FFDA93B177641D270D3A5C4B2D,60631,6,10,4,109.57778,18.27583,1814
16256,124056,417408FFDA93B177641D270D3A5C4B2D,30854,10,11,1,109.56889,18.27076,1763
16257,124057,417408FFDA93B177641D270D3A5C4B2D,31071,13,14,1,109.58257,18.28458,1815
16258,124058,417408FFDA93B177641D270D3A5C4B2D,60631,16,18,2,109.57778,18.27583,1814
16259,124059,417408FFDA93B177641D270D3A5C4B2D,30854,20,23,3,109.56889,18.27076,1763
16260,124090,6DA8429267883939CEB3C36824DAAEC3,31811,15,16,1,109.54201,18.31806,1671
16261,124146,A4743972EC2FC58546DD11935BDC0E1A,39091,0,8,8,109.50097,18.25222,1510
16262,124147,A4743972EC2FC58546DD11935BDC0E1A,30711,10,13,3,109.50271,18.25347,1510
16263,124148,A4743972EC2FC58546DD11935BDC0E1A,39091,16,17,1,109.50097,18.25222,1510
16264,124149,A4743972EC2FC58546DD11935BDC0E1A,39091,19,20,1,109.50097,18.25222,1510
16265,124150,A4743972EC2FC58546DD11935BDC0E1A,31931,22,23,1,109.54771,18.29403,1667
16269,124214,C5D5953F1870A58B2AFFAAD0551D4A89,60331,0,7,7,109.505,18.26507,1512
16270,124215,C5D5953F1870A58B2AFFAAD0551D4A89,31931,9,10,1,109.54771,18.29403,1667
16271,124216,C5D5953F1870A58B2AFFAAD0551D4A89,31351,12,13,1,109.4959,18.28417,1465
16272,124217,C5D5953F1870A58B2AFFAAD0551D4A89,31931,13,14,1,109.54771,18.29403,1667
16273,124218,C5D5953F1870A58B2AFFAAD0551D4A89,30911,18,23,5,109.50493,18.26181,1511
16274,124270,D2A5F87218CF25385163A2F3C4229CB8,31561,0,5,5,109.56792,18.28479,1765
16275,124271,D2A5F87218CF25385163A2F3C4229CB8,30851,5,22,17,109.5616,18.27396,1713
16276,124280,561C33446D67FC6E6E2ADA3F2F9F59D1,38271,0,4,4,109.62632,18.23049,1956
16277,124281,561C33446D67FC6E6E2ADA3F2F9F59D1,31321,5,8,3,109.63799,18.23201,2007
16278,124282,561C33446D67FC6E6E2ADA3F2F9F59D1,38271,8,13,5,109.62632,18.23049,1956
16279,124283,561C33446D67FC6E6E2ADA3F2F9F59D1,60071,14,23,9,109.75674,18.31583,2470
16284,124314,39D0B119BCF23E40EF7A286F6A03CC6A,60594,0,2,2,109.62694,18.22799,1956
16285,124315,39D0B119BCF23E40EF7A286F6A03CC6A,30131,2,6,4,109.6959,18.215,2254
16286,124316,39D0B119BCF23E40EF7A286F6A03CC6A,38052,8,10,2,109.62618,18.23042,1956
16287,124317,39D0B119BCF23E40EF7A286F6A03CC6A,60594,12,16,4,109.62694,18.22799,1956
16288,124318,39D0B119BCF23E40EF7A286F6A03CC6A,38052,17,21,4,109.62618,18.23042,1956
16289,124319,39D0B119BCF23E40EF7A286F6A03CC6A,60594,21,23,2,109.62694,18.22799,1956
16290,124328,BD4652414D5C17466BA36FD4BD943A94,30721,1,2,1,109.51597,18.28257,1565
16291,124329,BD4652414D5C17466BA36FD4BD943A94,60221,4,7,3,109.52569,18.29188,1616
16292,124330,BD4652414D5C17466BA36FD4BD943A94,60381,12,14,2,109.5241,18.22458,1605
16293,124331,BD4652414D5C17466BA36FD4BD943A94,60221,16,18,2,109.52569,18.29188,1616
16294,124332,BD4652414D5C17466BA36FD4BD943A94,31041,22,23,1,109.50278,18.23701,1507
16298,124453,C85D0B931BEF54F05B9ABBBB03212DB7,30854,9,11,2,109.56889,18.27076,1763
16299,124454,C85D0B931BEF54F05B9ABBBB03212DB7,31561,13,17,4,109.56792,18.28479,1765
16300,124455,C85D0B931BEF54F05B9ABBBB03212DB7,30854,18,20,2,109.56889,18.27076,1763
16301,124462,9A3188B823DC0B814D36D0F4BE27142F,31071,0,9,9,109.58257,18.28458,1815
16302,124463,9A3188B823DC0B814D36D0F4BE27142F,31101,9,12,3,109.65389,18.23403,2057
16303,124464,9A3188B823DC0B814D36D0F4BE27142F,31071,13,17,4,109.58257,18.28458,1815
16304,124465,CDA1EB7B89E47C48A7CAC823B0773234,30391,0,8,8,109.4975,18.27118,1513
16305,124466,CDA1EB7B89E47C48A7CAC823B0773234,30234,8,10,2,109.60681,18.29979,1918
16306,124467,CDA1EB7B89E47C48A7CAC823B0773234,31161,10,13,3,109.70229,18.31361,2270
16307,124476,0E1DB444F47235AEDAD0A0404A7B75B4,31561,0,7,7,109.56792,18.28479,1765
16308,124477,0E1DB444F47235AEDAD0A0404A7B75B4,39181,9,12,3,109.55153,18.28035,1715
16309,124478,0E1DB444F47235AEDAD0A0404A7B75B4,39183,14,18,4,109.55542,18.28208,1715
16310,124479,0E1DB444F47235AEDAD0A0404A7B75B4,31561,19,20,1,109.56792,18.28479,1765
16311,124480,0E1DB444F47235AEDAD0A0404A7B75B4,39183,20,23,3,109.55542,18.28208,1715
16312,124524,88518ED3B6347887E74E353A92E1996C,31421,0,5,5,109.55382,18.22347,1705
16313,124525,88518ED3B6347887E74E353A92E1996C,30681,7,8,1,109.48493,18.26917,1463
16314,124526,88518ED3B6347887E74E353A92E1996C,60291,9,10,1,109.50826,18.24639,1509
16315,124527,88518ED3B6347887E74E353A92E1996C,38325,12,13,1,109.39792,18.2909,1116
16316,124528,88518ED3B6347887E74E353A92E1996C,60131,14,16,2,109.49819,18.24778,1509
16317,124529,88518ED3B6347887E74E353A92E1996C,60281,17,21,4,109.51743,18.25924,1561
16318,124582,258F9A09B3B0048D107FC9EF9EB27CDE,30421,8,11,3,109.50021,18.25861,1511
16319,124583,258F9A09B3B0048D107FC9EF9EB27CDE,30711,11,12,1,109.50271,18.25347,1510
16320,124584,258F9A09B3B0048D107FC9EF9EB27CDE,30421,14,16,2,109.50021,18.25861,1511
16321,124585,258F9A09B3B0048D107FC9EF9EB27CDE,30421,17,20,3,109.50021,18.25861,1511
16322,124586,258F9A09B3B0048D107FC9EF9EB27CDE,30421,20,23,3,109.50021,18.25861,1511
16323,124604,82F42D74CE1CC00D6CC7F8D17CCF784D,31851,0,10,10,109.71736,18.29007,2316
16324,124605,82F42D74CE1CC00D6CC7F8D17CCF784D,30361,12,13,1,109.50347,18.24,1508
16325,124606,82F42D74CE1CC00D6CC7F8D17CCF784D,31931,16,22,6,109.54771,18.29403,1667
16330,124652,F432BE98F277FF953CE263D7467BFC47,60381,17,19,2,109.5241,18.22458,1605
16331,124653,F432BE98F277FF953CE263D7467BFC47,30351,19,23,4,109.41701,18.29292,1217
16332,124658,044B260BB5F12A7C76BF06F0DD8F09A0,31521,16,18,2,109.51458,18.22542,1555
16333,124659,044B260BB5F12A7C76BF06F0DD8F09A0,30181,19,20,1,109.51597,18.23313,1557
16334,124752,34F3D64B41C252481F72E5CF931AC833,30851,18,21,3,109.5616,18.27396,1713
16335,124753,34F3D64B41C252481F72E5CF931AC833,30854,22,23,1,109.56889,18.27076,1763
16339,124791,95E09A72760B2799C2CC9BD7AF527107,30854,0,2,2,109.56889,18.27076,1763
16340,124792,95E09A72760B2799C2CC9BD7AF527107,31071,4,23,19,109.58257,18.28458,1815
16341,124800,C99018C5FE7BE36145E83B623599A9D0,31521,7,8,1,109.51458,18.22542,1555
16342,124801,C99018C5FE7BE36145E83B623599A9D0,31521,9,16,7,109.51458,18.22542,1555
16343,124802,C99018C5FE7BE36145E83B623599A9D0,31521,17,19,2,109.51458,18.22542,1555
16344,124803,C99018C5FE7BE36145E83B623599A9D0,31521,20,23,3,109.51458,18.22542,1555
16345,124809,8D8AA41210FC9E2D5DD4D81CF4DB18D7,30191,15,18,3,109.50361,18.22701,1506
16346,124810,8D8AA41210FC9E2D5DD4D81CF4DB18D7,30281,19,21,2,109.50597,18.27583,1514
16347,124814,BAB9B8A3D1E7FB96DB94A06687C464B3,60504,0,7,7,109.47917,18.28903,1416
16348,124815,BAB9B8A3D1E7FB96DB94A06687C464B3,30581,9,14,5,109.62257,18.24951,1959
16349,124816,BAB9B8A3D1E7FB96DB94A06687C464B3,38991,16,17,1,109.52681,18.30368,1618
16350,124817,BAB9B8A3D1E7FB96DB94A06687C464B3,60571,18,21,3,109.50722,18.25056,1510
16351,124818,BAB9B8A3D1E7FB96DB94A06687C464B3,60381,21,23,2,109.5241,18.22458,1605
16352,124836,C3FE81ED5256B04BAEEBFAC334C8D570,30861,17,21,4,109.52722,18.22743,1606
16353,124837,C3FE81ED5256B04BAEEBFAC334C8D570,31061,22,23,1,109.53333,18.23257,1607
16354,124844,A952750F25C558E5C17B3EB7DD935431,31931,14,15,1,109.54771,18.29403,1667
16355,124845,A952750F25C558E5C17B3EB7DD935431,60371,17,18,1,109.53063,18.30056,1618
16356,124846,A952750F25C558E5C17B3EB7DD935431,31951,22,23,1,109.52174,18.30299,1568
16361,124854,5E97A4561E11AAC4FBC53FD068EAA52B,30891,0,6,6,109.59431,18.28389,1865
16362,124855,5E97A4561E11AAC4FBC53FD068EAA52B,30854,7,22,15,109.56889,18.27076,1763
16363,124884,E6541B4F346982101D887BAAF0315541,30161,19,20,1,109.50042,18.24389,1508
16364,124885,E6541B4F346982101D887BAAF0315541,31261,22,23,1,109.51174,18.2466,1559
16365,124905,E5088AAA29200A61CA8A4F0D8DC29FB9,31521,16,21,5,109.51458,18.22542,1555
16366,124906,E5088AAA29200A61CA8A4F0D8DC29FB9,30731,21,23,2,109.50944,18.22306,1555
16367,124953,D792C662B1DB3D5110ED9FC86834DD73,31841,0,11,11,109.73201,18.33382,2373
16368,124954,D792C662B1DB3D5110ED9FC86834DD73,39321,15,16,1,109.529,18.2167,1604
16369,124955,D792C662B1DB3D5110ED9FC86834DD73,38094,18,19,1,109.45403,18.28778,1316
16370,124956,D792C662B1DB3D5110ED9FC86834DD73,38071,20,22,2,109.40722,18.30938,1169
16371,124957,B643AC77F8D8498A9694D45BA8B0F75F,60631,0,16,16,109.57778,18.27583,1814
16372,124958,B643AC77F8D8498A9694D45BA8B0F75F,30854,21,22,1,109.56889,18.27076,1763
16373,124999,63EC2A869FC00ECA459FA43A119B0B4B,60201,16,21,5,109.5041,18.2509,1510
16380,125098,27BCEF3137923B84211F08830816C810,30851,18,23,5,109.5616,18.27396,1713
16381,125129,E8EFAA5D1A201DE1B09CA7FAC04D4F91,38826,4,7,3,109.50326,18.25514,1510
16382,125130,E8EFAA5D1A201DE1B09CA7FAC04D4F91,31781,11,13,2,109.19847,18.2975,367
16383,125131,E8EFAA5D1A201DE1B09CA7FAC04D4F91,60221,18,20,2,109.52569,18.29188,1616
16384,125132,E8EFAA5D1A201DE1B09CA7FAC04D4F91,30421,21,22,1,109.50021,18.25861,1511
16385,125181,4D944399BAAD1AD37CC1D68A51FA53FD,30161,15,23,8,109.50042,18.24389,1508
16386,125222,12B727D6483DEDBBC92CB35708DC3CFE,30281,0,6,6,109.50597,18.27583,1514
16387,125223,12B727D6483DEDBBC92CB35708DC3CFE,30281,7,8,1,109.50597,18.27583,1514
16388,125224,12B727D6483DEDBBC92CB35708DC3CFE,30211,11,12,1,109.49882,18.23931,1508
16389,125225,12B727D6483DEDBBC92CB35708DC3CFE,30281,13,20,7,109.50597,18.27583,1514
16390,125226,12B727D6483DEDBBC92CB35708DC3CFE,30281,20,23,3,109.50597,18.27583,1514
16391,125229,283C1DB08EC53022FE9E85C662A0B611,38951,1,6,5,109.48097,18.28868,1416
16392,125230,283C1DB08EC53022FE9E85C662A0B611,30941,7,9,2,109.5559,18.33938,1724
16393,125231,283C1DB08EC53022FE9E85C662A0B611,38951,10,22,12,109.48097,18.28868,1416
16412,125373,F198CAA1F49ACA5D003FD8F8473B3798,30854,0,17,17,109.56889,18.27076,1763
16413,125374,F198CAA1F49ACA5D003FD8F8473B3798,60463,18,21,3,109.52507,18.22438,1605
16414,125442,C7A58F45156649A612134237290C5B69,30821,0,17,17,109.43681,18.33639,1274
16415,125443,C7A58F45156649A612134237290C5B69,31081,20,21,1,109.44639,18.30181,1318
16416,125455,8C5A16299A6D294198C90C34C25C5949,31561,0,2,2,109.56792,18.28479,1765
16417,125456,8C5A16299A6D294198C90C34C25C5949,30854,3,23,20,109.56889,18.27076,1763
16418,125459,552B98A65A23DB4CD390E78F3246E9C5,60241,0,8,8,109.53319,18.28667,1616
16419,125460,552B98A65A23DB4CD390E78F3246E9C5,31931,9,10,1,109.54771,18.29403,1667
16420,125461,552B98A65A23DB4CD390E78F3246E9C5,30921,13,14,1,109.53903,18.29451,1667
16421,125462,552B98A65A23DB4CD390E78F3246E9C5,31931,15,17,2,109.54771,18.29403,1667
16422,125463,552B98A65A23DB4CD390E78F3246E9C5,60241,21,23,2,109.53319,18.28667,1616
16423,125492,E2CFBC4AD8BA700D32898ABFA9A0C849,30854,1,21,20,109.56889,18.27076,1763
16424,125493,E2CFBC4AD8BA700D32898ABFA9A0C849,60631,21,22,1,109.57778,18.27583,1814
16425,125494,B4A8648DE41BAD1E29E1F905692C2DB7,31031,19,20,1,109.49979,18.25382,1510
16426,125495,B4A8648DE41BAD1E29E1F905692C2DB7,31531,21,23,2,109.49583,18.25972,1461
16427,125545,51015BF65833D98716A0309741D1F1C2,30854,0,16,16,109.56889,18.27076,1763
16428,125546,51015BF65833D98716A0309741D1F1C2,60463,18,21,3,109.52507,18.22438,1605
16429,125554,C12FB46046E6CB3AEC59B310176A356F,31521,0,8,8,109.51458,18.22542,1555
16430,125555,C12FB46046E6CB3AEC59B310176A356F,31691,10,12,2,109.36604,18.3075,1019
16431,125556,C12FB46046E6CB3AEC59B310176A356F,31521,16,17,1,109.51458,18.22542,1555
16432,125557,C12FB46046E6CB3AEC59B310176A356F,31031,18,19,1,109.49979,18.25382,1510
16433,125558,C12FB46046E6CB3AEC59B310176A356F,31521,20,22,2,109.51458,18.22542,1555
16434,125566,EA45533158A318D0CC45EE1B8E7FE07E,38073,3,8,5,109.40813,18.30958,1169
16435,125567,EA45533158A318D0CC45EE1B8E7FE07E,30941,11,13,2,109.5559,18.33938,1724
16436,125568,EA45533158A318D0CC45EE1B8E7FE07E,60221,16,18,2,109.52569,18.29188,1616
16437,125569,EA45533158A318D0CC45EE1B8E7FE07E,39151,19,21,2,109.49875,18.25097,1510
16438,125570,77E0479537D8350123531CE1FA2E6649,60631,0,7,7,109.57778,18.27583,1814
16439,125571,77E0479537D8350123531CE1FA2E6649,31321,10,14,4,109.63799,18.23201,2007
16440,125572,77E0479537D8350123531CE1FA2E6649,30854,16,22,6,109.56889,18.27076,1763
16444,125615,4BE8FEB7C7A1255367E8FF1F934ACEB2,30101,13,18,5,109.57299,18.33333,1773
16445,125617,7AE891083A2B2C0292CFD40014FEF0E4,38973,0,8,8,109.51097,18.25389,1560
16446,125619,7AE891083A2B2C0292CFD40014FEF0E4,30151,17,23,6,109.50986,18.25083,1560
16458,125679,C1F9914EF577AE2A8300B1A3945A50FF,30851,12,13,1,109.5616,18.27396,1713
16459,125680,C1F9914EF577AE2A8300B1A3945A50FF,31071,14,22,8,109.58257,18.28458,1815
16460,125686,FDC2B4BB960ACDA9822626D3DCBE25AF,31071,0,9,9,109.58257,18.28458,1815
16461,125687,FDC2B4BB960ACDA9822626D3DCBE25AF,30854,12,20,8,109.56889,18.27076,1763
16462,125769,533C598FBE9A80A69F24B4E517B0CF08,31351,0,19,19,109.4959,18.28417,1465
16463,125770,533C598FBE9A80A69F24B4E517B0CF08,38251,20,21,1,109.49618,18.25493,1510
16464,125801,60E3CB2A4B8EEDBCF8F5092F0306C0A3,30351,0,1,1,109.41701,18.29292,1217
16465,125802,60E3CB2A4B8EEDBCF8F5092F0306C0A3,31231,2,7,5,109.42597,18.29292,1217
16466,125862,41BDAE8841B5E7F15F794B60F93978D9,31031,18,20,2,109.49979,18.25382,1510
16467,125863,41BDAE8841B5E7F15F794B60F93978D9,38251,21,23,2,109.49618,18.25493,1510
16468,125903,BE8220A49F1231C0A022F4AA2075503E,31945,1,15,14,109.58021,18.29403,1817
16469,125904,BE8220A49F1231C0A022F4AA2075503E,60031,18,20,2,109.49694,18.31632,1521
16473,125924,94C4D5691F7DFC1AB38806AFFAC1389E,31931,5,8,3,109.54771,18.29403,1667
16474,125925,94C4D5691F7DFC1AB38806AFFAC1389E,39091,8,11,3,109.50097,18.25222,1510
16475,125926,94C4D5691F7DFC1AB38806AFFAC1389E,31931,11,14,3,109.54771,18.29403,1667
16476,125942,FFA78E97945507AFD9DEF992A707C4AC,31145,13,14,1,109.20431,18.30479,369
16477,125943,FFA78E97945507AFD9DEF992A707C4AC,31471,15,17,2,109.34583,18.29563,917
16478,125944,FFA78E97945507AFD9DEF992A707C4AC,31461,19,23,4,109.5091,18.25389,1510
16483,125998,8DA382180751D7D787A12E9A5D5EEBBE,39141,0,13,13,109.2009,18.29431,367
16484,125999,8DA382180751D7D787A12E9A5D5EEBBE,31531,14,15,1,109.49583,18.25972,1461
16485,126000,8DA382180751D7D787A12E9A5D5EEBBE,31554,18,23,5,109.55521,18.2459,1709
16486,126036,07F004282B66F8FFF4893B155B27BCEE,30351,16,18,2,109.41701,18.29292,1217
16487,126037,07F004282B66F8FFF4893B155B27BCEE,60552,19,20,1,109.41729,18.30014,1218
16488,126053,2C0209770A37CBC62C92C1A37F9CD2E2,60381,0,1,1,109.5241,18.22458,1605
16489,126054,2C0209770A37CBC62C92C1A37F9CD2E2,31521,5,8,3,109.51458,18.22542,1555
16490,126055,2C0209770A37CBC62C92C1A37F9CD2E2,31145,10,13,3,109.20431,18.30479,369
16491,126056,2C0209770A37CBC62C92C1A37F9CD2E2,31521,16,19,3,109.51458,18.22542,1555
16492,126057,2C0209770A37CBC62C92C1A37F9CD2E2,60381,19,23,4,109.5241,18.22458,1605
16493,126061,50A45076AF8C91AD6E4AEFAAB7160170,30151,0,8,8,109.50986,18.25083,1560
16494,126062,50A45076AF8C91AD6E4AEFAAB7160170,31321,9,11,2,109.63799,18.23201,2007
16498,126086,1F06AA918C76552C10500EE5591E8312,31531,20,21,1,109.49583,18.25972,1461
16499,126087,1F06AA918C76552C10500EE5591E8312,31031,21,23,2,109.49979,18.25382,1510
16500,126187,0A80AC29DC2E111565D686AEC8FAB306,60381,17,20,3,109.5241,18.22458,1605
16501,126188,0A80AC29DC2E111565D686AEC8FAB306,31521,21,23,2,109.51458,18.22542,1555
16502,126198,2576A40187A845D7B849E820F16B3DB1,30854,0,1,1,109.56889,18.27076,1763
16503,126199,2576A40187A845D7B849E820F16B3DB1,31071,2,5,3,109.58257,18.28458,1815
16504,126200,2576A40187A845D7B849E820F16B3DB1,30854,6,12,6,109.56889,18.27076,1763
16505,126201,2576A40187A845D7B849E820F16B3DB1,31071,14,15,1,109.58257,18.28458,1815
16506,126202,2576A40187A845D7B849E820F16B3DB1,30854,16,18,2,109.56889,18.27076,1763
16507,126203,2576A40187A845D7B849E820F16B3DB1,31181,22,23,1,109.50382,18.24813,1509
16508,126211,90B0A60855A43B2DB99A0964CE51D3AF,30851,16,17,1,109.5616,18.27396,1713
16509,126212,90B0A60855A43B2DB99A0964CE51D3AF,30771,18,19,1,109.49938,18.26042,1511
16510,126382,47A18820FDA9856131F74091D44B6BCB,31561,0,7,7,109.56792,18.28479,1765
16511,126383,47A18820FDA9856131F74091D44B6BCB,30851,10,22,12,109.5616,18.27396,1713
16515,126416,48416008147DAB01F8E510488F0426BA,60171,13,15,2,109.51292,18.30694,1569
16516,126417,48416008147DAB01F8E510488F0426BA,38991,16,18,2,109.52681,18.30368,1618
16520,126464,B663EE883B81AEB709AC84DCCEC3D38E,31945,0,7,7,109.58021,18.29403,1817
16521,126465,B663EE883B81AEB709AC84DCCEC3D38E,30854,11,12,1,109.56889,18.27076,1763
16522,126466,B663EE883B81AEB709AC84DCCEC3D38E,31945,13,14,1,109.58021,18.29403,1817
16523,126467,B663EE883B81AEB709AC84DCCEC3D38E,31071,15,17,2,109.58257,18.28458,1815
16524,126468,B663EE883B81AEB709AC84DCCEC3D38E,30854,18,23,5,109.56889,18.27076,1763
16525,126491,A9FCE0049DB44FE004EAFBF5B783F4A5,38154,19,20,1,109.5266,18.28278,1615
16526,126492,A9FCE0049DB44FE004EAFBF5B783F4A5,30421,21,23,2,109.50021,18.25861,1511
16527,126513,E21BDA79D452CC6D5F26BA60A43939EC,38911,15,16,1,109.51674,18.24965,1559
16528,126514,E21BDA79D452CC6D5F26BA60A43939EC,30381,18,19,1,109.52521,18.24507,1609
16529,126515,E21BDA79D452CC6D5F26BA60A43939EC,30371,20,22,2,109.51,18.24771,1559
16533,126624,7024F3A14F6F554DC6E80063E30315F0,31561,4,5,1,109.56792,18.28479,1765
16534,126625,7024F3A14F6F554DC6E80063E30315F0,39183,9,15,6,109.55542,18.28208,1715
16535,126659,53108F311C210CF417B0D8E14F0347CF,31781,11,13,2,109.19847,18.2975,367
16536,126660,53108F311C210CF417B0D8E14F0347CF,38071,17,18,1,109.40722,18.30938,1169
16540,126686,8CE55AC8BC984D52D16D6CE4872EB6FC,31091,1,2,1,109.41201,18.31222,1170
16541,126687,8CE55AC8BC984D52D16D6CE4872EB6FC,31391,4,18,14,109.50382,18.24285,1508
16542,126688,8CE55AC8BC984D52D16D6CE4872EB6FC,38754,20,21,1,109.74667,18.37382,2430
16543,126689,8CE55AC8BC984D52D16D6CE4872EB6FC,30511,22,23,1,109.51069,18.24208,1558
16544,126690,C04EA069938282DB5BB0C38C2CD8C103,30511,0,9,9,109.51069,18.24208,1558
16545,126719,833001CDF394BB3F6E4F040C2A70AC27,31071,3,6,3,109.58257,18.28458,1815
16546,126720,833001CDF394BB3F6E4F040C2A70AC27,30854,7,17,10,109.56889,18.27076,1763
16547,126729,663CE56232D73D50E42DEC41EA33269F,31931,2,8,6,109.54771,18.29403,1667
16548,126730,663CE56232D73D50E42DEC41EA33269F,31571,11,13,2,109.61563,18.23326,1957
16549,126731,663CE56232D73D50E42DEC41EA33269F,30921,14,16,2,109.53903,18.29451,1667
16550,126744,44D0BB13B5123E75A8BB6EBED6897096,39061,0,6,6,109.38222,18.28958,1066
16551,126745,44D0BB13B5123E75A8BB6EBED6897096,31781,10,12,2,109.19847,18.2975,367
16552,126746,44D0BB13B5123E75A8BB6EBED6897096,60054,14,15,1,109.3016,18.31229,770
16553,126765,0D00E0CA974DDA00224ACCD00B993468,30851,0,4,4,109.5616,18.27396,1713
16554,126766,0D00E0CA974DDA00224ACCD00B993468,39183,4,5,1,109.55542,18.28208,1715
16555,126767,0D00E0CA974DDA00224ACCD00B993468,30854,8,9,1,109.56889,18.27076,1763
16556,126768,0D00E0CA974DDA00224ACCD00B993468,31561,10,15,5,109.56792,18.28479,1765
16557,126769,0D00E0CA974DDA00224ACCD00B993468,31071,18,22,4,109.58257,18.28458,1815
16561,126793,567BF1868FBA42FA9B3B29F2CA13F65D,31931,3,5,2,109.54771,18.29403,1667
16562,126794,567BF1868FBA42FA9B3B29F2CA13F65D,30921,7,12,5,109.53903,18.29451,1667
16563,126795,567BF1868FBA42FA9B3B29F2CA13F65D,31931,15,18,3,109.54771,18.29403,1667
16564,126796,567BF1868FBA42FA9B3B29F2CA13F65D,30221,19,22,3,109.57833,18.20222,1802
16565,126806,4A0A93A257347F50F0B6F0C8309FF3C3,31521,16,17,1,109.51458,18.22542,1555
16566,126807,4A0A93A257347F50F0B6F0C8309FF3C3,60381,17,21,4,109.5241,18.22458,1605
16567,126808,4A0A93A257347F50F0B6F0C8309FF3C3,31521,21,22,1,109.51458,18.22542,1555
16568,126809,931F0CE96CB3E3BDA4D1114A4A6C2A83,31851,0,3,3,109.71736,18.29007,2316
16569,126810,931F0CE96CB3E3BDA4D1114A4A6C2A83,30854,6,8,2,109.56889,18.27076,1763
16570,126811,931F0CE96CB3E3BDA4D1114A4A6C2A83,31071,11,13,2,109.58257,18.28458,1815
16571,126812,931F0CE96CB3E3BDA4D1114A4A6C2A83,30854,14,15,1,109.56889,18.27076,1763
16572,126813,931F0CE96CB3E3BDA4D1114A4A6C2A83,31031,19,21,2,109.49979,18.25382,1510
16573,126814,F00821368F615DCDAF214035D8EC4A44,31071,0,7,7,109.58257,18.28458,1815
16574,126815,F00821368F615DCDAF214035D8EC4A44,30854,8,17,9,109.56889,18.27076,1763
16575,126844,934029FB5F97BCE114EDCE88F0393A63,30232,0,4,4,109.6191,18.31701,1971
16576,126845,934029FB5F97BCE114EDCE88F0393A63,30854,6,19,13,109.56889,18.27076,1763
16577,126846,934029FB5F97BCE114EDCE88F0393A63,39371,21,23,2,109.56627,18.2646,1762
16581,126856,4521A8D92A7219267FD46990BC1A5213,30232,0,4,4,109.6191,18.31701,1971
16582,126857,4521A8D92A7219267FD46990BC1A5213,31561,5,6,1,109.56792,18.28479,1765
16583,126858,4521A8D92A7219267FD46990BC1A5213,30232,10,23,13,109.6191,18.31701,1971
16584,126872,E082FB5BD091C5B334EC1176FF352EE0,60371,0,8,8,109.53063,18.30056,1618
16585,126873,E082FB5BD091C5B334EC1176FF352EE0,39181,9,11,2,109.55153,18.28035,1715
16586,126874,E082FB5BD091C5B334EC1176FF352EE0,31931,11,12,1,109.54771,18.29403,1667
16587,126875,E082FB5BD091C5B334EC1176FF352EE0,39181,14,16,2,109.55153,18.28035,1715
16588,126876,E082FB5BD091C5B334EC1176FF352EE0,30071,20,22,2,109.52819,18.30472,1619
16589,126888,4290A01FCBC2456E9D2F061E9D5E5D68,60371,18,23,5,109.53063,18.30056,1618
16590,126902,AA17C9279A63248D7DCDF49F93EB8817,39183,2,9,7,109.55542,18.28208,1715
16591,126903,AA17C9279A63248D7DCDF49F93EB8817,60381,13,15,2,109.5241,18.22458,1605
16592,126904,AA17C9279A63248D7DCDF49F93EB8817,30854,19,20,1,109.56889,18.27076,1763
16593,126951,7050D1E0A5553A00BB03B768ACFBCA8F,30361,11,13,2,109.50347,18.24,1508
16594,126952,7050D1E0A5553A00BB03B768ACFBCA8F,31461,13,17,4,109.5091,18.25389,1510
16595,126953,7050D1E0A5553A00BB03B768ACFBCA8F,60361,19,22,3,109.51938,18.29681,1567
16599,126974,926E22A5E8101C23324E16D288147F19,38094,12,13,1,109.45403,18.28778,1316
16600,126975,926E22A5E8101C23324E16D288147F19,60281,13,15,2,109.51743,18.25924,1561
16601,126987,F84D949DDCBF25D5530F771BC55E0B9D,61011,0,3,3,109.60653,18.19076,1900
16602,126994,409F5E8F01172D32BBE91132149C037E,31864,18,20,2,109.49014,18.28333,1465
16603,126995,409F5E8F01172D32BBE91132149C037E,31861,21,22,1,109.49042,18.27549,1464
16604,126996,07169E7114E4F14C073261BAAC0D4491,61011,0,8,8,109.60653,18.19076,1900
16605,126998,07169E7114E4F14C073261BAAC0D4491,61011,12,16,4,109.60653,18.19076,1900
16606,127000,53490AD77ACCA93C3ED0F3DE79CA488B,31071,7,9,2,109.58257,18.28458,1815
16607,127001,53490AD77ACCA93C3ED0F3DE79CA488B,30854,10,12,2,109.56889,18.27076,1763
16608,127002,53490AD77ACCA93C3ED0F3DE79CA488B,31071,16,17,1,109.58257,18.28458,1815
16609,127003,53490AD77ACCA93C3ED0F3DE79CA488B,30854,18,21,3,109.56889,18.27076,1763
16610,127013,B7A51644BA2B41C2F23A67608468F705,31561,0,20,20,109.56792,18.28479,1765
16611,127014,B7A51644BA2B41C2F23A67608468F705,30854,22,23,1,109.56889,18.27076,1763
16612,127029,6F590AF2C10C4B9F0F4E76B8E922550E,31945,0,17,17,109.58021,18.29403,1817
16613,127030,6F590AF2C10C4B9F0F4E76B8E922550E,60381,17,20,3,109.5241,18.22458,1605
16614,127064,088D66324A5ED1F3FDE9B38E9377D275,31841,1,8,7,109.73201,18.33382,2373
16615,127065,088D66324A5ED1F3FDE9B38E9377D275,31471,12,13,1,109.34583,18.29563,917
16616,127066,088D66324A5ED1F3FDE9B38E9377D275,31701,15,16,1,109.44132,18.28833,1266
16617,127067,088D66324A5ED1F3FDE9B38E9377D275,30361,17,19,2,109.50347,18.24,1508
16622,127074,121138E269BBF0B506FA8CE6CEB3BF52,31931,0,7,7,109.54771,18.29403,1667
16623,127075,121138E269BBF0B506FA8CE6CEB3BF52,39181,10,11,1,109.55153,18.28035,1715
16624,127098,9C1407835BC54BEBDB541F52E1DA1820,61011,5,10,5,109.60653,18.19076,1900
16625,127100,9C1407835BC54BEBDB541F52E1DA1820,61011,15,21,6,109.60653,18.19076,1900
16626,127125,3520FED22A4D572CBFE1B08BD2743E22,31181,0,1,1,109.50382,18.24813,1509
16627,127126,3520FED22A4D572CBFE1B08BD2743E22,60291,4,9,5,109.50826,18.24639,1509
16628,127127,3520FED22A4D572CBFE1B08BD2743E22,30161,11,16,5,109.50042,18.24389,1508
16629,127128,3520FED22A4D572CBFE1B08BD2743E22,30764,16,17,1,109.45806,18.29486,1367
16630,127129,3520FED22A4D572CBFE1B08BD2743E22,60381,19,20,1,109.5241,18.22458,1605
16631,127130,3520FED22A4D572CBFE1B08BD2743E22,60291,22,23,1,109.50826,18.24639,1509
16632,127153,8E5F3B2493DD0AA38315FE1AF112101A,31391,0,5,5,109.50382,18.24285,1508
16633,127154,8E5F3B2493DD0AA38315FE1AF112101A,31781,8,10,2,109.19847,18.2975,367
16634,127155,8E5F3B2493DD0AA38315FE1AF112101A,31145,10,13,3,109.20431,18.30479,369
16635,127156,8E5F3B2493DD0AA38315FE1AF112101A,60054,13,14,1,109.3016,18.31229,770
16636,127162,832CED7A9767F731540B7A7E7B00DB89,60361,15,16,1,109.51938,18.29681,1567
16637,127163,832CED7A9767F731540B7A7E7B00DB89,60631,18,22,4,109.57778,18.27583,1814
16638,127221,2A699167E9D3E245FFAC98B0B1AFC37B,31071,0,7,7,109.58257,18.28458,1815
16639,127222,2A699167E9D3E245FFAC98B0B1AFC37B,60381,9,11,2,109.5241,18.22458,1605
16640,127223,2A699167E9D3E245FFAC98B0B1AFC37B,30854,14,17,3,109.56889,18.27076,1763
16641,127224,2A699167E9D3E245FFAC98B0B1AFC37B,31071,19,20,1,109.58257,18.28458,1815
16642,127231,4568F4CB3839A063AA85BE5AD656F1DE,30911,17,18,1,109.50493,18.26181,1511
16643,127232,4568F4CB3839A063AA85BE5AD656F1DE,31461,18,20,2,109.5091,18.25389,1510
16644,127233,4568F4CB3839A063AA85BE5AD656F1DE,30721,20,23,3,109.51597,18.28257,1565
16645,127240,A8E275DD27FBBA73D05B585FBDDEE684,60594,1,6,5,109.62694,18.22799,1956
16646,127241,A8E275DD27FBBA73D05B585FBDDEE684,38052,8,10,2,109.62618,18.23042,1956
16647,127242,8C3D244B6DAAE8C73F174808255E03C6,60011,0,6,6,109.48965,18.30222,1468
16648,127243,8C3D244B6DAAE8C73F174808255E03C6,30764,7,17,10,109.45806,18.29486,1367
16649,127247,9BF28B433E02EDD44843729C864FE002,30711,9,10,1,109.50271,18.25347,1510
16650,127248,9BF28B433E02EDD44843729C864FE002,31461,11,13,2,109.5091,18.25389,1510
16651,127249,9BF28B433E02EDD44843729C864FE002,31145,15,17,2,109.20431,18.30479,369
16652,127250,9BF28B433E02EDD44843729C864FE002,31461,18,23,5,109.5091,18.25389,1510
16653,127258,1F5A515C5AC85D4C79D71950DF5477FB,30571,1,12,11,109.50243,18.21861,1504
16654,127259,1F5A515C5AC85D4C79D71950DF5477FB,38017,13,14,1,109.49729,18.21424,1504
16655,127260,1F5A515C5AC85D4C79D71950DF5477FB,38071,15,16,1,109.40722,18.30938,1169
16660,127302,AD24687CE009DD38418E30D2A06E4D4E,60381,17,19,2,109.5241,18.22458,1605
16661,127303,AD24687CE009DD38418E30D2A06E4D4E,31864,20,23,3,109.49014,18.28333,1465
16662,127365,99CBAA6A65A50998F0A10B72B36210E4,60231,2,4,2,109.49903,18.21972,1504
16663,127366,99CBAA6A65A50998F0A10B72B36210E4,30271,4,5,1,109.49132,18.23153,1456
16664,127367,99CBAA6A65A50998F0A10B72B36210E4,60231,6,7,1,109.49903,18.21972,1504
16665,127368,99CBAA6A65A50998F0A10B72B36210E4,30341,12,14,2,109.3625,18.29167,966
16666,127369,99CBAA6A65A50998F0A10B72B36210E4,30661,15,16,1,109.37028,18.24361,1008
16667,127370,99CBAA6A65A50998F0A10B72B36210E4,60161,19,23,4,109.49174,18.26181,1461
16668,127437,3DC27A2CD4FE63FAF7640F6DDBACB36E,60131,0,9,9,109.49819,18.24778,1509
16669,127438,3DC27A2CD4FE63FAF7640F6DDBACB36E,31531,11,12,1,109.49583,18.25972,1461
16670,127439,3DC27A2CD4FE63FAF7640F6DDBACB36E,60131,12,13,1,109.49819,18.24778,1509
16671,127440,3DC27A2CD4FE63FAF7640F6DDBACB36E,30571,17,18,1,109.50243,18.21861,1504
16672,127441,3DC27A2CD4FE63FAF7640F6DDBACB36E,38017,22,23,1,109.49729,18.21424,1504
16676,127463,37D38EF0062E64D55C94EB554B76F9EE,31945,0,6,6,109.58021,18.29403,1817
16677,127464,37D38EF0062E64D55C94EB554B76F9EE,30854,8,9,1,109.56889,18.27076,1763
16678,127480,E34FF61340C5B86CF9FD0AD454D26266,60331,0,6,6,109.505,18.26507,1512
16679,127481,E34FF61340C5B86CF9FD0AD454D26266,30324,8,10,2,109.50326,18.29257,1517
16680,127482,E34FF61340C5B86CF9FD0AD454D26266,60331,11,14,3,109.505,18.26507,1512
16681,127483,E34FF61340C5B86CF9FD0AD454D26266,30911,17,18,1,109.50493,18.26181,1511
16682,127484,E34FF61340C5B86CF9FD0AD454D26266,38127,18,20,2,109.50833,18.27222,1513
16683,127485,E34FF61340C5B86CF9FD0AD454D26266,30081,21,23,2,109.50243,18.26632,1512
16684,127538,2986E42C864F9C3503A05721F57A75DB,31931,0,7,7,109.54771,18.29403,1667
16685,127539,2986E42C864F9C3503A05721F57A75DB,39101,9,10,1,109.50132,18.24931,1509
16686,127540,2986E42C864F9C3503A05721F57A75DB,31931,11,13,2,109.54771,18.29403,1667
16687,127557,7784022BDEFABB0258B32ABBB5E13027,38754,13,14,1,109.74667,18.37382,2430
16688,127558,7784022BDEFABB0258B32ABBB5E13027,60291,18,19,1,109.50826,18.24639,1509
16689,127559,7784022BDEFABB0258B32ABBB5E13027,30861,21,23,2,109.52722,18.22743,1606
16690,127565,92A2864B24BF6E1A0CE547DBC05D8536,31471,15,17,2,109.34583,18.29563,917
16691,127566,92A2864B24BF6E1A0CE547DBC05D8536,31311,20,22,2,109.72299,18.27438,2364
16698,127640,70E36A4B82878626B569C66E46C7827C,31101,15,23,8,109.65389,18.23403,2057
16699,127680,76F6A54588C8DF7DDADFC50CAA11D44C,30854,10,12,2,109.56889,18.27076,1763
16700,127681,76F6A54588C8DF7DDADFC50CAA11D44C,38085,15,16,1,109.6291,18.23625,2007
16701,127705,11BA48A87BA84CE63B9512A0940BAB43,31851,0,10,10,109.71736,18.29007,2316
16702,127706,11BA48A87BA84CE63B9512A0940BAB43,30711,11,15,4,109.50271,18.25347,1510
16703,127707,11BA48A87BA84CE63B9512A0940BAB43,31851,16,23,7,109.71736,18.29007,2316
16704,127769,56F818D0924E7BDB02CCC04065747626,38205,0,7,7,109.62743,18.23139,1956
16705,127771,56F818D0924E7BDB02CCC04065747626,38205,15,22,7,109.62743,18.23139,1956
16706,127774,51061B3DE820AF1C1C713EF684728003,30854,0,2,2,109.56889,18.27076,1763
16707,127775,51061B3DE820AF1C1C713EF684728003,31071,5,7,2,109.58257,18.28458,1815
16708,127776,51061B3DE820AF1C1C713EF684728003,30854,9,11,2,109.56889,18.27076,1763
16709,127777,51061B3DE820AF1C1C713EF684728003,31071,13,14,1,109.58257,18.28458,1815
16710,127778,51061B3DE820AF1C1C713EF684728003,30854,14,22,8,109.56889,18.27076,1763
16711,127785,A8E9C7BB918ADAD29A3EA7ACDDCD32D7,38951,0,2,2,109.48097,18.28868,1416
16712,127786,A8E9C7BB918ADAD29A3EA7ACDDCD32D7,38951,2,12,10,109.48097,18.28868,1416
16713,127787,A8E9C7BB918ADAD29A3EA7ACDDCD32D7,60041,13,14,1,109.39889,18.31944,1121
16714,127788,A8E9C7BB918ADAD29A3EA7ACDDCD32D7,31171,16,22,6,109.50938,18.24917,1559
16715,127799,012ABD06F231728C214A4BA917E75B1C,31561,0,2,2,109.56792,18.28479,1765
16716,127800,012ABD06F231728C214A4BA917E75B1C,30851,6,7,1,109.5616,18.27396,1713
16717,127801,012ABD06F231728C214A4BA917E75B1C,31561,9,13,4,109.56792,18.28479,1765
16718,127802,012ABD06F231728C214A4BA917E75B1C,30851,13,15,2,109.5616,18.27396,1713
16719,127803,012ABD06F231728C214A4BA917E75B1C,31561,15,17,2,109.56792,18.28479,1765
16720,127804,012ABD06F231728C214A4BA917E75B1C,30851,17,23,6,109.5616,18.27396,1713
16728,127951,D61883A9E0C7F2103C981F95E51C66DA,30921,19,20,1,109.53903,18.29451,1667
16729,127952,D61883A9E0C7F2103C981F95E51C66DA,31931,21,22,1,109.54771,18.29403,1667
16733,128001,A77997C0827AC67795C1E20276F47342,31471,12,13,1,109.34583,18.29563,917
16734,128002,A77997C0827AC67795C1E20276F47342,30101,16,22,6,109.57299,18.33333,1773
16735,128052,8752BC71725B50257436D50C6598F252,31071,0,7,7,109.58257,18.28458,1815
16736,128053,8752BC71725B50257436D50C6598F252,30854,7,19,12,109.56889,18.27076,1763
16737,128133,08077B5D5F0A9938A81D328635D03C8B,30234,2,6,4,109.60681,18.29979,1918
16738,128134,08077B5D5F0A9938A81D328635D03C8B,30854,7,12,5,109.56889,18.27076,1763
16739,128146,DC9973204E62AA99FA79F0696CF6C0F6,30854,0,10,10,109.56889,18.27076,1763
16740,128147,DC9973204E62AA99FA79F0696CF6C0F6,31945,10,13,3,109.58021,18.29403,1817
16741,128157,6ABF30CD5F14455AA21662324DAC8186,31561,6,7,1,109.56792,18.28479,1765
16742,128158,6ABF30CD5F14455AA21662324DAC8186,30854,10,11,1,109.56889,18.27076,1763
16743,128159,6ABF30CD5F14455AA21662324DAC8186,31071,15,16,1,109.58257,18.28458,1815
16744,128160,6ABF30CD5F14455AA21662324DAC8186,31561,17,20,3,109.56792,18.28479,1765
16745,128194,33A62A8066AF8B1342859DF4B906FBD2,30741,0,10,10,109.49833,18.28681,1516
16746,128195,33A62A8066AF8B1342859DF4B906FBD2,30351,11,12,1,109.41701,18.29292,1217
16747,128197,A29C3DFD5E3ED4F98E6C43DA6AE0D5D6,60131,0,2,2,109.49819,18.24778,1509
16748,128198,A29C3DFD5E3ED4F98E6C43DA6AE0D5D6,39091,3,7,4,109.50097,18.25222,1510
16749,128199,A29C3DFD5E3ED4F98E6C43DA6AE0D5D6,39151,7,13,6,109.49875,18.25097,1510
16750,128200,A29C3DFD5E3ED4F98E6C43DA6AE0D5D6,31031,13,15,2,109.49979,18.25382,1510
16751,128201,A29C3DFD5E3ED4F98E6C43DA6AE0D5D6,31031,18,20,2,109.49979,18.25382,1510
16755,128269,7A8A49FBFD114425697B8C888A41840A,60631,0,17,17,109.57778,18.27583,1814
16756,128270,7A8A49FBFD114425697B8C888A41840A,31071,19,23,4,109.58257,18.28458,1815
16757,128271,BA7DDC5AF6FA3B9E59DB2783070090EF,31471,16,17,1,109.34583,18.29563,917
16758,128272,BA7DDC5AF6FA3B9E59DB2783070090EF,60084,20,23,3,109.4984,18.2334,1507
16759,128273,FED6A35BC679413EC0346D897F15EB66,38321,1,11,10,109.39854,18.29132,1116
16760,128274,FED6A35BC679413EC0346D897F15EB66,38754,14,15,1,109.74667,18.37382,2430
16761,128275,FED6A35BC679413EC0346D897F15EB66,38325,18,23,5,109.39792,18.2909,1116
16762,128320,1412BA3B65BC1A2354CCBE297098A0E1,31071,1,11,10,109.58257,18.28458,1815
16763,128321,1412BA3B65BC1A2354CCBE297098A0E1,30854,15,18,3,109.56889,18.27076,1763
16768,128461,C6FE4CF0CD47303AD7F7EC5A71315B10,60631,6,7,1,109.57778,18.27583,1814
16769,128462,C6FE4CF0CD47303AD7F7EC5A71315B10,38275,10,20,10,109.62875,18.22938,2006
16770,128475,D2AB5CB6DDBFA91923528DA022D6A566,30854,0,5,5,109.56889,18.27076,1763
16771,128476,D2AB5CB6DDBFA91923528DA022D6A566,30361,9,10,1,109.50347,18.24,1508
16772,128477,D2AB5CB6DDBFA91923528DA022D6A566,30101,12,14,2,109.57299,18.33333,1773
16776,128559,40285EE8CCE25C38988EC087545664EC,31071,16,18,2,109.58257,18.28458,1815
16777,128560,40285EE8CCE25C38988EC087545664EC,31821,19,20,1,109.51181,18.24924,1559
16778,128561,40285EE8CCE25C38988EC087545664EC,31206,21,23,2,109.50819,18.23549,1507
16779,128579,686584B2BD5C98E8E504E785E36CD6B3,38951,0,6,6,109.48097,18.28868,1416
16780,128580,686584B2BD5C98E8E504E785E36CD6B3,30941,8,12,4,109.5559,18.33938,1724
16781,128581,686584B2BD5C98E8E504E785E36CD6B3,38951,13,23,10,109.48097,18.28868,1416
16782,128647,D9359F177293DE6337F7CC97B1116186,60594,1,2,1,109.62694,18.22799,1956
16783,128648,D9359F177293DE6337F7CC97B1116186,31571,5,7,2,109.61563,18.23326,1957
16784,128654,C8922FAF66F21ECAECB6B717FCD5A53B,60614,0,7,7,109.48799,18.29521,1467
16785,128655,C8922FAF66F21ECAECB6B717FCD5A53B,60391,7,9,2,109.47667,18.28757,1416
16786,128656,C8922FAF66F21ECAECB6B717FCD5A53B,60614,9,14,5,109.48799,18.29521,1467
16787,128657,C8922FAF66F21ECAECB6B717FCD5A53B,60391,14,19,5,109.47667,18.28757,1416
16788,128658,C8922FAF66F21ECAECB6B717FCD5A53B,60614,19,23,4,109.48799,18.29521,1467
16789,128659,7D1ED6067ECBD941EFC43CE0A6ADAE71,30854,0,15,15,109.56889,18.27076,1763
16790,128660,7D1ED6067ECBD941EFC43CE0A6ADAE71,30421,18,22,4,109.50021,18.25861,1511
16791,128661,FD359EB3CAC5C54CC64F5DDAD6DDAE97,31061,0,16,16,109.53333,18.23257,1607
16792,128662,FD359EB3CAC5C54CC64F5DDAD6DDAE97,31021,18,20,2,109.49021,18.27,1463
16793,128667,9E8746086915F9D4A063A74CF0B5B7AB,30851,3,5,2,109.5616,18.27396,1713
16794,128668,9E8746086915F9D4A063A74CF0B5B7AB,31561,6,7,1,109.56792,18.28479,1765
16795,128669,9E8746086915F9D4A063A74CF0B5B7AB,39183,7,8,1,109.55542,18.28208,1715
16796,128670,9E8746086915F9D4A063A74CF0B5B7AB,31561,12,14,2,109.56792,18.28479,1765
16797,128671,9E8746086915F9D4A063A74CF0B5B7AB,39183,14,15,1,109.55542,18.28208,1715
16798,128680,017BB493E18067371C6FAA1A30D4BA4B,60161,9,10,1,109.49174,18.26181,1461
16799,128681,017BB493E18067371C6FAA1A30D4BA4B,60441,12,16,4,109.46792,18.28604,1366
16800,128682,017BB493E18067371C6FAA1A30D4BA4B,60231,19,20,1,109.49903,18.21972,1504
16801,128702,8A19D38C67DEBBE2072401E23B2467C5,60114,18,19,1,109.73028,18.33847,2374
16802,128703,8A19D38C67DEBBE2072401E23B2467C5,31161,21,23,2,109.70229,18.31361,2270
16803,128715,FD5B9AB034F15F72E8BEF02193669238,31931,8,9,1,109.54771,18.29403,1667
16804,128716,FD5B9AB034F15F72E8BEF02193669238,60241,12,22,10,109.53319,18.28667,1616
16805,128738,04ABA8BFD5D63DDF1B83BA0577C9019C,31071,10,17,7,109.58257,18.28458,1815
16806,128739,04ABA8BFD5D63DDF1B83BA0577C9019C,30232,21,22,1,109.6191,18.31701,1971
16807,128742,C56FFEC7A513E811F8A8716FF6938EBC,39091,0,9,9,109.50097,18.25222,1510
16808,128744,C56FFEC7A513E811F8A8716FF6938EBC,30711,19,23,4,109.50271,18.25347,1510
16809,128774,564220533658012885D64AC3FDD81E22,30361,16,17,1,109.50347,18.24,1508
16810,128775,564220533658012885D64AC3FDD81E22,60381,18,23,5,109.5241,18.22458,1605
16811,128781,55D663E94101F000896F2C3F897BA6C9,30561,0,4,4,109.52778,18.31938,1621
16812,128782,55D663E94101F000896F2C3F897BA6C9,30031,4,15,11,109.53681,18.33313,1673
16813,128783,55D663E94101F000896F2C3F897BA6C9,60381,16,17,1,109.5241,18.22458,1605
16814,128784,55D663E94101F000896F2C3F897BA6C9,30031,20,21,1,109.53681,18.33313,1673
16815,128785,55D663E94101F000896F2C3F897BA6C9,30561,21,23,2,109.52778,18.31938,1621
16816,128822,E9E473F09C342630187345312F4A31D8,39181,0,19,19,109.55153,18.28035,1715
16817,128823,E9E473F09C342630187345312F4A31D8,39181,20,23,3,109.55153,18.28035,1715
16818,128846,08A066736557478B1013C0CF834491DF,30921,0,6,6,109.53903,18.29451,1667
16819,128847,08A066736557478B1013C0CF834491DF,31931,9,13,4,109.54771,18.29403,1667
16820,128848,08A066736557478B1013C0CF834491DF,30921,17,18,1,109.53903,18.29451,1667
16821,128849,08A066736557478B1013C0CF834491DF,31931,19,20,1,109.54771,18.29403,1667
16822,128850,08A066736557478B1013C0CF834491DF,30921,22,23,1,109.53903,18.29451,1667
16823,128863,A1657F2E26148E87604D8FB77783D52A,31231,0,8,8,109.42597,18.29292,1217
16824,128864,A1657F2E26148E87604D8FB77783D52A,38241,11,12,1,109.54111,18.30542,1669
16825,128865,A1657F2E26148E87604D8FB77783D52A,31231,13,17,4,109.42597,18.29292,1217
16826,128866,A1657F2E26148E87604D8FB77783D52A,31461,19,20,1,109.5091,18.25389,1510
16827,128867,A1657F2E26148E87604D8FB77783D52A,31231,21,23,2,109.42597,18.29292,1217
16828,128876,E24CDF8EE180624B3803A186364F1593,60171,11,12,1,109.51292,18.30694,1569
16829,128877,E24CDF8EE180624B3803A186364F1593,30761,13,14,1,109.45201,18.3,1318
16830,128888,892C8CDA0BCAF97A4A9B5DDF3BB8D7F0,30854,17,18,1,109.56889,18.27076,1763
16831,128889,892C8CDA0BCAF97A4A9B5DDF3BB8D7F0,31071,20,22,2,109.58257,18.28458,1815
16835,128966,32E97C71348406BC9AE60C6CB8F1E953,60371,18,23,5,109.53063,18.30056,1618
16836,129010,2AE38FAF341950B0B91404FFCE5A0F3E,30921,6,18,12,109.53903,18.29451,1667
16837,129011,2AE38FAF341950B0B91404FFCE5A0F3E,31931,20,22,2,109.54771,18.29403,1667
16841,129022,39F25FE146A03325C93C111F2A943B6C,31945,0,7,7,109.58021,18.29403,1817
16842,129023,39F25FE146A03325C93C111F2A943B6C,30854,9,12,3,109.56889,18.27076,1763
16843,129024,39F25FE146A03325C93C111F2A943B6C,31945,12,13,1,109.58021,18.29403,1817
16844,129025,39F25FE146A03325C93C111F2A943B6C,30854,15,16,1,109.56889,18.27076,1763
16845,129026,39F25FE146A03325C93C111F2A943B6C,31071,16,17,1,109.58257,18.28458,1815
16846,129027,39F25FE146A03325C93C111F2A943B6C,31041,20,21,1,109.50278,18.23701,1507
16847,129028,58418A9EA4A7DC03127CB79C039A5185,31071,0,8,8,109.58257,18.28458,1815
16848,129029,58418A9EA4A7DC03127CB79C039A5185,38754,11,16,5,109.74667,18.37382,2430
16849,129030,58418A9EA4A7DC03127CB79C039A5185,39091,18,23,5,109.50097,18.25222,1510
16850,129104,9F5F8E6110AC554161BA0F6410145CFE,30671,14,15,1,109.43611,18.30139,1268
16851,129105,9F5F8E6110AC554161BA0F6410145CFE,31231,16,18,2,109.42597,18.29292,1217
16852,129106,9F5F8E6110AC554161BA0F6410145CFE,30351,20,23,3,109.41701,18.29292,1217
16859,129175,B34415F599F0ED7D1A073EE314A60B9B,60541,0,7,7,109.4084,18.29208,1167
16860,129176,B34415F599F0ED7D1A073EE314A60B9B,31671,7,21,14,109.38965,18.29813,1068
16861,129216,6780524A249B8A38CA7BA3C9D25990DC,60541,18,19,1,109.4084,18.29208,1167
16862,129217,6780524A249B8A38CA7BA3C9D25990DC,31681,21,23,2,109.40396,18.29979,1168
16863,129243,EC4B90EDBF35256FDB4D4F8B87DB8A04,31071,0,16,16,109.58257,18.28458,1815
16864,129244,EC4B90EDBF35256FDB4D4F8B87DB8A04,30854,20,22,2,109.56889,18.27076,1763
16868,129248,E0A24740E2C54F3B77DB561A91D2BED7,31821,0,1,1,109.51181,18.24924,1559
16869,129249,E0A24740E2C54F3B77DB561A91D2BED7,30151,6,7,1,109.50986,18.25083,1560
16870,129250,E0A24740E2C54F3B77DB561A91D2BED7,30251,8,17,9,109.50611,18.26653,1512
16871,129251,E0A24740E2C54F3B77DB561A91D2BED7,31461,17,20,3,109.5091,18.25389,1510
16872,129252,E0A24740E2C54F3B77DB561A91D2BED7,60571,21,23,2,109.50722,18.25056,1510
16873,129281,10E6DCB22C04D9E1B01193CDA87B3193,60221,19,21,2,109.52569,18.29188,1616
16874,129282,10E6DCB22C04D9E1B01193CDA87B3193,30721,21,23,2,109.51597,18.28257,1565
16875,129309,03DA52CB04D303C32B3FDE6BAFCAF395,31521,0,14,14,109.51458,18.22542,1555
16876,129310,03DA52CB04D303C32B3FDE6BAFCAF395,30854,15,18,3,109.56889,18.27076,1763
16877,129311,03DA52CB04D303C32B3FDE6BAFCAF395,31521,19,23,4,109.51458,18.22542,1555
16878,129326,9E75E21F61DD725C83C4FFC35907ACC9,60221,16,17,1,109.52569,18.29188,1616
16879,129327,9E75E21F61DD725C83C4FFC35907ACC9,31701,18,21,3,109.44132,18.28833,1266
16880,129328,9E75E21F61DD725C83C4FFC35907ACC9,38871,22,23,1,109.44681,18.28625,1316
16881,129421,3272381C6A94F906EDCE0D12EAC755B5,30361,1,9,8,109.50347,18.24,1508
16882,129422,3272381C6A94F906EDCE0D12EAC755B5,31411,9,11,2,109.5016,18.23576,1507
16883,129423,3272381C6A94F906EDCE0D12EAC755B5,30711,12,13,1,109.50271,18.25347,1510
16884,129424,3272381C6A94F906EDCE0D12EAC755B5,38361,14,18,4,109.43667,18.29201,1267
16885,129425,3272381C6A94F906EDCE0D12EAC755B5,39191,19,20,1,109.51493,18.23472,1557
16886,129427,F284433312BF32177275D1EBBDCED548,31145,11,14,3,109.20431,18.30479,369
16890,129453,87ACF3C6ADE430D2B9DFB3C954E0C031,39183,15,16,1,109.55542,18.28208,1715
16891,129454,87ACF3C6ADE430D2B9DFB3C954E0C031,30854,16,18,2,109.56889,18.27076,1763
16895,129532,D20C070E72B2E72E0898232810D95CC4,31521,0,7,7,109.51458,18.22542,1555
16896,129533,D20C070E72B2E72E0898232810D95CC4,30851,9,12,3,109.5616,18.27396,1713
16897,129534,D20C070E72B2E72E0898232810D95CC4,31521,12,23,11,109.51458,18.22542,1555
16898,129543,AF125EFCC483E24833CBDDBC7248BDF1,31201,15,16,1,109.51042,18.23819,1558
16899,129544,AF125EFCC483E24833CBDDBC7248BDF1,30421,18,20,2,109.50021,18.25861,1511
16900,129545,AF125EFCC483E24833CBDDBC7248BDF1,31206,21,22,1,109.50819,18.23549,1507
16907,129644,C8501DFE42E6954852B7593EDA5D3099,30371,3,9,6,109.51,18.24771,1559
16908,129645,C8501DFE42E6954852B7593EDA5D3099,30084,11,12,1,109.50118,18.26972,1513
16909,129656,1D8B814EC83D52D7C5F3FED99C129EE0,38271,12,20,8,109.62632,18.23049,1956
16910,129657,1D8B814EC83D52D7C5F3FED99C129EE0,39183,22,23,1,109.55542,18.28208,1715
16911,129733,F04654AC056A2E82B670DFA8C627A5F2,60331,0,6,6,109.505,18.26507,1512
16912,129734,F04654AC056A2E82B670DFA8C627A5F2,31561,9,18,9,109.56792,18.28479,1765
16916,129747,AB8B051428E5E5EDACDABEECED7F5A35,31421,4,10,6,109.55382,18.22347,1705
16917,129748,AB8B051428E5E5EDACDABEECED7F5A35,31071,12,14,2,109.58257,18.28458,1815
16918,129749,AB8B051428E5E5EDACDABEECED7F5A35,31421,15,23,8,109.55382,18.22347,1705
16919,129825,93F22684CF6BFF2B98A28D1F2EA5D875,30711,13,15,2,109.50271,18.25347,1510
16920,129826,93F22684CF6BFF2B98A28D1F2EA5D875,31171,16,17,1,109.50938,18.24917,1559
16921,129827,93F22684CF6BFF2B98A28D1F2EA5D875,30711,18,19,1,109.50271,18.25347,1510
16922,129828,93F22684CF6BFF2B98A28D1F2EA5D875,31461,22,23,1,109.5091,18.25389,1510
16923,129835,6876B785B3B8E427F5B0017E0B0EC706,60472,0,7,7,109.46625,18.29542,1367
16924,129836,6876B785B3B8E427F5B0017E0B0EC706,31021,8,10,2,109.49021,18.27,1463
16925,129837,6876B785B3B8E427F5B0017E0B0EC706,30611,12,14,2,109.74958,18.40188,2485
16926,129838,6876B785B3B8E427F5B0017E0B0EC706,30211,18,20,2,109.49882,18.23931,1508
16927,129839,6876B785B3B8E427F5B0017E0B0EC706,38127,21,23,2,109.50833,18.27222,1513
16932,129862,EEC6B662D07BE95423A2DC77D2E69188,31071,12,14,2,109.58257,18.28458,1815
16933,129863,EEC6B662D07BE95423A2DC77D2E69188,30854,14,17,3,109.56889,18.27076,1763
16934,129980,452F0FF6BC36839041DCBEF2292D6E55,60661,0,8,8,109.548,18.2377,1657
16935,129981,452F0FF6BC36839041DCBEF2292D6E55,31421,9,10,1,109.55382,18.22347,1705
16936,129982,452F0FF6BC36839041DCBEF2292D6E55,30281,13,14,1,109.50597,18.27583,1514
16937,129983,452F0FF6BC36839041DCBEF2292D6E55,60381,15,17,2,109.5241,18.22458,1605
16938,129984,452F0FF6BC36839041DCBEF2292D6E55,31421,18,19,1,109.55382,18.22347,1705
16939,129985,452F0FF6BC36839041DCBEF2292D6E55,60661,22,23,1,109.548,18.2377,1657
16940,130026,AB43182259122294244C13D6FC66D4A1,30891,1,6,5,109.59431,18.28389,1865
16941,130027,AB43182259122294244C13D6FC66D4A1,30851,8,10,2,109.5616,18.27396,1713
16942,130028,AB43182259122294244C13D6FC66D4A1,31561,12,18,6,109.56792,18.28479,1765
16943,130029,AB43182259122294244C13D6FC66D4A1,30891,19,20,1,109.59431,18.28389,1865
16944,130030,AB43182259122294244C13D6FC66D4A1,60631,22,23,1,109.57778,18.27583,1814
16945,130064,4E5EF6715EF8F99087B1600B906A4C49,30131,0,16,16,109.6959,18.215,2254
16946,130065,4E5EF6715EF8F99087B1600B906A4C49,30861,18,19,1,109.52722,18.22743,1606
16947,130066,4E5EF6715EF8F99087B1600B906A4C49,30131,21,23,2,109.6959,18.215,2254
16951,130104,4BA42026831E7F4B42D17FDF4BDEE62E,31931,0,15,15,109.54771,18.29403,1667
16952,130105,4BA42026831E7F4B42D17FDF4BDEE62E,38127,19,20,1,109.50833,18.27222,1513
16957,130146,CDB754188DCCAD5F0F53165537428C84,39091,15,16,1,109.50097,18.25222,1510
16958,130147,CDB754188DCCAD5F0F53165537428C84,60411,21,23,2,109.32514,18.30854,869
16959,130156,D1A5E6081E70F748BFD3C6895B141C01,60411,0,9,9,109.32514,18.30854,869
16960,130157,D1A5E6081E70F748BFD3C6895B141C01,30661,11,15,4,109.37028,18.24361,1008
16961,130158,D1A5E6081E70F748BFD3C6895B141C01,60411,16,18,2,109.32514,18.30854,869
16962,130183,C58D0182BFC61ED113EE3B09763C30B2,38185,0,6,6,109.51333,18.27347,1563
16963,130184,C58D0182BFC61ED113EE3B09763C30B2,31461,7,8,1,109.5091,18.25389,1510
16964,130185,C58D0182BFC61ED113EE3B09763C30B2,38157,9,13,4,109.51483,18.26958,1563
16965,130186,C58D0182BFC61ED113EE3B09763C30B2,39181,14,15,1,109.55153,18.28035,1715
16966,130187,C58D0182BFC61ED113EE3B09763C30B2,60131,19,20,1,109.49819,18.24778,1509
16967,130188,C58D0182BFC61ED113EE3B09763C30B2,38185,21,23,2,109.51333,18.27347,1563
16968,130256,9352766CE000C006A9C46226806783DB,31071,0,6,6,109.58257,18.28458,1815
16969,130257,9352766CE000C006A9C46226806783DB,30131,8,13,5,109.6959,18.215,2254
16970,130258,9352766CE000C006A9C46226806783DB,31071,15,16,1,109.58257,18.28458,1815
16971,130259,9352766CE000C006A9C46226806783DB,31561,16,18,2,109.56792,18.28479,1765
16972,130326,86B0297E36D6ADB85661F97C0262CD46,30151,10,11,1,109.50986,18.25083,1560
16973,130327,86B0297E36D6ADB85661F97C0262CD46,31181,12,15,3,109.50382,18.24813,1509
16974,130328,86B0297E36D6ADB85661F97C0262CD46,60381,18,19,1,109.5241,18.22458,1605
16975,130352,3871846CD20CC7E3D76BFB165D15B326,60401,16,17,1,109.47444,18.27583,1414
16976,130353,3871846CD20CC7E3D76BFB165D15B326,30854,21,23,2,109.56889,18.27076,1763
16977,130367,C6C3BC01E542B810EF853FEEB6C81198,60361,0,18,18,109.51938,18.29681,1567
16978,130368,C6C3BC01E542B810EF853FEEB6C81198,31071,21,22,1,109.58257,18.28458,1815
16983,130399,20C15B76A1E0DF79D86EDEAC7BC3D7B7,31071,0,18,18,109.58257,18.28458,1815
16984,130400,20C15B76A1E0DF79D86EDEAC7BC3D7B7,31161,19,21,2,109.70229,18.31361,2270
16985,130417,39D4F14340B4650E084697607335F122,30161,1,9,8,109.50042,18.24389,1508
16986,130418,39D4F14340B4650E084697607335F122,39101,13,14,1,109.50132,18.24931,1509
16987,130419,39D4F14340B4650E084697607335F122,31931,18,20,2,109.54771,18.29403,1667
16988,130420,39D4F14340B4650E084697607335F122,39101,21,22,1,109.50132,18.24931,1509
16989,130450,C1C69C0EAD4ABEFD1467543102429D9B,39183,1,3,2,109.55542,18.28208,1715
16990,130451,C1C69C0EAD4ABEFD1467543102429D9B,30854,4,6,2,109.56889,18.27076,1763
16991,130452,C1C69C0EAD4ABEFD1467543102429D9B,39183,6,7,1,109.55542,18.28208,1715
16992,130453,C1C69C0EAD4ABEFD1467543102429D9B,60301,11,12,1,109.60715,18.30993,1919
16993,130454,C1C69C0EAD4ABEFD1467543102429D9B,30281,14,15,1,109.50597,18.27583,1514
16994,130455,C1C69C0EAD4ABEFD1467543102429D9B,39183,16,18,2,109.55542,18.28208,1715
16995,130482,63B5E489F3503F8EC6E40A38F9D2117C,31931,2,4,2,109.54771,18.29403,1667
16996,130483,63B5E489F3503F8EC6E40A38F9D2117C,60241,6,7,1,109.53319,18.28667,1616
16997,130484,63B5E489F3503F8EC6E40A38F9D2117C,60361,8,10,2,109.51938,18.29681,1567
16998,130485,63B5E489F3503F8EC6E40A38F9D2117C,31951,13,14,1,109.52174,18.30299,1568
16999,130486,63B5E489F3503F8EC6E40A38F9D2117C,60171,17,19,2,109.51292,18.30694,1569
17000,130513,FAC035CAF00431CACD74AF53D18C4996,30111,0,6,6,109.47583,18.30542,1419
17001,130514,FAC035CAF00431CACD74AF53D18C4996,30764,7,9,2,109.45806,18.29486,1367
17002,130515,FAC035CAF00431CACD74AF53D18C4996,30111,12,13,1,109.47583,18.30542,1419
17003,130516,FAC035CAF00431CACD74AF53D18C4996,30764,14,18,4,109.45806,18.29486,1367
17004,130517,FAC035CAF00431CACD74AF53D18C4996,60011,19,20,1,109.48965,18.30222,1468
17005,130518,FAC035CAF00431CACD74AF53D18C4996,30111,20,22,2,109.47583,18.30542,1419
17006,130555,7D72A79F2F964580140FF5C346A60898,60614,0,6,6,109.48799,18.29521,1467
17007,130556,7D72A79F2F964580140FF5C346A60898,30941,9,11,2,109.5559,18.33938,1724
17008,130557,7D72A79F2F964580140FF5C346A60898,38951,15,18,3,109.48097,18.28868,1416
17009,130558,7D72A79F2F964580140FF5C346A60898,60614,19,20,1,109.48799,18.29521,1467
17010,130566,CFFDD1BF3134B9FDD71614F40E1DE0FD,31561,1,3,2,109.56792,18.28479,1765
17011,130567,CFFDD1BF3134B9FDD71614F40E1DE0FD,31071,5,9,4,109.58257,18.28458,1815
17012,130568,CFFDD1BF3134B9FDD71614F40E1DE0FD,30851,10,11,1,109.5616,18.27396,1713
17013,130569,CFFDD1BF3134B9FDD71614F40E1DE0FD,31071,12,15,3,109.58257,18.28458,1815
17014,130570,CFFDD1BF3134B9FDD71614F40E1DE0FD,30851,18,19,1,109.5616,18.27396,1713
17015,130571,CFFDD1BF3134B9FDD71614F40E1DE0FD,31071,21,23,2,109.58257,18.28458,1815
17022,130641,9EF6440DA421994ED152A57FAE59B45B,31261,0,6,6,109.51174,18.2466,1559
17023,130642,9EF6440DA421994ED152A57FAE59B45B,38291,6,10,4,109.51618,18.24313,1558
17024,130643,9EF6440DA421994ED152A57FAE59B45B,30571,11,13,2,109.50243,18.21861,1504
17025,130644,9EF6440DA421994ED152A57FAE59B45B,30051,13,14,1,109.48917,18.21215,1453
17026,130645,9EF6440DA421994ED152A57FAE59B45B,60231,14,15,1,109.49903,18.21972,1504
17027,130646,9EF6440DA421994ED152A57FAE59B45B,38911,18,19,1,109.51674,18.24965,1559
17028,130647,9EF6440DA421994ED152A57FAE59B45B,31261,20,23,3,109.51174,18.2466,1559
17029,130658,A515C2BA2B0AE21CADC42FF4E7FC0007,39181,0,6,6,109.55153,18.28035,1715
17030,130659,A515C2BA2B0AE21CADC42FF4E7FC0007,39181,10,23,13,109.55153,18.28035,1715
17031,130663,FE95B3A32EFBC2838F293DF38F55FDD1,39183,15,16,1,109.55542,18.28208,1715
17032,130664,FE95B3A32EFBC2838F293DF38F55FDD1,30854,17,18,1,109.56889,18.27076,1763
17033,130688,6C0D826A77A1C04C0B62713EC9E3496E,38141,0,10,10,109.39479,18.2916,1116
17034,130689,6C0D826A77A1C04C0B62713EC9E3496E,31471,12,14,2,109.34583,18.29563,917
17035,130690,6C0D826A77A1C04C0B62713EC9E3496E,30361,16,18,2,109.50347,18.24,1508
17036,130691,6C0D826A77A1C04C0B62713EC9E3496E,38325,21,23,2,109.39792,18.2909,1116
17037,130794,30CE72A519D49881F23B8123486E3A02,31471,17,19,2,109.34583,18.29563,917
17038,130795,30CE72A519D49881F23B8123486E3A02,60411,20,21,1,109.32514,18.30854,869
17039,130796,30CE72A519D49881F23B8123486E3A02,60054,21,22,1,109.3016,18.31229,770
17040,130821,AAAED401E69F3FED1BCF91F4DEF17254,31471,15,17,2,109.34583,18.29563,917
17041,130822,AAAED401E69F3FED1BCF91F4DEF17254,31841,21,23,2,109.73201,18.33382,2373
17048,130895,798BF3B08F72A16A6DEAAA235F1899BB,61011,8,23,15,109.60653,18.19076,1900
17049,130924,4BD5B88B6C62E9E50471E319F2898EED,31081,0,7,7,109.44639,18.30181,1318
17050,130925,4BD5B88B6C62E9E50471E319F2898EED,31301,8,10,2,109.14493,18.31222,170
17051,130926,4BD5B88B6C62E9E50471E319F2898EED,31471,12,14,2,109.34583,18.29563,917
17056,130986,A83BF34FB3DF79FCF76C955C7C1B2AAC,31421,15,16,1,109.55382,18.22347,1705
17057,130987,A83BF34FB3DF79FCF76C955C7C1B2AAC,30421,16,18,2,109.50021,18.25861,1511
17058,130988,A83BF34FB3DF79FCF76C955C7C1B2AAC,38171,19,20,1,109.50799,18.28139,1515
17059,130989,A83BF34FB3DF79FCF76C955C7C1B2AAC,60381,20,23,3,109.5241,18.22458,1605
17060,131042,FEF1B208BFBEDDE7B3E7A77BB07513A4,30341,14,23,9,109.3625,18.29167,966
17064,131046,D2ADB4C0F26D2E7501D600522A8254AC,60551,4,8,4,109.42722,18.30111,1218
17065,131047,D2ADB4C0F26D2E7501D600522A8254AC,38361,8,12,4,109.43667,18.29201,1267
17066,131048,D2ADB4C0F26D2E7501D600522A8254AC,60551,13,14,1,109.42722,18.30111,1218
17067,131049,D2ADB4C0F26D2E7501D600522A8254AC,30361,15,18,3,109.50347,18.24,1508
17068,131050,D2ADB4C0F26D2E7501D600522A8254AC,38361,21,23,2,109.43667,18.29201,1267
17075,131172,7F632B4875B2736225CD6D350CD25670,30854,15,18,3,109.56889,18.27076,1763
17076,131173,7F632B4875B2736225CD6D350CD25670,38251,21,22,1,109.49618,18.25493,1510
17077,131186,4552AE0C0FB78BA3063EBA5C903C87F0,31421,0,6,6,109.55382,18.22347,1705
17082,131214,51D8741123978D021DF7DCEBAD567A54,30711,0,8,8,109.50271,18.25347,1510
17083,131215,51D8741123978D021DF7DCEBAD567A54,38251,8,9,1,109.49618,18.25493,1510
17084,131242,DD045376657AFD220DDDD1E2A8CFE636,31861,16,20,4,109.49042,18.27549,1464
17085,131275,59F29435D748531F416A4F1636997ECF,60381,15,16,1,109.5241,18.22458,1605
17086,131276,59F29435D748531F416A4F1636997ECF,31041,19,23,4,109.50278,18.23701,1507
17087,131280,FBC5739CB4FF6DA3B4E28BEEAB3F9194,60221,0,9,9,109.52569,18.29188,1616
17088,131281,FBC5739CB4FF6DA3B4E28BEEAB3F9194,38251,11,12,1,109.49618,18.25493,1510
17089,131282,FBC5739CB4FF6DA3B4E28BEEAB3F9194,30711,12,13,1,109.50271,18.25347,1510
17090,131283,FBC5739CB4FF6DA3B4E28BEEAB3F9194,30711,14,15,1,109.50271,18.25347,1510
17091,131284,FBC5739CB4FF6DA3B4E28BEEAB3F9194,30771,16,17,1,109.49938,18.26042,1511
17092,131285,FBC5739CB4FF6DA3B4E28BEEAB3F9194,60221,21,23,2,109.52569,18.29188,1616
17093,131286,2D0506173E3FD672D1B56E46B7843F5D,38754,14,16,2,109.74667,18.37382,2430
17094,131287,2D0506173E3FD672D1B56E46B7843F5D,30191,21,22,1,109.50361,18.22701,1506
17095,131291,68DBE0B52FD0AB95F1DD47068FD7847F,60311,0,8,8,109.52097,18.24319,1558
17096,131292,68DBE0B52FD0AB95F1DD47068FD7847F,38291,8,10,2,109.51618,18.24313,1558
17097,131293,68DBE0B52FD0AB95F1DD47068FD7847F,60311,11,12,1,109.52097,18.24319,1558
17098,131294,68DBE0B52FD0AB95F1DD47068FD7847F,30181,13,15,2,109.51597,18.23313,1557
17099,131295,68DBE0B52FD0AB95F1DD47068FD7847F,60311,18,22,4,109.52097,18.24319,1558
17100,131319,A8ABE4987042D12DD458C81CFD9663F5,30711,17,18,1,109.50271,18.25347,1510
17101,131320,A8ABE4987042D12DD458C81CFD9663F5,38127,18,23,5,109.50833,18.27222,1513
17102,131331,9955D8331F1866B4F8C7C7981EBD1A88,31206,0,17,17,109.50819,18.23549,1507
17103,131332,9955D8331F1866B4F8C7C7981EBD1A88,30181,18,19,1,109.51597,18.23313,1557
17104,131337,B54CA9FDA6F9A4F01A3EC25BB60F0B4A,30731,0,9,9,109.50944,18.22306,1555
17105,131338,B54CA9FDA6F9A4F01A3EC25BB60F0B4A,31521,9,11,2,109.51458,18.22542,1555
17106,131339,B54CA9FDA6F9A4F01A3EC25BB60F0B4A,30731,13,14,1,109.50944,18.22306,1555
17107,131340,B54CA9FDA6F9A4F01A3EC25BB60F0B4A,31521,15,16,1,109.51458,18.22542,1555
17108,131341,B54CA9FDA6F9A4F01A3EC25BB60F0B4A,30731,20,22,2,109.50944,18.22306,1555
17109,131355,74206C862E4BA6236E7F7978D63D1D7D,60631,4,7,3,109.57778,18.27583,1814
17110,131356,74206C862E4BA6236E7F7978D63D1D7D,30854,7,8,1,109.56889,18.27076,1763
17111,131374,5F458C24FFFBC33D1CB0F07B19ED30E6,38017,4,5,1,109.49729,18.21424,1504
17112,131375,5F458C24FFFBC33D1CB0F07B19ED30E6,30051,7,8,1,109.48917,18.21215,1453
17113,131376,5F458C24FFFBC33D1CB0F07B19ED30E6,31521,12,14,2,109.51458,18.22542,1555
17114,131377,5F458C24FFFBC33D1CB0F07B19ED30E6,30571,16,18,2,109.50243,18.21861,1504
17115,131378,5F458C24FFFBC33D1CB0F07B19ED30E6,30854,19,21,2,109.56889,18.27076,1763
17116,131396,E58E5EFF0A1D7ADABE8F5BBEE665ED0D,30861,19,21,2,109.52722,18.22743,1606
17117,131397,E58E5EFF0A1D7ADABE8F5BBEE665ED0D,60641,21,23,2,109.53854,18.2359,1657
17118,131406,DECB7B3FC95BFA8620EFD8D9DE328252,31945,9,19,10,109.58021,18.29403,1817
17119,131407,DECB7B3FC95BFA8620EFD8D9DE328252,30854,19,23,4,109.56889,18.27076,1763
17120,131415,7E95AEA91A37473FF71C625BDD54FD92,60361,14,15,1,109.51938,18.29681,1567
17121,131416,7E95AEA91A37473FF71C625BDD54FD92,60226,19,20,1,109.5175,18.28778,1566
17129,131488,407AE188132462D6A2BFC7C6B4E99CAE,38251,1,11,10,109.49618,18.25493,1510
17130,131489,407AE188132462D6A2BFC7C6B4E99CAE,31101,13,16,3,109.65389,18.23403,2057
17131,131490,407AE188132462D6A2BFC7C6B4E99CAE,38281,17,19,2,109.6525,18.23403,2057
17132,131491,407AE188132462D6A2BFC7C6B4E99CAE,31101,21,23,2,109.65389,18.23403,2057
17136,131518,FE6376AB53578CB7B343C13E491275A1,30771,6,7,1,109.49938,18.26042,1511
17137,131519,FE6376AB53578CB7B343C13E491275A1,39154,11,13,2,109.50201,18.25681,1511
17138,131520,FE6376AB53578CB7B343C13E491275A1,30201,14,19,5,109.4909,18.26465,1462
17139,131558,222E0B6922623CE9FBB280F81068D40E,30854,15,19,4,109.56889,18.27076,1763
17140,131559,222E0B6922623CE9FBB280F81068D40E,30081,19,20,1,109.50243,18.26632,1512
17141,131584,46D10B971C10D2856504DC61068F66E7,31091,13,18,5,109.41201,18.31222,1170
17142,131585,46D10B971C10D2856504DC61068F66E7,30921,19,21,2,109.53903,18.29451,1667
17143,131586,46D10B971C10D2856504DC61068F66E7,60221,21,23,2,109.52569,18.29188,1616
17144,131601,8CA8213586CAC00347DCD29330308F27,30571,18,19,1,109.50243,18.21861,1504
17145,131602,8CA8213586CAC00347DCD29330308F27,31031,20,21,1,109.49979,18.25382,1510
17146,131620,7C68E1F4B8B2F3CBBD5427BF66BF9C2E,30891,0,1,1,109.59431,18.28389,1865
17147,131621,7C68E1F4B8B2F3CBBD5427BF66BF9C2E,30854,4,7,3,109.56889,18.27076,1763
17148,131622,7C68E1F4B8B2F3CBBD5427BF66BF9C2E,31571,8,10,2,109.61563,18.23326,1957
17149,131623,7C68E1F4B8B2F3CBBD5427BF66BF9C2E,38054,11,13,2,109.63479,18.23097,2006
17154,131636,5403ECE41AD9921A5DEF63FF6DE6A9D1,30854,0,1,1,109.56889,18.27076,1763
17155,131637,5403ECE41AD9921A5DEF63FF6DE6A9D1,31071,2,9,7,109.58257,18.28458,1815
17156,131638,5403ECE41AD9921A5DEF63FF6DE6A9D1,30854,10,18,8,109.56889,18.27076,1763
17157,131639,5403ECE41AD9921A5DEF63FF6DE6A9D1,31071,20,21,1,109.58257,18.28458,1815
17158,131640,5403ECE41AD9921A5DEF63FF6DE6A9D1,30854,22,23,1,109.56889,18.27076,1763
17159,131655,15195C578D4A8081B069C4B518039EFC,60371,15,17,2,109.53063,18.30056,1618
17160,131656,15195C578D4A8081B069C4B518039EFC,60221,18,19,1,109.52569,18.29188,1616
17161,131657,15195C578D4A8081B069C4B518039EFC,31031,20,23,3,109.49979,18.25382,1510
17162,131696,C97A61E87ADF22CB0CED7FFED3A35BC3,30951,15,18,3,109.56208,18.25667,1761
17166,131735,66F845C21313F6E347B30C7E8BF089D2,60621,0,6,6,109.48354,18.27451,1464
17167,131736,66F845C21313F6E347B30C7E8BF089D2,60501,7,9,2,109.48701,18.29021,1466
17168,131737,66F845C21313F6E347B30C7E8BF089D2,30371,13,14,1,109.51,18.24771,1559
17169,131738,66F845C21313F6E347B30C7E8BF089D2,30371,15,18,3,109.51,18.24771,1559
17170,131739,66F845C21313F6E347B30C7E8BF089D2,30084,20,21,1,109.50118,18.26972,1513
17171,131740,66F845C21313F6E347B30C7E8BF089D2,31531,22,23,1,109.49583,18.25972,1461
17172,131741,6784729F492E40D40F1F209931B40EB9,31031,20,21,1,109.49979,18.25382,1510
17173,131742,6784729F492E40D40F1F209931B40EB9,30351,21,23,2,109.41701,18.29292,1217
17174,131845,9316856FC9B7BE008DD2CC2209708EA4,30131,0,7,7,109.6959,18.215,2254
17175,131846,9316856FC9B7BE008DD2CC2209708EA4,30121,9,11,2,109.52861,18.27222,1613
17176,131847,9316856FC9B7BE008DD2CC2209708EA4,30161,12,13,1,109.50042,18.24389,1508
17177,131848,9316856FC9B7BE008DD2CC2209708EA4,30121,15,18,3,109.52861,18.27222,1613
17178,131849,9316856FC9B7BE008DD2CC2209708EA4,30131,19,23,4,109.6959,18.215,2254
17179,131927,002C7A8161A15E55D29FBC7F9B584A32,31304,5,6,1,109.15903,18.32854,223
17180,131929,002C7A8161A15E55D29FBC7F9B584A32,31304,13,15,2,109.15903,18.32854,223
17188,131966,39E5C7923C3234177BB4A3BFF8D867ED,30361,0,11,11,109.50347,18.24,1508
17189,131967,39E5C7923C3234177BB4A3BFF8D867ED,60054,13,15,2,109.3016,18.31229,770
17190,131968,39E5C7923C3234177BB4A3BFF8D867ED,30361,18,23,5,109.50347,18.24,1508
17195,132085,1CE7F29C06B3E8D5875212BD6805BDFB,31071,0,7,7,109.58257,18.28458,1815
17196,132086,1CE7F29C06B3E8D5875212BD6805BDFB,30161,11,16,5,109.50042,18.24389,1508
17200,132170,C0A84E293FFFD544F9A2EE258D4D51EC,31461,1,5,4,109.5091,18.25389,1510
17201,132171,C0A84E293FFFD544F9A2EE258D4D51EC,39154,6,10,4,109.50201,18.25681,1511
17202,132172,C0A84E293FFFD544F9A2EE258D4D51EC,31471,11,13,2,109.34583,18.29563,917
17203,132173,C0A84E293FFFD544F9A2EE258D4D51EC,31471,13,14,1,109.34583,18.29563,917
17204,132199,302C193EE9901423C2412C2BB087FCC7,30351,12,14,2,109.41701,18.29292,1217
17205,132200,302C193EE9901423C2412C2BB087FCC7,31091,15,20,5,109.41201,18.31222,1170
17206,132201,302C193EE9901423C2412C2BB087FCC7,31231,20,21,1,109.42597,18.29292,1217
17207,132202,302C193EE9901423C2412C2BB087FCC7,30351,22,23,1,109.41701,18.29292,1217
17211,132243,8877F0646282478FC034CF7A2CC8A7FE,31521,0,2,2,109.51458,18.22542,1555
17212,132244,8877F0646282478FC034CF7A2CC8A7FE,60291,2,6,4,109.50826,18.24639,1509
17213,132253,DADE85815C8ECCC9738CA3D0741CB1B3,31471,14,17,3,109.34583,18.29563,917
17214,132254,DADE85815C8ECCC9738CA3D0741CB1B3,60381,18,20,2,109.5241,18.22458,1605
17215,132255,DADE85815C8ECCC9738CA3D0741CB1B3,31421,21,22,1,109.55382,18.22347,1705
17216,132256,CE045EEE305A10957A4EB0B7223F0776,31031,0,7,7,109.49979,18.25382,1510
17217,132257,CE045EEE305A10957A4EB0B7223F0776,31781,9,10,1,109.19847,18.2975,367
17218,132258,CE045EEE305A10957A4EB0B7223F0776,31471,12,14,2,109.34583,18.29563,917
17222,132290,887B4CB1328C20D61945E5BC833B406E,30071,0,6,6,109.52819,18.30472,1619
17223,132291,887B4CB1328C20D61945E5BC833B406E,60371,6,13,7,109.53063,18.30056,1618
17224,132292,887B4CB1328C20D61945E5BC833B406E,30031,14,15,1,109.53681,18.33313,1673
17225,132293,887B4CB1328C20D61945E5BC833B406E,60371,18,19,1,109.53063,18.30056,1618
17226,132294,887B4CB1328C20D61945E5BC833B406E,60221,19,23,4,109.52569,18.29188,1616
17233,132462,CBEABB1E72916DEDB4C30D20E0746E11,30354,0,8,8,109.42813,18.29076,1216
17234,132463,CBEABB1E72916DEDB4C30D20E0746E11,31781,10,13,3,109.19847,18.2975,367
17235,132464,CBEABB1E72916DEDB4C30D20E0746E11,30354,17,23,6,109.42813,18.29076,1216
17240,132565,355E9BABB06A4EA2083D2B98B74A3F80,39321,13,14,1,109.529,18.2167,1604
17241,132566,355E9BABB06A4EA2083D2B98B74A3F80,39091,15,17,2,109.50097,18.25222,1510
17242,132567,355E9BABB06A4EA2083D2B98B74A3F80,30891,18,20,2,109.59431,18.28389,1865
17243,132574,8621CFDF1B89A83351494618C53D033F,39181,0,8,8,109.55153,18.28035,1715
17244,132575,8621CFDF1B89A83351494618C53D033F,31071,9,10,1,109.58257,18.28458,1815
17245,132576,8621CFDF1B89A83351494618C53D033F,39181,11,14,3,109.55153,18.28035,1715
17246,132577,8621CFDF1B89A83351494618C53D033F,31071,14,15,1,109.58257,18.28458,1815
17247,132578,8621CFDF1B89A83351494618C53D033F,39181,15,20,5,109.55153,18.28035,1715
17248,132579,8621CFDF1B89A83351494618C53D033F,39181,20,22,2,109.55153,18.28035,1715
17249,132664,BE7763F8096EB5A037146E1CC4190538,30854,1,2,1,109.56889,18.27076,1763
17250,132665,BE7763F8096EB5A037146E1CC4190538,30324,7,16,9,109.50326,18.29257,1517
17251,132712,FD0AE67B2089C3E18D5A20F1644632E4,31437,0,8,8,109.45049,18.29146,1316
17252,132713,FD0AE67B2089C3E18D5A20F1644632E4,31145,10,12,2,109.20431,18.30479,369
17253,132714,FD0AE67B2089C3E18D5A20F1644632E4,60054,14,16,2,109.3016,18.31229,770
17254,132715,FD0AE67B2089C3E18D5A20F1644632E4,31437,20,23,3,109.45049,18.29146,1316
17263,132876,13C882817D5EF3329D8612AEE7E0F34D,31864,0,11,11,109.49014,18.28333,1465
17264,132877,13C882817D5EF3329D8612AEE7E0F34D,30961,14,15,1,109.74042,18.37903,2431
17265,132878,13C882817D5EF3329D8612AEE7E0F34D,31091,19,20,1,109.41201,18.31222,1170
17266,132905,878FC5EBB1B28FAABA6E6BFD01664318,30251,0,17,17,109.50611,18.26653,1512
17267,132906,878FC5EBB1B28FAABA6E6BFD01664318,31031,18,19,1,109.49979,18.25382,1510
17268,132942,3C6C31F30579C628F9EDFADEE409AE9F,60671,14,16,2,109.52979,18.31757,1621
17269,132943,3C6C31F30579C628F9EDFADEE409AE9F,30921,17,19,2,109.53903,18.29451,1667
17270,132944,3C6C31F30579C628F9EDFADEE409AE9F,30101,19,22,3,109.57299,18.33333,1773
17274,133073,F83D748D9AC433CCB24E3050C5762E35,30661,0,5,5,109.37028,18.24361,1008
17275,133074,F83D748D9AC433CCB24E3050C5762E35,38023,7,9,2,109.37132,18.28993,1016
17276,133075,F83D748D9AC433CCB24E3050C5762E35,31471,10,11,1,109.34583,18.29563,917
17277,133076,F83D748D9AC433CCB24E3050C5762E35,31471,12,14,2,109.34583,18.29563,917
17278,133077,F83D748D9AC433CCB24E3050C5762E35,31101,16,23,7,109.65389,18.23403,2057
17279,133096,C8A5539982743C3D86E28F8FF2DA3472,39183,2,8,6,109.55542,18.28208,1715
17280,133097,C8A5539982743C3D86E28F8FF2DA3472,30951,9,17,8,109.56208,18.25667,1761
17281,133098,C8A5539982743C3D86E28F8FF2DA3472,31421,17,18,1,109.55382,18.22347,1705
17282,133099,C8A5539982743C3D86E28F8FF2DA3472,30951,21,23,2,109.56208,18.25667,1761
17283,133130,64E97CAFCF024F6A9B1AA7827CD1E4FF,31206,17,18,1,109.50819,18.23549,1507
17284,133131,64E97CAFCF024F6A9B1AA7827CD1E4FF,30671,21,22,1,109.43611,18.30139,1268
17285,133170,5264833F0013AE6B294396000613EF89,31411,19,20,1,109.5016,18.23576,1507
17286,133171,5264833F0013AE6B294396000613EF89,31461,21,23,2,109.5091,18.25389,1510
17287,133178,AE6DC7ACB81DB5F351E45AC25E5F5A3B,31201,0,2,2,109.51042,18.23819,1558
17288,133179,AE6DC7ACB81DB5F351E45AC25E5F5A3B,30161,2,4,2,109.50042,18.24389,1508
17289,133180,AE6DC7ACB81DB5F351E45AC25E5F5A3B,38297,5,10,5,109.52576,18.24965,1609
17290,133181,AE6DC7ACB81DB5F351E45AC25E5F5A3B,60281,10,11,1,109.51743,18.25924,1561
17291,133182,AE6DC7ACB81DB5F351E45AC25E5F5A3B,38297,12,14,2,109.52576,18.24965,1609
17292,133207,DE85A2F9432633114A7B9A1B323B8AE9,30051,0,6,6,109.48917,18.21215,1453
17293,133208,DE85A2F9432633114A7B9A1B323B8AE9,30571,7,8,1,109.50243,18.21861,1504
17294,133209,DE85A2F9432633114A7B9A1B323B8AE9,30051,12,15,3,109.48917,18.21215,1453
17295,133210,DE85A2F9432633114A7B9A1B323B8AE9,60231,16,17,1,109.49903,18.21972,1504
17296,133211,DE85A2F9432633114A7B9A1B323B8AE9,30051,17,23,6,109.48917,18.21215,1453
17305,133298,11ACC233938E27960515F82E3D9CDE84,39321,0,7,7,109.529,18.2167,1604
17306,133299,11ACC233938E27960515F82E3D9CDE84,30391,9,11,2,109.4975,18.27118,1513
17307,133300,11ACC233938E27960515F82E3D9CDE84,30861,11,12,1,109.52722,18.22743,1606
17308,133301,11ACC233938E27960515F82E3D9CDE84,39321,12,16,4,109.529,18.2167,1604
17309,133302,11ACC233938E27960515F82E3D9CDE84,38127,17,21,4,109.50833,18.27222,1513
17313,133328,4F6A6D6BDB1CA40A8AF45B87F3BE9E9C,31881,1,7,6,109.7441,18.40785,2436
17314,133329,4F6A6D6BDB1CA40A8AF45B87F3BE9E9C,30791,7,8,1,109.72333,18.40889,2386
17315,133330,4F6A6D6BDB1CA40A8AF45B87F3BE9E9C,31841,13,14,1,109.73201,18.33382,2373
17319,133364,0312B43ACF9ED1D8304E325E851AEE29,31561,7,17,10,109.56792,18.28479,1765
17320,133365,0312B43ACF9ED1D8304E325E851AEE29,30851,17,20,3,109.5616,18.27396,1713
17321,133366,0312B43ACF9ED1D8304E325E851AEE29,31561,20,21,1,109.56792,18.28479,1765
17325,133406,B55959B64746A18ECF5077B5F7359221,39183,15,17,2,109.55542,18.28208,1715
17326,133407,B55959B64746A18ECF5077B5F7359221,30854,18,22,4,109.56889,18.27076,1763
17327,133465,5CC1762A5E087A77C8027D2CC6A16A88,30071,0,8,8,109.52819,18.30472,1619
17328,133466,5CC1762A5E087A77C8027D2CC6A16A88,38991,11,23,12,109.52681,18.30368,1618
17333,133635,0C8D15C0488D521680F0DE3A28CFE111,31811,0,7,7,109.54201,18.31806,1671
17334,133636,0C8D15C0488D521680F0DE3A28CFE111,30701,7,9,2,109.59313,18.32007,1871
17335,133637,0C8D15C0488D521680F0DE3A28CFE111,31811,10,11,1,109.54201,18.31806,1671
17336,133638,0C8D15C0488D521680F0DE3A28CFE111,30701,12,16,4,109.59313,18.32007,1871
17337,133639,0C8D15C0488D521680F0DE3A28CFE111,31811,17,21,4,109.54201,18.31806,1671
17338,133640,0C8D15C0488D521680F0DE3A28CFE111,30701,21,23,2,109.59313,18.32007,1871
17343,133765,5A7A3D5F722F0EB2695C45BF16BBC483,38157,0,10,10,109.51483,18.26958,1563
17344,133766,5A7A3D5F722F0EB2695C45BF16BBC483,30421,10,12,2,109.50021,18.25861,1511
17345,133767,5A7A3D5F722F0EB2695C45BF16BBC483,60291,12,13,1,109.50826,18.24639,1509
17346,133768,5A7A3D5F722F0EB2695C45BF16BBC483,38157,15,18,3,109.51483,18.26958,1563
17347,133769,5A7A3D5F722F0EB2695C45BF16BBC483,39111,21,22,1,109.5191,18.22597,1555
17348,133795,35011D65DB8F346A960E649EB3FC56D5,30181,0,8,8,109.51597,18.23313,1557
17349,133797,35011D65DB8F346A960E649EB3FC56D5,31311,13,15,2,109.72299,18.27438,2364
17350,133798,35011D65DB8F346A960E649EB3FC56D5,31521,16,17,1,109.51458,18.22542,1555
17351,133799,35011D65DB8F346A960E649EB3FC56D5,30181,18,22,4,109.51597,18.23313,1557
17356,133944,B3E95D5FEFF26E73B4387678C52BCA45,38171,19,23,4,109.50799,18.28139,1515
17357,133964,6AF6E3AFD18EC04099B3351F858D9C1A,30421,0,6,6,109.50021,18.25861,1511
17358,133965,6AF6E3AFD18EC04099B3351F858D9C1A,33051,10,12,2,109.6475,18.46618,2096
17359,133966,6AF6E3AFD18EC04099B3351F858D9C1A,38251,14,15,1,109.49618,18.25493,1510
17360,133967,6AF6E3AFD18EC04099B3351F858D9C1A,30421,16,18,2,109.50021,18.25861,1511
17365,134026,C93386A9D86FE22A1FD4E5116045DD8D,31561,0,3,3,109.56792,18.28479,1765
17366,134027,C93386A9D86FE22A1FD4E5116045DD8D,39183,7,9,2,109.55542,18.28208,1715
17367,134028,C93386A9D86FE22A1FD4E5116045DD8D,31561,10,12,2,109.56792,18.28479,1765
17368,134029,C93386A9D86FE22A1FD4E5116045DD8D,39183,15,18,3,109.55542,18.28208,1715
17369,134030,C93386A9D86FE22A1FD4E5116045DD8D,31561,21,23,2,109.56792,18.28479,1765
17370,134074,386A993804AE7686717510E63DEFF753,31841,0,8,8,109.73201,18.33382,2373
17371,134075,386A993804AE7686717510E63DEFF753,33481,10,12,2,109.67278,18.41278,2187
17375,134098,6587551DA47309E484D1302521C8D417,60631,0,7,7,109.57778,18.27583,1814
17376,134099,6587551DA47309E484D1302521C8D417,38275,8,20,12,109.62875,18.22938,2006
17377,134100,6587551DA47309E484D1302521C8D417,30854,20,22,2,109.56889,18.27076,1763
17382,134139,B207231D4D7F99627BB65117B9554A5E,60381,0,4,4,109.5241,18.22458,1605
17383,134140,B207231D4D7F99627BB65117B9554A5E,31521,8,9,1,109.51458,18.22542,1555
17384,134141,B207231D4D7F99627BB65117B9554A5E,31781,12,14,2,109.19847,18.2975,367
17385,134151,3977578BE56276DA0700B04B81DC1356,31561,0,11,11,109.56792,18.28479,1765
17386,134152,3977578BE56276DA0700B04B81DC1356,30161,14,15,1,109.50042,18.24389,1508
17387,134153,3977578BE56276DA0700B04B81DC1356,31561,17,21,4,109.56792,18.28479,1765
17388,134159,E5DA2FC779B1E8E31A367E849D1BF38A,38127,0,5,5,109.50833,18.27222,1513
17389,134160,E5DA2FC779B1E8E31A367E849D1BF38A,31461,8,9,1,109.5091,18.25389,1510
17390,134161,E5DA2FC779B1E8E31A367E849D1BF38A,30511,11,15,4,109.51069,18.24208,1558
17391,134162,E5DA2FC779B1E8E31A367E849D1BF38A,38127,16,19,3,109.50833,18.27222,1513
17392,134163,E5DA2FC779B1E8E31A367E849D1BF38A,31071,20,22,2,109.58257,18.28458,1815
17393,134164,E5DA2FC779B1E8E31A367E849D1BF38A,30854,22,23,1,109.56889,18.27076,1763
17394,134238,F203E94EEA8913AD49AA02E37C0DFB8F,30821,13,14,1,109.43681,18.33639,1274
17395,134239,F203E94EEA8913AD49AA02E37C0DFB8F,60041,17,20,3,109.39889,18.31944,1121
17396,134255,AD608A919061B1C684914F8654FB2493,30241,8,9,1,109.26174,18.3275,622
17397,134256,AD608A919061B1C684914F8654FB2493,30651,14,15,1,109.42611,18.385,1232
17398,134257,D37BF241A4A35F0F341582CAF9EF0DD2,30161,16,18,2,109.50042,18.24389,1508
17399,134258,D37BF241A4A35F0F341582CAF9EF0DD2,39101,19,23,4,109.50132,18.24931,1509
17400,134316,9111D45CF0ACFF1F78F6B2A96D11CE9D,31351,0,7,7,109.4959,18.28417,1465
17401,134317,9111D45CF0ACFF1F78F6B2A96D11CE9D,30741,8,10,2,109.49833,18.28681,1516
17402,134326,0E129C09250C0D46273B4BD7E5225556,60441,16,17,1,109.46792,18.28604,1366
17403,134327,0E129C09250C0D46273B4BD7E5225556,60201,18,20,2,109.5041,18.2509,1510
17404,134328,0E129C09250C0D46273B4BD7E5225556,60281,21,22,1,109.51743,18.25924,1561
17405,134329,0E129C09250C0D46273B4BD7E5225556,30151,22,23,1,109.50986,18.25083,1560
17406,134336,221D8AFDF93613700F6F08A099FC19BF,60201,0,8,8,109.5041,18.2509,1510
17407,134337,221D8AFDF93613700F6F08A099FC19BF,60301,9,10,1,109.60715,18.30993,1919
17408,134338,221D8AFDF93613700F6F08A099FC19BF,38754,10,12,2,109.74667,18.37382,2430
17409,134339,221D8AFDF93613700F6F08A099FC19BF,31461,14,17,3,109.5091,18.25389,1510
17410,134340,221D8AFDF93613700F6F08A099FC19BF,31391,18,19,1,109.50382,18.24285,1508
17411,134341,221D8AFDF93613700F6F08A099FC19BF,31461,21,23,2,109.5091,18.25389,1510
17412,134397,56C8C781972E8BFAF8A768A19AD7F590,38127,0,7,7,109.50833,18.27222,1513
17413,134399,56C8C781972E8BFAF8A768A19AD7F590,30281,19,22,3,109.50597,18.27583,1514
17414,134404,44CB5F545D2E3587ACF209AB2414C1A1,31071,0,3,3,109.58257,18.28458,1815
17415,134405,44CB5F545D2E3587ACF209AB2414C1A1,30854,4,6,2,109.56889,18.27076,1763
17416,134406,44CB5F545D2E3587ACF209AB2414C1A1,31071,6,8,2,109.58257,18.28458,1815
17417,134407,44CB5F545D2E3587ACF209AB2414C1A1,30854,15,16,1,109.56889,18.27076,1763
17418,134408,44CB5F545D2E3587ACF209AB2414C1A1,31071,17,23,6,109.58257,18.28458,1815
17422,134432,6CB2262427E621944253A1554B6D79F3,31251,5,22,17,109.18528,18.2975,317
17423,134446,173CD7A2B7B334BC53A50A1D248FBCFE,31071,5,6,1,109.58257,18.28458,1815
17424,134447,173CD7A2B7B334BC53A50A1D248FBCFE,30854,8,10,2,109.56889,18.27076,1763
17425,134448,173CD7A2B7B334BC53A50A1D248FBCFE,31071,11,13,2,109.58257,18.28458,1815
17426,134449,173CD7A2B7B334BC53A50A1D248FBCFE,60381,15,17,2,109.5241,18.22458,1605
17427,134450,173CD7A2B7B334BC53A50A1D248FBCFE,30854,18,19,1,109.56889,18.27076,1763
17428,134451,173CD7A2B7B334BC53A50A1D248FBCFE,31071,21,22,1,109.58257,18.28458,1815
17436,134480,32B282E0D9D6AD6484A59DFBF2B8EAC5,31681,0,6,6,109.40396,18.29979,1168
17437,134481,32B282E0D9D6AD6484A59DFBF2B8EAC5,38105,7,8,1,109.40299,18.29229,1117
17438,134482,32B282E0D9D6AD6484A59DFBF2B8EAC5,31301,11,12,1,109.14493,18.31222,170
17446,134600,3E8DFE6B8A4FF70B43F1C2C8FF289AC0,31101,0,2,2,109.65389,18.23403,2057
17447,134601,3E8DFE6B8A4FF70B43F1C2C8FF289AC0,38331,2,4,2,109.62465,18.22736,1956
17448,134602,3E8DFE6B8A4FF70B43F1C2C8FF289AC0,60381,8,9,1,109.5241,18.22458,1605
17449,134603,3E8DFE6B8A4FF70B43F1C2C8FF289AC0,31781,11,14,3,109.19847,18.2975,367
17450,134604,3E8DFE6B8A4FF70B43F1C2C8FF289AC0,31471,16,17,1,109.34583,18.29563,917
17451,134605,3E8DFE6B8A4FF70B43F1C2C8FF289AC0,31723,20,23,3,109.68563,18.23701,2207
17452,134617,529A14F498129B0238F7B12A9FC7F6F7,31205,0,2,2,109.51111,18.23736,1557
17453,134618,529A14F498129B0238F7B12A9FC7F6F7,31261,3,4,1,109.51174,18.2466,1559
17454,134619,529A14F498129B0238F7B12A9FC7F6F7,31671,5,14,9,109.38965,18.29813,1068
17455,134620,529A14F498129B0238F7B12A9FC7F6F7,30761,15,18,3,109.45201,18.3,1318
17456,134621,529A14F498129B0238F7B12A9FC7F6F7,30711,20,21,1,109.50271,18.25347,1510
17457,134657,3C9D5DF00C57B6E7794B9A51846C6621,31121,0,7,7,109.16292,18.37063,230
17458,134658,3C9D5DF00C57B6E7794B9A51846C6621,31261,9,11,2,109.51174,18.2466,1559
17459,134659,3C9D5DF00C57B6E7794B9A51846C6621,31031,11,14,3,109.49979,18.25382,1510
17460,134660,3C9D5DF00C57B6E7794B9A51846C6621,31121,19,23,4,109.16292,18.37063,230
17461,134691,866460FA5062A635337B6369BB2AADDA,30854,2,7,5,109.56889,18.27076,1763
17462,134692,866460FA5062A635337B6369BB2AADDA,60591,11,12,1,109.61118,18.21715,1904
17463,134697,0BB1CA81E48C2B6566102295CAE07E5D,30121,15,18,3,109.52861,18.27222,1613
17464,134698,0BB1CA81E48C2B6566102295CAE07E5D,31071,20,21,1,109.58257,18.28458,1815
17468,134766,B07D1803AC15C12AA319092ED1E797D8,60381,0,8,8,109.5241,18.22458,1605
17469,134767,B07D1803AC15C12AA319092ED1E797D8,31471,12,13,1,109.34583,18.29563,917
17470,134768,B07D1803AC15C12AA319092ED1E797D8,31471,14,15,1,109.34583,18.29563,917
17471,134769,B07D1803AC15C12AA319092ED1E797D8,38315,16,17,1,109.48979,18.29764,1467
17472,134789,02F7708F1CFAC98CD0B107132A271A25,60463,14,15,1,109.52507,18.22438,1605
17473,134790,02F7708F1CFAC98CD0B107132A271A25,48574,16,20,4,109.48931,18.28458,1465
17474,134804,6A8C883D29A8AF90E102449F92489A64,38821,18,19,1,109.50354,18.25243,1510
17475,134805,6A8C883D29A8AF90E102449F92489A64,30854,20,22,2,109.56889,18.27076,1763
17476,134820,0E1B3CFC64EBB658DA96D0DCA834701E,61011,4,10,6,109.60653,18.19076,1900
17477,134822,0E1B3CFC64EBB658DA96D0DCA834701E,61011,17,21,4,109.60653,18.19076,1900
17478,134824,0E56047C2113CB9384943BEBAA9FF06B,31031,0,16,16,109.49979,18.25382,1510
17479,134825,0E56047C2113CB9384943BEBAA9FF06B,38315,16,17,1,109.48979,18.29764,1467
17480,134843,CB1C8502149DACE0B32B2F7416279EF2,31071,0,9,9,109.58257,18.28458,1815
17481,134844,CB1C8502149DACE0B32B2F7416279EF2,30854,9,19,10,109.56889,18.27076,1763
17482,134845,69376C55C8883D60B733443073E6E40F,31861,0,9,9,109.49042,18.27549,1464
17483,134846,69376C55C8883D60B733443073E6E40F,31801,11,13,2,109.20417,18.32118,371
17484,134847,69376C55C8883D60B733443073E6E40F,60411,15,16,1,109.32514,18.30854,869
17485,134917,40C57F24FE0409ABB752B2031C349577,38951,1,13,12,109.48097,18.28868,1416
17486,134918,40C57F24FE0409ABB752B2031C349577,60463,16,20,4,109.52507,18.22438,1605
17487,134919,40C57F24FE0409ABB752B2031C349577,38951,21,23,2,109.48097,18.28868,1416
17488,134944,D6B54C643B88B86782DC30A38AD291FD,31561,3,13,10,109.56792,18.28479,1765
17489,134945,D6B54C643B88B86782DC30A38AD291FD,30854,15,21,6,109.56889,18.27076,1763
17490,134984,1FE2866848043A2C10AD87212485FE15,31181,1,2,1,109.50382,18.24813,1509
17491,134985,1FE2866848043A2C10AD87212485FE15,31071,3,7,4,109.58257,18.28458,1815
17492,134986,1FE2866848043A2C10AD87212485FE15,30854,10,23,13,109.56889,18.27076,1763
17493,135058,4920907824EB321BE55C3B9CE4B6FB57,38541,0,1,1,109.73715,18.34875,2426
17494,135060,4920907824EB321BE55C3B9CE4B6FB57,38541,3,8,5,109.73715,18.34875,2426
17499,135148,B712327B6033C61F37801CFD6DAC08AD,31951,0,3,3,109.52174,18.30299,1568
17500,135149,B712327B6033C61F37801CFD6DAC08AD,38991,3,4,1,109.52681,18.30368,1618
17501,135150,B712327B6033C61F37801CFD6DAC08AD,38484,5,14,9,109.53028,18.31528,1620
17502,135151,B712327B6033C61F37801CFD6DAC08AD,38484,14,18,4,109.53028,18.31528,1620
17503,135152,B712327B6033C61F37801CFD6DAC08AD,30561,20,22,2,109.52778,18.31938,1621
17507,135224,530F0AE3A2D48DD91CDC3A17D13BA70F,38707,0,11,11,109.73778,18.35368,2427
17508,135225,530F0AE3A2D48DD91CDC3A17D13BA70F,30531,15,16,1,109.53271,18.21472,1604
17509,135226,530F0AE3A2D48DD91CDC3A17D13BA70F,38707,17,19,2,109.73778,18.35368,2427
17510,135255,6CF89A30BF6785DF298A05F3A844C4F4,30821,0,3,3,109.43681,18.33639,1274
17511,135256,6CF89A30BF6785DF298A05F3A844C4F4,60421,3,6,3,109.46333,18.31743,1371
17512,135257,6CF89A30BF6785DF298A05F3A844C4F4,31781,9,11,2,109.19847,18.2975,367
17513,135258,6CF89A30BF6785DF298A05F3A844C4F4,30661,11,13,2,109.37028,18.24361,1008
17514,135276,202E088A34F33462A1153A80AD45CA6B,31231,13,17,4,109.42597,18.29292,1217
17515,135277,202E088A34F33462A1153A80AD45CA6B,60524,19,23,4,109.42951,18.28993,1216
17519,135300,1EE9007A08685A1EA943EBCDEA8805C7,31471,13,14,1,109.34583,18.29563,917
17520,135373,06CCC403601D7C9C1AA6BF102B163D95,60161,14,16,2,109.49174,18.26181,1461
17521,135374,06CCC403601D7C9C1AA6BF102B163D95,60231,17,18,1,109.49903,18.21972,1504
17525,135408,3842150E551101E5C7EA3E39AF0BFFE0,31061,0,6,6,109.53333,18.23257,1607
17526,135418,F47C4E1E39056C43B0AD32AC994AB7C0,31931,1,20,19,109.54771,18.29403,1667
17527,135419,F47C4E1E39056C43B0AD32AC994AB7C0,60361,21,22,1,109.51938,18.29681,1567
17528,135424,811CE7E060D5A10FC7748D88604CC4FD,31231,0,9,9,109.42597,18.29292,1217
17529,135425,811CE7E060D5A10FC7748D88604CC4FD,30671,10,11,1,109.43611,18.30139,1268
17530,135426,811CE7E060D5A10FC7748D88604CC4FD,30941,15,16,1,109.5559,18.33938,1724
17531,135427,811CE7E060D5A10FC7748D88604CC4FD,31231,21,22,1,109.42597,18.29292,1217
17532,135433,0B3D35BF2B857D2477B6F03BDBF1D90C,31471,14,16,2,109.34583,18.29563,917
17533,135434,0B3D35BF2B857D2477B6F03BDBF1D90C,30361,19,20,1,109.50347,18.24,1508
17534,135435,0B3D35BF2B857D2477B6F03BDBF1D90C,30211,21,22,1,109.49882,18.23931,1508
17538,135539,30F5D42A1A8F1CF26F5C9617FCB06C4F,30854,17,19,2,109.56889,18.27076,1763
17539,135540,30F5D42A1A8F1CF26F5C9617FCB06C4F,31561,19,21,2,109.56792,18.28479,1765
17540,135556,608CD70841FB78E12CBE2B3DBFC716D5,31761,0,1,1,109.60521,18.27965,1914
17541,135557,608CD70841FB78E12CBE2B3DBFC716D5,39371,2,3,1,109.56627,18.2646,1762
17542,135558,608CD70841FB78E12CBE2B3DBFC716D5,30854,3,7,4,109.56889,18.27076,1763
17543,135559,608CD70841FB78E12CBE2B3DBFC716D5,31071,10,11,1,109.58257,18.28458,1815
17544,135560,608CD70841FB78E12CBE2B3DBFC716D5,30854,11,23,12,109.56889,18.27076,1763
17545,135595,A928E9F6C796FE1A60807BA003DE87BB,30854,0,5,5,109.56889,18.27076,1763
17546,135596,A928E9F6C796FE1A60807BA003DE87BB,31071,7,8,1,109.58257,18.28458,1815
17547,135597,A928E9F6C796FE1A60807BA003DE87BB,33481,9,14,5,109.67278,18.41278,2187
17548,135598,A928E9F6C796FE1A60807BA003DE87BB,30854,15,18,3,109.56889,18.27076,1763
17549,135599,A928E9F6C796FE1A60807BA003DE87BB,31071,18,19,1,109.58257,18.28458,1815
17550,135600,A928E9F6C796FE1A60807BA003DE87BB,30854,20,22,2,109.56889,18.27076,1763
17551,135646,3F320FCC97654DBDACE66BB1BF09E301,30711,10,13,3,109.50271,18.25347,1510
17552,135686,97C31877CA4226D0F1BA1C0E12066B56,60331,0,6,6,109.505,18.26507,1512
17553,135687,97C31877CA4226D0F1BA1C0E12066B56,30854,7,13,6,109.56889,18.27076,1763
17554,135688,97C31877CA4226D0F1BA1C0E12066B56,31561,14,15,1,109.56792,18.28479,1765
17555,135689,97C31877CA4226D0F1BA1C0E12066B56,30251,18,21,3,109.50611,18.26653,1512
17556,135690,97C31877CA4226D0F1BA1C0E12066B56,60331,21,23,2,109.505,18.26507,1512
17560,135709,21FBB6F0F825A6B1E89545963BB6C9D3,30854,0,20,20,109.56889,18.27076,1763
17561,135710,21FBB6F0F825A6B1E89545963BB6C9D3,60631,22,23,1,109.57778,18.27583,1814
17562,135752,A749E400BFD3B5908671E939EC104DEE,30854,0,9,9,109.56889,18.27076,1763
17563,135753,A749E400BFD3B5908671E939EC104DEE,31491,12,14,2,109.73042,18.38771,2382
17564,135754,A749E400BFD3B5908671E939EC104DEE,30854,17,20,3,109.56889,18.27076,1763
17565,135783,7CB856FEE9B622309A7C94CB5E258253,31411,13,14,1,109.5016,18.23576,1507
17566,135784,7CB856FEE9B622309A7C94CB5E258253,39183,15,17,2,109.55542,18.28208,1715
17573,135805,DA759AC2EBBA8078FBC390D09D5C4EC7,31101,11,14,3,109.65389,18.23403,2057
17574,135806,DA759AC2EBBA8078FBC390D09D5C4EC7,30854,15,19,4,109.56889,18.27076,1763
17575,135820,331C93B6083F5634586EEDFC958D0A76,60361,0,8,8,109.51938,18.29681,1567
17576,135821,331C93B6083F5634586EEDFC958D0A76,31145,9,15,6,109.20431,18.30479,369
17577,135830,6176265D4B047A058BFE39B579C63226,31521,0,8,8,109.51458,18.22542,1555
17578,135831,6176265D4B047A058BFE39B579C63226,31471,11,13,2,109.34583,18.29563,917
17579,135832,6176265D4B047A058BFE39B579C63226,31521,14,22,8,109.51458,18.22542,1555
17580,135833,9AC9BAB6FD8AF8D8ECCEB379050F672F,31701,0,8,8,109.44132,18.28833,1266
17581,135834,9AC9BAB6FD8AF8D8ECCEB379050F672F,31781,12,13,1,109.19847,18.2975,367
17582,135835,9AC9BAB6FD8AF8D8ECCEB379050F672F,31701,18,23,5,109.44132,18.28833,1266
17589,135903,3E01B14B28C0FDBF8BB343D61C8AA7D8,31931,0,9,9,109.54771,18.29403,1667
17590,135904,3E01B14B28C0FDBF8BB343D61C8AA7D8,31301,14,17,3,109.14493,18.31222,170
17591,135905,3E01B14B28C0FDBF8BB343D61C8AA7D8,60241,21,23,2,109.53319,18.28667,1616
17592,135936,66DAA2740440F603A26B0FC0D4309DF2,31931,9,23,14,109.54771,18.29403,1667
17597,135955,EF2DD50D8910ACE6DC9CDC38ED663FB8,31561,2,13,11,109.56792,18.28479,1765
17598,135956,EF2DD50D8910ACE6DC9CDC38ED663FB8,30854,14,16,2,109.56889,18.27076,1763
17599,135974,319C385C256C2264D15D0D4ABF1C5A6B,31061,0,9,9,109.53333,18.23257,1607
17600,135975,319C385C256C2264D15D0D4ABF1C5A6B,60084,10,11,1,109.4984,18.2334,1507
17601,135976,319C385C256C2264D15D0D4ABF1C5A6B,30861,12,13,1,109.52722,18.22743,1606
17602,135977,319C385C256C2264D15D0D4ABF1C5A6B,30111,14,18,4,109.47583,18.30542,1419
17603,135978,C61360C6C8202A54143E165C2C08120B,30232,0,2,2,109.6191,18.31701,1971
17604,135979,C61360C6C8202A54143E165C2C08120B,30951,2,13,11,109.56208,18.25667,1761
17612,136004,19A7A932E03C63EDA78541C31E010D15,38903,0,6,6,109.39229,18.29243,1117
17613,136005,19A7A932E03C63EDA78541C31E010D15,38141,8,10,2,109.39479,18.2916,1116
17614,136006,19A7A932E03C63EDA78541C31E010D15,30361,10,13,3,109.50347,18.24,1508
17615,136007,19A7A932E03C63EDA78541C31E010D15,60541,15,22,7,109.4084,18.29208,1167
17616,136044,065F1687C35F3C827A2EA4A378A0E2C6,30851,10,11,1,109.5616,18.27396,1713
17617,136045,065F1687C35F3C827A2EA4A378A0E2C6,39371,14,15,1,109.56627,18.2646,1762
17618,136046,065F1687C35F3C827A2EA4A378A0E2C6,30851,16,18,2,109.5616,18.27396,1713
17619,136047,75A6390EC6BFC646EB62C94B6457CC0E,31521,0,8,8,109.51458,18.22542,1555
17620,136048,75A6390EC6BFC646EB62C94B6457CC0E,30661,11,12,1,109.37028,18.24361,1008
17621,136049,75A6390EC6BFC646EB62C94B6457CC0E,60381,15,19,4,109.5241,18.22458,1605
17622,136050,75A6390EC6BFC646EB62C94B6457CC0E,31521,20,23,3,109.51458,18.22542,1555
17623,136082,13166628932DF36C0AD7B1DB5811240A,60591,0,6,6,109.61118,18.21715,1904
17624,136083,13166628932DF36C0AD7B1DB5811240A,30854,9,16,7,109.56889,18.27076,1763
17625,136084,13166628932DF36C0AD7B1DB5811240A,60591,19,23,4,109.61118,18.21715,1904
17626,136112,2DA5948E96121EADE6CCFA0D33794EFE,38251,0,2,2,109.49618,18.25493,1510
17627,136113,2DA5948E96121EADE6CCFA0D33794EFE,60131,5,7,2,109.49819,18.24778,1509
17628,136114,2DA5948E96121EADE6CCFA0D33794EFE,30711,7,12,5,109.50271,18.25347,1510
17629,136115,2DA5948E96121EADE6CCFA0D33794EFE,30741,13,14,1,109.49833,18.28681,1516
17630,136116,2DA5948E96121EADE6CCFA0D33794EFE,31531,15,17,2,109.49583,18.25972,1461
17631,136117,2DA5948E96121EADE6CCFA0D33794EFE,30711,18,22,4,109.50271,18.25347,1510
17635,136127,389CF830723A2E0E3A1A739A3938F222,31521,12,14,2,109.51458,18.22542,1555
17636,136128,389CF830723A2E0E3A1A739A3938F222,31471,16,17,1,109.34583,18.29563,917
17637,136129,389CF830723A2E0E3A1A739A3938F222,31521,18,23,5,109.51458,18.22542,1555
17638,136130,B621E9075674E792CCB217233825F9D1,30851,1,3,2,109.5616,18.27396,1713
17639,136131,B621E9075674E792CCB217233825F9D1,30232,3,6,3,109.6191,18.31701,1971
17640,136132,B621E9075674E792CCB217233825F9D1,30854,7,8,1,109.56889,18.27076,1763
17641,136133,B621E9075674E792CCB217233825F9D1,60591,10,12,2,109.61118,18.21715,1904
17642,136134,B621E9075674E792CCB217233825F9D1,30854,20,22,2,109.56889,18.27076,1763
17643,136135,B621E9075674E792CCB217233825F9D1,60631,22,23,1,109.57778,18.27583,1814
17644,136136,E605B26D53F08A0D3360A4541E09F4E2,30721,0,5,5,109.51597,18.28257,1565
17645,136137,E605B26D53F08A0D3360A4541E09F4E2,38283,8,11,3,109.62229,18.22618,1956
17646,136138,E605B26D53F08A0D3360A4541E09F4E2,38283,13,23,10,109.62229,18.22618,1956
17647,136176,9837FB962D7F62E426A73EBD66CBBE03,60524,20,21,1,109.42951,18.28993,1216
17648,136177,9837FB962D7F62E426A73EBD66CBBE03,30721,22,23,1,109.51597,18.28257,1565
17653,136260,7AF4921BC4D1712A961904D0ECC91550,30071,0,10,10,109.52819,18.30472,1619
17654,136261,7AF4921BC4D1712A961904D0ECC91550,30421,14,15,1,109.50021,18.25861,1511
17658,136289,7421066246AAD1C230E7E2A7ADF06E9D,60631,0,5,5,109.57778,18.27583,1814
17659,136290,7421066246AAD1C230E7E2A7ADF06E9D,30854,7,11,4,109.56889,18.27076,1763
17660,136291,7421066246AAD1C230E7E2A7ADF06E9D,60381,15,17,2,109.5241,18.22458,1605
17661,136292,7421066246AAD1C230E7E2A7ADF06E9D,31071,20,21,1,109.58257,18.28458,1815
17662,136314,6E580E35F1856BA2850385BDFB597BF5,39371,1,13,12,109.56627,18.2646,1762
17666,136326,E2A4A2ABBE2AAFDE32C6FA06BCCC268D,31071,0,16,16,109.58257,18.28458,1815
17667,136327,E2A4A2ABBE2AAFDE32C6FA06BCCC268D,30854,20,23,3,109.56889,18.27076,1763
17671,136352,417408FFDA93B177641D270D3A5C4B2D,31071,10,14,4,109.58257,18.28458,1815
17672,136353,417408FFDA93B177641D270D3A5C4B2D,30854,14,17,3,109.56889,18.27076,1763
17673,136354,417408FFDA93B177641D270D3A5C4B2D,31071,21,23,2,109.58257,18.28458,1815
17674,136358,A5E738BCE3A14BFC61D30835FD8302F3,38321,0,9,9,109.39854,18.29132,1116
17675,136359,A5E738BCE3A14BFC61D30835FD8302F3,31471,10,11,1,109.34583,18.29563,917
17676,136360,A5E738BCE3A14BFC61D30835FD8302F3,31031,15,18,3,109.49979,18.25382,1510
17677,136361,A5E738BCE3A14BFC61D30835FD8302F3,38105,19,23,4,109.40299,18.29229,1117
17678,136403,C1788356D6298A19C2039F0E2F1C2CF1,31071,2,6,4,109.58257,18.28458,1815
17679,136404,C1788356D6298A19C2039F0E2F1C2CF1,30891,6,9,3,109.59431,18.28389,1865
17680,136405,C1788356D6298A19C2039F0E2F1C2CF1,39183,11,12,1,109.55542,18.28208,1715
17681,136406,C1788356D6298A19C2039F0E2F1C2CF1,39321,13,14,1,109.529,18.2167,1604
17682,136435,2087FDBE09ECB215FF50CC16A9791DF1,31534,0,8,8,109.49368,18.25806,1461
17683,136437,2087FDBE09ECB215FF50CC16A9791DF1,31471,13,15,2,109.34583,18.29563,917
17684,136438,2087FDBE09ECB215FF50CC16A9791DF1,31431,17,18,1,109.44639,18.29042,1316
17685,136439,2087FDBE09ECB215FF50CC16A9791DF1,31534,18,23,5,109.49368,18.25806,1461
17689,136449,EA27C1DACC015E381783BB03940DBA88,31561,18,20,2,109.56792,18.28479,1765
17690,136450,EA27C1DACC015E381783BB03940DBA88,38484,21,23,2,109.53028,18.31528,1620
17691,136502,FE1026339FD332D4A4F5FBDF23B53B96,31031,11,16,5,109.49979,18.25382,1510
17692,136503,FE1026339FD332D4A4F5FBDF23B53B96,60291,18,19,1,109.50826,18.24639,1509
17693,136575,4EDFE7100E9EE56C14E553A61B670292,30854,15,16,1,109.56889,18.27076,1763
17694,136576,4EDFE7100E9EE56C14E553A61B670292,31071,19,20,1,109.58257,18.28458,1815
17695,136587,8DD23AA43C0F7967C45F7488D66F9159,31521,17,20,3,109.51458,18.22542,1555
17696,136588,8DD23AA43C0F7967C45F7488D66F9159,30191,21,23,2,109.50361,18.22701,1506
17697,136596,147470AD3D3B8724582C30D5F244A8B6,60421,0,7,7,109.46333,18.31743,1371
17698,136597,147470AD3D3B8724582C30D5F244A8B6,30111,8,10,2,109.47583,18.30542,1419
17699,136598,147470AD3D3B8724582C30D5F244A8B6,60421,11,13,2,109.46333,18.31743,1371
17700,136599,147470AD3D3B8724582C30D5F244A8B6,30111,13,18,5,109.47583,18.30542,1419
17701,136600,147470AD3D3B8724582C30D5F244A8B6,60421,18,22,4,109.46333,18.31743,1371
17702,136673,598A5BC9BEA86E74379689160E91B24E,30854,0,12,12,109.56889,18.27076,1763
17703,136674,598A5BC9BEA86E74379689160E91B24E,31071,15,17,2,109.58257,18.28458,1815
17704,136694,528F99F7FD8CA49B85B45B64A5D784BA,39183,1,3,2,109.55542,18.28208,1715
17705,136695,528F99F7FD8CA49B85B45B64A5D784BA,30851,7,12,5,109.5616,18.27396,1713
17706,136762,0E1DB444F47235AEDAD0A0404A7B75B4,31561,0,8,8,109.56792,18.28479,1765
17707,136763,0E1DB444F47235AEDAD0A0404A7B75B4,39183,11,22,11,109.55542,18.28208,1715
17708,136826,324899445F811D5785FB336DE18DAC0E,31531,0,5,5,109.49583,18.25972,1461
17709,136892,EBF906C5498076BCFA3E97DF6001B4F3,60631,2,10,8,109.57778,18.27583,1814
17710,136893,EBF906C5498076BCFA3E97DF6001B4F3,30854,15,23,8,109.56889,18.27076,1763
17714,136930,E6F34D056CDFAA8A4D106C82CFE2C31C,30191,17,19,2,109.50361,18.22701,1506
17715,136952,258F9A09B3B0048D107FC9EF9EB27CDE,30771,0,6,6,109.49938,18.26042,1511
17716,136953,258F9A09B3B0048D107FC9EF9EB27CDE,30421,6,11,5,109.50021,18.25861,1511
17717,136954,258F9A09B3B0048D107FC9EF9EB27CDE,30421,12,14,2,109.50021,18.25861,1511
17718,136955,258F9A09B3B0048D107FC9EF9EB27CDE,30421,17,19,2,109.50021,18.25861,1511
17719,136956,258F9A09B3B0048D107FC9EF9EB27CDE,38251,19,22,3,109.49618,18.25493,1510
17720,136972,F432BE98F277FF953CE263D7467BFC47,38671,0,7,7,109.41576,18.29285,1167
17721,136974,F432BE98F277FF953CE263D7467BFC47,31571,14,15,1,109.61563,18.23326,1957
17722,136975,F432BE98F277FF953CE263D7467BFC47,31701,16,19,3,109.44132,18.28833,1266
17729,137018,E16204D131FCD957D5ADB9592C1DD0ED,30854,1,7,6,109.56889,18.27076,1763
17730,137019,E16204D131FCD957D5ADB9592C1DD0ED,31071,7,11,4,109.58257,18.28458,1815
17731,137020,E16204D131FCD957D5ADB9592C1DD0ED,38754,12,13,1,109.74667,18.37382,2430
17732,137021,E16204D131FCD957D5ADB9592C1DD0ED,30731,17,22,5,109.50944,18.22306,1555
17736,137101,BB31C40AF9668A41ED1DCCB876852450,31061,0,7,7,109.53333,18.23257,1607
17737,137121,05B8E3BA98D31919D00565FFE318CEF9,31231,0,7,7,109.42597,18.29292,1217
17738,137122,05B8E3BA98D31919D00565FFE318CEF9,60054,12,13,1,109.3016,18.31229,770
17739,137123,05B8E3BA98D31919D00565FFE318CEF9,31231,15,16,1,109.42597,18.29292,1217
17740,137124,05B8E3BA98D31919D00565FFE318CEF9,30181,18,19,1,109.51597,18.23313,1557
17741,137125,4CE6A4570746D2FE13DAD47FED742E4E,31521,0,4,4,109.51458,18.22542,1555
17742,137126,4CE6A4570746D2FE13DAD47FED742E4E,60381,6,7,1,109.5241,18.22458,1605
17743,137127,4CE6A4570746D2FE13DAD47FED742E4E,31521,8,11,3,109.51458,18.22542,1555
17744,137128,4CE6A4570746D2FE13DAD47FED742E4E,30681,13,14,1,109.48493,18.26917,1463
17745,137129,4CE6A4570746D2FE13DAD47FED742E4E,38251,16,17,1,109.49618,18.25493,1510
17746,137130,4CE6A4570746D2FE13DAD47FED742E4E,31021,20,21,1,109.49021,18.27,1463
17747,137131,4CE6A4570746D2FE13DAD47FED742E4E,30681,22,23,1,109.48493,18.26917,1463
17751,137138,06FCF67485A2B44C8ABC96FDB92547C5,61011,0,2,2,109.60653,18.19076,1900
17752,137140,06FCF67485A2B44C8ABC96FDB92547C5,61011,6,7,1,109.60653,18.19076,1900
17760,137186,BAB9B8A3D1E7FB96DB94A06687C464B3,38154,1,7,6,109.5266,18.28278,1615
17761,137187,BAB9B8A3D1E7FB96DB94A06687C464B3,31311,9,16,7,109.72299,18.27438,2364
17762,137188,BAB9B8A3D1E7FB96DB94A06687C464B3,31361,20,23,3,109.47417,18.28292,1415
17763,137205,A952750F25C558E5C17B3EB7DD935431,60371,2,6,4,109.53063,18.30056,1618
17764,137206,A952750F25C558E5C17B3EB7DD935431,31931,9,12,3,109.54771,18.29403,1667
17765,137207,A952750F25C558E5C17B3EB7DD935431,60371,12,13,1,109.53063,18.30056,1618
17766,137208,A952750F25C558E5C17B3EB7DD935431,31931,15,20,5,109.54771,18.29403,1667
17767,137209,A952750F25C558E5C17B3EB7DD935431,60371,20,22,2,109.53063,18.30056,1618
17768,137217,ABCD0851CC1C78BCD7AF6DBDF2F5DE49,60524,0,6,6,109.42951,18.28993,1216
17769,137218,ABCD0851CC1C78BCD7AF6DBDF2F5DE49,30211,6,11,5,109.49882,18.23931,1508
17770,137219,ABCD0851CC1C78BCD7AF6DBDF2F5DE49,60552,12,13,1,109.41729,18.30014,1218
17771,137220,ABCD0851CC1C78BCD7AF6DBDF2F5DE49,30051,14,18,4,109.48917,18.21215,1453
17772,137221,ABCD0851CC1C78BCD7AF6DBDF2F5DE49,30821,18,22,4,109.43681,18.33639,1274
17773,137224,5E97A4561E11AAC4FBC53FD068EAA52B,60631,0,1,1,109.57778,18.27583,1814
17774,137225,5E97A4561E11AAC4FBC53FD068EAA52B,30854,3,21,18,109.56889,18.27076,1763
17778,137279,9EB99F27F9127F01C16DB7BA7D10B6E0,38754,10,12,2,109.74667,18.37382,2430
17779,137280,9EB99F27F9127F01C16DB7BA7D10B6E0,30854,13,14,1,109.56889,18.27076,1763
17780,137281,9EB99F27F9127F01C16DB7BA7D10B6E0,31071,15,22,7,109.58257,18.28458,1815
17781,137292,B0E741288CA2FC33FD0EC2387A571BD4,38683,0,8,8,109.4266,18.29097,1216
17782,137293,B0E741288CA2FC33FD0EC2387A571BD4,31781,10,11,1,109.19847,18.2975,367
17783,137294,B0E741288CA2FC33FD0EC2387A571BD4,31145,11,12,1,109.20431,18.30479,369
17784,137320,B643AC77F8D8498A9694D45BA8B0F75F,31561,3,5,2,109.56792,18.28479,1765
17785,137321,B643AC77F8D8498A9694D45BA8B0F75F,60631,8,16,8,109.57778,18.27583,1814
17786,137368,6593F76DF8B5BF518604AD69943FBD58,30854,12,15,3,109.56889,18.27076,1763
17787,137369,6593F76DF8B5BF518604AD69943FBD58,31071,17,18,1,109.58257,18.28458,1815
17788,137437,BAC7E51B2D0D207ECF67D07957EC28B1,60501,20,21,1,109.48701,18.29021,1466
17789,137438,BAC7E51B2D0D207ECF67D07957EC28B1,30111,21,23,2,109.47583,18.30542,1419
17790,137460,27BCEF3137923B84211F08830816C810,30851,1,7,6,109.5616,18.27396,1713
17791,137461,27BCEF3137923B84211F08830816C810,61011,11,12,1,109.60653,18.19076,1900
17792,137486,E8EFAA5D1A201DE1B09CA7FAC04D4F91,30421,17,21,4,109.50021,18.25861,1511
17793,137487,E8EFAA5D1A201DE1B09CA7FAC04D4F91,60131,22,23,1,109.49819,18.24778,1509
17794,137494,439C404954398764464D854D76F475D8,31345,19,20,1,109.39,18.29,1066
17795,137495,439C404954398764464D854D76F475D8,31345,21,23,2,109.39,18.29,1066
17800,137584,937F0B31443CC6355891AA9D2DB0C670,31561,0,2,2,109.56792,18.28479,1765
17801,137585,937F0B31443CC6355891AA9D2DB0C670,31071,2,5,3,109.58257,18.28458,1815
17802,137586,937F0B31443CC6355891AA9D2DB0C670,31561,6,15,9,109.56792,18.28479,1765
17803,137587,937F0B31443CC6355891AA9D2DB0C670,30854,16,18,2,109.56889,18.27076,1763
17804,137588,937F0B31443CC6355891AA9D2DB0C670,31561,19,23,4,109.56792,18.28479,1765
17805,137605,C69C9580000F43E4250576851966C975,30661,0,7,7,109.37028,18.24361,1008
17806,137606,C69C9580000F43E4250576851966C975,31781,12,14,2,109.19847,18.2975,367
17807,137632,00FD2268DE6E83934D2916174E81532F,60472,13,14,1,109.46625,18.29542,1367
17808,137633,00FD2268DE6E83934D2916174E81532F,30111,17,23,6,109.47583,18.30542,1419
17809,137650,057935907C2B481CA4E4D08E6E9B9029,30771,18,21,3,109.49938,18.26042,1511
17810,137662,22130435C432F057AB9DDA7C1A223C66,60084,0,10,10,109.4984,18.2334,1507
17811,137663,22130435C432F057AB9DDA7C1A223C66,30051,11,12,1,109.48917,18.21215,1453
17812,137664,22130435C432F057AB9DDA7C1A223C66,31521,13,14,1,109.51458,18.22542,1555
17813,137665,22130435C432F057AB9DDA7C1A223C66,60381,16,17,1,109.5241,18.22458,1605
17814,137666,22130435C432F057AB9DDA7C1A223C66,60084,18,23,5,109.4984,18.2334,1507
17819,137693,F198CAA1F49ACA5D003FD8F8473B3798,31071,0,7,7,109.58257,18.28458,1815
17820,137694,F198CAA1F49ACA5D003FD8F8473B3798,30854,9,11,2,109.56889,18.27076,1763
17821,137753,BB341BA09AFD6F1A65DDB2B3AF49B6CA,31031,16,17,1,109.49979,18.25382,1510
17822,137764,DAB08D254D49BF150533311BD904D49C,39191,0,12,12,109.51493,18.23472,1557
17823,137765,DAB08D254D49BF150533311BD904D49C,31071,13,16,3,109.58257,18.28458,1815
17824,137766,DAB08D254D49BF150533311BD904D49C,38154,19,21,2,109.5266,18.28278,1615
17825,137767,DAB08D254D49BF150533311BD904D49C,30721,21,23,2,109.51597,18.28257,1565
17826,137768,B2447A087C8F374ABEBA0025E60F3E7C,31521,0,7,7,109.51458,18.22542,1555
17827,137769,B2447A087C8F374ABEBA0025E60F3E7C,31521,8,9,1,109.51458,18.22542,1555
17828,137770,B2447A087C8F374ABEBA0025E60F3E7C,31303,12,14,2,109.15826,18.29549,217
17829,137771,B2447A087C8F374ABEBA0025E60F3E7C,60381,16,20,4,109.5241,18.22458,1605
17830,137772,B2447A087C8F374ABEBA0025E60F3E7C,39321,21,22,1,109.529,18.2167,1604
17834,137776,6AA1FDAFF316CF8CAED7100E9AF3DC53,60551,0,7,7,109.42722,18.30111,1218
17835,137777,6AA1FDAFF316CF8CAED7100E9AF3DC53,31781,9,11,2,109.19847,18.2975,367
17836,137778,6AA1FDAFF316CF8CAED7100E9AF3DC53,31145,11,13,2,109.20431,18.30479,369
17837,137779,6AA1FDAFF316CF8CAED7100E9AF3DC53,60552,16,17,1,109.41729,18.30014,1218
17838,137780,6AA1FDAFF316CF8CAED7100E9AF3DC53,60551,18,23,5,109.42722,18.30111,1218
17839,137793,1B2AAA05011DB9CAB121805410EE3612,38951,19,21,2,109.48097,18.28868,1416
17840,137794,1B2AAA05011DB9CAB121805410EE3612,38951,22,23,1,109.48097,18.28868,1416
17841,137798,800DFCEC5F68D621508C6DD1FAD20726,31431,2,9,7,109.44639,18.29042,1316
17842,137799,800DFCEC5F68D621508C6DD1FAD20726,30854,13,14,1,109.56889,18.27076,1763
17843,137800,800DFCEC5F68D621508C6DD1FAD20726,60621,16,17,1,109.48354,18.27451,1464
17844,137801,800DFCEC5F68D621508C6DD1FAD20726,31431,20,23,3,109.44639,18.29042,1316
17845,137802,420DF8F1B34A98719142CDFE3AAEB3D3,60381,3,11,8,109.5241,18.22458,1605
17846,137803,420DF8F1B34A98719142CDFE3AAEB3D3,38754,14,17,3,109.74667,18.37382,2430
17847,137804,420DF8F1B34A98719142CDFE3AAEB3D3,31521,17,20,3,109.51458,18.22542,1555
17848,137805,420DF8F1B34A98719142CDFE3AAEB3D3,31521,20,23,3,109.51458,18.22542,1555
17852,137837,C2EDA129DED7B4E10FC6588761A88D65,38171,0,15,15,109.50799,18.28139,1515
17853,137873,AFCE3351168C576BE2AA828A190DD579,60401,11,13,2,109.47444,18.27583,1414
17854,137874,AFCE3351168C576BE2AA828A190DD579,60221,16,17,1,109.52569,18.29188,1616
17855,137875,AFCE3351168C576BE2AA828A190DD579,31031,18,20,2,109.49979,18.25382,1510
17856,137876,AFCE3351168C576BE2AA828A190DD579,31231,20,23,3,109.42597,18.29292,1217
17857,137878,AE9453D604AF88F4293DEF99463B2345,30421,17,19,2,109.50021,18.25861,1511
17858,137899,51015BF65833D98716A0309741D1F1C2,30854,0,15,15,109.56889,18.27076,1763
17859,137900,51015BF65833D98716A0309741D1F1C2,60231,16,17,1,109.49903,18.21972,1504
17860,137901,51015BF65833D98716A0309741D1F1C2,39091,18,20,2,109.50097,18.25222,1510
17861,137905,0A5FE7A49BFEAE015B4E071389173366,30791,18,22,4,109.72333,18.40889,2386
17862,137929,A91F346055333341B878D926F011AB58,31061,0,7,7,109.53333,18.23257,1607
17863,137937,0E0D6E55BB1995EBF85F6B7AA8765E55,39183,17,18,1,109.55542,18.28208,1715
17864,137938,0E0D6E55BB1995EBF85F6B7AA8765E55,30854,19,23,4,109.56889,18.27076,1763
17865,137949,7AE891083A2B2C0292CFD40014FEF0E4,38973,0,9,9,109.51097,18.25389,1560
17866,137950,7AE891083A2B2C0292CFD40014FEF0E4,30711,10,13,3,109.50271,18.25347,1510
17867,137951,7AE891083A2B2C0292CFD40014FEF0E4,30151,13,15,2,109.50986,18.25083,1560
17868,137952,7AE891083A2B2C0292CFD40014FEF0E4,60114,19,21,2,109.73028,18.33847,2374
17869,137955,2D39AE6120F2674000C6DBB8A6E572A0,30854,11,12,1,109.56889,18.27076,1763
17870,137956,2D39AE6120F2674000C6DBB8A6E572A0,31945,14,16,2,109.58021,18.29403,1817
17871,137957,2D39AE6120F2674000C6DBB8A6E572A0,30854,18,19,1,109.56889,18.27076,1763
17872,137958,2D39AE6120F2674000C6DBB8A6E572A0,60631,19,20,1,109.57778,18.27583,1814
17873,137981,2D683B3AD358B28A27E068E80E3AA9C8,33481,9,13,4,109.67278,18.41278,2187
17874,137982,2D683B3AD358B28A27E068E80E3AA9C8,31071,16,18,2,109.58257,18.28458,1815
17875,137983,2D683B3AD358B28A27E068E80E3AA9C8,30854,19,23,4,109.56889,18.27076,1763
17879,138026,21EA50B7F2072F2024B9F3B7B9174B94,31561,16,17,1,109.56792,18.28479,1765
17880,138027,21EA50B7F2072F2024B9F3B7B9174B94,30234,17,19,2,109.60681,18.29979,1918
17881,138028,21EA50B7F2072F2024B9F3B7B9174B94,30321,21,22,1,109.49563,18.29611,1467
17885,138092,D3FB1B9D3C241050E5FB29B7C0AA31BE,31021,14,16,2,109.49021,18.27,1463
17886,138093,D3FB1B9D3C241050E5FB29B7C0AA31BE,31611,18,23,5,109.63076,18.34944,2026
17887,138219,361A6FA452CCBED9D72BF58E7EB7C21F,60524,0,7,7,109.42951,18.28993,1216
17888,138220,361A6FA452CCBED9D72BF58E7EB7C21F,60054,12,13,1,109.3016,18.31229,770
17889,138221,361A6FA452CCBED9D72BF58E7EB7C21F,60221,16,17,1,109.52569,18.29188,1616
17890,138222,361A6FA452CCBED9D72BF58E7EB7C21F,60524,19,23,4,109.42951,18.28993,1216
17891,138339,FFA78E97945507AFD9DEF992A707C4AC,31461,0,7,7,109.5091,18.25389,1510
17892,138340,FFA78E97945507AFD9DEF992A707C4AC,31081,8,10,2,109.44639,18.30181,1318
17893,138342,FFA78E97945507AFD9DEF992A707C4AC,31031,19,20,1,109.49979,18.25382,1510
17894,138343,FFA78E97945507AFD9DEF992A707C4AC,31461,20,23,3,109.5091,18.25389,1510
17895,138371,E191BF114A3C2277CB7C3323BAA13F43,30854,0,16,16,109.56889,18.27076,1763
17896,138372,E191BF114A3C2277CB7C3323BAA13F43,30191,21,23,2,109.50361,18.22701,1506
17897,138373,9FC721E86703223349C05C95FE4BBB6F,60087,0,1,1,109.50688,18.22299,1505
17898,138374,9FC721E86703223349C05C95FE4BBB6F,60081,1,11,10,109.51097,18.22639,1556
17899,138375,9FC721E86703223349C05C95FE4BBB6F,31521,11,14,3,109.51458,18.22542,1555
17900,138376,9FC721E86703223349C05C95FE4BBB6F,60381,14,19,5,109.5241,18.22458,1605
17901,138377,9FC721E86703223349C05C95FE4BBB6F,30731,20,21,1,109.50944,18.22306,1555
17902,138378,34CDE58722D425921983509B878EB515,30181,0,6,6,109.51597,18.23313,1557
17903,138379,34CDE58722D425921983509B878EB515,31151,8,11,3,109.75549,18.4191,2488
17904,138380,34CDE58722D425921983509B878EB515,31841,12,14,2,109.73201,18.33382,2373
17905,138383,C28E7C5F7B366223D185D96F76A4BF8F,38094,0,7,7,109.45403,18.28778,1316
17906,138384,C28E7C5F7B366223D185D96F76A4BF8F,31781,12,14,2,109.19847,18.2975,367
17907,138421,07F004282B66F8FFF4893B155B27BCEE,60524,0,6,6,109.42951,18.28993,1216
17908,138450,2C0209770A37CBC62C92C1A37F9CD2E2,31521,0,6,6,109.51458,18.22542,1555
17909,138451,2C0209770A37CBC62C92C1A37F9CD2E2,60381,6,10,4,109.5241,18.22458,1605
17910,138452,2C0209770A37CBC62C92C1A37F9CD2E2,31521,11,12,1,109.51458,18.22542,1555
17911,138453,2C0209770A37CBC62C92C1A37F9CD2E2,38111,13,16,3,109.52007,18.22403,1555
17912,138454,2C0209770A37CBC62C92C1A37F9CD2E2,38071,18,21,3,109.40722,18.30938,1169
17913,138482,C145E18C3951CC141DA56187AFB95CCF,31271,0,7,7,109.48958,18.26257,1462
17914,138483,C145E18C3951CC141DA56187AFB95CCF,31471,12,14,2,109.34583,18.29563,917
17915,138484,C145E18C3951CC141DA56187AFB95CCF,31271,18,23,5,109.48958,18.26257,1462
17916,138490,CFCFA94681CDD57855D6405C244168DD,38891,2,6,4,109.51486,18.24118,1558
17917,138491,CFCFA94681CDD57855D6405C244168DD,30911,7,8,1,109.50493,18.26181,1511
17918,138492,CFCFA94681CDD57855D6405C244168DD,38291,10,11,1,109.51618,18.24313,1558
17919,138493,CFCFA94681CDD57855D6405C244168DD,31201,12,15,3,109.51042,18.23819,1558
17920,138494,CFCFA94681CDD57855D6405C244168DD,31261,17,19,2,109.51174,18.2466,1559
17921,138495,CFCFA94681CDD57855D6405C244168DD,38251,22,23,1,109.49618,18.25493,1510
17925,138740,0D3DA8126B134D203BB35373EAFFB116,31071,0,17,17,109.58257,18.28458,1815
17926,138741,0D3DA8126B134D203BB35373EAFFB116,30854,19,23,4,109.56889,18.27076,1763
17927,138750,AF1EA8B0A2B2E2169B1942DA5F1F6F92,30201,0,7,7,109.4909,18.26465,1462
17928,138773,C78747A0453D40EE772827559A626260,38111,0,10,10,109.52007,18.22403,1555
17929,138774,C78747A0453D40EE772827559A626260,31471,12,13,1,109.34583,18.29563,917
17930,138775,C78747A0453D40EE772827559A626260,30361,16,19,3,109.50347,18.24,1508
17931,138776,C78747A0453D40EE772827559A626260,38111,19,21,2,109.52007,18.22403,1555
17935,138802,3B2F0B1EB2C18CFD96A1AF866AE54E56,60161,0,2,2,109.49174,18.26181,1461
17936,138803,3B2F0B1EB2C18CFD96A1AF866AE54E56,60231,3,8,5,109.49903,18.21972,1504
17940,138867,26CDE97E277FCC5CCED61585339A0A32,60084,0,6,6,109.4984,18.2334,1507
17941,138868,26CDE97E277FCC5CCED61585339A0A32,31471,8,10,2,109.34583,18.29563,917
17942,138869,26CDE97E277FCC5CCED61585339A0A32,31145,13,14,1,109.20431,18.30479,369
17943,138870,26CDE97E277FCC5CCED61585339A0A32,30821,15,17,2,109.43681,18.33639,1274
17944,138873,46486D9DD250B380A793A8C24723F284,31431,0,8,8,109.44639,18.29042,1316
17945,138877,011180B62F4B74096321FE5AD83DEDE5,31701,0,8,8,109.44132,18.28833,1266
17946,138878,011180B62F4B74096321FE5AD83DEDE5,31781,12,13,1,109.19847,18.2975,367
17947,138879,011180B62F4B74096321FE5AD83DEDE5,60054,14,15,1,109.3016,18.31229,770
17948,138880,011180B62F4B74096321FE5AD83DEDE5,31701,16,23,7,109.44132,18.28833,1266
17949,138899,A9FCE0049DB44FE004EAFBF5B783F4A5,31945,0,7,7,109.58021,18.29403,1817
17950,138900,A9FCE0049DB44FE004EAFBF5B783F4A5,30854,7,15,8,109.56889,18.27076,1763
17951,138912,32ADC32EC334C9A30E8F811D3E7356C7,38251,0,2,2,109.49618,18.25493,1510
17952,138913,32ADC32EC334C9A30E8F811D3E7356C7,60161,3,8,5,109.49174,18.26181,1461
17956,138928,A64494D6F3A0AF8BF93D9FAA1169011A,38811,0,15,15,109.50875,18.2175,1504
17957,138929,A64494D6F3A0AF8BF93D9FAA1169011A,30741,17,20,3,109.49833,18.28681,1516
17958,138930,A64494D6F3A0AF8BF93D9FAA1169011A,31534,21,22,1,109.49368,18.25806,1461
17959,138957,3AC2F24CA8FAEF79CE1BF617A79038A2,31471,12,13,1,109.34583,18.29563,917
17960,138958,3AC2F24CA8FAEF79CE1BF617A79038A2,60411,15,17,2,109.32514,18.30854,869
17961,138976,8E06EAC16B0EF776FA1BAAC5B9747325,30511,0,6,6,109.51069,18.24208,1558
17962,138977,8E06EAC16B0EF776FA1BAAC5B9747325,60114,11,18,7,109.73028,18.33847,2374
17963,138978,8E06EAC16B0EF776FA1BAAC5B9747325,30511,19,23,4,109.51069,18.24208,1558
17964,138992,84DF4A7C208235D171EF56473BCCF210,30851,0,3,3,109.5616,18.27396,1713
17965,138993,84DF4A7C208235D171EF56473BCCF210,31561,3,7,4,109.56792,18.28479,1765
17966,138994,84DF4A7C208235D171EF56473BCCF210,30854,7,8,1,109.56889,18.27076,1763
17967,138995,84DF4A7C208235D171EF56473BCCF210,60631,8,17,9,109.57778,18.27583,1814
17968,138996,84DF4A7C208235D171EF56473BCCF210,30851,20,23,3,109.5616,18.27396,1713
17969,139009,88EA7986E36BDB47723EEA4FDCFA624A,30354,0,8,8,109.42813,18.29076,1216
17970,139010,88EA7986E36BDB47723EEA4FDCFA624A,31781,9,13,4,109.19847,18.2975,367
17971,139011,88EA7986E36BDB47723EEA4FDCFA624A,30354,17,23,6,109.42813,18.29076,1216
17975,139061,7024F3A14F6F554DC6E80063E30315F0,31561,1,6,5,109.56792,18.28479,1765
17976,139062,7024F3A14F6F554DC6E80063E30315F0,39183,8,16,8,109.55542,18.28208,1715
17983,139234,188C304BB598010A42FAC48FFAD2E905,60524,0,7,7,109.42951,18.28993,1216
17984,139235,188C304BB598010A42FAC48FFAD2E905,31781,10,11,1,109.19847,18.2975,367
17985,139236,188C304BB598010A42FAC48FFAD2E905,31471,13,15,2,109.34583,18.29563,917
17986,139237,188C304BB598010A42FAC48FFAD2E905,31431,17,18,1,109.44639,18.29042,1316
17987,139238,F00821368F615DCDAF214035D8EC4A44,31071,2,7,5,109.58257,18.28458,1815
17988,139239,F00821368F615DCDAF214035D8EC4A44,30854,8,16,8,109.56889,18.27076,1763
17989,139266,934029FB5F97BCE114EDCE88F0393A63,30854,16,19,3,109.56889,18.27076,1763
17990,139267,934029FB5F97BCE114EDCE88F0393A63,30234,22,23,1,109.60681,18.29979,1918
17991,139277,96F98526707B06BE1263CCD4F72E07A1,31071,0,9,9,109.58257,18.28458,1815
17992,139278,96F98526707B06BE1263CCD4F72E07A1,30854,9,11,2,109.56889,18.27076,1763
17993,139279,96F98526707B06BE1263CCD4F72E07A1,31071,12,13,1,109.58257,18.28458,1815
17994,139280,96F98526707B06BE1263CCD4F72E07A1,31945,15,16,1,109.58021,18.29403,1817
17995,139281,96F98526707B06BE1263CCD4F72E07A1,30854,19,21,2,109.56889,18.27076,1763
17996,139282,4521A8D92A7219267FD46990BC1A5213,30232,0,3,3,109.6191,18.31701,1971
17997,139283,4521A8D92A7219267FD46990BC1A5213,31561,4,5,1,109.56792,18.28479,1765
17998,139284,4521A8D92A7219267FD46990BC1A5213,30232,7,23,16,109.6191,18.31701,1971
18002,139299,33B6215E88E05EAC96C763C8595FD5B3,60621,0,8,8,109.48354,18.27451,1464
18003,139309,0500828DD6E0C85C8CBD75C0F0AE1363,31431,0,6,6,109.44639,18.29042,1316
18004,139310,0500828DD6E0C85C8CBD75C0F0AE1363,31781,10,11,1,109.19847,18.2975,367
18005,139316,AB89AD6D2E26F2802EB970B91FAAF097,38111,9,16,7,109.52007,18.22403,1555
18006,139317,AB89AD6D2E26F2802EB970B91FAAF097,38111,17,19,2,109.52007,18.22403,1555
18007,139332,AA17C9279A63248D7DCDF49F93EB8817,30854,1,12,11,109.56889,18.27076,1763
18008,139333,AA17C9279A63248D7DCDF49F93EB8817,60463,17,20,3,109.52507,18.22438,1605
18009,139334,AA17C9279A63248D7DCDF49F93EB8817,30854,21,23,2,109.56889,18.27076,1763
18010,139347,ECE5F9061BD873B365108DCE1A2E8E9E,38134,2,7,5,109.63931,18.23451,2007
18011,139348,ECE5F9061BD873B365108DCE1A2E8E9E,31321,8,9,1,109.63799,18.23201,2007
18012,139349,ECE5F9061BD873B365108DCE1A2E8E9E,38271,10,17,7,109.62632,18.23049,1956
18013,139350,ECE5F9061BD873B365108DCE1A2E8E9E,30361,18,19,1,109.50347,18.24,1508
18014,139351,ECE5F9061BD873B365108DCE1A2E8E9E,31321,21,23,2,109.63799,18.23201,2007
18015,139371,A3BD759CB67CAA27775E36B23655EA26,38134,0,7,7,109.63931,18.23451,2007
18016,139372,A3BD759CB67CAA27775E36B23655EA26,38271,7,9,2,109.62632,18.23049,1956
18017,139373,A3BD759CB67CAA27775E36B23655EA26,31471,11,13,2,109.34583,18.29563,917
18018,139374,A3BD759CB67CAA27775E36B23655EA26,31781,15,16,1,109.19847,18.2975,367
18019,139375,A3BD759CB67CAA27775E36B23655EA26,38134,21,23,2,109.63931,18.23451,2007
18020,139386,36566106CC9CFD386F41AE364EF63663,30341,14,16,2,109.3625,18.29167,966
18025,139427,00E4BC24F22404A2FC4D45749054257A,30854,13,18,5,109.56889,18.27076,1763
18026,139428,00E4BC24F22404A2FC4D45749054257A,31071,20,22,2,109.58257,18.28458,1815
18027,139434,F84D949DDCBF25D5530F771BC55E0B9D,61011,0,6,6,109.60653,18.19076,1900
18028,139436,F84D949DDCBF25D5530F771BC55E0B9D,61011,10,11,1,109.60653,18.19076,1900
18029,139460,07169E7114E4F14C073261BAAC0D4491,61011,1,6,5,109.60653,18.19076,1900
18030,139462,07169E7114E4F14C073261BAAC0D4491,61011,9,11,2,109.60653,18.19076,1900
18031,139473,53490AD77ACCA93C3ED0F3DE79CA488B,31071,8,16,8,109.58257,18.28458,1815
18032,139474,53490AD77ACCA93C3ED0F3DE79CA488B,30854,19,21,2,109.56889,18.27076,1763
18036,139526,0958879F2092FEC51B8948C9F5C46956,60054,15,16,1,109.3016,18.31229,770
18037,139527,0958879F2092FEC51B8948C9F5C46956,60381,18,19,1,109.5241,18.22458,1605
18038,139528,0958879F2092FEC51B8948C9F5C46956,31231,21,23,2,109.42597,18.29292,1217
18039,139570,B1CCD68E3CC8A7232EF2DE7E986C4789,30911,0,1,1,109.50493,18.26181,1511
18040,139571,B1CCD68E3CC8A7232EF2DE7E986C4789,30971,1,9,8,109.48708,18.29319,1467
18041,139572,B1CCD68E3CC8A7232EF2DE7E986C4789,60504,13,14,1,109.47917,18.28903,1416
18042,139573,B1CCD68E3CC8A7232EF2DE7E986C4789,60381,15,17,2,109.5241,18.22458,1605
18043,139574,B1CCD68E3CC8A7232EF2DE7E986C4789,30681,22,23,1,109.48493,18.26917,1463
18044,139575,9C1407835BC54BEBDB541F52E1DA1820,61011,0,11,11,109.60653,18.19076,1900
18045,139577,9C1407835BC54BEBDB541F52E1DA1820,61011,15,23,8,109.60653,18.19076,1900
18046,139610,3520FED22A4D572CBFE1B08BD2743E22,60291,4,9,5,109.50826,18.24639,1509
18047,139611,3520FED22A4D572CBFE1B08BD2743E22,31181,10,11,1,109.50382,18.24813,1509
18048,139612,3520FED22A4D572CBFE1B08BD2743E22,31311,14,15,1,109.72299,18.27438,2364
18049,139613,3520FED22A4D572CBFE1B08BD2743E22,38361,16,18,2,109.43667,18.29201,1267
18050,139614,3520FED22A4D572CBFE1B08BD2743E22,31031,18,20,2,109.49979,18.25382,1510
18051,139615,3520FED22A4D572CBFE1B08BD2743E22,38291,20,22,2,109.51618,18.24313,1558
18055,139718,8C3D244B6DAAE8C73F174808255E03C6,60011,0,6,6,109.48965,18.30222,1468
18056,139719,8C3D244B6DAAE8C73F174808255E03C6,30764,7,15,8,109.45806,18.29486,1367
18057,139720,8C3D244B6DAAE8C73F174808255E03C6,30761,16,18,2,109.45201,18.3,1318
18058,139721,8C3D244B6DAAE8C73F174808255E03C6,30111,20,21,1,109.47583,18.30542,1419
18059,139722,8C3D244B6DAAE8C73F174808255E03C6,60011,21,23,2,109.48965,18.30222,1468
18060,139733,D9D5ADF124CBC7323CAE219AA0CE2AB6,31271,0,9,9,109.48958,18.26257,1462
18061,139734,D9D5ADF124CBC7323CAE219AA0CE2AB6,31471,13,15,2,109.34583,18.29563,917
18062,139735,D9D5ADF124CBC7323CAE219AA0CE2AB6,31031,18,20,2,109.49979,18.25382,1510
18063,139736,D9D5ADF124CBC7323CAE219AA0CE2AB6,31531,21,23,2,109.49583,18.25972,1461
18070,139866,73EAC1341C5005A58B26B1A52457F38B,31181,0,4,4,109.50382,18.24813,1509
18071,139867,73EAC1341C5005A58B26B1A52457F38B,60641,4,7,3,109.53854,18.2359,1657
18072,139868,73EAC1341C5005A58B26B1A52457F38B,39101,8,9,1,109.50132,18.24931,1509
18073,139869,73EAC1341C5005A58B26B1A52457F38B,31181,10,15,5,109.50382,18.24813,1509
18074,139870,73EAC1341C5005A58B26B1A52457F38B,30711,18,23,5,109.50271,18.25347,1510
18075,139906,99CBAA6A65A50998F0A10B72B36210E4,60231,0,3,3,109.49903,18.21972,1504
18076,139907,99CBAA6A65A50998F0A10B72B36210E4,60084,7,8,1,109.4984,18.2334,1507
18077,139908,99CBAA6A65A50998F0A10B72B36210E4,60231,12,13,1,109.49903,18.21972,1504
18078,139909,99CBAA6A65A50998F0A10B72B36210E4,60161,18,20,2,109.49174,18.26181,1461
18079,139910,99CBAA6A65A50998F0A10B72B36210E4,38251,20,21,1,109.49618,18.25493,1510
18080,139916,43922725F0A46A5D2B5FC870E087F339,31071,16,17,1,109.58257,18.28458,1815
18081,139917,43922725F0A46A5D2B5FC870E087F339,30854,20,22,2,109.56889,18.27076,1763
18082,139971,55FA72F7A9567EE8C2569F2A3640F92B,60371,0,4,4,109.53063,18.30056,1618
18083,139972,55FA72F7A9567EE8C2569F2A3640F92B,31931,5,7,2,109.54771,18.29403,1667
18084,139973,55FA72F7A9567EE8C2569F2A3640F92B,39181,8,14,6,109.55153,18.28035,1715
18085,139974,55FA72F7A9567EE8C2569F2A3640F92B,39181,14,17,3,109.55153,18.28035,1715
18086,139975,55FA72F7A9567EE8C2569F2A3640F92B,31931,21,23,2,109.54771,18.29403,1667
18087,139979,37D38EF0062E64D55C94EB554B76F9EE,30854,10,13,3,109.56889,18.27076,1763
18088,139980,37D38EF0062E64D55C94EB554B76F9EE,31071,17,18,1,109.58257,18.28458,1815
18089,139981,37D38EF0062E64D55C94EB554B76F9EE,30854,20,21,1,109.56889,18.27076,1763
18090,139985,3A429390E0D19C5F409E32660585ED7B,30571,0,2,2,109.50243,18.21861,1504
18099,140045,D2B9DF4FCA3149F43DC5DB6395F8ACBA,38105,0,10,10,109.40299,18.29229,1117
18100,140046,D2B9DF4FCA3149F43DC5DB6395F8ACBA,31781,12,13,1,109.19847,18.2975,367
18101,140047,D2B9DF4FCA3149F43DC5DB6395F8ACBA,30361,15,16,1,109.50347,18.24,1508
18102,140048,D2B9DF4FCA3149F43DC5DB6395F8ACBA,38105,20,23,3,109.40299,18.29229,1117
18106,140118,020753EF78F0A0C39658113A3377EA1E,31561,0,15,15,109.56792,18.28479,1765
18107,140119,020753EF78F0A0C39658113A3377EA1E,30851,17,18,1,109.5616,18.27396,1713
18108,140142,70E36A4B82878626B569C66E46C7827C,31101,0,8,8,109.65389,18.23403,2057
18109,140143,70E36A4B82878626B569C66E46C7827C,31145,10,12,2,109.20431,18.30479,369
18110,140144,70E36A4B82878626B569C66E46C7827C,31471,13,14,1,109.34583,18.29563,917
18111,140145,70E36A4B82878626B569C66E46C7827C,60221,16,17,1,109.52569,18.29188,1616
18112,140146,70E36A4B82878626B569C66E46C7827C,60381,18,20,2,109.5241,18.22458,1605
18113,140147,70E36A4B82878626B569C66E46C7827C,31101,21,23,2,109.65389,18.23403,2057
18117,140168,EB0139E0BBB300F5407E4F7BCDA3B148,30151,0,4,4,109.50986,18.25083,1560
18118,140169,EB0139E0BBB300F5407E4F7BCDA3B148,38291,6,10,4,109.51618,18.24313,1558
18119,140170,EB0139E0BBB300F5407E4F7BCDA3B148,33481,11,15,4,109.67278,18.41278,2187
18120,140171,EB0139E0BBB300F5407E4F7BCDA3B148,31861,18,22,4,109.49042,18.27549,1464
18121,140236,D9E8C2A0E8C0B92A69D34C40543135ED,30731,0,1,1,109.50944,18.22306,1555
18122,140237,D9E8C2A0E8C0B92A69D34C40543135ED,60081,3,6,3,109.51097,18.22639,1556
18123,140238,D9E8C2A0E8C0B92A69D34C40543135ED,30241,9,10,1,109.26174,18.3275,622
18124,140239,D9E8C2A0E8C0B92A69D34C40543135ED,31781,12,13,1,109.19847,18.2975,367
18125,140240,D9E8C2A0E8C0B92A69D34C40543135ED,31471,14,16,2,109.34583,18.29563,917
18126,140294,FB38B30A8888B4A30D6BD4705441E645,38094,0,5,5,109.45403,18.28778,1316
18127,140295,FB38B30A8888B4A30D6BD4705441E645,31781,10,12,2,109.19847,18.2975,367
18128,140296,FB38B30A8888B4A30D6BD4705441E645,38094,17,18,1,109.45403,18.28778,1316
18138,140342,1C13A323A75285DF0344A33D367E6C75,31471,13,16,3,109.34583,18.29563,917
18139,140431,6EB2B3F5283FD4FC75239E7A3DF1C160,31461,0,5,5,109.5091,18.25389,1510
18140,140432,6EB2B3F5283FD4FC75239E7A3DF1C160,30711,6,7,1,109.50271,18.25347,1510
18141,140433,6EB2B3F5283FD4FC75239E7A3DF1C160,31081,8,9,1,109.44639,18.30181,1318
18142,140434,6EB2B3F5283FD4FC75239E7A3DF1C160,31461,19,20,1,109.5091,18.25389,1510
18143,140435,6EB2B3F5283FD4FC75239E7A3DF1C160,60201,20,23,3,109.5041,18.2509,1510
18144,140452,ACC390C77025BECAF4CD259D41E8F314,30232,1,5,4,109.6191,18.31701,1971
18145,140453,ACC390C77025BECAF4CD259D41E8F314,30854,9,11,2,109.56889,18.27076,1763
18146,140454,ACC390C77025BECAF4CD259D41E8F314,39371,16,17,1,109.56627,18.2646,1762
18147,140455,ACC390C77025BECAF4CD259D41E8F314,30854,19,20,1,109.56889,18.27076,1763
18151,140506,6B4FAB397217C25457DFB4FC930EC14C,30111,11,14,3,109.47583,18.30542,1419
18152,140530,2A1AB09F11CECAAFA5576058E9461FEA,30661,0,1,1,109.37028,18.24361,1008
18153,140531,2A1AB09F11CECAAFA5576058E9461FEA,31231,2,3,1,109.42597,18.29292,1217
18154,140532,2A1AB09F11CECAAFA5576058E9461FEA,60161,7,8,1,109.49174,18.26181,1461
18155,140533,2A1AB09F11CECAAFA5576058E9461FEA,31231,9,11,2,109.42597,18.29292,1217
18156,140534,2A1AB09F11CECAAFA5576058E9461FEA,60084,13,14,1,109.4984,18.2334,1507
18161,140574,6ADBEFDC21CA46F051933BF984A8E255,30854,9,13,4,109.56889,18.27076,1763
18162,140575,6ADBEFDC21CA46F051933BF984A8E255,38706,16,17,1,109.74625,18.37097,2430
18163,140576,6ADBEFDC21CA46F051933BF984A8E255,30961,20,21,1,109.74042,18.37903,2431
18164,140577,6ADBEFDC21CA46F051933BF984A8E255,38706,22,23,1,109.74625,18.37097,2430
18165,140597,8177A8185FF91F7A3E5BC89BE108D19E,30211,4,6,2,109.49882,18.23931,1508
18166,140598,8177A8185FF91F7A3E5BC89BE108D19E,31145,9,12,3,109.20431,18.30479,369
18167,140599,8177A8185FF91F7A3E5BC89BE108D19E,31471,13,16,3,109.34583,18.29563,917
18168,140649,020DAC5EBA12079D2F27F5BC84508A6E,30361,0,10,10,109.50347,18.24,1508
18169,140650,020DAC5EBA12079D2F27F5BC84508A6E,60054,14,15,1,109.3016,18.31229,770
18170,140651,020DAC5EBA12079D2F27F5BC84508A6E,30361,18,20,2,109.50347,18.24,1508
18171,140652,020DAC5EBA12079D2F27F5BC84508A6E,30361,21,23,2,109.50347,18.24,1508
18172,140690,1A3FFDC65E8E8B2347B759A77F2F6BEE,60381,0,5,5,109.5241,18.22458,1605
18173,140691,1A3FFDC65E8E8B2347B759A77F2F6BEE,30191,6,7,1,109.50361,18.22701,1506
18174,140692,1A3FFDC65E8E8B2347B759A77F2F6BEE,31781,12,13,1,109.19847,18.2975,367
18175,140693,1A3FFDC65E8E8B2347B759A77F2F6BEE,31521,16,18,2,109.51458,18.22542,1555
18176,140694,1A3FFDC65E8E8B2347B759A77F2F6BEE,30361,19,21,2,109.50347,18.24,1508
18177,140703,08077B5D5F0A9938A81D328635D03C8B,30851,0,5,5,109.5616,18.27396,1713
18178,140704,08077B5D5F0A9938A81D328635D03C8B,30854,5,13,8,109.56889,18.27076,1763
18179,140723,C983E73D646629A775690ECA8920EB29,30101,16,19,3,109.57299,18.33333,1773
18183,140801,F1FA54BCDE7297F39D6C0507CA898D49,30731,0,7,7,109.50944,18.22306,1555
18184,140802,F1FA54BCDE7297F39D6C0507CA898D49,38361,11,23,12,109.43667,18.29201,1267
18185,140809,3EAE2CCEF780CC2E20C47963EA2CF3C6,30854,5,12,7,109.56889,18.27076,1763
18186,140810,3EAE2CCEF780CC2E20C47963EA2CF3C6,31561,12,23,11,109.56792,18.28479,1765
18187,140843,377A324496E54511961704972731A3D5,38121,13,14,1,109.51361,18.27813,1564
18188,140844,377A324496E54511961704972731A3D5,31521,14,22,8,109.51458,18.22542,1555
18189,141001,F4D58A766EF9F9F31794D51DC3B7202C,30854,16,17,1,109.56889,18.27076,1763
18190,141002,F4D58A766EF9F9F31794D51DC3B7202C,31071,21,23,2,109.58257,18.28458,1815
18191,141022,E8C4FD393F72FBBB76050B5970191821,31071,1,7,6,109.58257,18.28458,1815
18192,141023,E8C4FD393F72FBBB76050B5970191821,31945,7,20,13,109.58021,18.29403,1817
18193,141024,9AA959ED87D1ECC3053DED17290EFCBD,30854,0,3,3,109.56889,18.27076,1763
18194,141025,9AA959ED87D1ECC3053DED17290EFCBD,31561,3,23,20,109.56792,18.28479,1765
18195,141064,BA3D3DE13D22E6DD1BA5A0B2CACB0B94,30361,12,14,2,109.50347,18.24,1508
18196,141065,BA3D3DE13D22E6DD1BA5A0B2CACB0B94,30441,17,18,1,109.64021,18.25424,2010
18197,141066,BA3D3DE13D22E6DD1BA5A0B2CACB0B94,60594,21,22,1,109.62694,18.22799,1956
18198,141067,83ED041A7C5392602E387EAC8E5436E3,38751,2,13,11,109.74903,18.37639,2481
18199,141068,83ED041A7C5392602E387EAC8E5436E3,31221,14,15,1,109.61333,18.26833,1913
18200,141069,83ED041A7C5392602E387EAC8E5436E3,30511,19,20,1,109.51069,18.24208,1558
18201,141092,7890099D98AA300C5BF12527E7372DB0,31071,12,13,1,109.58257,18.28458,1815
18202,141093,7890099D98AA300C5BF12527E7372DB0,30854,15,17,2,109.56889,18.27076,1763
18203,141094,7890099D98AA300C5BF12527E7372DB0,60631,21,23,2,109.57778,18.27583,1814
18204,141095,7B9A787C6833CBFA52C05ADBB8F5D371,31031,0,7,7,109.49979,18.25382,1510
18205,141096,7B9A787C6833CBFA52C05ADBB8F5D371,31471,9,10,1,109.34583,18.29563,917
18206,141097,7B9A787C6833CBFA52C05ADBB8F5D371,31031,14,16,2,109.49979,18.25382,1510
18207,141112,7171DFF8DAFC6575B222E1F303C150CC,38721,17,19,2,109.50368,18.27542,1514
18208,141113,7171DFF8DAFC6575B222E1F303C150CC,39101,20,22,2,109.50132,18.24931,1509
18209,141123,AECCCA10F076AF0904633347B64B94DB,31521,17,18,1,109.51458,18.22542,1555
18210,141124,AECCCA10F076AF0904633347B64B94DB,30361,19,21,2,109.50347,18.24,1508
18211,141157,C1DFDFC110B50DFE0D66E47848759FB2,30861,11,17,6,109.52722,18.22743,1606
18212,141158,C1DFDFC110B50DFE0D66E47848759FB2,39183,17,18,1,109.55542,18.28208,1715
18213,141195,BBE4D8242EE46AE73AD69A56A00F4408,30201,0,7,7,109.4909,18.26465,1462
18214,141196,BBE4D8242EE46AE73AD69A56A00F4408,31271,9,11,2,109.48958,18.26257,1462
18215,141197,BBE4D8242EE46AE73AD69A56A00F4408,30681,11,12,1,109.48493,18.26917,1463
18216,141198,BBE4D8242EE46AE73AD69A56A00F4408,31021,13,15,2,109.49021,18.27,1463
18217,141199,BBE4D8242EE46AE73AD69A56A00F4408,30201,19,23,4,109.4909,18.26465,1462
18218,141207,40285EE8CCE25C38988EC087545664EC,31071,1,6,5,109.58257,18.28458,1815
18219,141208,40285EE8CCE25C38988EC087545664EC,30854,10,17,7,109.56889,18.27076,1763
18220,141281,528DF0E8B4B73FA0C9FB75037E21B5BA,31931,14,15,1,109.54771,18.29403,1667
18221,141282,528DF0E8B4B73FA0C9FB75037E21B5BA,60241,17,18,1,109.53319,18.28667,1616
18222,141283,528DF0E8B4B73FA0C9FB75037E21B5BA,31931,20,23,3,109.54771,18.29403,1667
18226,141307,7D1ED6067ECBD941EFC43CE0A6ADAE71,30854,1,16,15,109.56889,18.27076,1763
18227,141308,7D1ED6067ECBD941EFC43CE0A6ADAE71,60381,18,19,1,109.5241,18.22458,1605
18228,141309,7D1ED6067ECBD941EFC43CE0A6ADAE71,30854,20,22,2,109.56889,18.27076,1763
18235,141328,219D03D2345568C24C18853ACF5CAE7D,31781,12,14,2,109.19847,18.2975,367
18236,141329,219D03D2345568C24C18853ACF5CAE7D,31201,17,18,1,109.51042,18.23819,1558
18237,141364,2825FD87EFD45342A281A57765BF5EE8,38541,0,9,9,109.73715,18.34875,2426
18238,141365,2825FD87EFD45342A281A57765BF5EE8,31061,13,14,1,109.53333,18.23257,1607
18239,141366,2825FD87EFD45342A281A57765BF5EE8,38541,15,23,8,109.73715,18.34875,2426
18240,141384,04ABA8BFD5D63DDF1B83BA0577C9019C,31421,4,5,1,109.55382,18.22347,1705
18241,141385,04ABA8BFD5D63DDF1B83BA0577C9019C,39183,7,8,1,109.55542,18.28208,1715
18242,141386,04ABA8BFD5D63DDF1B83BA0577C9019C,30854,8,22,14,109.56889,18.27076,1763
18243,141411,B7C4E049ABEA8BC374DE2818E1AEEA50,31941,9,11,2,109.62451,18.31222,1970
18244,141412,B7C4E049ABEA8BC374DE2818E1AEEA50,30084,13,15,2,109.50118,18.26972,1513
18245,141413,B7C4E049ABEA8BC374DE2818E1AEEA50,30711,16,18,2,109.50271,18.25347,1510
18246,141419,55D663E94101F000896F2C3F897BA6C9,30561,0,1,1,109.52778,18.31938,1621
18247,141420,55D663E94101F000896F2C3F897BA6C9,30031,3,12,9,109.53681,18.33313,1673
18248,141421,55D663E94101F000896F2C3F897BA6C9,31145,15,16,1,109.20431,18.30479,369
18249,141422,55D663E94101F000896F2C3F897BA6C9,60381,18,22,4,109.5241,18.22458,1605
18256,141521,E75CF54BA14775FEDD26504F9F6B7365,31945,0,6,6,109.58021,18.29403,1817
18257,141522,E75CF54BA14775FEDD26504F9F6B7365,31561,6,17,11,109.56792,18.28479,1765
18258,141531,96C474E5BFF92BC21432A4ADDD7A543D,30854,0,17,17,109.56889,18.27076,1763
18259,141532,96C474E5BFF92BC21432A4ADDD7A543D,31761,21,22,1,109.60521,18.27965,1914
18271,141634,58418A9EA4A7DC03127CB79C039A5185,31071,0,9,9,109.58257,18.28458,1815
18272,141635,58418A9EA4A7DC03127CB79C039A5185,39371,10,13,3,109.56627,18.2646,1762
18273,141636,58418A9EA4A7DC03127CB79C039A5185,30151,18,19,1,109.50986,18.25083,1560
18274,141714,1E36640BE395A4EE8CCB2697222419A5,31071,0,2,2,109.58257,18.28458,1815
18275,141715,1E36640BE395A4EE8CCB2697222419A5,60631,3,17,14,109.57778,18.27583,1814
18283,141727,DFFF17B7FE30E79B8AABBB5CE171272F,31561,5,18,13,109.56792,18.28479,1765
18284,141728,DFFF17B7FE30E79B8AABBB5CE171272F,39183,18,20,2,109.55542,18.28208,1715
18292,141859,63BCEBE172D1624AB431F458DD97DAC7,31864,0,8,8,109.49014,18.28333,1465
18293,141860,63BCEBE172D1624AB431F458DD97DAC7,60054,11,12,1,109.3016,18.31229,770
18294,141861,63BCEBE172D1624AB431F458DD97DAC7,31781,16,17,1,109.19847,18.2975,367
18295,141897,0D69669D4DBC1CEB06269A084D86E853,60631,0,5,5,109.57778,18.27583,1814
18296,141898,0D69669D4DBC1CEB06269A084D86E853,31571,7,16,9,109.61563,18.23326,1957
18297,141899,0D69669D4DBC1CEB06269A084D86E853,60631,18,22,4,109.57778,18.27583,1814
18298,141900,03DA52CB04D303C32B3FDE6BAFCAF395,31521,0,12,12,109.51458,18.22542,1555
18299,141901,03DA52CB04D303C32B3FDE6BAFCAF395,30854,15,18,3,109.56889,18.27076,1763
18300,141902,03DA52CB04D303C32B3FDE6BAFCAF395,31521,19,23,4,109.51458,18.22542,1555
18301,141969,85F98999C51742A0E8D410E1B8BA2FC0,30761,0,6,6,109.45201,18.3,1318
18302,141999,C53C007230CE5B7B1302C51A9FDED3D1,31521,0,4,4,109.51458,18.22542,1555
18303,142000,C53C007230CE5B7B1302C51A9FDED3D1,39111,5,6,1,109.5191,18.22597,1555
18304,142001,C53C007230CE5B7B1302C51A9FDED3D1,60552,8,9,1,109.41729,18.30014,1218
18305,142002,C53C007230CE5B7B1302C51A9FDED3D1,30341,10,13,3,109.3625,18.29167,966
18306,142003,C53C007230CE5B7B1302C51A9FDED3D1,30181,15,16,1,109.51597,18.23313,1557
18307,142030,CCC0948C8F9216D11E617BCBE962EF82,30861,15,18,3,109.52722,18.22743,1606
18308,142031,CCC0948C8F9216D11E617BCBE962EF82,60211,20,23,3,109.63549,18.26049,2011
18309,142035,BA4F535914401174601F6D052DC24E0D,30731,0,2,2,109.50944,18.22306,1555
18310,142036,BA4F535914401174601F6D052DC24E0D,38061,3,11,8,109.50597,18.23118,1506
18311,142038,3272381C6A94F906EDCE0D12EAC755B5,38361,1,9,8,109.43667,18.29201,1267
18315,142072,03CEC0FDDD5484124514C6D24A63D4DD,31561,16,18,2,109.56792,18.28479,1765
18316,142073,03CEC0FDDD5484124514C6D24A63D4DD,30854,21,22,1,109.56889,18.27076,1763
18320,142122,14BAF7EA9BDBA3487944890AC6AB30A3,38157,0,10,10,109.51483,18.26958,1563
18321,142123,14BAF7EA9BDBA3487944890AC6AB30A3,38157,13,22,9,109.51483,18.26958,1563
18322,142228,E218C587552A5DADC05C4E69685FE374,39183,0,7,7,109.55542,18.28208,1715
18323,142229,E218C587552A5DADC05C4E69685FE374,30854,10,12,2,109.56889,18.27076,1763
18324,142230,E218C587552A5DADC05C4E69685FE374,31841,13,16,3,109.73201,18.33382,2373
18325,142231,E218C587552A5DADC05C4E69685FE374,39183,17,22,5,109.55542,18.28208,1715
18326,142232,610DBC389A8D19B34D0871DB44596B0A,31861,0,11,11,109.49042,18.27549,1464
18327,142233,610DBC389A8D19B34D0871DB44596B0A,60054,13,15,2,109.3016,18.31229,770
18328,142234,610DBC389A8D19B34D0871DB44596B0A,31861,17,19,2,109.49042,18.27549,1464
18329,142235,610DBC389A8D19B34D0871DB44596B0A,60463,21,23,2,109.52507,18.22438,1605
18330,142261,269D3761ED337530C37A42787A175B92,31304,0,8,8,109.15903,18.32854,223
18331,142262,269D3761ED337530C37A42787A175B92,30711,9,11,2,109.50271,18.25347,1510
18332,142263,269D3761ED337530C37A42787A175B92,30711,11,15,4,109.50271,18.25347,1510
18333,142264,269D3761ED337530C37A42787A175B92,31304,18,23,5,109.15903,18.32854,223
18334,142289,1D8B814EC83D52D7C5F3FED99C129EE0,60631,3,5,2,109.57778,18.27583,1814
18335,142290,1D8B814EC83D52D7C5F3FED99C129EE0,30854,7,10,3,109.56889,18.27076,1763
18336,142291,1D8B814EC83D52D7C5F3FED99C129EE0,38271,12,20,8,109.62632,18.23049,1956
18340,142344,2225A928A5F41EC3C7691341B4D74A48,38297,12,13,1,109.52576,18.24965,1609
18341,142345,2225A928A5F41EC3C7691341B4D74A48,60311,13,15,2,109.52097,18.24319,1558
18342,142346,2225A928A5F41EC3C7691341B4D74A48,38297,18,19,1,109.52576,18.24965,1609
18343,142383,8880BF3B03853247B5235ADF19775070,30511,1,7,6,109.51069,18.24208,1558
18344,142384,8880BF3B03853247B5235ADF19775070,31261,7,10,3,109.51174,18.2466,1559
18345,142385,8880BF3B03853247B5235ADF19775070,60381,11,14,3,109.5241,18.22458,1605
18346,142386,8880BF3B03853247B5235ADF19775070,31521,14,15,1,109.51458,18.22542,1555
18347,142387,8880BF3B03853247B5235ADF19775070,60381,15,23,8,109.5241,18.22458,1605
18348,142465,93F22684CF6BFF2B98A28D1F2EA5D875,60291,0,2,2,109.50826,18.24639,1509
18349,142466,93F22684CF6BFF2B98A28D1F2EA5D875,30711,4,5,1,109.50271,18.25347,1510
18350,142467,93F22684CF6BFF2B98A28D1F2EA5D875,31781,10,12,2,109.19847,18.2975,367
18351,142468,93F22684CF6BFF2B98A28D1F2EA5D875,30711,16,20,4,109.50271,18.25347,1510
18352,142474,7C4B45B599684104AFE3AA992CD3924A,60211,0,9,9,109.63549,18.26049,2011
18353,142475,7C4B45B599684104AFE3AA992CD3924A,30811,10,19,9,109.65188,18.26257,2062
18354,142476,1B3E8931F1FF667205B6505EE53C6E2C,60631,0,8,8,109.57778,18.27583,1814
18355,142477,1B3E8931F1FF667205B6505EE53C6E2C,30854,11,20,9,109.56889,18.27076,1763
18356,142507,7B84211769976A29D6F3DD47508547C2,31781,8,12,4,109.19847,18.2975,367
18357,142508,7B84211769976A29D6F3DD47508547C2,60054,14,15,1,109.3016,18.31229,770
18358,142509,7B84211769976A29D6F3DD47508547C2,30361,18,23,5,109.50347,18.24,1508
18362,142584,D626C213FA0AAEAFB4EA6E1A519D93E5,38111,0,1,1,109.52007,18.22403,1555
18363,142585,D626C213FA0AAEAFB4EA6E1A519D93E5,39321,2,4,2,109.529,18.2167,1604
18364,142586,D626C213FA0AAEAFB4EA6E1A519D93E5,31521,4,8,4,109.51458,18.22542,1555
18365,142587,D626C213FA0AAEAFB4EA6E1A519D93E5,39321,8,9,1,109.529,18.2167,1604
18366,142588,D626C213FA0AAEAFB4EA6E1A519D93E5,31521,11,12,1,109.51458,18.22542,1555
18367,142589,D626C213FA0AAEAFB4EA6E1A519D93E5,60381,12,13,1,109.5241,18.22458,1605
18368,142590,D626C213FA0AAEAFB4EA6E1A519D93E5,39321,14,15,1,109.529,18.2167,1604
18369,142591,D626C213FA0AAEAFB4EA6E1A519D93E5,31521,15,17,2,109.51458,18.22542,1555
18370,142609,452F0FF6BC36839041DCBEF2292D6E55,30151,13,15,2,109.50986,18.25083,1560
18371,142610,452F0FF6BC36839041DCBEF2292D6E55,60661,20,21,1,109.548,18.2377,1657
18372,142611,9DC42534658C1F6AF8E261B5948D5230,38903,3,7,4,109.39229,18.29243,1117
18373,142612,9DC42534658C1F6AF8E261B5948D5230,38325,8,9,1,109.39792,18.2909,1116
18374,142613,9DC42534658C1F6AF8E261B5948D5230,31801,11,13,2,109.20417,18.32118,371
18375,142614,9DC42534658C1F6AF8E261B5948D5230,31471,13,14,1,109.34583,18.29563,917
18376,142615,9DC42534658C1F6AF8E261B5948D5230,30361,16,22,6,109.50347,18.24,1508
18377,142644,C462628FF36F8FF2D0B7493E6DDA38BB,30661,3,11,8,109.37028,18.24361,1008
18378,142645,C462628FF36F8FF2D0B7493E6DDA38BB,60411,11,14,3,109.32514,18.30854,869
18379,142646,C462628FF36F8FF2D0B7493E6DDA38BB,30661,15,21,6,109.37028,18.24361,1008
18380,142682,C17A8098B013F904BD9DA05D90234A30,31071,11,13,2,109.58257,18.28458,1815
18381,142683,C17A8098B013F904BD9DA05D90234A30,30711,14,15,1,109.50271,18.25347,1510
18388,142787,C58D0182BFC61ED113EE3B09763C30B2,38157,0,16,16,109.51483,18.26958,1563
18389,142788,C58D0182BFC61ED113EE3B09763C30B2,38185,19,23,4,109.51333,18.27347,1563
18390,142826,9352766CE000C006A9C46226806783DB,31561,1,7,6,109.56792,18.28479,1765
18391,142827,9352766CE000C006A9C46226806783DB,30031,9,16,7,109.53681,18.33313,1673
18392,142828,9352766CE000C006A9C46226806783DB,31561,18,19,1,109.56792,18.28479,1765
18393,142913,E872AA2C9381997C1534BFD4E63418EE,31461,0,6,6,109.5091,18.25389,1510
18394,142914,E872AA2C9381997C1534BFD4E63418EE,30711,6,7,1,109.50271,18.25347,1510
18395,142915,E872AA2C9381997C1534BFD4E63418EE,31081,8,9,1,109.44639,18.30181,1318
18396,142916,E872AA2C9381997C1534BFD4E63418EE,38094,17,18,1,109.45403,18.28778,1316
18397,142917,E872AA2C9381997C1534BFD4E63418EE,31461,20,23,3,109.5091,18.25389,1510
18398,142955,2461E97B3A29F94DA6EAE9F74EF592A3,30211,17,20,3,109.49882,18.23931,1508
18399,142956,2461E97B3A29F94DA6EAE9F74EF592A3,30211,21,23,2,109.49882,18.23931,1508
18400,142964,E649CF84A26278291AA1A5B5C5D01FCA,30854,0,8,8,109.56889,18.27076,1763
18401,142965,E649CF84A26278291AA1A5B5C5D01FCA,31561,9,10,1,109.56792,18.28479,1765
18402,142966,E649CF84A26278291AA1A5B5C5D01FCA,38171,11,12,1,109.50799,18.28139,1515
18403,142967,E649CF84A26278291AA1A5B5C5D01FCA,31071,18,20,2,109.58257,18.28458,1815
18404,142968,E649CF84A26278291AA1A5B5C5D01FCA,30191,21,23,2,109.50361,18.22701,1506
18414,143044,A05C5224EBD39E4769ABC987F547C22B,31611,0,7,7,109.63076,18.34944,2026
18415,143045,A05C5224EBD39E4769ABC987F547C22B,30051,11,12,1,109.48917,18.21215,1453
18416,143046,A05C5224EBD39E4769ABC987F547C22B,38185,13,14,1,109.51333,18.27347,1563
18417,143047,A05C5224EBD39E4769ABC987F547C22B,30281,15,17,2,109.50597,18.27583,1514
18418,143048,A05C5224EBD39E4769ABC987F547C22B,31611,18,23,5,109.63076,18.34944,2026
18419,143059,6C0260646767B781577B5B8CE2471E51,30561,0,3,3,109.52778,18.31938,1621
18420,143060,6C0260646767B781577B5B8CE2471E51,38484,3,23,20,109.53028,18.31528,1620
18421,143071,52626520133C58C019E9712FB19D3224,30511,19,20,1,109.51069,18.24208,1558
18422,143072,52626520133C58C019E9712FB19D3224,38171,22,23,1,109.50799,18.28139,1515
18423,143133,63B5E489F3503F8EC6E40A38F9D2117C,31951,10,12,2,109.52174,18.30299,1568
18424,143134,63B5E489F3503F8EC6E40A38F9D2117C,60171,13,17,4,109.51292,18.30694,1569
18425,143135,63B5E489F3503F8EC6E40A38F9D2117C,31951,21,22,1,109.52174,18.30299,1568
18426,143173,FAC035CAF00431CACD74AF53D18C4996,30111,0,5,5,109.47583,18.30542,1419
18427,143174,FAC035CAF00431CACD74AF53D18C4996,30764,7,12,5,109.45806,18.29486,1367
18428,143175,FAC035CAF00431CACD74AF53D18C4996,60011,12,13,1,109.48965,18.30222,1468
18429,143176,FAC035CAF00431CACD74AF53D18C4996,30764,14,18,4,109.45806,18.29486,1367
18430,143177,FAC035CAF00431CACD74AF53D18C4996,60011,22,23,1,109.48965,18.30222,1468
18431,143256,BB6A9729DE557ADD6D3E7E09F28116DB,60281,13,15,2,109.51743,18.25924,1561
18432,143257,BB6A9729DE557ADD6D3E7E09F28116DB,31031,15,18,3,109.49979,18.25382,1510
18433,143258,BB6A9729DE557ADD6D3E7E09F28116DB,60081,20,21,1,109.51097,18.22639,1556
18437,143307,B2035C0684FF9CA861B7EB217CE5A160,31473,12,17,5,109.34792,18.29465,917
18438,143308,B2035C0684FF9CA861B7EB217CE5A160,60552,18,19,1,109.41729,18.30014,1218
18439,143309,B2035C0684FF9CA861B7EB217CE5A160,60041,20,21,1,109.39889,18.31944,1121
18443,143336,ABFA7703F593D5D792FA2E32D1AEB9E3,60351,0,9,9,109.58403,18.28958,1816
18444,143337,ABFA7703F593D5D792FA2E32D1AEB9E3,31021,9,11,2,109.49021,18.27,1463
18445,143338,ABFA7703F593D5D792FA2E32D1AEB9E3,30771,12,13,1,109.49938,18.26042,1511
18446,143340,ABFA7703F593D5D792FA2E32D1AEB9E3,60351,20,23,3,109.58403,18.28958,1816
18447,143349,FE95B3A32EFBC2838F293DF38F55FDD1,31561,16,18,2,109.56792,18.28479,1765
18448,143350,FE95B3A32EFBC2838F293DF38F55FDD1,39183,18,23,5,109.55542,18.28208,1715
18449,143369,FD9120CA3F85D3F015CEFB66B9BF2F3D,30721,0,15,15,109.51597,18.28257,1565
18450,143370,FD9120CA3F85D3F015CEFB66B9BF2F3D,60301,17,19,2,109.60715,18.30993,1919
18451,143371,FD9120CA3F85D3F015CEFB66B9BF2F3D,30721,21,23,2,109.51597,18.28257,1565
18456,143431,E8BAAF476E8FE57075BAB1A8D4FF1780,30232,0,4,4,109.6191,18.31701,1971
18457,143432,E8BAAF476E8FE57075BAB1A8D4FF1780,39371,8,22,14,109.56627,18.2646,1762
18458,143449,30CE72A519D49881F23B8123486E3A02,60054,0,6,6,109.3016,18.31229,770
18459,143450,30CE72A519D49881F23B8123486E3A02,31851,8,11,3,109.71736,18.29007,2316
18460,143451,30CE72A519D49881F23B8123486E3A02,60411,12,15,3,109.32514,18.30854,869
18461,143511,9A1D1AA5EE2CD156CC396C667ED8C5B9,31071,0,6,6,109.58257,18.28458,1815
18462,143512,9A1D1AA5EE2CD156CC396C667ED8C5B9,30854,10,18,8,109.56889,18.27076,1763
18463,143513,9A1D1AA5EE2CD156CC396C667ED8C5B9,31041,19,23,4,109.50278,18.23701,1507
18464,143534,BAF784C90E903A1C0CEDF594F05C3F50,38171,0,13,13,109.50799,18.28139,1515
18465,143535,BAF784C90E903A1C0CEDF594F05C3F50,60661,15,16,1,109.548,18.2377,1657
18466,143536,BAF784C90E903A1C0CEDF594F05C3F50,30121,20,23,3,109.52861,18.27222,1613
18467,143574,798BF3B08F72A16A6DEAAA235F1899BB,61011,0,8,8,109.60653,18.19076,1900
18468,143576,798BF3B08F72A16A6DEAAA235F1899BB,61011,22,23,1,109.60653,18.19076,1900
18469,143595,0D48FD835B207ED202CAB110B7436DC2,30151,18,20,2,109.50986,18.25083,1560
18470,143596,0D48FD835B207ED202CAB110B7436DC2,30854,20,23,3,109.56889,18.27076,1763
18471,143652,6A36867DD00EFE141723506DB0350D1F,38321,0,9,9,109.39854,18.29132,1116
18472,143653,6A36867DD00EFE141723506DB0350D1F,60054,11,14,3,109.3016,18.31229,770
18473,143654,6A36867DD00EFE141723506DB0350D1F,38251,16,18,2,109.49618,18.25493,1510
18474,143655,6A36867DD00EFE141723506DB0350D1F,38321,19,23,4,109.39854,18.29132,1116
18478,143716,91F59FD84A5A011AF1877621EDB85B69,39183,0,8,8,109.55542,18.28208,1715
18479,143717,91F59FD84A5A011AF1877621EDB85B69,30854,8,10,2,109.56889,18.27076,1763
18480,143718,91F59FD84A5A011AF1877621EDB85B69,60341,11,13,2,109.70597,18.31778,2271
18481,143749,7E2EA58FE60AC1C253C1CC188337CCC8,31521,21,23,2,109.51458,18.22542,1555
18482,143771,FC9B7FD2465F862BBF1D529A5948B21C,60161,0,10,10,109.49174,18.26181,1461
18483,143773,FC9B7FD2465F862BBF1D529A5948B21C,30201,18,23,5,109.4909,18.26465,1462
18484,143774,9B979E9430BCD0DDB6C78BBE525EBD2D,60631,0,2,2,109.57778,18.27583,1814
18485,143775,9B979E9430BCD0DDB6C78BBE525EBD2D,30854,2,3,1,109.56889,18.27076,1763
18486,143776,9B979E9430BCD0DDB6C78BBE525EBD2D,60631,5,6,1,109.57778,18.27583,1814
18487,143777,9B979E9430BCD0DDB6C78BBE525EBD2D,30854,8,18,10,109.56889,18.27076,1763
18488,143778,9B979E9430BCD0DDB6C78BBE525EBD2D,39371,21,22,1,109.56627,18.2646,1762
18492,143854,0E2E791F47920A60A5F7E41FFDC79CF5,31071,17,23,6,109.58257,18.28458,1815
18493,143875,084391752080FAB778036174C9E3D4FE,31171,0,20,20,109.50938,18.24917,1559
18494,143876,084391752080FAB778036174C9E3D4FE,30151,21,23,2,109.50986,18.25083,1560
18495,143880,7F632B4875B2736225CD6D350CD25670,60631,9,10,1,109.57778,18.27583,1814
18496,143881,7F632B4875B2736225CD6D350CD25670,31071,10,12,2,109.58257,18.28458,1815
18497,143882,7F632B4875B2736225CD6D350CD25670,30854,15,21,6,109.56889,18.27076,1763
18498,143889,4552AE0C0FB78BA3063EBA5C903C87F0,31421,0,7,7,109.55382,18.22347,1705
18499,143890,4552AE0C0FB78BA3063EBA5C903C87F0,60171,11,12,1,109.51292,18.30694,1569
18500,143891,4552AE0C0FB78BA3063EBA5C903C87F0,30361,13,14,1,109.50347,18.24,1508
18501,143892,4552AE0C0FB78BA3063EBA5C903C87F0,31421,14,18,4,109.55382,18.22347,1705
18502,143893,4552AE0C0FB78BA3063EBA5C903C87F0,60661,22,23,1,109.548,18.2377,1657
18503,143925,DAEBC1B20700AEACAB1016AEE13DF8AE,60411,0,15,15,109.32514,18.30854,869
18504,143926,DAEBC1B20700AEACAB1016AEE13DF8AE,30901,19,22,3,109.27597,18.3134,670
18505,143935,45D6FEED987FF96C23D5532C0D645AC3,30291,2,4,2,109.50403,18.27028,1513
18506,143936,45D6FEED987FF96C23D5532C0D645AC3,38127,6,23,17,109.50833,18.27222,1513
18514,143985,2D0506173E3FD672D1B56E46B7843F5D,60131,2,8,6,109.49819,18.24778,1509
18515,143986,2D0506173E3FD672D1B56E46B7843F5D,30361,13,14,1,109.50347,18.24,1508
18516,143987,2D0506173E3FD672D1B56E46B7843F5D,31231,15,18,3,109.42597,18.29292,1217
18517,143988,2D0506173E3FD672D1B56E46B7843F5D,60552,18,20,2,109.41729,18.30014,1218
18526,144017,860C13CBFA013D0236AC6B4CB1CB4DEE,31931,3,4,1,109.54771,18.29403,1667
18527,144018,860C13CBFA013D0236AC6B4CB1CB4DEE,30324,6,8,2,109.50326,18.29257,1517
18528,144019,860C13CBFA013D0236AC6B4CB1CB4DEE,31461,10,14,4,109.5091,18.25389,1510
18529,144020,860C13CBFA013D0236AC6B4CB1CB4DEE,30721,17,18,1,109.51597,18.28257,1565
18530,144037,BAC047B6079E6BEA7B1F8943C9D7A733,30854,0,12,12,109.56889,18.27076,1763
18531,144038,BAC047B6079E6BEA7B1F8943C9D7A733,31071,16,22,6,109.58257,18.28458,1815
18532,144061,E8DB631088E68D5FF25F35789654CC79,60344,0,2,2,109.68847,18.31931,2221
18533,144062,E8DB631088E68D5FF25F35789654CC79,38171,4,7,3,109.50799,18.28139,1515
18534,144063,E8DB631088E68D5FF25F35789654CC79,38336,9,10,1,109.61111,18.21806,1904
18535,144064,E8DB631088E68D5FF25F35789654CC79,30931,11,13,2,109.55653,18.32722,1722
18536,144065,E8DB631088E68D5FF25F35789654CC79,30711,14,15,1,109.50271,18.25347,1510
18537,144087,21654650140FAEB6349280DE7F7F6D8E,30891,15,16,1,109.59431,18.28389,1865
18538,144088,21654650140FAEB6349280DE7F7F6D8E,30854,17,18,1,109.56889,18.27076,1763
18539,144089,21654650140FAEB6349280DE7F7F6D8E,30891,21,22,1,109.59431,18.28389,1865
18540,144096,55CDDB1A84A2F40D42C80C17393C28FB,38951,16,19,3,109.48097,18.28868,1416
18541,144097,55CDDB1A84A2F40D42C80C17393C28FB,38951,19,23,4,109.48097,18.28868,1416
18542,144100,BD38467346E00D9FC913492A38FA335E,31071,0,14,14,109.58257,18.28458,1815
18543,144101,BD38467346E00D9FC913492A38FA335E,30861,17,18,1,109.52722,18.22743,1606
18544,144106,D5F511343821CDCEF81ED534E668B0E7,30051,11,12,1,109.48917,18.21215,1453
18545,144107,D5F511343821CDCEF81ED534E668B0E7,30271,14,16,2,109.49132,18.23153,1456
18546,144108,D5F511343821CDCEF81ED534E668B0E7,30051,16,22,6,109.48917,18.21215,1453
18550,144150,066CC6CBB5ADF978A93AF5D0C3292806,60371,0,1,1,109.53063,18.30056,1618
18551,144151,066CC6CBB5ADF978A93AF5D0C3292806,31931,4,23,19,109.54771,18.29403,1667
18552,144230,46D10B971C10D2856504DC61068F66E7,60221,0,9,9,109.52569,18.29188,1616
18553,144231,46D10B971C10D2856504DC61068F66E7,31091,13,15,2,109.41201,18.31222,1170
18554,144288,7C68E1F4B8B2F3CBBD5427BF66BF9C2E,30581,11,12,1,109.62257,18.24951,1959
18555,144289,7C68E1F4B8B2F3CBBD5427BF66BF9C2E,31571,15,17,2,109.61563,18.23326,1957
18556,144290,7C68E1F4B8B2F3CBBD5427BF66BF9C2E,30891,19,20,1,109.59431,18.28389,1865
18557,144295,FF4FFCE42CAA120B76F0E344A1E34B45,31471,13,15,2,109.34583,18.29563,917
18558,144296,FF4FFCE42CAA120B76F0E344A1E34B45,31271,18,19,1,109.48958,18.26257,1462
18559,144297,FF4FFCE42CAA120B76F0E344A1E34B45,60391,20,23,3,109.47667,18.28757,1416
18566,144375,BD5D5103B08534F20AF53FB58E9A43CA,60371,18,20,2,109.53063,18.30056,1618
18567,144376,BD5D5103B08534F20AF53FB58E9A43CA,31931,21,23,2,109.54771,18.29403,1667
18568,144377,246EF4D95FA494895EFB2D649512DAE7,60081,0,7,7,109.51097,18.22639,1556
18569,144378,246EF4D95FA494895EFB2D649512DAE7,61011,8,16,8,109.60653,18.19076,1900
18570,144380,246EF4D95FA494895EFB2D649512DAE7,31521,20,23,3,109.51458,18.22542,1555
18571,144384,C97A61E87ADF22CB0CED7FFED3A35BC3,30851,14,16,2,109.5616,18.27396,1713
18572,144385,C97A61E87ADF22CB0CED7FFED3A35BC3,30951,20,23,3,109.56208,18.25667,1761
18573,144398,080247CC19405F981D4BEFE1A1E9D339,31931,0,3,3,109.54771,18.29403,1667
18574,144399,080247CC19405F981D4BEFE1A1E9D339,39181,3,4,1,109.55153,18.28035,1715
18575,144400,080247CC19405F981D4BEFE1A1E9D339,31931,5,7,2,109.54771,18.29403,1667
18576,144401,080247CC19405F981D4BEFE1A1E9D339,39181,11,14,3,109.55153,18.28035,1715
18577,144402,080247CC19405F981D4BEFE1A1E9D339,31931,19,22,3,109.54771,18.29403,1667
18578,144412,372A5433078073EAD18922D679CE0A73,60411,1,2,1,109.32514,18.30854,869
18579,144413,372A5433078073EAD18922D679CE0A73,60054,3,17,14,109.3016,18.31229,770
18580,144414,372A5433078073EAD18922D679CE0A73,30661,19,20,1,109.37028,18.24361,1008
18581,144415,372A5433078073EAD18922D679CE0A73,60411,21,22,1,109.32514,18.30854,869
18582,144461,120AF04D254D2FF4D02F1F05C67DC087,60221,18,21,3,109.52569,18.29188,1616
18583,144462,120AF04D254D2FF4D02F1F05C67DC087,38251,22,23,1,109.49618,18.25493,1510
18584,144472,4316F4C2A6A1B3B05695481348115DEA,31421,0,2,2,109.55382,18.22347,1705
18585,144473,4316F4C2A6A1B3B05695481348115DEA,60381,3,4,1,109.5241,18.22458,1605
18586,144474,4316F4C2A6A1B3B05695481348115DEA,31145,9,11,2,109.20431,18.30479,369
18587,144475,4316F4C2A6A1B3B05695481348115DEA,31781,11,12,1,109.19847,18.2975,367
18588,144476,4316F4C2A6A1B3B05695481348115DEA,60281,19,21,2,109.51743,18.25924,1561
18589,144477,4316F4C2A6A1B3B05695481348115DEA,31421,21,23,2,109.55382,18.22347,1705
18590,144636,D4EE8E1A4C04A1FF0596E4221D0B8B42,31071,0,8,8,109.58257,18.28458,1815
18591,144637,D4EE8E1A4C04A1FF0596E4221D0B8B42,30854,8,12,4,109.56889,18.27076,1763
18592,144638,D4EE8E1A4C04A1FF0596E4221D0B8B42,31071,12,13,1,109.58257,18.28458,1815
18593,144639,D4EE8E1A4C04A1FF0596E4221D0B8B42,30854,17,18,1,109.56889,18.27076,1763
18594,144640,D4EE8E1A4C04A1FF0596E4221D0B8B42,31461,19,21,2,109.5091,18.25389,1510
18595,144641,D4EE8E1A4C04A1FF0596E4221D0B8B42,31071,22,23,1,109.58257,18.28458,1815
18596,144670,5A888DC7A3AA300CC584D9862C5384A1,30421,0,6,6,109.50021,18.25861,1511
18597,144671,5A888DC7A3AA300CC584D9862C5384A1,39183,8,12,4,109.55542,18.28208,1715
18598,144672,5A888DC7A3AA300CC584D9862C5384A1,39181,12,13,1,109.55153,18.28035,1715
18599,144673,5A888DC7A3AA300CC584D9862C5384A1,39183,14,17,3,109.55542,18.28208,1715
18600,144674,5A888DC7A3AA300CC584D9862C5384A1,30771,20,21,1,109.49938,18.26042,1511
18601,144675,5A888DC7A3AA300CC584D9862C5384A1,30421,21,23,2,109.50021,18.25861,1511
18605,144695,45FC4D7B7AEB1BB8222449DDC064C06B,31945,0,16,16,109.58021,18.29403,1817
18606,144696,45FC4D7B7AEB1BB8222449DDC064C06B,31031,19,20,1,109.49979,18.25382,1510
18607,144697,45FC4D7B7AEB1BB8222449DDC064C06B,60291,20,22,2,109.50826,18.24639,1509
18608,144735,8CF08DEE8EF83AC7333B837D79034776,38121,0,10,10,109.51361,18.27813,1564
18609,144736,8CF08DEE8EF83AC7333B837D79034776,31531,12,20,8,109.49583,18.25972,1461
18610,144794,5127AAE654D4D4E9D3B44D4B22E94180,31071,0,15,15,109.58257,18.28458,1815
18611,144795,5127AAE654D4D4E9D3B44D4B22E94180,30854,16,17,1,109.56889,18.27076,1763
18612,144801,9B389AE8E9B004176803CCEAFF69104A,60631,7,9,2,109.57778,18.27583,1814
18613,144802,9B389AE8E9B004176803CCEAFF69104A,31071,9,13,4,109.58257,18.28458,1815
18614,144803,9B389AE8E9B004176803CCEAFF69104A,60631,13,22,9,109.57778,18.27583,1814
18615,144810,302C193EE9901423C2412C2BB087FCC7,30351,7,9,2,109.41701,18.29292,1217
18616,144811,302C193EE9901423C2412C2BB087FCC7,30861,13,21,8,109.52722,18.22743,1606
18617,144812,302C193EE9901423C2412C2BB087FCC7,31091,22,23,1,109.41201,18.31222,1170
18618,144860,EDA7FD9B0EED945E31B5E28BA44B79A6,30084,0,8,8,109.50118,18.26972,1513
18619,144861,EDA7FD9B0EED945E31B5E28BA44B79A6,30084,13,15,2,109.50118,18.26972,1513
18620,144871,283E90F84EEBCE43BF6B6D42BDFBC3E7,39111,0,9,9,109.5191,18.22597,1555
18621,144872,283E90F84EEBCE43BF6B6D42BDFBC3E7,31471,12,16,4,109.34583,18.29563,917
18622,144873,283E90F84EEBCE43BF6B6D42BDFBC3E7,39111,20,23,3,109.5191,18.22597,1555
18627,144911,7B35A311846C912B678B880E5F54AFB9,31231,0,5,5,109.42597,18.29292,1217
18628,144912,7B35A311846C912B678B880E5F54AFB9,31231,6,12,6,109.42597,18.29292,1217
18629,144913,7B35A311846C912B678B880E5F54AFB9,30854,14,18,4,109.56889,18.27076,1763
18630,144914,7B35A311846C912B678B880E5F54AFB9,31071,19,22,3,109.58257,18.28458,1815
18631,144921,0E47EABA6E2AA714B8511218BE042510,30854,0,10,10,109.56889,18.27076,1763
18635,144972,4714721B3653AF0BFB4036AA672A88A7,31231,11,12,1,109.42597,18.29292,1217
18636,144973,4714721B3653AF0BFB4036AA672A88A7,30854,14,19,5,109.56889,18.27076,1763
18637,144974,4714721B3653AF0BFB4036AA672A88A7,31071,19,21,2,109.58257,18.28458,1815
18638,144975,4714721B3653AF0BFB4036AA672A88A7,30854,22,23,1,109.56889,18.27076,1763
18639,145013,1C67859AC074D33800F75471EB5E573E,31071,0,2,2,109.58257,18.28458,1815
18640,145014,1C67859AC074D33800F75471EB5E573E,30854,2,4,2,109.56889,18.27076,1763
18641,145015,1C67859AC074D33800F75471EB5E573E,31071,6,7,1,109.58257,18.28458,1815
18642,145016,1C67859AC074D33800F75471EB5E573E,30854,10,11,1,109.56889,18.27076,1763
18643,145017,1C67859AC074D33800F75471EB5E573E,31071,15,17,2,109.58257,18.28458,1815
18644,145018,1C67859AC074D33800F75471EB5E573E,30854,17,20,3,109.56889,18.27076,1763
18648,145133,8621CFDF1B89A83351494618C53D033F,39181,1,2,1,109.55153,18.28035,1715
18649,145134,8621CFDF1B89A83351494618C53D033F,31071,4,6,2,109.58257,18.28458,1815
18650,145135,8621CFDF1B89A83351494618C53D033F,39181,6,12,6,109.55153,18.28035,1715
18651,145136,8621CFDF1B89A83351494618C53D033F,39181,13,15,2,109.55153,18.28035,1715
18652,145137,8621CFDF1B89A83351494618C53D033F,39181,15,22,7,109.55153,18.28035,1715
18656,145150,CAA77ED111F233A95D550D9E8F270524,30351,18,20,2,109.41701,18.29292,1217
18657,145151,CAA77ED111F233A95D550D9E8F270524,30351,21,23,2,109.41701,18.29292,1217
18658,145194,F6A539AAED9AF63EFFEF4F07EA46DEF3,60621,0,6,6,109.48354,18.27451,1464
18659,145195,F6A539AAED9AF63EFFEF4F07EA46DEF3,31781,9,15,6,109.19847,18.2975,367
18660,145196,F6A539AAED9AF63EFFEF4F07EA46DEF3,60541,19,21,2,109.4084,18.29208,1167
18661,145202,613C19D70986B2841FFE30ACA302B5BF,31781,10,12,2,109.19847,18.2975,367
18662,145203,613C19D70986B2841FFE30ACA302B5BF,30241,13,14,1,109.26174,18.3275,622
18663,145204,613C19D70986B2841FFE30ACA302B5BF,30764,16,21,5,109.45806,18.29486,1367
18664,145205,22B987DE38F8C4435934FE5E6190C4A2,30441,9,10,1,109.64021,18.25424,2010
18665,145206,22B987DE38F8C4435934FE5E6190C4A2,30581,12,14,2,109.62257,18.24951,1959
18666,145207,22B987DE38F8C4435934FE5E6190C4A2,30441,14,17,3,109.64021,18.25424,2010
18673,145323,8B3125BACE32612AE7F9DC5599DC75E6,30661,13,18,5,109.37028,18.24361,1008
18674,145324,8B3125BACE32612AE7F9DC5599DC75E6,30191,19,20,1,109.50361,18.22701,1506
18675,145325,8B3125BACE32612AE7F9DC5599DC75E6,30731,20,23,3,109.50944,18.22306,1555
18676,145406,EB316856896788EC8FD871E122E95728,30701,0,1,1,109.59313,18.32007,1871
18677,145407,EB316856896788EC8FD871E122E95728,31811,2,10,8,109.54201,18.31806,1671
18678,145408,EB316856896788EC8FD871E122E95728,30701,11,14,3,109.59313,18.32007,1871
18679,145409,EB316856896788EC8FD871E122E95728,31811,14,15,1,109.54201,18.31806,1671
18680,145410,EB316856896788EC8FD871E122E95728,30701,16,23,7,109.59313,18.32007,1871
18684,145532,FA6D7510012E571D09E23E75BE9DD4E6,38094,0,3,3,109.45403,18.28778,1316
18685,145533,FA6D7510012E571D09E23E75BE9DD4E6,30111,4,5,1,109.47583,18.30542,1419
18686,145534,FA6D7510012E571D09E23E75BE9DD4E6,60441,5,6,1,109.46792,18.28604,1366
18687,145535,FA6D7510012E571D09E23E75BE9DD4E6,31781,11,15,4,109.19847,18.2975,367
18688,145536,FA6D7510012E571D09E23E75BE9DD4E6,31781,15,16,1,109.19847,18.2975,367
18689,145569,9BB39A24BC97A0FBACA2CD185E234B22,31681,9,10,1,109.40396,18.29979,1168
18690,145570,9BB39A24BC97A0FBACA2CD185E234B22,38105,14,18,4,109.40299,18.29229,1117
18691,145571,9BB39A24BC97A0FBACA2CD185E234B22,38127,19,20,1,109.50833,18.27222,1513
18692,145579,D5ED0B56415F07DD214B0DC3E9293672,30854,17,18,1,109.56889,18.27076,1763
18693,145580,D5ED0B56415F07DD214B0DC3E9293672,39371,21,22,1,109.56627,18.2646,1762
18694,145611,706B8E0F0F5D1C9FC2F8EBB2574EE89F,30711,0,4,4,109.50271,18.25347,1510
18695,145612,706B8E0F0F5D1C9FC2F8EBB2574EE89F,31461,5,7,2,109.5091,18.25389,1510
18696,145613,706B8E0F0F5D1C9FC2F8EBB2574EE89F,30711,7,13,6,109.50271,18.25347,1510
18697,145614,706B8E0F0F5D1C9FC2F8EBB2574EE89F,60131,14,15,1,109.49819,18.24778,1509
18698,145615,706B8E0F0F5D1C9FC2F8EBB2574EE89F,60201,18,20,2,109.5041,18.2509,1510
18702,145731,5C8B80BEC63DDEFB9892A030CF73AEB3,31071,16,23,7,109.58257,18.28458,1815
18703,145737,5264833F0013AE6B294396000613EF89,30361,15,16,1,109.50347,18.24,1508
18704,145738,5264833F0013AE6B294396000613EF89,38881,19,22,3,109.51618,18.26431,1562
18705,145794,50942B7AD3E1DC9B7C014E537BF17F88,31391,0,6,6,109.50382,18.24285,1508
18706,145795,50942B7AD3E1DC9B7C014E537BF17F88,31521,8,9,1,109.51458,18.22542,1555
18707,145796,50942B7AD3E1DC9B7C014E537BF17F88,33051,12,15,3,109.6475,18.46618,2096
18708,145797,50942B7AD3E1DC9B7C014E537BF17F88,31521,18,22,4,109.51458,18.22542,1555
18709,145824,8F0B95EE20D5923AECD1F781FE6A4D19,60054,12,23,11,109.3016,18.31229,770
18717,145860,7B1A07C39637E996C01DF0A3D287D3C6,30854,15,18,3,109.56889,18.27076,1763
18718,145861,7B1A07C39637E996C01DF0A3D287D3C6,31071,18,19,1,109.58257,18.28458,1815
18719,145862,7B1A07C39637E996C01DF0A3D287D3C6,30854,19,22,3,109.56889,18.27076,1763
18723,145903,0312B43ACF9ED1D8304E325E851AEE29,31561,7,10,3,109.56792,18.28479,1765
18724,145904,0312B43ACF9ED1D8304E325E851AEE29,30851,10,12,2,109.5616,18.27396,1713
18725,145905,0312B43ACF9ED1D8304E325E851AEE29,31561,14,18,4,109.56792,18.28479,1765
18726,145906,0312B43ACF9ED1D8304E325E851AEE29,30851,18,21,3,109.5616,18.27396,1713
18730,145981,B6DAE56480B5807A4F8E22B536AE66D4,31761,0,3,3,109.60521,18.27965,1914
18731,145982,B6DAE56480B5807A4F8E22B536AE66D4,31071,3,4,1,109.58257,18.28458,1815
18732,145983,B6DAE56480B5807A4F8E22B536AE66D4,30854,8,12,4,109.56889,18.27076,1763
18733,145984,B6DAE56480B5807A4F8E22B536AE66D4,31561,14,16,2,109.56792,18.28479,1765
18734,145985,B6DAE56480B5807A4F8E22B536AE66D4,31071,17,20,3,109.58257,18.28458,1815
18735,146071,4EEB87EFD2F33BBAF42BE530271C40CA,31161,15,16,1,109.70229,18.31361,2270
18736,146073,4EEB87EFD2F33BBAF42BE530271C40CA,31161,20,23,3,109.70229,18.31361,2270
18737,146093,18DB7A828EB46A46D7669F7F83E646D2,31071,16,18,2,109.58257,18.28458,1815
18738,146094,18DB7A828EB46A46D7669F7F83E646D2,38071,19,20,1,109.40722,18.30938,1169
18739,146167,F3CB7C11E7F651A3E5E683B713A65912,30531,0,8,8,109.53271,18.21472,1604
18740,146168,F3CB7C11E7F651A3E5E683B713A65912,31781,12,13,1,109.19847,18.2975,367
18741,146169,F3CB7C11E7F651A3E5E683B713A65912,60221,15,17,2,109.52569,18.29188,1616
18742,146170,F3CB7C11E7F651A3E5E683B713A65912,30531,20,22,2,109.53271,18.21472,1604
18743,146176,CA3896FB33E9BC68E91955EDFF5D709B,30854,14,16,2,109.56889,18.27076,1763
18744,146177,CA3896FB33E9BC68E91955EDFF5D709B,31761,19,20,1,109.60521,18.27965,1914
18745,146178,CA3896FB33E9BC68E91955EDFF5D709B,30854,21,22,1,109.56889,18.27076,1763
18757,146238,DE5024DB59D5BF6AE5857A85EB7680EA,30281,19,20,1,109.50597,18.27583,1514
18758,146239,DE5024DB59D5BF6AE5857A85EB7680EA,38185,20,22,2,109.51333,18.27347,1563
18763,146375,25419DDF60017295279E872003D6F9C0,60501,17,23,6,109.48701,18.29021,1466
18764,146396,E292D83051830D054E89D209EEABA4B9,30854,1,5,4,109.56889,18.27076,1763
18765,146397,E292D83051830D054E89D209EEABA4B9,31561,9,21,12,109.56792,18.28479,1765
18766,146408,886165CD4CCF3674607C202B8ADD28B5,31221,14,15,1,109.61333,18.26833,1913
18767,146409,886165CD4CCF3674607C202B8ADD28B5,38052,16,18,2,109.62618,18.23042,1956
18768,146428,6AF6E3AFD18EC04099B3351F858D9C1A,31031,14,16,2,109.49979,18.25382,1510
18769,146429,6AF6E3AFD18EC04099B3351F858D9C1A,30421,17,18,1,109.50021,18.25861,1511
18770,146430,6AF6E3AFD18EC04099B3351F858D9C1A,38251,18,20,2,109.49618,18.25493,1510
18771,146493,EF0AF6DFF11E792E87881ED5E6F91398,38154,0,6,6,109.5266,18.28278,1615
18772,146494,EF0AF6DFF11E792E87881ED5E6F91398,39183,7,8,1,109.55542,18.28208,1715
18773,146497,C93386A9D86FE22A1FD4E5116045DD8D,39183,13,17,4,109.55542,18.28208,1715
18774,146498,C93386A9D86FE22A1FD4E5116045DD8D,31561,22,23,1,109.56792,18.28479,1765
18775,146526,2B8C748A18FA7D08D4335AD7C9DEF01B,31761,0,7,7,109.60521,18.27965,1914
18776,146527,2B8C748A18FA7D08D4335AD7C9DEF01B,31551,11,14,3,109.55868,18.24222,1708
18777,146528,2B8C748A18FA7D08D4335AD7C9DEF01B,31761,18,23,5,109.60521,18.27965,1914
18778,146541,DED64374A4602648AE7C998119F6E01F,31421,0,6,6,109.55382,18.22347,1705
18779,146542,DED64374A4602648AE7C998119F6E01F,38261,8,12,4,109.50361,18.28153,1515
18780,146543,DED64374A4602648AE7C998119F6E01F,60171,13,14,1,109.51292,18.30694,1569
18781,146544,DED64374A4602648AE7C998119F6E01F,38261,14,17,3,109.50361,18.28153,1515
18782,146551,7DABBE2EA1D8427C873A3C78CE560DA5,30351,18,19,1,109.41701,18.29292,1217
18783,146552,7DABBE2EA1D8427C873A3C78CE560DA5,38141,20,21,1,109.39479,18.2916,1116
18787,146570,01C3A40E8C2D18FB80BE4CD2C78B4B61,30711,0,8,8,109.50271,18.25347,1510
18791,146705,0133DDFFB5CECBB261CEDEF10A82D50B,30854,0,6,6,109.56889,18.27076,1763
18792,146706,0133DDFFB5CECBB261CEDEF10A82D50B,31561,10,11,1,109.56792,18.28479,1765
18793,146715,B6AB556CC50BF965F5C24E069B82A8CD,60261,0,12,12,109.44326,18.3075,1319
18794,146716,B6AB556CC50BF965F5C24E069B82A8CD,38315,12,13,1,109.48979,18.29764,1467
18798,146784,209169FA99384242F6A8B020D13CF1D1,60594,0,6,6,109.62694,18.22799,1956
18799,146785,209169FA99384242F6A8B020D13CF1D1,38052,9,21,12,109.62618,18.23042,1956
18800,146810,5D4E252AC551D7DB97A6F7C764F981F2,38721,14,15,1,109.50368,18.27542,1514
18801,146811,5D4E252AC551D7DB97A6F7C764F981F2,30741,18,23,5,109.49833,18.28681,1516
18805,146860,E9F915B7CAC1919ECC27AEE8F91CE820,31031,19,20,1,109.49979,18.25382,1510
18806,146861,E9F915B7CAC1919ECC27AEE8F91CE820,60551,22,23,1,109.42722,18.30111,1218
18810,146867,451E2BF48CD7B253EB0892324E679BCC,60281,6,10,4,109.51743,18.25924,1561
18811,146868,451E2BF48CD7B253EB0892324E679BCC,38291,12,14,2,109.51618,18.24313,1558
18812,146869,451E2BF48CD7B253EB0892324E679BCC,60281,15,17,2,109.51743,18.25924,1561
18813,146870,451E2BF48CD7B253EB0892324E679BCC,38297,17,21,4,109.52576,18.24965,1609
18814,146871,451E2BF48CD7B253EB0892324E679BCC,31461,21,22,1,109.5091,18.25389,1510
18815,146898,32B282E0D9D6AD6484A59DFBF2B8EAC5,38105,0,11,11,109.40299,18.29229,1117
18816,146899,32B282E0D9D6AD6484A59DFBF2B8EAC5,31521,12,14,2,109.51458,18.22542,1555
18817,146900,32B282E0D9D6AD6484A59DFBF2B8EAC5,60541,15,17,2,109.4084,18.29208,1167
18818,146934,8883DF5E66B5FC284A8EF97DE8EAAAB3,31571,16,17,1,109.61563,18.23326,1957
18819,146935,8883DF5E66B5FC284A8EF97DE8EAAAB3,31071,20,22,2,109.58257,18.28458,1815
18823,146981,0E5593A90D661690BE3DAAA17AD936E2,30281,12,15,3,109.50597,18.27583,1514
18824,146982,0E5593A90D661690BE3DAAA17AD936E2,31271,19,21,2,109.48958,18.26257,1462
18825,147006,529A14F498129B0238F7B12A9FC7F6F7,30761,15,16,1,109.45201,18.3,1318
18826,147007,529A14F498129B0238F7B12A9FC7F6F7,60561,18,19,1,109.38229,18.29785,1067
18831,147034,09DBC2D12A2F2AE7770BC11D858FDC44,60131,17,19,2,109.49819,18.24778,1509
18832,147035,09DBC2D12A2F2AE7770BC11D858FDC44,38105,20,22,2,109.40299,18.29229,1117
18833,147064,866460FA5062A635337B6369BB2AADDA,31571,11,17,6,109.61563,18.23326,1957
18834,147065,866460FA5062A635337B6369BB2AADDA,30854,20,23,3,109.56889,18.27076,1763
18835,147074,68CF2FB8FE76D27AF8CCF53FD9DC9FD2,31431,0,8,8,109.44639,18.29042,1316
18836,147075,68CF2FB8FE76D27AF8CCF53FD9DC9FD2,38094,11,23,12,109.45403,18.28778,1316
18837,147079,C2622C284BAD8F487DCD454B3FAF9432,60361,0,6,6,109.51938,18.29681,1567
18838,147080,C2622C284BAD8F487DCD454B3FAF9432,30721,9,12,3,109.51597,18.28257,1565
18839,147081,C2622C284BAD8F487DCD454B3FAF9432,31121,13,21,8,109.16292,18.37063,230
18840,147089,905E2A0CDA32B9AB6A7856433550079B,31145,14,15,1,109.20431,18.30479,369
18841,147090,905E2A0CDA32B9AB6A7856433550079B,31431,16,18,2,109.44639,18.29042,1316
18842,147091,905E2A0CDA32B9AB6A7856433550079B,31351,21,23,2,109.4959,18.28417,1465
18846,147136,5AF85D9ED958D0E5348613692DAC5B4D,30771,0,7,7,109.49938,18.26042,1511
18850,147174,0E1B3CFC64EBB658DA96D0DCA834701E,61011,0,5,5,109.60653,18.19076,1900
18851,147176,0E1B3CFC64EBB658DA96D0DCA834701E,61011,12,17,5,109.60653,18.19076,1900
18856,147240,D39D64452E6BBEF7B3056CA239E1B86E,30851,0,1,1,109.5616,18.27396,1713
18857,147241,D39D64452E6BBEF7B3056CA239E1B86E,30854,2,6,4,109.56889,18.27076,1763
18858,147242,D39D64452E6BBEF7B3056CA239E1B86E,31561,6,8,2,109.56792,18.28479,1765
18859,147243,D39D64452E6BBEF7B3056CA239E1B86E,30854,13,14,1,109.56889,18.27076,1763
18860,147244,D39D64452E6BBEF7B3056CA239E1B86E,31561,14,16,2,109.56792,18.28479,1765
18861,147245,D39D64452E6BBEF7B3056CA239E1B86E,30854,17,23,6,109.56889,18.27076,1763
18865,147267,9DAE997BEB986F0CF4B419431BF5F5C1,60201,13,16,3,109.5041,18.2509,1510
18866,147268,9DAE997BEB986F0CF4B419431BF5F5C1,38111,18,20,2,109.52007,18.22403,1555
18867,147269,9DAE997BEB986F0CF4B419431BF5F5C1,60201,20,22,2,109.5041,18.2509,1510
18872,147357,1A1B5C664F8D6460240C73AB76187420,39091,18,19,1,109.50097,18.25222,1510
18873,147358,1A1B5C664F8D6460240C73AB76187420,31071,22,23,1,109.58257,18.28458,1815
18874,147426,0D61EA75C03A93303AE1706E6D1B22F4,30201,0,7,7,109.4909,18.26465,1462
18875,147427,0D61EA75C03A93303AE1706E6D1B22F4,38153,8,10,2,109.51819,18.25736,1561
18876,147428,0D61EA75C03A93303AE1706E6D1B22F4,31461,14,17,3,109.5091,18.25389,1510
18877,147429,0D61EA75C03A93303AE1706E6D1B22F4,60361,18,19,1,109.51938,18.29681,1567
18878,147430,0D61EA75C03A93303AE1706E6D1B22F4,30201,20,23,3,109.4909,18.26465,1462
18886,147502,B81C37BC332023335C0BA8EE3FC6F3B6,60221,16,17,1,109.52569,18.29188,1616
18887,147503,B81C37BC332023335C0BA8EE3FC6F3B6,38251,19,21,2,109.49618,18.25493,1510
18895,147575,530F0AE3A2D48DD91CDC3A17D13BA70F,38707,0,14,14,109.73778,18.35368,2427
18896,147576,530F0AE3A2D48DD91CDC3A17D13BA70F,38707,18,23,5,109.73778,18.35368,2427
18897,147612,89362A3CA3AE6F5B75871F2110924F99,30851,0,7,7,109.5616,18.27396,1713
18898,147613,89362A3CA3AE6F5B75871F2110924F99,30951,7,8,1,109.56208,18.25667,1761
18899,147614,89362A3CA3AE6F5B75871F2110924F99,31551,8,10,2,109.55868,18.24222,1708
18900,147615,89362A3CA3AE6F5B75871F2110924F99,30951,10,17,7,109.56208,18.25667,1761
18901,147616,89362A3CA3AE6F5B75871F2110924F99,30851,21,23,2,109.5616,18.27396,1713
18906,147686,32A9B525F749A542977BF021ED61F7D7,30151,0,2,2,109.50986,18.25083,1560
18907,147687,32A9B525F749A542977BF021ED61F7D7,30151,5,6,1,109.50986,18.25083,1560
18908,147688,32A9B525F749A542977BF021ED61F7D7,30371,7,10,3,109.51,18.24771,1559
18909,147689,32A9B525F749A542977BF021ED61F7D7,30151,11,16,5,109.50986,18.25083,1560
18910,147690,32A9B525F749A542977BF021ED61F7D7,30151,16,21,5,109.50986,18.25083,1560
18911,147729,7FF3C6569A3990C03CAF6C52D3C8BC6C,31931,15,17,2,109.54771,18.29403,1667
18912,147730,7FF3C6569A3990C03CAF6C52D3C8BC6C,60241,18,20,2,109.53319,18.28667,1616
18913,147764,AA2A5396AD753E9245AC53C94BAEDECD,61011,1,4,3,109.60653,18.19076,1900
18914,147766,AA2A5396AD753E9245AC53C94BAEDECD,61011,8,19,11,109.60653,18.19076,1900
18915,147768,9B4D51D619C13878F9CB21B880DF4E45,30761,1,6,5,109.45201,18.3,1318
18916,147769,9B4D51D619C13878F9CB21B880DF4E45,30111,6,11,5,109.47583,18.30542,1419
18917,147770,9B4D51D619C13878F9CB21B880DF4E45,60054,13,15,2,109.3016,18.31229,770
18925,147836,B8DD8B95F813909FEB8C25204CE776AE,31091,3,6,3,109.41201,18.31222,1170
18926,147837,B8DD8B95F813909FEB8C25204CE776AE,31231,7,12,5,109.42597,18.29292,1217
18927,147838,B8DD8B95F813909FEB8C25204CE776AE,30854,17,20,3,109.56889,18.27076,1763
18928,147839,B8DD8B95F813909FEB8C25204CE776AE,31071,21,22,1,109.58257,18.28458,1815
18929,147879,0F23B6E4E3B228AFE54C52B9B3D593D7,60551,1,5,4,109.42722,18.30111,1218
18930,147880,0F23B6E4E3B228AFE54C52B9B3D593D7,60524,5,10,5,109.42951,18.28993,1216
18931,147881,0F23B6E4E3B228AFE54C52B9B3D593D7,60551,14,17,3,109.42722,18.30111,1218
18932,147882,0F23B6E4E3B228AFE54C52B9B3D593D7,60524,18,19,1,109.42951,18.28993,1216
18933,147883,0F23B6E4E3B228AFE54C52B9B3D593D7,60551,21,23,2,109.42722,18.30111,1218
18937,147973,E4D6271627F68F0A6924319AF3674CF6,30324,0,9,9,109.50326,18.29257,1517
18938,147974,E4D6271627F68F0A6924319AF3674CF6,30921,10,12,2,109.53903,18.29451,1667
18939,148012,8E03A6760BDEE4B1D6F55B7F42573793,38094,0,7,7,109.45403,18.28778,1316
18940,148013,8E03A6760BDEE4B1D6F55B7F42573793,31781,11,12,1,109.19847,18.2975,367
18941,148014,8E03A6760BDEE4B1D6F55B7F42573793,60054,14,15,1,109.3016,18.31229,770
18942,148015,8E03A6760BDEE4B1D6F55B7F42573793,60221,16,18,2,109.52569,18.29188,1616
18943,148016,8E03A6760BDEE4B1D6F55B7F42573793,38094,21,23,2,109.45403,18.28778,1316
18944,148017,807332CEC38772FA8DF98C48FBD8DD1E,31561,6,15,9,109.56792,18.28479,1765
18945,148018,807332CEC38772FA8DF98C48FBD8DD1E,39183,16,18,2,109.55542,18.28208,1715
18946,148019,807332CEC38772FA8DF98C48FBD8DD1E,31561,18,20,2,109.56792,18.28479,1765
18947,148020,807332CEC38772FA8DF98C48FBD8DD1E,30851,20,23,3,109.5616,18.27396,1713
18948,148028,A549C024E6F63EDBD3DC866F10DB11CE,30234,0,6,6,109.60681,18.29979,1918
18949,148029,A549C024E6F63EDBD3DC866F10DB11CE,30854,10,21,11,109.56889,18.27076,1763
18950,148040,70A62761FE79F922D082380DA7747243,31561,0,6,6,109.56792,18.28479,1765
18951,148041,70A62761FE79F922D082380DA7747243,30854,6,21,15,109.56889,18.27076,1763
18952,148061,0F09C2BE6A190F4BF3D635D6A9F19FD3,31951,0,8,8,109.52174,18.30299,1568
18953,148062,0F09C2BE6A190F4BF3D635D6A9F19FD3,31061,9,11,2,109.53333,18.23257,1607
18954,148063,0F09C2BE6A190F4BF3D635D6A9F19FD3,30121,12,14,2,109.52861,18.27222,1613
18955,148064,0F09C2BE6A190F4BF3D635D6A9F19FD3,60661,17,21,4,109.548,18.2377,1657
18956,148065,0F09C2BE6A190F4BF3D635D6A9F19FD3,60371,21,22,1,109.53063,18.30056,1618
18957,148079,8C2A72A3EA8DBE7544B4A433B2BC3FE0,38361,0,11,11,109.43667,18.29201,1267
18958,148080,8C2A72A3EA8DBE7544B4A433B2BC3FE0,31321,14,16,2,109.63799,18.23201,2007
18959,148081,8C2A72A3EA8DBE7544B4A433B2BC3FE0,31391,19,21,2,109.50382,18.24285,1508
18960,148094,E4B522EF4348156010E5C578EC13D60F,30854,0,2,2,109.56889,18.27076,1763
18961,148095,E4B522EF4348156010E5C578EC13D60F,30234,3,5,2,109.60681,18.29979,1918
18962,148096,E4B522EF4348156010E5C578EC13D60F,30854,5,6,1,109.56889,18.27076,1763
18963,148097,E4B522EF4348156010E5C578EC13D60F,30221,9,12,3,109.57833,18.20222,1802
18964,148098,E4B522EF4348156010E5C578EC13D60F,30854,16,23,7,109.56889,18.27076,1763
18965,148104,F25102D4BE48A66B8AE50787215C5331,31181,12,20,8,109.50382,18.24813,1509
18966,148105,F25102D4BE48A66B8AE50787215C5331,60291,21,23,2,109.50826,18.24639,1509
18967,148109,9AF351B3CC27394DFED45513F0E32162,60351,0,6,6,109.58403,18.28958,1816
18968,148110,9AF351B3CC27394DFED45513F0E32162,31551,8,12,4,109.55868,18.24222,1708
18969,148111,9AF351B3CC27394DFED45513F0E32162,30951,13,16,3,109.56208,18.25667,1761
18970,148112,9AF351B3CC27394DFED45513F0E32162,31071,18,20,2,109.58257,18.28458,1815
18971,148113,9AF351B3CC27394DFED45513F0E32162,60351,20,22,2,109.58403,18.28958,1816
18981,148178,52820FDF38F5A08FADB7112AE77AAA8C,38023,0,10,10,109.37132,18.28993,1016
18982,148179,52820FDF38F5A08FADB7112AE77AAA8C,60291,14,15,1,109.50826,18.24639,1509
18983,148180,52820FDF38F5A08FADB7112AE77AAA8C,60201,16,22,6,109.5041,18.2509,1510
18994,148279,E0686F37399D74676DEB0528C7B9FCF9,38903,0,7,7,109.39229,18.29243,1117
18995,148280,E0686F37399D74676DEB0528C7B9FCF9,38325,8,11,3,109.39792,18.2909,1116
18996,148281,E0686F37399D74676DEB0528C7B9FCF9,31781,12,14,2,109.19847,18.2975,367
18997,148282,E0686F37399D74676DEB0528C7B9FCF9,38141,16,19,3,109.39479,18.2916,1116
18998,148283,E0686F37399D74676DEB0528C7B9FCF9,30711,19,21,2,109.50271,18.25347,1510
18999,148284,E0686F37399D74676DEB0528C7B9FCF9,38141,22,23,1,109.39479,18.2916,1116
19000,148312,5E6F81A7DA23F57413C15AC7514275E5,31945,2,15,13,109.58021,18.29403,1817
19001,148313,5E6F81A7DA23F57413C15AC7514275E5,31561,19,21,2,109.56792,18.28479,1765
19002,148364,3066D3BA0EF6F55E10FAD924A6ADDDEF,30771,0,1,1,109.49938,18.26042,1511
19003,148365,3066D3BA0EF6F55E10FAD924A6ADDDEF,30381,4,10,6,109.52521,18.24507,1609
19004,148366,3066D3BA0EF6F55E10FAD924A6ADDDEF,30861,12,13,1,109.52722,18.22743,1606
19005,148367,3066D3BA0EF6F55E10FAD924A6ADDDEF,31031,14,16,2,109.49979,18.25382,1510
19006,148368,3066D3BA0EF6F55E10FAD924A6ADDDEF,30381,17,22,5,109.52521,18.24507,1609
19007,148418,6DF7485545B790F22810B0EDD8F1B356,31945,12,13,1,109.58021,18.29403,1817
19008,148419,6DF7485545B790F22810B0EDD8F1B356,30854,15,16,1,109.56889,18.27076,1763
19009,148420,B621E9075674E792CCB217233825F9D1,30851,3,7,4,109.5616,18.27396,1713
19010,148421,B621E9075674E792CCB217233825F9D1,31101,9,14,5,109.65389,18.23403,2057
19011,148422,B621E9075674E792CCB217233825F9D1,30854,16,17,1,109.56889,18.27076,1763
19015,148429,DF410547949833E8F7EB071905643771,38871,0,3,3,109.44681,18.28625,1316
19016,148430,DF410547949833E8F7EB071905643771,31861,4,5,1,109.49042,18.27549,1464
19017,148431,DF410547949833E8F7EB071905643771,31021,8,9,1,109.49021,18.27,1463
19018,148432,DF410547949833E8F7EB071905643771,31861,10,11,1,109.49042,18.27549,1464
19019,148433,DF410547949833E8F7EB071905643771,30361,12,13,1,109.50347,18.24,1508
19020,148434,DF410547949833E8F7EB071905643771,31021,20,21,1,109.49021,18.27,1463
19021,148435,DF410547949833E8F7EB071905643771,31861,21,23,2,109.49042,18.27549,1464
19025,148510,19E8353A2DD0F178EBFC3FFA3E623B24,31945,0,17,17,109.58021,18.29403,1817
19026,148511,19E8353A2DD0F178EBFC3FFA3E623B24,30854,18,21,3,109.56889,18.27076,1763
19027,148533,76F07B8DC17758A94772CF5ACE457FAC,30171,0,8,8,109.48458,18.27139,1463
19028,148534,76F07B8DC17758A94772CF5ACE457FAC,31531,12,15,3,109.49583,18.25972,1461
19029,148535,76F07B8DC17758A94772CF5ACE457FAC,60381,17,18,1,109.5241,18.22458,1605
19030,148536,76F07B8DC17758A94772CF5ACE457FAC,31031,18,19,1,109.49979,18.25382,1510
19031,148537,76F07B8DC17758A94772CF5ACE457FAC,31531,20,23,3,109.49583,18.25972,1461
19032,148602,7421066246AAD1C230E7E2A7ADF06E9D,60631,0,7,7,109.57778,18.27583,1814
19033,148603,7421066246AAD1C230E7E2A7ADF06E9D,30854,7,9,2,109.56889,18.27076,1763
19034,148604,7421066246AAD1C230E7E2A7ADF06E9D,60631,12,13,1,109.57778,18.27583,1814
19035,148605,7421066246AAD1C230E7E2A7ADF06E9D,30854,17,18,1,109.56889,18.27076,1763
19036,148606,7421066246AAD1C230E7E2A7ADF06E9D,60631,21,23,2,109.57778,18.27583,1814
19040,148638,E2A4A2ABBE2AAFDE32C6FA06BCCC268D,31071,11,14,3,109.58257,18.28458,1815
19041,148639,E2A4A2ABBE2AAFDE32C6FA06BCCC268D,30581,15,17,2,109.62257,18.24951,1959
19042,148640,E2A4A2ABBE2AAFDE32C6FA06BCCC268D,31261,19,21,2,109.51174,18.2466,1559
19043,148660,417408FFDA93B177641D270D3A5C4B2D,30854,12,13,1,109.56889,18.27076,1763
19044,148661,417408FFDA93B177641D270D3A5C4B2D,31071,15,16,1,109.58257,18.28458,1815
19045,148662,417408FFDA93B177641D270D3A5C4B2D,30854,17,18,1,109.56889,18.27076,1763
19046,148663,417408FFDA93B177641D270D3A5C4B2D,31071,19,23,4,109.58257,18.28458,1815
19047,148696,770D2E9A8A9D56CFD9834A323B86C483,30854,12,13,1,109.56889,18.27076,1763
19048,148697,770D2E9A8A9D56CFD9834A323B86C483,31071,13,14,1,109.58257,18.28458,1815
19049,148698,770D2E9A8A9D56CFD9834A323B86C483,30854,14,17,3,109.56889,18.27076,1763
19050,148699,770D2E9A8A9D56CFD9834A323B86C483,31071,18,19,1,109.58257,18.28458,1815
19051,148713,C1788356D6298A19C2039F0E2F1C2CF1,30371,19,20,1,109.51,18.24771,1559
19052,148714,C1788356D6298A19C2039F0E2F1C2CF1,60381,21,23,2,109.5241,18.22458,1605
19059,148827,DA5E6B13E9B86E6A18C6646FBB376A74,31251,6,9,3,109.18528,18.2975,317
19060,148830,DA5E6B13E9B86E6A18C6646FBB376A74,31251,13,15,2,109.18528,18.2975,317
19061,148856,DF49F834C08C7E8FA6D78272EE1FB651,60361,0,6,6,109.51938,18.29681,1567
19062,148857,DF49F834C08C7E8FA6D78272EE1FB651,30951,8,17,9,109.56208,18.25667,1761
19063,148858,DF49F834C08C7E8FA6D78272EE1FB651,60361,18,23,5,109.51938,18.29681,1567
19067,148895,BD4652414D5C17466BA36FD4BD943A94,30721,1,5,4,109.51597,18.28257,1565
19068,148896,BD4652414D5C17466BA36FD4BD943A94,39183,8,18,10,109.55542,18.28208,1715
19073,148981,83930DA23863D53A36D25B51299F2054,61011,0,2,2,109.60653,18.19076,1900
19074,148983,83930DA23863D53A36D25B51299F2054,61011,9,11,2,109.60653,18.19076,1900
19075,149015,6D2D20F4D67580FE7309C23DCCA820C3,30951,16,17,1,109.56208,18.25667,1761
19076,149016,6D2D20F4D67580FE7309C23DCCA820C3,31071,18,23,5,109.58257,18.28458,1815
19077,149041,22EBBC51F7D1EF3A417D690DEC68B2D9,30171,3,10,7,109.48458,18.27139,1463
19081,149074,0E1DB444F47235AEDAD0A0404A7B75B4,31561,0,1,1,109.56792,18.28479,1765
19082,149075,0E1DB444F47235AEDAD0A0404A7B75B4,39183,1,6,5,109.55542,18.28208,1715
19083,149076,0E1DB444F47235AEDAD0A0404A7B75B4,31561,11,12,1,109.56792,18.28479,1765
19084,149077,0E1DB444F47235AEDAD0A0404A7B75B4,30251,15,16,1,109.50611,18.26653,1512
19085,149078,0E1DB444F47235AEDAD0A0404A7B75B4,30251,17,23,6,109.50611,18.26653,1512
19086,149144,D758DCB0CB2E5EA2CADCED24F521A533,30854,1,2,1,109.56889,18.27076,1763
19087,149145,D758DCB0CB2E5EA2CADCED24F521A533,31945,2,5,3,109.58021,18.29403,1817
19088,149146,D758DCB0CB2E5EA2CADCED24F521A533,30221,8,13,5,109.57833,18.20222,1802
19089,149147,D758DCB0CB2E5EA2CADCED24F521A533,31945,20,21,1,109.58021,18.29403,1817
19090,149148,D758DCB0CB2E5EA2CADCED24F521A533,31071,21,23,2,109.58257,18.28458,1815
19091,149213,2A6BA0678DDF16AF08BAC9E3FA3C9391,31561,0,5,5,109.56792,18.28479,1765
19092,149214,2A6BA0678DDF16AF08BAC9E3FA3C9391,30854,8,17,9,109.56889,18.27076,1763
19103,149356,ECCCA5770AD6AA7162B63EC395B55856,30951,13,17,4,109.56208,18.25667,1761
19104,149357,ECCCA5770AD6AA7162B63EC395B55856,60631,19,23,4,109.57778,18.27583,1814
19105,149358,A249BB92E18839D454C438B797D69714,38291,0,9,9,109.51618,18.24313,1558
19106,149359,A249BB92E18839D454C438B797D69714,38017,12,18,6,109.49729,18.21424,1504
19107,149394,34F3D64B41C252481F72E5CF931AC833,30851,16,19,3,109.5616,18.27396,1713
19108,149395,34F3D64B41C252481F72E5CF931AC833,30854,20,22,2,109.56889,18.27076,1763
19109,149410,3A352532FC7E82C19FB49B77C773900E,31864,14,18,4,109.49014,18.28333,1465
19110,149411,3A352532FC7E82C19FB49B77C773900E,60281,20,22,2,109.51743,18.25924,1561
19111,149416,95E09A72760B2799C2CC9BD7AF527107,31071,6,19,13,109.58257,18.28458,1815
19112,149417,95E09A72760B2799C2CC9BD7AF527107,30854,20,22,2,109.56889,18.27076,1763
19113,149418,95E09A72760B2799C2CC9BD7AF527107,31071,22,23,1,109.58257,18.28458,1815
19117,149463,06FCF67485A2B44C8ABC96FDB92547C5,61011,2,17,15,109.60653,18.19076,1900
19118,149467,5E97A4561E11AAC4FBC53FD068EAA52B,30854,0,8,8,109.56889,18.27076,1763
19119,149468,5E97A4561E11AAC4FBC53FD068EAA52B,30531,8,18,10,109.53271,18.21472,1604
19120,149469,5E97A4561E11AAC4FBC53FD068EAA52B,30854,20,22,2,109.56889,18.27076,1763
19124,149515,9EB99F27F9127F01C16DB7BA7D10B6E0,30854,13,17,4,109.56889,18.27076,1763
19125,149516,9EB99F27F9127F01C16DB7BA7D10B6E0,31071,18,20,2,109.58257,18.28458,1815
19126,149517,9EB99F27F9127F01C16DB7BA7D10B6E0,31561,22,23,1,109.56792,18.28479,1765
19127,149523,EF45C1C5A7F95D1E71D98768E1D22F90,31561,17,18,1,109.56792,18.28479,1765
19128,149524,EF45C1C5A7F95D1E71D98768E1D22F90,30854,20,22,2,109.56889,18.27076,1763
19129,149554,D9D6266510871BA9EBCA49EA785B4F2F,38331,0,11,11,109.62465,18.22736,1956
19130,149555,D9D6266510871BA9EBCA49EA785B4F2F,31571,11,15,4,109.61563,18.23326,1957
19131,149556,D9D6266510871BA9EBCA49EA785B4F2F,30361,19,20,1,109.50347,18.24,1508
19132,149557,D9D6266510871BA9EBCA49EA785B4F2F,31571,21,23,2,109.61563,18.23326,1957
19136,149599,98EB1CF842CD30ED85E927AB3226642D,30854,13,15,2,109.56889,18.27076,1763
19137,149600,98EB1CF842CD30ED85E927AB3226642D,31071,19,20,1,109.58257,18.28458,1815
19138,149601,98EB1CF842CD30ED85E927AB3226642D,30891,21,22,1,109.59431,18.28389,1865
19139,149668,E960A9C960574B6ECAA9E8161ED40783,30181,0,10,10,109.51597,18.23313,1557
19140,149669,E960A9C960574B6ECAA9E8161ED40783,31521,10,11,1,109.51458,18.22542,1555
19141,149670,E960A9C960574B6ECAA9E8161ED40783,38054,13,14,1,109.63479,18.23097,2006
19142,149671,E960A9C960574B6ECAA9E8161ED40783,30181,16,18,2,109.51597,18.23313,1557
19143,149672,E960A9C960574B6ECAA9E8161ED40783,31521,19,21,2,109.51458,18.22542,1555
19144,149673,27BCEF3137923B84211F08830816C810,31561,15,16,1,109.56792,18.28479,1765
19145,149674,27BCEF3137923B84211F08830816C810,30851,17,18,1,109.5616,18.27396,1713
19146,149675,27BCEF3137923B84211F08830816C810,31561,21,22,1,109.56792,18.28479,1765
19150,149754,4995463B780282C9C030A19D9F49AEAC,31071,2,5,3,109.58257,18.28458,1815
19151,149755,4995463B780282C9C030A19D9F49AEAC,30854,8,14,6,109.56889,18.27076,1763
19155,149786,937F0B31443CC6355891AA9D2DB0C670,30854,14,19,5,109.56889,18.27076,1763
19156,149787,937F0B31443CC6355891AA9D2DB0C670,31561,21,22,1,109.56792,18.28479,1765
19157,149820,2506E93F1473AB5227728C7B0A12E7AF,38911,0,7,7,109.51674,18.24965,1559
19158,149821,2506E93F1473AB5227728C7B0A12E7AF,31261,10,15,5,109.51174,18.2466,1559
19159,149860,B87EA32D7A8C628CB2B89E95996DDE3E,31931,13,15,2,109.54771,18.29403,1667
19160,149861,B95D5FCFC7327770C14B6F9FFDB772BC,30854,12,13,1,109.56889,18.27076,1763
19161,149862,B95D5FCFC7327770C14B6F9FFDB772BC,31945,14,15,1,109.58021,18.29403,1817
19162,149893,996C0D9500BF90CC0E7F5A04C49A464B,31931,9,17,8,109.54771,18.29403,1667
19163,149894,996C0D9500BF90CC0E7F5A04C49A464B,39183,21,22,1,109.55542,18.28208,1715
19164,149897,B340EDEF4A878E8DF5CBEC25E465EACE,30854,1,2,1,109.56889,18.27076,1763
19165,149898,B340EDEF4A878E8DF5CBEC25E465EACE,31071,4,5,1,109.58257,18.28458,1815
19166,149899,B340EDEF4A878E8DF5CBEC25E465EACE,30854,6,15,9,109.56889,18.27076,1763
19167,149900,B340EDEF4A878E8DF5CBEC25E465EACE,60631,15,17,2,109.57778,18.27583,1814
19168,149901,B340EDEF4A878E8DF5CBEC25E465EACE,30854,20,21,1,109.56889,18.27076,1763
19169,149944,CD6FBEA58741CB482F98EE3EFC4C981F,38094,0,7,7,109.45403,18.28778,1316
19170,149945,CD6FBEA58741CB482F98EE3EFC4C981F,30241,9,10,1,109.26174,18.3275,622
19171,149946,CD6FBEA58741CB482F98EE3EFC4C981F,31781,12,13,1,109.19847,18.2975,367
19172,149947,CD6FBEA58741CB482F98EE3EFC4C981F,60221,16,18,2,109.52569,18.29188,1616
19173,149948,CD6FBEA58741CB482F98EE3EFC4C981F,38094,21,22,1,109.45403,18.28778,1316
19174,149957,2EBBAC66DDB6248DEB5E1D635794A55A,61011,0,10,10,109.60653,18.19076,1900
19175,149959,2EBBAC66DDB6248DEB5E1D635794A55A,61011,18,23,5,109.60653,18.19076,1900
19180,150023,E064E516ED48D19AB171E43D87D419CE,30211,15,17,2,109.49882,18.23931,1508
19181,150024,E064E516ED48D19AB171E43D87D419CE,60201,22,23,1,109.5041,18.2509,1510
19182,150027,8C5A16299A6D294198C90C34C25C5949,30854,2,3,1,109.56889,18.27076,1763
19183,150028,8C5A16299A6D294198C90C34C25C5949,39183,4,12,8,109.55542,18.28208,1715
19184,150090,B43DB539B5964E15F0064080164C40C1,30854,2,6,4,109.56889,18.27076,1763
19185,150091,B43DB539B5964E15F0064080164C40C1,60631,6,8,2,109.57778,18.27583,1814
19186,150092,B43DB539B5964E15F0064080164C40C1,38085,8,9,1,109.6291,18.23625,2007
19187,150093,B43DB539B5964E15F0064080164C40C1,38052,11,16,5,109.62618,18.23042,1956
19188,150094,B43DB539B5964E15F0064080164C40C1,30854,17,19,2,109.56889,18.27076,1763
19189,150104,B89747DA8FD8C271771A8056C80A48B6,60221,16,18,2,109.52569,18.29188,1616
19190,150105,B89747DA8FD8C271771A8056C80A48B6,30711,19,20,1,109.50271,18.25347,1510
19191,150106,B89747DA8FD8C271771A8056C80A48B6,30421,20,22,2,109.50021,18.25861,1511
19192,150113,AFCE3351168C576BE2AA828A190DD579,31231,1,9,8,109.42597,18.29292,1217
19193,150114,AFCE3351168C576BE2AA828A190DD579,30271,12,13,1,109.49132,18.23153,1456
19194,150115,AFCE3351168C576BE2AA828A190DD579,38754,15,16,1,109.74667,18.37382,2430
19195,150116,AFCE3351168C576BE2AA828A190DD579,31031,18,20,2,109.49979,18.25382,1510
19196,150117,AFCE3351168C576BE2AA828A190DD579,30051,22,23,1,109.48917,18.21215,1453
19197,150154,EB92ED6162DE5D09C3C6A535524882F3,31091,18,20,2,109.41201,18.31222,1170
19198,150155,EB92ED6162DE5D09C3C6A535524882F3,31431,20,21,1,109.44639,18.29042,1316
19199,150197,2D39AE6120F2674000C6DBB8A6E572A0,30854,17,18,1,109.56889,18.27076,1763
19200,150198,2D39AE6120F2674000C6DBB8A6E572A0,31945,20,23,3,109.58021,18.29403,1817
19201,150224,2D683B3AD358B28A27E068E80E3AA9C8,30854,0,4,4,109.56889,18.27076,1763
19202,150225,2D683B3AD358B28A27E068E80E3AA9C8,31071,5,6,1,109.58257,18.28458,1815
19203,150226,2D683B3AD358B28A27E068E80E3AA9C8,30854,6,17,11,109.56889,18.27076,1763
19204,150227,2D683B3AD358B28A27E068E80E3AA9C8,31945,18,21,3,109.58021,18.29403,1817
19205,150228,2D683B3AD358B28A27E068E80E3AA9C8,30854,21,23,2,109.56889,18.27076,1763
19206,150238,C1F9914EF577AE2A8300B1A3945A50FF,31561,1,10,9,109.56792,18.28479,1765
19207,150239,C1F9914EF577AE2A8300B1A3945A50FF,30851,12,18,6,109.5616,18.27396,1713
19215,150383,58E91236A2413C70EF9B297260454A51,33051,11,15,4,109.6475,18.46618,2096
19216,150384,58E91236A2413C70EF9B297260454A51,38105,17,19,2,109.40299,18.29229,1117
19217,150385,58E91236A2413C70EF9B297260454A51,38251,20,21,1,109.49618,18.25493,1510
19218,150389,7763FA5342AFBCA436FF4D695F9B9CB2,30711,1,7,6,109.50271,18.25347,1510
19219,150390,7763FA5342AFBCA436FF4D695F9B9CB2,31781,12,15,3,109.19847,18.2975,367
19220,150391,7763FA5342AFBCA436FF4D695F9B9CB2,30711,17,19,2,109.50271,18.25347,1510
19221,150392,7763FA5342AFBCA436FF4D695F9B9CB2,30711,20,23,3,109.50271,18.25347,1510
19222,150419,F605546ADA1ADB3E2AF3E74D19682812,60311,0,1,1,109.52097,18.24319,1558
19223,150420,F605546ADA1ADB3E2AF3E74D19682812,60221,4,10,6,109.52569,18.29188,1616
19224,150421,F605546ADA1ADB3E2AF3E74D19682812,30854,14,15,1,109.56889,18.27076,1763
19225,150422,F605546ADA1ADB3E2AF3E74D19682812,31931,17,20,3,109.54771,18.29403,1667
19226,150423,F605546ADA1ADB3E2AF3E74D19682812,60221,22,23,1,109.52569,18.29188,1616
19231,150505,C3EF49B0098C6C3C4B26CC8869DE86AF,38271,13,17,4,109.62632,18.23049,1956
19232,150506,C3EF49B0098C6C3C4B26CC8869DE86AF,30854,18,23,5,109.56889,18.27076,1763
19233,150511,94C4D5691F7DFC1AB38806AFFAC1389E,30921,0,5,5,109.53903,18.29451,1667
19234,150512,94C4D5691F7DFC1AB38806AFFAC1389E,39101,10,12,2,109.50132,18.24931,1509
19235,150513,94C4D5691F7DFC1AB38806AFFAC1389E,31931,15,23,8,109.54771,18.29403,1667
19236,150594,293757429670FEF848C950D685169FCC,31071,0,14,14,109.58257,18.28458,1815
19237,150595,293757429670FEF848C950D685169FCC,30854,19,20,1,109.56889,18.27076,1763
19238,150599,B616D64706FE00CB4CDA3E3D124853B8,31671,0,8,8,109.38965,18.29813,1068
19239,150600,B616D64706FE00CB4CDA3E3D124853B8,38751,10,14,4,109.74903,18.37639,2481
19240,150601,B616D64706FE00CB4CDA3E3D124853B8,31671,18,23,5,109.38965,18.29813,1068
19241,150608,07F004282B66F8FFF4893B155B27BCEE,30351,18,19,1,109.41701,18.29292,1217
19242,150609,07F004282B66F8FFF4893B155B27BCEE,60552,22,23,1,109.41729,18.30014,1218
19246,150622,E70F59D4F47F86725E25CD6D6D80730B,60054,13,14,1,109.3016,18.31229,770
19247,150623,E70F59D4F47F86725E25CD6D6D80730B,38251,16,21,5,109.49618,18.25493,1510
19248,150624,E70F59D4F47F86725E25CD6D6D80730B,31181,22,23,1,109.50382,18.24813,1509
19249,150666,37064F9BC763FD0F497B111F9661D621,39091,11,13,2,109.50097,18.25222,1510
19250,150667,37064F9BC763FD0F497B111F9661D621,30711,15,19,4,109.50271,18.25347,1510
19251,150668,37064F9BC763FD0F497B111F9661D621,39091,22,23,1,109.50097,18.25222,1510
19256,150684,28BD8349014AF7ACA687EB9A336CEC23,60054,12,23,11,109.3016,18.31229,770
19266,150788,FD33950BA7DBDA4F7AA88F8E119D9C66,38094,6,10,4,109.45403,18.28778,1316
19267,150789,FD33950BA7DBDA4F7AA88F8E119D9C66,38094,14,17,3,109.45403,18.28778,1316
19268,150790,FD33950BA7DBDA4F7AA88F8E119D9C66,60381,17,20,3,109.5241,18.22458,1605
19277,150862,A65416E0023DB5B05C85EFD796D8188E,31521,2,10,8,109.51458,18.22542,1555
19278,150863,A65416E0023DB5B05C85EFD796D8188E,31261,12,14,2,109.51174,18.2466,1559
19279,150864,A65416E0023DB5B05C85EFD796D8188E,38291,14,17,3,109.51618,18.24313,1558
19280,150865,A65416E0023DB5B05C85EFD796D8188E,31261,17,18,1,109.51174,18.2466,1559
19281,150866,A65416E0023DB5B05C85EFD796D8188E,31261,19,21,2,109.51174,18.2466,1559
19285,150957,A519BA026730D6143CD46B3D7E63697F,30511,10,12,2,109.51069,18.24208,1558
19286,150958,A519BA026730D6143CD46B3D7E63697F,31181,13,14,1,109.50382,18.24813,1509
19287,150959,A519BA026730D6143CD46B3D7E63697F,38911,15,16,1,109.51674,18.24965,1559
19288,150983,74AD1AF2EA5153BD40BCF9A3F3F2C4E3,30854,11,19,8,109.56889,18.27076,1763
19289,150984,74AD1AF2EA5153BD40BCF9A3F3F2C4E3,31071,19,20,1,109.58257,18.28458,1815
19290,150985,74AD1AF2EA5153BD40BCF9A3F3F2C4E3,30854,21,23,2,109.56889,18.27076,1763
19297,151060,9F78F38D6383CA869F6B266FFD637AAB,31471,13,15,2,109.34583,18.29563,917
19298,151061,9F78F38D6383CA869F6B266FFD637AAB,38094,16,18,2,109.45403,18.28778,1316
19299,151062,9F78F38D6383CA869F6B266FFD637AAB,60551,18,20,2,109.42722,18.30111,1218
19300,151063,9F78F38D6383CA869F6B266FFD637AAB,31061,22,23,1,109.53333,18.23257,1607
19301,151070,8E06EAC16B0EF776FA1BAAC5B9747325,30511,0,9,9,109.51069,18.24208,1558
19302,151071,8E06EAC16B0EF776FA1BAAC5B9747325,60071,11,16,5,109.75674,18.31583,2470
19303,151072,8E06EAC16B0EF776FA1BAAC5B9747325,30891,19,21,2,109.59431,18.28389,1865
19304,151087,84DF4A7C208235D171EF56473BCCF210,31561,4,7,3,109.56792,18.28479,1765
19305,151088,84DF4A7C208235D171EF56473BCCF210,60631,8,18,10,109.57778,18.27583,1814
19306,151107,95009B06B81B68C6E9DA0D3D0B4DC185,31931,9,15,6,109.54771,18.29403,1667
19307,151108,95009B06B81B68C6E9DA0D3D0B4DC185,30921,15,18,3,109.53903,18.29451,1667
19308,151123,C3071072DB6684DC75BE160268E6323C,30854,1,18,17,109.56889,18.27076,1763
19309,151124,C3071072DB6684DC75BE160268E6323C,31461,19,21,2,109.5091,18.25389,1510
19314,151165,17E33F98086F9D71B1BE47BE6FC58756,30232,10,15,5,109.6191,18.31701,1971
19315,151166,17E33F98086F9D71B1BE47BE6FC58756,31091,18,21,3,109.41201,18.31222,1170
19320,151243,12F418F6C44355E3BA708D12ADBC4871,38336,9,10,1,109.61111,18.21806,1904
19321,151264,6831AD010DA6E3DA47BF53D43652AAC5,30731,2,3,1,109.50944,18.22306,1555
19322,151265,6831AD010DA6E3DA47BF53D43652AAC5,30191,3,4,1,109.50361,18.22701,1506
19323,151266,6831AD010DA6E3DA47BF53D43652AAC5,30731,5,7,2,109.50944,18.22306,1555
19324,151267,6831AD010DA6E3DA47BF53D43652AAC5,60054,11,12,1,109.3016,18.31229,770
19325,151268,6831AD010DA6E3DA47BF53D43652AAC5,30191,19,21,2,109.50361,18.22701,1506
19326,151269,6831AD010DA6E3DA47BF53D43652AAC5,30731,21,22,1,109.50944,18.22306,1555
19330,151307,46EF230EB6A4B6FDC207E16C624EC19C,38134,3,8,5,109.63931,18.23451,2007
19331,151308,46EF230EB6A4B6FDC207E16C624EC19C,38271,9,12,3,109.62632,18.23049,1956
19332,151309,4DE3E9C2C0E7F48C3178063DD53BC336,31041,0,2,2,109.50278,18.23701,1507
19333,151310,4DE3E9C2C0E7F48C3178063DD53BC336,30771,3,7,4,109.49938,18.26042,1511
19334,151311,4DE3E9C2C0E7F48C3178063DD53BC336,31941,8,16,8,109.62451,18.31222,1970
19335,151312,F00821368F615DCDAF214035D8EC4A44,31071,0,6,6,109.58257,18.28458,1815
19336,151313,F00821368F615DCDAF214035D8EC4A44,30854,9,16,7,109.56889,18.27076,1763
19337,151314,F00821368F615DCDAF214035D8EC4A44,60463,18,21,3,109.52507,18.22438,1605
19338,151315,F00821368F615DCDAF214035D8EC4A44,30854,22,23,1,109.56889,18.27076,1763
19339,151355,934029FB5F97BCE114EDCE88F0393A63,30854,15,17,2,109.56889,18.27076,1763
19340,151356,934029FB5F97BCE114EDCE88F0393A63,31945,19,20,1,109.58021,18.29403,1817
19341,151357,934029FB5F97BCE114EDCE88F0393A63,30854,21,23,2,109.56889,18.27076,1763
19342,151361,C2CC718D695CB45C49C10B739F52F650,31181,9,11,2,109.50382,18.24813,1509
19343,151362,C2CC718D695CB45C49C10B739F52F650,60131,11,15,4,109.49819,18.24778,1509
19344,151363,C2CC718D695CB45C49C10B739F52F650,31031,15,21,6,109.49979,18.25382,1510
19349,151391,48E412C068F936A4922628B0DC57FE76,30111,12,14,2,109.47583,18.30542,1419
19353,151414,A4FEA494C186F671057B754D5D75BB49,31431,0,8,8,109.44639,18.29042,1316
19354,151415,A4FEA494C186F671057B754D5D75BB49,31145,9,11,2,109.20431,18.30479,369
19355,151416,A4FEA494C186F671057B754D5D75BB49,31781,11,13,2,109.19847,18.2975,367
19356,151417,A4FEA494C186F671057B754D5D75BB49,60054,14,15,1,109.3016,18.31229,770
19357,151418,A4FEA494C186F671057B754D5D75BB49,31431,17,20,3,109.44639,18.29042,1316
19358,151419,A4FEA494C186F671057B754D5D75BB49,30161,20,22,2,109.50042,18.24389,1508
19359,151425,97F87E25D267410278E74FDFD0CF66D1,31071,0,10,10,109.58257,18.28458,1815
19360,151426,97F87E25D267410278E74FDFD0CF66D1,30161,11,14,3,109.50042,18.24389,1508
19361,151427,97F87E25D267410278E74FDFD0CF66D1,30071,16,17,1,109.52819,18.30472,1619
19362,151429,AA17C9279A63248D7DCDF49F93EB8817,38275,9,17,8,109.62875,18.22938,2006
19363,151430,AA17C9279A63248D7DCDF49F93EB8817,30854,20,21,1,109.56889,18.27076,1763
19364,151431,AA17C9279A63248D7DCDF49F93EB8817,31071,22,23,1,109.58257,18.28458,1815
19369,151464,D73D0E1690714CD7F442C709F67E4771,60361,0,6,6,109.51938,18.29681,1567
19370,151465,D73D0E1690714CD7F442C709F67E4771,30851,8,9,1,109.5616,18.27396,1713
19371,151466,D73D0E1690714CD7F442C709F67E4771,31421,11,16,5,109.55382,18.22347,1705
19372,151467,D73D0E1690714CD7F442C709F67E4771,60361,18,23,5,109.51938,18.29681,1567
19373,151511,F84D949DDCBF25D5530F771BC55E0B9D,61011,0,4,4,109.60653,18.19076,1900
19374,151521,409F5E8F01172D32BBE91132149C037E,31201,0,7,7,109.51042,18.23819,1558
19375,151522,409F5E8F01172D32BBE91132149C037E,31931,8,10,2,109.54771,18.29403,1667
19376,151523,409F5E8F01172D32BBE91132149C037E,30511,11,13,2,109.51069,18.24208,1558
19377,151524,409F5E8F01172D32BBE91132149C037E,31931,14,16,2,109.54771,18.29403,1667
19378,151525,409F5E8F01172D32BBE91132149C037E,30511,17,20,3,109.51069,18.24208,1558
19379,151526,409F5E8F01172D32BBE91132149C037E,31261,20,21,1,109.51174,18.2466,1559
19380,151527,409F5E8F01172D32BBE91132149C037E,38376,22,23,1,109.50924,18.24,1558
19381,151534,07169E7114E4F14C073261BAAC0D4491,61011,1,5,4,109.60653,18.19076,1900
19382,151536,07169E7114E4F14C073261BAAC0D4491,61011,13,16,3,109.60653,18.19076,1900
19383,151537,53490AD77ACCA93C3ED0F3DE79CA488B,31071,9,10,1,109.58257,18.28458,1815
19384,151538,53490AD77ACCA93C3ED0F3DE79CA488B,30854,12,18,6,109.56889,18.27076,1763
19388,151630,30EB9FD1E5C3A2F993BE211A12B3D4BF,38951,0,8,8,109.48097,18.28868,1416
19389,151631,30EB9FD1E5C3A2F993BE211A12B3D4BF,33521,12,15,3,109.66313,18.45174,2143
19390,151632,30EB9FD1E5C3A2F993BE211A12B3D4BF,38951,17,22,5,109.48097,18.28868,1416
19391,151636,9C1407835BC54BEBDB541F52E1DA1820,61011,4,6,2,109.60653,18.19076,1900
19392,151664,3520FED22A4D572CBFE1B08BD2743E22,60291,6,9,3,109.50826,18.24639,1509
19393,151665,3520FED22A4D572CBFE1B08BD2743E22,30211,11,18,7,109.49882,18.23931,1508
19394,151666,3520FED22A4D572CBFE1B08BD2743E22,38291,18,20,2,109.51618,18.24313,1558
19395,151667,3520FED22A4D572CBFE1B08BD2743E22,31391,21,22,1,109.50382,18.24285,1508
19396,151668,A3495AE12DCA51791665FEB15CF0D86C,31561,1,10,9,109.56792,18.28479,1765
19397,151669,A3495AE12DCA51791665FEB15CF0D86C,30071,11,12,1,109.52819,18.30472,1619
19398,151670,A3495AE12DCA51791665FEB15CF0D86C,31561,14,15,1,109.56792,18.28479,1765
19399,151671,A3495AE12DCA51791665FEB15CF0D86C,30071,16,18,2,109.52819,18.30472,1619
19400,151672,A3495AE12DCA51791665FEB15CF0D86C,39183,21,23,2,109.55542,18.28208,1715
19412,151847,73EAC1341C5005A58B26B1A52457F38B,31181,0,19,19,109.50382,18.24813,1509
19413,151848,73EAC1341C5005A58B26B1A52457F38B,38891,22,23,1,109.51486,18.24118,1558
19417,151877,99CBAA6A65A50998F0A10B72B36210E4,38251,2,3,1,109.49618,18.25493,1510
19418,151878,99CBAA6A65A50998F0A10B72B36210E4,30051,4,16,12,109.48917,18.21215,1453
19422,151894,43922725F0A46A5D2B5FC870E087F339,30854,14,16,2,109.56889,18.27076,1763
19423,151895,43922725F0A46A5D2B5FC870E087F339,31071,17,18,1,109.58257,18.28458,1815
19424,151896,43922725F0A46A5D2B5FC870E087F339,30854,20,21,1,109.56889,18.27076,1763
19431,151935,37D38EF0062E64D55C94EB554B76F9EE,31071,6,7,1,109.58257,18.28458,1815
19432,151936,37D38EF0062E64D55C94EB554B76F9EE,30221,9,11,2,109.57833,18.20222,1802
19433,151958,E00EF22F493557E868E52C93194870CF,31071,10,11,1,109.58257,18.28458,1815
19434,151959,E00EF22F493557E868E52C93194870CF,30234,12,14,2,109.60681,18.29979,1918
19435,151960,E00EF22F493557E868E52C93194870CF,30854,16,17,1,109.56889,18.27076,1763
19436,151961,E00EF22F493557E868E52C93194870CF,31071,20,23,3,109.58257,18.28458,1815
19437,151980,3F0525247EE9DA06541A62C07CFE6D4C,31531,20,23,3,109.49583,18.25972,1461
19438,151983,DF1914B7230B32BA806E8A8749CAD846,60491,1,2,1,109.43354,18.30847,1269
19439,151984,DF1914B7230B32BA806E8A8749CAD846,60261,2,4,2,109.44326,18.3075,1319
19440,151985,DF1914B7230B32BA806E8A8749CAD846,60421,5,6,1,109.46333,18.31743,1371
19441,151986,DF1914B7230B32BA806E8A8749CAD846,60491,6,12,6,109.43354,18.30847,1269
19442,151987,DF1914B7230B32BA806E8A8749CAD846,60281,19,20,1,109.51743,18.25924,1561
19443,151988,DF1914B7230B32BA806E8A8749CAD846,31031,21,22,1,109.49979,18.25382,1510
19447,152071,4A5724424F2C122BD123A5CE62CED1C7,60641,9,11,2,109.53854,18.2359,1657
19456,152127,EB0139E0BBB300F5407E4F7BCDA3B148,30511,2,4,2,109.51069,18.24208,1558
19457,152128,EB0139E0BBB300F5407E4F7BCDA3B148,38291,5,8,3,109.51618,18.24313,1558
19458,152129,EB0139E0BBB300F5407E4F7BCDA3B148,31521,12,15,3,109.51458,18.22542,1555
19459,152130,EB0139E0BBB300F5407E4F7BCDA3B148,38291,16,21,5,109.51618,18.24313,1558
19460,152131,EB0139E0BBB300F5407E4F7BCDA3B148,38891,22,23,1,109.51486,18.24118,1558
19461,152176,4A5667D82CB3C711D86862CBE82C4E19,38027,0,14,14,109.38833,18.2909,1066
19462,152177,4A5667D82CB3C711D86862CBE82C4E19,38315,15,16,1,109.48979,18.29764,1467
19463,152202,46FB195BB21573CE6CD85D42D7B06C1A,30854,6,9,3,109.56889,18.27076,1763
19464,152203,46FB195BB21573CE6CD85D42D7B06C1A,31071,11,13,2,109.58257,18.28458,1815
19465,152204,46FB195BB21573CE6CD85D42D7B06C1A,30854,15,19,4,109.56889,18.27076,1763
19469,152253,51061B3DE820AF1C1C713EF684728003,30854,1,14,13,109.56889,18.27076,1763
19470,152254,51061B3DE820AF1C1C713EF684728003,31071,18,20,2,109.58257,18.28458,1815
19471,152263,A8E9C7BB918ADAD29A3EA7ACDDCD32D7,38951,0,2,2,109.48097,18.28868,1416
19472,152264,A8E9C7BB918ADAD29A3EA7ACDDCD32D7,38951,2,14,12,109.48097,18.28868,1416
19473,152265,A8E9C7BB918ADAD29A3EA7ACDDCD32D7,60381,14,19,5,109.5241,18.22458,1605
19474,152266,A8E9C7BB918ADAD29A3EA7ACDDCD32D7,38951,20,23,3,109.48097,18.28868,1416
19475,152275,012ABD06F231728C214A4BA917E75B1C,31561,0,15,15,109.56792,18.28479,1765
19476,152276,012ABD06F231728C214A4BA917E75B1C,30851,18,20,2,109.5616,18.27396,1713
19487,152422,D61883A9E0C7F2103C981F95E51C66DA,31931,0,12,12,109.54771,18.29403,1667
19488,152423,D61883A9E0C7F2103C981F95E51C66DA,31206,17,18,1,109.50819,18.23549,1507
19493,152447,1B56AAF9660B4689609A2EAC980068F2,31861,0,8,8,109.49042,18.27549,1464
19494,152448,1B56AAF9660B4689609A2EAC980068F2,38754,11,14,3,109.74667,18.37382,2430
19495,152449,1B56AAF9660B4689609A2EAC980068F2,30361,17,18,1,109.50347,18.24,1508
19496,152450,1B56AAF9660B4689609A2EAC980068F2,31861,19,21,2,109.49042,18.27549,1464
19497,152478,2A1AB09F11CECAAFA5576058E9461FEA,31231,4,21,17,109.42597,18.29292,1217
19498,152479,2A1AB09F11CECAAFA5576058E9461FEA,31091,22,23,1,109.41201,18.31222,1170
19499,152480,2371AF49C13083A9B56BAFD9F258B46A,30721,0,6,6,109.51597,18.28257,1565
19500,152481,2371AF49C13083A9B56BAFD9F258B46A,30861,8,11,3,109.52722,18.22743,1606
19501,152482,2371AF49C13083A9B56BAFD9F258B46A,30721,12,14,2,109.51597,18.28257,1565
19502,152483,2371AF49C13083A9B56BAFD9F258B46A,30861,15,18,3,109.52722,18.22743,1606
19503,152484,2371AF49C13083A9B56BAFD9F258B46A,30121,19,21,2,109.52861,18.27222,1613
19504,152495,48E7CF9BD7466E8BC3AC99D05DB84CA5,31471,1,6,5,109.34583,18.29563,917
19505,152496,48E7CF9BD7466E8BC3AC99D05DB84CA5,30241,7,8,1,109.26174,18.3275,622
19506,152502,8752BC71725B50257436D50C6598F252,31071,0,7,7,109.58257,18.28458,1815
19507,152503,8752BC71725B50257436D50C6598F252,30854,7,22,15,109.56889,18.27076,1763
19508,152525,01E4EDC1E5574D5D38AD2CBB1DBED767,60351,10,13,3,109.58403,18.28958,1816
19509,152526,01E4EDC1E5574D5D38AD2CBB1DBED767,30851,15,19,4,109.5616,18.27396,1713
19513,152564,FFDAF8A9D2C792AE2603FAF38162851E,60491,16,19,3,109.43354,18.30847,1269
19514,152565,FFDAF8A9D2C792AE2603FAF38162851E,30084,21,23,2,109.50118,18.26972,1513
19519,152642,832E158759EFB7090F6865072A9601D8,38971,0,7,7,109.50743,18.25125,1510
19520,152643,832E158759EFB7090F6865072A9601D8,33481,9,12,3,109.67278,18.41278,2187
19521,152644,832E158759EFB7090F6865072A9601D8,33051,14,16,2,109.6475,18.46618,2096
19522,152645,832E158759EFB7090F6865072A9601D8,30711,18,20,2,109.50271,18.25347,1510
19523,152646,832E158759EFB7090F6865072A9601D8,31181,21,23,2,109.50382,18.24813,1509
19524,152647,CCBE9BD27BE45DF1D524AAA2624A3639,38121,0,8,8,109.51361,18.27813,1564
19525,152648,CCBE9BD27BE45DF1D524AAA2624A3639,30051,8,13,5,109.48917,18.21215,1453
19526,152649,CCBE9BD27BE45DF1D524AAA2624A3639,31951,16,22,6,109.52174,18.30299,1568
19527,152671,33A62A8066AF8B1342859DF4B906FBD2,38991,18,20,2,109.52681,18.30368,1618
19528,152672,33A62A8066AF8B1342859DF4B906FBD2,31181,21,22,1,109.50382,18.24813,1509
19529,152718,789033FF9671BBE480F6F60FF87489C2,31031,12,13,1,109.49979,18.25382,1510
19530,152719,789033FF9671BBE480F6F60FF87489C2,30431,18,23,5,109.16931,18.37486,280
19531,152792,117CDF2D41FFFF099F62724091D8605A,60631,17,18,1,109.57778,18.27583,1814
19532,152793,117CDF2D41FFFF099F62724091D8605A,30891,19,20,1,109.59431,18.28389,1865
19537,152828,9EBFE19AEC38C3A6F47AE2D903294BAE,30854,0,15,15,109.56889,18.27076,1763
19538,152829,9EBFE19AEC38C3A6F47AE2D903294BAE,30791,20,21,1,109.72333,18.40889,2386
19543,152912,BA3D3DE13D22E6DD1BA5A0B2CACB0B94,30441,0,8,8,109.64021,18.25424,2010
19544,152913,BA3D3DE13D22E6DD1BA5A0B2CACB0B94,38052,8,10,2,109.62618,18.23042,1956
19545,152914,BA3D3DE13D22E6DD1BA5A0B2CACB0B94,30441,12,16,4,109.64021,18.25424,2010
19546,152915,BA3D3DE13D22E6DD1BA5A0B2CACB0B94,60594,18,19,1,109.62694,18.22799,1956
19547,152916,BA3D3DE13D22E6DD1BA5A0B2CACB0B94,30441,22,23,1,109.64021,18.25424,2010
19558,152958,C1DFDFC110B50DFE0D66E47848759FB2,30851,2,4,2,109.5616,18.27396,1713
19559,152959,C1DFDFC110B50DFE0D66E47848759FB2,39183,8,9,1,109.55542,18.28208,1715
19560,152960,C1DFDFC110B50DFE0D66E47848759FB2,31071,14,15,1,109.58257,18.28458,1815
19561,152961,C1DFDFC110B50DFE0D66E47848759FB2,38251,19,20,1,109.49618,18.25493,1510
19562,152962,C1DFDFC110B50DFE0D66E47848759FB2,38275,21,22,1,109.62875,18.22938,2006
19563,152972,0ED0AC9F879ECB02034F61F5961F8D91,39063,0,3,3,109.386,18.2919,1066
19564,152973,0ED0AC9F879ECB02034F61F5961F8D91,38027,4,6,2,109.38833,18.2909,1066
19565,152974,0ED0AC9F879ECB02034F61F5961F8D91,38027,7,8,1,109.38833,18.2909,1066
19566,152975,0ED0AC9F879ECB02034F61F5961F8D91,38027,10,12,2,109.38833,18.2909,1066
19567,152976,0ED0AC9F879ECB02034F61F5961F8D91,60561,14,16,2,109.38229,18.29785,1067
19568,152977,0ED0AC9F879ECB02034F61F5961F8D91,31671,18,20,2,109.38965,18.29813,1068
19569,152978,0ED0AC9F879ECB02034F61F5961F8D91,38027,21,23,2,109.38833,18.2909,1066
19574,153008,40285EE8CCE25C38988EC087545664EC,31071,1,9,8,109.58257,18.28458,1815
19575,153009,40285EE8CCE25C38988EC087545664EC,30854,9,10,1,109.56889,18.27076,1763
19576,153010,40285EE8CCE25C38988EC087545664EC,31071,10,11,1,109.58257,18.28458,1815
19577,153011,40285EE8CCE25C38988EC087545664EC,30854,14,16,2,109.56889,18.27076,1763
19578,153012,40285EE8CCE25C38988EC087545664EC,31071,18,21,3,109.58257,18.28458,1815
19579,153024,468231DFF07583BA8A222D360B2FDB3A,31864,1,6,5,109.49014,18.28333,1465
19580,153025,468231DFF07583BA8A222D360B2FDB3A,30741,9,13,4,109.49833,18.28681,1516
19584,153150,9E8746086915F9D4A063A74CF0B5B7AB,39183,10,11,1,109.55542,18.28208,1715
19585,153151,9E8746086915F9D4A063A74CF0B5B7AB,31561,14,23,9,109.56792,18.28479,1765
19586,153157,E74DD709C18EF8EBD8453383A814635F,60501,11,12,1,109.48701,18.29021,1466
19587,153158,E74DD709C18EF8EBD8453383A814635F,38951,12,23,11,109.48097,18.28868,1416
19591,153233,5CFFF8D919E96524101209E188C669B3,31951,0,10,10,109.52174,18.30299,1568
19592,153308,00FC332040A284DA251A8D0705989FE9,31071,1,12,11,109.58257,18.28458,1815
19593,153309,00FC332040A284DA251A8D0705989FE9,30854,14,16,2,109.56889,18.27076,1763
19594,153310,00FC332040A284DA251A8D0705989FE9,30151,19,20,1,109.50986,18.25083,1560
19595,153311,00FC332040A284DA251A8D0705989FE9,30854,22,23,1,109.56889,18.27076,1763
19596,153410,2AE38FAF341950B0B91404FFCE5A0F3E,30921,7,17,10,109.53903,18.29451,1667
19597,153411,2AE38FAF341950B0B91404FFCE5A0F3E,31931,18,23,5,109.54771,18.29403,1667
19598,153412,8DA877D3A30401F86E81FB7BC1CA2A00,30854,0,19,19,109.56889,18.27076,1763
19599,153413,8DA877D3A30401F86E81FB7BC1CA2A00,31071,20,21,1,109.58257,18.28458,1815
19603,153449,D8917A2A43EA8070EEC2FA46A7C72FE1,38251,12,13,1,109.49618,18.25493,1510
19604,153450,D8917A2A43EA8070EEC2FA46A7C72FE1,30504,16,23,7,109.705,18.35368,2277
19609,153497,92B04F1171F7627BEF2FDBB24EA4D3B4,31471,9,12,3,109.34583,18.29563,917
19610,153498,92B04F1171F7627BEF2FDBB24EA4D3B4,31145,13,14,1,109.20431,18.30479,369
19611,153499,92B04F1171F7627BEF2FDBB24EA4D3B4,30351,17,19,2,109.41701,18.29292,1217
19612,153503,CFA6DB42B4EA79576A8AEA8F93765E81,30721,3,7,4,109.51597,18.28257,1565
19613,153504,CFA6DB42B4EA79576A8AEA8F93765E81,30271,10,11,1,109.49132,18.23153,1456
19614,153505,CFA6DB42B4EA79576A8AEA8F93765E81,30291,15,18,3,109.50403,18.27028,1513
19615,153506,CFA6DB42B4EA79576A8AEA8F93765E81,31864,19,20,1,109.49014,18.28333,1465
19619,153531,B34415F599F0ED7D1A073EE314A60B9B,60041,2,9,7,109.39889,18.31944,1121
19620,153532,B34415F599F0ED7D1A073EE314A60B9B,31671,9,20,11,109.38965,18.29813,1068
19621,153590,EC4B90EDBF35256FDB4D4F8B87DB8A04,31071,1,7,6,109.58257,18.28458,1815
19622,153591,EC4B90EDBF35256FDB4D4F8B87DB8A04,30854,7,18,11,109.56889,18.27076,1763
19626,153667,0D69669D4DBC1CEB06269A084D86E853,30851,1,2,1,109.5616,18.27396,1713
19627,153668,0D69669D4DBC1CEB06269A084D86E853,30854,2,6,4,109.56889,18.27076,1763
19628,153768,979ABBB43C3434EE96D76E04CFC66E55,30201,20,21,1,109.4909,18.26465,1462
19629,153769,979ABBB43C3434EE96D76E04CFC66E55,60201,22,23,1,109.5041,18.2509,1510
19630,153775,853957914DEF6F72A1C4EECCFE47E293,30854,2,7,5,109.56889,18.27076,1763
19631,153776,853957914DEF6F72A1C4EECCFE47E293,38706,8,18,10,109.74625,18.37097,2430
19632,153788,18B397C6C5E352538250AEDC640C72E3,31941,0,6,6,109.62451,18.31222,1970
19633,153789,18B397C6C5E352538250AEDC640C72E3,38205,7,12,5,109.62743,18.23139,1956
19634,153790,18B397C6C5E352538250AEDC640C72E3,31221,13,14,1,109.61333,18.26833,1913
19638,153845,03CEC0FDDD5484124514C6D24A63D4DD,31561,0,7,7,109.56792,18.28479,1765
19639,153846,03CEC0FDDD5484124514C6D24A63D4DD,39183,8,10,2,109.55542,18.28208,1715
19640,153847,03CEC0FDDD5484124514C6D24A63D4DD,31561,11,12,1,109.56792,18.28479,1765
19641,153848,03CEC0FDDD5484124514C6D24A63D4DD,39183,13,17,4,109.55542,18.28208,1715
19642,153849,03CEC0FDDD5484124514C6D24A63D4DD,31561,17,19,2,109.56792,18.28479,1765
19643,153850,03CEC0FDDD5484124514C6D24A63D4DD,30854,22,23,1,109.56889,18.27076,1763
19644,153872,87ACF3C6ADE430D2B9DFB3C954E0C031,39183,1,4,3,109.55542,18.28208,1715
19645,153873,87ACF3C6ADE430D2B9DFB3C954E0C031,31071,6,10,4,109.58257,18.28458,1815
19646,153874,87ACF3C6ADE430D2B9DFB3C954E0C031,39181,10,12,2,109.55153,18.28035,1715
19647,153875,87ACF3C6ADE430D2B9DFB3C954E0C031,31071,12,16,4,109.58257,18.28458,1815
19648,153876,87ACF3C6ADE430D2B9DFB3C954E0C031,39183,16,19,3,109.55542,18.28208,1715
19649,153877,87ACF3C6ADE430D2B9DFB3C954E0C031,31071,20,21,1,109.58257,18.28458,1815
19650,153944,1E93239453A807F80FEB34C902C59FA1,48601,0,7,7,109.51694,18.22514,1555
19651,153945,1E93239453A807F80FEB34C902C59FA1,31521,11,14,3,109.51458,18.22542,1555
19652,153946,1E93239453A807F80FEB34C902C59FA1,48601,14,17,3,109.51694,18.22514,1555
19653,153947,1E93239453A807F80FEB34C902C59FA1,31521,18,20,2,109.51458,18.22542,1555
19654,153948,1E93239453A807F80FEB34C902C59FA1,31521,20,21,1,109.51458,18.22542,1555
19655,153949,1E93239453A807F80FEB34C902C59FA1,30731,21,23,2,109.50944,18.22306,1555
19660,154003,27229B6D41BD7CDDDAA38911093865DB,30854,0,3,3,109.56889,18.27076,1763
19661,154004,27229B6D41BD7CDDDAA38911093865DB,38085,5,13,8,109.6291,18.23625,2007
19662,154025,F941F01D0E9ADF1E538631C17665F2E0,38336,0,10,10,109.61111,18.21806,1904
19663,154026,F941F01D0E9ADF1E538631C17665F2E0,30361,12,13,1,109.50347,18.24,1508
19664,154027,F941F01D0E9ADF1E538631C17665F2E0,30854,17,19,2,109.56889,18.27076,1763
19665,154028,F941F01D0E9ADF1E538631C17665F2E0,31071,19,21,2,109.58257,18.28458,1815
19666,154029,F941F01D0E9ADF1E538631C17665F2E0,60591,22,23,1,109.61118,18.21715,1904
19667,154046,E218C587552A5DADC05C4E69685FE374,30854,8,18,10,109.56889,18.27076,1763
19668,154047,E218C587552A5DADC05C4E69685FE374,39183,21,23,2,109.55542,18.28208,1715
19669,154048,B9C328A62B9F9830C9EA98AE81376626,30771,0,7,7,109.49938,18.26042,1511
19670,154049,B9C328A62B9F9830C9EA98AE81376626,30251,9,10,1,109.50611,18.26653,1512
19671,154050,B9C328A62B9F9830C9EA98AE81376626,30771,12,17,5,109.49938,18.26042,1511
19672,154051,B9C328A62B9F9830C9EA98AE81376626,30571,18,19,1,109.50243,18.21861,1504
19673,154052,B9C328A62B9F9830C9EA98AE81376626,30771,20,23,3,109.49938,18.26042,1511
19674,154165,F8340F8DE3FC6E4B51712C02CF964A60,38117,0,5,5,109.51611,18.22354,1555
19675,154166,F8340F8DE3FC6E4B51712C02CF964A60,31521,6,8,2,109.51458,18.22542,1555
19676,154167,F8340F8DE3FC6E4B51712C02CF964A60,31521,11,14,3,109.51458,18.22542,1555
19677,154168,F8340F8DE3FC6E4B51712C02CF964A60,39321,14,15,1,109.529,18.2167,1604
19678,154169,F8340F8DE3FC6E4B51712C02CF964A60,60381,19,21,2,109.5241,18.22458,1605
19679,154178,8880BF3B03853247B5235ADF19775070,31781,10,12,2,109.19847,18.2975,367
19680,154179,8880BF3B03853247B5235ADF19775070,31471,14,16,2,109.34583,18.29563,917
19681,154180,8880BF3B03853247B5235ADF19775070,60381,17,23,6,109.5241,18.22458,1605
19682,154184,AB8B051428E5E5EDACDABEECED7F5A35,31421,0,1,1,109.55382,18.22347,1705
19683,154185,AB8B051428E5E5EDACDABEECED7F5A35,30851,1,3,2,109.5616,18.27396,1713
19684,154186,AB8B051428E5E5EDACDABEECED7F5A35,31421,4,14,10,109.55382,18.22347,1705
19685,154187,AB8B051428E5E5EDACDABEECED7F5A35,30851,15,17,2,109.5616,18.27396,1713
19686,154188,AB8B051428E5E5EDACDABEECED7F5A35,31421,18,23,5,109.55382,18.22347,1705
19687,154229,4B8D9F3A9653A6483169F67E5D72F0C2,31945,16,17,1,109.58021,18.29403,1817
19688,154230,4B8D9F3A9653A6483169F67E5D72F0C2,30791,19,23,4,109.72333,18.40889,2386
19689,154277,7C4B45B599684104AFE3AA992CD3924A,31521,0,2,2,109.51458,18.22542,1555
19690,154278,7C4B45B599684104AFE3AA992CD3924A,60211,2,8,6,109.63549,18.26049,2011
19691,154279,7C4B45B599684104AFE3AA992CD3924A,30711,9,13,4,109.50271,18.25347,1510
19692,154280,7C4B45B599684104AFE3AA992CD3924A,30421,14,16,2,109.50021,18.25861,1511
19693,154281,7C4B45B599684104AFE3AA992CD3924A,30811,18,21,3,109.65188,18.26257,2062
19694,154282,7C4B45B599684104AFE3AA992CD3924A,60211,21,23,2,109.63549,18.26049,2011
19699,154363,752B4C65CCCA1EA27D3C6EA24E289B9C,60631,12,14,2,109.57778,18.27583,1814
19700,154364,752B4C65CCCA1EA27D3C6EA24E289B9C,30854,14,20,6,109.56889,18.27076,1763
19705,154414,2F64FEF19C86AA0A8AA3E3FA37CC4F2D,30854,0,1,1,109.56889,18.27076,1763
19706,154415,2F64FEF19C86AA0A8AA3E3FA37CC4F2D,60631,1,9,8,109.57778,18.27583,1814
19707,154416,2F64FEF19C86AA0A8AA3E3FA37CC4F2D,30891,10,11,1,109.59431,18.28389,1865
19708,154417,2F64FEF19C86AA0A8AA3E3FA37CC4F2D,30854,13,19,6,109.56889,18.27076,1763
19709,154418,2F64FEF19C86AA0A8AA3E3FA37CC4F2D,60631,20,22,2,109.57778,18.27583,1814
19710,154422,0E54E51B728435921FF462A3D9A68B3D,30854,0,14,14,109.56889,18.27076,1763
19711,154423,0E54E51B728435921FF462A3D9A68B3D,31231,18,23,5,109.42597,18.29292,1217
19712,154434,AB43182259122294244C13D6FC66D4A1,30851,16,18,2,109.5616,18.27396,1713
19713,154435,AB43182259122294244C13D6FC66D4A1,60631,18,23,5,109.57778,18.27583,1814
19714,154440,C462628FF36F8FF2D0B7493E6DDA38BB,30661,1,7,6,109.37028,18.24361,1008
19715,154441,C462628FF36F8FF2D0B7493E6DDA38BB,60411,8,12,4,109.32514,18.30854,869
19716,154442,C462628FF36F8FF2D0B7493E6DDA38BB,30661,13,14,1,109.37028,18.24361,1008
19717,154443,C462628FF36F8FF2D0B7493E6DDA38BB,60411,14,23,9,109.32514,18.30854,869
19718,154468,036DFEF8CA623F9034F928149FE2468D,30821,14,20,6,109.43681,18.33639,1274
19719,154469,036DFEF8CA623F9034F928149FE2468D,30651,21,22,1,109.42611,18.385,1232
19720,154484,E1BB7B2CDA075A402737990C0757A672,39091,0,9,9,109.50097,18.25222,1510
19721,154485,E1BB7B2CDA075A402737990C0757A672,30361,10,11,1,109.50347,18.24,1508
19722,154494,F8D799D9161B0143E0D71C40472A357E,38991,1,7,6,109.52681,18.30368,1618
19723,154495,F8D799D9161B0143E0D71C40472A357E,31951,7,8,1,109.52174,18.30299,1568
19724,154496,F8D799D9161B0143E0D71C40472A357E,30071,10,14,4,109.52819,18.30472,1619
19725,154497,F8D799D9161B0143E0D71C40472A357E,31951,15,18,3,109.52174,18.30299,1568
19726,154498,F8D799D9161B0143E0D71C40472A357E,30071,18,20,2,109.52819,18.30472,1619
19727,154499,F8D799D9161B0143E0D71C40472A357E,30071,21,23,2,109.52819,18.30472,1619
19728,154512,5EE25A6E7DD554FFDA0C9C1A504114B7,30221,0,16,16,109.57833,18.20222,1802
19729,154513,5EE25A6E7DD554FFDA0C9C1A504114B7,30281,18,19,1,109.50597,18.27583,1514
19730,154545,E7DB0F55EDE33BB4C08C98B80B7173BF,31841,15,16,1,109.73201,18.33382,2373
19731,154546,E7DB0F55EDE33BB4C08C98B80B7173BF,60111,17,18,1,109.72556,18.31924,2371
19732,154547,E7DB0F55EDE33BB4C08C98B80B7173BF,60371,20,23,3,109.53063,18.30056,1618
19733,154550,7BF65E5054DA81A230AB5423620158E1,60631,0,7,7,109.57778,18.27583,1814
19734,154551,7BF65E5054DA81A230AB5423620158E1,30854,7,19,12,109.56889,18.27076,1763
19735,154552,ADC7B707FBBD7BF3F9ACE0C092DAADE5,30921,0,2,2,109.53903,18.29451,1667
19736,154553,ADC7B707FBBD7BF3F9ACE0C092DAADE5,60371,3,6,3,109.53063,18.30056,1618
19737,154557,F5EB56BD5801B85A9E4703584DF6DFA6,60661,0,6,6,109.548,18.2377,1657
19738,154558,F5EB56BD5801B85A9E4703584DF6DFA6,60431,10,11,1,109.46139,18.32861,1373
19739,154559,F5EB56BD5801B85A9E4703584DF6DFA6,31534,11,13,2,109.49368,18.25806,1461
19740,154695,A46BA306DAEA889FAC7ACE9E5FD6A1FF,30081,0,6,6,109.50243,18.26632,1512
19741,154696,A46BA306DAEA889FAC7ACE9E5FD6A1FF,30911,7,9,2,109.50493,18.26181,1511
19742,154697,A46BA306DAEA889FAC7ACE9E5FD6A1FF,30711,10,14,4,109.50271,18.25347,1510
19743,154698,A46BA306DAEA889FAC7ACE9E5FD6A1FF,31171,14,16,2,109.50938,18.24917,1559
19744,154699,A46BA306DAEA889FAC7ACE9E5FD6A1FF,30511,20,21,1,109.51069,18.24208,1558
19745,154702,E649CF84A26278291AA1A5B5C5D01FCA,31561,1,5,4,109.56792,18.28479,1765
19746,154703,E649CF84A26278291AA1A5B5C5D01FCA,30854,5,15,10,109.56889,18.27076,1763
19751,154746,3871846CD20CC7E3D76BFB165D15B326,60631,13,14,1,109.57778,18.27583,1814
19752,154747,3871846CD20CC7E3D76BFB165D15B326,30854,17,23,6,109.56889,18.27076,1763
19753,154748,FE3B5F01A6626B19D8324F79E0BF8F47,60031,13,14,1,109.49694,18.31632,1521
19754,154749,FE3B5F01A6626B19D8324F79E0BF8F47,31461,18,20,2,109.5091,18.25389,1510
19755,154750,FE3B5F01A6626B19D8324F79E0BF8F47,30371,21,23,2,109.51,18.24771,1559
19759,154774,20C15B76A1E0DF79D86EDEAC7BC3D7B7,31071,0,4,4,109.58257,18.28458,1815
19760,154775,20C15B76A1E0DF79D86EDEAC7BC3D7B7,31945,6,8,2,109.58021,18.29403,1817
19761,154891,FAC035CAF00431CACD74AF53D18C4996,60011,0,6,6,109.48965,18.30222,1468
19762,154892,FAC035CAF00431CACD74AF53D18C4996,30764,7,10,3,109.45806,18.29486,1367
19763,154893,FAC035CAF00431CACD74AF53D18C4996,30761,10,11,1,109.45201,18.3,1318
19764,154894,FAC035CAF00431CACD74AF53D18C4996,30764,14,17,3,109.45806,18.29486,1367
19765,154895,FAC035CAF00431CACD74AF53D18C4996,60011,19,20,1,109.48965,18.30222,1468
19766,154898,1E5258D0CC7C3DBB97888929EF64B7AF,30361,0,10,10,109.50347,18.24,1508
19767,154899,1E5258D0CC7C3DBB97888929EF64B7AF,31041,11,12,1,109.50278,18.23701,1507
19768,154900,1E5258D0CC7C3DBB97888929EF64B7AF,30361,13,16,3,109.50347,18.24,1508
19769,154901,1E5258D0CC7C3DBB97888929EF64B7AF,30161,17,19,2,109.50042,18.24389,1508
19770,154902,1E5258D0CC7C3DBB97888929EF64B7AF,30361,21,23,2,109.50347,18.24,1508
19771,154937,CFFDD1BF3134B9FDD71614F40E1DE0FD,31561,0,2,2,109.56792,18.28479,1765
19772,154938,CFFDD1BF3134B9FDD71614F40E1DE0FD,31071,5,22,17,109.58257,18.28458,1815
19773,154965,075F360F88180B9A93BF11A5704B49F3,31621,0,8,8,109.51035,18.29826,1568
19774,154966,075F360F88180B9A93BF11A5704B49F3,60121,12,14,2,109.74507,18.37472,2430
19775,154967,075F360F88180B9A93BF11A5704B49F3,30741,18,21,3,109.49833,18.28681,1516
19779,155025,9EF6440DA421994ED152A57FAE59B45B,30151,0,9,9,109.50986,18.25083,1560
19780,155026,9EF6440DA421994ED152A57FAE59B45B,30711,9,11,2,109.50271,18.25347,1510
19781,155027,9EF6440DA421994ED152A57FAE59B45B,39091,12,14,2,109.50097,18.25222,1510
19782,155028,9EF6440DA421994ED152A57FAE59B45B,30371,14,16,2,109.51,18.24771,1559
19783,155029,9EF6440DA421994ED152A57FAE59B45B,30371,18,23,5,109.51,18.24771,1559
19784,155096,E8BAAF476E8FE57075BAB1A8D4FF1780,30232,18,20,2,109.6191,18.31701,1971
19785,155097,E8BAAF476E8FE57075BAB1A8D4FF1780,39371,20,21,1,109.56627,18.2646,1762
19790,155143,B40042BCF38D15C3E5C90930640CEE46,38071,20,22,2,109.40722,18.30938,1169
19791,155162,9A1D1AA5EE2CD156CC396C667ED8C5B9,31071,1,9,8,109.58257,18.28458,1815
19792,155163,9A1D1AA5EE2CD156CC396C667ED8C5B9,31164,10,15,5,109.69993,18.27215,2263
19793,155164,9A1D1AA5EE2CD156CC396C667ED8C5B9,30854,16,21,5,109.56889,18.27076,1763
19794,155214,798BF3B08F72A16A6DEAAA235F1899BB,61011,2,5,3,109.60653,18.19076,1900
19795,155216,798BF3B08F72A16A6DEAAA235F1899BB,61011,20,22,2,109.60653,18.19076,1900
19802,155352,E4C7AB656E412C7E33554D18277C9478,60291,10,14,4,109.50826,18.24639,1509
19803,155353,E4C7AB656E412C7E33554D18277C9478,38127,17,19,2,109.50833,18.27222,1513
19804,155443,6751CEC3CF9B2AE78246C7287443D2B4,31945,0,2,2,109.58021,18.29403,1817
19805,155444,6751CEC3CF9B2AE78246C7287443D2B4,30854,7,23,16,109.56889,18.27076,1763
19809,155479,7FA173D0839B9BE60B23B32DD3C2AC47,31071,15,17,2,109.58257,18.28458,1815
19810,155480,7FA173D0839B9BE60B23B32DD3C2AC47,30071,18,19,1,109.52819,18.30472,1619
19811,155481,7FA173D0839B9BE60B23B32DD3C2AC47,60084,20,21,1,109.4984,18.2334,1507
19812,155482,7FA173D0839B9BE60B23B32DD3C2AC47,30511,22,23,1,109.51069,18.24208,1558
19813,155502,68DBE0B52FD0AB95F1DD47068FD7847F,60311,2,11,9,109.52097,18.24319,1558
19814,155503,68DBE0B52FD0AB95F1DD47068FD7847F,30181,15,23,8,109.51597,18.23313,1557
19822,155602,172CB232BBE684655CFBDFD055BB1CB5,30771,0,7,7,109.49938,18.26042,1511
19823,155603,172CB232BBE684655CFBDFD055BB1CB5,60551,12,15,3,109.42722,18.30111,1218
19824,155604,172CB232BBE684655CFBDFD055BB1CB5,60524,18,19,1,109.42951,18.28993,1216
19829,155655,5D5B29A994BBA3635D38463A75BE58F6,30201,0,5,5,109.4909,18.26465,1462
19830,155656,5D5B29A994BBA3635D38463A75BE58F6,31531,5,6,1,109.49583,18.25972,1461
19831,155657,5D5B29A994BBA3635D38463A75BE58F6,30201,7,8,1,109.4909,18.26465,1462
19832,155658,5D5B29A994BBA3635D38463A75BE58F6,31473,12,13,1,109.34792,18.29465,917
19833,155659,5D5B29A994BBA3635D38463A75BE58F6,31021,14,21,7,109.49021,18.27,1463
19840,155695,222E0B6922623CE9FBB280F81068D40E,30731,12,17,5,109.50944,18.22306,1555
19841,155696,222E0B6922623CE9FBB280F81068D40E,31561,21,23,2,109.56792,18.28479,1765
19842,155739,90D91A493F9482486DCC3B27CF3F61EE,31071,0,7,7,109.58257,18.28458,1815
19843,155740,90D91A493F9482486DCC3B27CF3F61EE,30854,8,9,1,109.56889,18.27076,1763
19844,155741,90D91A493F9482486DCC3B27CF3F61EE,31071,11,13,2,109.58257,18.28458,1815
19845,155742,90D91A493F9482486DCC3B27CF3F61EE,30854,14,16,2,109.56889,18.27076,1763
19846,155743,90D91A493F9482486DCC3B27CF3F61EE,31071,16,17,1,109.58257,18.28458,1815
19847,155755,7C68E1F4B8B2F3CBBD5427BF66BF9C2E,31571,14,15,1,109.61563,18.23326,1957
19848,155756,7C68E1F4B8B2F3CBBD5427BF66BF9C2E,30854,20,22,2,109.56889,18.27076,1763
19849,155760,5403ECE41AD9921A5DEF63FF6DE6A9D1,31071,2,9,7,109.58257,18.28458,1815
19850,155761,5403ECE41AD9921A5DEF63FF6DE6A9D1,30854,11,17,6,109.56889,18.27076,1763
19851,155765,15195C578D4A8081B069C4B518039EFC,60161,15,20,5,109.49174,18.26181,1461
19852,155766,15195C578D4A8081B069C4B518039EFC,30051,22,23,1,109.48917,18.21215,1453
19853,155786,B02D7A3F297B377D646E0F85B7C19006,61011,0,2,2,109.60653,18.19076,1900
19854,155788,B02D7A3F297B377D646E0F85B7C19006,61011,22,23,1,109.60653,18.19076,1900
19855,155794,246EF4D95FA494895EFB2D649512DAE7,60081,0,6,6,109.51097,18.22639,1556
19856,155796,246EF4D95FA494895EFB2D649512DAE7,61011,13,17,4,109.60653,18.19076,1900
19860,155820,DD8DCE806AFFEAC5D779812E5F8F2B3D,31561,0,2,2,109.56792,18.28479,1765
19861,155821,DD8DCE806AFFEAC5D779812E5F8F2B3D,31071,3,5,2,109.58257,18.28458,1815
19862,155822,DD8DCE806AFFEAC5D779812E5F8F2B3D,31561,5,8,3,109.56792,18.28479,1765
19863,155823,DD8DCE806AFFEAC5D779812E5F8F2B3D,30854,9,11,2,109.56889,18.27076,1763
19864,155824,DD8DCE806AFFEAC5D779812E5F8F2B3D,31561,15,16,1,109.56792,18.28479,1765
19868,155863,0354DA7FCEC6CBE8F4AF79CA9C56607E,30854,8,9,1,109.56889,18.27076,1763
19869,155864,0354DA7FCEC6CBE8F4AF79CA9C56607E,31561,9,14,5,109.56792,18.28479,1765
19870,155865,0354DA7FCEC6CBE8F4AF79CA9C56607E,30854,16,17,1,109.56889,18.27076,1763
19871,155866,0354DA7FCEC6CBE8F4AF79CA9C56607E,38484,18,20,2,109.53028,18.31528,1620
19872,155867,0354DA7FCEC6CBE8F4AF79CA9C56607E,30854,20,21,1,109.56889,18.27076,1763
19873,155868,0354DA7FCEC6CBE8F4AF79CA9C56607E,31071,21,23,2,109.58257,18.28458,1815
19874,155896,98874DCD35D34E4D34E0BC9C49822D59,31521,0,14,14,109.51458,18.22542,1555
19875,155897,98874DCD35D34E4D34E0BC9C49822D59,60381,15,16,1,109.5241,18.22458,1605
19876,155898,98874DCD35D34E4D34E0BC9C49822D59,31521,16,17,1,109.51458,18.22542,1555
19877,155899,98874DCD35D34E4D34E0BC9C49822D59,31521,19,21,2,109.51458,18.22542,1555
19878,155900,98874DCD35D34E4D34E0BC9C49822D59,60381,22,23,1,109.5241,18.22458,1605
19879,155903,A969AA4D78FD71B9F4E643F763F4C75F,30221,3,6,3,109.57833,18.20222,1802
19880,155904,A969AA4D78FD71B9F4E643F763F4C75F,31521,7,8,1,109.51458,18.22542,1555
19881,155905,A969AA4D78FD71B9F4E643F763F4C75F,60381,8,9,1,109.5241,18.22458,1605
19882,155906,A969AA4D78FD71B9F4E643F763F4C75F,31521,10,21,11,109.51458,18.22542,1555
19883,155907,A969AA4D78FD71B9F4E643F763F4C75F,60381,21,23,2,109.5241,18.22458,1605
19884,155923,B023927CBEC0A8053CBDF64A5B76E367,30571,0,7,7,109.50243,18.21861,1504
19885,155924,B023927CBEC0A8053CBDF64A5B76E367,31931,8,15,7,109.54771,18.29403,1667
19886,155925,B023927CBEC0A8053CBDF64A5B76E367,30571,19,23,4,109.50243,18.21861,1504
19887,155980,B172E1B17A92EA23226EC822FB6F7B82,30161,18,20,2,109.50042,18.24389,1508
19888,155981,B172E1B17A92EA23226EC822FB6F7B82,31201,21,23,2,109.51042,18.23819,1558
19902,156039,45FC4D7B7AEB1BB8222449DDC064C06B,31945,11,16,5,109.58021,18.29403,1817
19903,156040,45FC4D7B7AEB1BB8222449DDC064C06B,30854,17,20,3,109.56889,18.27076,1763
19904,156041,45FC4D7B7AEB1BB8222449DDC064C06B,31071,21,23,2,109.58257,18.28458,1815
19905,156106,1B378B100EB2E1F18A0E8906C6FD4DA1,61011,1,2,1,109.60653,18.19076,1900
19906,156108,1B378B100EB2E1F18A0E8906C6FD4DA1,61011,11,13,2,109.60653,18.19076,1900
19907,156113,6F55ACFC3A2BD8567407A1426439CC11,38991,1,6,5,109.52681,18.30368,1618
19908,156114,6F55ACFC3A2BD8567407A1426439CC11,60171,6,8,2,109.51292,18.30694,1569
19909,156115,6F55ACFC3A2BD8567407A1426439CC11,30071,8,12,4,109.52819,18.30472,1619
19910,156116,6F55ACFC3A2BD8567407A1426439CC11,60171,12,14,2,109.51292,18.30694,1569
19911,156117,6F55ACFC3A2BD8567407A1426439CC11,30071,15,17,2,109.52819,18.30472,1619
19912,156124,B330AB454B331A0CFDC38B66AEDE5BA8,60131,17,19,2,109.49819,18.24778,1509
19913,156125,B330AB454B331A0CFDC38B66AEDE5BA8,60621,20,23,3,109.48354,18.27451,1464
19914,156135,302C193EE9901423C2412C2BB087FCC7,60524,0,6,6,109.42951,18.28993,1216
19915,156136,302C193EE9901423C2412C2BB087FCC7,30351,7,9,2,109.41701,18.29292,1217
19916,156137,302C193EE9901423C2412C2BB087FCC7,31091,13,14,1,109.41201,18.31222,1170
19917,156138,302C193EE9901423C2412C2BB087FCC7,30351,15,19,4,109.41701,18.29292,1217
19918,156139,302C193EE9901423C2412C2BB087FCC7,31091,22,23,1,109.41201,18.31222,1170
19922,156166,A8E229AD359BAFAD8DE94B2EA508C4AD,38891,0,5,5,109.51486,18.24118,1558
19923,156167,A8E229AD359BAFAD8DE94B2EA508C4AD,31261,5,7,2,109.51174,18.2466,1559
19924,156168,A8E229AD359BAFAD8DE94B2EA508C4AD,31206,8,10,2,109.50819,18.23549,1507
19925,156169,A8E229AD359BAFAD8DE94B2EA508C4AD,31181,12,13,1,109.50382,18.24813,1509
19926,156170,A8E229AD359BAFAD8DE94B2EA508C4AD,31206,16,18,2,109.50819,18.23549,1507
19927,156171,A8E229AD359BAFAD8DE94B2EA508C4AD,30731,19,20,1,109.50944,18.22306,1555
19928,156172,A8E229AD359BAFAD8DE94B2EA508C4AD,31441,20,22,2,109.51181,18.24424,1559
19939,156292,6256EC46A5EE081F3E479741B6BEAFA5,60501,0,7,7,109.48701,18.29021,1466
19940,156293,6256EC46A5EE081F3E479741B6BEAFA5,30731,8,23,15,109.50944,18.22306,1555
19941,156297,58E7368992E69F6E05A047BE8D6587D0,38251,0,9,9,109.49618,18.25493,1510
19942,156298,58E7368992E69F6E05A047BE8D6587D0,31471,13,14,1,109.34583,18.29563,917
19943,156299,58E7368992E69F6E05A047BE8D6587D0,38251,17,23,6,109.49618,18.25493,1510
19947,156333,D53608326657C140C9801171477BB48D,38171,18,20,2,109.50799,18.28139,1515
19948,156334,D53608326657C140C9801171477BB48D,30771,20,23,3,109.49938,18.26042,1511
19949,156356,E43761FEBE209371C105554567258124,31321,0,5,5,109.63799,18.23201,2007
19950,156357,E43761FEBE209371C105554567258124,31931,6,9,3,109.54771,18.29403,1667
19951,156358,E43761FEBE209371C105554567258124,30921,11,13,2,109.53903,18.29451,1667
19952,156359,E43761FEBE209371C105554567258124,31931,13,14,1,109.54771,18.29403,1667
19953,156360,E43761FEBE209371C105554567258124,31321,18,23,5,109.63799,18.23201,2007
19961,156436,22B987DE38F8C4435934FE5E6190C4A2,30441,12,14,2,109.64021,18.25424,2010
19962,156437,22B987DE38F8C4435934FE5E6190C4A2,31571,16,19,3,109.61563,18.23326,1957
19969,156510,E9F64FD67E39C3E2C15C20715338A941,31931,0,12,12,109.54771,18.29403,1667
19970,156511,E9F64FD67E39C3E2C15C20715338A941,30921,14,22,8,109.53903,18.29451,1667
19971,156535,2E29BE7E21F829BB8E4505964B146371,30324,7,14,7,109.50326,18.29257,1517
19972,156536,2E29BE7E21F829BB8E4505964B146371,30321,15,17,2,109.49563,18.29611,1467
19973,156553,B39D2F94395224891CE3AFBCC24B5EAD,30661,7,12,5,109.37028,18.24361,1008
19974,156554,B39D2F94395224891CE3AFBCC24B5EAD,60411,12,20,8,109.32514,18.30854,869
19975,156557,13C882817D5EF3329D8612AEE7E0F34D,31864,0,17,17,109.49014,18.28333,1465
19976,156558,13C882817D5EF3329D8612AEE7E0F34D,60381,20,21,1,109.5241,18.22458,1605
19980,156592,878FC5EBB1B28FAABA6E6BFD01664318,30251,0,16,16,109.50611,18.26653,1512
19981,156593,878FC5EBB1B28FAABA6E6BFD01664318,30711,20,21,1,109.50271,18.25347,1510
19982,156637,BDDA3D7B24B34BCCEA8CD647D80A3FAF,30191,2,3,1,109.50361,18.22701,1506
19983,156638,BDDA3D7B24B34BCCEA8CD647D80A3FAF,30181,5,8,3,109.51597,18.23313,1557
19984,156639,BDDA3D7B24B34BCCEA8CD647D80A3FAF,31201,8,9,1,109.51042,18.23819,1558
19985,156640,BDDA3D7B24B34BCCEA8CD647D80A3FAF,30181,10,11,1,109.51597,18.23313,1557
19986,156641,BDDA3D7B24B34BCCEA8CD647D80A3FAF,30711,19,20,1,109.50271,18.25347,1510
19987,156642,BDDA3D7B24B34BCCEA8CD647D80A3FAF,38105,22,23,1,109.40299,18.29229,1117
19988,156654,FA6D7510012E571D09E23E75BE9DD4E6,60441,1,6,5,109.46792,18.28604,1366
19989,156655,FA6D7510012E571D09E23E75BE9DD4E6,38094,8,9,1,109.45403,18.28778,1316
19990,156656,FA6D7510012E571D09E23E75BE9DD4E6,33481,10,16,6,109.67278,18.41278,2187
19991,156717,706B8E0F0F5D1C9FC2F8EBB2574EE89F,39154,8,21,13,109.50201,18.25681,1511
19992,156718,706B8E0F0F5D1C9FC2F8EBB2574EE89F,30911,21,22,1,109.50493,18.26181,1511
19993,156719,706B8E0F0F5D1C9FC2F8EBB2574EE89F,60201,22,23,1,109.5041,18.2509,1510
19994,156727,EBD16061EA20EE33D9344D33735E5205,38891,0,5,5,109.51486,18.24118,1558
19995,156728,EBD16061EA20EE33D9344D33735E5205,31201,5,6,1,109.51042,18.23819,1558
19996,156729,EBD16061EA20EE33D9344D33735E5205,38291,10,12,2,109.51618,18.24313,1558
19997,156730,EBD16061EA20EE33D9344D33735E5205,31201,13,14,1,109.51042,18.23819,1558
19998,156731,EBD16061EA20EE33D9344D33735E5205,31821,14,15,1,109.51181,18.24924,1559
19999,156732,EBD16061EA20EE33D9344D33735E5205,31201,17,19,2,109.51042,18.23819,1558
20000,156733,EBD16061EA20EE33D9344D33735E5205,38891,21,23,2,109.51486,18.24118,1558
20001,156743,35EDAC48C13C8606D4CE310CA7143DD0,31381,11,16,5,109.1375,18.36833,129
20002,156744,35EDAC48C13C8606D4CE310CA7143DD0,31251,17,20,3,109.18528,18.2975,317
20006,156779,20CCCB6B429AF607F53CD26A27B9CFC5,60291,0,5,5,109.50826,18.24639,1509
20007,156780,20CCCB6B429AF607F53CD26A27B9CFC5,30084,9,10,1,109.50118,18.26972,1513
20008,156781,20CCCB6B429AF607F53CD26A27B9CFC5,31931,12,13,1,109.54771,18.29403,1667
20009,156782,20CCCB6B429AF607F53CD26A27B9CFC5,60241,13,14,1,109.53319,18.28667,1616
20010,156788,4879DE9CACF93CF08E9DC08004A43027,30741,14,15,1,109.49833,18.28681,1516
20011,156789,4879DE9CACF93CF08E9DC08004A43027,60472,16,18,2,109.46625,18.29542,1367
20012,156790,4879DE9CACF93CF08E9DC08004A43027,30721,19,23,4,109.51597,18.28257,1565
20013,156797,5C8B80BEC63DDEFB9892A030CF73AEB3,31071,2,3,1,109.58257,18.28458,1815
20014,156798,5C8B80BEC63DDEFB9892A030CF73AEB3,30854,5,8,3,109.56889,18.27076,1763
20015,156839,50942B7AD3E1DC9B7C014E537BF17F88,39111,0,1,1,109.5191,18.22597,1555
20016,156840,50942B7AD3E1DC9B7C014E537BF17F88,31391,3,4,1,109.50382,18.24285,1508
20017,156841,50942B7AD3E1DC9B7C014E537BF17F88,31521,6,7,1,109.51458,18.22542,1555
20018,156842,50942B7AD3E1DC9B7C014E537BF17F88,31781,10,11,1,109.19847,18.2975,367
20019,156843,50942B7AD3E1DC9B7C014E537BF17F88,31471,14,15,1,109.34583,18.29563,917
20020,156853,ACDEAAF45B65DE48CF80A48DBD3C775E,30854,0,10,10,109.56889,18.27076,1763
20021,156854,ACDEAAF45B65DE48CF80A48DBD3C775E,31071,11,13,2,109.58257,18.28458,1815
20022,156855,ACDEAAF45B65DE48CF80A48DBD3C775E,30854,14,16,2,109.56889,18.27076,1763
20023,156856,ACDEAAF45B65DE48CF80A48DBD3C775E,31071,17,18,1,109.58257,18.28458,1815
20024,156857,ACDEAAF45B65DE48CF80A48DBD3C775E,30854,19,20,1,109.56889,18.27076,1763
20025,156868,5EBEA276FCB4A19AC5C987F5C7CC8908,60401,0,7,7,109.47444,18.27583,1414
20026,156869,5EBEA276FCB4A19AC5C987F5C7CC8908,38361,10,11,1,109.43667,18.29201,1267
20030,156915,0312B43ACF9ED1D8304E325E851AEE29,31561,7,10,3,109.56792,18.28479,1765
20031,156916,0312B43ACF9ED1D8304E325E851AEE29,30851,10,11,1,109.5616,18.27396,1713
20032,156917,0312B43ACF9ED1D8304E325E851AEE29,31561,11,15,4,109.56792,18.28479,1765
20033,156918,0312B43ACF9ED1D8304E325E851AEE29,30851,15,17,2,109.5616,18.27396,1713
20034,156919,0312B43ACF9ED1D8304E325E851AEE29,31561,17,19,2,109.56792,18.28479,1765
20035,156920,0312B43ACF9ED1D8304E325E851AEE29,30851,20,21,1,109.5616,18.27396,1713
20036,156952,383D937DE514A0EC375F222FA3476E15,31031,0,10,10,109.49979,18.25382,1510
20041,157090,0C8D15C0488D521680F0DE3A28CFE111,30701,0,1,1,109.59313,18.32007,1871
20042,157091,0C8D15C0488D521680F0DE3A28CFE111,31811,4,6,2,109.54201,18.31806,1671
20043,157092,0C8D15C0488D521680F0DE3A28CFE111,30701,7,14,7,109.59313,18.32007,1871
20044,157093,0C8D15C0488D521680F0DE3A28CFE111,31091,16,17,1,109.41201,18.31222,1170
20045,157094,0C8D15C0488D521680F0DE3A28CFE111,30701,20,23,3,109.59313,18.32007,1871
20046,157104,CA3896FB33E9BC68E91955EDFF5D709B,30854,14,15,1,109.56889,18.27076,1763
20047,157105,CA3896FB33E9BC68E91955EDFF5D709B,31821,19,21,2,109.51181,18.24924,1559
20048,157120,45CCFCD3EBDF941E1C92B70ED06E8B5E,30854,0,12,12,109.56889,18.27076,1763
20049,157121,45CCFCD3EBDF941E1C92B70ED06E8B5E,31071,12,13,1,109.58257,18.28458,1815
20050,157122,45CCFCD3EBDF941E1C92B70ED06E8B5E,30854,15,16,1,109.56889,18.27076,1763
20051,157123,45CCFCD3EBDF941E1C92B70ED06E8B5E,31521,19,21,2,109.51458,18.22542,1555
20052,157124,45CCFCD3EBDF941E1C92B70ED06E8B5E,30854,22,23,1,109.56889,18.27076,1763
20053,157154,998A01460E3F739CE0004E00240DDFFF,31521,0,9,9,109.51458,18.22542,1555
20054,157155,998A01460E3F739CE0004E00240DDFFF,38361,14,18,4,109.43667,18.29201,1267
20055,157156,998A01460E3F739CE0004E00240DDFFF,31701,19,23,4,109.44132,18.28833,1266
20056,157157,F8B0DC789B112F08EAF5FF1027906309,39183,11,13,2,109.55542,18.28208,1715
20057,157158,F8B0DC789B112F08EAF5FF1027906309,30854,14,16,2,109.56889,18.27076,1763
20058,157159,F8B0DC789B112F08EAF5FF1027906309,38071,17,19,2,109.40722,18.30938,1169
20065,157181,933C30058B1CA246EC59609197D7CAAB,31071,12,23,11,109.58257,18.28458,1815
20066,157238,25419DDF60017295279E872003D6F9C0,60501,0,12,12,109.48701,18.29021,1466
20071,157274,886165CD4CCF3674607C202B8ADD28B5,31781,13,15,2,109.19847,18.2975,367
20072,157275,886165CD4CCF3674607C202B8ADD28B5,31031,17,18,1,109.49979,18.25382,1510
20076,157356,5BAA9C7C807C2E83985768BCEFDEE04A,31231,4,9,5,109.42597,18.29292,1217
20077,157357,5BAA9C7C807C2E83985768BCEFDEE04A,39091,13,14,1,109.50097,18.25222,1510
20078,157358,5BAA9C7C807C2E83985768BCEFDEE04A,30661,19,23,4,109.37028,18.24361,1008
20079,157359,BAFDD3A022A674BA6CCC93E365FAFC36,30201,0,6,6,109.4909,18.26465,1462
20080,157399,DA10676C4DA702E02A2C3FFFAC40ABA2,39183,16,17,1,109.55542,18.28208,1715
20081,157400,DA10676C4DA702E02A2C3FFFAC40ABA2,31561,17,23,6,109.56792,18.28479,1765
20082,157457,AD608A919061B1C684914F8654FB2493,30651,5,6,1,109.42611,18.385,1232
20083,157458,AD608A919061B1C684914F8654FB2493,60041,8,9,1,109.39889,18.31944,1121
20084,157459,AD608A919061B1C684914F8654FB2493,31231,9,15,6,109.42597,18.29292,1217
20085,157460,AD608A919061B1C684914F8654FB2493,30651,17,23,6,109.42611,18.385,1232
20090,157500,28B366167501D3E270BF1F5EDB4474EC,30854,10,13,3,109.56889,18.27076,1763
20091,157501,28B366167501D3E270BF1F5EDB4474EC,31561,16,19,3,109.56792,18.28479,1765
20092,157529,56C8C781972E8BFAF8A768A19AD7F590,38127,0,7,7,109.50833,18.27222,1513
20093,157533,56C8C781972E8BFAF8A768A19AD7F590,38127,18,23,5,109.50833,18.27222,1513
20094,157550,C709D01469E0800AF998DFAF42105CDC,60631,0,3,3,109.57778,18.27583,1814
20095,157551,C709D01469E0800AF998DFAF42105CDC,30854,4,5,1,109.56889,18.27076,1763
20096,157552,C709D01469E0800AF998DFAF42105CDC,31561,5,6,1,109.56792,18.28479,1765
20097,157553,C709D01469E0800AF998DFAF42105CDC,30854,8,10,2,109.56889,18.27076,1763
20098,157554,C709D01469E0800AF998DFAF42105CDC,31561,13,16,3,109.56792,18.28479,1765
20099,157555,C709D01469E0800AF998DFAF42105CDC,30854,17,19,2,109.56889,18.27076,1763
20100,157556,C709D01469E0800AF998DFAF42105CDC,60631,20,23,3,109.57778,18.27583,1814
20101,157569,173CD7A2B7B334BC53A50A1D248FBCFE,30854,7,17,10,109.56889,18.27076,1763
20102,157570,173CD7A2B7B334BC53A50A1D248FBCFE,31071,19,20,1,109.58257,18.28458,1815
20103,157571,173CD7A2B7B334BC53A50A1D248FBCFE,30854,20,22,2,109.56889,18.27076,1763
20104,157572,451E2BF48CD7B253EB0892324E679BCC,60281,7,17,10,109.51743,18.25924,1561
20105,157573,451E2BF48CD7B253EB0892324E679BCC,38297,19,21,2,109.52576,18.24965,1609
20106,157574,451E2BF48CD7B253EB0892324E679BCC,31461,22,23,1,109.5091,18.25389,1510
20107,157607,8883DF5E66B5FC284A8EF97DE8EAAAB3,60214,13,14,1,109.63104,18.24493,2009
20108,157608,8883DF5E66B5FC284A8EF97DE8EAAAB3,30581,15,16,1,109.62257,18.24951,1959
20113,157637,DDE77D3A656666992FC3458B84010D43,39183,1,4,3,109.55542,18.28208,1715
20114,157638,DDE77D3A656666992FC3458B84010D43,31561,6,20,14,109.56792,18.28479,1765
20115,157675,EDAE3160B50CE140907F5C4DAEEDDA8F,30201,11,17,6,109.4909,18.26465,1462
20116,157676,EDAE3160B50CE140907F5C4DAEEDDA8F,31081,18,19,1,109.44639,18.30181,1318
20117,157677,EDAE3160B50CE140907F5C4DAEEDDA8F,31091,20,21,1,109.41201,18.31222,1170
20118,157678,C8B662CAEBDC359FAD2D68CB046F51F0,30681,0,7,7,109.48493,18.26917,1463
20119,157679,C8B662CAEBDC359FAD2D68CB046F51F0,60401,7,9,2,109.47444,18.27583,1414
20120,157680,C8B662CAEBDC359FAD2D68CB046F51F0,31781,12,15,3,109.19847,18.2975,367
20121,157681,C8B662CAEBDC359FAD2D68CB046F51F0,30681,19,23,4,109.48493,18.26917,1463
20126,157715,F6A1EBB84FE583E84185C423218578F5,31561,0,6,6,109.56792,18.28479,1765
20127,157716,F6A1EBB84FE583E84185C423218578F5,39091,11,12,1,109.50097,18.25222,1510
20128,157717,F6A1EBB84FE583E84185C423218578F5,31561,14,23,9,109.56792,18.28479,1765
20129,157758,0E1B3CFC64EBB658DA96D0DCA834701E,61011,0,14,14,109.60653,18.19076,1900
20130,157760,0E1B3CFC64EBB658DA96D0DCA834701E,61011,18,23,5,109.60653,18.19076,1900
20131,157775,CB1C8502149DACE0B32B2F7416279EF2,30854,10,11,1,109.56889,18.27076,1763
20132,157793,8C7667B6277A3C193B50CC18C706780E,30951,10,13,3,109.56208,18.25667,1761
20133,157794,8C7667B6277A3C193B50CC18C706780E,31421,16,17,1,109.55382,18.22347,1705
20134,157795,8C7667B6277A3C193B50CC18C706780E,60581,18,23,5,109.59785,18.29931,1868
20135,157820,D39D64452E6BBEF7B3056CA239E1B86E,30854,0,1,1,109.56889,18.27076,1763
20136,157821,D39D64452E6BBEF7B3056CA239E1B86E,30851,1,5,4,109.5616,18.27396,1713
20137,157822,D39D64452E6BBEF7B3056CA239E1B86E,30854,7,14,7,109.56889,18.27076,1763
20138,157823,D39D64452E6BBEF7B3056CA239E1B86E,31561,14,15,1,109.56792,18.28479,1765
20139,157824,D39D64452E6BBEF7B3056CA239E1B86E,30854,16,23,7,109.56889,18.27076,1763
20146,157930,5EB757C8918F704B5295B0BDE01D6841,38754,11,13,2,109.74667,18.37382,2430
20147,157945,CD576F1C1CDFB89E6A99A20E65927346,31561,3,4,1,109.56792,18.28479,1765
20148,157946,CD576F1C1CDFB89E6A99A20E65927346,30854,9,22,13,109.56889,18.27076,1763
20149,157968,FB0C3DBC0AB121F552294646CC7B81E6,60087,0,7,7,109.50688,18.22299,1505
20150,157969,FB0C3DBC0AB121F552294646CC7B81E6,30961,10,17,7,109.74042,18.37903,2431
20151,157970,FB0C3DBC0AB121F552294646CC7B81E6,30371,18,20,2,109.51,18.24771,1559
20152,157971,FB0C3DBC0AB121F552294646CC7B81E6,60121,22,23,1,109.74507,18.37472,2430
20153,157983,15B71EBD44CAF1ECFDFB1D93C0E3A395,31161,0,15,15,109.70229,18.31361,2270
20154,157984,15B71EBD44CAF1ECFDFB1D93C0E3A395,31861,18,19,1,109.49042,18.27549,1464
20155,157987,B0D7DAF8D84656FF4C7229ABB8EA1350,31561,2,7,5,109.56792,18.28479,1765
20156,157988,B0D7DAF8D84656FF4C7229ABB8EA1350,30854,9,13,4,109.56889,18.27076,1763
20157,158000,B712327B6033C61F37801CFD6DAC08AD,31951,3,5,2,109.52174,18.30299,1568
20158,158001,B712327B6033C61F37801CFD6DAC08AD,38484,7,14,7,109.53028,18.31528,1620
20159,158002,B712327B6033C61F37801CFD6DAC08AD,38484,15,18,3,109.53028,18.31528,1620
20160,158003,B712327B6033C61F37801CFD6DAC08AD,38484,20,22,2,109.53028,18.31528,1620
20161,158004,B712327B6033C61F37801CFD6DAC08AD,31951,22,23,1,109.52174,18.30299,1568
20169,158031,B81C37BC332023335C0BA8EE3FC6F3B6,31031,17,18,1,109.49979,18.25382,1510
20170,158032,B81C37BC332023335C0BA8EE3FC6F3B6,30361,18,20,2,109.50347,18.24,1508
20171,158033,B81C37BC332023335C0BA8EE3FC6F3B6,31231,21,23,2,109.42597,18.29292,1217
20172,158049,EB51257A99E5D8C5B96E616F99FA4BE1,31061,0,8,8,109.53333,18.23257,1607
20173,158050,EB51257A99E5D8C5B96E616F99FA4BE1,38325,13,14,1,109.39792,18.2909,1116
20174,158051,EB51257A99E5D8C5B96E616F99FA4BE1,30571,15,16,1,109.50243,18.21861,1504
20175,158052,EB51257A99E5D8C5B96E616F99FA4BE1,30361,20,21,1,109.50347,18.24,1508
20176,158102,225EDE82328108AFB3E7EE610CA3F074,31931,0,18,18,109.54771,18.29403,1667
20177,158103,225EDE82328108AFB3E7EE610CA3F074,60371,18,21,3,109.53063,18.30056,1618
20182,158182,7FF3C6569A3990C03CAF6C52D3C8BC6C,60241,11,13,2,109.53319,18.28667,1616
20183,158183,7FF3C6569A3990C03CAF6C52D3C8BC6C,30921,15,23,8,109.53903,18.29451,1667
20184,158242,192815485DBBC485508837480A81E25C,30151,0,7,7,109.50986,18.25083,1560
20185,158243,192815485DBBC485508837480A81E25C,30711,7,9,2,109.50271,18.25347,1510
20186,158244,192815485DBBC485508837480A81E25C,60381,9,10,1,109.5241,18.22458,1605
20187,158245,192815485DBBC485508837480A81E25C,31461,11,15,4,109.5091,18.25389,1510
20188,158246,192815485DBBC485508837480A81E25C,30051,18,22,4,109.48917,18.21215,1453
20189,158247,9D08F64A3A6AF6A3D8E4936FA0DD307A,31471,17,19,2,109.34583,18.29563,917
20190,158248,9D08F64A3A6AF6A3D8E4936FA0DD307A,38903,21,23,2,109.39229,18.29243,1117
20191,158279,B45693D5B184478846DA7E564CBD0CD0,38052,9,12,3,109.62618,18.23042,1956
20192,158280,B45693D5B184478846DA7E564CBD0CD0,31071,14,15,1,109.58257,18.28458,1815
20193,158314,D7B221E6999CDA2B49CD9F659205E39E,60661,0,8,8,109.548,18.2377,1657
20194,158315,D7B221E6999CDA2B49CD9F659205E39E,31421,9,11,2,109.55382,18.22347,1705
20195,158316,D7B221E6999CDA2B49CD9F659205E39E,60661,12,13,1,109.548,18.2377,1657
20196,158317,D7B221E6999CDA2B49CD9F659205E39E,31201,19,20,1,109.51042,18.23819,1558
20197,158318,D7B221E6999CDA2B49CD9F659205E39E,60661,22,23,1,109.548,18.2377,1657
20201,158346,A02F58F4D887D8C7AFCC5C3BF1733917,31461,15,16,1,109.5091,18.25389,1510
20202,158347,A02F58F4D887D8C7AFCC5C3BF1733917,31261,19,21,2,109.51174,18.2466,1559
20203,158348,A02F58F4D887D8C7AFCC5C3BF1733917,38291,21,22,1,109.51618,18.24313,1558
20204,158367,A928E9F6C796FE1A60807BA003DE87BB,39183,12,14,2,109.55542,18.28208,1715
20205,158368,A928E9F6C796FE1A60807BA003DE87BB,30854,16,18,2,109.56889,18.27076,1763
20206,158369,A928E9F6C796FE1A60807BA003DE87BB,31071,18,19,1,109.58257,18.28458,1815
20207,158370,A928E9F6C796FE1A60807BA003DE87BB,30854,19,23,4,109.56889,18.27076,1763
20211,158390,80B72DFF870E58099F17893CA96A269C,31071,0,16,16,109.58257,18.28458,1815
20212,158391,80B72DFF870E58099F17893CA96A269C,31945,18,19,1,109.58021,18.29403,1817
20213,158401,3F320FCC97654DBDACE66BB1BF09E301,30084,19,20,1,109.50118,18.26972,1513
20214,158402,3F320FCC97654DBDACE66BB1BF09E301,38061,20,21,1,109.50597,18.23118,1506
20215,158431,068048E7A110C24CC84B03CCF16511AC,31531,20,21,1,109.49583,18.25972,1461
20216,158432,068048E7A110C24CC84B03CCF16511AC,38251,22,23,1,109.49618,18.25493,1510
20220,158452,33DACB62584DBB9731FA36EFE0B72692,31071,5,8,3,109.58257,18.28458,1815
20221,158453,33DACB62584DBB9731FA36EFE0B72692,30854,10,20,10,109.56889,18.27076,1763
20222,158454,70A62761FE79F922D082380DA7747243,30854,1,10,9,109.56889,18.27076,1763
20223,158455,70A62761FE79F922D082380DA7747243,38754,14,16,2,109.74667,18.37382,2430
20227,158485,E4B522EF4348156010E5C578EC13D60F,30854,0,8,8,109.56889,18.27076,1763
20228,158486,E4B522EF4348156010E5C578EC13D60F,60361,11,13,2,109.51938,18.29681,1567
20229,158487,E4B522EF4348156010E5C578EC13D60F,38991,18,19,1,109.52681,18.30368,1618
20230,158488,E4B522EF4348156010E5C578EC13D60F,30191,20,22,2,109.50361,18.22701,1506
20231,158489,F25102D4BE48A66B8AE50787215C5331,31181,0,13,13,109.50382,18.24813,1509
20232,158490,F25102D4BE48A66B8AE50787215C5331,31181,14,23,9,109.50382,18.24813,1509
20233,158495,9AF351B3CC27394DFED45513F0E32162,30951,8,10,2,109.56208,18.25667,1761
20234,158496,9AF351B3CC27394DFED45513F0E32162,31551,11,13,2,109.55868,18.24222,1708
20235,158497,9AF351B3CC27394DFED45513F0E32162,30851,13,14,1,109.5616,18.27396,1713
20236,158498,9AF351B3CC27394DFED45513F0E32162,31551,15,16,1,109.55868,18.24222,1708
20240,158510,D090D23BEAB243AAF74CB3648E81F65B,30851,3,6,3,109.5616,18.27396,1713
20241,158511,D090D23BEAB243AAF74CB3648E81F65B,31561,8,21,13,109.56792,18.28479,1765
20249,158526,7BF5A8A20737728F6EEBC1B96BC6C752,38094,13,17,4,109.45403,18.28778,1316
20250,158527,7BF5A8A20737728F6EEBC1B96BC6C752,31021,20,23,3,109.49021,18.27,1463
20258,158565,28413CB0160B68347E92144BE214EF48,60381,17,18,1,109.5241,18.22458,1605
20259,158566,28413CB0160B68347E92144BE214EF48,30181,19,20,1,109.51597,18.23313,1557
20263,158614,3E01B14B28C0FDBF8BB343D61C8AA7D8,60361,11,14,3,109.51938,18.29681,1567
20264,158615,3E01B14B28C0FDBF8BB343D61C8AA7D8,31931,15,17,2,109.54771,18.29403,1667
20265,158616,3E01B14B28C0FDBF8BB343D61C8AA7D8,60241,18,20,2,109.53319,18.28667,1616
20266,158617,3E01B14B28C0FDBF8BB343D61C8AA7D8,60331,21,23,2,109.505,18.26507,1512
20267,158627,6FC418E3C4CF83240DA2FD9B60CEEA6E,30151,0,1,1,109.50986,18.25083,1560
20268,158628,6FC418E3C4CF83240DA2FD9B60CEEA6E,31821,2,3,1,109.51181,18.24924,1559
20269,158629,6FC418E3C4CF83240DA2FD9B60CEEA6E,30151,4,6,2,109.50986,18.25083,1560
20270,158630,6FC418E3C4CF83240DA2FD9B60CEEA6E,30151,6,14,8,109.50986,18.25083,1560
20271,158631,6FC418E3C4CF83240DA2FD9B60CEEA6E,31521,18,21,3,109.51458,18.22542,1555
20272,158632,6FC418E3C4CF83240DA2FD9B60CEEA6E,30151,21,23,2,109.50986,18.25083,1560
20273,158633,8920C93432771D8645B969281AC5EB63,30661,13,15,2,109.37028,18.24361,1008
20274,158634,8920C93432771D8645B969281AC5EB63,30361,16,23,7,109.50347,18.24,1508
20275,158658,963B5F4C98446446023B8ED177B869B3,31561,14,15,1,109.56792,18.28479,1765
20276,158659,963B5F4C98446446023B8ED177B869B3,60361,19,23,4,109.51938,18.29681,1567
20277,158660,C61360C6C8202A54143E165C2C08120B,30951,1,2,1,109.56208,18.25667,1761
20278,158661,C61360C6C8202A54143E165C2C08120B,30232,2,4,2,109.6191,18.31701,1971
20279,158662,C61360C6C8202A54143E165C2C08120B,30951,4,10,6,109.56208,18.25667,1761
20280,158692,66B36EAB2804138C84FF096B3B06E748,30421,6,7,1,109.50021,18.25861,1511
20281,158693,66B36EAB2804138C84FF096B3B06E748,30711,7,23,16,109.50271,18.25347,1510
20282,158709,065F1687C35F3C827A2EA4A378A0E2C6,30951,0,6,6,109.56208,18.25667,1761
20283,158710,065F1687C35F3C827A2EA4A378A0E2C6,30851,9,12,3,109.5616,18.27396,1713
20284,158733,BD24F3225C20924188793107A437125E,60524,0,3,3,109.42951,18.28993,1216
20285,158734,BD24F3225C20924188793107A437125E,30351,3,8,5,109.41701,18.29292,1217
20286,158735,BD24F3225C20924188793107A437125E,31145,9,11,2,109.20431,18.30479,369
20287,158736,BD24F3225C20924188793107A437125E,31471,13,14,1,109.34583,18.29563,917
20288,158737,BD24F3225C20924188793107A437125E,60524,19,20,1,109.42951,18.28993,1216
20293,158750,B621E9075674E792CCB217233825F9D1,30854,0,3,3,109.56889,18.27076,1763
20294,158751,B621E9075674E792CCB217233825F9D1,30851,4,13,9,109.5616,18.27396,1713
20298,158805,76F07B8DC17758A94772CF5ACE457FAC,31531,0,1,1,109.49583,18.25972,1461
20299,158806,76F07B8DC17758A94772CF5ACE457FAC,31531,3,5,2,109.49583,18.25972,1461
20300,158807,76F07B8DC17758A94772CF5ACE457FAC,31781,9,11,2,109.19847,18.2975,367
20301,158808,76F07B8DC17758A94772CF5ACE457FAC,31145,12,13,1,109.20431,18.30479,369
20302,158823,89A01963B06628A3D6B13DA41FA507D1,31561,0,18,18,109.56792,18.28479,1765
20303,158824,89A01963B06628A3D6B13DA41FA507D1,30854,18,19,1,109.56889,18.27076,1763
20304,158831,5513D4DF2C6575E373329D82A78CC8F3,31461,12,13,1,109.5091,18.25389,1510
20305,158832,5513D4DF2C6575E373329D82A78CC8F3,60201,18,20,2,109.5041,18.2509,1510
20306,158840,932D308A47BD924E11B570EA7CB7901D,31521,10,17,7,109.51458,18.22542,1555
20320,158914,C1788356D6298A19C2039F0E2F1C2CF1,60381,0,1,1,109.5241,18.22458,1605
20321,158915,C1788356D6298A19C2039F0E2F1C2CF1,30891,4,10,6,109.59431,18.28389,1865
20322,158916,C1788356D6298A19C2039F0E2F1C2CF1,60011,15,16,1,109.48965,18.30222,1468
20323,158931,28F7DFD4A036DBA4E68AFC71762D44D7,30851,18,20,2,109.5616,18.27396,1713
20324,158932,28F7DFD4A036DBA4E68AFC71762D44D7,31561,20,22,2,109.56792,18.28479,1765
20325,158933,28F7DFD4A036DBA4E68AFC71762D44D7,30851,22,23,1,109.5616,18.27396,1713
20326,158943,872709FDC860D320EC74676CCC63D436,60291,14,15,1,109.50826,18.24639,1509
20327,158944,872709FDC860D320EC74676CCC63D436,30511,15,17,2,109.51069,18.24208,1558
20328,158945,872709FDC860D320EC74676CCC63D436,39154,21,23,2,109.50201,18.25681,1511
20329,158946,AD6CE74FEECB42F7806A62DA7A4CECCA,60631,9,10,1,109.57778,18.27583,1814
20330,158947,AD6CE74FEECB42F7806A62DA7A4CECCA,30854,12,18,6,109.56889,18.27076,1763
20331,158974,1BDE433888973A22F2D9A5CC8B5A34FF,31071,0,7,7,109.58257,18.28458,1815
20332,158975,1BDE433888973A22F2D9A5CC8B5A34FF,30854,7,8,1,109.56889,18.27076,1763
20333,158976,1BDE433888973A22F2D9A5CC8B5A34FF,30221,10,21,11,109.57833,18.20222,1802
20334,159004,CB0DCEB8E5573AF0622B1E4D0B156499,38052,0,14,14,109.62618,18.23042,1956
20335,159005,CB0DCEB8E5573AF0622B1E4D0B156499,30361,17,18,1,109.50347,18.24,1508
20336,159006,CB0DCEB8E5573AF0622B1E4D0B156499,38052,20,22,2,109.62618,18.23042,1956
20337,159036,D2A5F87218CF25385163A2F3C4229CB8,30851,7,15,8,109.5616,18.27396,1713
20338,159037,D2A5F87218CF25385163A2F3C4229CB8,31561,19,23,4,109.56792,18.28479,1765
20339,159041,DF49F834C08C7E8FA6D78272EE1FB651,60361,0,7,7,109.51938,18.29681,1567
20340,159042,DF49F834C08C7E8FA6D78272EE1FB651,30851,7,10,3,109.5616,18.27396,1713
20341,159043,DF49F834C08C7E8FA6D78272EE1FB651,30951,10,15,5,109.56208,18.25667,1761
20342,159044,DF49F834C08C7E8FA6D78272EE1FB651,60361,18,23,5,109.51938,18.29681,1567
20343,159067,8DD23AA43C0F7967C45F7488D66F9159,31945,0,7,7,109.58021,18.29403,1817
20344,159068,8DD23AA43C0F7967C45F7488D66F9159,30854,8,20,12,109.56889,18.27076,1763
20348,159079,38D035140A3A408F4047FF243A2434AD,30921,0,9,9,109.53903,18.29451,1667
20349,159080,38D035140A3A408F4047FF243A2434AD,30151,10,11,1,109.50986,18.25083,1560
20350,159081,38D035140A3A408F4047FF243A2434AD,38251,11,12,1,109.49618,18.25493,1510
20351,159082,38D035140A3A408F4047FF243A2434AD,30921,14,17,3,109.53903,18.29451,1667
20352,159083,38D035140A3A408F4047FF243A2434AD,30421,19,20,1,109.50021,18.25861,1511
20353,159084,38D035140A3A408F4047FF243A2434AD,30921,22,23,1,109.53903,18.29451,1667
20354,159098,598A5BC9BEA86E74379689160E91B24E,31071,0,1,1,109.58257,18.28458,1815
20355,159099,598A5BC9BEA86E74379689160E91B24E,30854,2,19,17,109.56889,18.27076,1763
20359,159212,E744F6CA97803D8EE5E846E5B7FD2E92,31945,18,19,1,109.58021,18.29403,1817
20360,159213,E744F6CA97803D8EE5E846E5B7FD2E92,60631,20,22,2,109.57778,18.27583,1814
20364,159237,C9FB9F2C2796B7DA9E44AABC0342CC7A,31081,0,7,7,109.44639,18.30181,1318
20365,159238,C9FB9F2C2796B7DA9E44AABC0342CC7A,31301,9,11,2,109.14493,18.31222,170
20366,159239,C9FB9F2C2796B7DA9E44AABC0342CC7A,31471,11,14,3,109.34583,18.29563,917
20367,159240,C9FB9F2C2796B7DA9E44AABC0342CC7A,30371,16,18,2,109.51,18.24771,1559
20368,159241,C9FB9F2C2796B7DA9E44AABC0342CC7A,60551,19,20,1,109.42722,18.30111,1218
20369,159242,C9FB9F2C2796B7DA9E44AABC0342CC7A,31554,21,22,1,109.55521,18.2459,1709
20370,159287,2A6BA0678DDF16AF08BAC9E3FA3C9391,31561,7,9,2,109.56792,18.28479,1765
20371,159288,2A6BA0678DDF16AF08BAC9E3FA3C9391,30854,9,11,2,109.56889,18.27076,1763
20372,159289,2A6BA0678DDF16AF08BAC9E3FA3C9391,31561,13,14,1,109.56792,18.28479,1765
20373,159290,2A6BA0678DDF16AF08BAC9E3FA3C9391,30854,16,19,3,109.56889,18.27076,1763
20389,159389,34F3D64B41C252481F72E5CF931AC833,30854,4,6,2,109.56889,18.27076,1763
20390,159390,34F3D64B41C252481F72E5CF931AC833,31071,10,14,4,109.58257,18.28458,1815
20394,159438,320DCBE6D506CB46EF34B31CD4373E09,31031,11,13,2,109.49979,18.25382,1510
20395,159439,320DCBE6D506CB46EF34B31CD4373E09,31521,13,15,2,109.51458,18.22542,1555
20396,159440,320DCBE6D506CB46EF34B31CD4373E09,31521,17,19,2,109.51458,18.22542,1555
20397,159441,320DCBE6D506CB46EF34B31CD4373E09,31521,19,22,3,109.51458,18.22542,1555
20398,159462,ABCD0851CC1C78BCD7AF6DBDF2F5DE49,60524,2,3,1,109.42951,18.28993,1216
20399,159463,ABCD0851CC1C78BCD7AF6DBDF2F5DE49,31031,8,9,1,109.49979,18.25382,1510
20400,159464,ABCD0851CC1C78BCD7AF6DBDF2F5DE49,60552,10,19,9,109.41729,18.30014,1218
20401,159473,B93D357AAB05700B15F775F104378052,31841,1,14,13,109.73201,18.33382,2373
20402,159474,B93D357AAB05700B15F775F104378052,60114,15,17,2,109.73028,18.33847,2374
20403,159475,5E97A4561E11AAC4FBC53FD068EAA52B,30854,0,7,7,109.56889,18.27076,1763
20404,159476,5E97A4561E11AAC4FBC53FD068EAA52B,30531,8,18,10,109.53271,18.21472,1604
20405,159477,5E97A4561E11AAC4FBC53FD068EAA52B,30854,20,22,2,109.56889,18.27076,1763
20409,159577,6593F76DF8B5BF518604AD69943FBD58,30854,0,6,6,109.56889,18.27076,1763
20410,159578,6593F76DF8B5BF518604AD69943FBD58,31071,6,7,1,109.58257,18.28458,1815
20411,159591,E5D9C2E63CCE9D1234DB3809C4F11F20,38291,0,10,10,109.51618,18.24313,1558
20412,159592,E5D9C2E63CCE9D1234DB3809C4F11F20,30371,10,11,1,109.51,18.24771,1559
20413,159593,E5D9C2E63CCE9D1234DB3809C4F11F20,30421,14,16,2,109.50021,18.25861,1511
20414,159594,E5D9C2E63CCE9D1234DB3809C4F11F20,60671,20,22,2,109.52979,18.31757,1621
20425,159665,E960A9C960574B6ECAA9E8161ED40783,30181,0,1,1,109.51597,18.23313,1557
20426,159666,E960A9C960574B6ECAA9E8161ED40783,31521,2,4,2,109.51458,18.22542,1555
20427,159667,E960A9C960574B6ECAA9E8161ED40783,30181,5,10,5,109.51597,18.23313,1557
20428,159668,E960A9C960574B6ECAA9E8161ED40783,60291,12,14,2,109.50826,18.24639,1509
20429,159669,E960A9C960574B6ECAA9E8161ED40783,30361,19,21,2,109.50347,18.24,1508
20430,159670,E960A9C960574B6ECAA9E8161ED40783,30181,22,23,1,109.51597,18.23313,1557
20431,159677,BF601B271A76319695C5DD1D101B549E,60501,0,4,4,109.48701,18.29021,1466
20432,159678,BF601B271A76319695C5DD1D101B549E,38951,4,23,19,109.48097,18.28868,1416
20433,159692,D120910A908EA6AFCCC9BC3841E6089E,38891,0,5,5,109.51486,18.24118,1558
20434,159693,D120910A908EA6AFCCC9BC3841E6089E,31261,5,6,1,109.51174,18.2466,1559
20435,159694,D120910A908EA6AFCCC9BC3841E6089E,31821,6,8,2,109.51181,18.24924,1559
20436,159695,D120910A908EA6AFCCC9BC3841E6089E,60311,14,18,4,109.52097,18.24319,1558
20437,159696,D120910A908EA6AFCCC9BC3841E6089E,38891,19,23,4,109.51486,18.24118,1558
20444,159748,4E94ADAE7ABEB20EEFAF67519DFCC1BE,31081,0,9,9,109.44639,18.30181,1318
20445,159749,4E94ADAE7ABEB20EEFAF67519DFCC1BE,31031,9,12,3,109.49979,18.25382,1510
20446,159750,4E94ADAE7ABEB20EEFAF67519DFCC1BE,31031,13,21,8,109.49979,18.25382,1510
20447,159800,00FD2268DE6E83934D2916174E81532F,30111,6,7,1,109.47583,18.30542,1419
20448,159801,00FD2268DE6E83934D2916174E81532F,60472,11,14,3,109.46625,18.29542,1367
20449,159802,00FD2268DE6E83934D2916174E81532F,30111,14,18,4,109.47583,18.30542,1419
20450,159803,00FD2268DE6E83934D2916174E81532F,60472,18,19,1,109.46625,18.29542,1367
20451,159804,00FD2268DE6E83934D2916174E81532F,30111,20,21,1,109.47583,18.30542,1419
20452,159817,B95D5FCFC7327770C14B6F9FFDB772BC,31945,19,20,1,109.58021,18.29403,1817
20453,159818,B95D5FCFC7327770C14B6F9FFDB772BC,31071,22,23,1,109.58257,18.28458,1815
20454,159827,996C0D9500BF90CC0E7F5A04C49A464B,31931,11,15,4,109.54771,18.29403,1667
20455,159828,996C0D9500BF90CC0E7F5A04C49A464B,30921,15,22,7,109.53903,18.29451,1667
20456,159838,B340EDEF4A878E8DF5CBEC25E465EACE,31071,0,4,4,109.58257,18.28458,1815
20457,159839,B340EDEF4A878E8DF5CBEC25E465EACE,30854,8,20,12,109.56889,18.27076,1763
20458,159845,91B57D3795DD45AFB8F2D4F7355B86E1,60441,16,18,2,109.46792,18.28604,1366
20459,159846,91B57D3795DD45AFB8F2D4F7355B86E1,31531,21,23,2,109.49583,18.25972,1461
20460,159860,55319B0406504211FF8992838E0FDE0A,31071,0,7,7,109.58257,18.28458,1815
20461,159861,55319B0406504211FF8992838E0FDE0A,31091,8,10,2,109.41201,18.31222,1170
20462,159863,F198CAA1F49ACA5D003FD8F8473B3798,31071,0,7,7,109.58257,18.28458,1815
20463,159864,F198CAA1F49ACA5D003FD8F8473B3798,30854,11,21,10,109.56889,18.27076,1763
20464,159884,2EBBAC66DDB6248DEB5E1D635794A55A,61011,0,4,4,109.60653,18.19076,1900
20465,159886,2EBBAC66DDB6248DEB5E1D635794A55A,61011,11,15,4,109.60653,18.19076,1900
20466,159895,B29FD39DCB3A3F5A51C3484B063DCAD3,38017,0,11,11,109.49729,18.21424,1504
20467,159896,B29FD39DCB3A3F5A51C3484B063DCAD3,31521,12,13,1,109.51458,18.22542,1555
20468,159899,C860767955774E3494068CF38C009FB6,31061,15,17,2,109.53333,18.23257,1607
20469,159900,C860767955774E3494068CF38C009FB6,60131,20,21,1,109.49819,18.24778,1509
20470,159901,C860767955774E3494068CF38C009FB6,60391,22,23,1,109.47667,18.28757,1416
20475,159943,552B98A65A23DB4CD390E78F3246E9C5,60221,1,2,1,109.52569,18.29188,1616
20476,159944,552B98A65A23DB4CD390E78F3246E9C5,31931,3,6,3,109.54771,18.29403,1667
20477,159945,552B98A65A23DB4CD390E78F3246E9C5,30921,9,11,2,109.53903,18.29451,1667
20478,159946,552B98A65A23DB4CD390E78F3246E9C5,31931,12,16,4,109.54771,18.29403,1667
20479,159947,552B98A65A23DB4CD390E78F3246E9C5,60221,19,21,2,109.52569,18.29188,1616
20480,159948,552B98A65A23DB4CD390E78F3246E9C5,30921,22,23,1,109.53903,18.29451,1667
20481,159966,B89747DA8FD8C271771A8056C80A48B6,30421,0,8,8,109.50021,18.25861,1511
20482,159967,B89747DA8FD8C271771A8056C80A48B6,30581,8,10,2,109.62257,18.24951,1959
20483,159974,1C9FB52F3215AC60A67CACDC4AFA4355,30084,14,16,2,109.50118,18.26972,1513
20484,159975,1C9FB52F3215AC60A67CACDC4AFA4355,60411,19,23,4,109.32514,18.30854,869
20485,159982,AFCE3351168C576BE2AA828A190DD579,30051,0,3,3,109.48917,18.21215,1453
20486,159983,AFCE3351168C576BE2AA828A190DD579,30271,3,4,1,109.49132,18.23153,1456
20487,159984,AFCE3351168C576BE2AA828A190DD579,30051,5,7,2,109.48917,18.21215,1453
20488,159985,AFCE3351168C576BE2AA828A190DD579,33051,12,13,1,109.6475,18.46618,2096
20489,159986,AFCE3351168C576BE2AA828A190DD579,30051,16,18,2,109.48917,18.21215,1453
20490,159987,AFCE3351168C576BE2AA828A190DD579,30161,18,20,2,109.50042,18.24389,1508
20491,159988,AFCE3351168C576BE2AA828A190DD579,30051,21,22,1,109.48917,18.21215,1453
20492,160002,AE9453D604AF88F4293DEF99463B2345,30861,14,16,2,109.52722,18.22743,1606
20493,160035,FB69127E95B4D9EC5AF61282F8D7EEB7,30854,2,3,1,109.56889,18.27076,1763
20494,160036,FB69127E95B4D9EC5AF61282F8D7EEB7,31071,4,7,3,109.58257,18.28458,1815
20495,160037,FB69127E95B4D9EC5AF61282F8D7EEB7,31561,11,13,2,109.56792,18.28479,1765
20496,160038,FB69127E95B4D9EC5AF61282F8D7EEB7,60121,14,16,2,109.74507,18.37472,2430
20497,160039,FB69127E95B4D9EC5AF61282F8D7EEB7,30854,18,23,5,109.56889,18.27076,1763
20498,160040,0E0D6E55BB1995EBF85F6B7AA8765E55,30854,0,1,1,109.56889,18.27076,1763
20499,160041,0E0D6E55BB1995EBF85F6B7AA8765E55,60631,2,3,1,109.57778,18.27583,1814
20500,160042,0E0D6E55BB1995EBF85F6B7AA8765E55,30854,3,5,2,109.56889,18.27076,1763
20501,160043,0E0D6E55BB1995EBF85F6B7AA8765E55,60631,5,6,1,109.57778,18.27583,1814
20502,160044,0E0D6E55BB1995EBF85F6B7AA8765E55,30854,9,23,14,109.56889,18.27076,1763
20503,160070,770A00BDAFE9BCA8C9E9FA68066EED7D,31071,0,6,6,109.58257,18.28458,1815
20504,160071,770A00BDAFE9BCA8C9E9FA68066EED7D,31561,9,10,1,109.56792,18.28479,1765
20505,160072,770A00BDAFE9BCA8C9E9FA68066EED7D,30851,11,12,1,109.5616,18.27396,1713
20506,160073,770A00BDAFE9BCA8C9E9FA68066EED7D,31561,16,18,2,109.56792,18.28479,1765
20507,160074,770A00BDAFE9BCA8C9E9FA68066EED7D,31071,21,23,2,109.58257,18.28458,1815
20508,160095,F418DE163D69F8F4F422D7CC67E3A86A,60661,0,7,7,109.548,18.2377,1657
20509,160096,F418DE163D69F8F4F422D7CC67E3A86A,30084,8,11,3,109.50118,18.26972,1513
20510,160097,F418DE163D69F8F4F422D7CC67E3A86A,60381,11,15,4,109.5241,18.22458,1605
20511,160098,F418DE163D69F8F4F422D7CC67E3A86A,30711,18,20,2,109.50271,18.25347,1510
20512,160099,F418DE163D69F8F4F422D7CC67E3A86A,60661,22,23,1,109.548,18.2377,1657
20513,160100,369F61D9EC42E510E242E24266B2C23F,30921,9,11,2,109.53903,18.29451,1667
20514,160101,369F61D9EC42E510E242E24266B2C23F,31931,11,23,12,109.54771,18.29403,1667
20518,160140,9D1EC22DFBB32C15D7FEE58EF69EC51E,30361,16,23,7,109.50347,18.24,1508
20519,160175,1E96C566C30C0324136B787B7442349D,39091,0,7,7,109.50097,18.25222,1510
20520,160186,4673FB95D801F5BA8AF86C05F77CD0AA,60161,0,11,11,109.49174,18.26181,1461
20521,160187,4673FB95D801F5BA8AF86C05F77CD0AA,30711,12,13,1,109.50271,18.25347,1510
20522,160188,4673FB95D801F5BA8AF86C05F77CD0AA,31471,15,16,1,109.34583,18.29563,917
20523,160189,4673FB95D801F5BA8AF86C05F77CD0AA,30361,18,21,3,109.50347,18.24,1508
20527,160195,7763FA5342AFBCA436FF4D695F9B9CB2,30711,0,9,9,109.50271,18.25347,1510
20528,160196,7763FA5342AFBCA436FF4D695F9B9CB2,60381,11,12,1,109.5241,18.22458,1605
20529,160197,7763FA5342AFBCA436FF4D695F9B9CB2,30711,13,15,2,109.50271,18.25347,1510
20530,160198,7763FA5342AFBCA436FF4D695F9B9CB2,30711,16,18,2,109.50271,18.25347,1510
20531,160199,7763FA5342AFBCA436FF4D695F9B9CB2,30421,18,23,5,109.50021,18.25861,1511
20532,160235,2A177ADF4F6516EDDF22425D74B17CFB,31931,0,5,5,109.54771,18.29403,1667
20533,160298,8AD9F37216B2D3FCE05CA77434307672,30741,1,8,7,109.49833,18.28681,1516
20534,160299,8AD9F37216B2D3FCE05CA77434307672,30361,11,12,1,109.50347,18.24,1508
20535,160300,8AD9F37216B2D3FCE05CA77434307672,31161,15,16,1,109.70229,18.31361,2270
20536,160301,8AD9F37216B2D3FCE05CA77434307672,60621,20,21,1,109.48354,18.27451,1464
20537,160302,8AD9F37216B2D3FCE05CA77434307672,60281,22,23,1,109.51743,18.25924,1561
20538,160309,E191BF114A3C2277CB7C3323BAA13F43,30854,0,10,10,109.56889,18.27076,1763
20539,160310,E191BF114A3C2277CB7C3323BAA13F43,31301,13,15,2,109.14493,18.31222,170
20540,160311,E191BF114A3C2277CB7C3323BAA13F43,30854,16,17,1,109.56889,18.27076,1763
20541,160312,7BB21D6130AE75AA410ED280998BF572,31236,10,13,3,109.42965,18.29111,1216
20542,160313,7BB21D6130AE75AA410ED280998BF572,31231,15,18,3,109.42597,18.29292,1217
20543,160314,7BB21D6130AE75AA410ED280998BF572,60524,20,21,1,109.42951,18.28993,1216
20550,160495,122D07F80E4FAC68FAE7EDBB2DF1AFA3,30854,9,15,6,109.56889,18.27076,1763
20551,160496,122D07F80E4FAC68FAE7EDBB2DF1AFA3,31071,16,18,2,109.58257,18.28458,1815
20552,160497,122D07F80E4FAC68FAE7EDBB2DF1AFA3,39091,21,22,1,109.50097,18.25222,1510
20553,160498,4020F45A25B90FB7F045FA0843BE28FF,31471,15,17,2,109.34583,18.29563,917
20554,160499,4020F45A25B90FB7F045FA0843BE28FF,30821,18,19,1,109.43681,18.33639,1274
20555,160507,A65416E0023DB5B05C85EFD796D8188E,31261,0,2,2,109.51174,18.2466,1559
20556,160508,A65416E0023DB5B05C85EFD796D8188E,38911,3,7,4,109.51674,18.24965,1559
20557,160509,A65416E0023DB5B05C85EFD796D8188E,31261,9,12,3,109.51174,18.2466,1559
20558,160510,A65416E0023DB5B05C85EFD796D8188E,30351,16,18,2,109.41701,18.29292,1217
20559,160511,A65416E0023DB5B05C85EFD796D8188E,30711,19,20,1,109.50271,18.25347,1510
20560,160512,A65416E0023DB5B05C85EFD796D8188E,31261,21,23,2,109.51174,18.2466,1559
20564,160537,415924917BD1FA059141A38CE1BD297D,38157,0,1,1,109.51483,18.26958,1563
20565,160538,415924917BD1FA059141A38CE1BD297D,30391,5,15,10,109.4975,18.27118,1513
20566,160539,415924917BD1FA059141A38CE1BD297D,30911,16,19,3,109.50493,18.26181,1511
20567,160540,415924917BD1FA059141A38CE1BD297D,30161,19,20,1,109.50042,18.24389,1508
20568,160541,415924917BD1FA059141A38CE1BD297D,31554,21,22,1,109.55521,18.2459,1709
20569,160558,47A18820FDA9856131F74091D44B6BCB,30851,7,11,4,109.5616,18.27396,1713
20570,160559,47A18820FDA9856131F74091D44B6BCB,31561,13,15,2,109.56792,18.28479,1765
20571,160560,47A18820FDA9856131F74091D44B6BCB,39183,15,17,2,109.55542,18.28208,1715
20575,160576,74AD1AF2EA5153BD40BCF9A3F3F2C4E3,31071,12,13,1,109.58257,18.28458,1815
20576,160577,74AD1AF2EA5153BD40BCF9A3F3F2C4E3,30854,14,19,5,109.56889,18.27076,1763
20577,160578,74AD1AF2EA5153BD40BCF9A3F3F2C4E3,31071,20,22,2,109.58257,18.28458,1815
20578,160590,A9FCE0049DB44FE004EAFBF5B783F4A5,31945,1,3,2,109.58021,18.29403,1817
20579,160591,A9FCE0049DB44FE004EAFBF5B783F4A5,31071,4,6,2,109.58257,18.28458,1815
20580,160592,A9FCE0049DB44FE004EAFBF5B783F4A5,30854,8,10,2,109.56889,18.27076,1763
20581,160593,A9FCE0049DB44FE004EAFBF5B783F4A5,31945,12,14,2,109.58021,18.29403,1817
20582,160594,A9FCE0049DB44FE004EAFBF5B783F4A5,30854,15,23,8,109.56889,18.27076,1763
20583,160595,CCBF1BE99DA9F84ADB162A21804AB04F,60361,6,7,1,109.51938,18.29681,1567
20584,160596,CCBF1BE99DA9F84ADB162A21804AB04F,31561,8,10,2,109.56792,18.28479,1765
20585,160597,CCBF1BE99DA9F84ADB162A21804AB04F,60361,12,13,1,109.51938,18.29681,1567
20586,160598,CCBF1BE99DA9F84ADB162A21804AB04F,31561,14,16,2,109.56792,18.28479,1765
20587,160599,CCBF1BE99DA9F84ADB162A21804AB04F,60361,20,21,1,109.51938,18.29681,1567
20592,160617,43DCA4A54D551EB9E56C0160DC714BC6,30854,2,3,1,109.56889,18.27076,1763
20593,160618,43DCA4A54D551EB9E56C0160DC714BC6,31561,3,9,6,109.56792,18.28479,1765
20594,160619,43DCA4A54D551EB9E56C0160DC714BC6,31861,10,11,1,109.49042,18.27549,1464
20595,160620,43DCA4A54D551EB9E56C0160DC714BC6,31561,13,19,6,109.56792,18.28479,1765
20596,160621,43DCA4A54D551EB9E56C0160DC714BC6,38891,20,23,3,109.51486,18.24118,1558
20603,160672,C0D9A8D1FC57A96EA766A127A0E8EAAC,30854,0,6,6,109.56889,18.27076,1763
20604,160673,C0D9A8D1FC57A96EA766A127A0E8EAAC,31571,7,9,2,109.61563,18.23326,1957
20605,160674,C0D9A8D1FC57A96EA766A127A0E8EAAC,60591,12,13,1,109.61118,18.21715,1904
20606,160675,C0D9A8D1FC57A96EA766A127A0E8EAAC,38054,17,19,2,109.63479,18.23097,2006
20610,160689,EAACD4FD1FD759C1481EE68BDD81E5E7,60201,0,1,1,109.5041,18.2509,1510
20611,160690,EAACD4FD1FD759C1481EE68BDD81E5E7,38251,2,9,7,109.49618,18.25493,1510
20612,160691,EAACD4FD1FD759C1481EE68BDD81E5E7,31471,12,14,2,109.34583,18.29563,917
20613,160692,EAACD4FD1FD759C1481EE68BDD81E5E7,31781,15,16,1,109.19847,18.2975,367
20614,160693,EAACD4FD1FD759C1481EE68BDD81E5E7,30271,18,19,1,109.49132,18.23153,1456
20615,160697,A94F66C88B84FF0658441320CD9F667C,60631,0,2,2,109.57778,18.27583,1814
20616,160698,A94F66C88B84FF0658441320CD9F667C,31071,5,6,1,109.58257,18.28458,1815
20617,160708,E8E05D2BF37E5522AAFF8446679CEF53,31931,8,9,1,109.54771,18.29403,1667
20618,160709,E8E05D2BF37E5522AAFF8446679CEF53,30921,9,10,1,109.53903,18.29451,1667
20619,160710,E8E05D2BF37E5522AAFF8446679CEF53,31931,11,13,2,109.54771,18.29403,1667
20620,160711,E8E05D2BF37E5522AAFF8446679CEF53,60671,14,23,9,109.52979,18.31757,1621
20625,160755,E1FCF6F0DAD733D65B4B7CF374C299B4,30661,0,4,4,109.37028,18.24361,1008
20626,160756,E1FCF6F0DAD733D65B4B7CF374C299B4,60054,5,6,1,109.3016,18.31229,770
20627,160757,E1FCF6F0DAD733D65B4B7CF374C299B4,30661,6,9,3,109.37028,18.24361,1008
20628,160758,E1FCF6F0DAD733D65B4B7CF374C299B4,60054,9,10,1,109.3016,18.31229,770
20629,160759,E1FCF6F0DAD733D65B4B7CF374C299B4,30661,10,23,13,109.37028,18.24361,1008
20633,160777,90316F668419B151242AF04D86EAF2CC,31761,1,6,5,109.60521,18.27965,1914
20634,160778,90316F668419B151242AF04D86EAF2CC,30854,9,10,1,109.56889,18.27076,1763
20635,160779,90316F668419B151242AF04D86EAF2CC,31071,11,12,1,109.58257,18.28458,1815
20636,160780,90316F668419B151242AF04D86EAF2CC,30854,12,17,5,109.56889,18.27076,1763
20637,160781,90316F668419B151242AF04D86EAF2CC,38154,18,20,2,109.5266,18.28278,1615
20638,160782,90316F668419B151242AF04D86EAF2CC,30281,21,23,2,109.50597,18.27583,1514
20646,160824,28A89A8FEC174286EFBBD2F96B7BCF44,60201,17,19,2,109.5041,18.2509,1510
20647,160825,28A89A8FEC174286EFBBD2F96B7BCF44,60281,20,22,2,109.51743,18.25924,1561
20652,160854,24B9CD23EC5587BA3102D06F602ACE38,60171,0,17,17,109.51292,18.30694,1569
20653,160855,24B9CD23EC5587BA3102D06F602ACE38,31181,19,21,2,109.50382,18.24813,1509
20654,160877,AA17C9279A63248D7DCDF49F93EB8817,39183,4,5,1,109.55542,18.28208,1715
20655,160878,AA17C9279A63248D7DCDF49F93EB8817,38275,8,17,9,109.62875,18.22938,2006
20656,160879,AA17C9279A63248D7DCDF49F93EB8817,30854,19,20,1,109.56889,18.27076,1763
20657,160890,36566106CC9CFD386F41AE364EF63663,38751,18,20,2,109.74903,18.37639,2481
20658,160891,36566106CC9CFD386F41AE364EF63663,60114,21,23,2,109.73028,18.33847,2374
20659,160906,3FBDC8D8C17B76F60ECEEB6B68F9AA0F,38361,0,7,7,109.43667,18.29201,1267
20660,160907,3FBDC8D8C17B76F60ECEEB6B68F9AA0F,31391,9,10,1,109.50382,18.24285,1508
20661,160908,3FBDC8D8C17B76F60ECEEB6B68F9AA0F,38291,12,16,4,109.51618,18.24313,1558
20662,160909,3FBDC8D8C17B76F60ECEEB6B68F9AA0F,38361,19,23,4,109.43667,18.29201,1267
20667,160943,F84D949DDCBF25D5530F771BC55E0B9D,61011,0,2,2,109.60653,18.19076,1900
20668,160949,07169E7114E4F14C073261BAAC0D4491,31071,0,7,7,109.58257,18.28458,1815
20669,160950,07169E7114E4F14C073261BAAC0D4491,61011,9,11,2,109.60653,18.19076,1900
20670,160963,53490AD77ACCA93C3ED0F3DE79CA488B,31071,5,13,8,109.58257,18.28458,1815
20671,160964,53490AD77ACCA93C3ED0F3DE79CA488B,30854,16,17,1,109.56889,18.27076,1763
20672,161026,121138E269BBF0B506FA8CE6CEB3BF52,39181,10,11,1,109.55153,18.28035,1715
20673,161027,121138E269BBF0B506FA8CE6CEB3BF52,31931,12,23,11,109.54771,18.29403,1667
20674,161031,8AE1DEDFE1A65A29B5153547EEA03A21,30851,15,17,2,109.5616,18.27396,1713
20675,161032,8AE1DEDFE1A65A29B5153547EEA03A21,31071,18,22,4,109.58257,18.28458,1815
20676,161036,9C1407835BC54BEBDB541F52E1DA1820,61011,0,5,5,109.60653,18.19076,1900
20677,161123,8C3D244B6DAAE8C73F174808255E03C6,60011,0,3,3,109.48965,18.30222,1468
20678,161124,8C3D244B6DAAE8C73F174808255E03C6,30111,3,11,8,109.47583,18.30542,1419
20679,161125,8C3D244B6DAAE8C73F174808255E03C6,60011,12,13,1,109.48965,18.30222,1468
20680,161126,8C3D244B6DAAE8C73F174808255E03C6,30761,14,16,2,109.45201,18.3,1318
20681,161127,8C3D244B6DAAE8C73F174808255E03C6,31031,20,23,3,109.49979,18.25382,1510
20685,161161,8799356B7181F28146A203E5F86C52F0,30571,16,19,3,109.50243,18.21861,1504
20686,161162,8799356B7181F28146A203E5F86C52F0,31621,20,21,1,109.51035,18.29826,1568
20687,161163,8799356B7181F28146A203E5F86C52F0,31351,22,23,1,109.4959,18.28417,1465
20692,161200,99CBAA6A65A50998F0A10B72B36210E4,30271,0,18,18,109.49132,18.23153,1456
20693,161201,99CBAA6A65A50998F0A10B72B36210E4,60084,18,23,5,109.4984,18.2334,1507
20694,161205,E7E2A00FD533B194627A6A403AE528B1,30721,0,13,13,109.51597,18.28257,1565
20695,161207,E7E2A00FD533B194627A6A403AE528B1,38171,20,23,3,109.50799,18.28139,1515
20696,161263,E00EF22F493557E868E52C93194870CF,30234,0,3,3,109.60681,18.29979,1918
20697,161264,E00EF22F493557E868E52C93194870CF,31071,4,14,10,109.58257,18.28458,1815
20698,161265,3C5AEA306E8A69C707195C4150E77D90,31931,2,7,5,109.54771,18.29403,1667
20699,161266,3C5AEA306E8A69C707195C4150E77D90,39181,7,17,10,109.55153,18.28035,1715
20700,161293,EF24901D99384F703B20FE07F2784FA0,31631,16,17,1,109.59542,18.36826,1879
20701,161294,EF24901D99384F703B20FE07F2784FA0,30101,20,21,1,109.57299,18.33333,1773
20702,161360,1122041491C04B199A15F6E1E401D68F,31461,8,9,1,109.5091,18.25389,1510
20703,161361,1122041491C04B199A15F6E1E401D68F,30461,12,13,1,109.5116,18.26313,1562
20704,161362,1122041491C04B199A15F6E1E401D68F,31261,15,16,1,109.51174,18.2466,1559
20705,161363,1122041491C04B199A15F6E1E401D68F,30461,20,22,2,109.5116,18.26313,1562
20709,161450,56F818D0924E7BDB02CCC04065747626,31421,0,6,6,109.55382,18.22347,1705
20710,161451,56F818D0924E7BDB02CCC04065747626,30711,7,10,3,109.50271,18.25347,1510
20711,161452,56F818D0924E7BDB02CCC04065747626,30861,10,11,1,109.52722,18.22743,1606
20712,161453,56F818D0924E7BDB02CCC04065747626,31421,12,13,1,109.55382,18.22347,1705
20713,161454,56F818D0924E7BDB02CCC04065747626,38205,15,17,2,109.62743,18.23139,1956
20714,161455,56F818D0924E7BDB02CCC04065747626,31421,20,22,2,109.55382,18.22347,1705
20715,161458,51061B3DE820AF1C1C713EF684728003,30854,18,20,2,109.56889,18.27076,1763
20716,161459,51061B3DE820AF1C1C713EF684728003,31071,21,23,2,109.58257,18.28458,1815
20717,161467,213AF2099653A4ADAEF799CCC144B279,30021,0,10,10,109.12014,18.40986,86
20718,161469,213AF2099653A4ADAEF799CCC144B279,30021,19,23,4,109.12014,18.40986,86
20722,161473,012ABD06F231728C214A4BA917E75B1C,31561,20,21,1,109.56792,18.28479,1765
20723,161474,012ABD06F231728C214A4BA917E75B1C,30851,22,23,1,109.5616,18.27396,1713
20724,161483,F3652FF504BC297E68234A33C1877043,31945,0,6,6,109.58021,18.29403,1817
20725,161484,F3652FF504BC297E68234A33C1877043,30854,6,22,16,109.56889,18.27076,1763
20739,161615,43E035AE85036EBD9891453E9567CB81,60621,12,13,1,109.48354,18.27451,1464
20740,161616,43E035AE85036EBD9891453E9567CB81,38154,15,16,1,109.5266,18.28278,1615
20741,161617,43E035AE85036EBD9891453E9567CB81,30151,20,23,3,109.50986,18.25083,1560
20742,161649,81596C8771F0BD5C8688C47E383316FD,31041,14,16,2,109.50278,18.23701,1507
20743,161650,81596C8771F0BD5C8688C47E383316FD,30191,18,22,4,109.50361,18.22701,1506
20747,161664,6ADBEFDC21CA46F051933BF984A8E255,30681,13,14,1,109.48493,18.26917,1463
20748,161665,6ADBEFDC21CA46F051933BF984A8E255,30201,15,19,4,109.4909,18.26465,1462
20749,161681,9671B6E053D263F77ADF522BC499DA98,30351,18,20,2,109.41701,18.29292,1217
20750,161682,9671B6E053D263F77ADF522BC499DA98,60524,21,22,1,109.42951,18.28993,1216
20755,161720,189633BA4D39EBA8A203BC9E364D4B1F,30381,1,8,7,109.52521,18.24507,1609
20756,161721,189633BA4D39EBA8A203BC9E364D4B1F,30571,8,10,2,109.50243,18.21861,1504
20757,161722,189633BA4D39EBA8A203BC9E364D4B1F,30051,11,12,1,109.48917,18.21215,1453
20758,161723,189633BA4D39EBA8A203BC9E364D4B1F,30571,13,14,1,109.50243,18.21861,1504
20759,161724,189633BA4D39EBA8A203BC9E364D4B1F,30051,15,17,2,109.48917,18.21215,1453
20760,161725,189633BA4D39EBA8A203BC9E364D4B1F,38291,20,23,3,109.51618,18.24313,1558
20761,161742,C983E73D646629A775690ECA8920EB29,31631,15,16,1,109.59542,18.36826,1879
20762,161743,C983E73D646629A775690ECA8920EB29,30101,19,21,2,109.57299,18.33333,1773
20763,161751,8C8F8FC2780D9BDAFAB332E6525E36FA,30084,14,16,2,109.50118,18.26972,1513
20764,161752,8C8F8FC2780D9BDAFAB332E6525E36FA,31351,16,18,2,109.4959,18.28417,1465
20765,161753,8C8F8FC2780D9BDAFAB332E6525E36FA,30084,20,22,2,109.50118,18.26972,1513
20766,161778,33A62A8066AF8B1342859DF4B906FBD2,30741,17,19,2,109.49833,18.28681,1516
20767,161779,33A62A8066AF8B1342859DF4B906FBD2,30351,20,23,3,109.41701,18.29292,1217
20771,161801,37657A593A7A700C5ECCE5BB0AAAABA7,31931,0,7,7,109.54771,18.29403,1667
20772,161802,37657A593A7A700C5ECCE5BB0AAAABA7,39183,8,10,2,109.55542,18.28208,1715
20773,161803,37657A593A7A700C5ECCE5BB0AAAABA7,31931,11,12,1,109.54771,18.29403,1667
20774,161804,37657A593A7A700C5ECCE5BB0AAAABA7,39183,15,16,1,109.55542,18.28208,1715
20775,161805,37657A593A7A700C5ECCE5BB0AAAABA7,31931,19,22,3,109.54771,18.29403,1667
20776,161847,6422CB87ACC55DDEF6EBE8946593C808,38171,0,5,5,109.50799,18.28139,1515
20777,161848,6422CB87ACC55DDEF6EBE8946593C808,60281,5,6,1,109.51743,18.25924,1561
20778,161849,6422CB87ACC55DDEF6EBE8946593C808,30571,8,15,7,109.50243,18.21861,1504
20779,161850,6422CB87ACC55DDEF6EBE8946593C808,30741,18,23,5,109.49833,18.28681,1516
20780,161886,53453D8B736810206EC5A6632D159BE6,30921,16,17,1,109.53903,18.29451,1667
20781,161887,53453D8B736810206EC5A6632D159BE6,31931,19,22,3,109.54771,18.29403,1667
20782,161892,D1700FD0B8D8B8304DC420C1C5EAA5DF,31521,0,6,6,109.51458,18.22542,1555
20783,161893,D1700FD0B8D8B8304DC420C1C5EAA5DF,31521,10,17,7,109.51458,18.22542,1555
20784,161894,D1700FD0B8D8B8304DC420C1C5EAA5DF,31091,19,22,3,109.41201,18.31222,1170
20788,161912,7890099D98AA300C5BF12527E7372DB0,60631,0,7,7,109.57778,18.27583,1814
20789,161913,7890099D98AA300C5BF12527E7372DB0,30854,7,10,3,109.56889,18.27076,1763
20790,161914,7890099D98AA300C5BF12527E7372DB0,31071,10,15,5,109.58257,18.28458,1815
20791,161915,7890099D98AA300C5BF12527E7372DB0,30854,16,18,2,109.56889,18.27076,1763
20792,161916,7890099D98AA300C5BF12527E7372DB0,60631,19,23,4,109.57778,18.27583,1814
20793,161917,C1F80FD61770F46AF18F3BEF2B67E7ED,31551,2,5,3,109.55868,18.24222,1708
20794,161918,C1F80FD61770F46AF18F3BEF2B67E7ED,31554,5,7,2,109.55521,18.2459,1709
20795,161919,C1F80FD61770F46AF18F3BEF2B67E7ED,60291,10,13,3,109.50826,18.24639,1509
20796,161920,C1F80FD61770F46AF18F3BEF2B67E7ED,31781,14,17,3,109.19847,18.2975,367
20797,161921,C1F80FD61770F46AF18F3BEF2B67E7ED,31551,19,22,3,109.55868,18.24222,1708
20798,161942,D96E01B8E0F0DE9C160C9FEAFDCFDB6D,30854,8,18,10,109.56889,18.27076,1763
20799,161943,D96E01B8E0F0DE9C160C9FEAFDCFDB6D,31071,20,21,1,109.58257,18.28458,1815
20800,161981,C37DBDD12F85B1DFB17F9185AF0E7708,30951,1,8,7,109.56208,18.25667,1761
20801,161982,C37DBDD12F85B1DFB17F9185AF0E7708,30851,8,11,3,109.5616,18.27396,1713
20802,161983,C37DBDD12F85B1DFB17F9185AF0E7708,30951,11,14,3,109.56208,18.25667,1761
20803,161984,C37DBDD12F85B1DFB17F9185AF0E7708,30851,14,15,1,109.5616,18.27396,1713
20804,161985,C37DBDD12F85B1DFB17F9185AF0E7708,30951,16,21,5,109.56208,18.25667,1761
20815,162104,D66DDB1AF696D6DDB044E124EA6B793E,60501,15,17,2,109.48701,18.29021,1466
20816,162105,D66DDB1AF696D6DDB044E124EA6B793E,38241,19,21,2,109.54111,18.30542,1669
20817,162119,C8922FAF66F21ECAECB6B717FCD5A53B,60391,0,1,1,109.47667,18.28757,1416
20818,162120,C8922FAF66F21ECAECB6B717FCD5A53B,60614,2,3,1,109.48799,18.29521,1467
20819,162121,C8922FAF66F21ECAECB6B717FCD5A53B,60391,4,6,2,109.47667,18.28757,1416
20820,162122,C8922FAF66F21ECAECB6B717FCD5A53B,60614,6,8,2,109.48799,18.29521,1467
20821,162123,C8922FAF66F21ECAECB6B717FCD5A53B,60391,8,17,9,109.47667,18.28757,1416
20822,162124,C8922FAF66F21ECAECB6B717FCD5A53B,60614,17,22,5,109.48799,18.29521,1467
20823,162128,7108DC6F5FE31ADF679880B9ADB266C0,38291,14,16,2,109.51618,18.24313,1558
20824,162129,7108DC6F5FE31ADF679880B9ADB266C0,30681,19,21,2,109.48493,18.26917,1463
20825,162139,9E8746086915F9D4A063A74CF0B5B7AB,31561,0,2,2,109.56792,18.28479,1765
20826,162140,9E8746086915F9D4A063A74CF0B5B7AB,30851,2,6,4,109.5616,18.27396,1713
20827,162157,219D03D2345568C24C18853ACF5CAE7D,38754,11,13,2,109.74667,18.37382,2430
20828,162158,219D03D2345568C24C18853ACF5CAE7D,30421,15,17,2,109.50021,18.25861,1511
20829,162159,219D03D2345568C24C18853ACF5CAE7D,60084,19,22,3,109.4984,18.2334,1507
20830,162170,A503639E15A0B5D04B0130D882921438,30711,0,19,19,109.50271,18.25347,1510
20831,162171,A503639E15A0B5D04B0130D882921438,31031,20,23,3,109.49979,18.25382,1510
20832,162199,FD5B9AB034F15F72E8BEF02193669238,60241,11,13,2,109.53319,18.28667,1616
20833,162200,FD5B9AB034F15F72E8BEF02193669238,31931,15,18,3,109.54771,18.29403,1667
20834,162201,FD5B9AB034F15F72E8BEF02193669238,60241,19,21,2,109.53319,18.28667,1616
20835,162216,04ABA8BFD5D63DDF1B83BA0577C9019C,39371,2,4,2,109.56627,18.2646,1762
20836,162217,04ABA8BFD5D63DDF1B83BA0577C9019C,30232,4,6,2,109.6191,18.31701,1971
20837,162218,04ABA8BFD5D63DDF1B83BA0577C9019C,39183,6,8,2,109.55542,18.28208,1715
20838,162219,04ABA8BFD5D63DDF1B83BA0577C9019C,39371,12,13,1,109.56627,18.2646,1762
20839,162241,C16911B04E69B2086DAE9402EB30D376,39111,0,14,14,109.5191,18.22597,1555
20840,162250,E9E473F09C342630187345312F4A31D8,39181,0,14,14,109.55153,18.28035,1715
20841,162251,E9E473F09C342630187345312F4A31D8,39181,16,23,7,109.55153,18.28035,1715
20845,162296,00FC332040A284DA251A8D0705989FE9,31071,0,13,13,109.58257,18.28458,1815
20846,162297,00FC332040A284DA251A8D0705989FE9,30854,13,16,3,109.56889,18.27076,1763
20847,162315,EF4AD841380B82F3DA5A0CBE5A6DFAF4,38052,0,10,10,109.62618,18.23042,1956
20848,162316,EF4AD841380B82F3DA5A0CBE5A6DFAF4,38052,12,14,2,109.62618,18.23042,1956
20849,162317,EF4AD841380B82F3DA5A0CBE5A6DFAF4,30361,17,18,1,109.50347,18.24,1508
20850,162318,EF4AD841380B82F3DA5A0CBE5A6DFAF4,38052,20,23,3,109.62618,18.23042,1956
20857,162365,8DA877D3A30401F86E81FB7BC1CA2A00,30854,8,16,8,109.56889,18.27076,1763
20858,162366,8DA877D3A30401F86E81FB7BC1CA2A00,31071,17,19,2,109.58257,18.28458,1815
20865,162426,1E36640BE395A4EE8CCB2697222419A5,60631,0,1,1,109.57778,18.27583,1814
20866,162427,1E36640BE395A4EE8CCB2697222419A5,31071,2,7,5,109.58257,18.28458,1815
20867,162428,1E36640BE395A4EE8CCB2697222419A5,31164,9,12,3,109.69993,18.27215,2263
20868,162429,1E36640BE395A4EE8CCB2697222419A5,31391,15,16,1,109.50382,18.24285,1508
20869,162430,14AE6C820CE45F96077630992CABD33D,30951,0,15,15,109.56208,18.25667,1761
20870,162431,14AE6C820CE45F96077630992CABD33D,39371,16,17,1,109.56627,18.2646,1762
20881,162468,EDE389AFA39F6BCEE22D12194DD10361,30671,0,8,8,109.43611,18.30139,1268
20882,162469,EDE389AFA39F6BCEE22D12194DD10361,30371,9,10,1,109.51,18.24771,1559
20883,162470,EDE389AFA39F6BCEE22D12194DD10361,30421,12,14,2,109.50021,18.25861,1511
20884,162471,EDE389AFA39F6BCEE22D12194DD10361,30671,14,23,9,109.43611,18.30139,1268
20885,162510,EC4B90EDBF35256FDB4D4F8B87DB8A04,31071,8,13,5,109.58257,18.28458,1815
20886,162511,EC4B90EDBF35256FDB4D4F8B87DB8A04,30854,15,23,8,109.56889,18.27076,1763
20897,162672,867B597177C033B93C7398A70CF92274,31041,0,1,1,109.50278,18.23701,1507
20898,162673,867B597177C033B93C7398A70CF92274,30151,1,9,8,109.50986,18.25083,1560
20899,162674,867B597177C033B93C7398A70CF92274,30711,12,13,1,109.50271,18.25347,1510
20900,162675,867B597177C033B93C7398A70CF92274,39154,16,17,1,109.50201,18.25681,1511
20901,162676,867B597177C033B93C7398A70CF92274,30151,18,23,5,109.50986,18.25083,1560
20902,162677,738D4FA982656893A7BF5113ADD931D7,30854,13,15,2,109.56889,18.27076,1763
20903,162678,738D4FA982656893A7BF5113ADD931D7,31071,18,21,3,109.58257,18.28458,1815
20904,162686,F209A1377D570F6F7DFE6504E3D5965F,31521,12,19,7,109.51458,18.22542,1555
20905,162687,F209A1377D570F6F7DFE6504E3D5965F,31521,21,22,1,109.51458,18.22542,1555
20906,162702,03CEC0FDDD5484124514C6D24A63D4DD,30854,0,4,4,109.56889,18.27076,1763
20907,162703,03CEC0FDDD5484124514C6D24A63D4DD,31561,4,6,2,109.56792,18.28479,1765
20925,162821,D0B7F52F6637F62713846394EF54526E,31781,13,16,3,109.19847,18.2975,367
20926,162822,D0B7F52F6637F62713846394EF54526E,31701,20,22,2,109.44132,18.28833,1266
20927,162840,E218C587552A5DADC05C4E69685FE374,30854,10,17,7,109.56889,18.27076,1763
20928,162841,E218C587552A5DADC05C4E69685FE374,39183,21,22,1,109.55542,18.28208,1715
20929,162890,1D8B814EC83D52D7C5F3FED99C129EE0,30854,2,8,6,109.56889,18.27076,1763
20930,162891,1D8B814EC83D52D7C5F3FED99C129EE0,38271,10,19,9,109.62632,18.23049,1956
20931,162892,1D8B814EC83D52D7C5F3FED99C129EE0,30854,19,21,2,109.56889,18.27076,1763
20932,162929,F8340F8DE3FC6E4B51712C02CF964A60,60381,19,20,1,109.5241,18.22458,1605
20933,162930,F8340F8DE3FC6E4B51712C02CF964A60,39321,20,22,2,109.529,18.2167,1604
20934,162977,45D28ABCF21CFC012A68F14A68C61EFC,31521,0,7,7,109.51458,18.22542,1555
20935,162978,45D28ABCF21CFC012A68F14A68C61EFC,31145,10,13,3,109.20431,18.30479,369
20936,162979,45D28ABCF21CFC012A68F14A68C61EFC,60381,14,16,2,109.5241,18.22458,1605
20937,162980,45D28ABCF21CFC012A68F14A68C61EFC,31521,16,17,1,109.51458,18.22542,1555
20938,162981,45D28ABCF21CFC012A68F14A68C61EFC,31521,18,23,5,109.51458,18.22542,1555
20939,163063,752B4C65CCCA1EA27D3C6EA24E289B9C,30854,0,17,17,109.56889,18.27076,1763
20940,163064,752B4C65CCCA1EA27D3C6EA24E289B9C,39371,20,21,1,109.56627,18.2646,1762
20944,163105,2F64FEF19C86AA0A8AA3E3FA37CC4F2D,30854,0,2,2,109.56889,18.27076,1763
20945,163106,2F64FEF19C86AA0A8AA3E3FA37CC4F2D,30851,4,5,1,109.5616,18.27396,1713
20946,163107,2F64FEF19C86AA0A8AA3E3FA37CC4F2D,30854,6,18,12,109.56889,18.27076,1763
20947,163108,2F64FEF19C86AA0A8AA3E3FA37CC4F2D,39183,18,19,1,109.55542,18.28208,1715
20948,163109,2F64FEF19C86AA0A8AA3E3FA37CC4F2D,30854,20,23,3,109.56889,18.27076,1763
20949,163113,5C4B759B8D2905A494B81A3EB710A8F3,30891,0,8,8,109.59431,18.28389,1865
20950,163114,5C4B759B8D2905A494B81A3EB710A8F3,60631,13,14,1,109.57778,18.27583,1814
20951,163115,5C4B759B8D2905A494B81A3EB710A8F3,31271,18,19,1,109.48958,18.26257,1462
20952,163116,5C4B759B8D2905A494B81A3EB710A8F3,30854,22,23,1,109.56889,18.27076,1763
20953,163120,AB43182259122294244C13D6FC66D4A1,30851,9,17,8,109.5616,18.27396,1713
20954,163121,AB43182259122294244C13D6FC66D4A1,60631,19,22,3,109.57778,18.27583,1814
20955,163128,036DFEF8CA623F9034F928149FE2468D,30821,1,2,1,109.43681,18.33639,1274
20956,163129,036DFEF8CA623F9034F928149FE2468D,30651,3,5,2,109.42611,18.385,1232
20957,163130,036DFEF8CA623F9034F928149FE2468D,30821,5,9,4,109.43681,18.33639,1274
20958,163131,036DFEF8CA623F9034F928149FE2468D,60011,11,23,12,109.48965,18.30222,1468
20959,163161,F8D799D9161B0143E0D71C40472A357E,38991,0,4,4,109.52681,18.30368,1618
20960,163162,F8D799D9161B0143E0D71C40472A357E,30071,6,8,2,109.52819,18.30472,1619
20961,163163,F8D799D9161B0143E0D71C40472A357E,30071,10,12,2,109.52819,18.30472,1619
20962,163164,F8D799D9161B0143E0D71C40472A357E,30071,13,21,8,109.52819,18.30472,1619
20963,163165,F8D799D9161B0143E0D71C40472A357E,31951,21,22,1,109.52174,18.30299,1568
20964,163177,5EE25A6E7DD554FFDA0C9C1A504114B7,60291,0,2,2,109.50826,18.24639,1509
20965,163178,5EE25A6E7DD554FFDA0C9C1A504114B7,60291,2,6,4,109.50826,18.24639,1509
20966,163179,5EE25A6E7DD554FFDA0C9C1A504114B7,30221,8,14,6,109.57833,18.20222,1802
20967,163180,5EE25A6E7DD554FFDA0C9C1A504114B7,30071,18,19,1,109.52819,18.30472,1619
20968,163181,5EE25A6E7DD554FFDA0C9C1A504114B7,30221,21,23,2,109.57833,18.20222,1802
20969,163213,7BF65E5054DA81A230AB5423620158E1,30854,0,1,1,109.56889,18.27076,1763
20970,163214,7BF65E5054DA81A230AB5423620158E1,31071,3,5,2,109.58257,18.28458,1815
20971,163215,7BF65E5054DA81A230AB5423620158E1,30854,8,11,3,109.56889,18.27076,1763
20972,163216,7BF65E5054DA81A230AB5423620158E1,60631,12,13,1,109.57778,18.27583,1814
20973,163217,7BF65E5054DA81A230AB5423620158E1,30854,13,15,2,109.56889,18.27076,1763
20974,163218,7BF65E5054DA81A230AB5423620158E1,31071,15,17,2,109.58257,18.28458,1815
20975,163219,7BF65E5054DA81A230AB5423620158E1,30854,19,21,2,109.56889,18.27076,1763
20979,163225,D12046233C14C8451AD4125CF88323E3,31021,0,12,12,109.49021,18.27,1463
20980,163251,C58D0182BFC61ED113EE3B09763C30B2,38185,0,6,6,109.51333,18.27347,1563
20981,163252,C58D0182BFC61ED113EE3B09763C30B2,30281,7,8,1,109.50597,18.27583,1514
20982,163253,C58D0182BFC61ED113EE3B09763C30B2,31931,8,11,3,109.54771,18.29403,1667
20983,163254,C58D0182BFC61ED113EE3B09763C30B2,38721,13,14,1,109.50368,18.27542,1514
20984,163255,C58D0182BFC61ED113EE3B09763C30B2,38185,18,23,5,109.51333,18.27347,1563
20985,163335,9BF33DB1F7AC1D27E06AF501C14CCF2C,39181,15,17,2,109.55153,18.28035,1715
20986,163336,9BF33DB1F7AC1D27E06AF501C14CCF2C,31931,18,23,5,109.54771,18.29403,1667
20987,163345,A46BA306DAEA889FAC7ACE9E5FD6A1FF,30911,0,20,20,109.50493,18.26181,1511
20988,163346,A46BA306DAEA889FAC7ACE9E5FD6A1FF,30421,20,22,2,109.50021,18.25861,1511
20993,163368,27CFDDBDBE225F8224792B641031B794,33051,13,14,1,109.6475,18.46618,2096
20994,163369,27CFDDBDBE225F8224792B641031B794,60381,16,19,3,109.5241,18.22458,1605
20995,163370,27CFDDBDBE225F8224792B641031B794,31236,21,23,2,109.42965,18.29111,1216
20996,163389,14F21534C21254001A38352AD4BB0EF6,30854,0,1,1,109.56889,18.27076,1763
20997,163390,14F21534C21254001A38352AD4BB0EF6,31071,2,6,4,109.58257,18.28458,1815
20998,163391,14F21534C21254001A38352AD4BB0EF6,30854,8,15,7,109.56889,18.27076,1763
20999,163392,14F21534C21254001A38352AD4BB0EF6,31071,16,17,1,109.58257,18.28458,1815
21000,163393,14F21534C21254001A38352AD4BB0EF6,30854,18,20,2,109.56889,18.27076,1763
21001,163396,7F3DDE6B55C3459C61E435131FEEF622,30191,1,7,6,109.50361,18.22701,1506
21002,163397,7F3DDE6B55C3459C61E435131FEEF622,30741,8,10,2,109.49833,18.28681,1516
21003,163398,7F3DDE6B55C3459C61E435131FEEF622,60463,12,14,2,109.52507,18.22438,1605
21004,163399,7F3DDE6B55C3459C61E435131FEEF622,30611,18,23,5,109.74958,18.40188,2485
21005,163409,6C0260646767B781577B5B8CE2471E51,30071,21,22,1,109.52819,18.30472,1619
21006,163410,6C0260646767B781577B5B8CE2471E51,38484,22,23,1,109.53028,18.31528,1620
21011,163473,63B5E489F3503F8EC6E40A38F9D2117C,60171,0,19,19,109.51292,18.30694,1569
21012,163474,63B5E489F3503F8EC6E40A38F9D2117C,60361,19,21,2,109.51938,18.29681,1567
21013,163478,41C41C21BD6663648BFE9928451490DC,39111,0,8,8,109.5191,18.22597,1555
21014,163479,41C41C21BD6663648BFE9928451490DC,31471,12,14,2,109.34583,18.29563,917
21015,163480,41C41C21BD6663648BFE9928451490DC,31521,18,23,5,109.51458,18.22542,1555
21016,163493,FAC035CAF00431CACD74AF53D18C4996,30111,0,1,1,109.47583,18.30542,1419
21017,163494,FAC035CAF00431CACD74AF53D18C4996,60011,5,6,1,109.48965,18.30222,1468
21018,163495,FAC035CAF00431CACD74AF53D18C4996,30764,9,11,2,109.45806,18.29486,1367
21019,163496,FAC035CAF00431CACD74AF53D18C4996,30761,14,15,1,109.45201,18.3,1318
21020,163497,FAC035CAF00431CACD74AF53D18C4996,30111,16,18,2,109.47583,18.30542,1419
21028,163543,BB6A9729DE557ADD6D3E7E09F28116DB,30731,0,1,1,109.50944,18.22306,1555
21029,163544,BB6A9729DE557ADD6D3E7E09F28116DB,30511,2,6,4,109.51069,18.24208,1558
21030,163545,BB6A9729DE557ADD6D3E7E09F28116DB,30191,6,7,1,109.50361,18.22701,1506
21031,163546,BB6A9729DE557ADD6D3E7E09F28116DB,31145,9,10,1,109.20431,18.30479,369
21032,163547,BB6A9729DE557ADD6D3E7E09F28116DB,31471,13,15,2,109.34583,18.29563,917
21033,163548,8AABF5FDF2B06EB445749240A3894969,31071,4,6,2,109.58257,18.28458,1815
21034,163549,8AABF5FDF2B06EB445749240A3894969,31561,6,8,2,109.56792,18.28479,1765
21035,163550,8AABF5FDF2B06EB445749240A3894969,30854,9,11,2,109.56889,18.27076,1763
21036,163551,8AABF5FDF2B06EB445749240A3894969,31851,11,12,1,109.71736,18.29007,2316
21037,163552,8AABF5FDF2B06EB445749240A3894969,31161,13,15,2,109.70229,18.31361,2270
21038,163553,8AABF5FDF2B06EB445749240A3894969,30854,20,21,1,109.56889,18.27076,1763
21039,163554,8AABF5FDF2B06EB445749240A3894969,31071,22,23,1,109.58257,18.28458,1815
21040,163555,075F360F88180B9A93BF11A5704B49F3,30961,12,14,2,109.74042,18.37903,2431
21041,163556,075F360F88180B9A93BF11A5704B49F3,60121,17,20,3,109.74507,18.37472,2430
21042,163597,FD9120CA3F85D3F015CEFB66B9BF2F3D,30721,0,7,7,109.51597,18.28257,1565
21043,163598,FD9120CA3F85D3F015CEFB66B9BF2F3D,60301,8,11,3,109.60715,18.30993,1919
21044,163599,FD9120CA3F85D3F015CEFB66B9BF2F3D,30721,13,16,3,109.51597,18.28257,1565
21045,163600,FD9120CA3F85D3F015CEFB66B9BF2F3D,60301,18,20,2,109.60715,18.30993,1919
21046,163601,FD9120CA3F85D3F015CEFB66B9BF2F3D,30721,21,22,1,109.51597,18.28257,1565
21050,163642,E8BAAF476E8FE57075BAB1A8D4FF1780,30232,0,4,4,109.6191,18.31701,1971
21051,163643,E8BAAF476E8FE57075BAB1A8D4FF1780,39371,6,8,2,109.56627,18.2646,1762
21052,163644,E8BAAF476E8FE57075BAB1A8D4FF1780,30181,11,12,1,109.51597,18.23313,1557
21053,163645,E8BAAF476E8FE57075BAB1A8D4FF1780,39371,13,14,1,109.56627,18.2646,1762
21054,163687,9A1D1AA5EE2CD156CC396C667ED8C5B9,31071,0,6,6,109.58257,18.28458,1815
21055,163688,9A1D1AA5EE2CD156CC396C667ED8C5B9,31164,9,16,7,109.69993,18.27215,2263
21056,163689,9A1D1AA5EE2CD156CC396C667ED8C5B9,30854,17,18,1,109.56889,18.27076,1763
21057,163711,BAF784C90E903A1C0CEDF594F05C3F50,60221,1,3,2,109.52569,18.29188,1616
21058,163712,BAF784C90E903A1C0CEDF594F05C3F50,30121,3,8,5,109.52861,18.27222,1613
21059,163713,BAF784C90E903A1C0CEDF594F05C3F50,30181,9,15,6,109.51597,18.23313,1557
21060,163734,798BF3B08F72A16A6DEAAA235F1899BB,61011,5,19,14,109.60653,18.19076,1900
21061,163746,0D48FD835B207ED202CAB110B7436DC2,31071,0,14,14,109.58257,18.28458,1815
21062,163747,0D48FD835B207ED202CAB110B7436DC2,30854,16,17,1,109.56889,18.27076,1763
21063,163748,0D48FD835B207ED202CAB110B7436DC2,31821,20,21,1,109.51181,18.24924,1559
21064,163753,BBEE5F721A31A0C7CA0CDB43309D2457,38754,12,13,1,109.74667,18.37382,2430
21065,163754,BBEE5F721A31A0C7CA0CDB43309D2457,38951,18,20,2,109.48097,18.28868,1416
21066,163755,BBEE5F721A31A0C7CA0CDB43309D2457,60401,20,23,3,109.47444,18.27583,1414
21070,163771,209DF6A91F218920F5741E5EF3086DD3,31071,0,8,8,109.58257,18.28458,1815
21071,163772,209DF6A91F218920F5741E5EF3086DD3,30421,12,14,2,109.50021,18.25861,1511
21072,163773,209DF6A91F218920F5741E5EF3086DD3,30854,14,15,1,109.56889,18.27076,1763
21073,163774,209DF6A91F218920F5741E5EF3086DD3,31071,19,23,4,109.58257,18.28458,1815
21074,163806,AD6E05A888C5166E4DCB46810FF747A8,31701,2,3,1,109.44132,18.28833,1266
21075,163807,AD6E05A888C5166E4DCB46810FF747A8,31701,3,10,7,109.44132,18.28833,1266
21076,163808,AD6E05A888C5166E4DCB46810FF747A8,38111,13,16,3,109.52007,18.22403,1555
21077,163813,91F59FD84A5A011AF1877621EDB85B69,38706,0,16,16,109.74625,18.37097,2430
21078,163814,91F59FD84A5A011AF1877621EDB85B69,38706,17,23,6,109.74625,18.37097,2430
21079,163818,4E9C3D8DBD7B4A03D77C4314ACCD7B6D,38951,1,2,1,109.48097,18.28868,1416
21080,163819,4E9C3D8DBD7B4A03D77C4314ACCD7B6D,38951,3,4,1,109.48097,18.28868,1416
21081,163820,4E9C3D8DBD7B4A03D77C4314ACCD7B6D,38951,5,6,1,109.48097,18.28868,1416
21082,163821,4E9C3D8DBD7B4A03D77C4314ACCD7B6D,38951,6,9,3,109.48097,18.28868,1416
21083,163822,4E9C3D8DBD7B4A03D77C4314ACCD7B6D,38315,14,15,1,109.48979,18.29764,1467
21084,163911,6751CEC3CF9B2AE78246C7287443D2B4,31945,0,3,3,109.58021,18.29403,1817
21085,163912,6751CEC3CF9B2AE78246C7287443D2B4,30854,7,19,12,109.56889,18.27076,1763
21086,163921,0FFE97B54C688D2EEA9662A15AA9CB9D,30281,0,3,3,109.50597,18.27583,1514
21087,163922,0FFE97B54C688D2EEA9662A15AA9CB9D,30291,5,7,2,109.50403,18.27028,1513
21088,163923,0FFE97B54C688D2EEA9662A15AA9CB9D,38157,7,8,1,109.51483,18.26958,1563
21089,163924,0FFE97B54C688D2EEA9662A15AA9CB9D,33481,11,16,5,109.67278,18.41278,2187
21090,163925,0FFE97B54C688D2EEA9662A15AA9CB9D,30291,20,23,3,109.50403,18.27028,1513
21097,163991,68DBE0B52FD0AB95F1DD47068FD7847F,30181,0,1,1,109.51597,18.23313,1557
21098,163992,68DBE0B52FD0AB95F1DD47068FD7847F,31521,2,5,3,109.51458,18.22542,1555
21099,163993,68DBE0B52FD0AB95F1DD47068FD7847F,30181,5,7,2,109.51597,18.23313,1557
21100,163994,68DBE0B52FD0AB95F1DD47068FD7847F,31521,9,11,2,109.51458,18.22542,1555
21101,163995,68DBE0B52FD0AB95F1DD47068FD7847F,30361,13,16,3,109.50347,18.24,1508
21102,163996,68DBE0B52FD0AB95F1DD47068FD7847F,31201,18,19,1,109.51042,18.23819,1558
21103,163997,68DBE0B52FD0AB95F1DD47068FD7847F,30181,20,22,2,109.51597,18.23313,1557
21104,164039,BA03E00C1E8A034E0F06517E78EC4066,31691,11,17,6,109.36604,18.3075,1019
21105,164040,BA03E00C1E8A034E0F06517E78EC4066,31121,21,23,2,109.16292,18.37063,230
21106,164060,D16C062350492867096E1F38A610E35D,30151,0,19,19,109.50986,18.25083,1560
21107,164061,D16C062350492867096E1F38A610E35D,31821,21,23,2,109.51181,18.24924,1559
21108,164066,2FAD245BB53FEB8086E954B3DFCAA678,60671,0,9,9,109.52979,18.31757,1621
21109,164067,2FAD245BB53FEB8086E954B3DFCAA678,30031,11,14,3,109.53681,18.33313,1673
21110,164068,2FAD245BB53FEB8086E954B3DFCAA678,60661,16,18,2,109.548,18.2377,1657
21111,164069,2FAD245BB53FEB8086E954B3DFCAA678,30361,19,20,1,109.50347,18.24,1508
21112,164070,2FAD245BB53FEB8086E954B3DFCAA678,30031,21,23,2,109.53681,18.33313,1673
21117,164098,DECB7B3FC95BFA8620EFD8D9DE328252,31945,14,15,1,109.58021,18.29403,1817
21118,164099,DECB7B3FC95BFA8620EFD8D9DE328252,30854,16,18,2,109.56889,18.27076,1763
21122,164132,172CB232BBE684655CFBDFD055BB1CB5,60291,13,14,1,109.50826,18.24639,1509
21123,164133,172CB232BBE684655CFBDFD055BB1CB5,38127,15,16,1,109.50833,18.27222,1513
21124,164134,172CB232BBE684655CFBDFD055BB1CB5,30291,19,21,2,109.50403,18.27028,1513
21125,164201,4E9C73925B67466BCE6AE7E22B99BF20,31561,4,8,4,109.56792,18.28479,1765
21126,164202,4E9C73925B67466BCE6AE7E22B99BF20,30854,10,21,11,109.56889,18.27076,1763
21127,164211,A7FDF665A78FC5E85D90E0F0BDBE51A2,30191,2,8,6,109.50361,18.22701,1506
21128,164212,A7FDF665A78FC5E85D90E0F0BDBE51A2,31145,11,13,2,109.20431,18.30479,369
21129,164213,A7FDF665A78FC5E85D90E0F0BDBE51A2,60054,16,17,1,109.3016,18.31229,770
21130,164244,2D8DD824BBF69AD8F67DA5D5B6F17323,31261,0,2,2,109.51174,18.2466,1559
21131,164245,2D8DD824BBF69AD8F67DA5D5B6F17323,31461,3,5,2,109.5091,18.25389,1510
21132,164246,2D8DD824BBF69AD8F67DA5D5B6F17323,60201,6,10,4,109.5041,18.2509,1510
21133,164247,2D8DD824BBF69AD8F67DA5D5B6F17323,30991,13,16,3,109.30847,18.44139,791
21134,164248,2D8DD824BBF69AD8F67DA5D5B6F17323,38891,18,20,2,109.51486,18.24118,1558
21135,164249,2D8DD824BBF69AD8F67DA5D5B6F17323,60201,21,23,2,109.5041,18.2509,1510
21136,164271,B175A0347ABEEA30E818C5CCD25E280F,30651,0,1,1,109.42611,18.385,1232
21137,164272,B175A0347ABEEA30E818C5CCD25E280F,30821,1,20,19,109.43681,18.33639,1274
21138,164291,8B69C410684F618B4BB94E686E30E787,31531,7,9,2,109.49583,18.25972,1461
21139,164292,8B69C410684F618B4BB94E686E30E787,31471,12,14,2,109.34583,18.29563,917
21140,164293,8B69C410684F618B4BB94E686E30E787,30421,16,18,2,109.50021,18.25861,1511
21141,164294,8B69C410684F618B4BB94E686E30E787,31531,19,21,2,109.49583,18.25972,1461
21142,164302,C9A281EF0BD980779EA579DF3160E0C7,30211,11,13,2,109.49882,18.23931,1508
21143,164303,C9A281EF0BD980779EA579DF3160E0C7,30161,18,19,1,109.50042,18.24389,1508
21144,164304,C9A281EF0BD980779EA579DF3160E0C7,30211,19,20,1,109.49882,18.23931,1508
21145,164305,C9A281EF0BD980779EA579DF3160E0C7,60614,21,23,2,109.48799,18.29521,1467
21149,164324,7C68E1F4B8B2F3CBBD5427BF66BF9C2E,31321,16,18,2,109.63799,18.23201,2007
21150,164325,7C68E1F4B8B2F3CBBD5427BF66BF9C2E,30581,18,20,2,109.62257,18.24951,1959
21155,164358,B02D7A3F297B377D646E0F85B7C19006,61011,0,10,10,109.60653,18.19076,1900
21156,164360,B02D7A3F297B377D646E0F85B7C19006,61011,12,23,11,109.60653,18.19076,1900
21157,164372,7F6E66BC10419161F6457A6D79258EDB,38094,10,11,1,109.45403,18.28778,1316
21158,164373,7F6E66BC10419161F6457A6D79258EDB,38251,11,13,2,109.49618,18.25493,1510
21159,164374,7F6E66BC10419161F6457A6D79258EDB,38094,14,15,1,109.45403,18.28778,1316
21160,164375,7F6E66BC10419161F6457A6D79258EDB,30341,16,17,1,109.3625,18.29167,966
21161,164376,7F6E66BC10419161F6457A6D79258EDB,60621,20,22,2,109.48354,18.27451,1464
21166,164387,246EF4D95FA494895EFB2D649512DAE7,31521,0,5,5,109.51458,18.22542,1555
21167,164389,246EF4D95FA494895EFB2D649512DAE7,61011,17,18,1,109.60653,18.19076,1900
21168,164399,080247CC19405F981D4BEFE1A1E9D339,31931,1,4,3,109.54771,18.29403,1667
21169,164400,080247CC19405F981D4BEFE1A1E9D339,39181,8,23,15,109.55153,18.28035,1715
21174,164421,372A5433078073EAD18922D679CE0A73,60054,0,8,8,109.3016,18.31229,770
21175,164422,372A5433078073EAD18922D679CE0A73,60411,12,13,1,109.32514,18.30854,869
21176,164423,372A5433078073EAD18922D679CE0A73,60054,14,15,1,109.3016,18.31229,770
21177,164424,372A5433078073EAD18922D679CE0A73,60411,15,17,2,109.32514,18.30854,869
21178,164425,372A5433078073EAD18922D679CE0A73,60054,20,21,1,109.3016,18.31229,770
21179,164426,372A5433078073EAD18922D679CE0A73,30661,22,23,1,109.37028,18.24361,1008
21180,164436,BCE751A95FD4E47157356B205E676C81,30351,0,16,16,109.41701,18.29292,1217
21181,164437,BCE751A95FD4E47157356B205E676C81,30361,16,19,3,109.50347,18.24,1508
21182,164441,24A5718F38ADE9789750DBD9F143F189,31031,19,21,2,109.49979,18.25382,1510
21183,164442,24A5718F38ADE9789750DBD9F143F189,38951,21,23,2,109.48097,18.28868,1416
21188,164526,BA987FAAC62A550769ECB5E13AC256A5,38171,0,9,9,109.50799,18.28139,1515
21189,164527,BA987FAAC62A550769ECB5E13AC256A5,31864,12,13,1,109.49014,18.28333,1465
21190,164528,BA987FAAC62A550769ECB5E13AC256A5,31931,15,17,2,109.54771,18.29403,1667
21191,164529,BA987FAAC62A550769ECB5E13AC256A5,39151,18,20,2,109.49875,18.25097,1510
21192,164530,BA987FAAC62A550769ECB5E13AC256A5,60281,22,23,1,109.51743,18.25924,1561
21193,164535,C925EDC1C2C39BAEC75090090BF059D6,30721,16,18,2,109.51597,18.28257,1565
21194,164536,C925EDC1C2C39BAEC75090090BF059D6,30741,19,23,4,109.49833,18.28681,1516
21208,164663,8CF08DEE8EF83AC7333B837D79034776,38121,0,8,8,109.51361,18.27813,1564
21209,164665,8CF08DEE8EF83AC7333B837D79034776,31531,17,23,6,109.49583,18.25972,1461
21210,164687,FBDD80570A641C18D89F4987D07601F8,31561,2,5,3,109.56792,18.28479,1765
21211,164688,FBDD80570A641C18D89F4987D07601F8,30854,7,22,15,109.56889,18.27076,1763
21212,164710,7BB0E357F79DCC3BC5358A41DFC62FBE,30854,13,20,7,109.56889,18.27076,1763
21213,164711,7BB0E357F79DCC3BC5358A41DFC62FBE,31561,21,23,2,109.56792,18.28479,1765
21214,164741,302C193EE9901423C2412C2BB087FCC7,30351,8,10,2,109.41701,18.29292,1217
21215,164742,302C193EE9901423C2412C2BB087FCC7,31091,11,13,2,109.41201,18.31222,1170
21216,164743,302C193EE9901423C2412C2BB087FCC7,38706,14,22,8,109.74625,18.37097,2430
21217,164751,A9F97D2464709590426A157138F3C687,31931,0,10,10,109.54771,18.29403,1667
21218,164752,A9F97D2464709590426A157138F3C687,39181,10,11,1,109.55153,18.28035,1715
21219,164753,A9F97D2464709590426A157138F3C687,31931,12,14,2,109.54771,18.29403,1667
21220,164754,A9F97D2464709590426A157138F3C687,39181,18,19,1,109.55153,18.28035,1715
21221,164755,A9F97D2464709590426A157138F3C687,31931,19,20,1,109.54771,18.29403,1667
21222,164826,775EB6812979C1B34766B2D30E0D2441,31701,0,5,5,109.44132,18.28833,1266
21223,164827,775EB6812979C1B34766B2D30E0D2441,38871,7,9,2,109.44681,18.28625,1316
21231,164921,07656689F72FAC39425758CA91F1B696,31781,16,17,1,109.19847,18.2975,367
21232,164922,07656689F72FAC39425758CA91F1B696,60221,19,20,1,109.52569,18.29188,1616
21233,164923,07656689F72FAC39425758CA91F1B696,30181,22,23,1,109.51597,18.23313,1557
21234,164924,81D70A3ED522BA9C5A3A11D0C612F029,30191,0,6,6,109.50361,18.22701,1506
21235,164925,81D70A3ED522BA9C5A3A11D0C612F029,30661,8,17,9,109.37028,18.24361,1008
21236,164926,81D70A3ED522BA9C5A3A11D0C612F029,31521,20,22,2,109.51458,18.22542,1555
21237,164927,36BCA39777B9D1E703C1404CDA6A45E7,30511,0,8,8,109.51069,18.24208,1558
21238,164928,36BCA39777B9D1E703C1404CDA6A45E7,30511,9,11,2,109.51069,18.24208,1558
21239,164929,36BCA39777B9D1E703C1404CDA6A45E7,31521,13,14,1,109.51458,18.22542,1555
21240,164930,36BCA39777B9D1E703C1404CDA6A45E7,30511,15,17,2,109.51069,18.24208,1558
21241,164931,36BCA39777B9D1E703C1404CDA6A45E7,30511,20,23,3,109.51069,18.24208,1558
21245,164953,855D815DC19AA779325469411A9E7B8A,38157,12,15,3,109.51483,18.26958,1563
21246,164954,855D815DC19AA779325469411A9E7B8A,30251,17,23,6,109.50611,18.26653,1512
21247,164999,8621CFDF1B89A83351494618C53D033F,31071,0,5,5,109.58257,18.28458,1815
21248,165000,8621CFDF1B89A83351494618C53D033F,39181,8,19,11,109.55153,18.28035,1715
21249,165061,B125AF31137882D184643AC445C2034E,31521,20,21,1,109.51458,18.22542,1555
21250,165062,B125AF31137882D184643AC445C2034E,60381,22,23,1,109.5241,18.22458,1605
21251,165074,BC78511C0B1B49984ADDBA304773FFF3,31521,14,17,3,109.51458,18.22542,1555
21252,165075,BC78511C0B1B49984ADDBA304773FFF3,38111,17,22,5,109.52007,18.22403,1555
21261,165126,3456EF45A9AD00721451876A26BECEFE,39321,3,5,2,109.529,18.2167,1604
21262,165127,3456EF45A9AD00721451876A26BECEFE,60381,7,23,16,109.5241,18.22458,1605
21263,165156,8B3125BACE32612AE7F9DC5599DC75E6,30731,0,7,7,109.50944,18.22306,1555
21264,165157,8B3125BACE32612AE7F9DC5599DC75E6,30661,8,9,1,109.37028,18.24361,1008
21265,165158,8B3125BACE32612AE7F9DC5599DC75E6,39061,11,12,1,109.38222,18.28958,1066
21266,165159,8B3125BACE32612AE7F9DC5599DC75E6,30661,12,18,6,109.37028,18.24361,1008
21267,165160,8B3125BACE32612AE7F9DC5599DC75E6,60081,20,23,3,109.51097,18.22639,1556
21276,165251,8F3DE08315D720DC64DC898C5903196E,60631,0,4,4,109.57778,18.27583,1814
21277,165252,8F3DE08315D720DC64DC898C5903196E,30854,7,23,16,109.56889,18.27076,1763
21278,165255,EB316856896788EC8FD871E122E95728,60361,0,7,7,109.51938,18.29681,1567
21279,165256,EB316856896788EC8FD871E122E95728,31811,8,11,3,109.54201,18.31806,1671
21280,165257,EB316856896788EC8FD871E122E95728,30101,12,14,2,109.57299,18.33333,1773
21281,165258,EB316856896788EC8FD871E122E95728,30701,16,21,5,109.59313,18.32007,1871
21286,165280,10549B1717E5239D7AEBFC330945270F,30661,1,2,1,109.37028,18.24361,1008
21287,165281,10549B1717E5239D7AEBFC330945270F,60411,3,7,4,109.32514,18.30854,869
21288,165288,878FC5EBB1B28FAABA6E6BFD01664318,30251,12,16,4,109.50611,18.26653,1512
21289,165289,878FC5EBB1B28FAABA6E6BFD01664318,30711,17,18,1,109.50271,18.25347,1510
21290,165290,878FC5EBB1B28FAABA6E6BFD01664318,30251,19,23,4,109.50611,18.26653,1512
21297,165419,706B8E0F0F5D1C9FC2F8EBB2574EE89F,60201,0,2,2,109.5041,18.2509,1510
21298,165420,706B8E0F0F5D1C9FC2F8EBB2574EE89F,31461,2,7,5,109.5091,18.25389,1510
21299,165421,706B8E0F0F5D1C9FC2F8EBB2574EE89F,30711,8,10,2,109.50271,18.25347,1510
21300,165422,706B8E0F0F5D1C9FC2F8EBB2574EE89F,30911,10,21,11,109.50493,18.26181,1511
21301,165423,706B8E0F0F5D1C9FC2F8EBB2574EE89F,30711,22,23,1,109.50271,18.25347,1510
21302,165433,44B54E64DFC324A23E66F52E98A481FB,30211,0,9,9,109.49882,18.23931,1508
21303,165434,44B54E64DFC324A23E66F52E98A481FB,31145,11,13,2,109.20431,18.30479,369
21304,165435,44B54E64DFC324A23E66F52E98A481FB,31781,13,14,1,109.19847,18.2975,367
21305,165436,44B54E64DFC324A23E66F52E98A481FB,30211,17,21,4,109.49882,18.23931,1508
21310,165473,9B43F93397D8AD2193F77AAD4D6186E5,30721,0,8,8,109.51597,18.28257,1565
21311,165476,9B43F93397D8AD2193F77AAD4D6186E5,30721,18,23,5,109.51597,18.28257,1565
21312,165490,019EB913544B8855829875D27D9C85B6,60361,0,1,1,109.51938,18.29681,1567
21313,165491,019EB913544B8855829875D27D9C85B6,31201,2,9,7,109.51042,18.23819,1558
21314,165492,019EB913544B8855829875D27D9C85B6,30511,12,14,2,109.51069,18.24208,1558
21315,165493,019EB913544B8855829875D27D9C85B6,30181,16,18,2,109.51597,18.23313,1557
21316,165520,2FD3D62C2F03A29CB2B8169833F320AE,31521,15,18,3,109.51458,18.22542,1555
21317,165521,2FD3D62C2F03A29CB2B8169833F320AE,31421,18,20,2,109.55382,18.22347,1705
21318,165522,2FD3D62C2F03A29CB2B8169833F320AE,60381,20,22,2,109.5241,18.22458,1605
21322,165584,1D613D61EB380544A693E6450D8A9DB4,31345,0,8,8,109.39,18.29,1066
21323,165585,1D613D61EB380544A693E6450D8A9DB4,31145,10,12,2,109.20431,18.30479,369
21324,165586,1D613D61EB380544A693E6450D8A9DB4,31471,13,15,2,109.34583,18.29563,917
21325,165587,1D613D61EB380544A693E6450D8A9DB4,60551,18,20,2,109.42722,18.30111,1218
21326,165588,1D613D61EB380544A693E6450D8A9DB4,31345,21,23,2,109.39,18.29,1066
21327,165589,53BCE5F560CEFC5FCB7183DCF1733E93,30511,1,9,8,109.51069,18.24208,1558
21328,165590,53BCE5F560CEFC5FCB7183DCF1733E93,30511,13,23,10,109.51069,18.24208,1558
21329,165597,8873690CCFD5F63D42F0A4C5C2610D9F,31471,15,16,1,109.34583,18.29563,917
21330,165598,8873690CCFD5F63D42F0A4C5C2610D9F,38754,18,20,2,109.74667,18.37382,2430
21335,165605,3B6FF1F8D896A0A62DC7E65967011999,31561,0,3,3,109.56792,18.28479,1765
21336,165606,3B6FF1F8D896A0A62DC7E65967011999,39183,5,23,18,109.55542,18.28208,1715
21337,165609,54036114D002A873652B2123255670F7,38754,0,13,13,109.74667,18.37382,2430
21338,165610,54036114D002A873652B2123255670F7,30361,17,19,2,109.50347,18.24,1508
21339,165611,54036114D002A873652B2123255670F7,38336,20,22,2,109.61111,18.21806,1904
21343,165639,DB4DF566D4757FF3BB488F82DE126248,31561,7,9,2,109.56792,18.28479,1765
21344,165640,DB4DF566D4757FF3BB488F82DE126248,30854,9,10,1,109.56889,18.27076,1763
21345,165663,0312B43ACF9ED1D8304E325E851AEE29,30851,6,14,8,109.5616,18.27396,1713
21346,165664,0312B43ACF9ED1D8304E325E851AEE29,31561,14,16,2,109.56792,18.28479,1765
21347,165665,0312B43ACF9ED1D8304E325E851AEE29,30851,16,21,5,109.5616,18.27396,1713
21348,165666,0312B43ACF9ED1D8304E325E851AEE29,31561,21,22,1,109.56792,18.28479,1765
21349,165672,24F13A92B374E6D95DDAA2ABBEAFF9C1,31345,0,8,8,109.39,18.29,1066
21350,165673,24F13A92B374E6D95DDAA2ABBEAFF9C1,31781,10,12,2,109.19847,18.2975,367
21351,165674,24F13A92B374E6D95DDAA2ABBEAFF9C1,31471,13,14,1,109.34583,18.29563,917
21352,165675,24F13A92B374E6D95DDAA2ABBEAFF9C1,60551,18,19,1,109.42722,18.30111,1218
21353,165676,24F13A92B374E6D95DDAA2ABBEAFF9C1,31345,22,23,1,109.39,18.29,1066
21354,165687,59B48C7DD533E36B4AA6ADABEB53F8C6,60631,0,6,6,109.57778,18.27583,1814
21355,165688,59B48C7DD533E36B4AA6ADABEB53F8C6,31571,7,12,5,109.61563,18.23326,1957
21356,165689,59B48C7DD533E36B4AA6ADABEB53F8C6,60631,14,15,1,109.57778,18.27583,1814
21357,165690,59B48C7DD533E36B4AA6ADABEB53F8C6,31571,16,17,1,109.61563,18.23326,1957
21358,165691,59B48C7DD533E36B4AA6ADABEB53F8C6,30854,18,20,2,109.56889,18.27076,1763
21359,165692,59B48C7DD533E36B4AA6ADABEB53F8C6,60631,21,23,2,109.57778,18.27583,1814
21370,165781,5CC1762A5E087A77C8027D2CC6A16A88,30741,12,14,2,109.49833,18.28681,1516
21371,165782,5CC1762A5E087A77C8027D2CC6A16A88,38127,16,23,7,109.50833,18.27222,1513
21372,165789,8088BB824557EB3DC3C65BFEE10DC938,31031,12,13,1,109.49979,18.25382,1510
21373,165790,8088BB824557EB3DC3C65BFEE10DC938,38251,18,20,2,109.49618,18.25493,1510
21374,165791,8088BB824557EB3DC3C65BFEE10DC938,30271,21,23,2,109.49132,18.23153,1456
21375,165832,B0D2E3C407097FA6EE45A73276479899,60331,18,20,2,109.505,18.26507,1512
21376,165833,B0D2E3C407097FA6EE45A73276479899,30421,20,21,1,109.50021,18.25861,1511
21377,165834,B0D2E3C407097FA6EE45A73276479899,60331,21,22,1,109.505,18.26507,1512
21378,165886,0B1CC3266C9F341870D0B135F2AF352E,60472,0,6,6,109.46625,18.29542,1367
21379,165887,0B1CC3266C9F341870D0B135F2AF352E,30111,7,8,1,109.47583,18.30542,1419
21380,165888,0B1CC3266C9F341870D0B135F2AF352E,30711,11,14,3,109.50271,18.25347,1510
21381,165889,0B1CC3266C9F341870D0B135F2AF352E,60441,14,21,7,109.46792,18.28604,1366
21382,165903,E43F5A263B0294AA2C456223D73198EC,31521,5,16,11,109.51458,18.22542,1555
21383,165904,E43F5A263B0294AA2C456223D73198EC,30861,17,19,2,109.52722,18.22743,1606
21384,165910,0C8D15C0488D521680F0DE3A28CFE111,30701,7,9,2,109.59313,18.32007,1871
21385,165911,0C8D15C0488D521680F0DE3A28CFE111,31811,9,11,2,109.54201,18.31806,1671
21386,165912,0C8D15C0488D521680F0DE3A28CFE111,30701,11,23,12,109.59313,18.32007,1871
21387,165944,45CCFCD3EBDF941E1C92B70ED06E8B5E,30854,0,5,5,109.56889,18.27076,1763
21388,165945,45CCFCD3EBDF941E1C92B70ED06E8B5E,31945,10,11,1,109.58021,18.29403,1817
21389,165946,45CCFCD3EBDF941E1C92B70ED06E8B5E,30854,11,14,3,109.56889,18.27076,1763
21390,165947,45CCFCD3EBDF941E1C92B70ED06E8B5E,31221,17,19,2,109.61333,18.26833,1913
21391,165948,45CCFCD3EBDF941E1C92B70ED06E8B5E,30441,21,22,1,109.64021,18.25424,2010
21392,165962,C5B1410BD3333D6A3B1B68633B51E495,38325,0,6,6,109.39792,18.2909,1116
21393,165978,6B806948BC9187A91D033B4096721B00,30854,0,8,8,109.56889,18.27076,1763
21394,165979,6B806948BC9187A91D033B4096721B00,31071,8,19,11,109.58257,18.28458,1815
21395,165983,DE5024DB59D5BF6AE5857A85EB7680EA,31071,0,4,4,109.58257,18.28458,1815
21396,165984,DE5024DB59D5BF6AE5857A85EB7680EA,30854,8,18,10,109.56889,18.27076,1763
21397,166028,BF47FA4C2D8294F1660DC2EB7200128F,31345,0,10,10,109.39,18.29,1066
21398,166029,BF47FA4C2D8294F1660DC2EB7200128F,31781,11,12,1,109.19847,18.2975,367
21399,166030,BF47FA4C2D8294F1660DC2EB7200128F,31345,15,17,2,109.39,18.29,1066
21400,166031,BF47FA4C2D8294F1660DC2EB7200128F,30201,18,19,1,109.4909,18.26465,1462
21401,166032,BF47FA4C2D8294F1660DC2EB7200128F,38291,20,23,3,109.51618,18.24313,1558
21402,166059,1CB7DA025FB95AE18ED5AC1449EEA03C,31081,1,13,12,109.44639,18.30181,1318
21407,166118,996308BA516E2A4FD895EB11278D247D,30201,0,19,19,109.4909,18.26465,1462
21408,166119,996308BA516E2A4FD895EB11278D247D,31031,19,23,4,109.49979,18.25382,1510
21409,166141,E292D83051830D054E89D209EEABA4B9,31561,1,2,1,109.56792,18.28479,1765
21410,166142,E292D83051830D054E89D209EEABA4B9,30851,4,6,2,109.5616,18.27396,1713
21411,166143,E292D83051830D054E89D209EEABA4B9,39183,8,10,2,109.55542,18.28208,1715
21412,166144,E292D83051830D054E89D209EEABA4B9,31561,14,16,2,109.56792,18.28479,1765
21413,166145,E292D83051830D054E89D209EEABA4B9,31031,21,22,1,109.49979,18.25382,1510
21414,166188,2C3459DAFE695C300A661A98CBD396AB,31231,9,10,1,109.42597,18.29292,1217
21415,166189,2C3459DAFE695C300A661A98CBD396AB,30101,15,16,1,109.57299,18.33333,1773
21416,166190,2C3459DAFE695C300A661A98CBD396AB,30651,17,21,4,109.42611,18.385,1232
21417,166206,30DA8BEF22769330A5D581D4E40911DE,60281,18,21,3,109.51743,18.25924,1561
21418,166207,30DA8BEF22769330A5D581D4E40911DE,31031,21,23,2,109.49979,18.25382,1510
21419,166209,A5C73F1C88306EFCBB8393D7978016B5,60381,18,19,1,109.5241,18.22458,1605
21424,166265,48EC852B1939DE9DE8D67EA49BF6D736,60361,12,14,2,109.51938,18.29681,1567
21425,166266,48EC852B1939DE9DE8D67EA49BF6D736,30251,16,18,2,109.50611,18.26653,1512
21426,166267,48EC852B1939DE9DE8D67EA49BF6D736,30721,21,23,2,109.51597,18.28257,1565
21427,166324,DA10676C4DA702E02A2C3FFFAC40ABA2,39183,1,12,11,109.55542,18.28208,1715
21428,166325,DA10676C4DA702E02A2C3FFFAC40ABA2,31561,13,23,10,109.56792,18.28479,1765
21429,166331,3977578BE56276DA0700B04B81DC1356,31561,4,5,1,109.56792,18.28479,1765
21430,166332,3977578BE56276DA0700B04B81DC1356,30851,5,7,2,109.5616,18.27396,1713
21431,166333,3977578BE56276DA0700B04B81DC1356,31561,8,9,1,109.56792,18.28479,1765
21432,166334,3977578BE56276DA0700B04B81DC1356,30851,10,11,1,109.5616,18.27396,1713
21433,166335,3977578BE56276DA0700B04B81DC1356,31561,12,14,2,109.56792,18.28479,1765
21434,166341,6EB870A8DE5FEF4CB01EB6410E49EA6C,30854,9,11,2,109.56889,18.27076,1763
21435,166342,6EB870A8DE5FEF4CB01EB6410E49EA6C,31561,11,15,4,109.56792,18.28479,1765
21436,166343,6EB870A8DE5FEF4CB01EB6410E49EA6C,30711,17,20,3,109.50271,18.25347,1510
21437,166344,6EB870A8DE5FEF4CB01EB6410E49EA6C,31561,21,23,2,109.56792,18.28479,1765
21438,166417,AD608A919061B1C684914F8654FB2493,60041,0,2,2,109.39889,18.31944,1121
21439,166418,AD608A919061B1C684914F8654FB2493,30651,2,4,2,109.42611,18.385,1232
21440,166419,AD608A919061B1C684914F8654FB2493,38145,5,7,2,109.378,18.2912,1066
21441,166420,AD608A919061B1C684914F8654FB2493,30651,9,14,5,109.42611,18.385,1232
21453,166504,28B366167501D3E270BF1F5EDB4474EC,30854,13,14,1,109.56889,18.27076,1763
21454,166505,28B366167501D3E270BF1F5EDB4474EC,30234,15,17,2,109.60681,18.29979,1918
21455,166517,537CA9C3FED012868AB5E4DF92AD232C,30861,0,10,10,109.52722,18.22743,1606
21456,166518,537CA9C3FED012868AB5E4DF92AD232C,60641,12,13,1,109.53854,18.2359,1657
21457,166519,537CA9C3FED012868AB5E4DF92AD232C,31461,14,15,1,109.5091,18.25389,1510
21458,166520,537CA9C3FED012868AB5E4DF92AD232C,31031,16,17,1,109.49979,18.25382,1510
21459,166521,537CA9C3FED012868AB5E4DF92AD232C,30861,19,23,4,109.52722,18.22743,1606
21466,166593,173CD7A2B7B334BC53A50A1D248FBCFE,31071,3,10,7,109.58257,18.28458,1815
21467,166594,173CD7A2B7B334BC53A50A1D248FBCFE,30854,10,14,4,109.56889,18.27076,1763
21468,166595,173CD7A2B7B334BC53A50A1D248FBCFE,31091,15,19,4,109.41201,18.31222,1170
21469,166602,451E2BF48CD7B253EB0892324E679BCC,38297,0,7,7,109.52576,18.24965,1609
21470,166603,451E2BF48CD7B253EB0892324E679BCC,60281,7,18,11,109.51743,18.25924,1561
21471,166604,451E2BF48CD7B253EB0892324E679BCC,38297,18,19,1,109.52576,18.24965,1609
21472,166605,451E2BF48CD7B253EB0892324E679BCC,30711,20,21,1,109.50271,18.25347,1510
21473,166606,451E2BF48CD7B253EB0892324E679BCC,38297,21,23,2,109.52576,18.24965,1609
21474,166618,3160CBE2F0CDCB610575CDC881D9968C,38127,17,18,1,109.50833,18.27222,1513
21475,166619,3160CBE2F0CDCB610575CDC881D9968C,31861,20,21,1,109.49042,18.27549,1464
21476,166620,3160CBE2F0CDCB610575CDC881D9968C,38297,22,23,1,109.52576,18.24965,1609
21477,166644,94ACF7A1508842D400E0E081D99A3FBE,31521,19,23,4,109.51458,18.22542,1555
21478,166676,5E08AB7C372A394BECF04F7C241613A4,60524,0,6,6,109.42951,18.28993,1216
21479,166677,5E08AB7C372A394BECF04F7C241613A4,60551,6,8,2,109.42722,18.30111,1218
21480,166678,5E08AB7C372A394BECF04F7C241613A4,31145,10,12,2,109.20431,18.30479,369
21481,166679,5E08AB7C372A394BECF04F7C241613A4,31781,12,13,1,109.19847,18.2975,367
21482,166680,5E08AB7C372A394BECF04F7C241613A4,31471,14,16,2,109.34583,18.29563,917
21483,166721,A76FBC2A19FBBE53E6CFE5E27050EE06,60081,0,5,5,109.51097,18.22639,1556
21484,166722,A76FBC2A19FBBE53E6CFE5E27050EE06,30191,6,8,2,109.50361,18.22701,1506
21485,166723,A76FBC2A19FBBE53E6CFE5E27050EE06,31781,11,13,2,109.19847,18.2975,367
21486,166724,A76FBC2A19FBBE53E6CFE5E27050EE06,31471,15,17,2,109.34583,18.29563,917
21487,166725,A76FBC2A19FBBE53E6CFE5E27050EE06,60381,20,22,2,109.5241,18.22458,1605
21488,166745,F6A1EBB84FE583E84185C423218578F5,30854,17,19,2,109.56889,18.27076,1763
21489,166746,F6A1EBB84FE583E84185C423218578F5,31561,19,20,1,109.56792,18.28479,1765
21490,166802,5202825DF51CA068C8B204422480230F,31071,2,9,7,109.58257,18.28458,1815
21491,166803,5202825DF51CA068C8B204422480230F,31945,13,14,1,109.58021,18.29403,1817
21492,166831,0E1B3CFC64EBB658DA96D0DCA834701E,61011,7,21,14,109.60653,18.19076,1900
21496,166841,76A2DDC275135F20E5541A96E91E072B,31031,15,18,3,109.49979,18.25382,1510
21497,166842,76A2DDC275135F20E5541A96E91E072B,31031,19,23,4,109.49979,18.25382,1510
21498,166877,D39D64452E6BBEF7B3056CA239E1B86E,30854,0,6,6,109.56889,18.27076,1763
21499,166878,D39D64452E6BBEF7B3056CA239E1B86E,31561,6,10,4,109.56792,18.28479,1765
21500,166879,D39D64452E6BBEF7B3056CA239E1B86E,30854,10,13,3,109.56889,18.27076,1763
21501,166880,D39D64452E6BBEF7B3056CA239E1B86E,31561,14,15,1,109.56792,18.28479,1765
21502,166881,D39D64452E6BBEF7B3056CA239E1B86E,30854,15,23,8,109.56889,18.27076,1763
21506,166970,B0C6DED232762D9BAF78468BD2731104,60041,14,15,1,109.39889,18.31944,1121
21507,166971,B0C6DED232762D9BAF78468BD2731104,30581,20,23,3,109.62257,18.24951,1959
21508,166972,1A1B5C664F8D6460240C73AB76187420,30854,3,8,5,109.56889,18.27076,1763
21509,166973,1A1B5C664F8D6460240C73AB76187420,31071,12,13,1,109.58257,18.28458,1815
21510,166974,1A1B5C664F8D6460240C73AB76187420,30854,15,16,1,109.56889,18.27076,1763
21511,166975,1A1B5C664F8D6460240C73AB76187420,31071,17,19,2,109.58257,18.28458,1815
21512,166976,1A1B5C664F8D6460240C73AB76187420,30854,20,22,2,109.56889,18.27076,1763
21513,166990,7E7742F5B0156B5C74FAAA9FE22D94C7,31071,0,13,13,109.58257,18.28458,1815
21514,166991,7E7742F5B0156B5C74FAAA9FE22D94C7,30854,16,23,7,109.56889,18.27076,1763
21515,167066,B712327B6033C61F37801CFD6DAC08AD,38484,13,15,2,109.53028,18.31528,1620
21516,167067,B712327B6033C61F37801CFD6DAC08AD,30561,19,22,3,109.52778,18.31938,1621
21520,167107,5C18A2E44B35E6C3C2823CC3AAFB80BA,60201,0,9,9,109.5041,18.2509,1510
21521,167108,5C18A2E44B35E6C3C2823CC3AAFB80BA,31931,9,11,2,109.54771,18.29403,1667
21522,167109,5C18A2E44B35E6C3C2823CC3AAFB80BA,60201,12,14,2,109.5041,18.2509,1510
21523,167110,5C18A2E44B35E6C3C2823CC3AAFB80BA,60201,15,23,8,109.5041,18.2509,1510
21527,167163,89362A3CA3AE6F5B75871F2110924F99,30851,0,11,11,109.5616,18.27396,1713
21528,167164,89362A3CA3AE6F5B75871F2110924F99,30951,11,14,3,109.56208,18.25667,1761
21529,167165,89362A3CA3AE6F5B75871F2110924F99,39371,14,16,2,109.56627,18.2646,1762
21530,167166,89362A3CA3AE6F5B75871F2110924F99,30951,16,17,1,109.56208,18.25667,1761
21531,167167,89362A3CA3AE6F5B75871F2110924F99,30851,18,23,5,109.5616,18.27396,1713
21536,167250,7FF3C6569A3990C03CAF6C52D3C8BC6C,30921,1,4,3,109.53903,18.29451,1667
21537,167251,7FF3C6569A3990C03CAF6C52D3C8BC6C,31931,5,7,2,109.54771,18.29403,1667
21538,167252,7FF3C6569A3990C03CAF6C52D3C8BC6C,30921,7,8,1,109.53903,18.29451,1667
21539,167253,7FF3C6569A3990C03CAF6C52D3C8BC6C,60241,11,12,1,109.53319,18.28667,1616
21540,167254,7FF3C6569A3990C03CAF6C52D3C8BC6C,31931,14,15,1,109.54771,18.29403,1667
21541,167255,7FF3C6569A3990C03CAF6C52D3C8BC6C,30921,16,17,1,109.53903,18.29451,1667
21545,167266,63C17AFD80869AD1D0375390D26A4ACA,38127,0,17,17,109.50833,18.27222,1513
21546,167267,63C17AFD80869AD1D0375390D26A4ACA,38157,20,22,2,109.51483,18.26958,1563
21547,167276,D6E72F3649E9FA4F285A8682EF1A1E3A,39101,0,9,9,109.50132,18.24931,1509
21548,167277,D6E72F3649E9FA4F285A8682EF1A1E3A,31521,11,20,9,109.51458,18.22542,1555
21549,167297,F47C4E1E39056C43B0AD32AC994AB7C0,31931,12,13,1,109.54771,18.29403,1667
21550,167298,F47C4E1E39056C43B0AD32AC994AB7C0,60361,14,19,5,109.51938,18.29681,1567
21551,167299,F47C4E1E39056C43B0AD32AC994AB7C0,31931,21,23,2,109.54771,18.29403,1667
21552,167311,2D72FF66CB71FCFECF5E9D92443E43AB,38291,14,16,2,109.51618,18.24313,1558
21553,167312,2D72FF66CB71FCFECF5E9D92443E43AB,60311,17,19,2,109.52097,18.24319,1558
21561,167362,C84F6E3CAF0EAE725088ED441618D6C7,30181,0,1,1,109.51597,18.23313,1557
21562,167363,C84F6E3CAF0EAE725088ED441618D6C7,31206,2,5,3,109.50819,18.23549,1507
21563,167364,C84F6E3CAF0EAE725088ED441618D6C7,30181,5,7,2,109.51597,18.23313,1557
21564,167365,C84F6E3CAF0EAE725088ED441618D6C7,30851,16,17,1,109.5616,18.27396,1713
21565,167366,C84F6E3CAF0EAE725088ED441618D6C7,30181,18,23,5,109.51597,18.23313,1557
21566,167367,3738BCD5F22BB841A8E524306ADFE0A0,38261,0,7,7,109.50361,18.28153,1515
21567,167368,3738BCD5F22BB841A8E524306ADFE0A0,38751,8,19,11,109.74903,18.37639,2481
21568,167369,3738BCD5F22BB841A8E524306ADFE0A0,60231,21,22,1,109.49903,18.21972,1504
21572,167465,491A112CD81B9085F752897809919691,31201,0,7,7,109.51042,18.23819,1558
21573,167466,491A112CD81B9085F752897809919691,30511,8,9,1,109.51069,18.24208,1558
21574,167467,491A112CD81B9085F752897809919691,60291,14,15,1,109.50826,18.24639,1509
21575,167468,491A112CD81B9085F752897809919691,31521,17,18,1,109.51458,18.22542,1555
21576,167469,491A112CD81B9085F752897809919691,31201,22,23,1,109.51042,18.23819,1558
21577,167475,68D4FD9FDF41B7C090858F716B8364B9,31521,0,6,6,109.51458,18.22542,1555
21578,167476,68D4FD9FDF41B7C090858F716B8364B9,38185,6,8,2,109.51333,18.27347,1563
21579,167477,68D4FD9FDF41B7C090858F716B8364B9,30854,10,11,1,109.56889,18.27076,1763
21580,167511,807332CEC38772FA8DF98C48FBD8DD1E,31561,11,12,1,109.56792,18.28479,1765
21581,167512,807332CEC38772FA8DF98C48FBD8DD1E,31931,15,17,2,109.54771,18.29403,1667
21582,167513,807332CEC38772FA8DF98C48FBD8DD1E,31561,20,22,2,109.56792,18.28479,1765
21583,167514,97C31877CA4226D0F1BA1C0E12066B56,30081,0,7,7,109.50243,18.26632,1512
21584,167515,97C31877CA4226D0F1BA1C0E12066B56,31071,9,10,1,109.58257,18.28458,1815
21585,167516,97C31877CA4226D0F1BA1C0E12066B56,30854,15,18,3,109.56889,18.27076,1763
21586,167517,97C31877CA4226D0F1BA1C0E12066B56,30081,19,20,1,109.50243,18.26632,1512
21587,167518,97C31877CA4226D0F1BA1C0E12066B56,60331,22,23,1,109.505,18.26507,1512
21588,167534,A549C024E6F63EDBD3DC866F10DB11CE,30234,1,4,3,109.60681,18.29979,1918
21589,167535,A549C024E6F63EDBD3DC866F10DB11CE,31071,5,6,1,109.58257,18.28458,1815
21590,167536,A549C024E6F63EDBD3DC866F10DB11CE,30854,7,10,3,109.56889,18.27076,1763
21591,167537,A549C024E6F63EDBD3DC866F10DB11CE,31071,12,13,1,109.58257,18.28458,1815
21592,167538,A549C024E6F63EDBD3DC866F10DB11CE,30854,15,17,2,109.56889,18.27076,1763
21593,167562,56D57BE12476A3A09FC512AA68EE1DCB,60084,0,6,6,109.4984,18.2334,1507
21594,167563,56D57BE12476A3A09FC512AA68EE1DCB,60231,7,14,7,109.49903,18.21972,1504
21595,167564,56D57BE12476A3A09FC512AA68EE1DCB,31251,16,21,5,109.18528,18.2975,317
21596,167574,A749E400BFD3B5908671E939EC104DEE,31071,2,7,5,109.58257,18.28458,1815
21597,167575,A749E400BFD3B5908671E939EC104DEE,30854,7,21,14,109.56889,18.27076,1763
21598,167576,E4B522EF4348156010E5C578EC13D60F,30234,0,9,9,109.60681,18.29979,1918
21599,167577,E4B522EF4348156010E5C578EC13D60F,30854,10,14,4,109.56889,18.27076,1763
21600,167578,E4B522EF4348156010E5C578EC13D60F,31164,18,20,2,109.69993,18.27215,2263
21601,167579,E4B522EF4348156010E5C578EC13D60F,30854,22,23,1,109.56889,18.27076,1763
21602,167589,560794A44CA17A43FA34D0FA6C339747,30181,18,21,3,109.51597,18.23313,1557
21603,167590,560794A44CA17A43FA34D0FA6C339747,30854,22,23,1,109.56889,18.27076,1763
21604,167596,DCD137352B900F9F43521E37884B7F13,60054,0,8,8,109.3016,18.31229,770
21605,167597,DCD137352B900F9F43521E37884B7F13,30661,9,11,2,109.37028,18.24361,1008
21606,167598,DCD137352B900F9F43521E37884B7F13,60054,12,23,11,109.3016,18.31229,770
21614,167673,362A5B9B34971851814BD592D30A5666,39191,0,2,2,109.51493,18.23472,1557
21615,167674,362A5B9B34971851814BD592D30A5666,38891,2,5,3,109.51486,18.24118,1558
21616,167675,362A5B9B34971851814BD592D30A5666,39191,5,8,3,109.51493,18.23472,1557
21617,167676,362A5B9B34971851814BD592D30A5666,31561,13,15,2,109.56792,18.28479,1765
21618,167677,362A5B9B34971851814BD592D30A5666,38891,20,23,3,109.51486,18.24118,1558
21619,167680,28413CB0160B68347E92144BE214EF48,31411,18,19,1,109.5016,18.23576,1507
21620,167681,28413CB0160B68347E92144BE214EF48,60084,21,23,2,109.4984,18.2334,1507
21621,167684,410DD8A32244BC0C8E0A44B87218A19E,30181,18,21,3,109.51597,18.23313,1557
21622,167685,410DD8A32244BC0C8E0A44B87218A19E,30854,21,23,2,109.56889,18.27076,1763
21626,167741,8920C93432771D8645B969281AC5EB63,60614,13,17,4,109.48799,18.29521,1467
21630,167817,065F1687C35F3C827A2EA4A378A0E2C6,39371,12,13,1,109.56627,18.2646,1762
21631,167818,065F1687C35F3C827A2EA4A378A0E2C6,30851,14,21,7,109.5616,18.27396,1713
21632,167845,13166628932DF36C0AD7B1DB5811240A,60631,12,13,1,109.57778,18.27583,1814
21633,167846,13166628932DF36C0AD7B1DB5811240A,30854,15,17,2,109.56889,18.27076,1763
21634,167847,13166628932DF36C0AD7B1DB5811240A,60591,19,23,4,109.61118,18.21715,1904
21635,167868,9837FB962D7F62E426A73EBD66CBBE03,30711,12,14,2,109.50271,18.25347,1510
21636,167869,9837FB962D7F62E426A73EBD66CBBE03,30711,15,17,2,109.50271,18.25347,1510
21637,167894,15A2A8790389D1537721C21B141A7A31,61011,1,9,8,109.60653,18.19076,1900
21638,167896,15A2A8790389D1537721C21B141A7A31,61011,13,16,3,109.60653,18.19076,1900
21639,167945,B47CB2A2315F987CAA4AD3E9353D33AE,38251,14,15,1,109.49618,18.25493,1510
21640,167946,B47CB2A2315F987CAA4AD3E9353D33AE,31231,16,17,1,109.42597,18.29292,1217
21641,167947,B47CB2A2315F987CAA4AD3E9353D33AE,60524,19,20,1,109.42951,18.28993,1216
21642,167948,B47CB2A2315F987CAA4AD3E9353D33AE,31031,20,22,2,109.49979,18.25382,1510
21643,167956,D0016644D08E46EAD736BEE805BD7ECD,30421,18,20,2,109.50021,18.25861,1511
21644,167957,D0016644D08E46EAD736BEE805BD7ECD,31864,21,23,2,109.49014,18.28333,1465
21645,167958,7AF4921BC4D1712A961904D0ECC91550,30071,16,18,2,109.52819,18.30472,1619
21646,167959,7AF4921BC4D1712A961904D0ECC91550,38251,20,21,1,109.49618,18.25493,1510
21651,167969,76DC937B0560E4BA6ECE26A57F4E541A,60491,0,20,20,109.43354,18.30847,1269
21652,167970,76DC937B0560E4BA6ECE26A57F4E541A,38951,21,23,2,109.48097,18.28868,1416
21653,167971,1026894DC5FF9A7FAF3A2EE28B95E239,30854,0,11,11,109.56889,18.27076,1763
21654,167972,1026894DC5FF9A7FAF3A2EE28B95E239,30232,14,16,2,109.6191,18.31701,1971
21655,167973,1026894DC5FF9A7FAF3A2EE28B95E239,30854,18,23,5,109.56889,18.27076,1763
21675,168100,872709FDC860D320EC74676CCC63D436,39154,0,10,10,109.50201,18.25681,1511
21676,168102,294D9A63045D1EB69E8575E3D91BD865,31421,18,19,1,109.55382,18.22347,1705
21677,168103,294D9A63045D1EB69E8575E3D91BD865,39321,21,23,2,109.529,18.2167,1604
21681,168107,E2847DA629B89621A8D8F84E79614739,38903,0,4,4,109.39229,18.29243,1117
21682,168133,AAD294F97E8F953422B544ED61B36D13,30851,16,17,1,109.5616,18.27396,1713
21683,168134,AAD294F97E8F953422B544ED61B36D13,31071,18,22,4,109.58257,18.28458,1815
21684,168152,CB0DCEB8E5573AF0622B1E4D0B156499,38052,0,9,9,109.62618,18.23042,1956
21685,168153,CB0DCEB8E5573AF0622B1E4D0B156499,38052,12,13,1,109.62618,18.23042,1956
21686,168154,CB0DCEB8E5573AF0622B1E4D0B156499,38754,14,17,3,109.74667,18.37382,2430
21687,168155,CB0DCEB8E5573AF0622B1E4D0B156499,38052,19,23,4,109.62618,18.23042,1956
21688,168156,EFFEF00C078D502D6D0D1D469ACBA466,31231,12,14,2,109.42597,18.29292,1217
21689,168157,EFFEF00C078D502D6D0D1D469ACBA466,31471,16,17,1,109.34583,18.29563,917
21690,168158,EFFEF00C078D502D6D0D1D469ACBA466,39154,19,23,4,109.50201,18.25681,1511
21691,168200,DF49F834C08C7E8FA6D78272EE1FB651,60361,0,6,6,109.51938,18.29681,1567
21692,168201,DF49F834C08C7E8FA6D78272EE1FB651,30951,9,17,8,109.56208,18.25667,1761
21693,168202,DF49F834C08C7E8FA6D78272EE1FB651,60361,18,23,5,109.51938,18.29681,1567
21697,168243,B800F38F59ABC7037D5C269643629D72,30084,11,13,2,109.50118,18.26972,1513
21698,168246,147470AD3D3B8724582C30D5F244A8B6,60421,0,7,7,109.46333,18.31743,1371
21699,168247,147470AD3D3B8724582C30D5F244A8B6,30111,7,8,1,109.47583,18.30542,1419
21700,168248,147470AD3D3B8724582C30D5F244A8B6,60421,8,16,8,109.46333,18.31743,1371
21701,168249,147470AD3D3B8724582C30D5F244A8B6,30111,16,18,2,109.47583,18.30542,1419
21702,168250,147470AD3D3B8724582C30D5F244A8B6,60421,19,22,3,109.46333,18.31743,1371
21703,168254,BD4652414D5C17466BA36FD4BD943A94,31931,12,14,2,109.54771,18.29403,1667
21704,168255,BD4652414D5C17466BA36FD4BD943A94,39183,16,17,1,109.55542,18.28208,1715
21705,168256,BD4652414D5C17466BA36FD4BD943A94,30321,20,21,1,109.49563,18.29611,1467
21706,168257,BD4652414D5C17466BA36FD4BD943A94,60221,22,23,1,109.52569,18.29188,1616
21707,168335,83930DA23863D53A36D25B51299F2054,61011,5,8,3,109.60653,18.19076,1900
21708,168337,83930DA23863D53A36D25B51299F2054,61011,19,23,4,109.60653,18.19076,1900
21709,168340,267F571F2E3CF014CFEEB29B9E88DA7A,30721,0,6,6,109.51597,18.28257,1565
21710,168341,267F571F2E3CF014CFEEB29B9E88DA7A,39154,8,9,1,109.50201,18.25681,1511
21711,168342,267F571F2E3CF014CFEEB29B9E88DA7A,31251,14,15,1,109.18528,18.2975,317
21712,168343,267F571F2E3CF014CFEEB29B9E88DA7A,30721,20,23,3,109.51597,18.28257,1565
21713,168377,1582BEC240072EC51899932D6A0A257A,30232,3,4,1,109.6191,18.31701,1971
21714,168378,1582BEC240072EC51899932D6A0A257A,30891,4,19,15,109.59431,18.28389,1865
21715,168379,1582BEC240072EC51899932D6A0A257A,31561,22,23,1,109.56792,18.28479,1765
21716,168388,0E1DB444F47235AEDAD0A0404A7B75B4,39183,15,17,2,109.55542,18.28208,1715
21717,168389,0E1DB444F47235AEDAD0A0404A7B75B4,38071,21,22,1,109.40722,18.30938,1169
21721,168438,D758DCB0CB2E5EA2CADCED24F521A533,31071,0,19,19,109.58257,18.28458,1815
21722,168439,D758DCB0CB2E5EA2CADCED24F521A533,30741,21,22,1,109.49833,18.28681,1516
21723,168452,EBF906C5498076BCFA3E97DF6001B4F3,60631,1,8,7,109.57778,18.27583,1814
21724,168453,EBF906C5498076BCFA3E97DF6001B4F3,30854,12,21,9,109.56889,18.27076,1763
21729,168499,B2420C24A59D2C27A09046B2EE9F5AF9,30854,0,8,8,109.56889,18.27076,1763
21730,168500,B2420C24A59D2C27A09046B2EE9F5AF9,31071,8,10,2,109.58257,18.28458,1815
21731,168501,B2420C24A59D2C27A09046B2EE9F5AF9,30854,10,15,5,109.56889,18.27076,1763
21732,168502,B2420C24A59D2C27A09046B2EE9F5AF9,31071,15,17,2,109.58257,18.28458,1815
21733,168503,B2420C24A59D2C27A09046B2EE9F5AF9,30854,18,23,5,109.56889,18.27076,1763
21741,168543,5A944CB174BBBA51B8B9B04F6940A655,39061,14,16,2,109.38222,18.28958,1066
21742,168544,5A944CB174BBBA51B8B9B04F6940A655,30821,18,19,1,109.43681,18.33639,1274
21743,168545,5A944CB174BBBA51B8B9B04F6940A655,60084,21,23,2,109.4984,18.2334,1507
21747,168585,06FCF67485A2B44C8ABC96FDB92547C5,61011,0,12,12,109.60653,18.19076,1900
21748,168591,F57902A58026464B5BDED6D5CB0C8C35,31041,13,14,1,109.50278,18.23701,1507
21749,168592,F57902A58026464B5BDED6D5CB0C8C35,30081,14,18,4,109.50243,18.26632,1512
21750,168593,F57902A58026464B5BDED6D5CB0C8C35,30721,18,20,2,109.51597,18.28257,1565
21751,168594,F57902A58026464B5BDED6D5CB0C8C35,30201,20,22,2,109.4909,18.26465,1462
21755,168610,1EC233846FD142FF96E668743DBF5A72,60161,0,2,2,109.49174,18.26181,1461
21756,168611,1EC233846FD142FF96E668743DBF5A72,31231,6,7,1,109.42597,18.29292,1217
21757,168612,1EC233846FD142FF96E668743DBF5A72,30211,10,13,3,109.49882,18.23931,1508
21758,168613,1EC233846FD142FF96E668743DBF5A72,31471,16,17,1,109.34583,18.29563,917
21759,168614,1EC233846FD142FF96E668743DBF5A72,31571,20,22,2,109.61563,18.23326,1957
21760,168620,6DA2EC279010D0E9F544FC8AE2AE810A,39331,0,5,5,109.62125,18.22708,1956
21761,168621,6DA2EC279010D0E9F544FC8AE2AE810A,31571,6,10,4,109.61563,18.23326,1957
21762,168622,6DA2EC279010D0E9F544FC8AE2AE810A,33051,11,13,2,109.6475,18.46618,2096
21763,168623,6DA2EC279010D0E9F544FC8AE2AE810A,33481,15,17,2,109.67278,18.41278,2187
21764,168624,6DA2EC279010D0E9F544FC8AE2AE810A,31571,18,23,5,109.61563,18.23326,1957
21773,168673,8D8AA41210FC9E2D5DD4D81CF4DB18D7,60371,1,11,10,109.53063,18.30056,1618
21774,168674,8D8AA41210FC9E2D5DD4D81CF4DB18D7,30391,13,15,2,109.4975,18.27118,1513
21775,168675,8D8AA41210FC9E2D5DD4D81CF4DB18D7,30711,18,19,1,109.50271,18.25347,1510
21776,168693,BD1C8CAB0CA377D9350002A865081450,31021,17,18,1,109.49021,18.27,1463
21777,168694,BD1C8CAB0CA377D9350002A865081450,30251,20,23,3,109.50611,18.26653,1512
21778,168702,5E97A4561E11AAC4FBC53FD068EAA52B,30854,0,6,6,109.56889,18.27076,1763
21779,168703,5E97A4561E11AAC4FBC53FD068EAA52B,30531,8,18,10,109.53271,18.21472,1604
21780,168704,5E97A4561E11AAC4FBC53FD068EAA52B,30854,22,23,1,109.56889,18.27076,1763
21788,168870,E960A9C960574B6ECAA9E8161ED40783,30181,0,1,1,109.51597,18.23313,1557
21789,168871,E960A9C960574B6ECAA9E8161ED40783,39111,2,4,2,109.5191,18.22597,1555
21790,168872,E960A9C960574B6ECAA9E8161ED40783,30181,5,8,3,109.51597,18.23313,1557
21791,168873,E960A9C960574B6ECAA9E8161ED40783,30661,11,16,5,109.37028,18.24361,1008
21792,168874,E960A9C960574B6ECAA9E8161ED40783,30861,20,23,3,109.52722,18.22743,1606
21796,168940,B2C1D7D797194AB8141D50C733D584D6,30271,1,5,4,109.49132,18.23153,1456
21797,168941,B2C1D7D797194AB8141D50C733D584D6,30711,6,8,2,109.50271,18.25347,1510
21798,168942,B2C1D7D797194AB8141D50C733D584D6,30441,12,13,1,109.64021,18.25424,2010
21799,168953,4995463B780282C9C030A19D9F49AEAC,31071,0,7,7,109.58257,18.28458,1815
21800,168954,4995463B780282C9C030A19D9F49AEAC,30854,7,9,2,109.56889,18.27076,1763
21801,168955,4995463B780282C9C030A19D9F49AEAC,31071,9,11,2,109.58257,18.28458,1815
21802,168956,4995463B780282C9C030A19D9F49AEAC,30854,11,15,4,109.56889,18.27076,1763
21803,168957,4995463B780282C9C030A19D9F49AEAC,31071,16,18,2,109.58257,18.28458,1815
21804,168958,4995463B780282C9C030A19D9F49AEAC,30854,22,23,1,109.56889,18.27076,1763
21808,169064,9DF600F9262EC0A308B6F0B7D23C17B4,31071,18,20,2,109.58257,18.28458,1815
21809,169065,9DF600F9262EC0A308B6F0B7D23C17B4,30854,20,23,3,109.56889,18.27076,1763
21810,169070,6DD2992D9A732B2B8C9D2BEBFF495B9E,30854,12,17,5,109.56889,18.27076,1763
21811,169071,6DD2992D9A732B2B8C9D2BEBFF495B9E,31561,19,23,4,109.56792,18.28479,1765
21812,169082,92C902C260BAB0E059978AFA43029807,30211,0,7,7,109.49882,18.23931,1508
21813,169083,92C902C260BAB0E059978AFA43029807,31391,8,9,1,109.50382,18.24285,1508
21814,169084,92C902C260BAB0E059978AFA43029807,31781,12,13,1,109.19847,18.2975,367
21815,169085,92C902C260BAB0E059978AFA43029807,30361,17,20,3,109.50347,18.24,1508
21816,169086,92C902C260BAB0E059978AFA43029807,30271,20,22,2,109.49132,18.23153,1456
21817,169094,B340EDEF4A878E8DF5CBEC25E465EACE,30854,0,1,1,109.56889,18.27076,1763
21818,169095,B340EDEF4A878E8DF5CBEC25E465EACE,31071,1,2,1,109.58257,18.28458,1815
21819,169096,B340EDEF4A878E8DF5CBEC25E465EACE,30854,4,6,2,109.56889,18.27076,1763
21820,169097,B340EDEF4A878E8DF5CBEC25E465EACE,60631,9,10,1,109.57778,18.27583,1814
21821,169098,B340EDEF4A878E8DF5CBEC25E465EACE,30854,14,17,3,109.56889,18.27076,1763
21822,169099,B340EDEF4A878E8DF5CBEC25E465EACE,38127,19,20,1,109.50833,18.27222,1513
21823,169100,B340EDEF4A878E8DF5CBEC25E465EACE,31206,21,23,2,109.50819,18.23549,1507
21828,169179,8C5A16299A6D294198C90C34C25C5949,39183,12,15,3,109.55542,18.28208,1715
21829,169180,8C5A16299A6D294198C90C34C25C5949,31561,16,23,7,109.56792,18.28479,1765
21833,169243,D1EBD1A5A8A922DEF994C933F10DD8DB,60381,0,6,6,109.5241,18.22458,1605
21834,169244,D1EBD1A5A8A922DEF994C933F10DD8DB,31021,7,8,1,109.49021,18.27,1463
21835,169245,D1EBD1A5A8A922DEF994C933F10DD8DB,60381,9,12,3,109.5241,18.22458,1605
21836,169246,D1EBD1A5A8A922DEF994C933F10DD8DB,30161,13,23,10,109.50042,18.24389,1508
21837,169247,AB23564C2A438938AB9FCEB6A1EF8561,30121,0,7,7,109.52861,18.27222,1613
21838,169248,AB23564C2A438938AB9FCEB6A1EF8561,31061,8,9,1,109.53333,18.23257,1607
21839,169249,AB23564C2A438938AB9FCEB6A1EF8561,60381,11,13,2,109.5241,18.22458,1605
21840,169250,AB23564C2A438938AB9FCEB6A1EF8561,30121,14,15,1,109.52861,18.27222,1613
21841,169251,AB23564C2A438938AB9FCEB6A1EF8561,30861,15,17,2,109.52722,18.22743,1606
21842,169252,AB23564C2A438938AB9FCEB6A1EF8561,30121,21,23,2,109.52861,18.27222,1613
21843,169330,44F505B3929E26B4B29F00CC284F3084,60631,0,6,6,109.57778,18.27583,1814
21844,169331,44F505B3929E26B4B29F00CC284F3084,30681,9,10,1,109.48493,18.26917,1463
21845,169332,44F505B3929E26B4B29F00CC284F3084,30854,12,14,2,109.56889,18.27076,1763
21846,169333,44F505B3929E26B4B29F00CC284F3084,60381,16,18,2,109.5241,18.22458,1605
21847,169337,770A00BDAFE9BCA8C9E9FA68066EED7D,31561,14,16,2,109.56792,18.28479,1765
21848,169338,770A00BDAFE9BCA8C9E9FA68066EED7D,31071,20,23,3,109.58257,18.28458,1815
21849,169339,2218DE2B527AD8BF235B73A4AAB31E7E,31031,10,14,4,109.49979,18.25382,1510
21850,169340,2218DE2B527AD8BF235B73A4AAB31E7E,60161,14,16,2,109.49174,18.26181,1461
21851,169341,2218DE2B527AD8BF235B73A4AAB31E7E,30201,19,20,1,109.4909,18.26465,1462
21852,169342,2218DE2B527AD8BF235B73A4AAB31E7E,60161,20,23,3,109.49174,18.26181,1461
21856,169354,369F61D9EC42E510E242E24266B2C23F,31931,0,18,18,109.54771,18.29403,1667
21857,169355,369F61D9EC42E510E242E24266B2C23F,30921,19,23,4,109.53903,18.29451,1667
21864,169421,F02E76D8008BA6DC4D6244598B7BBC70,60311,17,19,2,109.52097,18.24319,1558
21865,169422,F02E76D8008BA6DC4D6244598B7BBC70,31071,22,23,1,109.58257,18.28458,1815
21866,169474,9FEA4B85EAE4FAEE1CAF0EABFF2FAEA1,31561,0,12,12,109.56792,18.28479,1765
21867,169475,9FEA4B85EAE4FAEE1CAF0EABFF2FAEA1,39183,14,15,1,109.55542,18.28208,1715
21868,169476,7763FA5342AFBCA436FF4D695F9B9CB2,30711,0,7,7,109.50271,18.25347,1510
21869,169477,7763FA5342AFBCA436FF4D695F9B9CB2,60291,7,8,1,109.50826,18.24639,1509
21870,169478,7763FA5342AFBCA436FF4D695F9B9CB2,60211,13,15,2,109.63549,18.26049,2011
21871,169479,7763FA5342AFBCA436FF4D695F9B9CB2,30711,18,23,5,109.50271,18.25347,1510
21875,169515,C01D7F4C525517694A04D5EAA5AD2420,31931,14,17,3,109.54771,18.29403,1667
21876,169516,C01D7F4C525517694A04D5EAA5AD2420,31945,18,19,1,109.58021,18.29403,1817
21877,169517,C01D7F4C525517694A04D5EAA5AD2420,31071,21,23,2,109.58257,18.28458,1815
21878,169540,A27FD6E116842BE4E0FAFD34416290B6,30771,20,21,1,109.49938,18.26042,1511
21879,169541,A27FD6E116842BE4E0FAFD34416290B6,31271,22,23,1,109.48958,18.26257,1462
21880,169551,317A2326A5D15E475076F1921264E5AD,38117,0,8,8,109.51611,18.22354,1555
21881,169552,317A2326A5D15E475076F1921264E5AD,39321,8,10,2,109.529,18.2167,1604
21882,169553,317A2326A5D15E475076F1921264E5AD,31521,10,11,1,109.51458,18.22542,1555
21883,169554,317A2326A5D15E475076F1921264E5AD,39321,13,15,2,109.529,18.2167,1604
21884,169555,317A2326A5D15E475076F1921264E5AD,30731,16,17,1,109.50944,18.22306,1555
21885,169556,317A2326A5D15E475076F1921264E5AD,31521,21,23,2,109.51458,18.22542,1555
21886,169561,B0034CBA41049BC4020FA7373D060140,31071,1,4,3,109.58257,18.28458,1815
21887,169562,B0034CBA41049BC4020FA7373D060140,30854,5,13,8,109.56889,18.27076,1763
21888,169587,7BB21D6130AE75AA410ED280998BF572,31236,0,8,8,109.42965,18.29111,1216
21889,169588,7BB21D6130AE75AA410ED280998BF572,31145,9,10,1,109.20431,18.30479,369
21890,169589,7BB21D6130AE75AA410ED280998BF572,30771,15,16,1,109.49938,18.26042,1511
21891,169590,7BB21D6130AE75AA410ED280998BF572,60221,18,21,3,109.52569,18.29188,1616
21892,169591,7BB21D6130AE75AA410ED280998BF572,30771,21,23,2,109.49938,18.26042,1511
21897,169596,99DAF94CE6124D8A914C4452ADC2394D,30671,1,9,8,109.43611,18.30139,1268
21898,169597,99DAF94CE6124D8A914C4452ADC2394D,38251,10,11,1,109.49618,18.25493,1510
21899,169598,99DAF94CE6124D8A914C4452ADC2394D,60131,12,13,1,109.49819,18.24778,1509
21914,169760,B40C23F05DF669D1A7928A9352D650F2,30161,1,8,7,109.50042,18.24389,1508
21915,169761,B40C23F05DF669D1A7928A9352D650F2,31181,12,13,1,109.50382,18.24813,1509
21916,169805,2EB843F78CEA3889458F6783F8AADAE0,30854,1,2,1,109.56889,18.27076,1763
21917,169806,2EB843F78CEA3889458F6783F8AADAE0,31071,2,3,1,109.58257,18.28458,1815
21918,169807,2EB843F78CEA3889458F6783F8AADAE0,30854,3,5,2,109.56889,18.27076,1763
21919,169808,2EB843F78CEA3889458F6783F8AADAE0,31071,19,20,1,109.58257,18.28458,1815
21920,169809,2EB843F78CEA3889458F6783F8AADAE0,30854,22,23,1,109.56889,18.27076,1763
21921,169813,F9610B40FA7FDAD4A84DD7EF570B95F9,31841,0,8,8,109.73201,18.33382,2373
21922,169814,F9610B40FA7FDAD4A84DD7EF570B95F9,60211,12,13,1,109.63549,18.26049,2011
21923,169815,F9610B40FA7FDAD4A84DD7EF570B95F9,60231,14,16,2,109.49903,18.21972,1504
21924,169816,F9610B40FA7FDAD4A84DD7EF570B95F9,31841,20,23,3,109.73201,18.33382,2373
21925,169832,4118232D9131A3783CE684A84D794F5E,30854,0,15,15,109.56889,18.27076,1763
21926,169833,4118232D9131A3783CE684A84D794F5E,31561,18,19,1,109.56792,18.28479,1765
21927,169834,DF5BF21EA71E8781CC37C7BE0B10CC24,30661,12,14,2,109.37028,18.24361,1008
21928,169835,DF5BF21EA71E8781CC37C7BE0B10CC24,30581,16,17,1,109.62257,18.24951,1959
21929,169836,4020F45A25B90FB7F045FA0843BE28FF,30241,8,9,1,109.26174,18.3275,622
21930,169837,4020F45A25B90FB7F045FA0843BE28FF,30651,12,13,1,109.42611,18.385,1232
21931,169838,4020F45A25B90FB7F045FA0843BE28FF,30821,15,16,1,109.43681,18.33639,1274
21932,169839,4020F45A25B90FB7F045FA0843BE28FF,30651,20,22,2,109.42611,18.385,1232
21933,169864,A65416E0023DB5B05C85EFD796D8188E,31441,0,7,7,109.51181,18.24424,1559
21934,169865,A65416E0023DB5B05C85EFD796D8188E,30661,11,12,1,109.37028,18.24361,1008
21935,169866,A65416E0023DB5B05C85EFD796D8188E,31261,15,20,5,109.51174,18.2466,1559
21939,169947,79B3E6103791BA4C5123FE39F25946F0,30081,0,5,5,109.50243,18.26632,1512
21940,169948,79B3E6103791BA4C5123FE39F25946F0,30661,6,10,4,109.37028,18.24361,1008
21941,169949,79B3E6103791BA4C5123FE39F25946F0,60411,10,14,4,109.32514,18.30854,869
21945,169957,CCBF1BE99DA9F84ADB162A21804AB04F,39183,14,15,1,109.55542,18.28208,1715
21946,169958,CCBF1BE99DA9F84ADB162A21804AB04F,31561,15,16,1,109.56792,18.28479,1765
21947,169959,CCBF1BE99DA9F84ADB162A21804AB04F,60361,19,22,3,109.51938,18.29681,1567
21948,169962,03B0ABE70E1304E959E1A0EDA3550F7F,60661,0,6,6,109.548,18.2377,1657
21949,169963,03B0ABE70E1304E959E1A0EDA3550F7F,31091,8,10,2,109.41201,18.31222,1170
21950,169964,03B0ABE70E1304E959E1A0EDA3550F7F,30661,13,14,1,109.37028,18.24361,1008
21951,169965,03B0ABE70E1304E959E1A0EDA3550F7F,31421,16,17,1,109.55382,18.22347,1705
21952,169966,03B0ABE70E1304E959E1A0EDA3550F7F,60661,21,22,1,109.548,18.2377,1657
21953,170012,E4A6ADA106DC95FCBCCB308A3007E3C3,31471,15,17,2,109.34583,18.29563,917
21954,170013,E4A6ADA106DC95FCBCCB308A3007E3C3,60281,19,21,2,109.51743,18.25924,1561
21955,170014,E4A6ADA106DC95FCBCCB308A3007E3C3,30711,21,23,2,109.50271,18.25347,1510
21956,170018,0467E7A2F341B63F33E9945177D53E54,31521,1,7,6,109.51458,18.22542,1555
21957,170019,0467E7A2F341B63F33E9945177D53E54,31521,7,9,2,109.51458,18.22542,1555
21958,170020,0467E7A2F341B63F33E9945177D53E54,31781,10,12,2,109.19847,18.2975,367
21959,170021,0467E7A2F341B63F33E9945177D53E54,31521,13,16,3,109.51458,18.22542,1555
21960,170022,0467E7A2F341B63F33E9945177D53E54,60221,16,18,2,109.52569,18.29188,1616
21961,170023,0467E7A2F341B63F33E9945177D53E54,31521,19,23,4,109.51458,18.22542,1555
21965,170122,BE586ACB441383CC10D7CF3923850B73,39181,14,18,4,109.55153,18.28035,1715
21966,170123,BE586ACB441383CC10D7CF3923850B73,31931,19,23,4,109.54771,18.29403,1667
21967,170154,D8E932F61067935AEFB49165DCDE5286,31251,0,7,7,109.18528,18.2975,317
21968,170155,D8E932F61067935AEFB49165DCDE5286,31145,9,10,1,109.20431,18.30479,369
21969,170156,D8E932F61067935AEFB49165DCDE5286,31471,14,16,2,109.34583,18.29563,917
21970,170157,D8E932F61067935AEFB49165DCDE5286,60251,19,22,3,109.51229,18.325,1572
21971,170178,40D62DAB923B148A7A4FFB3BCA6C7343,60501,1,7,6,109.48701,18.29021,1466
21972,170179,40D62DAB923B148A7A4FFB3BCA6C7343,38951,10,11,1,109.48097,18.28868,1416
21973,170180,40D62DAB923B148A7A4FFB3BCA6C7343,38153,15,17,2,109.51819,18.25736,1561
21974,170181,40D62DAB923B148A7A4FFB3BCA6C7343,38951,18,20,2,109.48097,18.28868,1416
21975,170182,40D62DAB923B148A7A4FFB3BCA6C7343,30201,21,22,1,109.4909,18.26465,1462
21976,170201,2AB980E3003284F0269A1377C53CC1EB,30581,16,17,1,109.62257,18.24951,1959
21977,170202,2AB980E3003284F0269A1377C53CC1EB,38325,21,23,2,109.39792,18.2909,1116
21978,170210,FF90B6855593CFEA9A07FE008E94551D,31931,15,16,1,109.54771,18.29403,1667
21979,170211,FF90B6855593CFEA9A07FE008E94551D,30071,21,22,1,109.52819,18.30472,1619
21980,170220,8C0E6B51FAFE21C31FB9AE08C36DF0A2,30921,1,16,15,109.53903,18.29451,1667
21981,170221,8C0E6B51FAFE21C31FB9AE08C36DF0A2,60241,19,22,3,109.53319,18.28667,1616
21982,170228,28A89A8FEC174286EFBBD2F96B7BCF44,60281,1,2,1,109.51743,18.25924,1561
21983,170229,28A89A8FEC174286EFBBD2F96B7BCF44,38291,2,4,2,109.51618,18.24313,1558
21984,170230,28A89A8FEC174286EFBBD2F96B7BCF44,60281,5,7,2,109.51743,18.25924,1561
21985,170231,28A89A8FEC174286EFBBD2F96B7BCF44,30181,10,12,2,109.51597,18.23313,1557
21986,170232,28A89A8FEC174286EFBBD2F96B7BCF44,30171,13,14,1,109.48458,18.27139,1463
21987,170247,D947D8D9432E18EA6A214259B6E2987E,60411,0,14,14,109.32514,18.30854,869
21988,170248,D947D8D9432E18EA6A214259B6E2987E,30661,14,18,4,109.37028,18.24361,1008
21989,170249,D947D8D9432E18EA6A214259B6E2987E,60054,20,23,3,109.3016,18.31229,770
21997,170284,AA17C9279A63248D7DCDF49F93EB8817,38275,10,18,8,109.62875,18.22938,2006
21998,170285,AA17C9279A63248D7DCDF49F93EB8817,30854,22,23,1,109.56889,18.27076,1763
21999,170300,ECE5F9061BD873B365108DCE1A2E8E9E,31321,13,15,2,109.63799,18.23201,2007
22000,170301,ECE5F9061BD873B365108DCE1A2E8E9E,38271,17,22,5,109.62632,18.23049,1956
22001,170310,D73D0E1690714CD7F442C709F67E4771,60361,0,7,7,109.51938,18.29681,1567
22002,170311,D73D0E1690714CD7F442C709F67E4771,30951,8,11,3,109.56208,18.25667,1761
22003,170312,D73D0E1690714CD7F442C709F67E4771,30851,12,14,2,109.5616,18.27396,1713
22004,170313,D73D0E1690714CD7F442C709F67E4771,60361,19,23,4,109.51938,18.29681,1567
22005,170323,B16225DD3371073720184BB0D089E6D6,31561,2,6,4,109.56792,18.28479,1765
22006,170324,B16225DD3371073720184BB0D089E6D6,30854,7,16,9,109.56889,18.27076,1763
22011,170348,F84D949DDCBF25D5530F771BC55E0B9D,61011,5,23,18,109.60653,18.19076,1900
22012,170367,07169E7114E4F14C073261BAAC0D4491,61011,1,7,6,109.60653,18.19076,1900
22013,170369,07169E7114E4F14C073261BAAC0D4491,61011,18,23,5,109.60653,18.19076,1900
22014,170401,DDA0EB7263815D997F150C58431C5F5D,30351,0,8,8,109.41701,18.29292,1217
22015,170402,DDA0EB7263815D997F150C58431C5F5D,31471,10,12,2,109.34583,18.29563,917
22016,170403,DDA0EB7263815D997F150C58431C5F5D,31781,14,15,1,109.19847,18.2975,367
22017,170404,DDA0EB7263815D997F150C58431C5F5D,60281,19,20,1,109.51743,18.25924,1561
22018,170405,DDA0EB7263815D997F150C58431C5F5D,30351,22,23,1,109.41701,18.29292,1217
22019,170409,8F41B5A5D3BA7B315EA1C41B064BC5DA,60524,0,6,6,109.42951,18.28993,1216
22020,170410,8F41B5A5D3BA7B315EA1C41B064BC5DA,60552,6,7,1,109.41729,18.30014,1218
22021,170411,8F41B5A5D3BA7B315EA1C41B064BC5DA,31781,12,13,1,109.19847,18.2975,367
22022,170412,8F41B5A5D3BA7B315EA1C41B064BC5DA,31471,15,16,1,109.34583,18.29563,917
22023,170413,8F41B5A5D3BA7B315EA1C41B064BC5DA,38071,20,23,3,109.40722,18.30938,1169
22024,170447,8941A851436D0D911B70B8FD5F8E2C31,31161,15,23,8,109.70229,18.31361,2270
22025,170448,9C1407835BC54BEBDB541F52E1DA1820,61011,0,9,9,109.60653,18.19076,1900
22026,170500,52C15F07544D9CC60D46BD6BA2551891,31071,10,11,1,109.58257,18.28458,1815
22027,170501,52C15F07544D9CC60D46BD6BA2551891,60631,13,19,6,109.57778,18.27583,1814
22028,170502,52C15F07544D9CC60D46BD6BA2551891,30854,19,22,3,109.56889,18.27076,1763
22029,170503,52C15F07544D9CC60D46BD6BA2551891,60631,22,23,1,109.57778,18.27583,1814
22030,170533,1D815BFAE7906FCEB1C73FB23323FFF3,31345,0,10,10,109.39,18.29,1066
22031,170534,1D815BFAE7906FCEB1C73FB23323FFF3,31143,11,13,2,109.19986,18.29875,368
22032,170535,1D815BFAE7906FCEB1C73FB23323FFF3,31345,14,17,3,109.39,18.29,1066
22033,170536,1D815BFAE7906FCEB1C73FB23323FFF3,30201,17,19,2,109.4909,18.26465,1462
22034,170537,1D815BFAE7906FCEB1C73FB23323FFF3,31261,20,22,2,109.51174,18.2466,1559
22035,170538,1D815BFAE7906FCEB1C73FB23323FFF3,38291,22,23,1,109.51618,18.24313,1558
22036,170559,C23F82F14EE8213E43F931E428019A69,30321,21,23,2,109.49563,18.29611,1467
22045,170627,CCCD2290FB632A48009771412BE68ADD,31561,0,13,13,109.56792,18.28479,1765
22046,170628,CCCD2290FB632A48009771412BE68ADD,39183,15,16,1,109.55542,18.28208,1715
22050,170659,DC29C676832347947F366933ECB88090,31561,0,1,1,109.56792,18.28479,1765
22051,170660,DC29C676832347947F366933ECB88090,30854,2,4,2,109.56889,18.27076,1763
22052,170661,DC29C676832347947F366933ECB88090,31561,4,6,2,109.56792,18.28479,1765
22053,170662,DC29C676832347947F366933ECB88090,39183,10,11,1,109.55542,18.28208,1715
22054,170663,DC29C676832347947F366933ECB88090,31561,12,15,3,109.56792,18.28479,1765
22055,170664,DC29C676832347947F366933ECB88090,39183,15,17,2,109.55542,18.28208,1715
22056,170676,99CBAA6A65A50998F0A10B72B36210E4,60084,6,11,5,109.4984,18.2334,1507
22057,170677,99CBAA6A65A50998F0A10B72B36210E4,60201,12,13,1,109.5041,18.2509,1510
22058,170678,99CBAA6A65A50998F0A10B72B36210E4,60084,14,19,5,109.4984,18.2334,1507
22059,170679,99CBAA6A65A50998F0A10B72B36210E4,30271,21,22,1,109.49132,18.23153,1456
22060,170725,37D38EF0062E64D55C94EB554B76F9EE,31945,0,8,8,109.58021,18.29403,1817
22061,170726,37D38EF0062E64D55C94EB554B76F9EE,30854,13,14,1,109.56889,18.27076,1763
22062,170727,37D38EF0062E64D55C94EB554B76F9EE,31164,18,20,2,109.69993,18.27215,2263
22063,170728,37D38EF0062E64D55C94EB554B76F9EE,30854,21,22,1,109.56889,18.27076,1763
22064,170739,3C5AEA306E8A69C707195C4150E77D90,39183,7,9,2,109.55542,18.28208,1715
22065,170740,3C5AEA306E8A69C707195C4150E77D90,31931,10,13,3,109.54771,18.29403,1667
22066,170741,3C5AEA306E8A69C707195C4150E77D90,39181,13,16,3,109.55153,18.28035,1715
22067,170755,E34FF61340C5B86CF9FD0AD454D26266,60331,0,8,8,109.505,18.26507,1512
22068,170756,E34FF61340C5B86CF9FD0AD454D26266,60281,8,9,1,109.51743,18.25924,1561
22069,170757,E34FF61340C5B86CF9FD0AD454D26266,38251,10,11,1,109.49618,18.25493,1510
22070,170758,E34FF61340C5B86CF9FD0AD454D26266,31521,15,17,2,109.51458,18.22542,1555
22071,170759,E34FF61340C5B86CF9FD0AD454D26266,30251,18,22,4,109.50611,18.26653,1512
22072,170769,EF24901D99384F703B20FE07F2784FA0,31631,9,11,2,109.59542,18.36826,1879
22073,170770,EF24901D99384F703B20FE07F2784FA0,30101,13,18,5,109.57299,18.33333,1773
22074,170771,EF24901D99384F703B20FE07F2784FA0,31631,20,22,2,109.59542,18.36826,1879
22075,170786,5E0DF04AE6922A733420CB1D87AC36E1,30511,17,18,1,109.51069,18.24208,1558
22076,170787,5E0DF04AE6922A733420CB1D87AC36E1,39091,18,20,2,109.50097,18.25222,1510
22080,170793,7784022BDEFABB0258B32ABBB5E13027,39154,0,6,6,109.50201,18.25681,1511
22081,170794,7784022BDEFABB0258B32ABBB5E13027,38157,7,10,3,109.51483,18.26958,1563
22082,170795,7784022BDEFABB0258B32ABBB5E13027,30711,12,15,3,109.50271,18.25347,1510
22083,170796,7784022BDEFABB0258B32ABBB5E13027,31491,17,18,1,109.73042,18.38771,2382
22084,170797,7784022BDEFABB0258B32ABBB5E13027,60121,19,21,2,109.74507,18.37472,2430
22085,170814,8D496C0E2DB1FF881021B05CE10C0242,31071,0,7,7,109.58257,18.28458,1815
22086,170815,8D496C0E2DB1FF881021B05CE10C0242,30854,7,8,1,109.56889,18.27076,1763
22087,170816,8D496C0E2DB1FF881021B05CE10C0242,31071,11,12,1,109.58257,18.28458,1815
22088,170817,8D496C0E2DB1FF881021B05CE10C0242,30854,16,17,1,109.56889,18.27076,1763
22089,170818,8D496C0E2DB1FF881021B05CE10C0242,31071,22,23,1,109.58257,18.28458,1815
22090,170845,1122041491C04B199A15F6E1E401D68F,30151,14,17,3,109.50986,18.25083,1560
22091,170846,1122041491C04B199A15F6E1E401D68F,30461,18,19,1,109.5116,18.26313,1562
22092,170847,1122041491C04B199A15F6E1E401D68F,31821,21,22,1,109.51181,18.24924,1559
22093,170869,76F6A54588C8DF7DDADFC50CAA11D44C,38085,0,8,8,109.6291,18.23625,2007
22094,170870,76F6A54588C8DF7DDADFC50CAA11D44C,31561,12,15,3,109.56792,18.28479,1765
22095,170871,76F6A54588C8DF7DDADFC50CAA11D44C,30854,17,23,6,109.56889,18.27076,1763
22107,170972,844EDA750B421C0DF1043A6AC4E51E70,60041,1,10,9,109.39889,18.31944,1121
22108,170973,844EDA750B421C0DF1043A6AC4E51E70,30651,14,22,8,109.42611,18.385,1232
22109,170993,1980C8D409DE9551539224B3D393CDAA,30071,3,9,6,109.52819,18.30472,1619
22110,170994,1980C8D409DE9551539224B3D393CDAA,30071,9,12,3,109.52819,18.30472,1619
22111,170995,1980C8D409DE9551539224B3D393CDAA,30071,12,14,2,109.52819,18.30472,1619
22112,170996,1980C8D409DE9551539224B3D393CDAA,31951,14,19,5,109.52174,18.30299,1568
22113,170997,1980C8D409DE9551539224B3D393CDAA,30071,20,23,3,109.52819,18.30472,1619
22117,171032,D9AE11CD16B231308C3F0FB3F53BC3E9,30854,0,6,6,109.56889,18.27076,1763
22118,171033,D9AE11CD16B231308C3F0FB3F53BC3E9,31071,8,17,9,109.58257,18.28458,1815
22132,171114,2A1AB09F11CECAAFA5576058E9461FEA,31431,0,1,1,109.44639,18.29042,1316
22133,171115,2A1AB09F11CECAAFA5576058E9461FEA,31231,3,5,2,109.42597,18.29292,1217
22134,171116,2A1AB09F11CECAAFA5576058E9461FEA,30661,6,7,1,109.37028,18.24361,1008
22135,171117,2A1AB09F11CECAAFA5576058E9461FEA,30111,8,10,2,109.47583,18.30542,1419
22136,171118,594298D66BAD5405EE1904C905FA9B12,31071,13,19,6,109.58257,18.28458,1815
22137,171119,594298D66BAD5405EE1904C905FA9B12,30711,21,22,1,109.50271,18.25347,1510
22141,171194,189633BA4D39EBA8A203BC9E364D4B1F,30051,12,14,2,109.48917,18.21215,1453
22142,171195,189633BA4D39EBA8A203BC9E364D4B1F,38291,19,23,4,109.51618,18.24313,1558
22151,171226,EF9F15FAFA5926C5B853D240732ABDEA,30661,17,19,2,109.37028,18.24361,1008
22152,171227,EF9F15FAFA5926C5B853D240732ABDEA,60201,20,22,2,109.5041,18.2509,1510
22153,171261,F1FA54BCDE7297F39D6C0507CA898D49,38361,0,17,17,109.43667,18.29201,1267
22154,171262,F1FA54BCDE7297F39D6C0507CA898D49,60551,17,19,2,109.42722,18.30111,1218
22155,171278,D4AA3869830031578B573FD0033C24A8,60371,5,9,4,109.53063,18.30056,1618
22156,171279,D4AA3869830031578B573FD0033C24A8,31931,13,23,10,109.54771,18.29403,1667
22160,171315,4639E7F597994307D62A7FF9CC65CC1D,31071,0,18,18,109.58257,18.28458,1815
22161,171316,4639E7F597994307D62A7FF9CC65CC1D,30854,18,19,1,109.56889,18.27076,1763
22162,171403,9AA959ED87D1ECC3053DED17290EFCBD,30851,1,2,1,109.5616,18.27396,1713
22163,171404,9AA959ED87D1ECC3053DED17290EFCBD,31561,3,4,1,109.56792,18.28479,1765
22164,171456,D96E01B8E0F0DE9C160C9FEAFDCFDB6D,31021,15,16,1,109.49021,18.27,1463
22165,171457,D96E01B8E0F0DE9C160C9FEAFDCFDB6D,31071,19,21,2,109.58257,18.28458,1815
22166,171458,D96E01B8E0F0DE9C160C9FEAFDCFDB6D,30854,22,23,1,109.56889,18.27076,1763
22173,171555,651A229E7C61DF6BD0C5C3DE95C555BD,30854,10,18,8,109.56889,18.27076,1763
22174,171556,651A229E7C61DF6BD0C5C3DE95C555BD,30711,21,22,1,109.50271,18.25347,1510
22175,171580,C09C0EAB86082A4D7E18052318E53A38,38291,0,8,8,109.51618,18.24313,1558
22176,171581,C09C0EAB86082A4D7E18052318E53A38,38017,10,14,4,109.49729,18.21424,1504
22177,171582,C09C0EAB86082A4D7E18052318E53A38,31471,14,16,2,109.34583,18.29563,917
22178,171583,C09C0EAB86082A4D7E18052318E53A38,38017,19,23,4,109.49729,18.21424,1504
22179,171589,7426A8B55792A8B93D9B7B93370F4B93,60524,0,7,7,109.42951,18.28993,1216
22180,171590,7426A8B55792A8B93D9B7B93370F4B93,30351,7,8,1,109.41701,18.29292,1217
22181,171591,7426A8B55792A8B93D9B7B93370F4B93,30581,9,10,1,109.62257,18.24951,1959
22182,171631,1730F16E414BB3DC3E44A9424DB9DBC0,38484,0,1,1,109.53028,18.31528,1620
22183,171632,1730F16E414BB3DC3E44A9424DB9DBC0,60371,1,5,4,109.53063,18.30056,1618
22184,171634,1730F16E414BB3DC3E44A9424DB9DBC0,60371,13,14,1,109.53063,18.30056,1618
22185,171635,1730F16E414BB3DC3E44A9424DB9DBC0,31391,15,16,1,109.50382,18.24285,1508
22186,171636,1730F16E414BB3DC3E44A9424DB9DBC0,60371,19,23,4,109.53063,18.30056,1618
22190,171687,C69D9D9A56587BE98796607AF04788C3,60551,19,20,1,109.42722,18.30111,1218
22191,171688,C69D9D9A56587BE98796607AF04788C3,30421,21,23,2,109.50021,18.25861,1511
22192,171718,E1B69B9C5AD47FF9C02A38B65955BC56,31945,0,11,11,109.58021,18.29403,1817
22193,171719,E1B69B9C5AD47FF9C02A38B65955BC56,30854,13,23,10,109.56889,18.27076,1763
22194,171749,FD5B9AB034F15F72E8BEF02193669238,30921,9,11,2,109.53903,18.29451,1667
22195,171750,FD5B9AB034F15F72E8BEF02193669238,60241,12,22,10,109.53319,18.28667,1616
22196,171769,04ABA8BFD5D63DDF1B83BA0577C9019C,30232,2,4,2,109.6191,18.31701,1971
22197,171770,04ABA8BFD5D63DDF1B83BA0577C9019C,31421,4,5,1,109.55382,18.22347,1705
22198,171774,8B67CA01C44A0A9FF0492771727FF584,60381,18,19,1,109.5241,18.22458,1605
22199,171775,8B67CA01C44A0A9FF0492771727FF584,38891,20,23,3,109.51486,18.24118,1558
22200,171808,5CFFF8D919E96524101209E188C669B3,31951,22,23,1,109.52174,18.30299,1568
22201,171819,08A066736557478B1013C0CF834491DF,31931,18,20,2,109.54771,18.29403,1667
22202,171820,08A066736557478B1013C0CF834491DF,30921,20,21,1,109.53903,18.29451,1667
22203,171839,8EC6BA9FA8E683D0E20F5950ED4FE9BA,30851,0,2,2,109.5616,18.27396,1713
22204,171840,8EC6BA9FA8E683D0E20F5950ED4FE9BA,30854,3,4,1,109.56889,18.27076,1763
22205,171841,8EC6BA9FA8E683D0E20F5950ED4FE9BA,31561,5,6,1,109.56792,18.28479,1765
22206,171842,8EC6BA9FA8E683D0E20F5950ED4FE9BA,38891,19,20,1,109.51486,18.24118,1558
22207,171843,8EC6BA9FA8E683D0E20F5950ED4FE9BA,38154,22,23,1,109.5266,18.28278,1615
22208,171862,232722015844736ABCA5CD9BDD75C9C8,60614,0,6,6,109.48799,18.29521,1467
22209,171863,232722015844736ABCA5CD9BDD75C9C8,31221,11,12,1,109.61333,18.26833,1913
22210,171864,232722015844736ABCA5CD9BDD75C9C8,30441,13,16,3,109.64021,18.25424,2010
22211,171865,232722015844736ABCA5CD9BDD75C9C8,60501,20,23,3,109.48701,18.29021,1466
22212,171867,36BDBC763CA4EEA7EA86EDFAC07B856F,30581,8,10,2,109.62257,18.24951,1959
22213,171868,36BDBC763CA4EEA7EA86EDFAC07B856F,31781,12,13,1,109.19847,18.2975,367
22214,171889,00FC332040A284DA251A8D0705989FE9,31071,0,7,7,109.58257,18.28458,1815
22215,171890,00FC332040A284DA251A8D0705989FE9,30854,7,12,5,109.56889,18.27076,1763
22216,171955,2AE38FAF341950B0B91404FFCE5A0F3E,31931,4,6,2,109.54771,18.29403,1667
22217,171956,2AE38FAF341950B0B91404FFCE5A0F3E,30921,11,18,7,109.53903,18.29451,1667
22218,171957,75616D7735994EB9CD2FE56D29700535,30854,9,12,3,109.56889,18.27076,1763
22219,171958,75616D7735994EB9CD2FE56D29700535,31561,12,13,1,109.56792,18.28479,1765
22220,171959,75616D7735994EB9CD2FE56D29700535,30854,14,16,2,109.56889,18.27076,1763
22221,171960,75616D7735994EB9CD2FE56D29700535,30711,17,19,2,109.50271,18.25347,1510
22222,171961,75616D7735994EB9CD2FE56D29700535,31561,20,23,3,109.56792,18.28479,1765
22223,171962,39F25FE146A03325C93C111F2A943B6C,30854,13,15,2,109.56889,18.27076,1763
22224,171963,39F25FE146A03325C93C111F2A943B6C,31071,17,19,2,109.58257,18.28458,1815
22225,171990,B3777343168B11ED0B6DA62191147797,31071,0,8,8,109.58257,18.28458,1815
22226,171991,B3777343168B11ED0B6DA62191147797,30854,9,17,8,109.56889,18.27076,1763
22241,172119,EC4B90EDBF35256FDB4D4F8B87DB8A04,30854,0,1,1,109.56889,18.27076,1763
22242,172120,EC4B90EDBF35256FDB4D4F8B87DB8A04,31071,2,5,3,109.58257,18.28458,1815
22243,172121,EC4B90EDBF35256FDB4D4F8B87DB8A04,30854,8,9,1,109.56889,18.27076,1763
22244,172122,EC4B90EDBF35256FDB4D4F8B87DB8A04,31071,17,18,1,109.58257,18.28458,1815
22245,172123,EC4B90EDBF35256FDB4D4F8B87DB8A04,30854,21,23,2,109.56889,18.27076,1763
22250,172140,339B8E03A8626DDBBF8D74D2D918714D,60201,0,1,1,109.5041,18.2509,1510
22251,172141,339B8E03A8626DDBBF8D74D2D918714D,31461,3,6,3,109.5091,18.25389,1510
22252,172142,339B8E03A8626DDBBF8D74D2D918714D,30151,7,8,1,109.50986,18.25083,1560
22253,172143,339B8E03A8626DDBBF8D74D2D918714D,30661,12,13,1,109.37028,18.24361,1008
22254,172144,339B8E03A8626DDBBF8D74D2D918714D,60331,18,19,1,109.505,18.26507,1512
22255,172145,339B8E03A8626DDBBF8D74D2D918714D,60371,19,22,3,109.53063,18.30056,1618
22256,172146,339B8E03A8626DDBBF8D74D2D918714D,60331,22,23,1,109.505,18.26507,1512
22264,172250,979ABBB43C3434EE96D76E04CFC66E55,60201,0,9,9,109.5041,18.2509,1510
22265,172251,979ABBB43C3434EE96D76E04CFC66E55,31781,12,15,3,109.19847,18.2975,367
22266,172252,979ABBB43C3434EE96D76E04CFC66E55,31164,18,20,2,109.69993,18.27215,2263
22267,172298,03CEC0FDDD5484124514C6D24A63D4DD,39183,13,18,5,109.55542,18.28208,1715
22268,172299,03CEC0FDDD5484124514C6D24A63D4DD,30854,20,22,2,109.56889,18.27076,1763
22277,172320,9A1FB52F8D7F45B27EB2059FE8339DC0,38141,0,1,1,109.39479,18.2916,1116
22278,172321,9A1FB52F8D7F45B27EB2059FE8339DC0,38903,2,8,6,109.39229,18.29243,1117
22279,172322,9A1FB52F8D7F45B27EB2059FE8339DC0,38141,9,11,2,109.39479,18.2916,1116
22280,172323,9A1FB52F8D7F45B27EB2059FE8339DC0,38903,11,13,2,109.39229,18.29243,1117
22281,172324,9A1FB52F8D7F45B27EB2059FE8339DC0,31951,16,17,1,109.52174,18.30299,1568
22282,172325,9A1FB52F8D7F45B27EB2059FE8339DC0,38141,19,23,4,109.39479,18.2916,1116
22283,172339,38CF8AD578A393476F29705A4599B8B1,30511,0,9,9,109.51069,18.24208,1558
22284,172340,38CF8AD578A393476F29705A4599B8B1,60291,9,10,1,109.50826,18.24639,1509
22285,172341,38CF8AD578A393476F29705A4599B8B1,38271,12,14,2,109.62632,18.23049,1956
22286,172342,38CF8AD578A393476F29705A4599B8B1,38171,16,17,1,109.50799,18.28139,1515
22287,172343,38CF8AD578A393476F29705A4599B8B1,38271,19,23,4,109.62632,18.23049,1956
22291,172392,55D9F9C0249C92714E75EA2BD9E88590,39091,4,7,3,109.50097,18.25222,1510
22292,172422,14F1CC63CDA098F9694EAC8584B9C7A5,30854,14,15,1,109.56889,18.27076,1763
22293,172423,14F1CC63CDA098F9694EAC8584B9C7A5,31561,15,19,4,109.56792,18.28479,1765
22294,172437,93C8A9BFC982F63705EDC3214DA05AC8,30901,14,23,9,109.27597,18.3134,670
22295,172454,E218C587552A5DADC05C4E69685FE374,39183,0,7,7,109.55542,18.28208,1715
22296,172455,E218C587552A5DADC05C4E69685FE374,30854,10,16,6,109.56889,18.27076,1763
22297,172527,1D8B814EC83D52D7C5F3FED99C129EE0,38271,10,18,8,109.62632,18.23049,1956
22298,172528,1D8B814EC83D52D7C5F3FED99C129EE0,30854,19,20,1,109.56889,18.27076,1763
22303,172538,8AD957ABE98C62A8B6F06AA624D5CB23,30854,11,12,1,109.56889,18.27076,1763
22304,172539,8AD957ABE98C62A8B6F06AA624D5CB23,31071,12,13,1,109.58257,18.28458,1815
22305,172540,8AD957ABE98C62A8B6F06AA624D5CB23,31561,15,16,1,109.56792,18.28479,1765
22306,172541,8AD957ABE98C62A8B6F06AA624D5CB23,31071,18,19,1,109.58257,18.28458,1815
22307,172663,EEC6B662D07BE95423A2DC77D2E69188,30891,0,8,8,109.59431,18.28389,1865
22308,172664,EEC6B662D07BE95423A2DC77D2E69188,31071,9,17,8,109.58257,18.28458,1815
22309,172694,628B56F9AD0921837C78826286456231,31236,17,20,3,109.42965,18.29111,1216
22310,172695,628B56F9AD0921837C78826286456231,60552,21,23,2,109.41729,18.30014,1218
22311,172708,752B4C65CCCA1EA27D3C6EA24E289B9C,30854,0,2,2,109.56889,18.27076,1763
22312,172709,752B4C65CCCA1EA27D3C6EA24E289B9C,60631,4,5,1,109.57778,18.27583,1814
22313,172710,752B4C65CCCA1EA27D3C6EA24E289B9C,30854,10,15,5,109.56889,18.27076,1763
22314,172711,752B4C65CCCA1EA27D3C6EA24E289B9C,39371,16,18,2,109.56627,18.2646,1762
22315,172712,752B4C65CCCA1EA27D3C6EA24E289B9C,30854,20,21,1,109.56889,18.27076,1763
22316,172713,752B4C65CCCA1EA27D3C6EA24E289B9C,31071,21,23,2,109.58257,18.28458,1815
22317,172732,C7A4B55787295F6419B55AB029D11243,38251,0,2,2,109.49618,18.25493,1510
22318,172733,C7A4B55787295F6419B55AB029D11243,31031,3,7,4,109.49979,18.25382,1510
22319,172734,C7A4B55787295F6419B55AB029D11243,30421,8,10,2,109.50021,18.25861,1511
22320,172735,C7A4B55787295F6419B55AB029D11243,38251,11,15,4,109.49618,18.25493,1510
22321,172736,C7A4B55787295F6419B55AB029D11243,30421,15,17,2,109.50021,18.25861,1511
22322,172737,C7A4B55787295F6419B55AB029D11243,31031,17,21,4,109.49979,18.25382,1510
22326,172770,23019CE071DC0B0CEC6E78ADA422CE57,31091,1,2,1,109.41201,18.31222,1170
22327,172771,23019CE071DC0B0CEC6E78ADA422CE57,31461,3,16,13,109.5091,18.25389,1510
22328,172772,23019CE071DC0B0CEC6E78ADA422CE57,60361,17,19,2,109.51938,18.29681,1567
22335,172831,F8D799D9161B0143E0D71C40472A357E,30071,0,8,8,109.52819,18.30472,1619
22336,172832,F8D799D9161B0143E0D71C40472A357E,60371,8,10,2,109.53063,18.30056,1618
22337,172833,F8D799D9161B0143E0D71C40472A357E,30071,10,11,1,109.52819,18.30472,1619
22338,172834,F8D799D9161B0143E0D71C40472A357E,30071,12,18,6,109.52819,18.30472,1619
22339,172835,F8D799D9161B0143E0D71C40472A357E,31951,19,23,4,109.52174,18.30299,1568
22340,172840,6CFAF1B7B16CCEAB1A9CAE288B372D6F,60411,1,3,2,109.32514,18.30854,869
22341,172841,6CFAF1B7B16CCEAB1A9CAE288B372D6F,30661,3,9,6,109.37028,18.24361,1008
22342,172842,6CFAF1B7B16CCEAB1A9CAE288B372D6F,31471,13,15,2,109.34583,18.29563,917
22343,172843,6CFAF1B7B16CCEAB1A9CAE288B372D6F,60411,19,21,2,109.32514,18.30854,869
22344,172844,1C4D9C3B4ACCE12D2B04BB20561492BF,31461,14,17,3,109.5091,18.25389,1510
22345,172874,410ABF8C14ACED0B5467A09396FAD1E3,31071,4,5,1,109.58257,18.28458,1815
22346,172875,410ABF8C14ACED0B5467A09396FAD1E3,30854,8,22,14,109.56889,18.27076,1763
22356,173040,A46BA306DAEA889FAC7ACE9E5FD6A1FF,30911,0,1,1,109.50493,18.26181,1511
22357,173041,A46BA306DAEA889FAC7ACE9E5FD6A1FF,60331,5,9,4,109.505,18.26507,1512
22358,173042,A46BA306DAEA889FAC7ACE9E5FD6A1FF,30911,12,15,3,109.50493,18.26181,1511
22359,173043,A46BA306DAEA889FAC7ACE9E5FD6A1FF,30711,19,21,2,109.50271,18.25347,1510
22360,173044,A46BA306DAEA889FAC7ACE9E5FD6A1FF,30511,21,23,2,109.51069,18.24208,1558
22361,173064,C6C3BC01E542B810EF853FEEB6C81198,60361,0,19,19,109.51938,18.29681,1567
22362,173065,C6C3BC01E542B810EF853FEEB6C81198,31561,19,21,2,109.56792,18.28479,1765
22367,173082,14F21534C21254001A38352AD4BB0EF6,31071,0,15,15,109.58257,18.28458,1815
22368,173083,14F21534C21254001A38352AD4BB0EF6,30854,17,20,3,109.56889,18.27076,1763
22369,173095,7F3DDE6B55C3459C61E435131FEEF622,31151,0,10,10,109.75549,18.4191,2488
22370,173096,7F3DDE6B55C3459C61E435131FEEF622,30861,12,13,1,109.52722,18.22743,1606
22371,173097,7F3DDE6B55C3459C61E435131FEEF622,60381,18,21,3,109.5241,18.22458,1605
22372,173105,7045DBCCD7547EA005B802778717D4DC,30271,0,8,8,109.49132,18.23153,1456
22373,173106,7045DBCCD7547EA005B802778717D4DC,31471,11,12,1,109.34583,18.29563,917
22374,173107,7045DBCCD7547EA005B802778717D4DC,60054,12,13,1,109.3016,18.31229,770
22375,173108,7045DBCCD7547EA005B802778717D4DC,31471,14,15,1,109.34583,18.29563,917
22376,173109,7045DBCCD7547EA005B802778717D4DC,31021,17,19,2,109.49021,18.27,1463
22377,173110,7045DBCCD7547EA005B802778717D4DC,30271,20,23,3,109.49132,18.23153,1456
22378,173111,6C0260646767B781577B5B8CE2471E51,38484,0,17,17,109.53028,18.31528,1620
22379,173112,6C0260646767B781577B5B8CE2471E51,30071,21,22,1,109.52819,18.30472,1619
22386,173273,B8A8F8A9546487F572B7D006432745F0,39091,0,8,8,109.50097,18.25222,1510
22387,173274,B8A8F8A9546487F572B7D006432745F0,60411,11,23,12,109.32514,18.30854,869
22391,173297,FE95B3A32EFBC2838F293DF38F55FDD1,31561,16,17,1,109.56792,18.28479,1765
22392,173298,FE95B3A32EFBC2838F293DF38F55FDD1,39183,18,19,1,109.55542,18.28208,1715
22393,173361,E8BAAF476E8FE57075BAB1A8D4FF1780,30232,6,12,6,109.6191,18.31701,1971
22394,173362,E8BAAF476E8FE57075BAB1A8D4FF1780,39371,15,17,2,109.56627,18.2646,1762
22395,173363,E8BAAF476E8FE57075BAB1A8D4FF1780,31041,19,20,1,109.50278,18.23701,1507
22399,173423,0E92CE103B7D015A3121B51920E312F8,31021,0,7,7,109.49021,18.27,1463
22400,173424,0E92CE103B7D015A3121B51920E312F8,30281,10,11,1,109.50597,18.27583,1514
22401,173425,0E92CE103B7D015A3121B51920E312F8,31031,11,13,2,109.49979,18.25382,1510
22402,173426,0E92CE103B7D015A3121B51920E312F8,38171,15,18,3,109.50799,18.28139,1515
22403,173427,0E92CE103B7D015A3121B51920E312F8,60463,18,20,2,109.52507,18.22438,1605
22404,173428,0E92CE103B7D015A3121B51920E312F8,30281,21,22,1,109.50597,18.27583,1514
22405,173434,9A1D1AA5EE2CD156CC396C667ED8C5B9,30854,0,11,11,109.56889,18.27076,1763
22406,173435,9A1D1AA5EE2CD156CC396C667ED8C5B9,60631,15,16,1,109.57778,18.27583,1814
22407,173455,62373512AC63EC7FF3AD17244A4ECC6D,31531,17,20,3,109.49583,18.25972,1461
22408,173456,62373512AC63EC7FF3AD17244A4ECC6D,31534,21,23,2,109.49368,18.25806,1461
22409,173464,798BF3B08F72A16A6DEAAA235F1899BB,61011,0,5,5,109.60653,18.19076,1900
22410,173466,798BF3B08F72A16A6DEAAA235F1899BB,61011,10,23,13,109.60653,18.19076,1900
22411,173487,0D48FD835B207ED202CAB110B7436DC2,31821,14,18,4,109.51181,18.24924,1559
22412,173488,0D48FD835B207ED202CAB110B7436DC2,31071,21,22,1,109.58257,18.28458,1815
22413,173489,0D48FD835B207ED202CAB110B7436DC2,30854,22,23,1,109.56889,18.27076,1763
22414,173563,8FEFA204EA7EEB362556D906D163980A,31071,19,20,1,109.58257,18.28458,1815
22415,173564,8FEFA204EA7EEB362556D906D163980A,30854,22,23,1,109.56889,18.27076,1763
22416,173565,8DA90B6D40958D7E810FB66B32BF98D6,30361,16,17,1,109.50347,18.24,1508
22417,173566,8DA90B6D40958D7E810FB66B32BF98D6,31311,20,23,3,109.72299,18.27438,2364
22418,173573,CDBCEFE36800F86949E9657EF4E117F8,38541,0,13,13,109.73715,18.34875,2426
22419,173574,CDBCEFE36800F86949E9657EF4E117F8,30361,17,19,2,109.50347,18.24,1508
22420,173575,CDBCEFE36800F86949E9657EF4E117F8,30271,19,23,4,109.49132,18.23153,1456
22421,173600,995FEDA35E19404F9E3BD941B6B09B64,30191,0,7,7,109.50361,18.22701,1506
22422,173601,995FEDA35E19404F9E3BD941B6B09B64,31781,11,13,2,109.19847,18.2975,367
22423,173602,995FEDA35E19404F9E3BD941B6B09B64,31471,15,16,1,109.34583,18.29563,917
22424,173603,995FEDA35E19404F9E3BD941B6B09B64,30201,19,21,2,109.4909,18.26465,1462
22425,173604,995FEDA35E19404F9E3BD941B6B09B64,38961,22,23,1,109.50847,18.23514,1507
22433,173691,6751CEC3CF9B2AE78246C7287443D2B4,31761,15,16,1,109.60521,18.27965,1914
22434,173692,6751CEC3CF9B2AE78246C7287443D2B4,31945,21,23,2,109.58021,18.29403,1817
22435,173693,7F632B4875B2736225CD6D350CD25670,31071,0,7,7,109.58257,18.28458,1815
22436,173694,7F632B4875B2736225CD6D350CD25670,30854,8,22,14,109.56889,18.27076,1763
22437,173701,4552AE0C0FB78BA3063EBA5C903C87F0,31945,18,20,2,109.58021,18.29403,1817
22438,173702,4552AE0C0FB78BA3063EBA5C903C87F0,31421,21,23,2,109.55382,18.22347,1705
22439,173737,7FA173D0839B9BE60B23B32DD3C2AC47,30854,7,9,2,109.56889,18.27076,1763
22440,173738,7FA173D0839B9BE60B23B32DD3C2AC47,31071,9,10,1,109.58257,18.28458,1815
22441,173739,7FA173D0839B9BE60B23B32DD3C2AC47,31945,12,14,2,109.58021,18.29403,1817
22442,173740,7FA173D0839B9BE60B23B32DD3C2AC47,38241,18,19,1,109.54111,18.30542,1669
22443,173741,7FA173D0839B9BE60B23B32DD3C2AC47,30854,20,21,1,109.56889,18.27076,1763
22444,173769,01137538B50607C6E164E173798CDC4B,39131,0,5,5,109.2066,18.29639,417
22445,173770,01137538B50607C6E164E173798CDC4B,39131,8,11,3,109.2066,18.29639,417
22446,173771,01137538B50607C6E164E173798CDC4B,60571,14,15,1,109.50722,18.25056,1510
22447,173772,01137538B50607C6E164E173798CDC4B,60201,16,17,1,109.5041,18.2509,1510
22448,173773,01137538B50607C6E164E173798CDC4B,31171,18,20,2,109.50938,18.24917,1559
22449,173774,01137538B50607C6E164E173798CDC4B,30151,21,23,2,109.50986,18.25083,1560
22450,173781,4D4289AE0DFBF4B5C79A47559DC2EBDD,30854,2,17,15,109.56889,18.27076,1763
22451,173782,4D4289AE0DFBF4B5C79A47559DC2EBDD,60381,20,22,2,109.5241,18.22458,1605
22455,173812,68DBE0B52FD0AB95F1DD47068FD7847F,60311,0,7,7,109.52097,18.24319,1558
22456,173813,68DBE0B52FD0AB95F1DD47068FD7847F,30181,7,21,14,109.51597,18.23313,1557
22457,173887,905DE0D7E71B1111A514D0B230AE04DE,31251,0,7,7,109.18528,18.2975,317
22458,173889,905DE0D7E71B1111A514D0B230AE04DE,31251,11,16,5,109.18528,18.2975,317
22459,173929,DECB7B3FC95BFA8620EFD8D9DE328252,31381,8,9,1,109.1375,18.36833,129
22460,173930,DECB7B3FC95BFA8620EFD8D9DE328252,30854,12,14,2,109.56889,18.27076,1763
22461,173931,DECB7B3FC95BFA8620EFD8D9DE328252,60411,16,18,2,109.32514,18.30854,869
22462,173932,DECB7B3FC95BFA8620EFD8D9DE328252,30854,19,20,1,109.56889,18.27076,1763
22463,174041,019CCF25DBCE9B21B5D2698F82FCE788,30854,2,7,5,109.56889,18.27076,1763
22464,174042,019CCF25DBCE9B21B5D2698F82FCE788,31851,11,12,1,109.71736,18.29007,2316
22465,174043,019CCF25DBCE9B21B5D2698F82FCE788,31161,13,15,2,109.70229,18.31361,2270
22466,174044,019CCF25DBCE9B21B5D2698F82FCE788,31851,16,17,1,109.71736,18.29007,2316
22467,174045,019CCF25DBCE9B21B5D2698F82FCE788,31041,21,22,1,109.50278,18.23701,1507
22468,174061,4E9C73925B67466BCE6AE7E22B99BF20,31561,2,4,2,109.56792,18.28479,1765
22469,174062,4E9C73925B67466BCE6AE7E22B99BF20,31071,4,7,3,109.58257,18.28458,1815
22470,174063,4E9C73925B67466BCE6AE7E22B99BF20,30854,10,12,2,109.56889,18.27076,1763
22471,174064,4E9C73925B67466BCE6AE7E22B99BF20,39183,14,17,3,109.55542,18.28208,1715
22472,174065,4E9C73925B67466BCE6AE7E22B99BF20,30854,19,20,1,109.56889,18.27076,1763
22473,174066,4E9C73925B67466BCE6AE7E22B99BF20,31071,21,22,1,109.58257,18.28458,1815
22474,174080,FE6376AB53578CB7B343C13E491275A1,60121,15,16,1,109.74507,18.37472,2430
22475,174136,B175A0347ABEEA30E818C5CCD25E280F,30821,5,21,16,109.43681,18.33639,1274
22476,174137,B175A0347ABEEA30E818C5CCD25E280F,60011,22,23,1,109.48965,18.30222,1468
22477,174157,E7EF2FD0C20FE9F43ACE7950E88D1DFE,60561,0,4,4,109.38229,18.29785,1067
22478,174158,E7EF2FD0C20FE9F43ACE7950E88D1DFE,31671,5,18,13,109.38965,18.29813,1068
22479,174159,8B69C410684F618B4BB94E686E30E787,30361,15,17,2,109.50347,18.24,1508
22480,174160,8B69C410684F618B4BB94E686E30E787,31531,18,21,3,109.49583,18.25972,1461
22481,174166,C9A281EF0BD980779EA579DF3160E0C7,60614,0,8,8,109.48799,18.29521,1467
22482,174167,C9A281EF0BD980779EA579DF3160E0C7,31181,12,14,2,109.50382,18.24813,1509
22483,174174,90D91A493F9482486DCC3B27CF3F61EE,31071,0,6,6,109.58257,18.28458,1815
22484,174175,90D91A493F9482486DCC3B27CF3F61EE,30854,11,22,11,109.56889,18.27076,1763
22485,174180,AAB2387B734435D3D9CD946A8ED73005,31351,21,23,2,109.4959,18.28417,1465
22496,174218,0B5DA2373AB43B25667FC2040F3AB05D,31321,0,7,7,109.63799,18.23201,2007
22497,174219,0B5DA2373AB43B25667FC2040F3AB05D,31781,11,12,1,109.19847,18.2975,367
22498,174220,0B5DA2373AB43B25667FC2040F3AB05D,30354,17,18,1,109.42813,18.29076,1216
22499,174221,0B5DA2373AB43B25667FC2040F3AB05D,60524,20,23,3,109.42951,18.28993,1216
22500,174242,B02D7A3F297B377D646E0F85B7C19006,61011,1,3,2,109.60653,18.19076,1900
22501,174255,BD5D5103B08534F20AF53FB58E9A43CA,31931,14,16,2,109.54771,18.29403,1667
22502,174256,BD5D5103B08534F20AF53FB58E9A43CA,39101,18,19,1,109.50132,18.24931,1509
22503,174257,BD5D5103B08534F20AF53FB58E9A43CA,39053,19,21,2,109.511,18.2771,1564
22504,174258,246EF4D95FA494895EFB2D649512DAE7,60081,1,7,6,109.51097,18.22639,1556
22505,174260,246EF4D95FA494895EFB2D649512DAE7,31521,19,22,3,109.51458,18.22542,1555
22506,174276,372A5433078073EAD18922D679CE0A73,60054,2,3,1,109.3016,18.31229,770
22507,174277,372A5433078073EAD18922D679CE0A73,30661,4,6,2,109.37028,18.24361,1008
22508,174278,372A5433078073EAD18922D679CE0A73,60054,6,17,11,109.3016,18.31229,770
22509,174279,372A5433078073EAD18922D679CE0A73,31471,19,20,1,109.34583,18.29563,917
22510,174280,372A5433078073EAD18922D679CE0A73,60054,20,23,3,109.3016,18.31229,770
22511,174345,24A5718F38ADE9789750DBD9F143F189,60401,1,5,4,109.47444,18.27583,1414
22512,174346,24A5718F38ADE9789750DBD9F143F189,38951,5,6,1,109.48097,18.28868,1416
22513,174347,24A5718F38ADE9789750DBD9F143F189,60401,7,8,1,109.47444,18.27583,1414
22514,174348,24A5718F38ADE9789750DBD9F143F189,38951,8,10,2,109.48097,18.28868,1416
22515,174349,24A5718F38ADE9789750DBD9F143F189,38951,10,14,4,109.48097,18.28868,1416
22516,174350,24A5718F38ADE9789750DBD9F143F189,30361,18,20,2,109.50347,18.24,1508
22517,174351,24A5718F38ADE9789750DBD9F143F189,38951,20,23,3,109.48097,18.28868,1416
22518,174416,E2EDBB70F04FBEB0911E18FB05861B67,38141,0,8,8,109.39479,18.2916,1116
22519,174417,E2EDBB70F04FBEB0911E18FB05861B67,60231,10,13,3,109.49903,18.21972,1504
22520,174418,E2EDBB70F04FBEB0911E18FB05861B67,30201,18,19,1,109.4909,18.26465,1462
22521,174419,E2EDBB70F04FBEB0911E18FB05861B67,38141,21,23,2,109.39479,18.2916,1116
22522,174438,4A6E6277F47F7550E2618B9C1ADC3166,30361,0,17,17,109.50347,18.24,1508
22523,174439,4A6E6277F47F7550E2618B9C1ADC3166,30161,20,23,3,109.50042,18.24389,1508
22524,174440,BB31DF7CD95EBDC65D12089CF34DDE37,31521,0,9,9,109.51458,18.22542,1555
22525,174441,BB31DF7CD95EBDC65D12089CF34DDE37,60621,13,14,1,109.48354,18.27451,1464
22526,174442,BB31DF7CD95EBDC65D12089CF34DDE37,31521,18,23,5,109.51458,18.22542,1555
22527,174479,D4EE8E1A4C04A1FF0596E4221D0B8B42,31071,0,6,6,109.58257,18.28458,1815
22528,174480,D4EE8E1A4C04A1FF0596E4221D0B8B42,30854,7,21,14,109.56889,18.27076,1763
22529,174540,D2B92BDCA81782196C97ED9FBD07A486,39154,0,6,6,109.50201,18.25681,1511
22530,174541,D2B92BDCA81782196C97ED9FBD07A486,31145,9,12,3,109.20431,18.30479,369
22537,174627,A9F97D2464709590426A157138F3C687,39181,12,13,1,109.55153,18.28035,1715
22538,174628,A9F97D2464709590426A157138F3C687,31931,14,23,9,109.54771,18.29403,1667
22543,174687,C80B17780A5E1C3296CC2BACA948899A,30854,2,11,9,109.56889,18.27076,1763
22544,174689,C80B17780A5E1C3296CC2BACA948899A,30854,18,23,5,109.56889,18.27076,1763
22545,174703,C17F2EF1DEA79C8C951E3013EE071B2C,31071,0,13,13,109.58257,18.28458,1815
22546,174704,C17F2EF1DEA79C8C951E3013EE071B2C,30854,16,23,7,109.56889,18.27076,1763
22547,174721,B80D6AB96D3D5CEE71A70ED25275F830,60501,0,1,1,109.48701,18.29021,1466
22548,174722,B80D6AB96D3D5CEE71A70ED25275F830,38951,2,10,8,109.48097,18.28868,1416
22563,174785,06639AF8E634A2EA412E3ADD181BCABE,31071,0,1,1,109.58257,18.28458,1815
22564,174786,06639AF8E634A2EA412E3ADD181BCABE,31561,4,8,4,109.56792,18.28479,1765
22565,174787,06639AF8E634A2EA412E3ADD181BCABE,30854,12,13,1,109.56889,18.27076,1763
22566,174788,06639AF8E634A2EA412E3ADD181BCABE,31561,13,15,2,109.56792,18.28479,1765
22567,174789,06639AF8E634A2EA412E3ADD181BCABE,30854,18,19,1,109.56889,18.27076,1763
22568,174790,06639AF8E634A2EA412E3ADD181BCABE,31071,20,22,2,109.58257,18.28458,1815
22573,174860,855D815DC19AA779325469411A9E7B8A,30251,0,5,5,109.50611,18.26653,1512
22574,174861,855D815DC19AA779325469411A9E7B8A,38157,6,18,12,109.51483,18.26958,1563
22578,174880,EAED40469566BEC9779C5FE2ED8401DA,31311,15,17,2,109.72299,18.27438,2364
22579,174881,EAED40469566BEC9779C5FE2ED8401DA,30861,21,23,2,109.52722,18.22743,1606
22580,174915,8621CFDF1B89A83351494618C53D033F,31071,0,7,7,109.58257,18.28458,1815
22581,174916,8621CFDF1B89A83351494618C53D033F,39181,8,21,13,109.55153,18.28035,1715
22582,174927,5D7EC4507F4E76B3D5B0735531A150FF,30731,0,8,8,109.50944,18.22306,1555
22583,174928,5D7EC4507F4E76B3D5B0735531A150FF,30771,9,12,3,109.49938,18.26042,1511
22584,174929,5D7EC4507F4E76B3D5B0735531A150FF,31864,16,17,1,109.49014,18.28333,1465
22591,175010,63CB222117AB8A54673799718246EF46,30084,0,8,8,109.50118,18.26972,1513
22592,175011,63CB222117AB8A54673799718246EF46,31031,10,12,2,109.49979,18.25382,1510
22593,175012,63CB222117AB8A54673799718246EF46,60131,12,13,1,109.49819,18.24778,1509
22594,175013,63CB222117AB8A54673799718246EF46,30084,13,15,2,109.50118,18.26972,1513
22595,175014,63CB222117AB8A54673799718246EF46,30291,16,17,1,109.50403,18.27028,1513
22596,175015,63CB222117AB8A54673799718246EF46,30764,19,20,1,109.45806,18.29486,1367
22600,175027,4AA92C2276692190731459431C798101,31945,0,8,8,109.58021,18.29403,1817
22601,175029,4AA92C2276692190731459431C798101,31945,17,23,6,109.58021,18.29403,1817
22602,175030,F4D73E54C3F1B86838B3542D305E78B2,30851,15,17,2,109.5616,18.27396,1713
22603,175031,F4D73E54C3F1B86838B3542D305E78B2,60631,18,23,5,109.57778,18.27583,1814
22604,175069,23DF3A4510347EF32640F77C0A9AA1C8,60281,10,11,1,109.51743,18.25924,1561
22605,175070,23DF3A4510347EF32640F77C0A9AA1C8,39321,12,14,2,109.529,18.2167,1604
22606,175071,23DF3A4510347EF32640F77C0A9AA1C8,60381,15,17,2,109.5241,18.22458,1605
22607,175072,23DF3A4510347EF32640F77C0A9AA1C8,31821,17,21,4,109.51181,18.24924,1559
22608,175073,23DF3A4510347EF32640F77C0A9AA1C8,60281,22,23,1,109.51743,18.25924,1561
22609,175095,E9F64FD67E39C3E2C15C20715338A941,31931,7,9,2,109.54771,18.29403,1667
22610,175096,E9F64FD67E39C3E2C15C20715338A941,30921,9,17,8,109.53903,18.29451,1667
22611,175097,E9F64FD67E39C3E2C15C20715338A941,31931,22,23,1,109.54771,18.29403,1667
22612,175157,EB316856896788EC8FD871E122E95728,30701,0,6,6,109.59313,18.32007,1871
22613,175158,EB316856896788EC8FD871E122E95728,31811,8,9,1,109.54201,18.31806,1671
22614,175159,EB316856896788EC8FD871E122E95728,30931,12,13,1,109.55653,18.32722,1722
22615,175160,EB316856896788EC8FD871E122E95728,30701,15,17,2,109.59313,18.32007,1871
22616,175161,EB316856896788EC8FD871E122E95728,31811,20,21,1,109.54201,18.31806,1671
22617,175162,EB316856896788EC8FD871E122E95728,30701,21,23,2,109.59313,18.32007,1871
22618,175168,13C882817D5EF3329D8612AEE7E0F34D,60371,0,7,7,109.53063,18.30056,1618
22619,175169,13C882817D5EF3329D8612AEE7E0F34D,31145,10,11,1,109.20431,18.30479,369
22620,175195,5F05A258CA919BA01045F79DD70FBCC9,31561,11,13,2,109.56792,18.28479,1765
22621,175196,5F05A258CA919BA01045F79DD70FBCC9,30854,14,16,2,109.56889,18.27076,1763
22622,175197,5F05A258CA919BA01045F79DD70FBCC9,31561,17,21,4,109.56792,18.28479,1765
22623,175198,5F05A258CA919BA01045F79DD70FBCC9,30854,22,23,1,109.56889,18.27076,1763
22624,175236,3C6C31F30579C628F9EDFADEE409AE9F,60241,0,7,7,109.53319,18.28667,1616
22625,175237,3C6C31F30579C628F9EDFADEE409AE9F,30711,8,9,1,109.50271,18.25347,1510
22626,175238,3C6C31F30579C628F9EDFADEE409AE9F,31181,10,14,4,109.50382,18.24813,1509
22627,175239,3C6C31F30579C628F9EDFADEE409AE9F,30661,16,17,1,109.37028,18.24361,1008
22628,175240,3C6C31F30579C628F9EDFADEE409AE9F,60241,21,22,1,109.53319,18.28667,1616
22629,175247,CBA29FB366E4111071C95C99C696D0E6,31561,0,5,5,109.56792,18.28479,1765
22630,175248,CBA29FB366E4111071C95C99C696D0E6,31321,7,17,10,109.63799,18.23201,2007
22631,175249,CBA29FB366E4111071C95C99C696D0E6,30854,18,23,5,109.56889,18.27076,1763
22632,175280,4B004637D3CFBCA65EA00FFD3F1EF7A6,31561,0,2,2,109.56792,18.28479,1765
22633,175281,4B004637D3CFBCA65EA00FFD3F1EF7A6,30854,3,4,1,109.56889,18.27076,1763
22634,175282,4B004637D3CFBCA65EA00FFD3F1EF7A6,39183,8,10,2,109.55542,18.28208,1715
22635,175283,4B004637D3CFBCA65EA00FFD3F1EF7A6,31561,10,13,3,109.56792,18.28479,1765
22636,175284,4B004637D3CFBCA65EA00FFD3F1EF7A6,39183,16,22,6,109.55542,18.28208,1715
22637,175285,FA6D7510012E571D09E23E75BE9DD4E6,60081,17,19,2,109.51097,18.22639,1556
22638,175286,FA6D7510012E571D09E23E75BE9DD4E6,60441,20,21,1,109.46792,18.28604,1366
22639,175304,58DE8A719D3ADBEDAE163213845B460A,31071,0,7,7,109.58257,18.28458,1815
22640,175305,58DE8A719D3ADBEDAE163213845B460A,30854,8,12,4,109.56889,18.27076,1763
22641,175306,58DE8A719D3ADBEDAE163213845B460A,31071,12,13,1,109.58257,18.28458,1815
22642,175307,58DE8A719D3ADBEDAE163213845B460A,30854,15,19,4,109.56889,18.27076,1763
22643,175308,58DE8A719D3ADBEDAE163213845B460A,31071,20,23,3,109.58257,18.28458,1815
22644,175351,706B8E0F0F5D1C9FC2F8EBB2574EE89F,30711,0,1,1,109.50271,18.25347,1510
22645,175352,706B8E0F0F5D1C9FC2F8EBB2574EE89F,38185,1,2,1,109.51333,18.27347,1563
22646,175353,706B8E0F0F5D1C9FC2F8EBB2574EE89F,30711,2,10,8,109.50271,18.25347,1510
22647,175354,706B8E0F0F5D1C9FC2F8EBB2574EE89F,31461,10,20,10,109.5091,18.25389,1510
22648,175355,706B8E0F0F5D1C9FC2F8EBB2574EE89F,30711,21,23,2,109.50271,18.25347,1510
22649,175356,E79FCCBA9F6300DF5C81A804945B477E,31071,0,6,6,109.58257,18.28458,1815
22650,175357,E79FCCBA9F6300DF5C81A804945B477E,30854,8,11,3,109.56889,18.27076,1763
22651,175358,E52B1449B3E12C656C55695335C2EE0A,30071,0,14,14,109.52819,18.30472,1619
22652,175359,E52B1449B3E12C656C55695335C2EE0A,38251,14,15,1,109.49618,18.25493,1510
22653,175360,E52B1449B3E12C656C55695335C2EE0A,60201,16,19,3,109.5041,18.2509,1510
22654,175361,E52B1449B3E12C656C55695335C2EE0A,31411,20,21,1,109.5016,18.23576,1507
22658,175414,C7D2CD8303C3ACD5723978EF4C4C760B,38951,0,7,7,109.48097,18.28868,1416
22659,175415,C7D2CD8303C3ACD5723978EF4C4C760B,31145,9,10,1,109.20431,18.30479,369
22660,175416,C7D2CD8303C3ACD5723978EF4C4C760B,31471,15,16,1,109.34583,18.29563,917
22661,175417,C7D2CD8303C3ACD5723978EF4C4C760B,30821,18,19,1,109.43681,18.33639,1274
22662,175418,C7D2CD8303C3ACD5723978EF4C4C760B,38951,19,23,4,109.48097,18.28868,1416
22663,175437,2BFDDEF2CA95240C316B75CE066959B5,30111,20,21,1,109.47583,18.30542,1419
22664,175443,2FD3D62C2F03A29CB2B8169833F320AE,60054,14,15,1,109.3016,18.31229,770
22665,175444,2FD3D62C2F03A29CB2B8169833F320AE,38111,18,23,5,109.52007,18.22403,1555
22666,175447,5264833F0013AE6B294396000613EF89,60201,0,14,14,109.5041,18.2509,1510
22667,175449,5264833F0013AE6B294396000613EF89,60201,21,23,2,109.5041,18.2509,1510
22672,175462,756F7869BDD7D5958992D7847F42858F,60041,1,3,2,109.39889,18.31944,1121
22673,175463,756F7869BDD7D5958992D7847F42858F,30351,6,23,17,109.41701,18.29292,1217
22674,175487,2F440A235E684ECEDD042B3100A4AE95,31071,0,7,7,109.58257,18.28458,1815
22675,175488,2F440A235E684ECEDD042B3100A4AE95,30854,8,18,10,109.56889,18.27076,1763
22676,175535,5EBEA276FCB4A19AC5C987F5C7CC8908,60621,0,6,6,109.48354,18.27451,1464
22677,175536,5EBEA276FCB4A19AC5C987F5C7CC8908,60401,6,9,3,109.47444,18.27583,1414
22678,175537,5EBEA276FCB4A19AC5C987F5C7CC8908,60552,10,12,2,109.41729,18.30014,1218
22679,175538,5EBEA276FCB4A19AC5C987F5C7CC8908,60621,12,16,4,109.48354,18.27451,1464
22680,175539,5EBEA276FCB4A19AC5C987F5C7CC8908,60401,16,18,2,109.47444,18.27583,1414
22681,175540,5EBEA276FCB4A19AC5C987F5C7CC8908,38361,18,19,1,109.43667,18.29201,1267
22682,175541,5EBEA276FCB4A19AC5C987F5C7CC8908,60552,19,21,2,109.41729,18.30014,1218
22683,175542,5EBEA276FCB4A19AC5C987F5C7CC8908,60401,21,22,1,109.47444,18.27583,1414
22687,175588,45086BC0869D90A8E8F669EDA6561CFA,31071,0,14,14,109.58257,18.28458,1815
22688,175589,45086BC0869D90A8E8F669EDA6561CFA,30911,18,20,2,109.50493,18.26181,1511
22689,175590,45086BC0869D90A8E8F669EDA6561CFA,38127,20,21,1,109.50833,18.27222,1513
22690,175591,DB4DF566D4757FF3BB488F82DE126248,31561,14,15,1,109.56792,18.28479,1765
22691,175592,DB4DF566D4757FF3BB488F82DE126248,30851,16,17,1,109.5616,18.27396,1713
22692,175593,DB4DF566D4757FF3BB488F82DE126248,31561,21,22,1,109.56792,18.28479,1765
22696,175616,0312B43ACF9ED1D8304E325E851AEE29,30851,5,6,1,109.5616,18.27396,1713
22697,175617,0312B43ACF9ED1D8304E325E851AEE29,31561,7,17,10,109.56792,18.28479,1765
22698,175648,B55959B64746A18ECF5077B5F7359221,31561,0,16,16,109.56792,18.28479,1765
22699,175649,B55959B64746A18ECF5077B5F7359221,39183,17,18,1,109.55542,18.28208,1715
22700,175664,4BA143AD44480D9BEACA2836C34FF531,60231,3,8,5,109.49903,18.21972,1504
22701,175665,4BA143AD44480D9BEACA2836C34FF531,60084,9,11,2,109.4984,18.2334,1507
22702,175666,4BA143AD44480D9BEACA2836C34FF531,60231,11,13,2,109.49903,18.21972,1504
22703,175667,4BA143AD44480D9BEACA2836C34FF531,60084,15,16,1,109.4984,18.2334,1507
22704,175668,4BA143AD44480D9BEACA2836C34FF531,60231,17,19,2,109.49903,18.21972,1504
22705,175669,4BA143AD44480D9BEACA2836C34FF531,31411,21,22,1,109.5016,18.23576,1507
22706,175678,85CBCBBFD7989A93B3D9A05B97F2C0BC,31521,0,6,6,109.51458,18.22542,1555
22707,175679,85CBCBBFD7989A93B3D9A05B97F2C0BC,31145,8,9,1,109.20431,18.30479,369
22708,175680,85CBCBBFD7989A93B3D9A05B97F2C0BC,31781,9,11,2,109.19847,18.2975,367
22709,175681,85CBCBBFD7989A93B3D9A05B97F2C0BC,31145,11,12,1,109.20431,18.30479,369
22710,175682,85CBCBBFD7989A93B3D9A05B97F2C0BC,60054,14,15,1,109.3016,18.31229,770
22711,175683,85CBCBBFD7989A93B3D9A05B97F2C0BC,31521,19,22,3,109.51458,18.22542,1555
22712,175691,67D30B307FD4639F5D7DA8C23EB3E033,31461,8,9,1,109.5091,18.25389,1510
22713,175692,67D30B307FD4639F5D7DA8C23EB3E033,60641,10,12,2,109.53854,18.2359,1657
22714,175693,67D30B307FD4639F5D7DA8C23EB3E033,30711,12,15,3,109.50271,18.25347,1510
22718,175742,00AEAAE0DD4398BA164B5D4BA6DC0137,31071,0,7,7,109.58257,18.28458,1815
22719,175743,00AEAAE0DD4398BA164B5D4BA6DC0137,30861,11,13,2,109.52722,18.22743,1606
22720,175800,4EEB87EFD2F33BBAF42BE530271C40CA,31161,0,13,13,109.70229,18.31361,2270
22721,175801,4EEB87EFD2F33BBAF42BE530271C40CA,31841,14,17,3,109.73201,18.33382,2373
22722,175802,4EEB87EFD2F33BBAF42BE530271C40CA,39101,18,21,3,109.50132,18.24931,1509
22727,175848,30D9F47EE01436A9014A347A7F5878BC,38141,0,8,8,109.39479,18.2916,1116
22728,175849,30D9F47EE01436A9014A347A7F5878BC,31145,9,11,2,109.20431,18.30479,369
22729,175850,30D9F47EE01436A9014A347A7F5878BC,31781,11,12,1,109.19847,18.2975,367
22730,175851,B7A2800FDF738E1064EAD2A5E58F7A3C,61011,0,1,1,109.60653,18.19076,1900
22731,175853,B7A2800FDF738E1064EAD2A5E58F7A3C,61011,10,19,9,109.60653,18.19076,1900
22732,175869,0B1CC3266C9F341870D0B135F2AF352E,60441,16,17,1,109.46792,18.28604,1366
22733,175870,0B1CC3266C9F341870D0B135F2AF352E,30201,18,19,1,109.4909,18.26465,1462
22734,175871,0B1CC3266C9F341870D0B135F2AF352E,60441,21,22,1,109.46792,18.28604,1366
22735,175886,0C8D15C0488D521680F0DE3A28CFE111,31811,0,7,7,109.54201,18.31806,1671
22736,175887,0C8D15C0488D521680F0DE3A28CFE111,30701,7,21,14,109.59313,18.32007,1871
22737,175900,0410C9BFB4956092D2C91E696A83188B,31945,0,3,3,109.58021,18.29403,1817
22738,175901,0410C9BFB4956092D2C91E696A83188B,30854,7,8,1,109.56889,18.27076,1763
22739,175902,0410C9BFB4956092D2C91E696A83188B,31071,11,12,1,109.58257,18.28458,1815
22740,175903,0410C9BFB4956092D2C91E696A83188B,30854,15,16,1,109.56889,18.27076,1763
22741,175904,0410C9BFB4956092D2C91E696A83188B,31945,19,20,1,109.58021,18.29403,1817
22742,175912,64F4CDF664AA04E7B79DE93C57128CF6,31931,0,7,7,109.54771,18.29403,1667
22743,175913,64F4CDF664AA04E7B79DE93C57128CF6,39181,7,18,11,109.55153,18.28035,1715
22744,175917,45CCFCD3EBDF941E1C92B70ED06E8B5E,31561,2,3,1,109.56792,18.28479,1765
22745,175918,45CCFCD3EBDF941E1C92B70ED06E8B5E,30854,7,17,10,109.56889,18.27076,1763
22746,175919,45CCFCD3EBDF941E1C92B70ED06E8B5E,31421,18,19,1,109.55382,18.22347,1705
22747,175930,E885B3923220582401E6F1A363A3329C,31071,13,14,1,109.58257,18.28458,1815
22748,175931,E885B3923220582401E6F1A363A3329C,30854,15,23,8,109.56889,18.27076,1763
22749,175960,6B806948BC9187A91D033B4096721B00,31561,0,1,1,109.56792,18.28479,1765
22750,175961,6B806948BC9187A91D033B4096721B00,30854,1,7,6,109.56889,18.27076,1763
22751,175962,6B806948BC9187A91D033B4096721B00,31071,9,19,10,109.58257,18.28458,1815
22752,175963,6B806948BC9187A91D033B4096721B00,31561,21,22,1,109.56792,18.28479,1765
22753,175964,6B806948BC9187A91D033B4096721B00,30854,22,23,1,109.56889,18.27076,1763
22754,176015,76A2064D4E26CC1DFB7C0689BEBF7D5B,31061,0,7,7,109.53333,18.23257,1607
22755,176027,895CD60412795FD53135C10CDBA0A9C7,38154,1,7,6,109.5266,18.28278,1615
22756,176028,895CD60412795FD53135C10CDBA0A9C7,30281,12,13,1,109.50597,18.27583,1514
22757,176029,895CD60412795FD53135C10CDBA0A9C7,31471,15,17,2,109.34583,18.29563,917
22758,176030,895CD60412795FD53135C10CDBA0A9C7,38127,18,23,5,109.50833,18.27222,1513
22763,176096,996308BA516E2A4FD895EB11278D247D,30711,0,4,4,109.50271,18.25347,1510
22764,176097,996308BA516E2A4FD895EB11278D247D,30201,4,9,5,109.4909,18.26465,1462
22765,176098,996308BA516E2A4FD895EB11278D247D,30711,9,13,4,109.50271,18.25347,1510
22766,176099,996308BA516E2A4FD895EB11278D247D,30081,16,19,3,109.50243,18.26632,1512
22767,176100,996308BA516E2A4FD895EB11278D247D,30201,19,22,3,109.4909,18.26465,1462
22768,176145,5AE5291D69C9CAB9DE596EEA8E795748,31521,0,1,1,109.51458,18.22542,1555
22769,176146,5AE5291D69C9CAB9DE596EEA8E795748,31521,5,10,5,109.51458,18.22542,1555
22770,176147,5AE5291D69C9CAB9DE596EEA8E795748,60221,14,18,4,109.52569,18.29188,1616
22771,176160,76B21384CC3EFE3F43353B93FDFE32EE,30821,2,6,4,109.43681,18.33639,1274
22772,176161,76B21384CC3EFE3F43353B93FDFE32EE,30651,7,8,1,109.42611,18.385,1232
22773,176162,76B21384CC3EFE3F43353B93FDFE32EE,30821,8,14,6,109.43681,18.33639,1274
22774,176163,76B21384CC3EFE3F43353B93FDFE32EE,30651,14,17,3,109.42611,18.385,1232
22775,176164,76B21384CC3EFE3F43353B93FDFE32EE,30821,17,19,2,109.43681,18.33639,1274
22782,176238,2B8C748A18FA7D08D4335AD7C9DEF01B,31551,11,14,3,109.55868,18.24222,1708
22783,176239,2B8C748A18FA7D08D4335AD7C9DEF01B,31761,18,23,5,109.60521,18.27965,1914
22784,176254,7BD1580BA480E545686438B39D58DB57,31124,14,15,1,109.17069,18.35,276
22785,176255,7BD1580BA480E545686438B39D58DB57,38157,17,19,2,109.51483,18.26958,1563
22790,176299,EFDE35289FEC1E13D6F34EFEE66A8AD2,30854,15,16,1,109.56889,18.27076,1763
22791,176300,EFDE35289FEC1E13D6F34EFEE66A8AD2,60631,18,23,5,109.57778,18.27583,1814
22792,176311,5581E816D65ABEC11ABF61B39B1CF7D8,31781,12,14,2,109.19847,18.2975,367
22793,176312,5581E816D65ABEC11ABF61B39B1CF7D8,60571,16,18,2,109.50722,18.25056,1510
22794,176313,5581E816D65ABEC11ABF61B39B1CF7D8,31031,18,20,2,109.49979,18.25382,1510
22795,176316,DA10676C4DA702E02A2C3FFFAC40ABA2,31561,0,2,2,109.56792,18.28479,1765
22796,176317,DA10676C4DA702E02A2C3FFFAC40ABA2,39183,2,4,2,109.55542,18.28208,1715
22797,176318,DA10676C4DA702E02A2C3FFFAC40ABA2,31561,4,11,7,109.56792,18.28479,1765
22798,176319,DA10676C4DA702E02A2C3FFFAC40ABA2,39183,12,13,1,109.55542,18.28208,1715
22799,176320,DA10676C4DA702E02A2C3FFFAC40ABA2,31561,14,19,5,109.56792,18.28479,1765
22800,176321,DA10676C4DA702E02A2C3FFFAC40ABA2,39183,20,22,2,109.55542,18.28208,1715
22805,176372,AF8242E3517F84A72E26C512CF4FFF97,31471,14,16,2,109.34583,18.29563,917
22806,176373,AF8242E3517F84A72E26C512CF4FFF97,30821,17,18,1,109.43681,18.33639,1274
22807,176374,AF8242E3517F84A72E26C512CF4FFF97,38951,19,21,2,109.48097,18.28868,1416
22808,176375,AF8242E3517F84A72E26C512CF4FFF97,38951,21,23,2,109.48097,18.28868,1416
22809,176424,0133DDFFB5CECBB261CEDEF10A82D50B,31561,5,6,1,109.56792,18.28479,1765
22810,176425,0133DDFFB5CECBB261CEDEF10A82D50B,30854,6,8,2,109.56889,18.27076,1763
22811,176426,0133DDFFB5CECBB261CEDEF10A82D50B,31561,9,11,2,109.56792,18.28479,1765
22812,176427,0133DDFFB5CECBB261CEDEF10A82D50B,31071,13,14,1,109.58257,18.28458,1815
22813,176428,0133DDFFB5CECBB261CEDEF10A82D50B,31561,15,16,1,109.56792,18.28479,1765
22814,176464,0E129C09250C0D46273B4BD7E5225556,30151,0,6,6,109.50986,18.25083,1560
22815,176465,0E129C09250C0D46273B4BD7E5225556,60201,6,9,3,109.5041,18.2509,1510
22816,176466,0E129C09250C0D46273B4BD7E5225556,60441,12,16,4,109.46792,18.28604,1366
22817,176467,0E129C09250C0D46273B4BD7E5225556,30151,19,21,2,109.50986,18.25083,1560
22818,176468,0E129C09250C0D46273B4BD7E5225556,30151,22,23,1,109.50986,18.25083,1560
22825,176534,7D3715670DBD868CBE84944A90E4C6E8,38027,0,2,2,109.38833,18.2909,1066
22826,176535,7D3715670DBD868CBE84944A90E4C6E8,60561,3,4,1,109.38229,18.29785,1067
22827,176536,7D3715670DBD868CBE84944A90E4C6E8,38027,4,5,1,109.38833,18.2909,1066
22828,176537,7D3715670DBD868CBE84944A90E4C6E8,60561,7,9,2,109.38229,18.29785,1067
22829,176538,7D3715670DBD868CBE84944A90E4C6E8,38027,10,23,13,109.38833,18.2909,1066
22830,176552,C709D01469E0800AF998DFAF42105CDC,30854,0,2,2,109.56889,18.27076,1763
22831,176553,C709D01469E0800AF998DFAF42105CDC,31561,6,19,13,109.56792,18.28479,1765
22832,176570,451E2BF48CD7B253EB0892324E679BCC,38297,0,1,1,109.52576,18.24965,1609
22833,176571,451E2BF48CD7B253EB0892324E679BCC,38291,1,3,2,109.51618,18.24313,1558
22834,176572,451E2BF48CD7B253EB0892324E679BCC,38297,3,4,1,109.52576,18.24965,1609
22835,176573,451E2BF48CD7B253EB0892324E679BCC,60281,6,10,4,109.51743,18.25924,1561
22836,176574,451E2BF48CD7B253EB0892324E679BCC,38297,10,14,4,109.52576,18.24965,1609
22837,176575,451E2BF48CD7B253EB0892324E679BCC,60281,14,17,3,109.51743,18.25924,1561
22838,176576,451E2BF48CD7B253EB0892324E679BCC,38291,18,23,5,109.51618,18.24313,1558
22839,176593,8A0382A2385C362EFE2664E8795F133E,31561,0,8,8,109.56792,18.28479,1765
22840,176594,8A0382A2385C362EFE2664E8795F133E,39183,8,18,10,109.55542,18.28208,1715
22841,176616,5ABFF3E8EB470884C270C0C936A89A00,38754,17,21,4,109.74667,18.37382,2430
22842,176620,8883DF5E66B5FC284A8EF97DE8EAAAB3,31571,9,10,1,109.61563,18.23326,1957
22843,176621,8883DF5E66B5FC284A8EF97DE8EAAAB3,60214,13,14,1,109.63104,18.24493,2009
22847,176648,0E5593A90D661690BE3DAAA17AD936E2,30281,18,19,1,109.50597,18.27583,1514
22848,176649,0E5593A90D661690BE3DAAA17AD936E2,30084,19,22,3,109.50118,18.26972,1513
22849,176682,529A14F498129B0238F7B12A9FC7F6F7,31205,0,2,2,109.51111,18.23736,1557
22850,176683,529A14F498129B0238F7B12A9FC7F6F7,31671,2,14,12,109.38965,18.29813,1068
22851,176684,529A14F498129B0238F7B12A9FC7F6F7,38361,14,15,1,109.43667,18.29201,1267
22852,176685,529A14F498129B0238F7B12A9FC7F6F7,31091,17,18,1,109.41201,18.31222,1170
22853,176686,529A14F498129B0238F7B12A9FC7F6F7,31231,19,20,1,109.42597,18.29292,1217
22857,176788,28549A30BFBE28E97BEE5CE42AFF819B,30281,0,19,19,109.50597,18.27583,1514
22858,176789,28549A30BFBE28E97BEE5CE42AFF819B,38891,19,20,1,109.51486,18.24118,1558
22859,176800,12E2C9356A230BE21C77839B0896D677,30854,15,16,1,109.56889,18.27076,1763
22860,176801,12E2C9356A230BE21C77839B0896D677,31561,20,23,3,109.56792,18.28479,1765
22861,176814,0E1B3CFC64EBB658DA96D0DCA834701E,61011,0,2,2,109.60653,18.19076,1900
22862,176816,0E1B3CFC64EBB658DA96D0DCA834701E,61011,4,5,1,109.60653,18.19076,1900
22863,176843,D42D82F7F77C55013F0EAB7E35E2211F,31071,3,11,8,109.58257,18.28458,1815
22864,176844,D42D82F7F77C55013F0EAB7E35E2211F,30531,14,22,8,109.53271,18.21472,1604
22865,176845,0C2EC2AEEF4BBDE5715612F8F83C00CC,60274,13,14,1,109.514,18.2933,1567
22869,176877,D39D64452E6BBEF7B3056CA239E1B86E,30854,0,7,7,109.56889,18.27076,1763
22870,176878,D39D64452E6BBEF7B3056CA239E1B86E,31561,7,10,3,109.56792,18.28479,1765
22871,176879,D39D64452E6BBEF7B3056CA239E1B86E,30854,12,13,1,109.56889,18.27076,1763
22872,176880,D39D64452E6BBEF7B3056CA239E1B86E,31561,14,15,1,109.56792,18.28479,1765
22873,176881,D39D64452E6BBEF7B3056CA239E1B86E,30854,18,23,5,109.56889,18.27076,1763
22878,176913,ADDDEBD546B43FF699A163EB1EA5FE50,30151,12,14,2,109.50986,18.25083,1560
22879,176914,ADDDEBD546B43FF699A163EB1EA5FE50,38251,18,20,2,109.49618,18.25493,1510
22880,176915,ADDDEBD546B43FF699A163EB1EA5FE50,30201,21,23,2,109.4909,18.26465,1462
22881,176933,50C497E938D256053EDA53A1DE0E2147,31304,0,12,12,109.15903,18.32854,223
22882,176934,50C497E938D256053EDA53A1DE0E2147,38205,14,15,1,109.62743,18.23139,1956
22883,176935,50C497E938D256053EDA53A1DE0E2147,31304,17,19,2,109.15903,18.32854,223
22884,176936,50C497E938D256053EDA53A1DE0E2147,31124,21,22,1,109.17069,18.35,276
22885,176951,E1B4EE5B2DAE31219B37A92CAB40AC2A,60161,17,18,1,109.49174,18.26181,1461
22886,176952,E1B4EE5B2DAE31219B37A92CAB40AC2A,31531,20,21,1,109.49583,18.25972,1461
22890,176982,82591CF1D9AFC5ADCA95A1BAF87D07E3,60361,0,3,3,109.51938,18.29681,1567
22891,177008,7E7742F5B0156B5C74FAAA9FE22D94C7,31071,2,5,3,109.58257,18.28458,1815
22892,177009,7E7742F5B0156B5C74FAAA9FE22D94C7,30854,8,10,2,109.56889,18.27076,1763
22893,177010,7E7742F5B0156B5C74FAAA9FE22D94C7,31071,10,13,3,109.58257,18.28458,1815
22894,177011,7E7742F5B0156B5C74FAAA9FE22D94C7,30854,16,18,2,109.56889,18.27076,1763
22895,177012,7E7742F5B0156B5C74FAAA9FE22D94C7,31071,19,23,4,109.58257,18.28458,1815
22896,177025,CD576F1C1CDFB89E6A99A20E65927346,31561,4,5,1,109.56792,18.28479,1765
22897,177026,CD576F1C1CDFB89E6A99A20E65927346,30854,5,22,17,109.56889,18.27076,1763
22898,177034,FB0C3DBC0AB121F552294646CC7B81E6,60087,0,15,15,109.50688,18.22299,1505
22899,177035,FB0C3DBC0AB121F552294646CC7B81E6,60121,16,23,7,109.74507,18.37472,2430
22903,177061,B712327B6033C61F37801CFD6DAC08AD,38484,0,3,3,109.53028,18.31528,1620
22904,177062,B712327B6033C61F37801CFD6DAC08AD,31951,4,5,1,109.52174,18.30299,1568
22905,177063,B712327B6033C61F37801CFD6DAC08AD,38484,6,11,5,109.53028,18.31528,1620
22906,177064,B712327B6033C61F37801CFD6DAC08AD,30561,11,12,1,109.52778,18.31938,1621
22907,177065,B712327B6033C61F37801CFD6DAC08AD,38484,13,18,5,109.53028,18.31528,1620
22908,177066,B712327B6033C61F37801CFD6DAC08AD,38484,22,23,1,109.53028,18.31528,1620
22912,177105,5C18A2E44B35E6C3C2823CC3AAFB80BA,60201,0,10,10,109.5041,18.2509,1510
22913,177106,5C18A2E44B35E6C3C2823CC3AAFB80BA,31931,13,14,1,109.54771,18.29403,1667
22914,177107,5C18A2E44B35E6C3C2823CC3AAFB80BA,31821,14,16,2,109.51181,18.24924,1559
22915,177108,5C18A2E44B35E6C3C2823CC3AAFB80BA,30711,16,19,3,109.50271,18.25347,1510
22916,177109,5C18A2E44B35E6C3C2823CC3AAFB80BA,60201,20,21,1,109.5041,18.2509,1510
22917,177110,5C18A2E44B35E6C3C2823CC3AAFB80BA,60201,22,23,1,109.5041,18.2509,1510
22918,177111,DF296B63A64E364FCDA4C38B0935EEEE,30511,0,21,21,109.51069,18.24208,1558
22919,177112,DF296B63A64E364FCDA4C38B0935EEEE,30151,21,23,2,109.50986,18.25083,1560
22923,177206,7D632B68A96EBB9D6582527232D6634C,30151,12,18,6,109.50986,18.25083,1560
22924,177207,7D632B68A96EBB9D6582527232D6634C,39154,19,22,3,109.50201,18.25681,1511
22931,177260,ED7E4BD9A3B03A25328617DB4B500130,30111,0,8,8,109.47583,18.30542,1419
22932,177261,ED7E4BD9A3B03A25328617DB4B500130,60171,11,12,1,109.51292,18.30694,1569
22933,177262,ED7E4BD9A3B03A25328617DB4B500130,30111,13,15,2,109.47583,18.30542,1419
22934,177263,ED7E4BD9A3B03A25328617DB4B500130,31071,18,21,3,109.58257,18.28458,1815
22944,177330,96F82DE3A1872ACA5447FE8341C04D65,39091,16,17,1,109.50097,18.25222,1510
22945,177331,96F82DE3A1872ACA5447FE8341C04D65,31041,18,19,1,109.50278,18.23701,1507
22946,177332,96F82DE3A1872ACA5447FE8341C04D65,60471,21,23,2,109.44653,18.30646,1319
22947,177348,48C2384D12D5B16772007E35CE360CBB,30721,0,8,8,109.51597,18.28257,1565
22948,177349,48C2384D12D5B16772007E35CE360CBB,38105,9,17,8,109.40299,18.29229,1117
22949,177350,48C2384D12D5B16772007E35CE360CBB,39041,18,22,4,109.40021,18.29278,1117
22950,177461,A928E9F6C796FE1A60807BA003DE87BB,39181,8,10,2,109.55153,18.28035,1715
22951,177462,A928E9F6C796FE1A60807BA003DE87BB,30854,11,12,1,109.56889,18.27076,1763
22952,177463,A928E9F6C796FE1A60807BA003DE87BB,39181,13,16,3,109.55153,18.28035,1715
22953,177464,A928E9F6C796FE1A60807BA003DE87BB,30854,16,21,5,109.56889,18.27076,1763
22954,177474,975CB35586D2D95A387E2AA86A5AB719,31351,0,8,8,109.4959,18.28417,1465
22955,177475,975CB35586D2D95A387E2AA86A5AB719,30671,9,23,14,109.43611,18.30139,1268
22956,177485,491A112CD81B9085F752897809919691,31201,8,9,1,109.51042,18.23819,1558
22957,177486,491A112CD81B9085F752897809919691,38251,12,14,2,109.49618,18.25493,1510
22961,177524,97C31877CA4226D0F1BA1C0E12066B56,60331,0,6,6,109.505,18.26507,1512
22962,177525,97C31877CA4226D0F1BA1C0E12066B56,30854,7,9,2,109.56889,18.27076,1763
22963,177526,97C31877CA4226D0F1BA1C0E12066B56,31071,10,11,1,109.58257,18.28458,1815
22964,177527,97C31877CA4226D0F1BA1C0E12066B56,30854,14,17,3,109.56889,18.27076,1763
22965,177528,97C31877CA4226D0F1BA1C0E12066B56,60331,18,20,2,109.505,18.26507,1512
22981,177606,9AF351B3CC27394DFED45513F0E32162,60351,0,1,1,109.58403,18.28958,1816
22982,177607,9AF351B3CC27394DFED45513F0E32162,31071,1,3,2,109.58257,18.28458,1815
22983,177608,9AF351B3CC27394DFED45513F0E32162,60351,5,7,2,109.58403,18.28958,1816
22984,177609,9AF351B3CC27394DFED45513F0E32162,30851,10,11,1,109.5616,18.27396,1713
22985,177610,9AF351B3CC27394DFED45513F0E32162,30951,11,13,2,109.56208,18.25667,1761
22986,177611,9AF351B3CC27394DFED45513F0E32162,30851,13,16,3,109.5616,18.27396,1713
22990,177629,DCD137352B900F9F43521E37884B7F13,60054,0,15,15,109.3016,18.31229,770
22991,177630,DCD137352B900F9F43521E37884B7F13,30661,18,23,5,109.37028,18.24361,1008
22992,177638,DA759AC2EBBA8078FBC390D09D5C4EC7,30854,12,20,8,109.56889,18.27076,1763
22993,177639,DA759AC2EBBA8078FBC390D09D5C4EC7,31071,22,23,1,109.58257,18.28458,1815
22998,177659,5F6720997470E5A2E722B130218E5FC9,60594,13,22,9,109.62694,18.22799,1956
22999,177698,410DD8A32244BC0C8E0A44B87218A19E,30854,4,18,14,109.56889,18.27076,1763
23000,177699,410DD8A32244BC0C8E0A44B87218A19E,31461,21,22,1,109.5091,18.25389,1510
23001,177715,CFAA4900917F16A6BB33BA227F202636,30221,16,17,1,109.57833,18.20222,1802
23002,177716,CFAA4900917F16A6BB33BA227F202636,38241,19,20,1,109.54111,18.30542,1669
23006,177768,029EE78335AC14EA912876F28FB86277,30681,0,10,10,109.48493,18.26917,1463
23007,177769,029EE78335AC14EA912876F28FB86277,60381,12,14,2,109.5241,18.22458,1605
23008,177770,029EE78335AC14EA912876F28FB86277,31031,14,15,1,109.49979,18.25382,1510
23009,177771,029EE78335AC14EA912876F28FB86277,30681,16,21,5,109.48493,18.26917,1463
23010,177772,E0686F37399D74676DEB0528C7B9FCF9,30511,0,9,9,109.51069,18.24208,1558
23011,177773,E0686F37399D74676DEB0528C7B9FCF9,60381,9,11,2,109.5241,18.22458,1605
23012,177782,963B5F4C98446446023B8ED177B869B3,39183,14,16,2,109.55542,18.28208,1715
23013,177783,963B5F4C98446446023B8ED177B869B3,60361,18,22,4,109.51938,18.29681,1567
23021,177823,AAB3DCB18BAF89954DC0C8A658A6D766,31951,0,2,2,109.52174,18.30299,1568
23022,177824,AAB3DCB18BAF89954DC0C8A658A6D766,30071,2,5,3,109.52819,18.30472,1619
23023,177825,AAB3DCB18BAF89954DC0C8A658A6D766,30071,7,9,2,109.52819,18.30472,1619
23024,177826,AAB3DCB18BAF89954DC0C8A658A6D766,38881,14,17,3,109.51618,18.26431,1562
23025,177827,AAB3DCB18BAF89954DC0C8A658A6D766,31951,19,22,3,109.52174,18.30299,1568
23026,177836,19A7A932E03C63EDA78541C31E010D15,30201,14,15,1,109.4909,18.26465,1462
23027,177837,19A7A932E03C63EDA78541C31E010D15,60541,18,22,4,109.4084,18.29208,1167
23028,177899,DF5348A8E25901EBB63BBF3F6126BB02,31071,0,6,6,109.58257,18.28458,1815
23029,177900,DF5348A8E25901EBB63BBF3F6126BB02,30854,6,7,1,109.56889,18.27076,1763
23030,177901,DF5348A8E25901EBB63BBF3F6126BB02,31071,9,11,2,109.58257,18.28458,1815
23031,177902,DF5348A8E25901EBB63BBF3F6126BB02,60361,13,17,4,109.51938,18.29681,1567
23032,177903,DF5348A8E25901EBB63BBF3F6126BB02,31071,19,20,1,109.58257,18.28458,1815
23033,177904,DF5348A8E25901EBB63BBF3F6126BB02,30854,20,22,2,109.56889,18.27076,1763
23038,177979,3F91EE227475391A33DA85DF3C955C00,60054,13,14,1,109.3016,18.31229,770
23039,177980,3F91EE227475391A33DA85DF3C955C00,60401,17,18,1,109.47444,18.27583,1414
23043,178019,9700F013445EE92B5BC547553474ABFD,38105,0,10,10,109.40299,18.29229,1117
23044,178020,9700F013445EE92B5BC547553474ABFD,31031,13,15,2,109.49979,18.25382,1510
23045,178021,9700F013445EE92B5BC547553474ABFD,38105,17,20,3,109.40299,18.29229,1117
23049,178059,B47CB2A2315F987CAA4AD3E9353D33AE,31231,0,7,7,109.42597,18.29292,1217
23050,178060,B47CB2A2315F987CAA4AD3E9353D33AE,31781,9,12,3,109.19847,18.2975,367
23051,178061,B47CB2A2315F987CAA4AD3E9353D33AE,31521,13,15,2,109.51458,18.22542,1555
23055,178078,7AF4921BC4D1712A961904D0ECC91550,38991,0,7,7,109.52681,18.30368,1618
23056,178079,7AF4921BC4D1712A961904D0ECC91550,30421,9,10,1,109.50021,18.25861,1511
23057,178080,7AF4921BC4D1712A961904D0ECC91550,30071,12,14,2,109.52819,18.30472,1619
23058,178081,7AF4921BC4D1712A961904D0ECC91550,60571,14,15,1,109.50722,18.25056,1510
23059,178082,7AF4921BC4D1712A961904D0ECC91550,30071,17,19,2,109.52819,18.30472,1619
23063,178091,5513D4DF2C6575E373329D82A78CC8F3,60221,19,21,2,109.52569,18.29188,1616
23064,178092,5513D4DF2C6575E373329D82A78CC8F3,60281,21,23,2,109.51743,18.25924,1561
23065,178095,1026894DC5FF9A7FAF3A2EE28B95E239,30854,0,1,1,109.56889,18.27076,1763
23066,178096,1026894DC5FF9A7FAF3A2EE28B95E239,30232,2,3,1,109.6191,18.31701,1971
23067,178097,1026894DC5FF9A7FAF3A2EE28B95E239,30891,4,6,2,109.59431,18.28389,1865
23068,178098,1026894DC5FF9A7FAF3A2EE28B95E239,30232,6,7,1,109.6191,18.31701,1971
23069,178099,1026894DC5FF9A7FAF3A2EE28B95E239,30854,11,23,12,109.56889,18.27076,1763
23074,178133,7421066246AAD1C230E7E2A7ADF06E9D,60631,0,6,6,109.57778,18.27583,1814
23075,178134,7421066246AAD1C230E7E2A7ADF06E9D,30854,7,11,4,109.56889,18.27076,1763
23076,178135,7421066246AAD1C230E7E2A7ADF06E9D,60631,12,13,1,109.57778,18.27583,1814
23077,178136,7421066246AAD1C230E7E2A7ADF06E9D,30854,15,16,1,109.56889,18.27076,1763
23078,178137,7421066246AAD1C230E7E2A7ADF06E9D,31071,16,18,2,109.58257,18.28458,1815
23079,178191,A01B4012B619D942E7CC3AC9B78722B4,31561,1,8,7,109.56792,18.28479,1765
23080,178192,A01B4012B619D942E7CC3AC9B78722B4,30854,10,11,1,109.56889,18.27076,1763
23081,178193,A01B4012B619D942E7CC3AC9B78722B4,31561,12,13,1,109.56792,18.28479,1765
23082,178194,A01B4012B619D942E7CC3AC9B78722B4,31931,13,14,1,109.54771,18.29403,1667
23083,178195,A01B4012B619D942E7CC3AC9B78722B4,39183,15,16,1,109.55542,18.28208,1715
23084,178196,A01B4012B619D942E7CC3AC9B78722B4,31561,19,21,2,109.56792,18.28479,1765
23094,178309,06D4B9E449A0048FBF2732A634B857D8,30111,21,23,2,109.47583,18.30542,1419
23095,178310,F2B9C7568D81626E82B4BCA4DDFDDC53,30191,20,21,1,109.50361,18.22701,1506
23096,178311,F2B9C7568D81626E82B4BCA4DDFDDC53,60281,21,23,2,109.51743,18.25924,1561
23108,178449,4CE4A31810F905218B2DE448B8558D56,30341,14,17,3,109.3625,18.29167,966
23109,178450,4CE4A31810F905218B2DE448B8558D56,38071,19,20,1,109.40722,18.30938,1169
23110,178451,147470AD3D3B8724582C30D5F244A8B6,30111,6,12,6,109.47583,18.30542,1419
23111,178452,147470AD3D3B8724582C30D5F244A8B6,60421,13,23,10,109.46333,18.31743,1371
23112,178466,9E4B050A632405BF0E0F227A4DA9A53D,30854,0,10,10,109.56889,18.27076,1763
23113,178467,9E4B050A632405BF0E0F227A4DA9A53D,30441,11,12,1,109.64021,18.25424,2010
23114,178468,9E4B050A632405BF0E0F227A4DA9A53D,30731,15,18,3,109.50944,18.22306,1555
23115,178469,9E4B050A632405BF0E0F227A4DA9A53D,30191,20,23,3,109.50361,18.22701,1506
23116,178505,DE2E7FD3F70D02EF01FD3D7518139D80,38951,0,7,7,109.48097,18.28868,1416
23117,178506,DE2E7FD3F70D02EF01FD3D7518139D80,31781,9,12,3,109.19847,18.2975,367
23118,178507,DE2E7FD3F70D02EF01FD3D7518139D80,31471,14,15,1,109.34583,18.29563,917
23119,178508,DE2E7FD3F70D02EF01FD3D7518139D80,38951,19,21,2,109.48097,18.28868,1416
23120,178532,19AF14C42256ABB10CC41D7FEC42A786,31071,1,7,6,109.58257,18.28458,1815
23121,178533,19AF14C42256ABB10CC41D7FEC42A786,30851,8,9,1,109.5616,18.27396,1713
23122,178534,19AF14C42256ABB10CC41D7FEC42A786,33481,11,16,5,109.67278,18.41278,2187
23123,178544,83930DA23863D53A36D25B51299F2054,61011,4,6,2,109.60653,18.19076,1900
23124,178546,83930DA23863D53A36D25B51299F2054,61011,12,14,2,109.60653,18.19076,1900
23125,178560,01CB2F51227D8C2BB2D3000C42EE0DA2,31521,10,17,7,109.51458,18.22542,1555
23126,178561,01CB2F51227D8C2BB2D3000C42EE0DA2,31171,17,19,2,109.50938,18.24917,1559
23127,178562,01CB2F51227D8C2BB2D3000C42EE0DA2,60274,19,22,3,109.514,18.2933,1567
23128,178566,3261CBB7DE1D0E7EBB73DA5908B3B2A9,31521,0,10,10,109.51458,18.22542,1555
23129,178567,3261CBB7DE1D0E7EBB73DA5908B3B2A9,31031,14,17,3,109.49979,18.25382,1510
23130,178587,C85D0B931BEF54F05B9ABBBB03212DB7,31421,0,7,7,109.55382,18.22347,1705
23131,178588,C85D0B931BEF54F05B9ABBBB03212DB7,30854,9,20,11,109.56889,18.27076,1763
23132,178589,C85D0B931BEF54F05B9ABBBB03212DB7,31561,22,23,1,109.56792,18.28479,1765
23133,178610,1582BEC240072EC51899932D6A0A257A,60631,3,4,1,109.57778,18.27583,1814
23134,178611,1582BEC240072EC51899932D6A0A257A,30891,4,17,13,109.59431,18.28389,1865
23135,178661,C9FB9F2C2796B7DA9E44AABC0342CC7A,60381,14,15,1,109.5241,18.22458,1605
23136,178662,C9FB9F2C2796B7DA9E44AABC0342CC7A,31521,16,18,2,109.51458,18.22542,1555
23140,178698,EBF906C5498076BCFA3E97DF6001B4F3,60631,6,7,1,109.57778,18.27583,1814
23141,178699,EBF906C5498076BCFA3E97DF6001B4F3,30854,9,21,12,109.56889,18.27076,1763
23146,178770,F8028D3CB53BF090C5567009A22F9DE3,60131,0,9,9,109.49819,18.24778,1509
23147,178771,F8028D3CB53BF090C5567009A22F9DE3,31471,11,14,3,109.34583,18.29563,917
23148,178772,F8028D3CB53BF090C5567009A22F9DE3,39091,18,23,5,109.50097,18.25222,1510
23149,178775,8E3A30A4D1E8F550E98C2EF7500D367D,30084,0,14,14,109.50118,18.26972,1513
23150,178776,8E3A30A4D1E8F550E98C2EF7500D367D,60381,17,19,2,109.5241,18.22458,1605
23151,178777,8E3A30A4D1E8F550E98C2EF7500D367D,30421,20,21,1,109.50021,18.25861,1511
23152,178788,75817DB682187A07461734D66E1E6492,60631,0,4,4,109.57778,18.27583,1814
23153,178789,75817DB682187A07461734D66E1E6492,30854,6,15,9,109.56889,18.27076,1763
23154,178790,75817DB682187A07461734D66E1E6492,31061,19,21,2,109.53333,18.23257,1607
23155,178791,75817DB682187A07461734D66E1E6492,60631,22,23,1,109.57778,18.27583,1814
23156,178840,6DB79FADDF50EB053ABAC0F23B07A706,38721,12,16,4,109.50368,18.27542,1514
23157,178841,6DB79FADDF50EB053ABAC0F23B07A706,60381,19,22,3,109.5241,18.22458,1605
23158,178855,21C679D1B9FF307EA1AC2A89744209FE,38291,0,8,8,109.51618,18.24313,1558
23159,178856,21C679D1B9FF307EA1AC2A89744209FE,60281,8,10,2,109.51743,18.25924,1561
23160,178857,21C679D1B9FF307EA1AC2A89744209FE,38291,12,18,6,109.51618,18.24313,1558
23161,178858,21C679D1B9FF307EA1AC2A89744209FE,60281,18,20,2,109.51743,18.25924,1561
23162,178859,21C679D1B9FF307EA1AC2A89744209FE,38291,20,23,3,109.51618,18.24313,1558
23166,178887,06FCF67485A2B44C8ABC96FDB92547C5,61011,13,15,2,109.60653,18.19076,1900
23167,178889,06FCF67485A2B44C8ABC96FDB92547C5,61011,18,23,5,109.60653,18.19076,1900
23168,178900,6DA2EC279010D0E9F544FC8AE2AE810A,39331,0,1,1,109.62125,18.22708,1956
23169,178901,6DA2EC279010D0E9F544FC8AE2AE810A,38283,1,4,3,109.62229,18.22618,1956
23170,178902,6DA2EC279010D0E9F544FC8AE2AE810A,31571,5,8,3,109.61563,18.23326,1957
23171,178904,6DA2EC279010D0E9F544FC8AE2AE810A,30361,19,23,4,109.50347,18.24,1508
23172,178923,95E09A72760B2799C2CC9BD7AF527107,31071,1,6,5,109.58257,18.28458,1815
23173,178924,95E09A72760B2799C2CC9BD7AF527107,30854,6,7,1,109.56889,18.27076,1763
23174,178925,95E09A72760B2799C2CC9BD7AF527107,31071,8,10,2,109.58257,18.28458,1815
23175,178926,95E09A72760B2799C2CC9BD7AF527107,30854,13,18,5,109.56889,18.27076,1763
23176,178927,95E09A72760B2799C2CC9BD7AF527107,31071,22,23,1,109.58257,18.28458,1815
23177,178928,B9443F64442A80E319EB0A8B9F1B13FA,31721,3,13,10,109.67938,18.24014,2158
23178,178929,B9443F64442A80E319EB0A8B9F1B13FA,39183,18,19,1,109.55542,18.28208,1715
23179,178930,B9443F64442A80E319EB0A8B9F1B13FA,30891,20,22,2,109.59431,18.28389,1865
23180,178944,8D8AA41210FC9E2D5DD4D81CF4DB18D7,60361,0,7,7,109.51938,18.29681,1567
23181,178945,8D8AA41210FC9E2D5DD4D81CF4DB18D7,38991,7,17,10,109.52681,18.30368,1618
23182,178946,8D8AA41210FC9E2D5DD4D81CF4DB18D7,39191,18,20,2,109.51493,18.23472,1557
23187,178972,ABCD0851CC1C78BCD7AF6DBDF2F5DE49,60041,0,5,5,109.39889,18.31944,1121
23188,178973,ABCD0851CC1C78BCD7AF6DBDF2F5DE49,60552,7,17,10,109.41729,18.30014,1218
23189,178974,ABCD0851CC1C78BCD7AF6DBDF2F5DE49,30731,18,19,1,109.50944,18.22306,1555
23190,178977,5E97A4561E11AAC4FBC53FD068EAA52B,30531,8,18,10,109.53271,18.21472,1604
23191,178978,5E97A4561E11AAC4FBC53FD068EAA52B,30854,20,22,2,109.56889,18.27076,1763
23192,178996,C19430CE8DF26BDEF43903E57E682236,31561,0,7,7,109.56792,18.28479,1765
23193,178997,C19430CE8DF26BDEF43903E57E682236,30854,10,12,2,109.56889,18.27076,1763
23194,178998,C19430CE8DF26BDEF43903E57E682236,31561,14,16,2,109.56792,18.28479,1765
23195,178999,C19430CE8DF26BDEF43903E57E682236,30854,19,21,2,109.56889,18.27076,1763
23196,179000,C19430CE8DF26BDEF43903E57E682236,31561,21,23,2,109.56792,18.28479,1765
23197,179008,E6541B4F346982101D887BAAF0315541,30854,0,1,1,109.56889,18.27076,1763
23198,179009,E6541B4F346982101D887BAAF0315541,31931,1,4,3,109.54771,18.29403,1667
23199,179010,E6541B4F346982101D887BAAF0315541,30854,4,5,1,109.56889,18.27076,1763
23200,179011,E6541B4F346982101D887BAAF0315541,31561,7,9,2,109.56792,18.28479,1765
23201,179012,E6541B4F346982101D887BAAF0315541,30854,12,14,2,109.56889,18.27076,1763
23202,179013,E6541B4F346982101D887BAAF0315541,31561,16,17,1,109.56792,18.28479,1765
23203,179014,E6541B4F346982101D887BAAF0315541,30854,18,20,2,109.56889,18.27076,1763
23204,179056,238A28D828ECC4FDAC2CC9F666ABE21D,31864,0,11,11,109.49014,18.28333,1465
23205,179057,238A28D828ECC4FDAC2CC9F666ABE21D,30161,11,15,4,109.50042,18.24389,1508
23206,179062,5DB17B652EFBF6CFE54CE332D8232D6E,31351,0,9,9,109.4959,18.28417,1465
23207,179068,7252A0F90E29EC78621699C082578EF7,31361,0,6,6,109.47417,18.28292,1415
23208,179069,7252A0F90E29EC78621699C082578EF7,60504,8,9,1,109.47917,18.28903,1416
23209,179070,7252A0F90E29EC78621699C082578EF7,31521,11,12,1,109.51458,18.22542,1555
23210,179071,7252A0F90E29EC78621699C082578EF7,31091,17,18,1,109.41201,18.31222,1170
23211,179072,7252A0F90E29EC78621699C082578EF7,30111,19,20,1,109.47583,18.30542,1419
23212,179073,7252A0F90E29EC78621699C082578EF7,31361,22,23,1,109.47417,18.28292,1415
23213,179100,6593F76DF8B5BF518604AD69943FBD58,31071,0,9,9,109.58257,18.28458,1815
23214,179101,6593F76DF8B5BF518604AD69943FBD58,30854,9,20,11,109.56889,18.27076,1763
23215,179118,E5D9C2E63CCE9D1234DB3809C4F11F20,30721,0,1,1,109.51597,18.28257,1565
23216,179119,E5D9C2E63CCE9D1234DB3809C4F11F20,60421,5,9,4,109.46333,18.31743,1371
23217,179120,E5D9C2E63CCE9D1234DB3809C4F11F20,60171,12,20,8,109.51292,18.30694,1569
23218,179153,4AE7355880AC4A67834E5F08397D8D3C,60524,0,2,2,109.42951,18.28993,1216
23219,179154,4AE7355880AC4A67834E5F08397D8D3C,30351,6,20,14,109.41701,18.29292,1217
23220,179155,4AE7355880AC4A67834E5F08397D8D3C,30771,21,22,1,109.49938,18.26042,1511
23221,179189,E960A9C960574B6ECAA9E8161ED40783,30861,0,12,12,109.52722,18.22743,1606
23222,179190,E960A9C960574B6ECAA9E8161ED40783,31031,14,16,2,109.49979,18.25382,1510
23223,179191,E960A9C960574B6ECAA9E8161ED40783,60221,17,21,4,109.52569,18.29188,1616
23227,179202,EA46ADF9F976BE5C491F6E059468AAEA,31521,0,5,5,109.51458,18.22542,1555
23228,179203,EA46ADF9F976BE5C491F6E059468AAEA,31521,6,8,2,109.51458,18.22542,1555
23229,179204,EA46ADF9F976BE5C491F6E059468AAEA,38754,11,13,2,109.74667,18.37382,2430
23230,179205,EA46ADF9F976BE5C491F6E059468AAEA,31521,15,22,7,109.51458,18.22542,1555
23231,179223,CBFB6695A565EE8288E80536B0FF653C,39321,16,17,1,109.529,18.2167,1604
23232,179224,CBFB6695A565EE8288E80536B0FF653C,30854,19,20,1,109.56889,18.27076,1763
23233,179225,5426296000364EE32711CD0E73D782C8,31071,2,9,7,109.58257,18.28458,1815
23234,179226,5426296000364EE32711CD0E73D782C8,31561,13,14,1,109.56792,18.28479,1765
23235,179227,5426296000364EE32711CD0E73D782C8,30854,17,18,1,109.56889,18.27076,1763
23236,179228,5426296000364EE32711CD0E73D782C8,38251,19,20,1,109.49618,18.25493,1510
23241,179275,4E94ADAE7ABEB20EEFAF67519DFCC1BE,31081,0,8,8,109.44639,18.30181,1318
23242,179276,4E94ADAE7ABEB20EEFAF67519DFCC1BE,31031,9,15,6,109.49979,18.25382,1510
23243,179277,4E94ADAE7ABEB20EEFAF67519DFCC1BE,31031,15,21,6,109.49979,18.25382,1510
23244,179339,00FD2268DE6E83934D2916174E81532F,60472,0,4,4,109.46625,18.29542,1367
23245,179340,00FD2268DE6E83934D2916174E81532F,30111,7,19,12,109.47583,18.30542,1419
23250,179387,8C8DB7A18864109B823771C405E00B29,60351,0,6,6,109.58403,18.28958,1816
23251,179388,8C8DB7A18864109B823771C405E00B29,31421,7,8,1,109.55382,18.22347,1705
23252,179389,8C8DB7A18864109B823771C405E00B29,30951,11,14,3,109.56208,18.25667,1761
23253,179390,8C8DB7A18864109B823771C405E00B29,31071,18,19,1,109.58257,18.28458,1815
23254,179391,8C8DB7A18864109B823771C405E00B29,60351,20,22,2,109.58403,18.28958,1816
23255,179392,C3AB0123E8B0A1F17841EC5DAE5B6707,31521,15,16,1,109.51458,18.22542,1555
23256,179393,C3AB0123E8B0A1F17841EC5DAE5B6707,30764,18,21,3,109.45806,18.29486,1367
23257,179396,996C0D9500BF90CC0E7F5A04C49A464B,31931,4,6,2,109.54771,18.29403,1667
23258,179398,B340EDEF4A878E8DF5CBEC25E465EACE,30854,7,11,4,109.56889,18.27076,1763
23259,179399,B340EDEF4A878E8DF5CBEC25E465EACE,31071,11,13,2,109.58257,18.28458,1815
23260,179400,B340EDEF4A878E8DF5CBEC25E465EACE,30854,14,15,1,109.56889,18.27076,1763
23261,179401,B340EDEF4A878E8DF5CBEC25E465EACE,60631,16,17,1,109.57778,18.27583,1814
23262,179402,B340EDEF4A878E8DF5CBEC25E465EACE,30721,17,20,3,109.51597,18.28257,1565
23263,179403,B340EDEF4A878E8DF5CBEC25E465EACE,31071,22,23,1,109.58257,18.28458,1815
23264,179420,F198CAA1F49ACA5D003FD8F8473B3798,30854,0,15,15,109.56889,18.27076,1763
23265,179421,F198CAA1F49ACA5D003FD8F8473B3798,30731,15,18,3,109.50944,18.22306,1555
23266,179441,6DD2992D9A732B2B8C9D2BEBFF495B9E,31561,0,8,8,109.56792,18.28479,1765
23267,179442,6DD2992D9A732B2B8C9D2BEBFF495B9E,30854,9,12,3,109.56889,18.27076,1763
23268,179443,6DD2992D9A732B2B8C9D2BEBFF495B9E,31561,13,18,5,109.56792,18.28479,1765
23269,179444,6DD2992D9A732B2B8C9D2BEBFF495B9E,30854,18,20,2,109.56889,18.27076,1763
23270,179445,6DD2992D9A732B2B8C9D2BEBFF495B9E,31561,21,22,1,109.56792,18.28479,1765
23271,179447,2EBBAC66DDB6248DEB5E1D635794A55A,61011,1,10,9,109.60653,18.19076,1900
23272,179449,2EBBAC66DDB6248DEB5E1D635794A55A,61011,15,17,2,109.60653,18.19076,1900
23276,179502,35C6EDC8AAC6B5ABA770190223528BA2,31061,0,5,5,109.53333,18.23257,1607
23277,179503,35C6EDC8AAC6B5ABA770190223528BA2,60381,6,8,2,109.5241,18.22458,1605
23278,179504,35C6EDC8AAC6B5ABA770190223528BA2,60121,10,11,1,109.74507,18.37472,2430
23279,179505,35C6EDC8AAC6B5ABA770190223528BA2,60381,14,16,2,109.5241,18.22458,1605
23280,179511,A50A9C6740FDA7E08A9D2C9FE22F2DDD,31531,13,14,1,109.49583,18.25972,1461
23281,179512,A50A9C6740FDA7E08A9D2C9FE22F2DDD,60221,15,17,2,109.52569,18.29188,1616
23282,179513,A50A9C6740FDA7E08A9D2C9FE22F2DDD,31271,20,21,1,109.48958,18.26257,1462
23287,179559,FEBC61D07262A46BE9A7FF14D2806B38,30854,0,8,8,109.56889,18.27076,1763
23288,179560,FEBC61D07262A46BE9A7FF14D2806B38,31031,12,14,2,109.49979,18.25382,1510
23289,179561,FEBC61D07262A46BE9A7FF14D2806B38,30854,14,16,2,109.56889,18.27076,1763
23290,179562,FEBC61D07262A46BE9A7FF14D2806B38,30161,17,22,5,109.50042,18.24389,1508
23291,179599,9D1215DD6B7CC5D7B77DB28818401AF1,31071,0,7,7,109.58257,18.28458,1815
23292,179600,9D1215DD6B7CC5D7B77DB28818401AF1,31761,9,10,1,109.60521,18.27965,1914
23293,179601,9D1215DD6B7CC5D7B77DB28818401AF1,30232,14,16,2,109.6191,18.31701,1971
23294,179602,9D1215DD6B7CC5D7B77DB28818401AF1,31071,17,19,2,109.58257,18.28458,1815
23295,179603,9D1215DD6B7CC5D7B77DB28818401AF1,31561,20,21,1,109.56792,18.28479,1765
23296,179611,D1EBD1A5A8A922DEF994C933F10DD8DB,60131,0,6,6,109.49819,18.24778,1509
23297,179612,D1EBD1A5A8A922DEF994C933F10DD8DB,30161,7,8,1,109.50042,18.24389,1508
23298,179613,D1EBD1A5A8A922DEF994C933F10DD8DB,60381,8,14,6,109.5241,18.22458,1605
23299,179614,D1EBD1A5A8A922DEF994C933F10DD8DB,60131,15,17,2,109.49819,18.24778,1509
23300,179615,D1EBD1A5A8A922DEF994C933F10DD8DB,30161,19,23,4,109.50042,18.24389,1508
23301,179644,665F7D27C5B6FBE7E46677D117D817C4,60381,19,21,2,109.5241,18.22458,1605
23302,179645,665F7D27C5B6FBE7E46677D117D817C4,30721,21,22,1,109.51597,18.28257,1565
23303,179646,F71405344B971967BDA24B8D31704EA3,39331,11,16,5,109.62125,18.22708,1956
23304,179647,F71405344B971967BDA24B8D31704EA3,30854,18,21,3,109.56889,18.27076,1763
23308,179713,770A00BDAFE9BCA8C9E9FA68066EED7D,31071,0,6,6,109.58257,18.28458,1815
23309,179714,770A00BDAFE9BCA8C9E9FA68066EED7D,30851,6,10,4,109.5616,18.27396,1713
23310,179715,770A00BDAFE9BCA8C9E9FA68066EED7D,30854,10,11,1,109.56889,18.27076,1763
23311,179716,770A00BDAFE9BCA8C9E9FA68066EED7D,31561,12,15,3,109.56792,18.28479,1765
23312,179717,770A00BDAFE9BCA8C9E9FA68066EED7D,30854,17,19,2,109.56889,18.27076,1763
23313,179718,770A00BDAFE9BCA8C9E9FA68066EED7D,31071,21,23,2,109.58257,18.28458,1815
23314,179746,FDC2B4BB960ACDA9822626D3DCBE25AF,31071,5,7,2,109.58257,18.28458,1815
23315,179747,FDC2B4BB960ACDA9822626D3DCBE25AF,30941,9,20,11,109.5559,18.33938,1724
23316,179748,FDC2B4BB960ACDA9822626D3DCBE25AF,31071,21,23,2,109.58257,18.28458,1815
23320,179752,369F61D9EC42E510E242E24266B2C23F,30921,0,7,7,109.53903,18.29451,1667
23321,179753,369F61D9EC42E510E242E24266B2C23F,31931,9,10,1,109.54771,18.29403,1667
23322,179754,369F61D9EC42E510E242E24266B2C23F,30921,10,11,1,109.53903,18.29451,1667
23323,179755,369F61D9EC42E510E242E24266B2C23F,31931,11,21,10,109.54771,18.29403,1667
23324,179756,369F61D9EC42E510E242E24266B2C23F,30071,22,23,1,109.52819,18.30472,1619
23325,179780,3BB007FDF28DB0E7E883BA594F721FFE,31181,0,15,15,109.50382,18.24813,1509
23326,179781,3BB007FDF28DB0E7E883BA594F721FFE,30711,16,23,7,109.50271,18.25347,1510
23327,179790,22328E79B5A8943E5A27CE35499D706B,60171,18,20,2,109.51292,18.30694,1569
23328,179791,22328E79B5A8943E5A27CE35499D706B,38251,21,23,2,109.49618,18.25493,1510
23329,179797,386F7C3EECFB31191CAF7B5A56666704,30854,18,19,1,109.56889,18.27076,1763
23330,179798,386F7C3EECFB31191CAF7B5A56666704,31071,21,22,1,109.58257,18.28458,1815
23335,179813,533C598FBE9A80A69F24B4E517B0CF08,30101,14,16,2,109.57299,18.33333,1773
23336,179814,533C598FBE9A80A69F24B4E517B0CF08,31351,17,19,2,109.4959,18.28417,1465
23337,179815,533C598FBE9A80A69F24B4E517B0CF08,30741,21,23,2,109.49833,18.28681,1516
23338,179837,DC0EB400EA24BEE9EB39D315B0E6AEF0,38871,0,3,3,109.44681,18.28625,1316
23339,179838,DC0EB400EA24BEE9EB39D315B0E6AEF0,31701,3,4,1,109.44132,18.28833,1266
23340,179839,DC0EB400EA24BEE9EB39D315B0E6AEF0,38871,5,7,2,109.44681,18.28625,1316
23341,179840,DC0EB400EA24BEE9EB39D315B0E6AEF0,31431,8,14,6,109.44639,18.29042,1316
23342,179842,DC0EB400EA24BEE9EB39D315B0E6AEF0,60274,20,23,3,109.514,18.2933,1567
23343,179858,9FEA4B85EAE4FAEE1CAF0EABFF2FAEA1,31931,13,16,3,109.54771,18.29403,1667
23344,179859,9FEA4B85EAE4FAEE1CAF0EABFF2FAEA1,39183,16,18,2,109.55542,18.28208,1715
23345,179867,7763FA5342AFBCA436FF4D695F9B9CB2,30711,0,6,6,109.50271,18.25347,1510
23346,179868,7763FA5342AFBCA436FF4D695F9B9CB2,60071,10,12,2,109.75674,18.31583,2470
23347,179869,7763FA5342AFBCA436FF4D695F9B9CB2,30711,16,17,1,109.50271,18.25347,1510
23348,179870,7763FA5342AFBCA436FF4D695F9B9CB2,30711,17,21,4,109.50271,18.25347,1510
23349,179874,32A3CE1C280040E7ED0898AB2CE878E8,60401,0,1,1,109.47444,18.27583,1414
23350,179875,32A3CE1C280040E7ED0898AB2CE878E8,30171,1,4,3,109.48458,18.27139,1463
23351,179876,32A3CE1C280040E7ED0898AB2CE878E8,60401,5,8,3,109.47444,18.27583,1414
23352,179877,32A3CE1C280040E7ED0898AB2CE878E8,31471,12,14,2,109.34583,18.29563,917
23353,179878,32A3CE1C280040E7ED0898AB2CE878E8,60401,16,22,6,109.47444,18.27583,1414
23354,179891,0A1CB07AD09D756A92F5040351DE4A0A,38336,0,11,11,109.61111,18.21806,1904
23355,179892,0A1CB07AD09D756A92F5040351DE4A0A,31321,12,13,1,109.63799,18.23201,2007
23356,179926,088829826E35A8DF49EB0AEC08CE7FE7,60054,15,16,1,109.3016,18.31229,770
23357,179927,088829826E35A8DF49EB0AEC08CE7FE7,30661,19,22,3,109.37028,18.24361,1008
23358,179928,088829826E35A8DF49EB0AEC08CE7FE7,60054,22,23,1,109.3016,18.31229,770
23359,179938,B2ECB16DAB1B797D0F4EE32090B0A991,60011,0,7,7,109.48965,18.30222,1468
23360,179939,B2ECB16DAB1B797D0F4EE32090B0A991,30111,8,10,2,109.47583,18.30542,1419
23361,179940,B2ECB16DAB1B797D0F4EE32090B0A991,60011,11,19,8,109.48965,18.30222,1468
23362,179941,B2ECB16DAB1B797D0F4EE32090B0A991,30111,20,21,1,109.47583,18.30542,1419
23363,179942,B2ECB16DAB1B797D0F4EE32090B0A991,60011,21,23,2,109.48965,18.30222,1468
23364,179951,94C4D5691F7DFC1AB38806AFFAC1389E,30921,12,16,4,109.53903,18.29451,1667
23365,179952,94C4D5691F7DFC1AB38806AFFAC1389E,31931,20,21,1,109.54771,18.29403,1667
23366,179957,317A2326A5D15E475076F1921264E5AD,39321,0,5,5,109.529,18.2167,1604
23367,179958,317A2326A5D15E475076F1921264E5AD,31521,7,8,1,109.51458,18.22542,1555
23368,179959,317A2326A5D15E475076F1921264E5AD,38071,12,13,1,109.40722,18.30938,1169
23369,179999,E191BF114A3C2277CB7C3323BAA13F43,31301,14,15,1,109.14493,18.31222,170
23370,180000,E191BF114A3C2277CB7C3323BAA13F43,30854,18,23,5,109.56889,18.27076,1763
23374,180030,293757429670FEF848C950D685169FCC,31071,0,4,4,109.58257,18.28458,1815
23375,180031,293757429670FEF848C950D685169FCC,30854,5,16,11,109.56889,18.27076,1763
23380,180046,E4199729A84482014747EE1ECF3FF7D9,30101,13,19,6,109.57299,18.33333,1773
23381,180047,E4199729A84482014747EE1ECF3FF7D9,30931,21,23,2,109.55653,18.32722,1722
23382,180078,E8D51F8B53F290BFD73338AD2AD8C728,31271,9,10,1,109.48958,18.26257,1462
23383,180079,E8D51F8B53F290BFD73338AD2AD8C728,31561,15,16,1,109.56792,18.28479,1765
23387,180115,5C958E9FBADCA0FB00CA547ED9076A9C,38121,3,7,4,109.51361,18.27813,1564
23388,180123,A8CC84F6441C04DAF82A74609E587ED2,39181,15,16,1,109.55153,18.28035,1715
23389,180124,A8CC84F6441C04DAF82A74609E587ED2,30561,19,20,1,109.52778,18.31938,1621
23390,180209,B40C23F05DF669D1A7928A9352D650F2,31391,0,1,1,109.50382,18.24285,1508
23391,180210,B40C23F05DF669D1A7928A9352D650F2,31181,1,2,1,109.50382,18.24813,1509
23392,180211,B40C23F05DF669D1A7928A9352D650F2,31391,2,8,6,109.50382,18.24285,1508
23393,180212,B40C23F05DF669D1A7928A9352D650F2,30361,9,11,2,109.50347,18.24,1508
23394,180213,B40C23F05DF669D1A7928A9352D650F2,31181,11,12,1,109.50382,18.24813,1509
23395,180214,B40C23F05DF669D1A7928A9352D650F2,31181,13,15,2,109.50382,18.24813,1509
23396,180215,B40C23F05DF669D1A7928A9352D650F2,30161,17,19,2,109.50042,18.24389,1508
23397,180216,B40C23F05DF669D1A7928A9352D650F2,60291,20,23,3,109.50826,18.24639,1509
23401,180232,DFE6C61D63344C2B343C27596421479D,30071,19,20,1,109.52819,18.30472,1619
23402,180233,DFE6C61D63344C2B343C27596421479D,30921,21,23,2,109.53903,18.29451,1667
23403,180234,E62AF2241FB9B5D16FE7C239F98C4F87,60331,0,6,6,109.505,18.26507,1512
23407,180280,2EB843F78CEA3889458F6783F8AADAE0,31071,14,17,3,109.58257,18.28458,1815
23408,180281,2EB843F78CEA3889458F6783F8AADAE0,30854,18,22,4,109.56889,18.27076,1763
23409,180288,4118232D9131A3783CE684A84D794F5E,31561,2,4,2,109.56792,18.28479,1765
23410,180289,4118232D9131A3783CE684A84D794F5E,30854,5,22,17,109.56889,18.27076,1763
23411,180290,4020F45A25B90FB7F045FA0843BE28FF,38871,13,16,3,109.44681,18.28625,1316
23412,180291,4020F45A25B90FB7F045FA0843BE28FF,31431,17,23,6,109.44639,18.29042,1316
23413,180310,A65416E0023DB5B05C85EFD796D8188E,31261,0,6,6,109.51174,18.2466,1559
23414,180311,A65416E0023DB5B05C85EFD796D8188E,38291,6,9,3,109.51618,18.24313,1558
23415,180312,A65416E0023DB5B05C85EFD796D8188E,60441,12,17,5,109.46792,18.28604,1366
23416,180313,A65416E0023DB5B05C85EFD796D8188E,30711,18,23,5,109.50271,18.25347,1510
23417,180323,D334753E33AD01D79142036B3D85543F,39183,5,6,1,109.55542,18.28208,1715
23418,180324,D334753E33AD01D79142036B3D85543F,31561,6,7,1,109.56792,18.28479,1765
23419,180342,10526BE112ADB237730F205D73F11651,38903,1,8,7,109.39229,18.29243,1117
23420,180343,10526BE112ADB237730F205D73F11651,31681,9,11,2,109.40396,18.29979,1168
23421,180344,10526BE112ADB237730F205D73F11651,38141,11,13,2,109.39479,18.2916,1116
23422,180345,10526BE112ADB237730F205D73F11651,31031,16,18,2,109.49979,18.25382,1510
23423,180346,10526BE112ADB237730F205D73F11651,38141,19,22,3,109.39479,18.2916,1116
23424,180379,47A18820FDA9856131F74091D44B6BCB,30851,11,17,6,109.5616,18.27396,1713
23425,180380,47A18820FDA9856131F74091D44B6BCB,31561,21,22,1,109.56792,18.28479,1765
23426,180381,5274FB91D917823AD6AE120EE7F21099,31931,0,7,7,109.54771,18.29403,1667
23427,180382,5274FB91D917823AD6AE120EE7F21099,60591,8,16,8,109.61118,18.21715,1904
23428,180383,5274FB91D917823AD6AE120EE7F21099,31931,19,23,4,109.54771,18.29403,1667
23429,180384,2E836A972A0232332CDA39E73CDA9E49,60331,0,15,15,109.505,18.26507,1512
23430,180385,2E836A972A0232332CDA39E73CDA9E49,30421,16,19,3,109.50021,18.25861,1511
23434,180419,74AD1AF2EA5153BD40BCF9A3F3F2C4E3,30854,7,18,11,109.56889,18.27076,1763
23435,180420,74AD1AF2EA5153BD40BCF9A3F3F2C4E3,60463,18,20,2,109.52507,18.22438,1605
23436,180421,74AD1AF2EA5153BD40BCF9A3F3F2C4E3,30854,21,23,2,109.56889,18.27076,1763
23437,180429,A9FCE0049DB44FE004EAFBF5B783F4A5,31071,9,10,1,109.58257,18.28458,1815
23438,180430,A9FCE0049DB44FE004EAFBF5B783F4A5,31945,11,13,2,109.58021,18.29403,1817
23439,180431,A9FCE0049DB44FE004EAFBF5B783F4A5,31071,15,16,1,109.58257,18.28458,1815
23440,180432,A9FCE0049DB44FE004EAFBF5B783F4A5,30854,16,23,7,109.56889,18.27076,1763
23441,180503,0467E7A2F341B63F33E9945177D53E54,31521,0,9,9,109.51458,18.22542,1555
23442,180505,0467E7A2F341B63F33E9945177D53E54,31521,18,20,2,109.51458,18.22542,1555
23443,180512,2CE19795F2549AFE8556FD3526787FA2,30851,12,18,6,109.5616,18.27396,1713
23444,180513,2CE19795F2549AFE8556FD3526787FA2,31071,20,23,3,109.58257,18.28458,1815
23445,180514,8E06EAC16B0EF776FA1BAAC5B9747325,31541,12,13,1,109.1809,18.36722,329
23446,180515,8E06EAC16B0EF776FA1BAAC5B9747325,30511,16,23,7,109.51069,18.24208,1558
23447,180529,984F2D9D2B3B2392734A65DD4D02EF52,60291,0,8,8,109.50826,18.24639,1509
23448,180534,CE0C6679CFD46FBB91046534419A41BB,31321,8,12,4,109.63799,18.23201,2007
23449,180535,CE0C6679CFD46FBB91046534419A41BB,30361,15,17,2,109.50347,18.24,1508
23450,180536,CE0C6679CFD46FBB91046534419A41BB,38071,18,19,1,109.40722,18.30938,1169
23451,180537,2BC350354AEE5008A4B7C604A26746F0,31431,18,19,1,109.44639,18.29042,1316
23452,180538,2BC350354AEE5008A4B7C604A26746F0,60401,20,22,2,109.47444,18.27583,1414
23453,180542,E9DD0C3BA6B2B97161600872C6799D2F,60552,9,10,1,109.41729,18.30014,1218
23454,180543,E9DD0C3BA6B2B97161600872C6799D2F,30581,12,13,1,109.62257,18.24951,1959
23455,180544,E9DD0C3BA6B2B97161600872C6799D2F,31061,17,19,2,109.53333,18.23257,1607
23456,180550,015CDEB9169BCE5537ABAE49B6A63F2B,30854,14,17,3,109.56889,18.27076,1763
23457,180551,015CDEB9169BCE5537ABAE49B6A63F2B,31031,19,22,3,109.49979,18.25382,1510
23458,180569,8AC12540A314B0C19F9DBE13856CB9EC,38094,0,8,8,109.45403,18.28778,1316
23459,180576,BCE29A3A46F5A479B3F0FA50B11216DE,31071,4,7,3,109.58257,18.28458,1815
23460,180577,BCE29A3A46F5A479B3F0FA50B11216DE,30854,10,11,1,109.56889,18.27076,1763
23461,180578,C3071072DB6684DC75BE160268E6323C,30854,14,16,2,109.56889,18.27076,1763
23462,180579,C3071072DB6684DC75BE160268E6323C,31071,18,21,3,109.58257,18.28458,1815
23463,180580,83F8DEFB45E9970F803B6E01CF53475C,60361,0,3,3,109.51938,18.29681,1567
23464,180581,83F8DEFB45E9970F803B6E01CF53475C,31021,4,13,9,109.49021,18.27,1463
23465,180582,83F8DEFB45E9970F803B6E01CF53475C,60261,13,15,2,109.44326,18.3075,1319
23466,180583,83F8DEFB45E9970F803B6E01CF53475C,31021,17,21,4,109.49021,18.27,1463
23467,180584,83F8DEFB45E9970F803B6E01CF53475C,60221,21,23,2,109.52569,18.29188,1616
23468,180592,2648BE3E594A9E0A865450E6976107E9,38094,0,13,13,109.45403,18.28778,1316
23472,180625,17E33F98086F9D71B1BE47BE6FC58756,30232,0,9,9,109.6191,18.31701,1971
23473,180626,17E33F98086F9D71B1BE47BE6FC58756,30861,10,12,2,109.52722,18.22743,1606
23474,180627,17E33F98086F9D71B1BE47BE6FC58756,39101,13,16,3,109.50132,18.24931,1509
23475,180628,17E33F98086F9D71B1BE47BE6FC58756,60381,19,20,1,109.5241,18.22458,1605
23476,180629,17E33F98086F9D71B1BE47BE6FC58756,30854,21,23,2,109.56889,18.27076,1763
23477,180632,8EB27D2E0095A9FF48E016863044B329,30854,18,19,1,109.56889,18.27076,1763
23478,180633,8EB27D2E0095A9FF48E016863044B329,31945,21,22,1,109.58021,18.29403,1817
23479,180639,C316CE65034FB3C77BE459147CBF943A,60291,0,8,8,109.50826,18.24639,1509
23480,180640,C316CE65034FB3C77BE459147CBF943A,30161,10,12,2,109.50042,18.24389,1508
23481,180641,C316CE65034FB3C77BE459147CBF943A,31181,12,15,3,109.50382,18.24813,1509
23482,180642,C316CE65034FB3C77BE459147CBF943A,30161,16,19,3,109.50042,18.24389,1508
23483,180643,C316CE65034FB3C77BE459147CBF943A,31181,19,23,4,109.50382,18.24813,1509
23490,180662,E1FCF6F0DAD733D65B4B7CF374C299B4,60054,0,5,5,109.3016,18.31229,770
23491,180663,E1FCF6F0DAD733D65B4B7CF374C299B4,30661,5,18,13,109.37028,18.24361,1008
23492,180697,F6B0C4B9BFBC5C0F5D704098C64B8B01,30861,19,21,2,109.52722,18.22743,1606
23493,180698,F6B0C4B9BFBC5C0F5D704098C64B8B01,30741,21,23,2,109.49833,18.28681,1516
23500,180736,776EC15CC06379D52F8D7E811FFEB172,30711,16,21,5,109.50271,18.25347,1510
23501,180743,F00821368F615DCDAF214035D8EC4A44,31071,0,6,6,109.58257,18.28458,1815
23502,180744,F00821368F615DCDAF214035D8EC4A44,30854,8,23,15,109.56889,18.27076,1763
23506,180776,934029FB5F97BCE114EDCE88F0393A63,30854,5,13,8,109.56889,18.27076,1763
23507,180777,934029FB5F97BCE114EDCE88F0393A63,30234,13,14,1,109.60681,18.29979,1918
23508,180778,28A89A8FEC174286EFBBD2F96B7BCF44,60241,18,21,3,109.53319,18.28667,1616
23509,180779,28A89A8FEC174286EFBBD2F96B7BCF44,60281,21,23,2,109.51743,18.25924,1561
23520,180816,AA17C9279A63248D7DCDF49F93EB8817,38275,9,17,8,109.62875,18.22938,2006
23521,180817,AA17C9279A63248D7DCDF49F93EB8817,30854,20,22,2,109.56889,18.27076,1763
23526,180842,A10AD66CE81CDFBC974C36FAC5FE4CAA,31071,5,8,3,109.58257,18.28458,1815
23527,180843,A10AD66CE81CDFBC974C36FAC5FE4CAA,30854,10,18,8,109.56889,18.27076,1763
23528,180844,6ED697962F10CC0C2236463F9FC9376B,30761,6,8,2,109.45201,18.3,1318
23529,180845,6ED697962F10CC0C2236463F9FC9376B,30821,9,18,9,109.43681,18.33639,1274
23530,180846,6ED697962F10CC0C2236463F9FC9376B,30761,19,22,3,109.45201,18.3,1318
23535,180857,26C399C5B5691882722617888E25101D,38154,0,19,19,109.5266,18.28278,1615
23536,180858,26C399C5B5691882722617888E25101D,31031,20,23,3,109.49979,18.25382,1510
23537,180870,54A6757CA4BF8A47C41CF1DDCA6EA505,30854,1,6,5,109.56889,18.27076,1763
23538,180871,54A6757CA4BF8A47C41CF1DDCA6EA505,60661,8,10,2,109.548,18.2377,1657
23539,180872,54A6757CA4BF8A47C41CF1DDCA6EA505,30361,13,16,3,109.50347,18.24,1508
23540,180893,F84D949DDCBF25D5530F771BC55E0B9D,61011,17,23,6,109.60653,18.19076,1900
23541,180903,07169E7114E4F14C073261BAAC0D4491,61011,4,6,2,109.60653,18.19076,1900
23542,180905,53490AD77ACCA93C3ED0F3DE79CA488B,31071,9,10,1,109.58257,18.28458,1815
23543,180906,53490AD77ACCA93C3ED0F3DE79CA488B,30854,10,21,11,109.56889,18.27076,1763
23551,180986,121138E269BBF0B506FA8CE6CEB3BF52,30711,19,20,1,109.50271,18.25347,1510
23552,180987,121138E269BBF0B506FA8CE6CEB3BF52,31931,21,22,1,109.54771,18.29403,1667
23553,180997,9C1407835BC54BEBDB541F52E1DA1820,61011,3,23,20,109.60653,18.19076,1900
23554,181017,C14397FECB4CD60D23F08FD75F05B3B4,30581,0,10,10,109.62257,18.24951,1959
23555,181018,C14397FECB4CD60D23F08FD75F05B3B4,31701,14,19,5,109.44132,18.28833,1266
23556,181019,C14397FECB4CD60D23F08FD75F05B3B4,60441,19,21,2,109.46792,18.28604,1366
23557,181020,C14397FECB4CD60D23F08FD75F05B3B4,38094,22,23,1,109.45403,18.28778,1316
23561,181089,59BC82AA673F3B026E4585AB957F187F,31521,0,10,10,109.51458,18.22542,1555
23562,181090,59BC82AA673F3B026E4585AB957F187F,60054,13,15,2,109.3016,18.31229,770
23563,181091,59BC82AA673F3B026E4585AB957F187F,31471,15,16,1,109.34583,18.29563,917
23564,181092,59BC82AA673F3B026E4585AB957F187F,31521,18,23,5,109.51458,18.22542,1555
23565,181126,B80D4B4CDBD08237A9C4254F8883AEF4,39151,0,7,7,109.49875,18.25097,1510
23566,181127,B80D4B4CDBD08237A9C4254F8883AEF4,60201,9,12,3,109.5041,18.2509,1510
23567,181128,B80D4B4CDBD08237A9C4254F8883AEF4,30711,12,14,2,109.50271,18.25347,1510
23568,181129,B80D4B4CDBD08237A9C4254F8883AEF4,31171,15,17,2,109.50938,18.24917,1559
23569,181130,B80D4B4CDBD08237A9C4254F8883AEF4,30171,20,21,1,109.48458,18.27139,1463
23573,181160,796A71B0D026A7B5CB7E27471C925E8B,30911,17,18,1,109.50493,18.26181,1511
23577,181229,8068F1EF55119CC805C3493D560CAAB3,30854,12,14,2,109.56889,18.27076,1763
23578,181230,8068F1EF55119CC805C3493D560CAAB3,31071,14,16,2,109.58257,18.28458,1815
23579,181231,8068F1EF55119CC805C3493D560CAAB3,30854,18,20,2,109.56889,18.27076,1763
23580,181232,99CBAA6A65A50998F0A10B72B36210E4,30271,0,4,4,109.49132,18.23153,1456
23581,181233,99CBAA6A65A50998F0A10B72B36210E4,60201,7,8,1,109.5041,18.2509,1510
23582,181234,99CBAA6A65A50998F0A10B72B36210E4,60084,10,11,1,109.4984,18.2334,1507
23583,181235,99CBAA6A65A50998F0A10B72B36210E4,60201,13,14,1,109.5041,18.2509,1510
23584,181236,99CBAA6A65A50998F0A10B72B36210E4,30051,14,18,4,109.48917,18.21215,1453
23585,181237,99CBAA6A65A50998F0A10B72B36210E4,60084,20,21,1,109.4984,18.2334,1507
23589,181256,0B625DE57093602A177FF6EF2935F6D3,31081,0,10,10,109.44639,18.30181,1318
23590,181257,0B625DE57093602A177FF6EF2935F6D3,31521,12,18,6,109.51458,18.22542,1555
23591,181258,0B625DE57093602A177FF6EF2935F6D3,60401,20,21,1,109.47444,18.27583,1414
23592,181259,0B625DE57093602A177FF6EF2935F6D3,31521,21,23,2,109.51458,18.22542,1555
23593,181275,84D09807769454188E86D49181B1B5D0,30421,0,13,13,109.50021,18.25861,1511
23594,181276,84D09807769454188E86D49181B1B5D0,31091,15,16,1,109.41201,18.31222,1170
23595,181277,84D09807769454188E86D49181B1B5D0,30421,17,19,2,109.50021,18.25861,1511
23596,181309,37D38EF0062E64D55C94EB554B76F9EE,30854,11,16,5,109.56889,18.27076,1763
23597,181310,37D38EF0062E64D55C94EB554B76F9EE,30291,20,21,1,109.50403,18.27028,1513
23602,181365,B89DA24132F66CAA79D695B4CC5F2909,60121,0,13,13,109.74507,18.37472,2430
23603,181367,B89DA24132F66CAA79D695B4CC5F2909,60121,19,23,4,109.74507,18.37472,2430
23607,181397,98C149D55643675CD88F276A1BCEA6F3,60321,0,1,1,109.63611,18.24306,2008
23608,181398,98C149D55643675CD88F276A1BCEA6F3,38134,5,8,3,109.63931,18.23451,2007
23609,181399,98C149D55643675CD88F276A1BCEA6F3,60321,8,10,2,109.63611,18.24306,2008
23610,181400,98C149D55643675CD88F276A1BCEA6F3,30854,10,15,5,109.56889,18.27076,1763
23611,181426,020753EF78F0A0C39658113A3377EA1E,30854,4,6,2,109.56889,18.27076,1763
23612,181427,020753EF78F0A0C39658113A3377EA1E,39183,8,9,1,109.55542,18.28208,1715
23613,181428,020753EF78F0A0C39658113A3377EA1E,31931,9,10,1,109.54771,18.29403,1667
23614,181429,020753EF78F0A0C39658113A3377EA1E,31561,11,14,3,109.56792,18.28479,1765
23615,181430,020753EF78F0A0C39658113A3377EA1E,39183,14,17,3,109.55542,18.28208,1715
23616,181431,020753EF78F0A0C39658113A3377EA1E,31561,18,22,4,109.56792,18.28479,1765
23617,181447,1122041491C04B199A15F6E1E401D68F,60281,0,1,1,109.51743,18.25924,1561
23618,181448,1122041491C04B199A15F6E1E401D68F,38881,1,7,6,109.51618,18.26431,1562
23619,181449,1122041491C04B199A15F6E1E401D68F,30711,10,11,1,109.50271,18.25347,1510
23620,181450,1122041491C04B199A15F6E1E401D68F,30461,12,13,1,109.5116,18.26313,1562
23621,181451,1122041491C04B199A15F6E1E401D68F,60281,15,18,3,109.51743,18.25924,1561
23622,181452,1122041491C04B199A15F6E1E401D68F,31031,19,20,1,109.49979,18.25382,1510
23623,181453,1122041491C04B199A15F6E1E401D68F,30461,21,23,2,109.5116,18.26313,1562
23627,181528,46FB195BB21573CE6CD85D42D7B06C1A,30854,7,10,3,109.56889,18.27076,1763
23628,181529,46FB195BB21573CE6CD85D42D7B06C1A,31164,12,15,3,109.69993,18.27215,2263
23629,181597,213AF2099653A4ADAEF799CCC144B279,30021,0,11,11,109.12014,18.40986,86
23634,181603,012ABD06F231728C214A4BA917E75B1C,30851,0,17,17,109.5616,18.27396,1713
23635,181604,012ABD06F231728C214A4BA917E75B1C,31561,19,23,4,109.56792,18.28479,1765
23636,181611,844EDA750B421C0DF1043A6AC4E51E70,30651,8,15,7,109.42611,18.385,1232
23637,181612,844EDA750B421C0DF1043A6AC4E51E70,38871,19,21,2,109.44681,18.28625,1316
23638,181613,844EDA750B421C0DF1043A6AC4E51E70,30651,21,23,2,109.42611,18.385,1232
23646,181663,FB20E84A4A99DC452BCC9B5660C3080F,39111,0,7,7,109.5191,18.22597,1555
23647,181664,FB20E84A4A99DC452BCC9B5660C3080F,60011,10,12,2,109.48965,18.30222,1468
23648,181665,FB20E84A4A99DC452BCC9B5660C3080F,30791,15,17,2,109.72333,18.40889,2386
23649,181666,FB20E84A4A99DC452BCC9B5660C3080F,31521,19,20,1,109.51458,18.22542,1555
23650,181667,FB20E84A4A99DC452BCC9B5660C3080F,31521,20,22,2,109.51458,18.22542,1555
23651,181677,CA63110F88D6457AD774A164FA870244,30271,6,8,2,109.49132,18.23153,1456
23652,181678,CA63110F88D6457AD774A164FA870244,60231,8,17,9,109.49903,18.21972,1504
23653,181679,CA63110F88D6457AD774A164FA870244,60084,21,23,2,109.4984,18.2334,1507
23654,181700,D9AE11CD16B231308C3F0FB3F53BC3E9,30854,0,1,1,109.56889,18.27076,1763
23655,181701,D9AE11CD16B231308C3F0FB3F53BC3E9,31071,2,7,5,109.58257,18.28458,1815
23656,181702,D9AE11CD16B231308C3F0FB3F53BC3E9,30854,9,11,2,109.56889,18.27076,1763
23657,181703,D9AE11CD16B231308C3F0FB3F53BC3E9,31071,12,13,1,109.58257,18.28458,1815
23658,181704,D9AE11CD16B231308C3F0FB3F53BC3E9,30854,14,15,1,109.56889,18.27076,1763
23659,181705,D9AE11CD16B231308C3F0FB3F53BC3E9,31071,16,17,1,109.58257,18.28458,1815
23660,181706,D9AE11CD16B231308C3F0FB3F53BC3E9,60641,18,19,1,109.53854,18.2359,1657
23661,181707,D9AE11CD16B231308C3F0FB3F53BC3E9,38241,20,23,3,109.54111,18.30542,1669
23662,181714,7BE3F2187062B105A4F6714C58D08E1A,31071,0,7,7,109.58257,18.28458,1815
23663,181715,7BE3F2187062B105A4F6714C58D08E1A,30951,7,13,6,109.56208,18.25667,1761
23664,181716,7BE3F2187062B105A4F6714C58D08E1A,31421,14,16,2,109.55382,18.22347,1705
23665,181717,7BE3F2187062B105A4F6714C58D08E1A,31071,17,23,6,109.58257,18.28458,1815
23673,181785,316CEA89BB7331FA8EA1A0930D8BA877,60491,2,10,8,109.43354,18.30847,1269
23674,181786,316CEA89BB7331FA8EA1A0930D8BA877,31031,11,13,2,109.49979,18.25382,1510
23675,181787,316CEA89BB7331FA8EA1A0930D8BA877,30711,16,23,7,109.50271,18.25347,1510
23682,181851,594298D66BAD5405EE1904C905FA9B12,30854,3,14,11,109.56889,18.27076,1763
23683,181852,594298D66BAD5405EE1904C905FA9B12,31071,14,15,1,109.58257,18.28458,1815
23690,181936,DC9973204E62AA99FA79F0696CF6C0F6,31945,0,7,7,109.58021,18.29403,1817
23691,181937,DC9973204E62AA99FA79F0696CF6C0F6,30854,8,12,4,109.56889,18.27076,1763
23692,181941,C983E73D646629A775690ECA8920EB29,31631,0,17,17,109.59542,18.36826,1879
23693,181942,C983E73D646629A775690ECA8920EB29,31031,19,20,1,109.49979,18.25382,1510
23694,181995,F1FA54BCDE7297F39D6C0507CA898D49,38361,1,2,1,109.43667,18.29201,1267
23695,181996,F1FA54BCDE7297F39D6C0507CA898D49,30731,3,6,3,109.50944,18.22306,1555
23696,181997,F1FA54BCDE7297F39D6C0507CA898D49,60551,8,13,5,109.42722,18.30111,1218
23697,181998,F1FA54BCDE7297F39D6C0507CA898D49,38361,14,16,2,109.43667,18.29201,1267
23698,181999,F1FA54BCDE7297F39D6C0507CA898D49,60551,17,18,1,109.42722,18.30111,1218
23699,182000,F1FA54BCDE7297F39D6C0507CA898D49,38361,19,23,4,109.43667,18.29201,1267
23700,182010,D4AA3869830031578B573FD0033C24A8,31931,0,9,9,109.54771,18.29403,1667
23701,182011,D4AA3869830031578B573FD0033C24A8,60371,9,19,10,109.53063,18.30056,1618
23705,182098,6422CB87ACC55DDEF6EBE8946593C808,31351,0,7,7,109.4959,18.28417,1465
23706,182099,6422CB87ACC55DDEF6EBE8946593C808,31851,7,10,3,109.71736,18.29007,2316
23707,182100,6422CB87ACC55DDEF6EBE8946593C808,60231,12,13,1,109.49903,18.21972,1504
23708,182101,6422CB87ACC55DDEF6EBE8946593C808,31351,17,23,6,109.4959,18.28417,1465
23712,182166,73E41EC2402BE125BFADB41C15633348,39191,0,8,8,109.51493,18.23472,1557
23713,182167,73E41EC2402BE125BFADB41C15633348,60463,10,13,3,109.52507,18.22438,1605
23714,182169,9AA959ED87D1ECC3053DED17290EFCBD,31561,10,20,10,109.56792,18.28479,1765
23715,182170,9AA959ED87D1ECC3053DED17290EFCBD,39183,21,23,2,109.55542,18.28208,1715
23716,182206,ACEF2E5153AE9E10B2F445536315664A,31031,19,21,2,109.49979,18.25382,1510
23717,182207,ACEF2E5153AE9E10B2F445536315664A,39151,21,23,2,109.49875,18.25097,1510
23718,182227,D96E01B8E0F0DE9C160C9FEAFDCFDB6D,31021,9,10,1,109.49021,18.27,1463
23719,182228,D96E01B8E0F0DE9C160C9FEAFDCFDB6D,31071,12,13,1,109.58257,18.28458,1815
23720,182229,D96E01B8E0F0DE9C160C9FEAFDCFDB6D,30854,14,23,9,109.56889,18.27076,1763
23721,182240,C6812E7C0E8E7B7313DC722FACB50779,30854,0,12,12,109.56889,18.27076,1763
23722,182241,C6812E7C0E8E7B7313DC722FACB50779,31945,13,15,2,109.58021,18.29403,1817
23723,182262,AA12884D86AA6006A6349FC5858AD75E,38325,16,18,2,109.39792,18.2909,1116
23724,182263,AA12884D86AA6006A6349FC5858AD75E,31201,19,20,1,109.51042,18.23819,1558
23725,182264,AA12884D86AA6006A6349FC5858AD75E,38903,20,23,3,109.39229,18.29243,1117
23726,182265,C6FE4CF0CD47303AD7F7EC5A71315B10,30851,3,9,6,109.5616,18.27396,1713
23727,182266,C6FE4CF0CD47303AD7F7EC5A71315B10,38275,10,21,11,109.62875,18.22938,2006
23728,182272,7084657DF30063A945AAA5EF4742695F,39183,0,2,2,109.55542,18.28208,1715
23729,182273,7084657DF30063A945AAA5EF4742695F,31561,2,6,4,109.56792,18.28479,1765
23730,182274,7084657DF30063A945AAA5EF4742695F,31931,8,11,3,109.54771,18.29403,1667
23731,182275,7084657DF30063A945AAA5EF4742695F,39183,11,13,2,109.55542,18.28208,1715
23732,182276,7084657DF30063A945AAA5EF4742695F,31931,14,16,2,109.54771,18.29403,1667
23733,182277,7084657DF30063A945AAA5EF4742695F,31071,19,20,1,109.58257,18.28458,1815
23734,182278,7084657DF30063A945AAA5EF4742695F,39183,21,23,2,109.55542,18.28208,1715
23735,182306,5B5FB16F9BE2A1826D497C2695908410,30854,14,15,1,109.56889,18.27076,1763
23736,182307,5B5FB16F9BE2A1826D497C2695908410,31561,18,19,1,109.56792,18.28479,1765
23737,182308,5B5FB16F9BE2A1826D497C2695908410,60371,20,21,1,109.53063,18.30056,1618
23738,182345,7426A8B55792A8B93D9B7B93370F4B93,60524,0,6,6,109.42951,18.28993,1216
23739,182346,7426A8B55792A8B93D9B7B93370F4B93,60071,10,12,2,109.75674,18.31583,2470
23740,182347,7426A8B55792A8B93D9B7B93370F4B93,30351,16,17,1,109.41701,18.29292,1217
23741,182348,7426A8B55792A8B93D9B7B93370F4B93,60552,18,19,1,109.41729,18.30014,1218
23742,182349,7426A8B55792A8B93D9B7B93370F4B93,60524,20,22,2,109.42951,18.28993,1216
23743,182350,7426A8B55792A8B93D9B7B93370F4B93,30351,22,23,1,109.41701,18.29292,1217
23747,182434,7D1ED6067ECBD941EFC43CE0A6ADAE71,31071,2,3,1,109.58257,18.28458,1815
23748,182435,7D1ED6067ECBD941EFC43CE0A6ADAE71,30854,6,16,10,109.56889,18.27076,1763
23749,182436,7D1ED6067ECBD941EFC43CE0A6ADAE71,60463,18,21,3,109.52507,18.22438,1605
23750,182437,84599FEEE94509A3E8D44F4C45C7CC01,31671,0,7,7,109.38965,18.29813,1068
23751,182438,84599FEEE94509A3E8D44F4C45C7CC01,31681,8,10,2,109.40396,18.29979,1168
23752,182439,84599FEEE94509A3E8D44F4C45C7CC01,60041,11,15,4,109.39889,18.31944,1121
23753,182440,84599FEEE94509A3E8D44F4C45C7CC01,31681,15,17,2,109.40396,18.29979,1168
23754,182441,84599FEEE94509A3E8D44F4C45C7CC01,31091,17,19,2,109.41201,18.31222,1170
23755,182442,84599FEEE94509A3E8D44F4C45C7CC01,31671,20,23,3,109.38965,18.29813,1068
23762,182465,C69D9D9A56587BE98796607AF04788C3,31521,0,7,7,109.51458,18.22542,1555
23763,182466,C69D9D9A56587BE98796607AF04788C3,60552,8,9,1,109.41729,18.30014,1218
23764,182484,83F5F6CBF2A63352524671B510BBFB08,30191,0,7,7,109.50361,18.22701,1506
23765,182485,83F5F6CBF2A63352524671B510BBFB08,31145,10,13,3,109.20431,18.30479,369
23766,182486,83F5F6CBF2A63352524671B510BBFB08,30191,15,23,8,109.50361,18.22701,1506
23767,182496,A503639E15A0B5D04B0130D882921438,31031,0,18,18,109.49979,18.25382,1510
23768,182497,A503639E15A0B5D04B0130D882921438,31031,19,23,4,109.49979,18.25382,1510
23769,182512,8255A2F4BC245ABC1F6126838351DBA2,39183,18,19,1,109.55542,18.28208,1715
23770,182513,8255A2F4BC245ABC1F6126838351DBA2,30854,21,23,2,109.56889,18.27076,1763
23771,182516,FD5B9AB034F15F72E8BEF02193669238,31931,8,11,3,109.54771,18.29403,1667
23772,182517,FD5B9AB034F15F72E8BEF02193669238,60241,11,13,2,109.53319,18.28667,1616
23773,182518,FD5B9AB034F15F72E8BEF02193669238,30921,16,17,1,109.53903,18.29451,1667
23774,182519,FD5B9AB034F15F72E8BEF02193669238,60241,19,23,4,109.53319,18.28667,1616
23775,182520,A83BD14E399B6923A1B4678B4F192AC2,60221,0,10,10,109.52569,18.29188,1616
23776,182521,A83BD14E399B6923A1B4678B4F192AC2,60241,11,13,2,109.53319,18.28667,1616
23777,182522,A83BD14E399B6923A1B4678B4F192AC2,31351,13,14,1,109.4959,18.28417,1465
23778,182523,A83BD14E399B6923A1B4678B4F192AC2,39091,17,19,2,109.50097,18.25222,1510
23779,182524,A83BD14E399B6923A1B4678B4F192AC2,30741,20,22,2,109.49833,18.28681,1516
23780,182537,51DF765CB634D9549D20AD1F2C37BA18,31561,9,10,1,109.56792,18.28479,1765
23781,182538,51DF765CB634D9549D20AD1F2C37BA18,30854,11,12,1,109.56889,18.27076,1763
23782,182539,51DF765CB634D9549D20AD1F2C37BA18,31561,15,19,4,109.56792,18.28479,1765
23783,182546,04ABA8BFD5D63DDF1B83BA0577C9019C,31071,9,10,1,109.58257,18.28458,1815
23784,182547,04ABA8BFD5D63DDF1B83BA0577C9019C,39371,12,18,6,109.56627,18.2646,1762
23785,182563,00678D3F0FE479614070948AEC721AF0,31561,0,10,10,109.56792,18.28479,1765
23786,182564,00678D3F0FE479614070948AEC721AF0,30854,12,20,8,109.56889,18.27076,1763
23787,182588,F7305868296354D8CCFF78E71B73969B,60391,1,6,5,109.47667,18.28757,1416
23788,182608,E9E473F09C342630187345312F4A31D8,39181,0,8,8,109.55153,18.28035,1715
23789,182609,E9E473F09C342630187345312F4A31D8,31931,9,10,1,109.54771,18.29403,1667
23790,182610,E9E473F09C342630187345312F4A31D8,39181,11,14,3,109.55153,18.28035,1715
23791,182611,E9E473F09C342630187345312F4A31D8,31931,14,15,1,109.54771,18.29403,1667
23792,182612,E9E473F09C342630187345312F4A31D8,39181,17,23,6,109.55153,18.28035,1715
23796,182646,A5A15F9723FE4E2C95CB1DC28822F214,31071,0,7,7,109.58257,18.28458,1815
23797,182647,A5A15F9723FE4E2C95CB1DC28822F214,30854,10,21,11,109.56889,18.27076,1763
23798,182660,65E68B83464639D712CFAC5226A0F5CB,39321,0,12,12,109.529,18.2167,1604
23799,182661,65E68B83464639D712CFAC5226A0F5CB,60131,13,14,1,109.49819,18.24778,1509
23800,182662,65E68B83464639D712CFAC5226A0F5CB,38754,16,18,2,109.74667,18.37382,2430
23801,182663,65E68B83464639D712CFAC5226A0F5CB,60541,21,23,2,109.4084,18.29208,1167
23808,182723,60C76AD19DF8888A84F620E94C92FF2B,60084,0,14,14,109.4984,18.2334,1507
23809,182724,60C76AD19DF8888A84F620E94C92FF2B,30271,15,17,2,109.49132,18.23153,1456
23810,182725,60C76AD19DF8888A84F620E94C92FF2B,60084,17,18,1,109.4984,18.2334,1507
23811,182726,60C76AD19DF8888A84F620E94C92FF2B,60231,18,20,2,109.49903,18.21972,1504
23812,182727,60C76AD19DF8888A84F620E94C92FF2B,60084,20,21,1,109.4984,18.2334,1507
23813,182728,60C76AD19DF8888A84F620E94C92FF2B,60231,21,23,2,109.49903,18.21972,1504
23814,182795,2AE38FAF341950B0B91404FFCE5A0F3E,30921,7,16,9,109.53903,18.29451,1667
23815,182796,2AE38FAF341950B0B91404FFCE5A0F3E,31931,20,23,3,109.54771,18.29403,1667
23819,182800,8DA877D3A30401F86E81FB7BC1CA2A00,31071,5,7,2,109.58257,18.28458,1815
23820,182801,8DA877D3A30401F86E81FB7BC1CA2A00,30854,10,16,6,109.56889,18.27076,1763
23825,182808,859E4192F6E8E2E3F5C7174B3CFA1BB4,30351,0,7,7,109.41701,18.29292,1217
23826,182809,859E4192F6E8E2E3F5C7174B3CFA1BB4,33481,9,13,4,109.67278,18.41278,2187
23827,182810,859E4192F6E8E2E3F5C7174B3CFA1BB4,33051,14,15,1,109.6475,18.46618,2096
23828,182811,859E4192F6E8E2E3F5C7174B3CFA1BB4,30351,17,22,5,109.41701,18.29292,1217
23829,182830,765716C073B71E5A4C89E173E62DD881,60311,0,7,7,109.52097,18.24319,1558
23830,182831,765716C073B71E5A4C89E173E62DD881,31931,10,15,5,109.54771,18.29403,1667
23831,182832,765716C073B71E5A4C89E173E62DD881,60671,16,17,1,109.52979,18.31757,1621
23832,182833,765716C073B71E5A4C89E173E62DD881,60311,19,23,4,109.52097,18.24319,1558
23833,182869,9ECDB9C3F97E311C1827C02496967431,60371,0,7,7,109.53063,18.30056,1618
23834,182870,9ECDB9C3F97E311C1827C02496967431,30101,8,9,1,109.57299,18.33333,1773
23835,182871,9ECDB9C3F97E311C1827C02496967431,60371,10,13,3,109.53063,18.30056,1618
23836,182872,9ECDB9C3F97E311C1827C02496967431,30701,14,16,2,109.59313,18.32007,1871
23837,182873,9ECDB9C3F97E311C1827C02496967431,30101,16,17,1,109.57299,18.33333,1773
23838,182874,9ECDB9C3F97E311C1827C02496967431,60371,18,20,2,109.53063,18.30056,1618
23839,182902,14AE6C820CE45F96077630992CABD33D,31551,8,11,3,109.55868,18.24222,1708
23840,182903,14AE6C820CE45F96077630992CABD33D,39371,11,13,2,109.56627,18.2646,1762
23841,182904,14AE6C820CE45F96077630992CABD33D,30951,15,22,7,109.56208,18.25667,1761
23842,182907,DFFF17B7FE30E79B8AABBB5CE171272F,39183,2,6,4,109.55542,18.28208,1715
23843,182908,DFFF17B7FE30E79B8AABBB5CE171272F,31561,6,7,1,109.56792,18.28479,1765
23844,182909,DFFF17B7FE30E79B8AABBB5CE171272F,39183,8,10,2,109.55542,18.28208,1715
23845,182910,DFFF17B7FE30E79B8AABBB5CE171272F,31561,11,13,2,109.56792,18.28479,1765
23846,182911,DFFF17B7FE30E79B8AABBB5CE171272F,39183,16,18,2,109.55542,18.28208,1715
23847,182912,DFFF17B7FE30E79B8AABBB5CE171272F,31561,20,22,2,109.56792,18.28479,1765
23848,182945,B34415F599F0ED7D1A073EE314A60B9B,31671,1,19,18,109.38965,18.29813,1068
23849,182946,B34415F599F0ED7D1A073EE314A60B9B,60041,22,23,1,109.39889,18.31944,1121
23850,182968,A312E6CD7504A7FEBB46DDC68FE4A7A1,39091,0,10,10,109.50097,18.25222,1510
23851,182969,A312E6CD7504A7FEBB46DDC68FE4A7A1,31471,12,14,2,109.34583,18.29563,917
23852,182970,A312E6CD7504A7FEBB46DDC68FE4A7A1,30711,18,23,5,109.50271,18.25347,1510
23853,182997,DCFC026A83B81F5FB8797C8205011404,31031,20,21,1,109.49979,18.25382,1510
23854,182998,DCFC026A83B81F5FB8797C8205011404,60084,22,23,1,109.4984,18.2334,1507
23861,183025,13BA422D9C6FCE9CD249F0603D3E98AC,30421,18,20,2,109.50021,18.25861,1511
23862,183026,13BA422D9C6FCE9CD249F0603D3E98AC,31701,20,21,1,109.44132,18.28833,1266
23863,183027,13BA422D9C6FCE9CD249F0603D3E98AC,31431,21,23,2,109.44639,18.29042,1316
23864,183028,29A22EA607E99C159FB2EC8DBCE0862B,30381,1,6,5,109.52521,18.24507,1609
23865,183029,29A22EA607E99C159FB2EC8DBCE0862B,38297,7,10,3,109.52576,18.24965,1609
23866,183030,29A22EA607E99C159FB2EC8DBCE0862B,30381,10,13,3,109.52521,18.24507,1609
23867,183031,29A22EA607E99C159FB2EC8DBCE0862B,38911,13,14,1,109.51674,18.24965,1559
23868,183032,29A22EA607E99C159FB2EC8DBCE0862B,30381,16,21,5,109.52521,18.24507,1609
23869,183039,B6B3717614F59DDB2BC10343DA931DEF,30854,0,7,7,109.56889,18.27076,1763
23870,183040,B6B3717614F59DDB2BC10343DA931DEF,31101,9,19,10,109.65389,18.23403,2057
23871,183041,B6B3717614F59DDB2BC10343DA931DEF,39183,19,21,2,109.55542,18.28208,1715
23872,183044,10E6DCB22C04D9E1B01193CDA87B3193,30721,20,21,1,109.51597,18.28257,1565
23873,183045,10E6DCB22C04D9E1B01193CDA87B3193,38154,22,23,1,109.5266,18.28278,1615
23874,183145,59FB777BFFD6221B504D668D06677EAC,38017,0,6,6,109.49729,18.21424,1504
23875,183146,59FB777BFFD6221B504D668D06677EAC,38017,7,9,2,109.49729,18.21424,1504
23876,183147,59FB777BFFD6221B504D668D06677EAC,31781,13,14,1,109.19847,18.2975,367
23877,183148,59FB777BFFD6221B504D668D06677EAC,38017,16,18,2,109.49729,18.21424,1504
23878,183149,59FB777BFFD6221B504D668D06677EAC,30711,19,21,2,109.50271,18.25347,1510
23879,183150,59FB777BFFD6221B504D668D06677EAC,38017,22,23,1,109.49729,18.21424,1504
23880,183168,5232A1F9DD43FADD1ACE9CE9BD82FED1,33521,10,12,2,109.66313,18.45174,2143
23881,183169,5232A1F9DD43FADD1ACE9CE9BD82FED1,39131,14,23,9,109.2066,18.29639,417
23882,183176,E1474E300BEF909C99028517459A2449,30854,0,10,10,109.56889,18.27076,1763
23883,183177,E1474E300BEF909C99028517459A2449,60501,14,16,2,109.48701,18.29021,1466
23884,183178,E1474E300BEF909C99028517459A2449,60614,20,23,3,109.48799,18.29521,1467
23885,183187,18B397C6C5E352538250AEDC640C72E3,30581,7,18,11,109.62257,18.24951,1959
23886,183188,18B397C6C5E352538250AEDC640C72E3,30232,20,23,3,109.6191,18.31701,1971
23887,183189,CE100D093BF3BFDD6A311D9723805BCC,30651,4,5,1,109.42611,18.385,1232
23888,183190,CE100D093BF3BFDD6A311D9723805BCC,38871,6,7,1,109.44681,18.28625,1316
23889,183232,F6355456D841CBD98F176AAD0DC166BC,30151,0,8,8,109.50986,18.25083,1560
23890,183233,F6355456D841CBD98F176AAD0DC166BC,60411,12,14,2,109.32514,18.30854,869
23891,183234,F6355456D841CBD98F176AAD0DC166BC,31031,16,17,1,109.49979,18.25382,1510
23892,183235,F6355456D841CBD98F176AAD0DC166BC,30151,20,23,3,109.50986,18.25083,1560
23897,183242,CD6BC9843B399CA50E6DC7ED58C0E9DC,60631,0,1,1,109.57778,18.27583,1814
23898,183243,CD6BC9843B399CA50E6DC7ED58C0E9DC,31071,2,20,18,109.58257,18.28458,1815
23903,183257,5106C265E7997749AD66854B6E7AAB9E,38754,11,13,2,109.74667,18.37382,2430
23904,183258,5106C265E7997749AD66854B6E7AAB9E,30361,17,18,1,109.50347,18.24,1508
23905,183283,102A3C1C3179D6FF6A52B59C3B4087A1,39091,0,8,8,109.50097,18.25222,1510
23906,183284,102A3C1C3179D6FF6A52B59C3B4087A1,30711,10,12,2,109.50271,18.25347,1510
23907,183285,38CF8AD578A393476F29705A4599B8B1,38271,0,2,2,109.62632,18.23049,1956
23908,183286,38CF8AD578A393476F29705A4599B8B1,31201,4,7,3,109.51042,18.23819,1558
23909,183287,38CF8AD578A393476F29705A4599B8B1,38271,11,22,11,109.62632,18.23049,1956
23913,183371,27229B6D41BD7CDDDAA38911093865DB,38085,5,13,8,109.6291,18.23625,2007
23914,183372,27229B6D41BD7CDDDAA38911093865DB,30854,16,23,7,109.56889,18.27076,1763
23915,183411,E218C587552A5DADC05C4E69685FE374,30854,16,21,5,109.56889,18.27076,1763
23916,183412,E218C587552A5DADC05C4E69685FE374,39371,22,23,1,109.56627,18.2646,1762
23917,183489,1D8B814EC83D52D7C5F3FED99C129EE0,60631,0,2,2,109.57778,18.27583,1814
23918,183490,1D8B814EC83D52D7C5F3FED99C129EE0,30854,4,9,5,109.56889,18.27076,1763
23919,183491,1D8B814EC83D52D7C5F3FED99C129EE0,38271,11,20,9,109.62632,18.23049,1956
23920,183492,1D8B814EC83D52D7C5F3FED99C129EE0,30851,22,23,1,109.5616,18.27396,1713
23921,183531,960E6AF880A0B0147E779761A652C7F1,30511,18,19,1,109.51069,18.24208,1558
23922,183532,960E6AF880A0B0147E779761A652C7F1,31391,20,23,3,109.50382,18.24285,1508
23923,183557,F04654AC056A2E82B670DFA8C627A5F2,30071,13,15,2,109.52819,18.30472,1619
23924,183558,F04654AC056A2E82B670DFA8C627A5F2,30081,18,23,5,109.50243,18.26632,1512
23925,183577,C6BDCA078DA12C36FBCA53FDC4E2A328,38275,4,9,5,109.62875,18.22938,2006
23926,183578,C6BDCA078DA12C36FBCA53FDC4E2A328,38754,11,14,3,109.74667,18.37382,2430
23927,183592,D11BB8B2E4EFB2DA119C7E6F9B91E70A,30421,11,13,2,109.50021,18.25861,1511
23928,183593,D11BB8B2E4EFB2DA119C7E6F9B91E70A,31201,13,15,2,109.51042,18.23819,1558
23929,183594,D11BB8B2E4EFB2DA119C7E6F9B91E70A,39321,18,20,2,109.529,18.2167,1604
23930,183595,D11BB8B2E4EFB2DA119C7E6F9B91E70A,31521,21,23,2,109.51458,18.22542,1555
23931,183605,4F1F2C63B1D8098AD9ABA50013979078,30151,0,11,11,109.50986,18.25083,1560
23932,183606,4F1F2C63B1D8098AD9ABA50013979078,30711,12,13,1,109.50271,18.25347,1510
23933,183607,4F1F2C63B1D8098AD9ABA50013979078,60201,15,16,1,109.5041,18.2509,1510
23934,183608,4F1F2C63B1D8098AD9ABA50013979078,30421,18,19,1,109.50021,18.25861,1511
23935,183609,4F1F2C63B1D8098AD9ABA50013979078,30321,20,22,2,109.49563,18.29611,1467
23936,183645,EEC6B662D07BE95423A2DC77D2E69188,31071,0,11,11,109.58257,18.28458,1815
23937,183646,EEC6B662D07BE95423A2DC77D2E69188,30854,13,16,3,109.56889,18.27076,1763
23938,183647,EEC6B662D07BE95423A2DC77D2E69188,31071,16,17,1,109.58257,18.28458,1815
23939,183648,EEC6B662D07BE95423A2DC77D2E69188,30854,19,21,2,109.56889,18.27076,1763
23940,183649,EEC6B662D07BE95423A2DC77D2E69188,31071,21,22,1,109.58257,18.28458,1815
23941,183672,FA5380545CCB9B0D320F8A515A2E8C57,60391,8,14,6,109.47667,18.28757,1416
23942,183673,FA5380545CCB9B0D320F8A515A2E8C57,60391,18,21,3,109.47667,18.28757,1416
23943,183691,628B56F9AD0921837C78826286456231,60552,0,4,4,109.41729,18.30014,1218
23944,183692,628B56F9AD0921837C78826286456231,31236,6,8,2,109.42965,18.29111,1216
23945,183693,628B56F9AD0921837C78826286456231,31781,10,11,1,109.19847,18.2975,367
23946,183694,628B56F9AD0921837C78826286456231,60054,14,15,1,109.3016,18.31229,770
23947,183695,628B56F9AD0921837C78826286456231,31091,20,23,3,109.41201,18.31222,1170
23948,183703,6BF671BC76B2463D72102139E4EB1018,60371,15,16,1,109.53063,18.30056,1618
23953,183728,34F2C4C2BDA247D8772C3C689C546CCB,31021,18,20,2,109.49021,18.27,1463
23954,183729,34F2C4C2BDA247D8772C3C689C546CCB,30171,21,23,2,109.48458,18.27139,1463
23955,183733,C7A4B55787295F6419B55AB029D11243,38251,0,2,2,109.49618,18.25493,1510
23956,183734,C7A4B55787295F6419B55AB029D11243,31531,3,5,2,109.49583,18.25972,1461
23957,183735,C7A4B55787295F6419B55AB029D11243,38251,5,13,8,109.49618,18.25493,1510
23958,183736,C7A4B55787295F6419B55AB029D11243,30421,13,17,4,109.50021,18.25861,1511
23959,183737,C7A4B55787295F6419B55AB029D11243,38251,17,22,5,109.49618,18.25493,1510
23963,183792,C462628FF36F8FF2D0B7493E6DDA38BB,60411,0,1,1,109.32514,18.30854,869
23964,183793,C462628FF36F8FF2D0B7493E6DDA38BB,30661,2,13,11,109.37028,18.24361,1008
23965,183794,C462628FF36F8FF2D0B7493E6DDA38BB,60411,14,17,3,109.32514,18.30854,869
23966,183795,5B058EBBD270D4814B560F0B36F48A4A,30351,0,8,8,109.41701,18.29292,1217
23967,183831,036DFEF8CA623F9034F928149FE2468D,30651,0,2,2,109.42611,18.385,1232
23968,183832,036DFEF8CA623F9034F928149FE2468D,30821,3,22,19,109.43681,18.33639,1274
23969,183833,FCFB14BA36BDB7CD6A39612B9AE933B2,39181,14,17,3,109.55153,18.28035,1715
23970,183834,FCFB14BA36BDB7CD6A39612B9AE933B2,38127,18,23,5,109.50833,18.27222,1513
23971,183835,F8D799D9161B0143E0D71C40472A357E,30071,0,18,18,109.52819,18.30472,1619
23972,183836,F8D799D9161B0143E0D71C40472A357E,30071,19,23,4,109.52819,18.30472,1619
23976,183884,F37B07A401D9C93406CC2037F09DFFEF,60161,10,11,1,109.49174,18.26181,1461
23977,183885,F37B07A401D9C93406CC2037F09DFFEF,30051,12,16,4,109.48917,18.21215,1453
23978,183886,F37B07A401D9C93406CC2037F09DFFEF,38105,19,20,1,109.40299,18.29229,1117
23979,183894,D12046233C14C8451AD4125CF88323E3,30201,1,7,6,109.4909,18.26465,1462
23980,183896,D12046233C14C8451AD4125CF88323E3,31021,15,23,8,109.49021,18.27,1463
23981,183916,C58D0182BFC61ED113EE3B09763C30B2,38185,0,7,7,109.51333,18.27347,1563
23982,183917,C58D0182BFC61ED113EE3B09763C30B2,30281,7,9,2,109.50597,18.27583,1514
23983,183918,C58D0182BFC61ED113EE3B09763C30B2,38127,10,15,5,109.50833,18.27222,1513
23984,183919,C58D0182BFC61ED113EE3B09763C30B2,30711,19,20,1,109.50271,18.25347,1510
23985,183920,C58D0182BFC61ED113EE3B09763C30B2,38185,21,23,2,109.51333,18.27347,1563
23989,183952,26CF9A9D015D5F6BC87A922112E6EBE3,31351,0,6,6,109.4959,18.28417,1465
23990,183953,26CF9A9D015D5F6BC87A922112E6EBE3,60552,8,9,1,109.41729,18.30014,1218
23991,184030,4053323049FA57896819CD5356E38746,31071,0,1,1,109.58257,18.28458,1815
23992,184031,4053323049FA57896819CD5356E38746,30854,2,21,19,109.56889,18.27076,1763
23993,184034,9BF33DB1F7AC1D27E06AF501C14CCF2C,31931,0,16,16,109.54771,18.29403,1667
23994,184035,9BF33DB1F7AC1D27E06AF501C14CCF2C,30711,19,20,1,109.50271,18.25347,1510
23995,184036,9BF33DB1F7AC1D27E06AF501C14CCF2C,31931,21,23,2,109.54771,18.29403,1667
23999,184058,E649CF84A26278291AA1A5B5C5D01FCA,30854,0,2,2,109.56889,18.27076,1763
24000,184059,E649CF84A26278291AA1A5B5C5D01FCA,31561,3,9,6,109.56792,18.28479,1765
24001,184065,27CFDDBDBE225F8224792B641031B794,31531,16,20,4,109.49583,18.25972,1461
24002,184066,27CFDDBDBE225F8224792B641031B794,30351,21,23,2,109.41701,18.29292,1217
24003,184112,6C0260646767B781577B5B8CE2471E51,38484,7,17,10,109.53028,18.31528,1620
24004,184113,6C0260646767B781577B5B8CE2471E51,30321,18,19,1,109.49563,18.29611,1467
24005,184114,6C0260646767B781577B5B8CE2471E51,38484,19,21,2,109.53028,18.31528,1620
24006,184115,6C0260646767B781577B5B8CE2471E51,38484,22,23,1,109.53028,18.31528,1620
24007,184131,52626520133C58C019E9712FB19D3224,38754,15,17,2,109.74667,18.37382,2430
24008,184132,52626520133C58C019E9712FB19D3224,31091,17,19,2,109.41201,18.31222,1170
24009,184133,52626520133C58C019E9712FB19D3224,30351,19,21,2,109.41701,18.29292,1217
24013,184194,26B686A42B220020984171EC7BD6742F,30854,11,12,1,109.56889,18.27076,1763
24014,184195,26B686A42B220020984171EC7BD6742F,31071,13,14,1,109.58257,18.28458,1815
24015,184196,26B686A42B220020984171EC7BD6742F,39183,15,22,7,109.55542,18.28208,1715
24016,184202,431D43589A63BFD6130F6E2FA2B0A71E,31471,13,15,2,109.34583,18.29563,917
24017,184203,431D43589A63BFD6130F6E2FA2B0A71E,30821,16,17,1,109.43681,18.33639,1274
24018,184204,431D43589A63BFD6130F6E2FA2B0A71E,31271,19,22,3,109.48958,18.26257,1462
24019,184213,A59893CF63A9A48BE0D9E2ED611A9BB2,60201,12,14,2,109.5041,18.2509,1510
24020,184214,A59893CF63A9A48BE0D9E2ED611A9BB2,30084,16,18,2,109.50118,18.26972,1513
24021,184220,F102C83FDC4F60C20EE0AB8CFB5C476F,30661,19,20,1,109.37028,18.24361,1008
24022,184221,F102C83FDC4F60C20EE0AB8CFB5C476F,60411,21,22,1,109.32514,18.30854,869
24023,184229,FF811E88FEA9CBDF12E5CC54DEE7CCA1,39371,17,18,1,109.56627,18.2646,1762
24024,184230,FF811E88FEA9CBDF12E5CC54DEE7CCA1,30232,19,21,2,109.6191,18.31701,1971
24025,184231,FF811E88FEA9CBDF12E5CC54DEE7CCA1,39371,21,23,2,109.56627,18.2646,1762
24034,184283,B2035C0684FF9CA861B7EB217CE5A160,60524,1,5,4,109.42951,18.28993,1216
24035,184284,B2035C0684FF9CA861B7EB217CE5A160,31091,6,8,2,109.41201,18.31222,1170
24036,184285,B2035C0684FF9CA861B7EB217CE5A160,30351,8,17,9,109.41701,18.29292,1217
24037,184286,B2035C0684FF9CA861B7EB217CE5A160,60041,18,20,2,109.39889,18.31944,1121
24038,184287,B2035C0684FF9CA861B7EB217CE5A160,31236,20,22,2,109.42965,18.29111,1216
24039,184288,B2035C0684FF9CA861B7EB217CE5A160,60041,22,23,1,109.39889,18.31944,1121
24040,184304,507CF3D1EACF4732FFA920666B1242A1,31021,18,19,1,109.49021,18.27,1463
24041,184305,507CF3D1EACF4732FFA920666B1242A1,30171,20,22,2,109.48458,18.27139,1463
24046,184386,E8BAAF476E8FE57075BAB1A8D4FF1780,30232,9,10,1,109.6191,18.31701,1971
24047,184387,E8BAAF476E8FE57075BAB1A8D4FF1780,39371,12,16,4,109.56627,18.2646,1762
24051,184423,56262E863531B59958C9E3F1A20F4447,38094,0,18,18,109.45403,18.28778,1316
24052,184424,56262E863531B59958C9E3F1A20F4447,30361,19,20,1,109.50347,18.24,1508
24053,184425,56262E863531B59958C9E3F1A20F4447,38094,21,22,1,109.45403,18.28778,1316
24061,184508,798BF3B08F72A16A6DEAAA235F1899BB,61011,2,17,15,109.60653,18.19076,1900
24062,184561,158EE23AC5B5E1F3FF8412E7F820E901,31561,18,20,2,109.56792,18.28479,1765
24063,184562,158EE23AC5B5E1F3FF8412E7F820E901,31071,21,22,1,109.58257,18.28458,1815
24064,184580,B3F017F7A9A81643FF9F81D88A6BEE4A,30854,16,18,2,109.56889,18.27076,1763
24065,184581,B3F017F7A9A81643FF9F81D88A6BEE4A,31071,19,20,1,109.58257,18.28458,1815
24069,184590,F30BE9C9754710CDCA5A89A96F673E96,30351,15,17,2,109.41701,18.29292,1217
24070,184591,F30BE9C9754710CDCA5A89A96F673E96,60524,22,23,1,109.42951,18.28993,1216
24071,184628,0C70A52F592FCFAC1CDC42762C9A17A0,31571,0,1,1,109.61563,18.23326,1957
24072,184629,0C70A52F592FCFAC1CDC42762C9A17A0,38085,4,7,3,109.6291,18.23625,2007
24073,184630,0C70A52F592FCFAC1CDC42762C9A17A0,60381,12,13,1,109.5241,18.22458,1605
24074,184631,0C70A52F592FCFAC1CDC42762C9A17A0,31473,16,17,1,109.34792,18.29465,917
24075,184632,0C70A52F592FCFAC1CDC42762C9A17A0,31041,18,20,2,109.50278,18.23701,1507
24076,184633,0C70A52F592FCFAC1CDC42762C9A17A0,38085,21,23,2,109.6291,18.23625,2007
24077,184645,FC9B7FD2465F862BBF1D529A5948B21C,30201,0,8,8,109.4909,18.26465,1462
24078,184646,FC9B7FD2465F862BBF1D529A5948B21C,38291,8,11,3,109.51618,18.24313,1558
24079,184647,FC9B7FD2465F862BBF1D529A5948B21C,30201,12,15,3,109.4909,18.26465,1462
24080,184648,FC9B7FD2465F862BBF1D529A5948B21C,38291,15,17,2,109.51618,18.24313,1558
24081,184649,FC9B7FD2465F862BBF1D529A5948B21C,30421,18,20,2,109.50021,18.25861,1511
24082,184686,3B8907096B5BACD5BD7132435146A19A,30661,1,6,5,109.37028,18.24361,1008
24083,184687,3B8907096B5BACD5BD7132435146A19A,60161,10,11,1,109.49174,18.26181,1461
24084,184688,3B8907096B5BACD5BD7132435146A19A,60231,12,17,5,109.49903,18.21972,1504
24085,184689,3B8907096B5BACD5BD7132435146A19A,30661,19,20,1,109.37028,18.24361,1008
24086,184690,3B8907096B5BACD5BD7132435146A19A,31681,21,23,2,109.40396,18.29979,1168
24087,184693,965E8F38FE667573C28BEF2A4D9F60FE,30721,12,13,1,109.51597,18.28257,1565
24088,184694,965E8F38FE667573C28BEF2A4D9F60FE,39053,16,21,5,109.511,18.2771,1564
24089,184695,965E8F38FE667573C28BEF2A4D9F60FE,30281,21,23,2,109.50597,18.27583,1514
24090,184696,C91F430AC30B55A21F7C58F74A11754B,30854,15,16,1,109.56889,18.27076,1763
24091,184697,C91F430AC30B55A21F7C58F74A11754B,30151,19,22,3,109.50986,18.25083,1560
24092,184745,05C1119F8C536EC2F1AEFFF96EE8A274,38677,0,8,8,109.41854,18.29701,1217
24093,184746,05C1119F8C536EC2F1AEFFF96EE8A274,31781,13,14,1,109.19847,18.2975,367
24094,184747,05C1119F8C536EC2F1AEFFF96EE8A274,31521,15,17,2,109.51458,18.22542,1555
24095,184748,05C1119F8C536EC2F1AEFFF96EE8A274,38677,20,23,3,109.41854,18.29701,1217
24096,184756,6D11A991B84CF2421C0052A4AC5AB4C3,38271,19,23,4,109.62632,18.23049,1956
24097,184778,C1F100A79C441D3FFDBAE922D32DC8D2,30854,0,4,4,109.56889,18.27076,1763
24098,184779,C1F100A79C441D3FFDBAE922D32DC8D2,31945,8,9,1,109.58021,18.29403,1817
24099,184781,6751CEC3CF9B2AE78246C7287443D2B4,31945,5,6,1,109.58021,18.29403,1817
24100,184782,6751CEC3CF9B2AE78246C7287443D2B4,30854,7,10,3,109.56889,18.27076,1763
24101,184783,6751CEC3CF9B2AE78246C7287443D2B4,31945,12,13,1,109.58021,18.29403,1817
24102,184784,6751CEC3CF9B2AE78246C7287443D2B4,31071,14,16,2,109.58257,18.28458,1815
24103,184785,6751CEC3CF9B2AE78246C7287443D2B4,30854,16,18,2,109.56889,18.27076,1763
24104,184794,6751CEC3CF9B2AE78246C7287443D2B4,31945,0,4,4,109.58021,18.29403,1817
24105,184795,6751CEC3CF9B2AE78246C7287443D2B4,30854,7,8,1,109.56889,18.27076,1763
24106,184796,6751CEC3CF9B2AE78246C7287443D2B4,31071,13,14,1,109.58257,18.28458,1815
24107,184797,6751CEC3CF9B2AE78246C7287443D2B4,60661,19,21,2,109.548,18.2377,1657
24111,184807,F73FA22BCE58EDAFF289460FA5CC21E5,31531,9,11,2,109.49583,18.25972,1461
24112,184808,F73FA22BCE58EDAFF289460FA5CC21E5,31471,12,15,3,109.34583,18.29563,917
24113,184809,F73FA22BCE58EDAFF289460FA5CC21E5,31531,18,23,5,109.49583,18.25972,1461
24114,184815,02C53C5746E38501957FE72E2C83CCA4,38251,0,9,9,109.49618,18.25493,1510
24115,184816,02C53C5746E38501957FE72E2C83CCA4,31431,12,13,1,109.44639,18.29042,1316
24116,184817,02C53C5746E38501957FE72E2C83CCA4,30651,14,15,1,109.42611,18.385,1232
24117,184818,02C53C5746E38501957FE72E2C83CCA4,38251,15,16,1,109.49618,18.25493,1510
24121,184913,882ECAD9BB7A0DC66E689517602F98B0,30891,4,8,4,109.59431,18.28389,1865
24122,184914,882ECAD9BB7A0DC66E689517602F98B0,30221,12,13,1,109.57833,18.20222,1802
24123,184918,8FF88CE1C7893F7B14E397F30C6E014A,30211,10,11,1,109.49882,18.23931,1508
24124,184920,E58E5EFF0A1D7ADABE8F5BBEE665ED0D,60641,0,7,7,109.53854,18.2359,1657
24125,184921,E58E5EFF0A1D7ADABE8F5BBEE665ED0D,31021,8,13,5,109.49021,18.27,1463
24126,184922,E58E5EFF0A1D7ADABE8F5BBEE665ED0D,30861,14,15,1,109.52722,18.22743,1606
24127,184923,E58E5EFF0A1D7ADABE8F5BBEE665ED0D,30861,17,19,2,109.52722,18.22743,1606
24128,184924,25816EE0A17BD271D78FE03A1826E784,60084,0,2,2,109.4984,18.2334,1507
24129,184925,25816EE0A17BD271D78FE03A1826E784,30271,3,8,5,109.49132,18.23153,1456
24130,184926,25816EE0A17BD271D78FE03A1826E784,60211,10,11,1,109.63549,18.26049,2011
24131,184944,8A4CA94771FDC32ED298939D74FF667F,31061,0,5,5,109.53333,18.23257,1607
24132,184945,8A4CA94771FDC32ED298939D74FF667F,38094,7,10,3,109.45403,18.28778,1316
24133,184946,8A4CA94771FDC32ED298939D74FF667F,31061,12,17,5,109.53333,18.23257,1607
24134,184980,0FFE1266CE318D6038E5B958E6916238,31671,0,2,2,109.38965,18.29813,1068
24135,184981,0FFE1266CE318D6038E5B958E6916238,38141,2,9,7,109.39479,18.2916,1116
24136,184982,0FFE1266CE318D6038E5B958E6916238,38141,10,14,4,109.39479,18.2916,1116
24137,184983,0FFE1266CE318D6038E5B958E6916238,31781,15,17,2,109.19847,18.2975,367
24138,184984,0FFE1266CE318D6038E5B958E6916238,31671,21,23,2,109.38965,18.29813,1068
24139,185007,D658FAED197C23209E6C54260A1F1BDD,38127,0,8,8,109.50833,18.27222,1513
24140,185010,A9634A2AD8447824C1C9412CBBCC32E0,31534,0,6,6,109.49368,18.25806,1461
24141,185011,A9634A2AD8447824C1C9412CBBCC32E0,31031,9,10,1,109.49979,18.25382,1510
24142,185012,A9634A2AD8447824C1C9412CBBCC32E0,31181,11,13,2,109.50382,18.24813,1509
24143,185013,A9634A2AD8447824C1C9412CBBCC32E0,31851,14,15,1,109.71736,18.29007,2316
24144,185014,A9634A2AD8447824C1C9412CBBCC32E0,31534,17,18,1,109.49368,18.25806,1461
24145,185015,A9634A2AD8447824C1C9412CBBCC32E0,31181,18,23,5,109.50382,18.24813,1509
24146,185034,14BFE46EEAB2E234698393270A62605D,60411,0,2,2,109.32514,18.30854,869
24147,185035,14BFE46EEAB2E234698393270A62605D,30661,3,21,18,109.37028,18.24361,1008
24148,185036,14BFE46EEAB2E234698393270A62605D,60411,21,22,1,109.32514,18.30854,869
24149,185039,5D5B29A994BBA3635D38463A75BE58F6,30201,0,10,10,109.4909,18.26465,1462
24150,185041,5D5B29A994BBA3635D38463A75BE58F6,30321,17,19,2,109.49563,18.29611,1467
24155,185135,7C68E1F4B8B2F3CBBD5427BF66BF9C2E,31571,8,19,11,109.61563,18.23326,1957
24156,185136,7C68E1F4B8B2F3CBBD5427BF66BF9C2E,30854,20,22,2,109.56889,18.27076,1763
24160,185158,5403ECE41AD9921A5DEF63FF6DE6A9D1,31945,4,10,6,109.58021,18.29403,1817
24161,185159,5403ECE41AD9921A5DEF63FF6DE6A9D1,30854,12,13,1,109.56889,18.27076,1763
24162,185160,5403ECE41AD9921A5DEF63FF6DE6A9D1,31271,14,16,2,109.48958,18.26257,1462
24163,185161,5403ECE41AD9921A5DEF63FF6DE6A9D1,31071,18,19,1,109.58257,18.28458,1815
24164,185168,15195C578D4A8081B069C4B518039EFC,60231,16,17,1,109.49903,18.21972,1504
24165,185169,15195C578D4A8081B069C4B518039EFC,60401,17,19,2,109.47444,18.27583,1414
24166,185201,BD5D5103B08534F20AF53FB58E9A43CA,38241,6,10,4,109.54111,18.30542,1669
24167,185202,BD5D5103B08534F20AF53FB58E9A43CA,30421,12,13,1,109.50021,18.25861,1511
24168,185203,BD5D5103B08534F20AF53FB58E9A43CA,60381,15,20,5,109.5241,18.22458,1605
24169,185236,372A5433078073EAD18922D679CE0A73,60054,0,6,6,109.3016,18.31229,770
24170,185237,372A5433078073EAD18922D679CE0A73,30901,7,8,1,109.27597,18.3134,670
24171,185238,372A5433078073EAD18922D679CE0A73,60054,9,14,5,109.3016,18.31229,770
24172,185239,372A5433078073EAD18922D679CE0A73,60411,14,17,3,109.32514,18.30854,869
24173,185240,372A5433078073EAD18922D679CE0A73,60054,18,23,5,109.3016,18.31229,770
24174,185248,ADF0A7CED2B8DFD757D8FCA8B507C37E,31561,13,15,2,109.56792,18.28479,1765
24175,185249,ADF0A7CED2B8DFD757D8FCA8B507C37E,38283,17,20,3,109.62229,18.22618,1956
24176,185320,B023927CBEC0A8053CBDF64A5B76E367,60231,1,6,5,109.49903,18.21972,1504
24177,185321,B023927CBEC0A8053CBDF64A5B76E367,31931,7,17,10,109.54771,18.29403,1667
24182,185396,D4EE8E1A4C04A1FF0596E4221D0B8B42,30854,16,17,1,109.56889,18.27076,1763
24183,185397,D4EE8E1A4C04A1FF0596E4221D0B8B42,30324,19,22,3,109.50326,18.29257,1517
24190,185518,9B389AE8E9B004176803CCEAFF69104A,39371,13,16,3,109.56627,18.2646,1762
24191,185519,9B389AE8E9B004176803CCEAFF69104A,31071,19,21,2,109.58257,18.28458,1815
24195,185561,C17F2EF1DEA79C8C951E3013EE071B2C,31071,12,13,1,109.58257,18.28458,1815
24196,185562,C17F2EF1DEA79C8C951E3013EE071B2C,30854,14,16,2,109.56889,18.27076,1763
24197,185578,879D0582077AA8488C2D5C693D7F7760,38361,0,9,9,109.43667,18.29201,1267
24198,185579,879D0582077AA8488C2D5C693D7F7760,60201,11,12,1,109.5041,18.2509,1510
24199,185580,879D0582077AA8488C2D5C693D7F7760,31031,12,14,2,109.49979,18.25382,1510
24200,185581,879D0582077AA8488C2D5C693D7F7760,38361,14,23,9,109.43667,18.29201,1267
24201,185582,3D8ADE80304FD3207128013D43F1118A,60421,1,7,6,109.46333,18.31743,1371
24202,185583,3D8ADE80304FD3207128013D43F1118A,31781,11,12,1,109.19847,18.2975,367
24203,185584,3D8ADE80304FD3207128013D43F1118A,30111,16,18,2,109.47583,18.30542,1419
24204,185585,3D8ADE80304FD3207128013D43F1118A,60472,19,20,1,109.46625,18.29542,1367
24205,185601,0442B38E8824E569B00E80CCEFC70940,31561,11,13,2,109.56792,18.28479,1765
24206,185602,0442B38E8824E569B00E80CCEFC70940,39183,14,16,2,109.55542,18.28208,1715
24207,185603,0442B38E8824E569B00E80CCEFC70940,31561,19,23,4,109.56792,18.28479,1765
24212,185681,8D3B10FD4DBC46DB93DA60040668F697,30854,0,6,6,109.56889,18.27076,1763
24213,185682,8D3B10FD4DBC46DB93DA60040668F697,31561,8,9,1,109.56792,18.28479,1765
24214,185683,8D3B10FD4DBC46DB93DA60040668F697,30854,12,13,1,109.56889,18.27076,1763
24215,185684,8D3B10FD4DBC46DB93DA60040668F697,31561,15,16,1,109.56792,18.28479,1765
24216,185685,8D3B10FD4DBC46DB93DA60040668F697,30854,18,23,5,109.56889,18.27076,1763
24217,185694,855D815DC19AA779325469411A9E7B8A,38911,3,4,1,109.51674,18.24965,1559
24218,185695,855D815DC19AA779325469411A9E7B8A,30251,5,7,2,109.50611,18.26653,1512
24219,185696,855D815DC19AA779325469411A9E7B8A,38157,7,10,3,109.51483,18.26958,1563
24220,185697,855D815DC19AA779325469411A9E7B8A,30251,11,12,1,109.50611,18.26653,1512
24221,185698,855D815DC19AA779325469411A9E7B8A,38157,13,14,1,109.51483,18.26958,1563
24222,185707,5A9102EC5E9F0DC40E1A3F8CEDE0001B,30854,16,17,1,109.56889,18.27076,1763
24223,185708,5A9102EC5E9F0DC40E1A3F8CEDE0001B,30861,20,21,1,109.52722,18.22743,1606
24224,185709,5A9102EC5E9F0DC40E1A3F8CEDE0001B,30121,22,23,1,109.52861,18.27222,1613
24225,185729,8621CFDF1B89A83351494618C53D033F,31071,0,6,6,109.58257,18.28458,1815
24226,185730,8621CFDF1B89A83351494618C53D033F,39181,8,9,1,109.55153,18.28035,1715
24227,185731,8621CFDF1B89A83351494618C53D033F,39181,10,15,5,109.55153,18.28035,1715
24228,185732,8621CFDF1B89A83351494618C53D033F,39181,18,21,3,109.55153,18.28035,1715
24229,185733,8621CFDF1B89A83351494618C53D033F,31071,21,23,2,109.58257,18.28458,1815
24230,185783,78ACFC8C61BE9AC648F94D8A9D03B0D0,38891,0,7,7,109.51486,18.24118,1558
24231,185784,78ACFC8C61BE9AC648F94D8A9D03B0D0,31521,7,10,3,109.51458,18.22542,1555
24232,185785,78ACFC8C61BE9AC648F94D8A9D03B0D0,38754,13,15,2,109.74667,18.37382,2430
24233,185786,78ACFC8C61BE9AC648F94D8A9D03B0D0,31521,19,20,1,109.51458,18.22542,1555
24234,185787,78ACFC8C61BE9AC648F94D8A9D03B0D0,30511,21,23,2,109.51069,18.24208,1558
24235,185797,EB291EA7E3235FF23960DA865075F183,60281,1,8,7,109.51743,18.25924,1561
24236,185798,EB291EA7E3235FF23960DA865075F183,31145,11,12,1,109.20431,18.30479,369
24237,185799,EB291EA7E3235FF23960DA865075F183,60161,16,17,1,109.49174,18.26181,1461
24238,185800,EB291EA7E3235FF23960DA865075F183,60281,21,23,2,109.51743,18.25924,1561
24239,185842,2191B2AD5C915B8862D4C345F0A13CFB,31071,6,12,6,109.58257,18.28458,1815
24240,185843,2191B2AD5C915B8862D4C345F0A13CFB,30851,15,16,1,109.5616,18.27396,1713
24241,185855,E9F64FD67E39C3E2C15C20715338A941,30921,0,2,2,109.53903,18.29451,1667
24242,185856,E9F64FD67E39C3E2C15C20715338A941,60371,3,6,3,109.53063,18.30056,1618
24243,185857,E9F64FD67E39C3E2C15C20715338A941,30921,7,11,4,109.53903,18.29451,1667
24244,185858,E9F64FD67E39C3E2C15C20715338A941,31931,13,14,1,109.54771,18.29403,1667
24245,185859,E9F64FD67E39C3E2C15C20715338A941,30921,14,22,8,109.53903,18.29451,1667
24246,185923,CBA29FB366E4111071C95C99C696D0E6,30854,1,4,3,109.56889,18.27076,1763
24247,185924,CBA29FB366E4111071C95C99C696D0E6,31561,4,5,1,109.56792,18.28479,1765
24248,185925,CBA29FB366E4111071C95C99C696D0E6,31321,7,16,9,109.63799,18.23201,2007
24249,185926,CBA29FB366E4111071C95C99C696D0E6,30854,19,20,1,109.56889,18.27076,1763
24250,185927,58979C567AA82D4656FBA764FCCBAA6B,39063,15,16,1,109.386,18.2919,1066
24251,185928,58979C567AA82D4656FBA764FCCBAA6B,31671,20,23,3,109.38965,18.29813,1068
24252,185954,6B6C009D25FF3E364187E5021A2E374B,30791,0,8,8,109.72333,18.40889,2386
24253,185955,6B6C009D25FF3E364187E5021A2E374B,31781,11,12,1,109.19847,18.2975,367
24254,185956,6B6C009D25FF3E364187E5021A2E374B,60161,16,18,2,109.49174,18.26181,1461
24255,185980,876B18E154DD33AF86D598DC340CC1E5,60101,13,14,1,109.75465,18.40139,2485
24256,185981,876B18E154DD33AF86D598DC340CC1E5,38185,15,23,8,109.51333,18.27347,1563
24264,186044,58DE8A719D3ADBEDAE163213845B460A,31071,0,7,7,109.58257,18.28458,1815
24265,186045,58DE8A719D3ADBEDAE163213845B460A,30854,7,12,5,109.56889,18.27076,1763
24266,186046,58DE8A719D3ADBEDAE163213845B460A,31071,12,14,2,109.58257,18.28458,1815
24267,186047,58DE8A719D3ADBEDAE163213845B460A,30854,14,15,1,109.56889,18.27076,1763
24268,186048,58DE8A719D3ADBEDAE163213845B460A,31071,17,23,6,109.58257,18.28458,1815
24272,186098,E52B1449B3E12C656C55695335C2EE0A,60201,0,7,7,109.5041,18.2509,1510
24273,186099,E52B1449B3E12C656C55695335C2EE0A,60161,7,8,1,109.49174,18.26181,1461
24274,186100,E52B1449B3E12C656C55695335C2EE0A,30071,12,13,1,109.52819,18.30472,1619
24275,186101,E52B1449B3E12C656C55695335C2EE0A,38275,14,16,2,109.62875,18.22938,2006
24276,186102,E52B1449B3E12C656C55695335C2EE0A,30071,19,20,1,109.52819,18.30472,1619
24277,186117,EBD16061EA20EE33D9344D33735E5205,38291,0,12,12,109.51618,18.24313,1558
24278,186118,EBD16061EA20EE33D9344D33735E5205,31261,13,23,10,109.51174,18.2466,1559
24282,186143,E52AB7AB71324275F6E7FD670EB569C3,48574,0,6,6,109.48931,18.28458,1465
24283,186144,E52AB7AB71324275F6E7FD670EB569C3,60501,7,8,1,109.48701,18.29021,1466
24284,186169,7F8080706CEE97D2E7730488F93BE8CE,31931,6,15,9,109.54771,18.29403,1667
24285,186170,7F8080706CEE97D2E7730488F93BE8CE,30891,19,20,1,109.59431,18.28389,1865
24286,186171,7F8080706CEE97D2E7730488F93BE8CE,31071,21,23,2,109.58257,18.28458,1815
24296,186215,ACDEAAF45B65DE48CF80A48DBD3C775E,30854,0,2,2,109.56889,18.27076,1763
24297,186216,ACDEAAF45B65DE48CF80A48DBD3C775E,31071,3,4,1,109.58257,18.28458,1815
24298,186217,ACDEAAF45B65DE48CF80A48DBD3C775E,30854,7,9,2,109.56889,18.27076,1763
24299,186218,ACDEAAF45B65DE48CF80A48DBD3C775E,30731,11,13,2,109.50944,18.22306,1555
24300,186219,ACDEAAF45B65DE48CF80A48DBD3C775E,30854,17,22,5,109.56889,18.27076,1763
24301,186234,BF521586C88C40E33C810282BBCA205D,30251,2,9,7,109.50611,18.26653,1512
24302,186235,BF521586C88C40E33C810282BBCA205D,31461,10,11,1,109.5091,18.25389,1510
24303,186236,BF521586C88C40E33C810282BBCA205D,31864,13,15,2,109.49014,18.28333,1465
24304,186237,BF521586C88C40E33C810282BBCA205D,31301,18,19,1,109.14493,18.31222,170
24305,186238,5EBEA276FCB4A19AC5C987F5C7CC8908,60401,13,15,2,109.47444,18.27583,1414
24306,186239,5EBEA276FCB4A19AC5C987F5C7CC8908,60621,15,17,2,109.48354,18.27451,1464
24307,186240,5EBEA276FCB4A19AC5C987F5C7CC8908,38361,17,23,6,109.43667,18.29201,1267
24308,186241,3B6FF1F8D896A0A62DC7E65967011999,39183,1,20,19,109.55542,18.28208,1715
24309,186242,3B6FF1F8D896A0A62DC7E65967011999,31561,22,23,1,109.56792,18.28479,1765
24310,186259,45CBD2C3BADB5D2EDB84D5554054690B,38871,1,3,2,109.44681,18.28625,1316
24311,186260,45CBD2C3BADB5D2EDB84D5554054690B,38094,6,8,2,109.45403,18.28778,1316
24312,186261,45CBD2C3BADB5D2EDB84D5554054690B,30661,12,14,2,109.37028,18.24361,1008
24313,186262,45CBD2C3BADB5D2EDB84D5554054690B,30111,19,23,4,109.47583,18.30542,1419
24314,186267,B032E534C72FB8134F1588648D944A44,30854,0,8,8,109.56889,18.27076,1763
24315,186268,B032E534C72FB8134F1588648D944A44,31521,13,14,1,109.51458,18.22542,1555
24316,186269,B032E534C72FB8134F1588648D944A44,30854,15,16,1,109.56889,18.27076,1763
24317,186270,B032E534C72FB8134F1588648D944A44,60354,18,19,1,109.58701,18.28521,1815
24318,186282,FBC323A047041F71D8997C22FDE88F17,31431,16,17,1,109.44639,18.29042,1316
24319,186283,FBC323A047041F71D8997C22FDE88F17,31864,19,20,1,109.49014,18.28333,1465
24320,186286,0312B43ACF9ED1D8304E325E851AEE29,30851,7,8,1,109.5616,18.27396,1713
24321,186287,0312B43ACF9ED1D8304E325E851AEE29,31561,8,9,1,109.56792,18.28479,1765
24322,186288,0312B43ACF9ED1D8304E325E851AEE29,30851,9,14,5,109.5616,18.27396,1713
24323,186289,0312B43ACF9ED1D8304E325E851AEE29,31561,14,17,3,109.56792,18.28479,1765
24324,186290,0312B43ACF9ED1D8304E325E851AEE29,30851,17,23,6,109.5616,18.27396,1713
24328,186303,FFD6F9EB143758832EB0BC3318A1D581,60401,0,7,7,109.47444,18.27583,1414
24329,186304,FFD6F9EB143758832EB0BC3318A1D581,31781,9,10,1,109.19847,18.2975,367
24330,186305,FFD6F9EB143758832EB0BC3318A1D581,31471,12,13,1,109.34583,18.29563,917
24331,186319,4BA143AD44480D9BEACA2836C34FF531,30211,6,12,6,109.49882,18.23931,1508
24332,186320,4BA143AD44480D9BEACA2836C34FF531,60231,14,16,2,109.49903,18.21972,1504
24337,186349,9485D4C6CDE6DE6B84BBFF7C364B13A6,60054,3,7,4,109.3016,18.31229,770
24338,186350,9485D4C6CDE6DE6B84BBFF7C364B13A6,30661,9,12,3,109.37028,18.24361,1008
24339,186351,9485D4C6CDE6DE6B84BBFF7C364B13A6,39061,14,23,9,109.38222,18.28958,1066
24340,186366,01F0083CC81D0009F9AAB8F7CAA0C106,30854,1,13,12,109.56889,18.27076,1763
24341,186367,01F0083CC81D0009F9AAB8F7CAA0C106,31071,13,16,3,109.58257,18.28458,1815
24342,186381,C8135D3E403B7CC96352A41CBCD291A7,38241,0,6,6,109.54111,18.30542,1669
24343,186382,C8135D3E403B7CC96352A41CBCD291A7,31931,6,7,1,109.54771,18.29403,1667
24344,186471,B7A2800FDF738E1064EAD2A5E58F7A3C,31071,19,20,1,109.58257,18.28458,1815
24345,186473,0B1CC3266C9F341870D0B135F2AF352E,38094,0,6,6,109.45403,18.28778,1316
24346,186474,0B1CC3266C9F341870D0B135F2AF352E,60441,8,14,6,109.46792,18.28604,1366
24347,186496,64F4CDF664AA04E7B79DE93C57128CF6,31931,0,7,7,109.54771,18.29403,1667
24348,186497,64F4CDF664AA04E7B79DE93C57128CF6,39181,8,16,8,109.55153,18.28035,1715
24349,186503,2784AD65C6F3580D4FC580DB3654BC4C,31521,10,16,6,109.51458,18.22542,1555
24350,186504,2784AD65C6F3580D4FC580DB3654BC4C,60381,20,21,1,109.5241,18.22458,1605
24354,186510,E885B3923220582401E6F1A363A3329C,39183,1,2,1,109.55542,18.28208,1715
24355,186511,E885B3923220582401E6F1A363A3329C,30854,2,5,3,109.56889,18.27076,1763
24356,186512,E885B3923220582401E6F1A363A3329C,39183,6,8,2,109.55542,18.28208,1715
24357,186513,E885B3923220582401E6F1A363A3329C,31071,8,10,2,109.58257,18.28458,1815
24358,186514,E885B3923220582401E6F1A363A3329C,30221,12,13,1,109.57833,18.20222,1802
24359,186515,E885B3923220582401E6F1A363A3329C,30731,15,16,1,109.50944,18.22306,1555
24363,186549,354DC607408BB828F25BA014BE4B0A10,38111,11,16,5,109.52007,18.22403,1555
24364,186550,354DC607408BB828F25BA014BE4B0A10,30731,17,20,3,109.50944,18.22306,1555
24365,186551,354DC607408BB828F25BA014BE4B0A10,39111,22,23,1,109.5191,18.22597,1555
24366,186552,F621296F333E8058687ACD884B135C6E,30504,0,5,5,109.705,18.35368,2277
24367,186553,F621296F333E8058687ACD884B135C6E,30711,9,10,1,109.50271,18.25347,1510
24368,186554,F621296F333E8058687ACD884B135C6E,31351,10,14,4,109.4959,18.28417,1465
24369,186626,2183AF5A97756EB05E1459D1CE0BD7C7,31931,14,15,1,109.54771,18.29403,1667
24370,186627,2183AF5A97756EB05E1459D1CE0BD7C7,60371,17,20,3,109.53063,18.30056,1618
24371,186628,2183AF5A97756EB05E1459D1CE0BD7C7,31931,20,23,3,109.54771,18.29403,1667
24372,186644,E65658506C2BF9C993BA69EE6D38B3C6,60361,0,2,2,109.51938,18.29681,1567
24373,186645,E65658506C2BF9C993BA69EE6D38B3C6,31951,3,4,1,109.52174,18.30299,1568
24374,186646,E65658506C2BF9C993BA69EE6D38B3C6,60361,4,6,2,109.51938,18.29681,1567
24375,186647,E65658506C2BF9C993BA69EE6D38B3C6,31951,6,9,3,109.52174,18.30299,1568
24376,186648,E65658506C2BF9C993BA69EE6D38B3C6,60361,9,12,3,109.51938,18.29681,1567
24377,186690,1C25334EE7BA1B02FAAADA4861FD1792,39111,1,3,2,109.5191,18.22597,1555
24378,186691,1C25334EE7BA1B02FAAADA4861FD1792,60381,5,8,3,109.5241,18.22458,1605
24379,186692,1C25334EE7BA1B02FAAADA4861FD1792,31781,10,13,3,109.19847,18.2975,367
24380,186693,1C25334EE7BA1B02FAAADA4861FD1792,60381,17,18,1,109.5241,18.22458,1605
24381,186694,1C25334EE7BA1B02FAAADA4861FD1792,31521,20,23,3,109.51458,18.22542,1555
24382,186707,5AE5291D69C9CAB9DE596EEA8E795748,31391,2,4,2,109.50382,18.24285,1508
24383,186708,5AE5291D69C9CAB9DE596EEA8E795748,31521,4,5,1,109.51458,18.22542,1555
24384,186709,5AE5291D69C9CAB9DE596EEA8E795748,60381,7,8,1,109.5241,18.22458,1605
24385,186710,5AE5291D69C9CAB9DE596EEA8E795748,33051,12,15,3,109.6475,18.46618,2096
24386,186711,5AE5291D69C9CAB9DE596EEA8E795748,31521,19,21,2,109.51458,18.22542,1555
24393,186732,4EC716C6116001DCCA61DAB5E48F9371,60524,2,3,1,109.42951,18.28993,1216
24394,186733,4EC716C6116001DCCA61DAB5E48F9371,60552,7,11,4,109.41729,18.30014,1218
24395,186734,4EC716C6116001DCCA61DAB5E48F9371,60401,12,13,1,109.47444,18.27583,1414
24396,186735,4EC716C6116001DCCA61DAB5E48F9371,31031,19,20,1,109.49979,18.25382,1510
24397,186736,4EC716C6116001DCCA61DAB5E48F9371,39321,21,22,1,109.529,18.2167,1604
24398,186768,9C068F0C3303F33ADE079F339455F990,30181,13,15,2,109.51597,18.23313,1557
24399,186769,9C068F0C3303F33ADE079F339455F990,31521,16,18,2,109.51458,18.22542,1555
24400,186770,9C068F0C3303F33ADE079F339455F990,30711,19,20,1,109.50271,18.25347,1510
24401,186820,6587551DA47309E484D1302521C8D417,60631,1,6,5,109.57778,18.27583,1814
24402,186821,6587551DA47309E484D1302521C8D417,38275,8,19,11,109.62875,18.22938,2006
24403,186827,EFDE35289FEC1E13D6F34EFEE66A8AD2,60631,17,19,2,109.57778,18.27583,1814
24404,186828,EFDE35289FEC1E13D6F34EFEE66A8AD2,60571,21,23,2,109.50722,18.25056,1510
24405,186857,DA10676C4DA702E02A2C3FFFAC40ABA2,31561,9,13,4,109.56792,18.28479,1765
24406,186858,DA10676C4DA702E02A2C3FFFAC40ABA2,39183,18,19,1,109.55542,18.28208,1715
24407,186859,DA10676C4DA702E02A2C3FFFAC40ABA2,31561,19,21,2,109.56792,18.28479,1765
24411,186923,AD608A919061B1C684914F8654FB2493,31251,13,15,2,109.18528,18.2975,317
24412,186924,AD608A919061B1C684914F8654FB2493,31231,18,19,1,109.42597,18.29292,1217
24413,186925,D37BF241A4A35F0F341582CAF9EF0DD2,60221,1,5,4,109.52569,18.29188,1616
24414,186926,D37BF241A4A35F0F341582CAF9EF0DD2,38251,10,13,3,109.49618,18.25493,1510
24415,186927,D37BF241A4A35F0F341582CAF9EF0DD2,31205,15,17,2,109.51111,18.23736,1557
24416,186928,D37BF241A4A35F0F341582CAF9EF0DD2,38291,18,19,1,109.51618,18.24313,1558
24417,186929,D37BF241A4A35F0F341582CAF9EF0DD2,38251,19,23,4,109.49618,18.25493,1510
24418,186938,0133DDFFB5CECBB261CEDEF10A82D50B,31561,0,4,4,109.56792,18.28479,1765
24419,186939,0133DDFFB5CECBB261CEDEF10A82D50B,30854,6,8,2,109.56889,18.27076,1763
24420,186940,0133DDFFB5CECBB261CEDEF10A82D50B,31561,8,11,3,109.56792,18.28479,1765
24421,186941,0133DDFFB5CECBB261CEDEF10A82D50B,31071,12,13,1,109.58257,18.28458,1815
24422,186942,0133DDFFB5CECBB261CEDEF10A82D50B,31561,14,15,1,109.56792,18.28479,1765
24423,186943,0133DDFFB5CECBB261CEDEF10A82D50B,30854,20,22,2,109.56889,18.27076,1763
24424,186948,638580236EF215868960D2AF9691D2BA,38052,0,8,8,109.62618,18.23042,1956
24425,186949,638580236EF215868960D2AF9691D2BA,31781,10,13,3,109.19847,18.2975,367
24426,186950,638580236EF215868960D2AF9691D2BA,30441,16,18,2,109.64021,18.25424,2010
24427,186951,638580236EF215868960D2AF9691D2BA,30354,19,20,1,109.42813,18.29076,1216
24428,186979,0E129C09250C0D46273B4BD7E5225556,30151,0,6,6,109.50986,18.25083,1560
24429,186980,0E129C09250C0D46273B4BD7E5225556,60201,6,9,3,109.5041,18.2509,1510
24430,186981,0E129C09250C0D46273B4BD7E5225556,60401,10,12,2,109.47444,18.27583,1414
24431,186982,0E129C09250C0D46273B4BD7E5225556,60441,12,16,4,109.46792,18.28604,1366
24432,186983,0E129C09250C0D46273B4BD7E5225556,60281,20,23,3,109.51743,18.25924,1561
24433,187003,E8837AFD996CC82B70ED442FBB169EAD,38013,0,8,8,109.49514,18.21951,1454
24434,187005,E8837AFD996CC82B70ED442FBB169EAD,30901,14,15,1,109.27597,18.3134,670
24435,187014,23DF42FF4E6B61B09E6A4E456F67A952,38361,0,2,2,109.43667,18.29201,1267
24436,187015,23DF42FF4E6B61B09E6A4E456F67A952,30051,2,5,3,109.48917,18.21215,1453
24437,187016,23DF42FF4E6B61B09E6A4E456F67A952,38361,6,7,1,109.43667,18.29201,1267
24438,187017,23DF42FF4E6B61B09E6A4E456F67A952,31781,8,10,2,109.19847,18.2975,367
24439,187027,5D4E252AC551D7DB97A6F7C764F981F2,38127,13,16,3,109.50833,18.27222,1513
24440,187028,5D4E252AC551D7DB97A6F7C764F981F2,31351,18,23,5,109.4959,18.28417,1465
24441,187034,C709D01469E0800AF998DFAF42105CDC,30854,2,3,1,109.56889,18.27076,1763
24442,187035,C709D01469E0800AF998DFAF42105CDC,31561,6,15,9,109.56792,18.28479,1765
24443,187050,C957C5FFC60830A667C461DE5D4133C9,60381,20,23,3,109.5241,18.22458,1605
24448,187063,451E2BF48CD7B253EB0892324E679BCC,38297,0,4,4,109.52576,18.24965,1609
24449,187064,451E2BF48CD7B253EB0892324E679BCC,60281,5,11,6,109.51743,18.25924,1561
24450,187065,451E2BF48CD7B253EB0892324E679BCC,38291,11,13,2,109.51618,18.24313,1558
24451,187066,451E2BF48CD7B253EB0892324E679BCC,60281,14,18,4,109.51743,18.25924,1561
24452,187067,451E2BF48CD7B253EB0892324E679BCC,38291,18,20,2,109.51618,18.24313,1558
24453,187068,451E2BF48CD7B253EB0892324E679BCC,38297,20,22,2,109.52576,18.24965,1609
24454,187069,A5351FE9BD2860440534F7277F893732,30111,0,7,7,109.47583,18.30542,1419
24455,187070,A5351FE9BD2860440534F7277F893732,31471,9,10,1,109.34583,18.29563,917
24456,187071,A5351FE9BD2860440534F7277F893732,39154,13,14,1,109.50201,18.25681,1511
24457,187072,A5351FE9BD2860440534F7277F893732,38251,15,19,4,109.49618,18.25493,1510
24458,187073,A5351FE9BD2860440534F7277F893732,30421,20,21,1,109.50021,18.25861,1511
24459,187074,A5351FE9BD2860440534F7277F893732,30421,21,23,2,109.50021,18.25861,1511
24460,187076,C7D574CBE15EDD2D6A977D5207AF0BA3,31471,9,11,2,109.34583,18.29563,917
24461,187077,C7D574CBE15EDD2D6A977D5207AF0BA3,33051,14,15,1,109.6475,18.46618,2096
24462,187131,93715618B304E009FF2F157425BB5843,30421,11,14,3,109.50021,18.25861,1511
24463,187132,93715618B304E009FF2F157425BB5843,30181,18,20,2,109.51597,18.23313,1557
24464,187133,93715618B304E009FF2F157425BB5843,60504,21,23,2,109.47917,18.28903,1416
24465,187142,4F3A073B0E00F2C591EAC7CA3550DBAE,30851,3,4,1,109.5616,18.27396,1713
24466,187143,4F3A073B0E00F2C591EAC7CA3550DBAE,39181,4,6,2,109.55153,18.28035,1715
24467,187144,4F3A073B0E00F2C591EAC7CA3550DBAE,39181,8,9,1,109.55153,18.28035,1715
24468,187145,4F3A073B0E00F2C591EAC7CA3550DBAE,31071,12,13,1,109.58257,18.28458,1815
24469,187146,4F3A073B0E00F2C591EAC7CA3550DBAE,39181,13,16,3,109.55153,18.28035,1715
24470,187147,4F3A073B0E00F2C591EAC7CA3550DBAE,31071,18,19,1,109.58257,18.28458,1815
24471,187163,0E5593A90D661690BE3DAAA17AD936E2,38127,0,7,7,109.50833,18.27222,1513
24472,187164,0E5593A90D661690BE3DAAA17AD936E2,38073,9,14,5,109.40813,18.30958,1169
24473,187165,0E5593A90D661690BE3DAAA17AD936E2,30281,17,18,1,109.50597,18.27583,1514
24474,187166,0E5593A90D661690BE3DAAA17AD936E2,31271,19,21,2,109.48958,18.26257,1462
24478,187198,C8B662CAEBDC359FAD2D68CB046F51F0,30681,10,11,1,109.48493,18.26917,1463
24479,187199,C8B662CAEBDC359FAD2D68CB046F51F0,60401,13,14,1,109.47444,18.27583,1414
24480,187200,C8B662CAEBDC359FAD2D68CB046F51F0,30681,15,16,1,109.48493,18.26917,1463
24481,187201,C8B662CAEBDC359FAD2D68CB046F51F0,30171,16,21,5,109.48458,18.27139,1463
24485,187210,8FAAC7EA21AE7BB6F52A4D0F285944CD,38721,0,8,8,109.50368,18.27542,1514
24486,187211,8FAAC7EA21AE7BB6F52A4D0F285944CD,30281,9,10,1,109.50597,18.27583,1514
24487,187212,8FAAC7EA21AE7BB6F52A4D0F285944CD,30281,11,13,2,109.50597,18.27583,1514
24488,187213,8FAAC7EA21AE7BB6F52A4D0F285944CD,30281,18,20,2,109.50597,18.27583,1514
24489,187214,8FAAC7EA21AE7BB6F52A4D0F285944CD,38151,21,23,2,109.51361,18.26542,1562
24490,187225,F6A1EBB84FE583E84185C423218578F5,39183,13,15,2,109.55542,18.28208,1715
24491,187226,F6A1EBB84FE583E84185C423218578F5,31561,18,19,1,109.56792,18.28479,1765
24492,187263,8A0FB0898366225E4559ACD305792D50,30121,0,9,9,109.52861,18.27222,1613
24493,187264,8A0FB0898366225E4559ACD305792D50,38347,9,16,7,109.4934,18.21444,1454
24494,187265,8A0FB0898366225E4559ACD305792D50,30421,19,20,1,109.50021,18.25861,1511
24495,187293,12E2C9356A230BE21C77839B0896D677,30854,12,13,1,109.56889,18.27076,1763
24496,187294,12E2C9356A230BE21C77839B0896D677,31071,15,19,4,109.58257,18.28458,1815
24497,187295,12E2C9356A230BE21C77839B0896D677,60631,20,21,1,109.57778,18.27583,1814
24498,187296,12E2C9356A230BE21C77839B0896D677,31071,21,23,2,109.58257,18.28458,1815
24499,187314,DD45307798B5E5E871398410DD7318C5,31145,13,14,1,109.20431,18.30479,369
24504,187363,ADDDEBD546B43FF699A163EB1EA5FE50,38251,18,19,1,109.49618,18.25493,1510
24505,187380,1758F7A03033DAF462A8174615B0DBCE,31321,18,19,1,109.63799,18.23201,2007
24506,187381,1758F7A03033DAF462A8174615B0DBCE,38331,19,22,3,109.62465,18.22736,1956
24507,187406,E1B4EE5B2DAE31219B37A92CAB40AC2A,60401,10,13,3,109.47444,18.27583,1414
24508,187407,E1B4EE5B2DAE31219B37A92CAB40AC2A,31531,14,20,6,109.49583,18.25972,1461
24516,187457,CD576F1C1CDFB89E6A99A20E65927346,31561,2,12,10,109.56792,18.28479,1765
24517,187458,CD576F1C1CDFB89E6A99A20E65927346,30854,13,21,8,109.56889,18.27076,1763
24521,187485,B712327B6033C61F37801CFD6DAC08AD,38484,3,4,1,109.53028,18.31528,1620
24522,187486,B712327B6033C61F37801CFD6DAC08AD,38484,7,10,3,109.53028,18.31528,1620
24523,187487,B712327B6033C61F37801CFD6DAC08AD,38484,12,14,2,109.53028,18.31528,1620
24524,187488,B712327B6033C61F37801CFD6DAC08AD,38484,14,18,4,109.53028,18.31528,1620
24525,187489,B712327B6033C61F37801CFD6DAC08AD,38484,20,22,2,109.53028,18.31528,1620
24540,187654,7FF3C6569A3990C03CAF6C52D3C8BC6C,31931,7,16,9,109.54771,18.29403,1667
24541,187655,7FF3C6569A3990C03CAF6C52D3C8BC6C,30921,18,23,5,109.53903,18.29451,1667
24545,187694,AA2A5396AD753E9245AC53C94BAEDECD,61011,2,5,3,109.60653,18.19076,1900
24546,187696,AA2A5396AD753E9245AC53C94BAEDECD,61011,11,20,9,109.60653,18.19076,1900
24547,187721,A9263BE9008920F9142A0014B55D5185,60401,0,7,7,109.47444,18.27583,1414
24548,187722,A9263BE9008920F9142A0014B55D5185,31781,9,10,1,109.19847,18.2975,367
24549,187723,A9263BE9008920F9142A0014B55D5185,31471,12,13,1,109.34583,18.29563,917
24550,187730,182D5101D28D51096306D4EF5FDD4501,60084,2,6,4,109.4984,18.2334,1507
24551,187731,182D5101D28D51096306D4EF5FDD4501,30361,9,11,2,109.50347,18.24,1508
24555,187817,A6AC80D1B196B7846A22B3CFEA4051A4,60661,0,8,8,109.548,18.2377,1657
24556,187819,A6AC80D1B196B7846A22B3CFEA4051A4,60661,18,22,4,109.548,18.2377,1657
24557,187839,76DA946F4DC1318DD46A32E1D303D6B7,39181,16,17,1,109.55153,18.28035,1715
24558,187840,76DA946F4DC1318DD46A32E1D303D6B7,31931,21,22,1,109.54771,18.29403,1667
24559,187848,975CB35586D2D95A387E2AA86A5AB719,30671,0,8,8,109.43611,18.30139,1268
24560,187849,975CB35586D2D95A387E2AA86A5AB719,31351,11,13,2,109.4959,18.28417,1465
24561,187850,975CB35586D2D95A387E2AA86A5AB719,30271,14,15,1,109.49132,18.23153,1456
24565,187897,807332CEC38772FA8DF98C48FBD8DD1E,31561,16,17,1,109.56792,18.28479,1765
24566,187898,807332CEC38772FA8DF98C48FBD8DD1E,30854,19,21,2,109.56889,18.27076,1763
24567,187899,807332CEC38772FA8DF98C48FBD8DD1E,31561,21,22,1,109.56792,18.28479,1765
24568,187900,97C31877CA4226D0F1BA1C0E12066B56,30854,7,16,9,109.56889,18.27076,1763
24569,187901,97C31877CA4226D0F1BA1C0E12066B56,60331,19,23,4,109.505,18.26507,1512
24580,187972,608A55C14BAB2A5B627ACC1F39B89FB6,31945,0,6,6,109.58021,18.29403,1817
24581,187973,608A55C14BAB2A5B627ACC1F39B89FB6,30854,8,10,2,109.56889,18.27076,1763
24582,187974,608A55C14BAB2A5B627ACC1F39B89FB6,31071,11,12,1,109.58257,18.28458,1815
24583,187975,608A55C14BAB2A5B627ACC1F39B89FB6,30854,13,17,4,109.56889,18.27076,1763
24584,187976,608A55C14BAB2A5B627ACC1F39B89FB6,31945,21,22,1,109.58021,18.29403,1817
24585,188006,410DD8A32244BC0C8E0A44B87218A19E,39053,0,1,1,109.511,18.2771,1564
24586,188007,410DD8A32244BC0C8E0A44B87218A19E,30854,2,9,7,109.56889,18.27076,1763
24587,188030,D75F3D28EEDDC3AAB22F587F99A79102,30854,0,11,11,109.56889,18.27076,1763
24588,188031,D75F3D28EEDDC3AAB22F587F99A79102,31071,11,12,1,109.58257,18.28458,1815
24589,188032,D75F3D28EEDDC3AAB22F587F99A79102,30854,15,18,3,109.56889,18.27076,1763
24590,188033,D75F3D28EEDDC3AAB22F587F99A79102,30851,18,19,1,109.5616,18.27396,1713
24591,188034,D75F3D28EEDDC3AAB22F587F99A79102,30854,20,21,1,109.56889,18.27076,1763
24592,188044,CFAA4900917F16A6BB33BA227F202636,31071,3,8,5,109.58257,18.28458,1815
24593,188045,CFAA4900917F16A6BB33BA227F202636,30854,8,11,3,109.56889,18.27076,1763
24594,188091,5E6F81A7DA23F57413C15AC7514275E5,31945,5,18,13,109.58021,18.29403,1817
24595,188092,5E6F81A7DA23F57413C15AC7514275E5,30851,19,21,2,109.5616,18.27396,1713
24596,188096,B09F6CB43F7BB3E6391589239BFB1120,38951,2,17,15,109.48097,18.28868,1416
24597,188097,B09F6CB43F7BB3E6391589239BFB1120,30681,19,22,3,109.48493,18.26917,1463
24602,188144,F463C6D05ADE42D98ADCBBE75434CCEF,30201,0,9,9,109.4909,18.26465,1462
24603,188145,F463C6D05ADE42D98ADCBBE75434CCEF,60054,13,15,2,109.3016,18.31229,770
24604,188146,F463C6D05ADE42D98ADCBBE75434CCEF,31021,19,23,4,109.49021,18.27,1463
24605,188184,E605B26D53F08A0D3360A4541E09F4E2,38283,0,8,8,109.62229,18.22618,1956
24606,188185,E605B26D53F08A0D3360A4541E09F4E2,38283,12,15,3,109.62229,18.22618,1956
24607,188211,2C5F898948A2B7909519666936FBF333,38707,0,14,14,109.73778,18.35368,2427
24608,188212,2C5F898948A2B7909519666936FBF333,38707,15,23,8,109.73778,18.35368,2427
24609,188230,637A9DA12514DD49C1B8E5B00DF49C3A,31681,16,17,1,109.40396,18.29979,1168
24610,188231,637A9DA12514DD49C1B8E5B00DF49C3A,30351,17,20,3,109.41701,18.29292,1217
24611,188255,77F5A37783010C53E376197FE3F1043D,30071,4,16,12,109.52819,18.30472,1619
24612,188256,77F5A37783010C53E376197FE3F1043D,60361,19,23,4,109.51938,18.29681,1567
24613,188260,C48911F2501F3C5309DA39E0641B7D38,31071,0,15,15,109.58257,18.28458,1815
24614,188261,C48911F2501F3C5309DA39E0641B7D38,30854,17,20,3,109.56889,18.27076,1763
24615,188270,89A01963B06628A3D6B13DA41FA507D1,30854,0,6,6,109.56889,18.27076,1763
24616,188271,89A01963B06628A3D6B13DA41FA507D1,31161,8,14,6,109.70229,18.31361,2270
24617,188272,89A01963B06628A3D6B13DA41FA507D1,30854,18,20,2,109.56889,18.27076,1763
24618,188273,0F558B6653C655C7F0BAEA9D66B33F57,31071,9,10,1,109.58257,18.28458,1815
24619,188274,0F558B6653C655C7F0BAEA9D66B33F57,30854,11,22,11,109.56889,18.27076,1763
24620,188275,1026894DC5FF9A7FAF3A2EE28B95E239,30232,9,12,3,109.6191,18.31701,1971
24621,188276,1026894DC5FF9A7FAF3A2EE28B95E239,30854,13,15,2,109.56889,18.27076,1763
24622,188277,1026894DC5FF9A7FAF3A2EE28B95E239,38085,16,17,1,109.6291,18.23625,2007
24623,188296,D93AA4B2BEBDAF08795028EBAFF2CAE4,31701,0,8,8,109.44132,18.28833,1266
24624,188297,D93AA4B2BEBDAF08795028EBAFF2CAE4,31561,13,14,1,109.56792,18.28479,1765
24625,188298,D93AA4B2BEBDAF08795028EBAFF2CAE4,31701,18,23,5,109.44132,18.28833,1266
24626,188299,A4823EEC9A8E697E80697432C029B488,30391,10,12,2,109.4975,18.27118,1513
24627,188300,A4823EEC9A8E697E80697432C029B488,30421,13,15,2,109.50021,18.25861,1511
24628,188301,A4823EEC9A8E697E80697432C029B488,30391,18,20,2,109.4975,18.27118,1513
24629,188323,A01B4012B619D942E7CC3AC9B78722B4,31561,0,7,7,109.56792,18.28479,1765
24630,188324,A01B4012B619D942E7CC3AC9B78722B4,31931,7,9,2,109.54771,18.29403,1667
24631,188325,A01B4012B619D942E7CC3AC9B78722B4,31561,9,10,1,109.56792,18.28479,1765
24632,188326,A01B4012B619D942E7CC3AC9B78722B4,39183,10,12,2,109.55542,18.28208,1715
24633,188327,A01B4012B619D942E7CC3AC9B78722B4,31561,12,23,11,109.56792,18.28479,1765
24637,188343,417408FFDA93B177641D270D3A5C4B2D,31071,0,6,6,109.58257,18.28458,1815
24638,188344,417408FFDA93B177641D270D3A5C4B2D,30854,10,11,1,109.56889,18.27076,1763
24639,188345,03CF17D18D5ABB539B8A67460591BD40,60541,0,8,8,109.4084,18.29208,1167
24640,188346,03CF17D18D5ABB539B8A67460591BD40,30211,10,20,10,109.49882,18.23931,1508
24641,188347,03CF17D18D5ABB539B8A67460591BD40,60291,20,23,3,109.50826,18.24639,1509
24642,188389,F0D8EB3805762325257E07582BA2416E,30861,13,16,3,109.52722,18.22743,1606
24643,188390,F0D8EB3805762325257E07582BA2416E,60381,19,23,4,109.5241,18.22458,1605
24644,188417,A4743972EC2FC58546DD11935BDC0E1A,30711,11,15,4,109.50271,18.25347,1510
24645,188418,A4743972EC2FC58546DD11935BDC0E1A,30421,19,20,1,109.50021,18.25861,1511
24646,188419,A4743972EC2FC58546DD11935BDC0E1A,39154,21,23,2,109.50201,18.25681,1511
24647,188424,0A9117B90774715AACE2ED3045D6F579,60551,0,8,8,109.42722,18.30111,1218
24648,188425,0A9117B90774715AACE2ED3045D6F579,31031,11,13,2,109.49979,18.25382,1510
24649,188426,0A9117B90774715AACE2ED3045D6F579,31181,13,14,1,109.50382,18.24813,1509
24650,188428,0A9117B90774715AACE2ED3045D6F579,60552,21,22,1,109.41729,18.30014,1218
24651,188436,FDC054EE1F6297074BC908470125F9F1,48574,1,6,5,109.48931,18.28458,1465
24652,188437,FDC054EE1F6297074BC908470125F9F1,31864,7,8,1,109.49014,18.28333,1465
24653,188438,FDC054EE1F6297074BC908470125F9F1,31471,10,11,1,109.34583,18.29563,917
24654,188439,FDC054EE1F6297074BC908470125F9F1,31031,18,21,3,109.49979,18.25382,1510
24655,188440,FDC054EE1F6297074BC908470125F9F1,48574,22,23,1,109.48931,18.28458,1465
24656,188461,F866B6E34CEF853A6497211DD74A607E,30201,15,17,2,109.4909,18.26465,1462
24657,188462,F866B6E34CEF853A6497211DD74A607E,60117,20,23,3,109.73604,18.35681,2427
24658,188532,BD4652414D5C17466BA36FD4BD943A94,60274,4,5,1,109.514,18.2933,1567
24659,188533,BD4652414D5C17466BA36FD4BD943A94,39053,6,7,1,109.511,18.2771,1564
24660,188534,BD4652414D5C17466BA36FD4BD943A94,39183,8,13,5,109.55542,18.28208,1715
24661,188535,BD4652414D5C17466BA36FD4BD943A94,39181,18,20,2,109.55153,18.28035,1715
24662,188536,BD4652414D5C17466BA36FD4BD943A94,31041,22,23,1,109.50278,18.23701,1507
24663,188564,B421B0364BC07B443944D07A1DCB065A,31461,0,9,9,109.5091,18.25389,1510
24664,188565,B421B0364BC07B443944D07A1DCB065A,39091,12,13,1,109.50097,18.25222,1510
24665,188566,B421B0364BC07B443944D07A1DCB065A,31931,15,16,1,109.54771,18.29403,1667
24666,188567,B421B0364BC07B443944D07A1DCB065A,60201,18,20,2,109.5041,18.2509,1510
24667,188602,B3570D3DE8F1063CDA8C0E261A8F3734,30241,11,12,1,109.26174,18.3275,622
24668,188603,B3570D3DE8F1063CDA8C0E261A8F3734,31471,13,16,3,109.34583,18.29563,917
24669,188604,D517610C2076C41FED0ED80CB6FFB44C,30851,8,17,9,109.5616,18.27396,1713
24670,188605,D517610C2076C41FED0ED80CB6FFB44C,30951,19,21,2,109.56208,18.25667,1761
24671,188606,D517610C2076C41FED0ED80CB6FFB44C,31561,22,23,1,109.56792,18.28479,1765
24672,188644,1D8B56371E487F3812C9965576175C8D,38361,0,10,10,109.43667,18.29201,1267
24673,188645,1D8B56371E487F3812C9965576175C8D,30084,11,12,1,109.50118,18.26972,1513
24674,188646,1D8B56371E487F3812C9965576175C8D,30171,12,13,1,109.48458,18.27139,1463
24675,188647,1D8B56371E487F3812C9965576175C8D,38361,16,17,1,109.43667,18.29201,1267
24676,188648,1D8B56371E487F3812C9965576175C8D,31861,18,20,2,109.49042,18.27549,1464
24677,188649,1D8B56371E487F3812C9965576175C8D,38361,21,23,2,109.43667,18.29201,1267
24682,188669,C85D0B931BEF54F05B9ABBBB03212DB7,31561,0,8,8,109.56792,18.28479,1765
24683,188670,C85D0B931BEF54F05B9ABBBB03212DB7,30854,8,22,14,109.56889,18.27076,1763
24684,188770,EBF906C5498076BCFA3E97DF6001B4F3,60631,0,7,7,109.57778,18.27583,1814
24685,188771,EBF906C5498076BCFA3E97DF6001B4F3,30854,10,12,2,109.56889,18.27076,1763
24686,188801,219721364FA6301D2F800ECE1EBFC972,30361,11,12,1,109.50347,18.24,1508
24687,188802,219721364FA6301D2F800ECE1EBFC972,30211,13,17,4,109.49882,18.23931,1508
24688,188803,219721364FA6301D2F800ECE1EBFC972,30211,18,23,5,109.49882,18.23931,1508
24689,188820,044B260BB5F12A7C76BF06F0DD8F09A0,30181,7,8,1,109.51597,18.23313,1557
24690,188821,044B260BB5F12A7C76BF06F0DD8F09A0,31521,9,10,1,109.51458,18.22542,1555
24691,188822,044B260BB5F12A7C76BF06F0DD8F09A0,30181,13,17,4,109.51597,18.23313,1557
24692,188823,044B260BB5F12A7C76BF06F0DD8F09A0,31521,19,20,1,109.51458,18.22542,1555
24693,188826,75817DB682187A07461734D66E1E6492,30854,9,13,4,109.56889,18.27076,1763
24694,188827,75817DB682187A07461734D66E1E6492,31071,13,14,1,109.58257,18.28458,1815
24695,188828,75817DB682187A07461734D66E1E6492,31061,19,20,1,109.53333,18.23257,1607
24696,188829,75817DB682187A07461734D66E1E6492,60631,22,23,1,109.57778,18.27583,1814
24697,188899,53875E69050EC42E511A64D3211FA7B3,60631,3,5,2,109.57778,18.27583,1814
24698,188900,53875E69050EC42E511A64D3211FA7B3,30854,9,15,6,109.56889,18.27076,1763
24699,188901,53875E69050EC42E511A64D3211FA7B3,60101,20,22,2,109.75465,18.40139,2485
24700,188926,B9443F64442A80E319EB0A8B9F1B13FA,30891,0,6,6,109.59431,18.28389,1865
24701,188927,B9443F64442A80E319EB0A8B9F1B13FA,30851,6,7,1,109.5616,18.27396,1713
24702,188928,B9443F64442A80E319EB0A8B9F1B13FA,31101,12,14,2,109.65389,18.23403,2057
24703,188929,B9443F64442A80E319EB0A8B9F1B13FA,31721,14,15,1,109.67938,18.24014,2158
24704,188965,79093FC5CD83BC87E594DF8DD17421B3,30351,19,21,2,109.41701,18.29292,1217
24705,188968,5E97A4561E11AAC4FBC53FD068EAA52B,30891,0,6,6,109.59431,18.28389,1865
24706,188969,5E97A4561E11AAC4FBC53FD068EAA52B,30854,7,8,1,109.56889,18.27076,1763
24707,188970,5E97A4561E11AAC4FBC53FD068EAA52B,30531,10,20,10,109.53271,18.21472,1604
24708,188971,5E97A4561E11AAC4FBC53FD068EAA52B,30854,21,22,1,109.56889,18.27076,1763
24712,189116,9EDC789413D54BDC00C69BCE3615AF7F,31351,0,11,11,109.4959,18.28417,1465
24713,189129,E960A9C960574B6ECAA9E8161ED40783,60084,1,7,6,109.4984,18.2334,1507
24714,189130,E960A9C960574B6ECAA9E8161ED40783,31781,12,15,3,109.19847,18.2975,367
24715,189133,5BD3BF1CB6F50721BC625B86AA70AC34,60524,1,9,8,109.42951,18.28993,1216
24716,189134,5BD3BF1CB6F50721BC625B86AA70AC34,30661,11,13,2,109.37028,18.24361,1008
24717,189150,4734AFF1B70F6E2220C283E468A26DA6,38356,20,23,3,109.50201,18.21486,1504
24722,189181,B2C1D7D797194AB8141D50C733D584D6,60524,0,7,7,109.42951,18.28993,1216
24723,189182,B2C1D7D797194AB8141D50C733D584D6,31781,11,13,2,109.19847,18.2975,367
24724,189183,B2C1D7D797194AB8141D50C733D584D6,30361,17,19,2,109.50347,18.24,1508
24725,189184,B2C1D7D797194AB8141D50C733D584D6,60524,21,23,2,109.42951,18.28993,1216
24726,189198,4995463B780282C9C030A19D9F49AEAC,30854,7,17,10,109.56889,18.27076,1763
24727,189199,4995463B780282C9C030A19D9F49AEAC,31071,19,21,2,109.58257,18.28458,1815
24728,189209,4E94ADAE7ABEB20EEFAF67519DFCC1BE,31081,0,9,9,109.44639,18.30181,1318
24729,189210,4E94ADAE7ABEB20EEFAF67519DFCC1BE,31031,9,22,13,109.49979,18.25382,1510
24730,189267,4D9A472B7DD43E0DD6EF3059F08EEEB1,30051,6,10,4,109.48917,18.21215,1453
24731,189268,4D9A472B7DD43E0DD6EF3059F08EEEB1,31231,11,13,2,109.42597,18.29292,1217
24732,189269,4D9A472B7DD43E0DD6EF3059F08EEEB1,30361,17,21,4,109.50347,18.24,1508
24733,189279,8F1EF92DD1571C1CE1F083763A3D65D0,30891,0,6,6,109.59431,18.28389,1865
24734,189280,8F1EF92DD1571C1CE1F083763A3D65D0,31071,9,11,2,109.58257,18.28458,1815
24735,189281,8F1EF92DD1571C1CE1F083763A3D65D0,30221,11,13,2,109.57833,18.20222,1802
24743,189408,8C5A16299A6D294198C90C34C25C5949,30851,0,3,3,109.5616,18.27396,1713
24744,189409,8C5A16299A6D294198C90C34C25C5949,39183,4,6,2,109.55542,18.28208,1715
24745,189410,8C5A16299A6D294198C90C34C25C5949,31561,11,12,1,109.56792,18.28479,1765
24746,189411,8C5A16299A6D294198C90C34C25C5949,39183,12,13,1,109.55542,18.28208,1715
24747,189412,8C5A16299A6D294198C90C34C25C5949,31561,16,17,1,109.56792,18.28479,1765
24748,189413,8C5A16299A6D294198C90C34C25C5949,39183,21,23,2,109.55542,18.28208,1715
24749,189416,35C6EDC8AAC6B5ABA770190223528BA2,30391,0,1,1,109.4975,18.27118,1513
24750,189417,35C6EDC8AAC6B5ABA770190223528BA2,30861,2,8,6,109.52722,18.22743,1606
24751,189418,35C6EDC8AAC6B5ABA770190223528BA2,33521,11,15,4,109.66313,18.45174,2143
24752,189446,C2EDA129DED7B4E10FC6588761A88D65,39053,0,7,7,109.511,18.2771,1564
24753,189447,C2EDA129DED7B4E10FC6588761A88D65,60291,9,10,1,109.50826,18.24639,1509
24754,189514,0E0D6E55BB1995EBF85F6B7AA8765E55,30854,0,14,14,109.56889,18.27076,1763
24755,189515,0E0D6E55BB1995EBF85F6B7AA8765E55,38271,15,23,8,109.62632,18.23049,1956
24756,189541,44F505B3929E26B4B29F00CC284F3084,31071,1,13,12,109.58257,18.28458,1815
24757,189542,44F505B3929E26B4B29F00CC284F3084,30854,16,23,7,109.56889,18.27076,1763
24758,189547,C1F9914EF577AE2A8300B1A3945A50FF,31561,0,9,9,109.56792,18.28479,1765
24759,189548,C1F9914EF577AE2A8300B1A3945A50FF,30851,11,13,2,109.5616,18.27396,1713
24760,189549,C1F9914EF577AE2A8300B1A3945A50FF,31561,13,14,1,109.56792,18.28479,1765
24761,189550,C1F9914EF577AE2A8300B1A3945A50FF,30854,15,16,1,109.56889,18.27076,1763
24762,189551,C1F9914EF577AE2A8300B1A3945A50FF,31561,18,20,2,109.56792,18.28479,1765
24766,189565,21EA50B7F2072F2024B9F3B7B9174B94,38154,1,7,6,109.5266,18.28278,1615
24767,189566,21EA50B7F2072F2024B9F3B7B9174B94,30232,9,18,9,109.6191,18.31701,1971
24768,189567,21EA50B7F2072F2024B9F3B7B9174B94,60501,18,20,2,109.48701,18.29021,1466
24782,189709,3604A30B97765FCF194506153EE8C0D9,31945,0,6,6,109.58021,18.29403,1817
24783,189710,3604A30B97765FCF194506153EE8C0D9,30854,10,23,13,109.56889,18.27076,1763
24784,189726,088829826E35A8DF49EB0AEC08CE7FE7,30661,0,3,3,109.37028,18.24361,1008
24785,189727,088829826E35A8DF49EB0AEC08CE7FE7,60054,5,7,2,109.3016,18.31229,770
24786,189728,088829826E35A8DF49EB0AEC08CE7FE7,30661,7,9,2,109.37028,18.24361,1008
24787,189729,088829826E35A8DF49EB0AEC08CE7FE7,60054,10,16,6,109.3016,18.31229,770
24788,189734,3047F6D5E6312C5CD043B8770B1E8967,31391,10,11,1,109.50382,18.24285,1508
24789,189735,3047F6D5E6312C5CD043B8770B1E8967,30161,12,15,3,109.50042,18.24389,1508
24790,189736,94C4D5691F7DFC1AB38806AFFAC1389E,31931,9,16,7,109.54771,18.29403,1667
24791,189737,94C4D5691F7DFC1AB38806AFFAC1389E,60241,17,18,1,109.53319,18.28667,1616
24792,189738,94C4D5691F7DFC1AB38806AFFAC1389E,31931,20,23,3,109.54771,18.29403,1667
24793,189770,E191BF114A3C2277CB7C3323BAA13F43,30854,0,15,15,109.56889,18.27076,1763
24794,189771,E191BF114A3C2277CB7C3323BAA13F43,31301,19,20,1,109.14493,18.31222,170
24795,189772,E191BF114A3C2277CB7C3323BAA13F43,30854,22,23,1,109.56889,18.27076,1763
24796,189788,EB5C701CC758E473EF822E076B49A534,31311,9,10,1,109.72299,18.27438,2364
24797,189789,EB5C701CC758E473EF822E076B49A534,31145,15,16,1,109.20431,18.30479,369
24798,189790,EB5C701CC758E473EF822E076B49A534,30421,20,23,3,109.50021,18.25861,1511
24799,189807,A68637AA89BD62624E677D9E66C32FAD,39101,0,4,4,109.50132,18.24931,1509
24800,189808,A68637AA89BD62624E677D9E66C32FAD,30361,5,8,3,109.50347,18.24,1508
24801,189809,A68637AA89BD62624E677D9E66C32FAD,30161,8,13,5,109.50042,18.24389,1508
24802,189810,A68637AA89BD62624E677D9E66C32FAD,31391,14,16,2,109.50382,18.24285,1508
24803,189811,A68637AA89BD62624E677D9E66C32FAD,30161,17,23,6,109.50042,18.24389,1508
24804,189812,0989A1FA83098A129EC9A63DDE064266,31561,1,2,1,109.56792,18.28479,1765
24805,189813,0989A1FA83098A129EC9A63DDE064266,30854,5,12,7,109.56889,18.27076,1763
24806,189814,0989A1FA83098A129EC9A63DDE064266,31071,12,14,2,109.58257,18.28458,1815
24807,189815,0989A1FA83098A129EC9A63DDE064266,30854,17,18,1,109.56889,18.27076,1763
24808,189816,0989A1FA83098A129EC9A63DDE064266,31071,18,23,5,109.58257,18.28458,1815
24812,189879,3389A095460231D31BA622B7185D6321,31231,0,1,1,109.42597,18.29292,1217
24813,189880,3389A095460231D31BA622B7185D6321,60552,2,4,2,109.41729,18.30014,1218
24814,189881,3389A095460231D31BA622B7185D6321,31681,6,8,2,109.40396,18.29979,1168
24815,189882,3389A095460231D31BA622B7185D6321,60541,8,11,3,109.4084,18.29208,1167
24816,189883,3389A095460231D31BA622B7185D6321,31681,12,14,2,109.40396,18.29979,1168
24817,189884,3389A095460231D31BA622B7185D6321,60541,17,19,2,109.4084,18.29208,1167
24818,189885,3389A095460231D31BA622B7185D6321,60552,19,21,2,109.41729,18.30014,1218
24819,189920,90B0A60855A43B2DB99A0964CE51D3AF,31071,0,7,7,109.58257,18.28458,1815
24820,189921,90B0A60855A43B2DB99A0964CE51D3AF,30854,8,10,2,109.56889,18.27076,1763
24821,189941,ABF738EC798E54DC6486A640123BFFD8,31071,2,7,5,109.58257,18.28458,1815
24822,189942,ABF738EC798E54DC6486A640123BFFD8,60291,11,13,2,109.50826,18.24639,1509
24823,189943,ABF738EC798E54DC6486A640123BFFD8,39091,13,22,9,109.50097,18.25222,1510
24824,190005,A65416E0023DB5B05C85EFD796D8188E,38251,0,9,9,109.49618,18.25493,1510
24825,190006,A65416E0023DB5B05C85EFD796D8188E,30361,11,13,2,109.50347,18.24,1508
24826,190007,A65416E0023DB5B05C85EFD796D8188E,30711,13,16,3,109.50271,18.25347,1510
24827,190008,A65416E0023DB5B05C85EFD796D8188E,38291,18,20,2,109.51618,18.24313,1558
24828,190009,A65416E0023DB5B05C85EFD796D8188E,38251,20,23,3,109.49618,18.25493,1510
24829,190016,D334753E33AD01D79142036B3D85543F,31561,0,5,5,109.56792,18.28479,1765
24830,190017,D334753E33AD01D79142036B3D85543F,31931,9,10,1,109.54771,18.29403,1667
24831,190018,D334753E33AD01D79142036B3D85543F,31561,11,13,2,109.56792,18.28479,1765
24832,190019,D334753E33AD01D79142036B3D85543F,30851,20,21,1,109.5616,18.27396,1713
24833,190020,D334753E33AD01D79142036B3D85543F,31561,22,23,1,109.56792,18.28479,1765
24834,190135,A9FCE0049DB44FE004EAFBF5B783F4A5,30854,0,8,8,109.56889,18.27076,1763
24835,190136,A9FCE0049DB44FE004EAFBF5B783F4A5,31071,8,10,2,109.58257,18.28458,1815
24836,190137,A9FCE0049DB44FE004EAFBF5B783F4A5,30854,10,16,6,109.56889,18.27076,1763
24837,190138,A9FCE0049DB44FE004EAFBF5B783F4A5,31071,16,18,2,109.58257,18.28458,1815
24838,190139,A9FCE0049DB44FE004EAFBF5B783F4A5,39091,22,23,1,109.50097,18.25222,1510
24839,190195,0467E7A2F341B63F33E9945177D53E54,31521,0,1,1,109.51458,18.22542,1555
24840,190196,0467E7A2F341B63F33E9945177D53E54,31521,4,8,4,109.51458,18.22542,1555
24841,190197,0467E7A2F341B63F33E9945177D53E54,31101,11,12,1,109.65389,18.23403,2057
24842,190208,84DF4A7C208235D171EF56473BCCF210,30851,19,23,4,109.5616,18.27396,1713
24843,190237,C3071072DB6684DC75BE160268E6323C,30854,16,18,2,109.56889,18.27076,1763
24844,190238,C3071072DB6684DC75BE160268E6323C,30324,20,22,2,109.50326,18.29257,1517
24845,190239,A94F66C88B84FF0658441320CD9F667C,60631,1,6,5,109.57778,18.27583,1814
24846,190240,A94F66C88B84FF0658441320CD9F667C,30854,7,18,11,109.56889,18.27076,1763
24850,190274,8CE55AC8BC984D52D16D6CE4872EB6FC,31391,4,15,11,109.50382,18.24285,1508
24851,190280,B8587D3CED4B79DF3F07DD5419A719F9,38754,16,17,1,109.74667,18.37382,2430
24852,190281,B8587D3CED4B79DF3F07DD5419A719F9,31031,19,21,2,109.49979,18.25382,1510
24853,190282,B8587D3CED4B79DF3F07DD5419A719F9,31231,21,23,2,109.42597,18.29292,1217
24854,190307,40D62DAB923B148A7A4FFB3BCA6C7343,31271,14,15,1,109.48958,18.26257,1462
24855,190308,40D62DAB923B148A7A4FFB3BCA6C7343,38951,18,19,1,109.48097,18.28868,1416
24856,190318,FEB5D5949975AC1B686ACF91B7A6C2AD,31271,0,8,8,109.48958,18.26257,1462
24857,190319,FEB5D5949975AC1B686ACF91B7A6C2AD,30961,12,13,1,109.74042,18.37903,2431
24858,190320,FEB5D5949975AC1B686ACF91B7A6C2AD,38251,16,17,1,109.49618,18.25493,1510
24859,190321,FEB5D5949975AC1B686ACF91B7A6C2AD,30361,19,22,3,109.50347,18.24,1508
24860,190347,F00821368F615DCDAF214035D8EC4A44,31071,0,4,4,109.58257,18.28458,1815
24861,190348,F00821368F615DCDAF214035D8EC4A44,30854,5,22,17,109.56889,18.27076,1763
24866,190370,934029FB5F97BCE114EDCE88F0393A63,31031,19,21,2,109.49979,18.25382,1510
24867,190371,934029FB5F97BCE114EDCE88F0393A63,39371,21,22,1,109.56627,18.2646,1762
24871,190386,335A7B1DE8538918FDA774EE3E402A76,30191,0,7,7,109.50361,18.22701,1506
24872,190387,335A7B1DE8538918FDA774EE3E402A76,31521,7,11,4,109.51458,18.22542,1555
24879,190460,54A6757CA4BF8A47C41CF1DDCA6EA505,30854,0,12,12,109.56889,18.27076,1763
24880,190461,54A6757CA4BF8A47C41CF1DDCA6EA505,30891,17,18,1,109.59431,18.28389,1865
24881,190498,07169E7114E4F14C073261BAAC0D4491,61011,5,12,7,109.60653,18.19076,1900
24882,190514,DDA0EB7263815D997F150C58431C5F5D,30351,0,4,4,109.41701,18.29292,1217
24883,190515,DDA0EB7263815D997F150C58431C5F5D,30351,5,8,3,109.41701,18.29292,1217
24884,190516,DDA0EB7263815D997F150C58431C5F5D,30661,11,13,2,109.37028,18.24361,1008
24885,190517,DDA0EB7263815D997F150C58431C5F5D,30351,15,17,2,109.41701,18.29292,1217
24886,190522,9AE2F7694D67538FB73269B53D8C1BCE,38903,19,21,2,109.39229,18.29243,1117
24887,190523,9AE2F7694D67538FB73269B53D8C1BCE,38325,21,23,2,109.39792,18.2909,1116
24888,190540,25029E441FE00FCACF889ABEDF6D0DA6,38141,0,9,9,109.39479,18.2916,1116
24889,190541,25029E441FE00FCACF889ABEDF6D0DA6,38141,12,21,9,109.39479,18.2916,1116
24894,190563,9C1407835BC54BEBDB541F52E1DA1820,61011,0,2,2,109.60653,18.19076,1900
24895,190565,9C1407835BC54BEBDB541F52E1DA1820,61011,5,9,4,109.60653,18.19076,1900
24896,190577,3A4E228E5E71900953BAD30C430563D8,60371,0,7,7,109.53063,18.30056,1618
24897,190578,3A4E228E5E71900953BAD30C430563D8,30851,8,10,2,109.5616,18.27396,1713
24898,190579,3A4E228E5E71900953BAD30C430563D8,60371,13,15,2,109.53063,18.30056,1618
24899,190580,3A4E228E5E71900953BAD30C430563D8,30921,15,16,1,109.53903,18.29451,1667
24900,190581,3A4E228E5E71900953BAD30C430563D8,60371,18,22,4,109.53063,18.30056,1618
24901,190660,7B9D64657CE26DF907B4C2AC87C9F431,60371,7,9,2,109.53063,18.30056,1618
24902,190661,7B9D64657CE26DF907B4C2AC87C9F431,38241,9,10,1,109.54111,18.30542,1669
24903,190662,7B9D64657CE26DF907B4C2AC87C9F431,60371,13,15,2,109.53063,18.30056,1618
24904,190663,7B9D64657CE26DF907B4C2AC87C9F431,31931,19,20,1,109.54771,18.29403,1667
24908,190700,B80D4B4CDBD08237A9C4254F8883AEF4,31534,18,20,2,109.49368,18.25806,1461
24909,190701,B80D4B4CDBD08237A9C4254F8883AEF4,39151,20,23,3,109.49875,18.25097,1510
24913,190738,DC29C676832347947F366933ECB88090,39183,0,2,2,109.55542,18.28208,1715
24914,190739,DC29C676832347947F366933ECB88090,31561,3,23,20,109.56792,18.28479,1765
24915,190760,8068F1EF55119CC805C3493D560CAAB3,31071,2,4,2,109.58257,18.28458,1815
24916,190761,8068F1EF55119CC805C3493D560CAAB3,30854,5,8,3,109.56889,18.27076,1763
24917,190762,8068F1EF55119CC805C3493D560CAAB3,30221,9,10,1,109.57833,18.20222,1802
24918,190763,8068F1EF55119CC805C3493D560CAAB3,30731,12,15,3,109.50944,18.22306,1555
24919,190764,8068F1EF55119CC805C3493D560CAAB3,31071,19,21,2,109.58257,18.28458,1815
24920,190765,8068F1EF55119CC805C3493D560CAAB3,31945,22,23,1,109.58021,18.29403,1817
24921,190766,99CBAA6A65A50998F0A10B72B36210E4,30051,3,14,11,109.48917,18.21215,1453
24922,190767,99CBAA6A65A50998F0A10B72B36210E4,60231,18,22,4,109.49903,18.21972,1504
24923,190781,0B625DE57093602A177FF6EF2935F6D3,60381,0,3,3,109.5241,18.22458,1605
24924,190782,0B625DE57093602A177FF6EF2935F6D3,31521,4,7,3,109.51458,18.22542,1555
24925,190783,0B625DE57093602A177FF6EF2935F6D3,60381,8,9,1,109.5241,18.22458,1605
24926,190784,0B625DE57093602A177FF6EF2935F6D3,60054,13,15,2,109.3016,18.31229,770
24927,190785,0B625DE57093602A177FF6EF2935F6D3,31521,18,22,4,109.51458,18.22542,1555
24928,190789,000584B3023702F3E9DDF521B1C35B1A,30854,0,2,2,109.56889,18.27076,1763
24929,190790,000584B3023702F3E9DDF521B1C35B1A,31071,3,6,3,109.58257,18.28458,1815
24930,190791,000584B3023702F3E9DDF521B1C35B1A,30854,6,8,2,109.56889,18.27076,1763
24931,190792,000584B3023702F3E9DDF521B1C35B1A,31071,11,12,1,109.58257,18.28458,1815
24932,190793,000584B3023702F3E9DDF521B1C35B1A,31071,15,17,2,109.58257,18.28458,1815
24937,190849,3C5AEA306E8A69C707195C4150E77D90,39183,7,17,10,109.55542,18.28208,1715
24938,190850,3C5AEA306E8A69C707195C4150E77D90,31931,18,19,1,109.54771,18.29403,1667
24939,190888,8D496C0E2DB1FF881021B05CE10C0242,31945,0,4,4,109.58021,18.29403,1817
24940,190889,8D496C0E2DB1FF881021B05CE10C0242,30854,8,23,15,109.56889,18.27076,1763
24941,190902,05A57DE8DC0D94268B97E02566D1A0C9,60351,0,5,5,109.58403,18.28958,1816
24942,190905,05A57DE8DC0D94268B97E02566D1A0C9,30861,14,15,1,109.52722,18.22743,1606
24943,190906,05A57DE8DC0D94268B97E02566D1A0C9,60351,18,23,5,109.58403,18.28958,1816
24944,190917,020753EF78F0A0C39658113A3377EA1E,31561,5,14,9,109.56792,18.28479,1765
24945,190918,020753EF78F0A0C39658113A3377EA1E,60381,14,15,1,109.5241,18.22458,1605
24946,190934,7FD31F65A9E7574FDAD4A110ACBA289D,60171,13,16,3,109.51292,18.30694,1569
24947,190935,7FD31F65A9E7574FDAD4A110ACBA289D,31931,19,23,4,109.54771,18.29403,1667
24948,190957,76F6A54588C8DF7DDADFC50CAA11D44C,31071,9,11,2,109.58257,18.28458,1815
24949,190958,76F6A54588C8DF7DDADFC50CAA11D44C,31561,13,15,2,109.56792,18.28479,1765
24950,190999,5D67332784D543EA1329DDE1D672CE40,38017,1,2,1,109.49729,18.21424,1504
24951,191000,5D67332784D543EA1329DDE1D672CE40,60234,4,7,3,109.49577,18.2096,1453
24952,191001,5D67332784D543EA1329DDE1D672CE40,30051,7,9,2,109.48917,18.21215,1453
24953,191002,5D67332784D543EA1329DDE1D672CE40,31781,12,14,2,109.19847,18.2975,367
24954,191003,5D67332784D543EA1329DDE1D672CE40,38017,16,18,2,109.49729,18.21424,1504
24955,191004,5D67332784D543EA1329DDE1D672CE40,38017,19,21,2,109.49729,18.21424,1504
24962,191029,213AF2099653A4ADAEF799CCC144B279,30021,0,14,14,109.12014,18.40986,86
24963,191031,51061B3DE820AF1C1C713EF684728003,31071,5,6,1,109.58257,18.28458,1815
24964,191032,51061B3DE820AF1C1C713EF684728003,30854,7,22,15,109.56889,18.27076,1763
24972,191077,68BC4ECB523764DB770AFD5383D642C3,60201,0,7,7,109.5041,18.2509,1510
24973,191078,68BC4ECB523764DB770AFD5383D642C3,60161,10,11,1,109.49174,18.26181,1461
24974,191079,68BC4ECB523764DB770AFD5383D642C3,30071,12,13,1,109.52819,18.30472,1619
24975,191080,68BC4ECB523764DB770AFD5383D642C3,38275,14,18,4,109.62875,18.22938,2006
24976,191081,68BC4ECB523764DB770AFD5383D642C3,30071,18,20,2,109.52819,18.30472,1619
24977,191089,1C9A566B8DA1C771B0866D2AEB70C2F0,31031,19,20,1,109.49979,18.25382,1510
24978,191090,1C9A566B8DA1C771B0866D2AEB70C2F0,30671,21,23,2,109.43611,18.30139,1268
24979,191098,CA63110F88D6457AD774A164FA870244,60231,0,13,13,109.49903,18.21972,1504
24980,191099,CA63110F88D6457AD774A164FA870244,30531,16,21,5,109.53271,18.21472,1604
24991,191204,6E54413485CBDE34C6A9D84D5B11990A,31781,12,14,2,109.19847,18.2975,367
24992,191278,FB01CB4AAEF97941600363E726859DCF,31521,0,7,7,109.51458,18.22542,1555
24993,191279,FB01CB4AAEF97941600363E726859DCF,60381,7,8,1,109.5241,18.22458,1605
24994,191280,FB01CB4AAEF97941600363E726859DCF,31781,10,13,3,109.19847,18.2975,367
24995,191281,FB01CB4AAEF97941600363E726859DCF,31521,16,23,7,109.51458,18.22542,1555
24996,191308,D4AA3869830031578B573FD0033C24A8,31931,17,19,2,109.54771,18.29403,1667
24997,191309,D4AA3869830031578B573FD0033C24A8,60371,19,22,3,109.53063,18.30056,1618
25002,191372,D0644281647025A7A26484BC424A7256,31101,0,1,1,109.65389,18.23403,2057
25003,191373,D0644281647025A7A26484BC424A7256,38052,3,13,10,109.62618,18.23042,1956
25004,191374,D0644281647025A7A26484BC424A7256,38331,13,15,2,109.62465,18.22736,1956
25005,191375,D0644281647025A7A26484BC424A7256,31321,18,19,1,109.63799,18.23201,2007
25006,191376,D0644281647025A7A26484BC424A7256,38052,19,21,2,109.62618,18.23042,1956
25007,191377,D0644281647025A7A26484BC424A7256,38331,21,23,2,109.62465,18.22736,1956
25012,191491,C37DBDD12F85B1DFB17F9185AF0E7708,30951,1,15,14,109.56208,18.25667,1761
25013,191492,C37DBDD12F85B1DFB17F9185AF0E7708,39371,19,20,1,109.56627,18.2646,1762
25014,191508,7084657DF30063A945AAA5EF4742695F,39183,12,13,1,109.55542,18.28208,1715
25015,191509,7084657DF30063A945AAA5EF4742695F,31931,15,16,1,109.54771,18.29403,1667
25016,191510,7084657DF30063A945AAA5EF4742695F,39183,19,23,4,109.55542,18.28208,1715
25025,191628,C49E05BA9578491269BA059D71D7A080,38027,19,20,1,109.38833,18.2909,1066
25026,191629,C49E05BA9578491269BA059D71D7A080,30351,22,23,1,109.41701,18.29292,1217
25027,191641,C8922FAF66F21ECAECB6B717FCD5A53B,60614,0,6,6,109.48799,18.29521,1467
25028,191642,C8922FAF66F21ECAECB6B717FCD5A53B,60391,6,9,3,109.47667,18.28757,1416
25029,191643,C8922FAF66F21ECAECB6B717FCD5A53B,60614,9,16,7,109.48799,18.29521,1467
25030,191644,C8922FAF66F21ECAECB6B717FCD5A53B,60391,16,18,2,109.47667,18.28757,1416
25031,191645,C8922FAF66F21ECAECB6B717FCD5A53B,60614,19,23,4,109.48799,18.29521,1467
25032,191693,A503639E15A0B5D04B0130D882921438,30711,0,17,17,109.50271,18.25347,1510
25033,191694,A503639E15A0B5D04B0130D882921438,31031,18,23,5,109.49979,18.25382,1510
25034,191705,FD5B9AB034F15F72E8BEF02193669238,60241,0,13,13,109.53319,18.28667,1616
25035,191706,FD5B9AB034F15F72E8BEF02193669238,30921,14,16,2,109.53903,18.29451,1667
25036,191707,86602408BC637A2A44D2EC51BE779605,39041,13,14,1,109.40021,18.29278,1117
25037,191708,86602408BC637A2A44D2EC51BE779605,31671,15,17,2,109.38965,18.29813,1068
25038,191711,EABE9486B25B9331D9C92F2ACD69756F,38336,0,11,11,109.61111,18.21806,1904
25039,191712,EABE9486B25B9331D9C92F2ACD69756F,60201,12,20,8,109.5041,18.2509,1510
25040,191713,EABE9486B25B9331D9C92F2ACD69756F,60381,21,23,2,109.5241,18.22458,1605
25041,191716,04ABA8BFD5D63DDF1B83BA0577C9019C,39371,2,8,6,109.56627,18.2646,1762
25042,191717,04ABA8BFD5D63DDF1B83BA0577C9019C,30854,9,10,1,109.56889,18.27076,1763
25043,191718,04ABA8BFD5D63DDF1B83BA0577C9019C,39371,12,13,1,109.56627,18.2646,1762
25044,191719,04ABA8BFD5D63DDF1B83BA0577C9019C,30854,15,16,1,109.56889,18.27076,1763
25045,191720,04ABA8BFD5D63DDF1B83BA0577C9019C,39371,19,20,1,109.56627,18.2646,1762
25046,191729,00678D3F0FE479614070948AEC721AF0,30854,0,9,9,109.56889,18.27076,1763
25047,191730,00678D3F0FE479614070948AEC721AF0,38754,11,13,2,109.74667,18.37382,2430
25048,191731,00678D3F0FE479614070948AEC721AF0,30854,17,20,3,109.56889,18.27076,1763
25049,191764,E9E473F09C342630187345312F4A31D8,39181,0,16,16,109.55153,18.28035,1715
25050,191765,E9E473F09C342630187345312F4A31D8,39181,18,23,5,109.55153,18.28035,1715
25051,191774,08A066736557478B1013C0CF834491DF,30921,1,6,5,109.53903,18.29451,1667
25052,191775,08A066736557478B1013C0CF834491DF,31931,6,18,12,109.54771,18.29403,1667
25060,191836,60C76AD19DF8888A84F620E94C92FF2B,60084,1,2,1,109.4984,18.2334,1507
25061,191837,60C76AD19DF8888A84F620E94C92FF2B,39151,4,5,1,109.49875,18.25097,1510
25062,191838,60C76AD19DF8888A84F620E94C92FF2B,60231,10,15,5,109.49903,18.21972,1504
25063,191839,60C76AD19DF8888A84F620E94C92FF2B,60084,16,17,1,109.4984,18.2334,1507
25064,191840,60C76AD19DF8888A84F620E94C92FF2B,30531,18,20,2,109.53271,18.21472,1604
25068,191859,19464A667335AE139DC940C83825CBD8,30161,10,15,5,109.50042,18.24389,1508
25072,191884,75616D7735994EB9CD2FE56D29700535,30854,7,11,4,109.56889,18.27076,1763
25073,191885,75616D7735994EB9CD2FE56D29700535,31421,14,16,2,109.55382,18.22347,1705
25074,191886,39F25FE146A03325C93C111F2A943B6C,31945,0,7,7,109.58021,18.29403,1817
25075,191887,39F25FE146A03325C93C111F2A943B6C,31071,8,9,1,109.58257,18.28458,1815
25076,191888,39F25FE146A03325C93C111F2A943B6C,31945,12,13,1,109.58021,18.29403,1817
25077,191889,39F25FE146A03325C93C111F2A943B6C,30854,15,16,1,109.56889,18.27076,1763
25078,191890,39F25FE146A03325C93C111F2A943B6C,31071,19,20,1,109.58257,18.28458,1815
25079,191891,39F25FE146A03325C93C111F2A943B6C,30854,20,22,2,109.56889,18.27076,1763
25080,191907,5DD2873132009BD9D866BCA396BA3ECB,31431,0,8,8,109.44639,18.29042,1316
25081,191908,5DD2873132009BD9D866BCA396BA3ECB,60231,12,13,1,109.49903,18.21972,1504
25082,191909,5DD2873132009BD9D866BCA396BA3ECB,60441,14,23,9,109.46792,18.28604,1366
25083,191921,67A3119E82936DF1B07EFCD41ABA5080,31271,0,8,8,109.48958,18.26257,1462
25084,191922,67A3119E82936DF1B07EFCD41ABA5080,38094,9,10,1,109.45403,18.28778,1316
25085,191923,67A3119E82936DF1B07EFCD41ABA5080,60054,13,14,1,109.3016,18.31229,770
25086,191924,67A3119E82936DF1B07EFCD41ABA5080,31271,18,22,4,109.48958,18.26257,1462
25091,191971,DFFF17B7FE30E79B8AABBB5CE171272F,31561,10,11,1,109.56792,18.28479,1765
25092,191972,DFFF17B7FE30E79B8AABBB5CE171272F,30854,12,14,2,109.56889,18.27076,1763
25093,191973,DFFF17B7FE30E79B8AABBB5CE171272F,31561,15,17,2,109.56792,18.28479,1765
25094,191974,DFFF17B7FE30E79B8AABBB5CE171272F,39183,20,21,1,109.55542,18.28208,1715
25095,192030,DCFC026A83B81F5FB8797C8205011404,31181,0,2,2,109.50382,18.24813,1509
25096,192031,DCFC026A83B81F5FB8797C8205011404,39151,3,5,2,109.49875,18.25097,1510
25097,192032,EC4B90EDBF35256FDB4D4F8B87DB8A04,31071,0,13,13,109.58257,18.28458,1815
25098,192033,EC4B90EDBF35256FDB4D4F8B87DB8A04,30854,16,17,1,109.56889,18.27076,1763
25099,192034,8CD15CF6B5FB4821940FF9AFE6D6CB84,39181,0,9,9,109.55153,18.28035,1715
25100,192035,8CD15CF6B5FB4821940FF9AFE6D6CB84,31931,11,13,2,109.54771,18.29403,1667
25101,192036,8CD15CF6B5FB4821940FF9AFE6D6CB84,30361,14,15,1,109.50347,18.24,1508
25102,192037,8CD15CF6B5FB4821940FF9AFE6D6CB84,31931,19,21,2,109.54771,18.29403,1667
25103,192153,3E06E0B107AE9E10530FC9DE60417A9C,30854,0,9,9,109.56889,18.27076,1763
25104,192154,3E06E0B107AE9E10530FC9DE60417A9C,31071,9,19,10,109.58257,18.28458,1815
25109,192189,38CF8AD578A393476F29705A4599B8B1,38891,0,8,8,109.51486,18.24118,1558
25110,192190,38CF8AD578A393476F29705A4599B8B1,38271,12,13,1,109.62632,18.23049,1956
25111,192191,38CF8AD578A393476F29705A4599B8B1,31041,17,18,1,109.50278,18.23701,1507
25112,192192,38CF8AD578A393476F29705A4599B8B1,38891,20,23,3,109.51486,18.24118,1558
25116,192204,15565874522715FB4EEB4DFBF24CA2B9,31491,0,6,6,109.73042,18.38771,2382
25117,192205,15565874522715FB4EEB4DFBF24CA2B9,38754,8,9,1,109.74667,18.37382,2430
25118,192206,15565874522715FB4EEB4DFBF24CA2B9,31951,10,11,1,109.52174,18.30299,1568
25119,192207,15565874522715FB4EEB4DFBF24CA2B9,60171,12,13,1,109.51292,18.30694,1569
25120,192208,15565874522715FB4EEB4DFBF24CA2B9,38754,13,19,6,109.74667,18.37382,2430
25121,192221,E987E65408C33CB1112132CB6DDF2895,38391,0,6,6,109.44111,18.29083,1266
25122,192222,E987E65408C33CB1112132CB6DDF2895,31431,9,23,14,109.44639,18.29042,1316
25126,192342,1D8B814EC83D52D7C5F3FED99C129EE0,60631,1,2,1,109.57778,18.27583,1814
25127,192343,1D8B814EC83D52D7C5F3FED99C129EE0,30854,4,6,2,109.56889,18.27076,1763
25128,192344,1D8B814EC83D52D7C5F3FED99C129EE0,38271,10,20,10,109.62632,18.23049,1956
25129,192345,1D8B814EC83D52D7C5F3FED99C129EE0,31561,22,23,1,109.56792,18.28479,1765
25130,192350,8AD957ABE98C62A8B6F06AA624D5CB23,30854,6,12,6,109.56889,18.27076,1763
25131,192351,8AD957ABE98C62A8B6F06AA624D5CB23,31071,13,16,3,109.58257,18.28458,1815
25132,192352,8AD957ABE98C62A8B6F06AA624D5CB23,31071,18,23,5,109.58257,18.28458,1815
25137,192428,3336A16929AE164DE73ACCE3EDAB4195,31521,0,6,6,109.51458,18.22542,1555
25138,192429,3336A16929AE164DE73ACCE3EDAB4195,31471,10,11,1,109.34583,18.29563,917
25139,192430,3336A16929AE164DE73ACCE3EDAB4195,30661,11,14,3,109.37028,18.24361,1008
25140,192431,3336A16929AE164DE73ACCE3EDAB4195,31521,16,18,2,109.51458,18.22542,1555
25141,192432,3336A16929AE164DE73ACCE3EDAB4195,39111,18,23,5,109.5191,18.22597,1555
25142,192472,71D35ED12FD809FD321ED1C8285B5582,31781,13,14,1,109.19847,18.2975,367
25143,192473,71D35ED12FD809FD321ED1C8285B5582,31471,15,16,1,109.34583,18.29563,917
25144,192474,71D35ED12FD809FD321ED1C8285B5582,38951,21,23,2,109.48097,18.28868,1416
25145,192509,947F03940C60BAB03B48F948CC8A55AE,60121,14,15,1,109.74507,18.37472,2430
25146,192510,947F03940C60BAB03B48F948CC8A55AE,30861,20,22,2,109.52722,18.22743,1606
25147,192565,591FE6773219F44C74B8131639493332,31391,0,8,8,109.50382,18.24285,1508
25148,192566,591FE6773219F44C74B8131639493332,30511,10,12,2,109.51069,18.24208,1558
25149,192567,591FE6773219F44C74B8131639493332,30361,12,14,2,109.50347,18.24,1508
25150,192568,591FE6773219F44C74B8131639493332,60594,15,17,2,109.62694,18.22799,1956
25151,192569,591FE6773219F44C74B8131639493332,30441,19,21,2,109.64021,18.25424,2010
25152,192578,5EE25A6E7DD554FFDA0C9C1A504114B7,60291,0,6,6,109.50826,18.24639,1509
25153,192579,5EE25A6E7DD554FFDA0C9C1A504114B7,30221,8,18,10,109.57833,18.20222,1802
25154,192580,5EE25A6E7DD554FFDA0C9C1A504114B7,31811,19,20,1,109.54201,18.31806,1671
25155,192581,5EE25A6E7DD554FFDA0C9C1A504114B7,30221,21,22,1,109.57833,18.20222,1802
25156,192608,E7DB0F55EDE33BB4C08C98B80B7173BF,30771,14,15,1,109.49938,18.26042,1511
25157,192609,E7DB0F55EDE33BB4C08C98B80B7173BF,60371,18,23,5,109.53063,18.30056,1618
25158,192610,410ABF8C14ACED0B5467A09396FAD1E3,31071,8,9,1,109.58257,18.28458,1815
25159,192611,410ABF8C14ACED0B5467A09396FAD1E3,30854,12,16,4,109.56889,18.27076,1763
25160,192612,410ABF8C14ACED0B5467A09396FAD1E3,31071,16,21,5,109.58257,18.28458,1815
25161,192613,7BF65E5054DA81A230AB5423620158E1,30854,7,8,1,109.56889,18.27076,1763
25162,192614,7BF65E5054DA81A230AB5423620158E1,31071,9,10,1,109.58257,18.28458,1815
25163,192615,7BF65E5054DA81A230AB5423620158E1,30854,11,15,4,109.56889,18.27076,1763
25164,192616,7BF65E5054DA81A230AB5423620158E1,31071,15,17,2,109.58257,18.28458,1815
25168,192634,D1A5E6081E70F748BFD3C6895B141C01,60411,0,2,2,109.32514,18.30854,869
25169,192635,D1A5E6081E70F748BFD3C6895B141C01,30661,2,4,2,109.37028,18.24361,1008
25170,192636,D1A5E6081E70F748BFD3C6895B141C01,60411,4,6,2,109.32514,18.30854,869
25171,192637,D1A5E6081E70F748BFD3C6895B141C01,30661,7,19,12,109.37028,18.24361,1008
25172,192638,D1A5E6081E70F748BFD3C6895B141C01,60411,21,23,2,109.32514,18.30854,869
25177,192701,394D1710D25BBA6EE7532E3C0B5270CF,38111,13,14,1,109.52007,18.22403,1555
25178,192702,394D1710D25BBA6EE7532E3C0B5270CF,39321,15,16,1,109.529,18.2167,1604
25179,192703,394D1710D25BBA6EE7532E3C0B5270CF,31521,20,22,2,109.51458,18.22542,1555
25194,192779,23348D27AE799B0D96AE7DABCCDD8B0C,31861,0,7,7,109.49042,18.27549,1464
25195,192780,23348D27AE799B0D96AE7DABCCDD8B0C,31471,9,10,1,109.34583,18.29563,917
25196,192781,23348D27AE799B0D96AE7DABCCDD8B0C,30661,11,12,1,109.37028,18.24361,1008
25197,192787,7F3DDE6B55C3459C61E435131FEEF622,31351,0,10,10,109.4959,18.28417,1465
25198,192788,7F3DDE6B55C3459C61E435131FEEF622,30581,13,14,1,109.62257,18.24951,1959
25199,192789,7F3DDE6B55C3459C61E435131FEEF622,38171,19,21,2,109.50799,18.28139,1515
25200,192799,6C0260646767B781577B5B8CE2471E51,31951,4,5,1,109.52174,18.30299,1568
25201,192800,6C0260646767B781577B5B8CE2471E51,38484,7,11,4,109.53028,18.31528,1620
25202,192801,6C0260646767B781577B5B8CE2471E51,60361,14,15,1,109.51938,18.29681,1567
25203,192802,6C0260646767B781577B5B8CE2471E51,38484,15,17,2,109.53028,18.31528,1620
25204,192803,6C0260646767B781577B5B8CE2471E51,30321,18,19,1,109.49563,18.29611,1467
25205,192804,6C0260646767B781577B5B8CE2471E51,38484,20,21,1,109.53028,18.31528,1620
25209,192812,7CCF6D37DF7208BEF6187AE3AF915883,39111,0,4,4,109.5191,18.22597,1555
25210,192813,7CCF6D37DF7208BEF6187AE3AF915883,30731,4,6,2,109.50944,18.22306,1555
25211,192814,7CCF6D37DF7208BEF6187AE3AF915883,31781,8,12,4,109.19847,18.2975,367
25212,192815,7CCF6D37DF7208BEF6187AE3AF915883,30731,17,23,6,109.50944,18.22306,1555
25213,192842,63B5E489F3503F8EC6E40A38F9D2117C,31031,11,13,2,109.49979,18.25382,1510
25214,192843,63B5E489F3503F8EC6E40A38F9D2117C,31951,14,17,3,109.52174,18.30299,1568
25215,192844,63B5E489F3503F8EC6E40A38F9D2117C,60171,22,23,1,109.51292,18.30694,1569
25216,192917,8AABF5FDF2B06EB445749240A3894969,31161,12,14,2,109.70229,18.31361,2270
25217,192918,8AABF5FDF2B06EB445749240A3894969,31851,14,16,2,109.71736,18.29007,2316
25224,192948,B2035C0684FF9CA861B7EB217CE5A160,60524,0,5,5,109.42951,18.28993,1216
25225,192949,B2035C0684FF9CA861B7EB217CE5A160,31236,6,8,2,109.42965,18.29111,1216
25226,192950,B2035C0684FF9CA861B7EB217CE5A160,30351,10,14,4,109.41701,18.29292,1217
25227,192951,B2035C0684FF9CA861B7EB217CE5A160,60041,16,19,3,109.39889,18.31944,1121
25228,192952,B2035C0684FF9CA861B7EB217CE5A160,60552,20,22,2,109.41729,18.30014,1218
25229,192953,FD8E83DD7FF39A687AC2462EEEA479A1,30171,0,7,7,109.48458,18.27139,1463
25230,192954,FD8E83DD7FF39A687AC2462EEEA479A1,30051,9,15,6,109.48917,18.21215,1453
25235,192999,5A6C2C4A9B4DF43C379FCADC2CCFC5BC,39331,20,21,1,109.62125,18.22708,1956
25236,193000,5A6C2C4A9B4DF43C379FCADC2CCFC5BC,30201,22,23,1,109.4909,18.26465,1462
25237,193027,E8BAAF476E8FE57075BAB1A8D4FF1780,30232,0,4,4,109.6191,18.31701,1971
25238,193028,E8BAAF476E8FE57075BAB1A8D4FF1780,39371,5,6,1,109.56627,18.2646,1762
25239,193029,E8BAAF476E8FE57075BAB1A8D4FF1780,30181,11,12,1,109.51597,18.23313,1557
25240,193030,E8BAAF476E8FE57075BAB1A8D4FF1780,39371,14,17,3,109.56627,18.2646,1762
25241,193031,E8BAAF476E8FE57075BAB1A8D4FF1780,31181,18,21,3,109.50382,18.24813,1509
25246,193101,5FEB0F79A440C59BADB91987EC64815F,30421,20,21,1,109.50021,18.25861,1511
25247,193112,798BF3B08F72A16A6DEAAA235F1899BB,61011,9,13,4,109.60653,18.19076,1900
25248,193114,798BF3B08F72A16A6DEAAA235F1899BB,61011,20,23,3,109.60653,18.19076,1900
25249,193171,DF467C78D5F42677C535DD714DC268A2,30721,17,19,2,109.51597,18.28257,1565
25250,193172,DF467C78D5F42677C535DD714DC268A2,38316,21,23,2,109.48542,18.27424,1464
25251,193248,3B8907096B5BACD5BD7132435146A19A,60041,12,15,3,109.39889,18.31944,1121
25252,193249,3B8907096B5BACD5BD7132435146A19A,30421,20,23,3,109.50021,18.25861,1511
25253,193311,4C8D744F276EFA40FC3A14D352CC4C3A,31471,15,17,2,109.34583,18.29563,917
25254,193312,4C8D744F276EFA40FC3A14D352CC4C3A,60401,18,20,2,109.47444,18.27583,1414
25255,193313,4C8D744F276EFA40FC3A14D352CC4C3A,60371,21,23,2,109.53063,18.30056,1618
25259,193323,02C53C5746E38501957FE72E2C83CCA4,31251,0,6,6,109.18528,18.2975,317
25260,193324,02C53C5746E38501957FE72E2C83CCA4,30651,6,8,2,109.42611,18.385,1232
25261,193325,02C53C5746E38501957FE72E2C83CCA4,31231,8,9,1,109.42597,18.29292,1217
25262,193326,02C53C5746E38501957FE72E2C83CCA4,60161,12,22,10,109.49174,18.26181,1461
25267,193362,39CA4FE8290F03A5AE8EA1D8371B2A6D,30121,19,23,4,109.52861,18.27222,1613
25268,193372,572E2789911180212572284EC334CD9D,30661,14,15,1,109.37028,18.24361,1008
25269,193373,572E2789911180212572284EC334CD9D,60501,18,19,1,109.48701,18.29021,1466
25270,193374,572E2789911180212572284EC334CD9D,30421,20,23,3,109.50021,18.25861,1511
25271,193410,BC7C85E5C2260F70932B05DBFD89E2B1,38951,0,7,7,109.48097,18.28868,1416
25272,193411,BC7C85E5C2260F70932B05DBFD89E2B1,33051,9,10,1,109.6475,18.46618,2096
25273,193412,BC7C85E5C2260F70932B05DBFD89E2B1,30661,13,15,2,109.37028,18.24361,1008
25278,193431,8689824A579D05952F091FA3AFF461AB,60524,1,6,5,109.42951,18.28993,1216
25279,193432,8689824A579D05952F091FA3AFF461AB,30351,6,7,1,109.41701,18.29292,1217
25280,193433,8689824A579D05952F091FA3AFF461AB,31145,11,12,1,109.20431,18.30479,369
25281,193451,6F6959FD6C59E6BB90C37E26B5C2BF83,30321,0,8,8,109.49563,18.29611,1467
25282,193452,6F6959FD6C59E6BB90C37E26B5C2BF83,60361,8,10,2,109.51938,18.29681,1567
25283,193453,6F6959FD6C59E6BB90C37E26B5C2BF83,30071,12,15,3,109.52819,18.30472,1619
25284,193454,6F6959FD6C59E6BB90C37E26B5C2BF83,30071,15,19,4,109.52819,18.30472,1619
25285,193455,6F6959FD6C59E6BB90C37E26B5C2BF83,60371,22,23,1,109.53063,18.30056,1618
25290,193472,C2024D8A8EDBFD4FD401299F90BFADF5,39091,12,13,1,109.50097,18.25222,1510
25291,193485,FDB9BD849EACDB9DE07F12A37BAD7769,60504,0,1,1,109.47917,18.28903,1416
25292,193486,FDB9BD849EACDB9DE07F12A37BAD7769,38951,2,22,20,109.48097,18.28868,1416
25297,193500,F0F4014EDBA84B976E9E99C8872ACAC4,30851,7,8,1,109.5616,18.27396,1713
25298,193501,F0F4014EDBA84B976E9E99C8872ACAC4,31561,10,15,5,109.56792,18.28479,1765
25299,193506,BCBE041A7FC025F9D2DFD86A6CB75E1D,60011,0,7,7,109.48965,18.30222,1468
25300,193507,BCBE041A7FC025F9D2DFD86A6CB75E1D,30821,8,11,3,109.43681,18.33639,1274
25301,193508,BCBE041A7FC025F9D2DFD86A6CB75E1D,30651,13,14,1,109.42611,18.385,1232
25302,193509,BCBE041A7FC025F9D2DFD86A6CB75E1D,30821,18,19,1,109.43681,18.33639,1274
25303,193523,E58E5EFF0A1D7ADABE8F5BBEE665ED0D,60641,0,7,7,109.53854,18.2359,1657
25304,193524,E58E5EFF0A1D7ADABE8F5BBEE665ED0D,30861,8,11,3,109.52722,18.22743,1606
25305,193525,E58E5EFF0A1D7ADABE8F5BBEE665ED0D,30861,14,16,2,109.52722,18.22743,1606
25306,193526,E58E5EFF0A1D7ADABE8F5BBEE665ED0D,60661,18,19,1,109.548,18.2377,1657
25307,193527,E58E5EFF0A1D7ADABE8F5BBEE665ED0D,30861,21,22,1,109.52722,18.22743,1606
25308,193575,0D1ADFB613CDE463D41F9DE1E81A3FEA,31061,0,16,16,109.53333,18.23257,1607
25309,193577,0D1ADFB613CDE463D41F9DE1E81A3FEA,30461,21,22,1,109.5116,18.26313,1562
25310,193586,A9634A2AD8447824C1C9412CBBCC32E0,31181,0,9,9,109.50382,18.24813,1509
25311,193587,A9634A2AD8447824C1C9412CBBCC32E0,31181,13,23,10,109.50382,18.24813,1509
25312,193610,14BFE46EEAB2E234698393270A62605D,30661,0,11,11,109.37028,18.24361,1008
25313,193611,14BFE46EEAB2E234698393270A62605D,60411,14,17,3,109.32514,18.30854,869
25314,193612,14BFE46EEAB2E234698393270A62605D,30661,21,22,1,109.37028,18.24361,1008
25315,193680,B175A0347ABEEA30E818C5CCD25E280F,30821,4,5,1,109.43681,18.33639,1274
25316,193681,B175A0347ABEEA30E818C5CCD25E280F,60011,7,8,1,109.48965,18.30222,1468
25317,193682,B175A0347ABEEA30E818C5CCD25E280F,30821,9,20,11,109.43681,18.33639,1274
25318,193699,ED983BC21ECA3F6E34A13642C4FA2271,38484,11,12,1,109.53028,18.31528,1620
25319,193707,8B69C410684F618B4BB94E686E30E787,31031,7,8,1,109.49979,18.25382,1510
25320,193708,8B69C410684F618B4BB94E686E30E787,30201,8,9,1,109.4909,18.26465,1462
25321,193709,8B69C410684F618B4BB94E686E30E787,38094,13,18,5,109.45403,18.28778,1316
25322,193710,8B69C410684F618B4BB94E686E30E787,31531,19,22,3,109.49583,18.25972,1461
25327,193762,D0C08069F9C46B3F961C3CEB0437811E,38325,0,6,6,109.39792,18.2909,1116
25328,193763,D0C08069F9C46B3F961C3CEB0437811E,60552,8,10,2,109.41729,18.30014,1218
25329,193774,5403ECE41AD9921A5DEF63FF6DE6A9D1,31945,3,4,1,109.58021,18.29403,1817
25330,193775,5403ECE41AD9921A5DEF63FF6DE6A9D1,31071,8,23,15,109.58257,18.28458,1815
25331,193789,141A87FA0005158A87D02A7AC0237629,30421,18,20,2,109.50021,18.25861,1511
25332,193800,B02D7A3F297B377D646E0F85B7C19006,61011,7,15,8,109.60653,18.19076,1900
25333,193808,DC0A6E2B29DF09A30557DDD1B0786438,31031,15,17,2,109.49979,18.25382,1510
25334,193809,DC0A6E2B29DF09A30557DDD1B0786438,31534,18,19,1,109.49368,18.25806,1461
25335,193810,DC0A6E2B29DF09A30557DDD1B0786438,38251,21,23,2,109.49618,18.25493,1510
25336,193819,BD5D5103B08534F20AF53FB58E9A43CA,39101,15,17,2,109.50132,18.24931,1509
25337,193820,BD5D5103B08534F20AF53FB58E9A43CA,31931,21,22,1,109.54771,18.29403,1667
25338,193821,7F6E66BC10419161F6457A6D79258EDB,60401,8,10,2,109.47444,18.27583,1414
25339,193822,7F6E66BC10419161F6457A6D79258EDB,31031,11,13,2,109.49979,18.25382,1510
25340,193823,7F6E66BC10419161F6457A6D79258EDB,38094,14,16,2,109.45403,18.28778,1316
25341,193824,7F6E66BC10419161F6457A6D79258EDB,60621,20,23,3,109.48354,18.27451,1464
25342,193860,372A5433078073EAD18922D679CE0A73,30661,4,6,2,109.37028,18.24361,1008
25343,193861,372A5433078073EAD18922D679CE0A73,60411,6,8,2,109.32514,18.30854,869
25344,193862,372A5433078073EAD18922D679CE0A73,30661,9,11,2,109.37028,18.24361,1008
25345,193863,372A5433078073EAD18922D679CE0A73,60054,12,14,2,109.3016,18.31229,770
25346,193864,372A5433078073EAD18922D679CE0A73,60411,17,19,2,109.32514,18.30854,869
25347,193865,372A5433078073EAD18922D679CE0A73,30661,21,23,2,109.37028,18.24361,1008
25348,193896,E008ACF509F77C075F3CE6807181F555,33354,11,12,1,109.67465,18.44583,2192
25349,193897,E008ACF509F77C075F3CE6807181F555,33051,13,14,1,109.6475,18.46618,2096
25350,193898,E008ACF509F77C075F3CE6807181F555,31101,16,17,1,109.65389,18.23403,2057
25351,193899,E008ACF509F77C075F3CE6807181F555,38951,19,22,3,109.48097,18.28868,1416
25352,193939,9316856FC9B7BE008DD2CC2209708EA4,30071,0,1,1,109.52819,18.30472,1619
25353,193940,9316856FC9B7BE008DD2CC2209708EA4,60371,1,3,2,109.53063,18.30056,1618
25354,193941,9316856FC9B7BE008DD2CC2209708EA4,30131,6,8,2,109.6959,18.215,2254
25355,193942,9316856FC9B7BE008DD2CC2209708EA4,30121,10,20,10,109.52861,18.27222,1613
25356,193943,9316856FC9B7BE008DD2CC2209708EA4,30131,22,23,1,109.6959,18.215,2254
25357,193956,E99AD2D512B0301F624D366BCD84F80C,31781,13,15,2,109.19847,18.2975,367
25358,193957,E99AD2D512B0301F624D366BCD84F80C,30071,17,19,2,109.52819,18.30472,1619
25359,193958,B023927CBEC0A8053CBDF64A5B76E367,38017,0,6,6,109.49729,18.21424,1504
25360,193959,B023927CBEC0A8053CBDF64A5B76E367,31931,9,15,6,109.54771,18.29403,1667
25361,193960,B023927CBEC0A8053CBDF64A5B76E367,30921,15,16,1,109.53903,18.29451,1667
25362,193961,B023927CBEC0A8053CBDF64A5B76E367,31931,16,17,1,109.54771,18.29403,1667
25363,193962,B023927CBEC0A8053CBDF64A5B76E367,38017,18,20,2,109.49729,18.21424,1504
25364,193963,B023927CBEC0A8053CBDF64A5B76E367,30051,21,22,1,109.48917,18.21215,1453
25372,194069,7803AECF4FFC2BF233E3B7ACD0D2E9F8,39181,0,7,7,109.55153,18.28035,1715
25373,194070,7803AECF4FFC2BF233E3B7ACD0D2E9F8,39183,7,8,1,109.55542,18.28208,1715
25374,194071,7803AECF4FFC2BF233E3B7ACD0D2E9F8,31931,12,14,2,109.54771,18.29403,1667
25375,194072,7803AECF4FFC2BF233E3B7ACD0D2E9F8,39183,14,15,1,109.55542,18.28208,1715
25376,194073,7803AECF4FFC2BF233E3B7ACD0D2E9F8,39181,17,23,6,109.55153,18.28035,1715
25383,194121,513C2C725960CB50EE4FAD755492AAB6,31471,13,14,1,109.34583,18.29563,917
25384,194122,513C2C725960CB50EE4FAD755492AAB6,31861,15,23,8,109.49042,18.27549,1464
25385,194161,546019449B49A5FCBBE36F9F3DB19C8A,30211,17,19,2,109.49882,18.23931,1508
25386,194162,546019449B49A5FCBBE36F9F3DB19C8A,31231,19,23,4,109.42597,18.29292,1217
25387,194193,FBDD80570A641C18D89F4987D07601F8,31071,4,6,2,109.58257,18.28458,1815
25388,194194,FBDD80570A641C18D89F4987D07601F8,30854,10,21,11,109.56889,18.27076,1763
25393,194298,E0B6F6926B372F679FEA2B9C5DA4FA6C,60071,1,6,5,109.75674,18.31583,2470
25394,194324,86431DA9F6D3A0F087AFBE2023050B39,30071,0,14,14,109.52819,18.30472,1619
25395,194326,9452CDA15F97056A23EBE77445992CB1,31701,0,8,8,109.44132,18.28833,1266
25396,194327,9452CDA15F97056A23EBE77445992CB1,30341,8,9,1,109.3625,18.29167,966
25397,194328,9452CDA15F97056A23EBE77445992CB1,30661,9,11,2,109.37028,18.24361,1008
25398,194329,9452CDA15F97056A23EBE77445992CB1,31471,12,13,1,109.34583,18.29563,917
25399,194330,9452CDA15F97056A23EBE77445992CB1,30661,13,15,2,109.37028,18.24361,1008
25400,194331,9452CDA15F97056A23EBE77445992CB1,31701,20,23,3,109.44132,18.28833,1266
25401,194332,3D8ADE80304FD3207128013D43F1118A,60421,0,13,13,109.46333,18.31743,1371
25402,194333,3D8ADE80304FD3207128013D43F1118A,60274,14,17,3,109.514,18.2933,1567
25403,194334,3D8ADE80304FD3207128013D43F1118A,30711,21,23,2,109.50271,18.25347,1510
25404,194342,B80D6AB96D3D5CEE71A70ED25275F830,38951,1,8,7,109.48097,18.28868,1416
25405,194343,B80D6AB96D3D5CEE71A70ED25275F830,30461,12,22,10,109.5116,18.26313,1562
25406,194351,73409464FC717CED4BA77E4E505DD18C,31321,0,10,10,109.63799,18.23201,2007
25407,194352,73409464FC717CED4BA77E4E505DD18C,31471,13,16,3,109.34583,18.29563,917
25408,194353,73409464FC717CED4BA77E4E505DD18C,31321,19,23,4,109.63799,18.23201,2007
25413,194387,06639AF8E634A2EA412E3ADD181BCABE,30361,12,14,2,109.50347,18.24,1508
25414,194388,06639AF8E634A2EA412E3ADD181BCABE,31071,17,23,6,109.58257,18.28458,1815
25415,194437,05A7525C75554A6F27954E59E5F0C64D,60291,18,19,1,109.50826,18.24639,1509
25416,194438,05A7525C75554A6F27954E59E5F0C64D,30511,21,23,2,109.51069,18.24208,1558
25421,194521,8621CFDF1B89A83351494618C53D033F,31071,0,6,6,109.58257,18.28458,1815
25422,194522,8621CFDF1B89A83351494618C53D033F,39181,10,21,11,109.55153,18.28035,1715
25423,194539,8E552343C8969B2EDD2EC2DFF2B0FA90,30561,11,16,5,109.52778,18.31938,1621
25424,194540,8E552343C8969B2EDD2EC2DFF2B0FA90,60171,17,23,6,109.51292,18.30694,1569
25425,194589,B125AF31137882D184643AC445C2034E,60381,0,19,19,109.5241,18.22458,1605
25426,194590,B125AF31137882D184643AC445C2034E,30361,20,22,2,109.50347,18.24,1508
25427,194595,E8BE10EF1C0A6A216F7B6C008ED029A8,60371,0,7,7,109.53063,18.30056,1618
25428,194597,63CB222117AB8A54673799718246EF46,30084,0,11,11,109.50118,18.26972,1513
25429,194598,63CB222117AB8A54673799718246EF46,39021,12,13,1,109.40368,18.41035,1186
25430,194599,63CB222117AB8A54673799718246EF46,30081,16,17,1,109.50243,18.26632,1512
25431,194600,63CB222117AB8A54673799718246EF46,60131,17,20,3,109.49819,18.24778,1509
25432,194601,63CB222117AB8A54673799718246EF46,30084,21,23,2,109.50118,18.26972,1513
25437,194627,09EFADEB7A93F2303481629CF2F84E98,31291,0,14,14,109.30375,18.40729,786
25438,194647,7806585C0EBE4AA0D21C8F6E5805F92A,39321,12,14,2,109.529,18.2167,1604
25439,194648,7806585C0EBE4AA0D21C8F6E5805F92A,60381,15,17,2,109.5241,18.22458,1605
25440,194651,71429A794A28AC178BF0585C81690813,31431,0,7,7,109.44639,18.29042,1316
25441,194652,71429A794A28AC178BF0585C81690813,60281,8,10,2,109.51743,18.25924,1561
25442,194653,71429A794A28AC178BF0585C81690813,31431,13,23,10,109.44639,18.29042,1316
25443,194654,4D190727D19452A2A511EC780EEEE090,30201,1,3,2,109.4909,18.26465,1462
25444,194655,4D190727D19452A2A511EC780EEEE090,60361,3,5,2,109.51938,18.29681,1567
25445,194656,4D190727D19452A2A511EC780EEEE090,30931,10,13,3,109.55653,18.32722,1722
25446,194657,4D190727D19452A2A511EC780EEEE090,30941,13,14,1,109.5559,18.33938,1724
25447,194736,2B7A53D30829A5F3F021AD579FE94CD8,31861,0,10,10,109.49042,18.27549,1464
25448,194737,2B7A53D30829A5F3F021AD579FE94CD8,31471,12,14,2,109.34583,18.29563,917
25449,194738,2B7A53D30829A5F3F021AD579FE94CD8,31861,17,18,1,109.49042,18.27549,1464
25450,194739,2B7A53D30829A5F3F021AD579FE94CD8,31021,19,23,4,109.49021,18.27,1463
25455,194752,2E29BE7E21F829BB8E4505964B146371,31561,1,4,3,109.56792,18.28479,1765
25456,194753,2E29BE7E21F829BB8E4505964B146371,30854,8,23,15,109.56889,18.27076,1763
25460,194806,5F05A258CA919BA01045F79DD70FBCC9,30854,1,5,4,109.56889,18.27076,1763
25461,194807,5F05A258CA919BA01045F79DD70FBCC9,39183,7,17,10,109.55542,18.28208,1715
25462,194817,878FC5EBB1B28FAABA6E6BFD01664318,30251,0,16,16,109.50611,18.26653,1512
25463,194818,878FC5EBB1B28FAABA6E6BFD01664318,30421,18,20,2,109.50021,18.25861,1511
25468,194914,A1EEE89B9C53AC2C13371CE13D1615DF,31421,0,6,6,109.55382,18.22347,1705
25469,194915,A1EEE89B9C53AC2C13371CE13D1615DF,31061,6,8,2,109.53333,18.23257,1607
25470,194916,A1EEE89B9C53AC2C13371CE13D1615DF,30381,8,10,2,109.52521,18.24507,1609
25471,194917,A1EEE89B9C53AC2C13371CE13D1615DF,31145,13,15,2,109.20431,18.30479,369
25472,195038,5264833F0013AE6B294396000613EF89,30251,0,5,5,109.50611,18.26653,1512
25473,195039,5264833F0013AE6B294396000613EF89,31181,5,10,5,109.50382,18.24813,1509
25474,195040,5264833F0013AE6B294396000613EF89,60581,11,13,2,109.59785,18.29931,1868
25475,195041,5264833F0013AE6B294396000613EF89,39151,17,19,2,109.49875,18.25097,1510
25476,195066,8BF73979F60E5F1BAAE4266406EB9535,31723,9,12,3,109.68563,18.23701,2207
25477,195067,8BF73979F60E5F1BAAE4266406EB9535,60631,14,15,1,109.57778,18.27583,1814
25478,195068,8BF73979F60E5F1BAAE4266406EB9535,30854,20,21,1,109.56889,18.27076,1763
25479,195074,2F440A235E684ECEDD042B3100A4AE95,30161,1,2,1,109.50042,18.24389,1508
25480,195075,2F440A235E684ECEDD042B3100A4AE95,31071,3,16,13,109.58257,18.28458,1815
25481,195076,2F440A235E684ECEDD042B3100A4AE95,60331,20,22,2,109.505,18.26507,1512
25485,195106,E4E97404D888F47AC51F80D2483EF416,60231,0,11,11,109.49903,18.21972,1504
25486,195107,E4E97404D888F47AC51F80D2483EF416,38017,11,13,2,109.49729,18.21424,1504
25487,195108,E4E97404D888F47AC51F80D2483EF416,60231,14,15,1,109.49903,18.21972,1504
25488,195109,E4E97404D888F47AC51F80D2483EF416,38017,15,17,2,109.49729,18.21424,1504
25489,195110,E4E97404D888F47AC51F80D2483EF416,60231,20,23,3,109.49903,18.21972,1504
25493,195134,74F0A13130A31FF37EE281403AC1C753,60411,12,17,5,109.32514,18.30854,869
25494,195138,5EBEA276FCB4A19AC5C987F5C7CC8908,60621,0,6,6,109.48354,18.27451,1464
25495,195139,5EBEA276FCB4A19AC5C987F5C7CC8908,60401,10,23,13,109.47444,18.27583,1414
25496,195147,54036114D002A873652B2123255670F7,30971,0,7,7,109.48708,18.29319,1467
25497,195149,54036114D002A873652B2123255670F7,38127,18,23,5,109.50833,18.27222,1513
25498,195152,3B6FF1F8D896A0A62DC7E65967011999,31561,1,4,3,109.56792,18.28479,1765
25499,195153,3B6FF1F8D896A0A62DC7E65967011999,39183,5,11,6,109.55542,18.28208,1715
25500,195154,3B6FF1F8D896A0A62DC7E65967011999,31561,11,12,1,109.56792,18.28479,1765
25501,195155,3B6FF1F8D896A0A62DC7E65967011999,39183,13,17,4,109.55542,18.28208,1715
25502,195156,3B6FF1F8D896A0A62DC7E65967011999,31561,18,19,1,109.56792,18.28479,1765
25503,195164,028777DBF8176CB8A735B293EDB3D71F,39181,0,4,4,109.55153,18.28035,1715
25504,195165,028777DBF8176CB8A735B293EDB3D71F,31931,4,6,2,109.54771,18.29403,1667
25505,195166,B57DD43ADCB0BF56BB60384ABB1C13C6,38023,0,9,9,109.37132,18.28993,1016
25506,195167,B57DD43ADCB0BF56BB60384ABB1C13C6,31145,10,11,1,109.20431,18.30479,369
25507,195168,B57DD43ADCB0BF56BB60384ABB1C13C6,30341,12,14,2,109.3625,18.29167,966
25508,195177,7B1A07C39637E996C01DF0A3D287D3C6,39371,6,8,2,109.56627,18.2646,1762
25509,195178,7B1A07C39637E996C01DF0A3D287D3C6,30711,9,11,2,109.50271,18.25347,1510
25514,195211,58D9A5715CD0EB0BC75B3571E4B93B4F,31145,13,14,1,109.20431,18.30479,369
25515,195212,58D9A5715CD0EB0BC75B3571E4B93B4F,60381,15,18,3,109.5241,18.22458,1605
25516,195213,58D9A5715CD0EB0BC75B3571E4B93B4F,30711,20,23,3,109.50271,18.25347,1510
25517,195219,FBC323A047041F71D8997C22FDE88F17,31201,0,1,1,109.51042,18.23819,1558
25518,195220,FBC323A047041F71D8997C22FDE88F17,30181,1,8,7,109.51597,18.23313,1557
25519,195221,FBC323A047041F71D8997C22FDE88F17,30511,8,10,2,109.51069,18.24208,1558
25520,195222,FBC323A047041F71D8997C22FDE88F17,38251,12,14,2,109.49618,18.25493,1510
25521,195223,FBC323A047041F71D8997C22FDE88F17,30731,17,18,1,109.50944,18.22306,1555
25522,195224,FBC323A047041F71D8997C22FDE88F17,39191,21,23,2,109.51493,18.23472,1557
25523,195229,0312B43ACF9ED1D8304E325E851AEE29,30851,0,6,6,109.5616,18.27396,1713
25524,195230,0312B43ACF9ED1D8304E325E851AEE29,31561,8,10,2,109.56792,18.28479,1765
25525,195231,0312B43ACF9ED1D8304E325E851AEE29,30851,10,13,3,109.5616,18.27396,1713
25526,195232,0312B43ACF9ED1D8304E325E851AEE29,31561,13,16,3,109.56792,18.28479,1765
25527,195233,0312B43ACF9ED1D8304E325E851AEE29,30851,17,20,3,109.5616,18.27396,1713
25528,195247,EEAA904909853FCE4C1006E1C626BEA2,60231,0,9,9,109.49903,18.21972,1504
25529,195248,EEAA904909853FCE4C1006E1C626BEA2,31321,13,14,1,109.63799,18.23201,2007
25530,195249,EEAA904909853FCE4C1006E1C626BEA2,60231,16,18,2,109.49903,18.21972,1504
25531,195250,EEAA904909853FCE4C1006E1C626BEA2,60371,19,20,1,109.53063,18.30056,1618
25532,195251,EEAA904909853FCE4C1006E1C626BEA2,30051,20,23,3,109.48917,18.21215,1453
25533,195261,FBEC160C45CDB913BEE085C420C4068D,31031,10,13,3,109.49979,18.25382,1510
25534,195262,FBEC160C45CDB913BEE085C420C4068D,31181,17,19,2,109.50382,18.24813,1509
25538,195365,09390A13C8E5C15C1E5674E3DB9139EC,31231,9,10,1,109.42597,18.29292,1217
25539,195366,09390A13C8E5C15C1E5674E3DB9139EC,60231,12,15,3,109.49903,18.21972,1504
25540,195387,33D9A19F318C67B0D9189A6D3D4AAED6,30421,12,13,1,109.50021,18.25861,1511
25541,195446,7EB4F76900011DECC835981CBE847D5E,30854,10,11,1,109.56889,18.27076,1763
25542,195447,7EB4F76900011DECC835981CBE847D5E,31561,14,17,3,109.56792,18.28479,1765
25543,195466,B7A2800FDF738E1064EAD2A5E58F7A3C,61011,1,9,8,109.60653,18.19076,1900
25544,195468,B7A2800FDF738E1064EAD2A5E58F7A3C,31171,20,21,1,109.50938,18.24917,1559
25545,195469,B7A2800FDF738E1064EAD2A5E58F7A3C,60381,21,23,2,109.5241,18.22458,1605
25549,195532,CA3896FB33E9BC68E91955EDFF5D709B,60631,0,5,5,109.57778,18.27583,1814
25550,195533,CA3896FB33E9BC68E91955EDFF5D709B,30854,8,11,3,109.56889,18.27076,1763
25551,195534,CA3896FB33E9BC68E91955EDFF5D709B,31945,15,17,2,109.58021,18.29403,1817
25552,195535,CA3896FB33E9BC68E91955EDFF5D709B,60381,18,19,1,109.5241,18.22458,1605
25553,195536,CA3896FB33E9BC68E91955EDFF5D709B,31945,20,22,2,109.58021,18.29403,1817
25554,195537,2784AD65C6F3580D4FC580DB3654BC4C,31521,0,7,7,109.51458,18.22542,1555
25555,195538,2784AD65C6F3580D4FC580DB3654BC4C,31471,12,13,1,109.34583,18.29563,917
25556,195539,2784AD65C6F3580D4FC580DB3654BC4C,60381,17,18,1,109.5241,18.22458,1605
25557,195540,2784AD65C6F3580D4FC580DB3654BC4C,31521,20,23,3,109.51458,18.22542,1555
25558,195548,45CCFCD3EBDF941E1C92B70ED06E8B5E,31561,1,5,4,109.56792,18.28479,1765
25559,195549,45CCFCD3EBDF941E1C92B70ED06E8B5E,30854,5,23,18,109.56889,18.27076,1763
25560,195584,1E9F6F4D6B7C40904E643E52078F97CE,30161,0,10,10,109.50042,18.24389,1508
25561,195585,1E9F6F4D6B7C40904E643E52078F97CE,60084,10,12,2,109.4984,18.2334,1507
25562,195586,1E9F6F4D6B7C40904E643E52078F97CE,31231,15,16,1,109.42597,18.29292,1217
25563,195588,354DC607408BB828F25BA014BE4B0A10,38111,17,22,5,109.52007,18.22403,1555
25564,195609,FA5581D3844E50B2A372DC72CD47A219,31471,17,19,2,109.34583,18.29563,917
25565,195610,FA5581D3844E50B2A372DC72CD47A219,38951,20,21,1,109.48097,18.28868,1416
25566,195611,FA5581D3844E50B2A372DC72CD47A219,38951,22,23,1,109.48097,18.28868,1416
25567,195640,EA734477BB59A1DAF87BF8B753D8AFA0,31521,0,10,10,109.51458,18.22542,1555
25568,195641,EA734477BB59A1DAF87BF8B753D8AFA0,30361,14,15,1,109.50347,18.24,1508
25569,195642,EA734477BB59A1DAF87BF8B753D8AFA0,38141,17,20,3,109.39479,18.2916,1116
25570,195643,EA734477BB59A1DAF87BF8B753D8AFA0,31671,20,22,2,109.38965,18.29813,1068
25571,195644,EA734477BB59A1DAF87BF8B753D8AFA0,38141,22,23,1,109.39479,18.2916,1116
25572,195653,49B3509BB0FF86B3DDAB6DD80329A93A,31471,14,15,1,109.34583,18.29563,917
25573,195654,49B3509BB0FF86B3DDAB6DD80329A93A,60054,16,17,1,109.3016,18.31229,770
25574,195655,49B3509BB0FF86B3DDAB6DD80329A93A,38951,18,23,5,109.48097,18.28868,1416
25575,195719,2C7E329ABF5669760C98EF0FEA876F54,31521,0,10,10,109.51458,18.22542,1555
25576,195720,2C7E329ABF5669760C98EF0FEA876F54,39111,12,13,1,109.5191,18.22597,1555
25577,195735,83E7C4368A133CBB6B889F8FD57C41CF,39101,21,23,2,109.50132,18.24931,1509
25582,195791,5A459B568F939BC327045343CB968445,31521,0,12,12,109.51458,18.22542,1555
25583,195792,5A459B568F939BC327045343CB968445,30921,14,15,1,109.53903,18.29451,1667
25584,195793,5A459B568F939BC327045343CB968445,39111,20,23,3,109.5191,18.22597,1555
25585,195810,EF0AF6DFF11E792E87881ED5E6F91398,30721,15,21,6,109.51597,18.28257,1565
25586,195811,EF0AF6DFF11E792E87881ED5E6F91398,38154,22,23,1,109.5266,18.28278,1615
25591,195833,3F25BC2EA3BCB1B9CD49F368B0B58610,30854,10,13,3,109.56889,18.27076,1763
25592,195834,3F25BC2EA3BCB1B9CD49F368B0B58610,30891,14,16,2,109.59431,18.28389,1865
25593,195835,3F25BC2EA3BCB1B9CD49F368B0B58610,60501,18,19,1,109.48701,18.29021,1466
25594,195836,3F25BC2EA3BCB1B9CD49F368B0B58610,39091,21,22,1,109.50097,18.25222,1510
25595,195871,BFB4E5030A54D70D88FDBFB48AF8C1F3,30511,20,21,1,109.51069,18.24208,1558
25596,195872,BFB4E5030A54D70D88FDBFB48AF8C1F3,60571,21,23,2,109.50722,18.25056,1510
25597,195873,B007CA712767A3A793F1267D6B26E822,31931,16,17,1,109.54771,18.29403,1667
25598,195874,B007CA712767A3A793F1267D6B26E822,31531,21,22,1,109.49583,18.25972,1461
25599,195900,6587551DA47309E484D1302521C8D417,30854,7,8,1,109.56889,18.27076,1763
25600,195901,6587551DA47309E484D1302521C8D417,60631,11,13,2,109.57778,18.27583,1814
25601,195902,6587551DA47309E484D1302521C8D417,38275,14,22,8,109.62875,18.22938,2006
25602,195948,DA10676C4DA702E02A2C3FFFAC40ABA2,39183,0,1,1,109.55542,18.28208,1715
25603,195949,DA10676C4DA702E02A2C3FFFAC40ABA2,31561,3,4,1,109.56792,18.28479,1765
25604,195950,DA10676C4DA702E02A2C3FFFAC40ABA2,39183,4,5,1,109.55542,18.28208,1715
25605,195951,DA10676C4DA702E02A2C3FFFAC40ABA2,31561,7,9,2,109.56792,18.28479,1765
25606,195952,DA10676C4DA702E02A2C3FFFAC40ABA2,39183,9,11,2,109.55542,18.28208,1715
25607,195953,DA10676C4DA702E02A2C3FFFAC40ABA2,31561,12,16,4,109.56792,18.28479,1765
25608,195954,DA10676C4DA702E02A2C3FFFAC40ABA2,39183,16,18,2,109.55542,18.28208,1715
25609,195955,DA10676C4DA702E02A2C3FFFAC40ABA2,31561,18,20,2,109.56792,18.28479,1765
25610,195956,3977578BE56276DA0700B04B81DC1356,30851,0,18,18,109.5616,18.27396,1713
25611,195957,3977578BE56276DA0700B04B81DC1356,31561,20,21,1,109.56792,18.28479,1765
25612,195983,EFDE35289FEC1E13D6F34EFEE66A8AD2,30151,0,16,16,109.50986,18.25083,1560
25613,195984,EFDE35289FEC1E13D6F34EFEE66A8AD2,30854,17,19,2,109.56889,18.27076,1763
25614,196005,002F5754EC66582DC6DA72516B3091EB,38185,9,11,2,109.51333,18.27347,1563
25615,196006,002F5754EC66582DC6DA72516B3091EB,60501,12,13,1,109.48701,18.29021,1466
25616,196047,AD608A919061B1C684914F8654FB2493,60161,12,14,2,109.49174,18.26181,1461
25617,196048,AD608A919061B1C684914F8654FB2493,30361,17,20,3,109.50347,18.24,1508
25621,196062,998ABE8C520F737BA8B4035E9C6950FC,38157,17,18,1,109.51483,18.26958,1563
25622,196063,998ABE8C520F737BA8B4035E9C6950FC,60281,18,21,3,109.51743,18.25924,1561
25623,196064,998ABE8C520F737BA8B4035E9C6950FC,38961,21,22,1,109.50847,18.23514,1507
25624,196070,24892DF473AC6ED4692FBD552CF21D37,60381,0,11,11,109.5241,18.22458,1605
25625,196071,24892DF473AC6ED4692FBD552CF21D37,39321,11,13,2,109.529,18.2167,1604
25626,196072,24892DF473AC6ED4692FBD552CF21D37,60381,14,16,2,109.5241,18.22458,1605
25627,196073,24892DF473AC6ED4692FBD552CF21D37,39321,18,20,2,109.529,18.2167,1604
25628,196074,24892DF473AC6ED4692FBD552CF21D37,60381,20,23,3,109.5241,18.22458,1605
25633,196113,2315F6E953FA87E5C2F5BE151F7177B3,31861,18,19,1,109.49042,18.27549,1464
25634,196114,2315F6E953FA87E5C2F5BE151F7177B3,30271,21,23,2,109.49132,18.23153,1456
25638,196131,44FF3F3995A0081423CE688C5217DF97,31781,15,16,1,109.19847,18.2975,367
25639,196132,44FF3F3995A0081423CE688C5217DF97,31551,18,19,1,109.55868,18.24222,1708
25640,196147,537CA9C3FED012868AB5E4DF92AD232C,30861,0,15,15,109.52722,18.22743,1606
25641,196148,537CA9C3FED012868AB5E4DF92AD232C,30861,18,20,2,109.52722,18.22743,1606
25642,196180,56C8C781972E8BFAF8A768A19AD7F590,38127,0,7,7,109.50833,18.27222,1513
25643,196184,56C8C781972E8BFAF8A768A19AD7F590,30681,21,22,1,109.48493,18.26917,1463
25644,196191,254704E101B8D6129E165FC845EECD1E,30581,9,11,2,109.62257,18.24951,1959
25645,196192,254704E101B8D6129E165FC845EECD1E,30361,12,14,2,109.50347,18.24,1508
25646,196193,254704E101B8D6129E165FC845EECD1E,30711,15,16,1,109.50271,18.25347,1510
25647,196194,254704E101B8D6129E165FC845EECD1E,30771,16,17,1,109.49938,18.26042,1511
25648,196201,C709D01469E0800AF998DFAF42105CDC,31561,6,16,10,109.56792,18.28479,1765
25649,196202,C709D01469E0800AF998DFAF42105CDC,60631,21,23,2,109.57778,18.27583,1814
25650,196221,FA14B010F60C7FB3B13194FAA13740E8,30854,3,5,2,109.56889,18.27076,1763
25651,196222,FA14B010F60C7FB3B13194FAA13740E8,31561,8,9,1,109.56792,18.28479,1765
25652,196223,FA14B010F60C7FB3B13194FAA13740E8,39183,9,11,2,109.55542,18.28208,1715
25653,196224,FA14B010F60C7FB3B13194FAA13740E8,31561,12,13,1,109.56792,18.28479,1765
25654,196225,FA14B010F60C7FB3B13194FAA13740E8,39183,15,17,2,109.55542,18.28208,1715
25655,196231,451E2BF48CD7B253EB0892324E679BCC,60311,5,6,1,109.52097,18.24319,1558
25656,196232,451E2BF48CD7B253EB0892324E679BCC,60281,7,9,2,109.51743,18.25924,1561
25657,196233,451E2BF48CD7B253EB0892324E679BCC,31461,9,12,3,109.5091,18.25389,1510
25658,196234,451E2BF48CD7B253EB0892324E679BCC,60281,13,18,5,109.51743,18.25924,1561
25659,196235,451E2BF48CD7B253EB0892324E679BCC,38297,18,19,1,109.52576,18.24965,1609
25660,196236,451E2BF48CD7B253EB0892324E679BCC,38291,21,22,1,109.51618,18.24313,1558
25661,196237,7FB03ED475E7749CD7E0CA9888FB40B5,60501,0,7,7,109.48701,18.29021,1466
25662,196277,CB9F456D1275025691EE74018BA9AEE8,30511,0,7,7,109.51069,18.24208,1558
25663,196278,CB9F456D1275025691EE74018BA9AEE8,38251,11,13,2,109.49618,18.25493,1510
25664,196279,CB9F456D1275025691EE74018BA9AEE8,31031,14,16,2,109.49979,18.25382,1510
25665,196280,CB9F456D1275025691EE74018BA9AEE8,38251,17,18,1,109.49618,18.25493,1510
25666,196281,CB9F456D1275025691EE74018BA9AEE8,60161,19,22,3,109.49174,18.26181,1461
25667,196289,8345A9276E866C21971E3C408D4E0341,31071,0,1,1,109.58257,18.28458,1815
25668,196290,8345A9276E866C21971E3C408D4E0341,30854,1,2,1,109.56889,18.27076,1763
25669,196291,8345A9276E866C21971E3C408D4E0341,31071,5,6,1,109.58257,18.28458,1815
25670,196292,8345A9276E866C21971E3C408D4E0341,30854,6,7,1,109.56889,18.27076,1763
25671,196293,8345A9276E866C21971E3C408D4E0341,30361,12,13,1,109.50347,18.24,1508
25672,196294,8345A9276E866C21971E3C408D4E0341,30854,15,23,8,109.56889,18.27076,1763
25676,196332,DDE77D3A656666992FC3458B84010D43,39183,0,14,14,109.55542,18.28208,1715
25677,196333,DDE77D3A656666992FC3458B84010D43,31561,14,19,5,109.56792,18.28479,1765
25678,196335,AB6D23E0CDB95F5E821EDCA2C6982C89,39131,9,10,1,109.2066,18.29639,417
25679,196336,AB6D23E0CDB95F5E821EDCA2C6982C89,60411,11,13,2,109.32514,18.30854,869
25680,196375,D2062FDC3B9E181B9C558CD298CA8016,38871,2,8,6,109.44681,18.28625,1316
25681,196376,D2062FDC3B9E181B9C558CD298CA8016,31431,8,12,4,109.44639,18.29042,1316
25682,196377,D2062FDC3B9E181B9C558CD298CA8016,38871,13,14,1,109.44681,18.28625,1316
25683,196378,D2062FDC3B9E181B9C558CD298CA8016,31701,15,17,2,109.44132,18.28833,1266
25684,196379,D2062FDC3B9E181B9C558CD298CA8016,31861,17,18,1,109.49042,18.27549,1464
25685,196380,D2062FDC3B9E181B9C558CD298CA8016,38871,21,23,2,109.44681,18.28625,1316
25686,196381,529A14F498129B0238F7B12A9FC7F6F7,31205,0,1,1,109.51111,18.23736,1557
25687,196382,529A14F498129B0238F7B12A9FC7F6F7,31671,2,15,13,109.38965,18.29813,1068
25688,196383,529A14F498129B0238F7B12A9FC7F6F7,60361,17,21,4,109.51938,18.29681,1567
25689,196396,2C3BD53A8702A47FB82F05FB4993B683,31561,1,5,4,109.56792,18.28479,1765
25690,196397,2C3BD53A8702A47FB82F05FB4993B683,39183,7,8,1,109.55542,18.28208,1715
25691,196398,2C3BD53A8702A47FB82F05FB4993B683,31561,12,13,1,109.56792,18.28479,1765
25692,196399,2C3BD53A8702A47FB82F05FB4993B683,39181,14,17,3,109.55153,18.28035,1715
25693,196400,2C3BD53A8702A47FB82F05FB4993B683,31561,20,23,3,109.56792,18.28479,1765
25697,196409,807F73DE76DFE56E472FA61396F0887C,30151,12,13,1,109.50986,18.25083,1560
25698,196417,4A7982D4CD3B194177EC6261E6672D24,31521,19,20,1,109.51458,18.22542,1555
25699,196418,4A7982D4CD3B194177EC6261E6672D24,30731,20,22,2,109.50944,18.22306,1555
25704,196467,283001ED673D8EDBEF7EEB00BDB31533,60231,0,1,1,109.49903,18.21972,1504
25705,196468,283001ED673D8EDBEF7EEB00BDB31533,38017,2,4,2,109.49729,18.21424,1504
25706,196469,283001ED673D8EDBEF7EEB00BDB31533,60201,8,9,1,109.5041,18.2509,1510
25707,196470,283001ED673D8EDBEF7EEB00BDB31533,31181,9,12,3,109.50382,18.24813,1509
25708,196471,283001ED673D8EDBEF7EEB00BDB31533,31181,13,14,1,109.50382,18.24813,1509
25709,196477,CEEBF763278B92FC619368987985476F,38336,0,13,13,109.61111,18.21806,1904
25710,196478,CEEBF763278B92FC619368987985476F,30421,18,19,1,109.50021,18.25861,1511
25711,196479,CEEBF763278B92FC619368987985476F,38336,21,23,2,109.61111,18.21806,1904
25712,196512,3E9C0673EA7EE82186269B93667BFAD6,30891,1,6,5,109.59431,18.28389,1865
25713,196513,3E9C0673EA7EE82186269B93667BFAD6,31071,6,7,1,109.58257,18.28458,1815
25714,196514,3E9C0673EA7EE82186269B93667BFAD6,39183,9,12,3,109.55542,18.28208,1715
25715,196515,3E9C0673EA7EE82186269B93667BFAD6,31101,14,16,2,109.65389,18.23403,2057
25716,196537,DD45307798B5E5E871398410DD7318C5,30441,14,15,1,109.64021,18.25424,2010
25717,196538,DD45307798B5E5E871398410DD7318C5,38951,19,23,4,109.48097,18.28868,1416
25722,196580,18E04CE5407B3EC01E2162F1F0904C8B,39371,0,7,7,109.56627,18.2646,1762
25723,196581,18E04CE5407B3EC01E2162F1F0904C8B,30854,9,10,1,109.56889,18.27076,1763
25724,196582,18E04CE5407B3EC01E2162F1F0904C8B,31561,10,12,2,109.56792,18.28479,1765
25725,196583,18E04CE5407B3EC01E2162F1F0904C8B,39371,13,14,1,109.56627,18.2646,1762
25726,196584,18E04CE5407B3EC01E2162F1F0904C8B,30854,14,16,2,109.56889,18.27076,1763
25727,196585,18E04CE5407B3EC01E2162F1F0904C8B,39371,19,23,4,109.56627,18.2646,1762
25728,196595,3570BE904888E551380F4347C7EA72F3,30361,20,22,2,109.50347,18.24,1508
25732,196642,1758F7A03033DAF462A8174615B0DBCE,60594,0,10,10,109.62694,18.22799,1956
25733,196643,1758F7A03033DAF462A8174615B0DBCE,38052,11,13,2,109.62618,18.23042,1956
25734,196644,1758F7A03033DAF462A8174615B0DBCE,38052,13,15,2,109.62618,18.23042,1956
25735,196645,1758F7A03033DAF462A8174615B0DBCE,31321,17,18,1,109.63799,18.23201,2007
25736,196646,1758F7A03033DAF462A8174615B0DBCE,38052,19,21,2,109.62618,18.23042,1956
25737,196647,1758F7A03033DAF462A8174615B0DBCE,31723,21,23,2,109.68563,18.23701,2207
25738,196681,1FE2866848043A2C10AD87212485FE15,31071,1,2,1,109.58257,18.28458,1815
25739,196682,1FE2866848043A2C10AD87212485FE15,30854,2,17,15,109.56889,18.27076,1763
25740,196683,34AB502A442AA8EA4A7FB30471B204DB,60621,2,3,1,109.48354,18.27451,1464
25741,196684,34AB502A442AA8EA4A7FB30471B204DB,38325,5,7,2,109.39792,18.2909,1116
25742,196685,34AB502A442AA8EA4A7FB30471B204DB,60401,8,10,2,109.47444,18.27583,1414
25743,196686,34AB502A442AA8EA4A7FB30471B204DB,38094,10,12,2,109.45403,18.28778,1316
25744,196687,34AB502A442AA8EA4A7FB30471B204DB,30341,13,14,1,109.3625,18.29167,966
25745,196688,34AB502A442AA8EA4A7FB30471B204DB,38251,16,17,1,109.49618,18.25493,1510
25746,196689,34AB502A442AA8EA4A7FB30471B204DB,60621,21,23,2,109.48354,18.27451,1464
25750,196775,B712327B6033C61F37801CFD6DAC08AD,31951,0,5,5,109.52174,18.30299,1568
25751,196776,B712327B6033C61F37801CFD6DAC08AD,38484,6,11,5,109.53028,18.31528,1620
25752,196777,B712327B6033C61F37801CFD6DAC08AD,38484,12,13,1,109.53028,18.31528,1620
25753,196778,B712327B6033C61F37801CFD6DAC08AD,38484,14,18,4,109.53028,18.31528,1620
25754,196779,B712327B6033C61F37801CFD6DAC08AD,38484,20,22,2,109.53028,18.31528,1620
25755,196782,B0763B4A96052E2584E19B64C16E779B,30661,14,16,2,109.37028,18.24361,1008
25756,196783,B0763B4A96052E2584E19B64C16E779B,60501,20,22,2,109.48701,18.29021,1466
25757,196809,A7B3BDD8DC79485BA41EC7F220A41345,60631,0,11,11,109.57778,18.27583,1814
25758,196810,A7B3BDD8DC79485BA41EC7F220A41345,30854,14,23,9,109.56889,18.27076,1763
25759,196811,63FBAC0202144B00077561285E6A7F87,30821,0,9,9,109.43681,18.33639,1274
25760,196812,63FBAC0202144B00077561285E6A7F87,30651,9,11,2,109.42611,18.385,1232
25761,196813,63FBAC0202144B00077561285E6A7F87,30821,13,15,2,109.43681,18.33639,1274
25762,196814,63FBAC0202144B00077561285E6A7F87,30651,15,17,2,109.42611,18.385,1232
25763,196815,63FBAC0202144B00077561285E6A7F87,30821,18,23,5,109.43681,18.33639,1274
25764,196843,4A181773B7D7DB21B899E84DBBF5FD51,60401,3,18,15,109.47444,18.27583,1414
25765,196844,4A181773B7D7DB21B899E84DBBF5FD51,31391,19,21,2,109.50382,18.24285,1508
25766,196865,848A877E923FAE990F640409C3D68042,60121,13,14,1,109.74507,18.37472,2430
25767,196866,848A877E923FAE990F640409C3D68042,31041,15,18,3,109.50278,18.23701,1507
25768,196867,848A877E923FAE990F640409C3D68042,60121,20,23,3,109.74507,18.37472,2430
25769,196873,47C8C71AB8A291B23C6D0393C8109E46,38171,0,7,7,109.50799,18.28139,1515
25770,196876,47C8C71AB8A291B23C6D0393C8109E46,38261,19,23,4,109.50361,18.28153,1515
25771,196890,E755AD63601CF016CD8E32C53EBB1378,30421,16,20,4,109.50021,18.25861,1511
25772,196891,E755AD63601CF016CD8E32C53EBB1378,31206,21,23,2,109.50819,18.23549,1507
25773,196900,5533066D8871087CCD481B88DD73EF7D,31361,0,20,20,109.47417,18.28292,1415
25774,196901,5533066D8871087CCD481B88DD73EF7D,60401,21,23,2,109.47444,18.27583,1414
25775,196915,0792BDFC81E11DA91D31ED7576F7343E,30421,11,12,1,109.50021,18.25861,1511
25776,196916,0792BDFC81E11DA91D31ED7576F7343E,31031,13,15,2,109.49979,18.25382,1510
25777,196917,0792BDFC81E11DA91D31ED7576F7343E,30421,17,19,2,109.50021,18.25861,1511
25778,196918,0792BDFC81E11DA91D31ED7576F7343E,39154,20,23,3,109.50201,18.25681,1511
25779,196950,D93246693BF2DE328C78E4FC538C8F54,30084,15,16,1,109.50118,18.26972,1513
25780,196951,D93246693BF2DE328C78E4FC538C8F54,60661,19,23,4,109.548,18.2377,1657
25784,197009,182D5101D28D51096306D4EF5FDD4501,38251,11,12,1,109.49618,18.25493,1510
25785,197010,182D5101D28D51096306D4EF5FDD4501,60401,13,14,1,109.47444,18.27583,1414
25786,197011,182D5101D28D51096306D4EF5FDD4501,30271,14,15,1,109.49132,18.23153,1456
25787,197020,64EA917EAAD3EB55DA2ABB227203C131,60631,0,7,7,109.57778,18.27583,1814
25788,197021,64EA917EAAD3EB55DA2ABB227203C131,31071,8,15,7,109.58257,18.28458,1815
25789,197022,64EA917EAAD3EB55DA2ABB227203C131,31851,20,22,2,109.71736,18.29007,2316
25790,197075,6F1C2EEBABDCCD4D60A02F44086A229B,60281,19,20,1,109.51743,18.25924,1561
25791,197076,6F1C2EEBABDCCD4D60A02F44086A229B,39201,21,23,2,109.45056,18.28667,1316
25792,197102,18073AD9E71B8DFC1E520C5E3653B1BD,31291,0,5,5,109.30375,18.40729,786
25793,197103,18073AD9E71B8DFC1E520C5E3653B1BD,31951,9,16,7,109.52174,18.30299,1568
25794,197104,18073AD9E71B8DFC1E520C5E3653B1BD,31291,17,23,6,109.30375,18.40729,786
25799,197128,ED8F5CD7EC6E2CD49679883B2A184DD2,30561,1,6,5,109.52778,18.31938,1621
25800,197129,ED8F5CD7EC6E2CD49679883B2A184DD2,31031,7,15,8,109.49979,18.25382,1510
25801,197130,ED8F5CD7EC6E2CD49679883B2A184DD2,30201,19,22,3,109.4909,18.26465,1462
25802,197142,725907B5E41C0055C10D17ED419C6B5D,60641,0,6,6,109.53854,18.2359,1657
25803,197143,725907B5E41C0055C10D17ED419C6B5D,31301,10,11,1,109.14493,18.31222,170
25804,197144,725907B5E41C0055C10D17ED419C6B5D,31471,13,14,1,109.34583,18.29563,917
25805,197153,A928E9F6C796FE1A60807BA003DE87BB,30854,12,16,4,109.56889,18.27076,1763
25806,197154,A928E9F6C796FE1A60807BA003DE87BB,31071,19,21,2,109.58257,18.28458,1815
25810,197165,975CB35586D2D95A387E2AA86A5AB719,31351,0,5,5,109.4959,18.28417,1465
25811,197166,975CB35586D2D95A387E2AA86A5AB719,30671,7,22,15,109.43611,18.30139,1268
25815,197191,491A112CD81B9085F752897809919691,31781,11,14,3,109.19847,18.2975,367
25816,197192,491A112CD81B9085F752897809919691,31201,18,20,2,109.51042,18.23819,1558
25817,197218,BF2B54690E8B5D78C4E66DC34DEE3501,30661,13,14,1,109.37028,18.24361,1008
25818,197219,BF2B54690E8B5D78C4E66DC34DEE3501,60381,17,19,2,109.5241,18.22458,1605
25819,197220,BF2B54690E8B5D78C4E66DC34DEE3501,60084,21,22,1,109.4984,18.2334,1507
25820,197230,42158B50A96F4BB50162AD5AAF8D7E2D,31181,19,20,1,109.50382,18.24813,1509
25821,197231,42158B50A96F4BB50162AD5AAF8D7E2D,31201,21,23,2,109.51042,18.23819,1558
25822,197264,97C31877CA4226D0F1BA1C0E12066B56,30854,14,18,4,109.56889,18.27076,1763
25823,197265,97C31877CA4226D0F1BA1C0E12066B56,30251,18,23,5,109.50611,18.26653,1512
25824,197273,A549C024E6F63EDBD3DC866F10DB11CE,30234,4,6,2,109.60681,18.29979,1918
25825,197274,A549C024E6F63EDBD3DC866F10DB11CE,30854,8,16,8,109.56889,18.27076,1763
25826,197281,B0A549E924C57A31C8B59CCDAEE0ED2D,31471,13,15,2,109.34583,18.29563,917
25827,197282,B0A549E924C57A31C8B59CCDAEE0ED2D,30421,17,23,6,109.50021,18.25861,1511
25828,197286,21FBB6F0F825A6B1E89545963BB6C9D3,30851,4,6,2,109.5616,18.27396,1713
25829,197287,21FBB6F0F825A6B1E89545963BB6C9D3,30854,9,10,1,109.56889,18.27076,1763
25833,197379,28413CB0160B68347E92144BE214EF48,60081,17,19,2,109.51097,18.22639,1556
25834,197380,28413CB0160B68347E92144BE214EF48,30191,19,23,4,109.50361,18.22701,1506
25835,197400,85586D73EA48B4F4D520D899B0BE0554,39181,10,13,3,109.55153,18.28035,1715
25836,197401,85586D73EA48B4F4D520D899B0BE0554,60631,15,17,2,109.57778,18.27583,1814
25837,197402,85586D73EA48B4F4D520D899B0BE0554,30291,19,23,4,109.50403,18.27028,1513
25838,197403,D75F3D28EEDDC3AAB22F587F99A79102,31071,0,8,8,109.58257,18.28458,1815
25839,197404,D75F3D28EEDDC3AAB22F587F99A79102,30854,8,17,9,109.56889,18.27076,1763
25843,197432,3E01B14B28C0FDBF8BB343D61C8AA7D8,31301,14,17,3,109.14493,18.31222,170
25844,197433,3E01B14B28C0FDBF8BB343D61C8AA7D8,31931,19,21,2,109.54771,18.29403,1667
25845,197440,C30EF1A03F3ACD87114629BE5EBA14E8,31231,12,14,2,109.42597,18.29292,1217
25846,197441,C30EF1A03F3ACD87114629BE5EBA14E8,60552,14,16,2,109.41729,18.30014,1218
25847,197466,182603D8C7C4BF5CDDF16B2E79D9DF52,38251,17,18,1,109.49618,18.25493,1510
25848,197467,182603D8C7C4BF5CDDF16B2E79D9DF52,60084,18,19,1,109.4984,18.2334,1507
25849,197468,182603D8C7C4BF5CDDF16B2E79D9DF52,30211,20,21,1,109.49882,18.23931,1508
25850,197479,87F6D9996659541EF975AE3E55004A94,31161,13,15,2,109.70229,18.31361,2270
25851,197485,A00570F904F3AC2F214AE7E56CFC6E64,31031,0,7,7,109.49979,18.25382,1510
25852,197486,A00570F904F3AC2F214AE7E56CFC6E64,38754,12,13,1,109.74667,18.37382,2430
25853,197487,A00570F904F3AC2F214AE7E56CFC6E64,31701,17,18,1,109.44132,18.28833,1266
25854,197488,A00570F904F3AC2F214AE7E56CFC6E64,38941,21,23,2,109.49625,18.25451,1510
25855,197555,B61666307486DD531F980787F0F8A7B7,30854,17,21,4,109.56889,18.27076,1763
25856,197556,B61666307486DD531F980787F0F8A7B7,31561,22,23,1,109.56792,18.28479,1765
25857,197566,778E4116E7B891C10FAD01297450E954,31206,20,21,1,109.50819,18.23549,1507
25858,197567,778E4116E7B891C10FAD01297450E954,31041,21,23,2,109.50278,18.23701,1507
25862,197595,29C138323F7793FA5DE28E5154764E0B,60381,13,14,1,109.5241,18.22458,1605
25863,197628,985A2EA61E10E912EF275486E93274F1,60161,0,6,6,109.49174,18.26181,1461
25864,197629,985A2EA61E10E912EF275486E93274F1,60201,6,16,10,109.5041,18.2509,1510
25865,197630,985A2EA61E10E912EF275486E93274F1,30581,18,19,1,109.62257,18.24951,1959
25866,197631,985A2EA61E10E912EF275486E93274F1,30211,21,23,2,109.49882,18.23931,1508
25871,197689,89A01963B06628A3D6B13DA41FA507D1,30854,0,13,13,109.56889,18.27076,1763
25872,197690,89A01963B06628A3D6B13DA41FA507D1,31561,14,15,1,109.56792,18.28479,1765
25873,197691,89A01963B06628A3D6B13DA41FA507D1,30854,16,18,2,109.56889,18.27076,1763
25874,197692,89A01963B06628A3D6B13DA41FA507D1,30361,20,22,2,109.50347,18.24,1508
25878,197701,8B6E59C60C038C35AF90682694A368A0,30851,16,17,1,109.5616,18.27396,1713
25879,197702,8B6E59C60C038C35AF90682694A368A0,30891,19,20,1,109.59431,18.28389,1865
25880,197706,43F5AB52A0AF3FEB5880C6DCD16BBA02,60011,0,15,15,109.48965,18.30222,1468
25881,197707,43F5AB52A0AF3FEB5880C6DCD16BBA02,30161,15,18,3,109.50042,18.24389,1508
25882,197708,43F5AB52A0AF3FEB5880C6DCD16BBA02,30321,18,20,2,109.49563,18.29611,1467
25883,197709,43F5AB52A0AF3FEB5880C6DCD16BBA02,60011,21,23,2,109.48965,18.30222,1468
25888,197738,B5D63E96812FAD17460F5BD0EE3EE49F,60084,8,10,2,109.4984,18.2334,1507
25889,197739,B5D63E96812FAD17460F5BD0EE3EE49F,60614,15,17,2,109.48799,18.29521,1467
25890,197740,B5D63E96812FAD17460F5BD0EE3EE49F,39154,20,23,3,109.50201,18.25681,1511
25899,197809,2A3E5205AC8230AFA039AD71C1DA60B8,60661,0,8,8,109.548,18.2377,1657
25900,197810,2A3E5205AC8230AFA039AD71C1DA60B8,30241,12,13,1,109.26174,18.3275,622
25901,197811,2A3E5205AC8230AFA039AD71C1DA60B8,60201,14,16,2,109.5041,18.2509,1510
25902,197841,8E74DEE1D6AD25525E0B9C766B9CBA47,30771,20,22,2,109.49938,18.26042,1511
25903,197862,03CF17D18D5ABB539B8A67460591BD40,60291,0,1,1,109.50826,18.24639,1509
25904,197863,03CF17D18D5ABB539B8A67460591BD40,30211,1,14,13,109.49882,18.23931,1508
25905,197864,03CF17D18D5ABB539B8A67460591BD40,30681,14,15,1,109.48493,18.26917,1463
25906,197865,03CF17D18D5ABB539B8A67460591BD40,30211,16,19,3,109.49882,18.23931,1508
25907,197866,03CF17D18D5ABB539B8A67460591BD40,31251,21,23,2,109.18528,18.2975,317
25908,197871,0A9117B90774715AACE2ED3045D6F579,60552,0,6,6,109.41729,18.30014,1218
25909,197872,0A9117B90774715AACE2ED3045D6F579,30651,7,8,1,109.42611,18.385,1232
25910,197873,0A9117B90774715AACE2ED3045D6F579,60551,12,15,3,109.42722,18.30111,1218
25911,197875,0A9117B90774715AACE2ED3045D6F579,60552,22,23,1,109.41729,18.30014,1218
25915,197880,1C170E7FDA19E425F091CDE0A56B7093,31781,10,13,3,109.19847,18.2975,367
25916,197881,1C170E7FDA19E425F091CDE0A56B7093,31081,18,23,5,109.44639,18.30181,1318
25920,197941,D2A5F87218CF25385163A2F3C4229CB8,30851,1,3,2,109.5616,18.27396,1713
25921,197942,D2A5F87218CF25385163A2F3C4229CB8,31561,6,9,3,109.56792,18.28479,1765
25922,197943,D2A5F87218CF25385163A2F3C4229CB8,30851,9,11,2,109.5616,18.27396,1713
25923,197944,D2A5F87218CF25385163A2F3C4229CB8,31561,12,15,3,109.56792,18.28479,1765
25924,197945,D2A5F87218CF25385163A2F3C4229CB8,30851,20,21,1,109.5616,18.27396,1713
25925,197946,D2A5F87218CF25385163A2F3C4229CB8,31561,22,23,1,109.56792,18.28479,1765
25929,198001,8DD23AA43C0F7967C45F7488D66F9159,31531,0,2,2,109.49583,18.25972,1461
25930,198002,8DD23AA43C0F7967C45F7488D66F9159,31945,3,7,4,109.58021,18.29403,1817
25931,198003,8DD23AA43C0F7967C45F7488D66F9159,31071,9,11,2,109.58257,18.28458,1815
25932,198036,1D10133A3A6B6A1226F963E2F33A13EC,38707,13,17,4,109.73778,18.35368,2427
25933,198037,1D10133A3A6B6A1226F963E2F33A13EC,38707,19,23,4,109.73778,18.35368,2427
25937,198067,A509D0CA53CD767E0234236B42930030,38094,20,23,3,109.45403,18.28778,1316
25938,198108,3940DDDB655239C16F43D83626AAB86A,38241,0,11,11,109.54111,18.30542,1669
25939,198109,3940DDDB655239C16F43D83626AAB86A,31931,13,14,1,109.54771,18.29403,1667
25940,198110,3940DDDB655239C16F43D83626AAB86A,30921,14,19,5,109.53903,18.29451,1667
25941,198111,3940DDDB655239C16F43D83626AAB86A,31931,19,21,2,109.54771,18.29403,1667
25942,198112,3940DDDB655239C16F43D83626AAB86A,38241,22,23,1,109.54111,18.30542,1669
25943,198115,BC2EDF4DF9C7FAD55BDEABA03DFA7284,31561,0,5,5,109.56792,18.28479,1765
25944,198116,BC2EDF4DF9C7FAD55BDEABA03DFA7284,39183,6,10,4,109.55542,18.28208,1715
25945,198117,BC2EDF4DF9C7FAD55BDEABA03DFA7284,31561,11,13,2,109.56792,18.28479,1765
25946,198118,BC2EDF4DF9C7FAD55BDEABA03DFA7284,30854,14,17,3,109.56889,18.27076,1763
25947,198119,BC2EDF4DF9C7FAD55BDEABA03DFA7284,31561,18,20,2,109.56792,18.28479,1765
25951,198151,1582BEC240072EC51899932D6A0A257A,31561,0,1,1,109.56792,18.28479,1765
25952,198152,1582BEC240072EC51899932D6A0A257A,30232,1,7,6,109.6191,18.31701,1971
25953,198153,1582BEC240072EC51899932D6A0A257A,31561,8,10,2,109.56792,18.28479,1765
25954,198154,1582BEC240072EC51899932D6A0A257A,30891,12,14,2,109.59431,18.28389,1865
25955,198155,1582BEC240072EC51899932D6A0A257A,30232,16,18,2,109.6191,18.31701,1971
25959,198240,E094C48A14335F51D2BE0671D37D0CCF,30181,0,9,9,109.51597,18.23313,1557
25960,198241,E094C48A14335F51D2BE0671D37D0CCF,31471,13,15,2,109.34583,18.29563,917
25961,198242,E094C48A14335F51D2BE0671D37D0CCF,30731,16,17,1,109.50944,18.22306,1555
25962,198243,E094C48A14335F51D2BE0671D37D0CCF,30421,19,21,2,109.50021,18.25861,1511
25963,198244,E094C48A14335F51D2BE0671D37D0CCF,30731,22,23,1,109.50944,18.22306,1555
25964,198259,EBF906C5498076BCFA3E97DF6001B4F3,30854,14,16,2,109.56889,18.27076,1763
25965,198260,EBF906C5498076BCFA3E97DF6001B4F3,60631,16,23,7,109.57778,18.27583,1814
25966,198267,2939307F3A35285FC5072EF5354D23D7,38951,0,7,7,109.48097,18.28868,1416
25967,198268,2939307F3A35285FC5072EF5354D23D7,33051,9,10,1,109.6475,18.46618,2096
25968,198269,2939307F3A35285FC5072EF5354D23D7,30661,14,16,2,109.37028,18.24361,1008
25969,198270,2939307F3A35285FC5072EF5354D23D7,38951,20,23,3,109.48097,18.28868,1416
25970,198288,2A6BA0678DDF16AF08BAC9E3FA3C9391,30741,12,14,2,109.49833,18.28681,1516
25971,198289,2A6BA0678DDF16AF08BAC9E3FA3C9391,30854,17,23,6,109.56889,18.27076,1763
25972,198328,75817DB682187A07461734D66E1E6492,31061,19,20,1,109.53333,18.23257,1607
25973,198329,75817DB682187A07461734D66E1E6492,60631,20,22,2,109.57778,18.27583,1814
25974,198349,1D0D5E68B48956FE4622EC000952996C,60361,11,12,1,109.51938,18.29681,1567
25975,198378,005F3AEFE6DBF371ED1FD57736434098,30854,14,21,7,109.56889,18.27076,1763
25976,198379,005F3AEFE6DBF371ED1FD57736434098,31071,21,23,2,109.58257,18.28458,1815
25977,198397,F57902A58026464B5BDED6D5CB0C8C35,31301,14,16,2,109.14493,18.31222,170
25978,198398,F57902A58026464B5BDED6D5CB0C8C35,31021,19,23,4,109.49021,18.27,1463
25982,198405,34F3D64B41C252481F72E5CF931AC833,30851,0,6,6,109.5616,18.27396,1713
25983,198406,34F3D64B41C252481F72E5CF931AC833,31071,7,12,5,109.58257,18.28458,1815
25995,198505,B48CF6FA27E864933632BDC922A5DB6B,30211,18,20,2,109.49882,18.23931,1508
25996,198506,B48CF6FA27E864933632BDC922A5DB6B,31031,20,22,2,109.49979,18.25382,1510
26003,198543,E6541B4F346982101D887BAAF0315541,30854,1,7,6,109.56889,18.27076,1763
26004,198544,E6541B4F346982101D887BAAF0315541,31561,8,18,10,109.56792,18.28479,1765
26005,198545,E6541B4F346982101D887BAAF0315541,30861,21,23,2,109.52722,18.22743,1606
26010,198621,B643AC77F8D8498A9694D45BA8B0F75F,60631,1,12,11,109.57778,18.27583,1814
26011,198622,B643AC77F8D8498A9694D45BA8B0F75F,30854,14,19,5,109.56889,18.27076,1763
26015,198716,CD2333A80921E2508A5B160841254ACF,38251,1,7,6,109.49618,18.25493,1510
26016,198717,CD2333A80921E2508A5B160841254ACF,30171,11,23,12,109.48458,18.27139,1463
26023,198777,42208654DD68D689FEE2FABD4C7FC956,38271,0,9,9,109.62632,18.23049,1956
26024,198778,42208654DD68D689FEE2FABD4C7FC956,33481,13,15,2,109.67278,18.41278,2187
26025,198779,42208654DD68D689FEE2FABD4C7FC956,30161,19,20,1,109.50042,18.24389,1508
26026,198780,42208654DD68D689FEE2FABD4C7FC956,31031,22,23,1,109.49979,18.25382,1510
26027,198794,4995463B780282C9C030A19D9F49AEAC,31071,0,7,7,109.58257,18.28458,1815
26028,198795,4995463B780282C9C030A19D9F49AEAC,30854,10,16,6,109.56889,18.27076,1763
26029,198812,4E94ADAE7ABEB20EEFAF67519DFCC1BE,31081,1,8,7,109.44639,18.30181,1318
26030,198813,4E94ADAE7ABEB20EEFAF67519DFCC1BE,31031,10,22,12,109.49979,18.25382,1510
26031,198871,4D9A472B7DD43E0DD6EF3059F08EEEB1,38251,8,11,3,109.49618,18.25493,1510
26032,198872,4D9A472B7DD43E0DD6EF3059F08EEEB1,60401,12,13,1,109.47444,18.27583,1414
26033,198873,4D9A472B7DD43E0DD6EF3059F08EEEB1,60161,16,19,3,109.49174,18.26181,1461
26034,198874,4D9A472B7DD43E0DD6EF3059F08EEEB1,31231,21,23,2,109.42597,18.29292,1217
26035,198884,C3485CDC6A0EB2B046EA3123960E45A0,31101,0,11,11,109.65389,18.23403,2057
26036,198885,C3485CDC6A0EB2B046EA3123960E45A0,30511,14,16,2,109.51069,18.24208,1558
26037,198886,C3485CDC6A0EB2B046EA3123960E45A0,31521,18,20,2,109.51458,18.22542,1555
26038,198887,C3485CDC6A0EB2B046EA3123960E45A0,30511,20,23,3,109.51069,18.24208,1558
26039,198888,00FD2268DE6E83934D2916174E81532F,60472,0,6,6,109.46625,18.29542,1367
26040,198889,00FD2268DE6E83934D2916174E81532F,30111,6,9,3,109.47583,18.30542,1419
26041,198890,00FD2268DE6E83934D2916174E81532F,30761,10,11,1,109.45201,18.3,1318
26042,198891,00FD2268DE6E83934D2916174E81532F,30111,11,14,3,109.47583,18.30542,1419
26043,198892,00FD2268DE6E83934D2916174E81532F,60472,14,16,2,109.46625,18.29542,1367
26044,198893,00FD2268DE6E83934D2916174E81532F,30111,17,19,2,109.47583,18.30542,1419
26052,198958,F198CAA1F49ACA5D003FD8F8473B3798,31071,0,7,7,109.58257,18.28458,1815
26053,198959,F198CAA1F49ACA5D003FD8F8473B3798,30854,8,23,15,109.56889,18.27076,1763
26054,198971,25F8E03F1120E0B7927A22C7EA6DF1B4,31031,0,13,13,109.49979,18.25382,1510
26055,198972,25F8E03F1120E0B7927A22C7EA6DF1B4,38315,14,15,1,109.48979,18.29764,1467
26056,199020,DAB08D254D49BF150533311BD904D49C,31411,19,20,1,109.5016,18.23576,1507
26057,199021,DAB08D254D49BF150533311BD904D49C,60291,21,23,2,109.50826,18.24639,1509
26058,199039,968151594EB4BCD9EBED877ECCD5C3EC,30351,0,8,8,109.41701,18.29292,1217
26059,199040,968151594EB4BCD9EBED877ECCD5C3EC,60054,12,15,3,109.3016,18.31229,770
26063,199044,35C6EDC8AAC6B5ABA770190223528BA2,31061,0,8,8,109.53333,18.23257,1607
26064,199045,35C6EDC8AAC6B5ABA770190223528BA2,33521,10,15,5,109.66313,18.45174,2143
26065,199058,FCC0ADE407C88A97F8FDA735A86E80B1,31864,0,6,6,109.49014,18.28333,1465
26066,199060,FCC0ADE407C88A97F8FDA735A86E80B1,30391,20,22,2,109.4975,18.27118,1513
26070,199106,AE9453D604AF88F4293DEF99463B2345,30391,12,13,1,109.4975,18.27118,1513
26071,199139,63359C177BE67F4FFCD2DF5C06228A23,60401,0,3,3,109.47444,18.27583,1414
26072,199140,63359C177BE67F4FFCD2DF5C06228A23,30051,3,4,1,109.48917,18.21215,1453
26073,199141,63359C177BE67F4FFCD2DF5C06228A23,60401,4,8,4,109.47444,18.27583,1414
26074,199142,63359C177BE67F4FFCD2DF5C06228A23,30051,8,9,1,109.48917,18.21215,1453
26075,199143,63359C177BE67F4FFCD2DF5C06228A23,60401,9,19,10,109.47444,18.27583,1414
26076,199144,63359C177BE67F4FFCD2DF5C06228A23,30161,19,21,2,109.50042,18.24389,1508
26077,199164,C711EA8F4B039EAC279F7CFC24309A8A,30051,12,13,1,109.48917,18.21215,1453
26078,199165,C711EA8F4B039EAC279F7CFC24309A8A,60671,14,15,1,109.52979,18.31757,1621
26079,199166,C711EA8F4B039EAC279F7CFC24309A8A,30071,20,23,3,109.52819,18.30472,1619
26080,199167,2D39AE6120F2674000C6DBB8A6E572A0,31945,2,13,11,109.58021,18.29403,1817
26081,199168,2D39AE6120F2674000C6DBB8A6E572A0,30854,13,15,2,109.56889,18.27076,1763
26082,199200,44F505B3929E26B4B29F00CC284F3084,60631,3,9,6,109.57778,18.27583,1814
26083,199201,44F505B3929E26B4B29F00CC284F3084,30854,10,16,6,109.56889,18.27076,1763
26084,199202,770A00BDAFE9BCA8C9E9FA68066EED7D,30854,18,19,1,109.56889,18.27076,1763
26085,199203,770A00BDAFE9BCA8C9E9FA68066EED7D,31071,20,23,3,109.58257,18.28458,1815
26086,199253,86C0171C8311911DC85F52F1754351D5,30021,0,8,8,109.12014,18.40986,86
26087,199254,86C0171C8311911DC85F52F1754351D5,30911,10,11,1,109.50493,18.26181,1511
26088,199255,86C0171C8311911DC85F52F1754351D5,30771,15,16,1,109.49938,18.26042,1511
26089,199256,86C0171C8311911DC85F52F1754351D5,30421,18,21,3,109.50021,18.25861,1511
26090,199257,86C0171C8311911DC85F52F1754351D5,30911,21,23,2,109.50493,18.26181,1511
26091,199286,3878C4CD0EA74CE57B1537A7F0A483EE,38023,0,9,9,109.37132,18.28993,1016
26092,199287,3878C4CD0EA74CE57B1537A7F0A483EE,30341,13,14,1,109.3625,18.29167,966
26093,199288,3878C4CD0EA74CE57B1537A7F0A483EE,38023,15,18,3,109.37132,18.28993,1016
26094,199289,3878C4CD0EA74CE57B1537A7F0A483EE,30341,19,20,1,109.3625,18.29167,966
26095,199290,3878C4CD0EA74CE57B1537A7F0A483EE,38023,21,23,2,109.37132,18.28993,1016
26096,199371,AD6C1B3AC9CE359429A262FC83337FDE,31471,15,17,2,109.34583,18.29563,917
26097,199372,AD6C1B3AC9CE359429A262FC83337FDE,30351,17,19,2,109.41701,18.29292,1217
26098,199373,AD6C1B3AC9CE359429A262FC83337FDE,60551,19,20,1,109.42722,18.30111,1218
26099,199374,AD6C1B3AC9CE359429A262FC83337FDE,38671,21,23,2,109.41576,18.29285,1167
26100,199457,94C4D5691F7DFC1AB38806AFFAC1389E,30921,1,7,6,109.53903,18.29451,1667
26101,199458,94C4D5691F7DFC1AB38806AFFAC1389E,31931,7,8,1,109.54771,18.29403,1667
26102,199459,94C4D5691F7DFC1AB38806AFFAC1389E,30921,9,10,1,109.53903,18.29451,1667
26103,199460,94C4D5691F7DFC1AB38806AFFAC1389E,31041,19,21,2,109.50278,18.23701,1507
26104,199461,94C4D5691F7DFC1AB38806AFFAC1389E,31931,22,23,1,109.54771,18.29403,1667
26105,199486,E191BF114A3C2277CB7C3323BAA13F43,30854,0,8,8,109.56889,18.27076,1763
26106,199487,E191BF114A3C2277CB7C3323BAA13F43,31121,12,14,2,109.16292,18.37063,230
26107,199488,E191BF114A3C2277CB7C3323BAA13F43,30854,16,17,1,109.56889,18.27076,1763
26108,199489,E191BF114A3C2277CB7C3323BAA13F43,31561,17,18,1,109.56792,18.28479,1765
26109,199490,E191BF114A3C2277CB7C3323BAA13F43,30854,21,22,1,109.56889,18.27076,1763
26117,199518,293757429670FEF848C950D685169FCC,31071,0,7,7,109.58257,18.28458,1815
26118,199519,293757429670FEF848C950D685169FCC,30854,11,18,7,109.56889,18.27076,1763
26119,199528,A68637AA89BD62624E677D9E66C32FAD,31391,0,4,4,109.50382,18.24285,1508
26120,199529,A68637AA89BD62624E677D9E66C32FAD,30361,5,8,3,109.50347,18.24,1508
26121,199530,A68637AA89BD62624E677D9E66C32FAD,30161,9,13,4,109.50042,18.24389,1508
26122,199531,A68637AA89BD62624E677D9E66C32FAD,30161,15,18,3,109.50042,18.24389,1508
26123,199532,A68637AA89BD62624E677D9E66C32FAD,60281,18,20,2,109.51743,18.25924,1561
26124,199533,A68637AA89BD62624E677D9E66C32FAD,31461,20,21,1,109.5091,18.25389,1510
26125,199557,B5EEA30F2FFAABF51AE99311CDE9203E,39111,0,6,6,109.5191,18.22597,1555
26126,199558,B5EEA30F2FFAABF51AE99311CDE9203E,31145,8,10,2,109.20431,18.30479,369
26127,199559,B5EEA30F2FFAABF51AE99311CDE9203E,31521,13,16,3,109.51458,18.22542,1555
26128,199560,B5EEA30F2FFAABF51AE99311CDE9203E,39111,19,23,4,109.5191,18.22597,1555
26129,199605,05905F60112FFA73902399BABD12025F,30181,1,11,10,109.51597,18.23313,1557
26130,199606,05905F60112FFA73902399BABD12025F,38754,12,16,4,109.74667,18.37382,2430
26131,199607,05905F60112FFA73902399BABD12025F,30361,18,21,3,109.50347,18.24,1508
26132,199608,05905F60112FFA73902399BABD12025F,30181,21,23,2,109.51597,18.23313,1557
26137,199663,46DF9F7A9481895A9B0E6AFE3F8BF4F5,30511,10,11,1,109.51069,18.24208,1558
26138,199665,3237597F614A630A7507AC0232ABB23F,31031,18,20,2,109.49979,18.25382,1510
26139,199666,3237597F614A630A7507AC0232ABB23F,30201,20,22,2,109.4909,18.26465,1462
26140,199679,90B0A60855A43B2DB99A0964CE51D3AF,31071,1,12,11,109.58257,18.28458,1815
26141,199680,90B0A60855A43B2DB99A0964CE51D3AF,30854,13,20,7,109.56889,18.27076,1763
26142,199686,EE1DC3D3663945EFC02BAB5EE6A065E9,31071,0,7,7,109.58257,18.28458,1815
26143,199687,EE1DC3D3663945EFC02BAB5EE6A065E9,30854,7,8,1,109.56889,18.27076,1763
26144,199688,EE1DC3D3663945EFC02BAB5EE6A065E9,31945,9,12,3,109.58021,18.29403,1817
26145,199689,EE1DC3D3663945EFC02BAB5EE6A065E9,30854,13,17,4,109.56889,18.27076,1763
26146,199690,EE1DC3D3663945EFC02BAB5EE6A065E9,31071,21,23,2,109.58257,18.28458,1815
26147,199712,301C6D43A4835F6C303372D1D4AB6B2B,30151,0,2,2,109.50986,18.25083,1560
26148,199713,301C6D43A4835F6C303372D1D4AB6B2B,30151,2,9,7,109.50986,18.25083,1560
26149,199714,301C6D43A4835F6C303372D1D4AB6B2B,60291,12,15,3,109.50826,18.24639,1509
26150,199715,301C6D43A4835F6C303372D1D4AB6B2B,30101,15,16,1,109.57299,18.33333,1773
26151,199716,301C6D43A4835F6C303372D1D4AB6B2B,31421,17,21,4,109.55382,18.22347,1705
26152,199717,301C6D43A4835F6C303372D1D4AB6B2B,30151,21,23,2,109.50986,18.25083,1560
26156,199770,122D07F80E4FAC68FAE7EDBB2DF1AFA3,31071,12,14,2,109.58257,18.28458,1815
26157,199771,122D07F80E4FAC68FAE7EDBB2DF1AFA3,30854,14,17,3,109.56889,18.27076,1763
26162,199813,D334753E33AD01D79142036B3D85543F,31561,0,5,5,109.56792,18.28479,1765
26163,199814,D334753E33AD01D79142036B3D85543F,39183,6,17,11,109.55542,18.28208,1715
26164,199825,00145806BBF2F60A963743509F901155,60331,0,7,7,109.505,18.26507,1512
26165,199826,00145806BBF2F60A963743509F901155,30291,12,13,1,109.50403,18.27028,1513
26166,199827,00145806BBF2F60A963743509F901155,60221,15,17,2,109.52569,18.29188,1616
26167,199828,00145806BBF2F60A963743509F901155,30291,18,20,2,109.50403,18.27028,1513
26168,199829,00145806BBF2F60A963743509F901155,60331,21,23,2,109.505,18.26507,1512
26169,199847,25A98576A428F536C695E42B71201D8E,31021,17,19,2,109.49021,18.27,1463
26170,199848,25A98576A428F536C695E42B71201D8E,38162,20,21,1,109.43944,18.28889,1266
26171,199849,25A98576A428F536C695E42B71201D8E,31701,22,23,1,109.44132,18.28833,1266
26175,199916,A9FCE0049DB44FE004EAFBF5B783F4A5,60631,3,8,5,109.57778,18.27583,1814
26176,199917,A9FCE0049DB44FE004EAFBF5B783F4A5,30854,8,18,10,109.56889,18.27076,1763
26177,199918,A9FCE0049DB44FE004EAFBF5B783F4A5,30191,20,22,2,109.50361,18.22701,1506
26184,200039,84DF4A7C208235D171EF56473BCCF210,30851,0,5,5,109.5616,18.27396,1713
26185,200040,84DF4A7C208235D171EF56473BCCF210,60631,8,18,10,109.57778,18.27583,1814
26186,200041,67E18D6323A016C43955B0A9A1FA3659,30211,5,11,6,109.49882,18.23931,1508
26187,200042,67E18D6323A016C43955B0A9A1FA3659,31231,16,17,1,109.42597,18.29292,1217
26188,200043,67E18D6323A016C43955B0A9A1FA3659,38281,19,22,3,109.6525,18.23403,2057
26189,200047,9220DF509B1CBDCE8F6FF4B7184ACC0D,31561,2,18,16,109.56792,18.28479,1765
26190,200048,9220DF509B1CBDCE8F6FF4B7184ACC0D,30421,19,21,2,109.50021,18.25861,1511
26194,200090,C3071072DB6684DC75BE160268E6323C,31071,1,6,5,109.58257,18.28458,1815
26195,200091,C3071072DB6684DC75BE160268E6323C,30854,11,13,2,109.56889,18.27076,1763
26200,200101,7024F3A14F6F554DC6E80063E30315F0,30854,19,20,1,109.56889,18.27076,1763
26201,200102,7024F3A14F6F554DC6E80063E30315F0,31561,22,23,1,109.56792,18.28479,1765
26202,200114,9905C3E423D151CCE1280F3A1732CE90,30854,0,6,6,109.56889,18.27076,1763
26203,200115,9905C3E423D151CCE1280F3A1732CE90,31071,7,8,1,109.58257,18.28458,1815
26204,200116,9905C3E423D151CCE1280F3A1732CE90,30851,8,11,3,109.5616,18.27396,1713
26205,200117,9905C3E423D151CCE1280F3A1732CE90,30951,13,18,5,109.56208,18.25667,1761
26206,200118,9905C3E423D151CCE1280F3A1732CE90,30854,19,22,3,109.56889,18.27076,1763
26207,200133,C316CE65034FB3C77BE459147CBF943A,60291,0,9,9,109.50826,18.24639,1509
26208,200134,C316CE65034FB3C77BE459147CBF943A,30161,11,12,1,109.50042,18.24389,1508
26209,200135,C316CE65034FB3C77BE459147CBF943A,39101,13,16,3,109.50132,18.24931,1509
26210,200136,C316CE65034FB3C77BE459147CBF943A,30161,17,20,3,109.50042,18.24389,1508
26211,200137,C316CE65034FB3C77BE459147CBF943A,31181,21,23,2,109.50382,18.24813,1509
26212,200143,BE586ACB441383CC10D7CF3923850B73,31931,0,7,7,109.54771,18.29403,1667
26213,200144,BE586ACB441383CC10D7CF3923850B73,39181,8,10,2,109.55153,18.28035,1715
26214,200145,BE586ACB441383CC10D7CF3923850B73,31931,12,13,1,109.54771,18.29403,1667
26215,200146,BE586ACB441383CC10D7CF3923850B73,39181,14,15,1,109.55153,18.28035,1715
26216,200147,BE586ACB441383CC10D7CF3923850B73,39181,16,17,1,109.55153,18.28035,1715
26217,200148,BE586ACB441383CC10D7CF3923850B73,31931,19,23,4,109.54771,18.29403,1667
26221,200171,B8587D3CED4B79DF3F07DD5419A719F9,38251,11,12,1,109.49618,18.25493,1510
26222,200172,B8587D3CED4B79DF3F07DD5419A719F9,38325,13,14,1,109.39792,18.2909,1116
26223,200173,B8587D3CED4B79DF3F07DD5419A719F9,30211,16,17,1,109.49882,18.23931,1508
26224,200193,D6A345956751BA2ACC5430EDF68A104F,39181,0,6,6,109.55153,18.28035,1715
26225,200194,D6A345956751BA2ACC5430EDF68A104F,31931,6,9,3,109.54771,18.29403,1667
26226,200195,D6A345956751BA2ACC5430EDF68A104F,30071,9,11,2,109.52819,18.30472,1619
26227,200196,D6A345956751BA2ACC5430EDF68A104F,31931,12,19,7,109.54771,18.29403,1667
26228,200197,D6A345956751BA2ACC5430EDF68A104F,39181,20,23,3,109.55153,18.28035,1715
26233,200230,3C81431CE72C8A68AA7DD35602A2B093,33481,13,15,2,109.67278,18.41278,2187
26234,200231,3C81431CE72C8A68AA7DD35602A2B093,60221,19,21,2,109.52569,18.29188,1616
26235,200232,3C81431CE72C8A68AA7DD35602A2B093,30861,22,23,1,109.52722,18.22743,1606
26243,200276,FF90B6855593CFEA9A07FE008E94551D,60371,19,21,2,109.53063,18.30056,1618
26244,200277,FF90B6855593CFEA9A07FE008E94551D,30071,21,23,2,109.52819,18.30472,1619
26248,200282,8C0E6B51FAFE21C31FB9AE08C36DF0A2,30921,0,16,16,109.53903,18.29451,1667
26249,200283,8C0E6B51FAFE21C31FB9AE08C36DF0A2,31931,18,20,2,109.54771,18.29403,1667
26250,200293,C54CD3A42CE5AE9A9396503ECCB4A236,39371,0,7,7,109.56627,18.2646,1762
26251,200294,C54CD3A42CE5AE9A9396503ECCB4A236,30111,7,17,10,109.47583,18.30542,1419
26252,200295,C54CD3A42CE5AE9A9396503ECCB4A236,30861,22,23,1,109.52722,18.22743,1606
26256,200327,3D689A9568FAADEA2EB7920B95888F95,60504,0,9,9,109.47917,18.28903,1416
26257,200328,3D689A9568FAADEA2EB7920B95888F95,60391,11,15,4,109.47667,18.28757,1416
26258,200329,3D689A9568FAADEA2EB7920B95888F95,31411,18,21,3,109.5016,18.23576,1507
26259,200330,3D689A9568FAADEA2EB7920B95888F95,31091,22,23,1,109.41201,18.31222,1170
26260,200347,D947D8D9432E18EA6A214259B6E2987E,60054,0,4,4,109.3016,18.31229,770
26261,200348,D947D8D9432E18EA6A214259B6E2987E,30661,6,12,6,109.37028,18.24361,1008
26262,200349,D947D8D9432E18EA6A214259B6E2987E,60411,13,14,1,109.32514,18.30854,869
26263,200350,D947D8D9432E18EA6A214259B6E2987E,30661,14,15,1,109.37028,18.24361,1008
26264,200351,D947D8D9432E18EA6A214259B6E2987E,60411,17,18,1,109.32514,18.30854,869
26271,200395,173F9710B8D6B9F1AA39189FE9F9512E,38017,19,20,1,109.49729,18.21424,1504
26272,200396,173F9710B8D6B9F1AA39189FE9F9512E,38251,22,23,1,109.49618,18.25493,1510
26273,200420,6ED697962F10CC0C2236463F9FC9376B,30821,7,20,13,109.43681,18.33639,1274
26274,200421,6ED697962F10CC0C2236463F9FC9376B,30761,21,22,1,109.45201,18.3,1318
26279,200458,54A6757CA4BF8A47C41CF1DDCA6EA505,30854,16,18,2,109.56889,18.27076,1763
26280,200459,54A6757CA4BF8A47C41CF1DDCA6EA505,31071,22,23,1,109.58257,18.28458,1815
26284,200485,409F5E8F01172D32BBE91132149C037E,30511,0,9,9,109.51069,18.24208,1558
26285,200486,409F5E8F01172D32BBE91132149C037E,39101,9,10,1,109.50132,18.24931,1509
26286,200487,409F5E8F01172D32BBE91132149C037E,30361,12,13,1,109.50347,18.24,1508
26287,200488,409F5E8F01172D32BBE91132149C037E,31201,17,18,1,109.51042,18.23819,1558
26288,200489,409F5E8F01172D32BBE91132149C037E,38157,22,23,1,109.51483,18.26958,1563
26289,200491,07169E7114E4F14C073261BAAC0D4491,61011,10,12,2,109.60653,18.19076,1900
26290,200493,53490AD77ACCA93C3ED0F3DE79CA488B,31071,11,13,2,109.58257,18.28458,1815
26291,200494,53490AD77ACCA93C3ED0F3DE79CA488B,30854,15,16,1,109.56889,18.27076,1763
26292,200495,53490AD77ACCA93C3ED0F3DE79CA488B,31071,18,20,2,109.58257,18.28458,1815
26293,200518,6F590AF2C10C4B9F0F4E76B8E922550E,31071,0,7,7,109.58257,18.28458,1815
26294,200519,6F590AF2C10C4B9F0F4E76B8E922550E,31071,9,11,2,109.58257,18.28458,1815
26295,200520,6F590AF2C10C4B9F0F4E76B8E922550E,30854,15,16,1,109.56889,18.27076,1763
26296,200521,6F590AF2C10C4B9F0F4E76B8E922550E,31761,18,21,3,109.60521,18.27965,1914
26297,200522,6F590AF2C10C4B9F0F4E76B8E922550E,60354,21,23,2,109.58701,18.28521,1815
26298,200544,2785D5AA4FE0918A7AF0E1FD0BB88176,30854,13,16,3,109.56889,18.27076,1763
26299,200545,2785D5AA4FE0918A7AF0E1FD0BB88176,38361,21,23,2,109.43667,18.29201,1267
26300,200569,9C1407835BC54BEBDB541F52E1DA1820,61011,17,21,4,109.60653,18.19076,1900
26301,200597,D4ACE21EA3DCCDD758BC5FDCC5A3C794,30351,0,7,7,109.41701,18.29292,1217
26302,200598,D4ACE21EA3DCCDD758BC5FDCC5A3C794,31781,9,12,3,109.19847,18.2975,367
26303,200599,D4ACE21EA3DCCDD758BC5FDCC5A3C794,60054,14,16,2,109.3016,18.31229,770
26304,200600,D4ACE21EA3DCCDD758BC5FDCC5A3C794,30351,19,23,4,109.41701,18.29292,1217
26305,200653,C666BDF91E2AEE4AB0E8446E7282D156,60463,10,12,2,109.52507,18.22438,1605
26306,200654,C666BDF91E2AEE4AB0E8446E7282D156,39053,14,16,2,109.511,18.2771,1564
26307,200655,C666BDF91E2AEE4AB0E8446E7282D156,31061,18,19,1,109.53333,18.23257,1607
26308,200656,C666BDF91E2AEE4AB0E8446E7282D156,60221,20,22,2,109.52569,18.29188,1616
26309,200661,0E355C05F79BCBF53145724D835D4901,38105,0,6,6,109.40299,18.29229,1117
26310,200662,0E355C05F79BCBF53145724D835D4901,31301,9,12,3,109.14493,18.31222,170
26311,200663,0E355C05F79BCBF53145724D835D4901,31471,13,15,2,109.34583,18.29563,917
26312,200674,87C93C09107C554DB19E0C119A198391,31531,8,9,1,109.49583,18.25972,1461
26313,200675,87C93C09107C554DB19E0C119A198391,30071,9,10,1,109.52819,18.30472,1619
26314,200676,87C93C09107C554DB19E0C119A198391,31031,12,13,1,109.49979,18.25382,1510
26315,200699,3D973863443908C78D38AAF704284294,30671,0,6,6,109.43611,18.30139,1268
26316,200700,3D973863443908C78D38AAF704284294,60054,10,11,1,109.3016,18.31229,770
26317,200701,3D973863443908C78D38AAF704284294,30661,11,13,2,109.37028,18.24361,1008
26318,200725,D9689370CD6256E9753C2B0B13067E2B,60631,1,6,5,109.57778,18.27583,1814
26319,200727,D9689370CD6256E9753C2B0B13067E2B,30854,15,23,8,109.56889,18.27076,1763
26320,200759,6A74DBCF68C394F15C6D2F7F45531CD3,60054,14,15,1,109.3016,18.31229,770
26321,200760,6A74DBCF68C394F15C6D2F7F45531CD3,60221,15,19,4,109.52569,18.29188,1616
26322,200761,6A74DBCF68C394F15C6D2F7F45531CD3,31421,22,23,1,109.55382,18.22347,1705
26323,200780,9D08739092826F08F2C268E72E8D5521,60281,19,21,2,109.51743,18.25924,1561
26324,200781,9D08739092826F08F2C268E72E8D5521,38325,22,23,1,109.39792,18.2909,1116
26325,200800,2091DB2ACA69B10ADE950A23CC278A98,31431,0,1,1,109.44639,18.29042,1316
26326,200801,2091DB2ACA69B10ADE950A23CC278A98,60361,3,5,2,109.51938,18.29681,1567
26327,200802,2091DB2ACA69B10ADE950A23CC278A98,31431,7,16,9,109.44639,18.29042,1316
26328,200803,2091DB2ACA69B10ADE950A23CC278A98,38251,16,17,1,109.49618,18.25493,1510
26329,200804,2091DB2ACA69B10ADE950A23CC278A98,31431,18,19,1,109.44639,18.29042,1316
26333,200842,38C163CD965FA1BEEEA1CEB4AE4ADD90,39181,12,14,2,109.55153,18.28035,1715
26334,200843,38C163CD965FA1BEEEA1CEB4AE4ADD90,60201,14,22,8,109.5041,18.2509,1510
26335,200864,99CBAA6A65A50998F0A10B72B36210E4,60161,9,10,1,109.49174,18.26181,1461
26336,200865,99CBAA6A65A50998F0A10B72B36210E4,60231,11,22,11,109.49903,18.21972,1504
26337,200866,2FE0F3A82C27452F04A6B927F514EFA7,31554,0,10,10,109.55521,18.2459,1709
26338,200867,2FE0F3A82C27452F04A6B927F514EFA7,31561,11,12,1,109.56792,18.28479,1765
26339,200868,2FE0F3A82C27452F04A6B927F514EFA7,31181,14,15,1,109.50382,18.24813,1509
26340,200869,2FE0F3A82C27452F04A6B927F514EFA7,30911,16,17,1,109.50493,18.26181,1511
26341,200870,2FE0F3A82C27452F04A6B927F514EFA7,60381,18,23,5,109.5241,18.22458,1605
26345,200885,000584B3023702F3E9DDF521B1C35B1A,30854,17,18,1,109.56889,18.27076,1763
26346,200886,000584B3023702F3E9DDF521B1C35B1A,31945,19,20,1,109.58021,18.29403,1817
26347,200887,7EBC20D0E5F0FBA046CA1D08E7FF47C1,30854,1,19,18,109.56889,18.27076,1763
26348,200888,7EBC20D0E5F0FBA046CA1D08E7FF47C1,30191,22,23,1,109.50361,18.22701,1506
26360,200982,01FF6D65AF5B6ECAD8BD2BEF97B00B84,38052,0,1,1,109.62618,18.23042,1956
26361,200983,01FF6D65AF5B6ECAD8BD2BEF97B00B84,31571,3,7,4,109.61563,18.23326,1957
26362,200984,01FF6D65AF5B6ECAD8BD2BEF97B00B84,38052,7,8,1,109.62618,18.23042,1956
26363,200985,01FF6D65AF5B6ECAD8BD2BEF97B00B84,30441,10,12,2,109.64021,18.25424,2010
26364,200986,01FF6D65AF5B6ECAD8BD2BEF97B00B84,38052,14,23,9,109.62618,18.23042,1956
26365,200999,7E544E07A6F29B69DAF0EA624E4EEAAD,60054,16,18,2,109.3016,18.31229,770
26366,201000,7E544E07A6F29B69DAF0EA624E4EEAAD,39281,21,23,2,109.21333,18.30271,418
26367,201018,E5E2DA460104E389257158E8D8C9FBDA,60281,0,6,6,109.51743,18.25924,1561
26368,201019,E5E2DA460104E389257158E8D8C9FBDA,60311,6,11,5,109.52097,18.24319,1558
26369,201020,E5E2DA460104E389257158E8D8C9FBDA,31261,11,12,1,109.51174,18.2466,1559
26370,201021,E5E2DA460104E389257158E8D8C9FBDA,60311,14,17,3,109.52097,18.24319,1558
26371,201022,E5E2DA460104E389257158E8D8C9FBDA,60281,17,23,6,109.51743,18.25924,1561
26378,201075,8D496C0E2DB1FF881021B05CE10C0242,31071,0,4,4,109.58257,18.28458,1815
26379,201076,8D496C0E2DB1FF881021B05CE10C0242,30854,7,23,16,109.56889,18.27076,1763
26380,201098,7FD31F65A9E7574FDAD4A110ACBA289D,60171,14,16,2,109.51292,18.30694,1569
26381,201099,7FD31F65A9E7574FDAD4A110ACBA289D,60371,18,19,1,109.53063,18.30056,1618
26385,201115,0CE734CF9AAD35EF26955DDF1FD6DDAB,38871,15,17,2,109.44681,18.28625,1316
26386,201116,0CE734CF9AAD35EF26955DDF1FD6DDAB,39091,18,19,1,109.50097,18.25222,1510
26387,201117,0CE734CF9AAD35EF26955DDF1FD6DDAB,39091,21,22,1,109.50097,18.25222,1510
26388,201231,51061B3DE820AF1C1C713EF684728003,30854,8,18,10,109.56889,18.27076,1763
26389,201232,51061B3DE820AF1C1C713EF684728003,31071,21,23,2,109.58257,18.28458,1815
26390,201238,213AF2099653A4ADAEF799CCC144B279,30021,0,11,11,109.12014,18.40986,86
26391,201240,213AF2099653A4ADAEF799CCC144B279,30021,17,22,5,109.12014,18.40986,86
26392,201241,5EC06FAC313B2D21C1321F01A9E06016,30661,13,15,2,109.37028,18.24361,1008
26393,201242,5EC06FAC313B2D21C1321F01A9E06016,60054,18,19,1,109.3016,18.31229,770
26394,201243,5EC06FAC313B2D21C1321F01A9E06016,38951,20,23,3,109.48097,18.28868,1416
26395,201244,A9BC995AD7BCE38026731A45BAD73591,31521,0,1,1,109.51458,18.22542,1555
26396,201245,A9BC995AD7BCE38026731A45BAD73591,30731,2,6,4,109.50944,18.22306,1555
26397,201246,A9BC995AD7BCE38026731A45BAD73591,38754,9,12,3,109.74667,18.37382,2430
26398,201278,1C7CD110946177CB33C47D26152F6C47,39183,1,6,5,109.55542,18.28208,1715
26399,201279,1C7CD110946177CB33C47D26152F6C47,30851,7,8,1,109.5616,18.27396,1713
26400,201293,207A3717E11AB3AC89EB226444DE97A9,31031,12,15,3,109.49979,18.25382,1510
26401,201294,207A3717E11AB3AC89EB226444DE97A9,31031,15,17,2,109.49979,18.25382,1510
26402,201295,207A3717E11AB3AC89EB226444DE97A9,30771,18,20,2,109.49938,18.26042,1511
26403,201296,207A3717E11AB3AC89EB226444DE97A9,30771,21,22,1,109.49938,18.26042,1511
26404,201320,D9AE11CD16B231308C3F0FB3F53BC3E9,31071,0,13,13,109.58257,18.28458,1815
26405,201321,D9AE11CD16B231308C3F0FB3F53BC3E9,30854,15,17,2,109.56889,18.27076,1763
26406,201338,7CE7C06285D7493A1117F256B3BBCC56,31031,8,9,1,109.49979,18.25382,1510
26407,201339,7CE7C06285D7493A1117F256B3BBCC56,30151,10,16,6,109.50986,18.25083,1560
26408,201340,7CE7C06285D7493A1117F256B3BBCC56,38291,18,19,1,109.51618,18.24313,1558
26409,201341,7CE7C06285D7493A1117F256B3BBCC56,30151,20,23,3,109.50986,18.25083,1560
26410,201383,8B9A9BFD1ACAD480EB101A91DBF2024D,38291,1,17,16,109.51618,18.24313,1558
26411,201384,8B9A9BFD1ACAD480EB101A91DBF2024D,30371,18,20,2,109.51,18.24771,1559
26412,201394,E9A67CAEAD4E146EE721320A56F893AA,31071,0,2,2,109.58257,18.28458,1815
26413,201395,E9A67CAEAD4E146EE721320A56F893AA,31945,4,6,2,109.58021,18.29403,1817
26414,201396,E9A67CAEAD4E146EE721320A56F893AA,30711,9,11,2,109.50271,18.25347,1510
26415,201397,E9A67CAEAD4E146EE721320A56F893AA,30854,17,20,3,109.56889,18.27076,1763
26416,201398,E9A67CAEAD4E146EE721320A56F893AA,31945,21,22,1,109.58021,18.29403,1817
26420,201424,F3EA4B3DF8A619A30272A53ECD9E968F,38185,0,7,7,109.51333,18.27347,1563
26421,201425,F3EA4B3DF8A619A30272A53ECD9E968F,38013,12,14,2,109.49514,18.21951,1454
26422,201426,F3EA4B3DF8A619A30272A53ECD9E968F,39191,17,19,2,109.51493,18.23472,1557
26423,201427,F3EA4B3DF8A619A30272A53ECD9E968F,60201,20,22,2,109.5041,18.2509,1510
26424,201432,B993C2FD00BD91EAEE002C4003C4B7E2,31071,0,7,7,109.58257,18.28458,1815
26425,201433,B993C2FD00BD91EAEE002C4003C4B7E2,31071,8,9,1,109.58257,18.28458,1815
26426,201434,B993C2FD00BD91EAEE002C4003C4B7E2,38251,14,15,1,109.49618,18.25493,1510
26427,201438,F7EB65229708BABC838B2F6907E461CE,31521,0,7,7,109.51458,18.22542,1555
26428,201439,F7EB65229708BABC838B2F6907E461CE,30661,9,14,5,109.37028,18.24361,1008
26429,201440,F7EB65229708BABC838B2F6907E461CE,60054,16,17,1,109.3016,18.31229,770
26430,201441,F7EB65229708BABC838B2F6907E461CE,31521,20,23,3,109.51458,18.22542,1555
26431,201448,2123231E14775D9A8DE8B95E56EEF6DC,31471,12,14,2,109.34583,18.29563,917
26432,201496,8752BC71725B50257436D50C6598F252,30854,13,15,2,109.56889,18.27076,1763
26433,201497,8752BC71725B50257436D50C6598F252,31071,19,23,4,109.58257,18.28458,1815
26434,201501,92E14A6094471B9C1A50CE8585136EC6,60087,15,17,2,109.50688,18.22299,1505
26435,201502,92E14A6094471B9C1A50CE8585136EC6,30731,19,23,4,109.50944,18.22306,1555
26436,201518,D2FA8B3378302724EAD475376DD7D7E4,30661,13,15,2,109.37028,18.24361,1008
26437,201519,D2FA8B3378302724EAD475376DD7D7E4,31303,19,23,4,109.15826,18.29549,217
26438,201556,4538154FE025AC6453F6CD695BA5F0AF,31261,14,15,1,109.51174,18.2466,1559
26439,201557,4538154FE025AC6453F6CD695BA5F0AF,30731,17,19,2,109.50944,18.22306,1555
26440,201558,4538154FE025AC6453F6CD695BA5F0AF,31261,19,23,4,109.51174,18.2466,1559
26441,201568,DC9973204E62AA99FA79F0696CF6C0F6,31945,0,7,7,109.58021,18.29403,1817
26442,201569,DC9973204E62AA99FA79F0696CF6C0F6,30854,8,14,6,109.56889,18.27076,1763
26443,201570,DC9973204E62AA99FA79F0696CF6C0F6,30361,17,18,1,109.50347,18.24,1508
26444,201571,DC9973204E62AA99FA79F0696CF6C0F6,31411,19,20,1,109.5016,18.23576,1507
26445,201572,DC9973204E62AA99FA79F0696CF6C0F6,30854,21,23,2,109.56889,18.27076,1763
26446,201573,C983E73D646629A775690ECA8920EB29,30101,0,5,5,109.57299,18.33333,1773
26447,201574,C983E73D646629A775690ECA8920EB29,31631,6,7,1,109.59542,18.36826,1879
26448,201575,C983E73D646629A775690ECA8920EB29,30101,8,11,3,109.57299,18.33333,1773
26449,201576,C983E73D646629A775690ECA8920EB29,31631,16,17,1,109.59542,18.36826,1879
26450,201577,C983E73D646629A775690ECA8920EB29,30101,19,20,1,109.57299,18.33333,1773
26451,201578,C983E73D646629A775690ECA8920EB29,31631,21,23,2,109.59542,18.36826,1879
26452,201593,86EDF7CD143DD19E47E6DF8DE8411FF2,31951,1,21,20,109.52174,18.30299,1568
26453,201594,86EDF7CD143DD19E47E6DF8DE8411FF2,30561,21,22,1,109.52778,18.31938,1621
26454,201639,8FE97C1052D63DE830211C405D8F5442,39371,5,7,2,109.56627,18.2646,1762
26455,201640,8FE97C1052D63DE830211C405D8F5442,60631,7,12,5,109.57778,18.27583,1814
26463,201700,87C5E55D14972DAB6DC404BB48A37840,31471,11,12,1,109.34583,18.29563,917
26464,201701,87C5E55D14972DAB6DC404BB48A37840,60054,12,14,2,109.3016,18.31229,770
26465,201711,664AAF94F095BCD14233E5648F0324F0,60491,7,8,1,109.43354,18.30847,1269
26469,201732,AE8680286B45D9D0276D665A2B272582,38251,0,7,7,109.49618,18.25493,1510
26470,201733,AE8680286B45D9D0276D665A2B272582,31471,12,14,2,109.34583,18.29563,917
26471,201734,AE8680286B45D9D0276D665A2B272582,60381,16,18,2,109.5241,18.22458,1605
26472,201735,AE8680286B45D9D0276D665A2B272582,38251,22,23,1,109.49618,18.25493,1510
26473,201736,9AA959ED87D1ECC3053DED17290EFCBD,30854,1,2,1,109.56889,18.27076,1763
26474,201737,9AA959ED87D1ECC3053DED17290EFCBD,31561,4,6,2,109.56792,18.28479,1765
26475,201738,9AA959ED87D1ECC3053DED17290EFCBD,39181,7,10,3,109.55153,18.28035,1715
26476,201739,9AA959ED87D1ECC3053DED17290EFCBD,39183,13,15,2,109.55542,18.28208,1715
26477,201740,9AA959ED87D1ECC3053DED17290EFCBD,31561,17,18,1,109.56792,18.28479,1765
26478,201750,BCDE01A4E2BDFB1588B63A66AC193559,31421,0,8,8,109.55382,18.22347,1705
26479,201751,BCDE01A4E2BDFB1588B63A66AC193559,31061,12,13,1,109.53333,18.23257,1607
26480,201752,BCDE01A4E2BDFB1588B63A66AC193559,31561,14,16,2,109.56792,18.28479,1765
26481,201762,058BB35E9365186FDBD53CD2B8640A1D,30731,1,6,5,109.50944,18.22306,1555
26482,201763,058BB35E9365186FDBD53CD2B8640A1D,31521,7,8,1,109.51458,18.22542,1555
26483,201766,7890099D98AA300C5BF12527E7372DB0,60631,0,6,6,109.57778,18.27583,1814
26484,201767,7890099D98AA300C5BF12527E7372DB0,30854,9,11,2,109.56889,18.27076,1763
26485,201768,7890099D98AA300C5BF12527E7372DB0,31071,12,14,2,109.58257,18.28458,1815
26486,201769,7890099D98AA300C5BF12527E7372DB0,30854,16,17,1,109.56889,18.27076,1763
26487,201770,7890099D98AA300C5BF12527E7372DB0,31071,18,20,2,109.58257,18.28458,1815
26488,201771,7890099D98AA300C5BF12527E7372DB0,60631,22,23,1,109.57778,18.27583,1814
26489,201806,D96E01B8E0F0DE9C160C9FEAFDCFDB6D,31071,1,7,6,109.58257,18.28458,1815
26490,201807,D96E01B8E0F0DE9C160C9FEAFDCFDB6D,30854,8,18,10,109.56889,18.27076,1763
26491,201825,3C1A2536A78CF30193CED5E3EEACBE7E,30851,0,6,6,109.5616,18.27396,1713
26492,201826,3C1A2536A78CF30193CED5E3EEACBE7E,31561,6,8,2,109.56792,18.28479,1765
26493,201827,3C1A2536A78CF30193CED5E3EEACBE7E,30851,12,13,1,109.5616,18.27396,1713
26494,201828,3C1A2536A78CF30193CED5E3EEACBE7E,30854,15,17,2,109.56889,18.27076,1763
26495,201829,3C1A2536A78CF30193CED5E3EEACBE7E,30851,19,22,3,109.5616,18.27396,1713
26496,201866,2261FA59C58CA1DB4ED476451BEA0AD4,60501,0,18,18,109.48701,18.29021,1466
26497,201867,2261FA59C58CA1DB4ED476451BEA0AD4,30321,19,20,1,109.49563,18.29611,1467
26504,201976,00262F856825A94933CC2BDE5C3D9737,60581,0,1,1,109.59785,18.29931,1868
26505,201977,00262F856825A94933CC2BDE5C3D9737,31421,2,3,1,109.55382,18.22347,1705
26506,201978,00262F856825A94933CC2BDE5C3D9737,60581,4,21,17,109.59785,18.29931,1868
26507,202032,AF32B82432A4AC8FBC8A961D5DCDD7BD,38331,1,17,16,109.62465,18.22736,1956
26508,202033,AF32B82432A4AC8FBC8A961D5DCDD7BD,31571,20,22,2,109.61563,18.23326,1957
26509,202034,9E8746086915F9D4A063A74CF0B5B7AB,30854,0,1,1,109.56889,18.27076,1763
26510,202035,9E8746086915F9D4A063A74CF0B5B7AB,31561,1,21,20,109.56792,18.28479,1765
26511,202053,95426015650BC53898B8F1908C1F7E01,38754,13,15,2,109.74667,18.37382,2430
26515,202090,3FAB7316FD33FC7E819B12F3936E0C0E,31461,10,12,2,109.5091,18.25389,1510
26516,202091,3FAB7316FD33FC7E819B12F3936E0C0E,31781,14,15,1,109.19847,18.2975,367
26523,202198,F0ED2F3817EE271ED7B659D7D4093D86,30071,0,11,11,109.52819,18.30472,1619
26527,202220,968E09217B26E1E21B124536BDB6DBAA,31931,1,11,10,109.54771,18.29403,1667
26528,202221,968E09217B26E1E21B124536BDB6DBAA,30921,11,12,1,109.53903,18.29451,1667
26529,202276,6C92EA68FFD99D11BB9BA660C1C2B71D,38261,0,10,10,109.50361,18.28153,1515
26530,202277,6C92EA68FFD99D11BB9BA660C1C2B71D,38754,12,13,1,109.74667,18.37382,2430
26531,202278,6C92EA68FFD99D11BB9BA660C1C2B71D,39191,17,18,1,109.51493,18.23472,1557
26532,202279,6C92EA68FFD99D11BB9BA660C1C2B71D,38171,19,20,1,109.50799,18.28139,1515
26533,202280,6C92EA68FFD99D11BB9BA660C1C2B71D,38251,21,22,1,109.49618,18.25493,1510
26534,202312,D8EBCB05DE029B0DEDBF9FBDF3DA3C2D,38251,10,12,2,109.49618,18.25493,1510
26535,202313,D8EBCB05DE029B0DEDBF9FBDF3DA3C2D,60084,12,13,1,109.4984,18.2334,1507
26536,202314,D8EBCB05DE029B0DEDBF9FBDF3DA3C2D,30211,14,16,2,109.49882,18.23931,1508
26537,202327,ED6C06A9523B96BECA45DFE9D14D9117,31031,0,1,1,109.49979,18.25382,1510
26538,202328,ED6C06A9523B96BECA45DFE9D14D9117,31701,2,9,7,109.44132,18.28833,1266
26539,202329,ED6C06A9523B96BECA45DFE9D14D9117,30661,13,14,1,109.37028,18.24361,1008
26540,202330,ED6C06A9523B96BECA45DFE9D14D9117,38754,15,17,2,109.74667,18.37382,2430
26541,202331,ED6C06A9523B96BECA45DFE9D14D9117,38291,22,23,1,109.51618,18.24313,1558
26542,202334,270A449E9E9FA455CDA0F1612D07A3C0,30341,0,4,4,109.3625,18.29167,966
26543,202335,270A449E9E9FA455CDA0F1612D07A3C0,31691,7,8,1,109.36604,18.3075,1019
26544,202336,270A449E9E9FA455CDA0F1612D07A3C0,30341,8,9,1,109.3625,18.29167,966
26545,202337,270A449E9E9FA455CDA0F1612D07A3C0,30421,11,13,2,109.50021,18.25861,1511
26546,202338,270A449E9E9FA455CDA0F1612D07A3C0,30421,16,17,1,109.50021,18.25861,1511
26547,202339,270A449E9E9FA455CDA0F1612D07A3C0,60552,18,22,4,109.41729,18.30014,1218
26548,202361,9AD8D18F2EF225E5E5CB5327E1407C0D,38951,0,7,7,109.48097,18.28868,1416
26549,202362,9AD8D18F2EF225E5E5CB5327E1407C0D,33051,9,10,1,109.6475,18.46618,2096
26550,202363,9AD8D18F2EF225E5E5CB5327E1407C0D,30661,14,16,2,109.37028,18.24361,1008
26551,202364,9AD8D18F2EF225E5E5CB5327E1407C0D,38951,20,23,3,109.48097,18.28868,1416
26552,202367,31A35D1F4FE97CCC4436EF0B61B8BAAF,60411,0,3,3,109.32514,18.30854,869
26553,202368,31A35D1F4FE97CCC4436EF0B61B8BAAF,30511,4,8,4,109.51069,18.24208,1558
26554,202369,31A35D1F4FE97CCC4436EF0B61B8BAAF,31121,11,14,3,109.16292,18.37063,230
26555,202370,31A35D1F4FE97CCC4436EF0B61B8BAAF,30511,15,19,4,109.51069,18.24208,1558
26556,202371,31A35D1F4FE97CCC4436EF0B61B8BAAF,31811,20,21,1,109.54201,18.31806,1671
26557,202372,31A35D1F4FE97CCC4436EF0B61B8BAAF,31841,22,23,1,109.73201,18.33382,2373
26558,202392,2AE38FAF341950B0B91404FFCE5A0F3E,31931,5,6,1,109.54771,18.29403,1667
26559,202393,2AE38FAF341950B0B91404FFCE5A0F3E,30921,7,14,7,109.53903,18.29451,1667
26560,202397,D6A5EA158BCFCEC27478CC8D9C57322E,30854,12,14,2,109.56889,18.27076,1763
26561,202398,D6A5EA158BCFCEC27478CC8D9C57322E,30361,15,16,1,109.50347,18.24,1508
26562,202399,D6A5EA158BCFCEC27478CC8D9C57322E,31671,20,21,1,109.38965,18.29813,1068
26563,202407,39F25FE146A03325C93C111F2A943B6C,31945,0,7,7,109.58021,18.29403,1817
26564,202408,39F25FE146A03325C93C111F2A943B6C,30854,8,17,9,109.56889,18.27076,1763
26565,202501,7A8D78B1079C175566DB4AED32858CF3,31021,17,19,2,109.49021,18.27,1463
26566,202505,1E36640BE395A4EE8CCB2697222419A5,39191,1,8,7,109.51493,18.23472,1557
26567,202506,1E36640BE395A4EE8CCB2697222419A5,30854,10,18,8,109.56889,18.27076,1763
26568,202507,1E36640BE395A4EE8CCB2697222419A5,30191,21,22,1,109.50361,18.22701,1506
26572,202532,3DCAC27BD35B2FC8704C8768B6D049BB,60201,12,15,3,109.5041,18.2509,1510
26573,202612,8CD15CF6B5FB4821940FF9AFE6D6CB84,30071,0,5,5,109.52819,18.30472,1619
26574,202613,8CD15CF6B5FB4821940FF9AFE6D6CB84,31931,9,11,2,109.54771,18.29403,1667
26575,202620,7E28863E3E4D0101A7DD8A6B64D39C6D,60463,15,17,2,109.52507,18.22438,1605
26576,202621,7E28863E3E4D0101A7DD8A6B64D39C6D,31041,19,20,1,109.50278,18.23701,1507
26580,202656,10E6DCB22C04D9E1B01193CDA87B3193,39183,12,13,1,109.55542,18.28208,1715
26581,202657,10E6DCB22C04D9E1B01193CDA87B3193,30721,15,23,8,109.51597,18.28257,1565
26582,202730,82F21893ACB53C60BC226BBEC5F58D74,38185,0,7,7,109.51333,18.27347,1563
26583,202731,82F21893ACB53C60BC226BBEC5F58D74,38157,7,9,2,109.51483,18.26958,1563
26584,202732,82F21893ACB53C60BC226BBEC5F58D74,38754,12,15,3,109.74667,18.37382,2430
26585,202733,82F21893ACB53C60BC226BBEC5F58D74,30421,16,18,2,109.50021,18.25861,1511
26586,202734,82F21893ACB53C60BC226BBEC5F58D74,38157,18,23,5,109.51483,18.26958,1563
26587,202796,301E657A2E52A15D5305B0C9B3D5B8BC,30921,0,8,8,109.53903,18.29451,1667
26588,202797,301E657A2E52A15D5305B0C9B3D5B8BC,31931,12,14,2,109.54771,18.29403,1667
26589,202813,03CEC0FDDD5484124514C6D24A63D4DD,31561,1,8,7,109.56792,18.28479,1765
26590,202814,03CEC0FDDD5484124514C6D24A63D4DD,39183,10,12,2,109.55542,18.28208,1715
26591,202817,5C5C16E98C1163D699B17F68D2A1C502,30941,0,8,8,109.5559,18.33938,1724
26592,202818,5C5C16E98C1163D699B17F68D2A1C502,30051,11,13,2,109.48917,18.21215,1453
26593,202819,5C5C16E98C1163D699B17F68D2A1C502,60291,14,15,1,109.50826,18.24639,1509
26594,202820,5C5C16E98C1163D699B17F68D2A1C502,30711,18,23,5,109.50271,18.25347,1510
26598,202845,102A3C1C3179D6FF6A52B59C3B4087A1,31391,0,8,8,109.50382,18.24285,1508
26599,202846,102A3C1C3179D6FF6A52B59C3B4087A1,31181,9,23,14,109.50382,18.24813,1509
26600,202896,6A4AE6B8374B8D13D516D5D8F4C03ACD,31261,0,7,7,109.51174,18.2466,1559
26601,202912,26AEADD88C2136C19E538838866C5D29,60501,0,21,21,109.48701,18.29021,1466
26602,202913,26AEADD88C2136C19E538838866C5D29,38951,22,23,1,109.48097,18.28868,1416
26603,202917,FEAE9163841AC1AA2EA5C6B7C414FE65,39091,0,7,7,109.50097,18.25222,1510
26604,202918,FEAE9163841AC1AA2EA5C6B7C414FE65,31171,7,9,2,109.50938,18.24917,1559
26605,202919,FEAE9163841AC1AA2EA5C6B7C414FE65,31171,9,11,2,109.50938,18.24917,1559
26606,202920,FEAE9163841AC1AA2EA5C6B7C414FE65,31521,14,15,1,109.51458,18.22542,1555
26607,202921,FEAE9163841AC1AA2EA5C6B7C414FE65,31031,16,17,1,109.49979,18.25382,1510
26608,202922,FEAE9163841AC1AA2EA5C6B7C414FE65,60571,17,19,2,109.50722,18.25056,1510
26609,202923,FEAE9163841AC1AA2EA5C6B7C414FE65,31031,20,21,1,109.49979,18.25382,1510
26610,202953,14F1CC63CDA098F9694EAC8584B9C7A5,30854,8,10,2,109.56889,18.27076,1763
26611,202954,14F1CC63CDA098F9694EAC8584B9C7A5,31561,13,16,3,109.56792,18.28479,1765
26612,202985,A6714C443816C19D990E7A07DCADADAD,60371,0,10,10,109.53063,18.30056,1618
26613,202986,A6714C443816C19D990E7A07DCADADAD,30911,12,13,1,109.50493,18.26181,1511
26614,202987,A6714C443816C19D990E7A07DCADADAD,31781,15,18,3,109.19847,18.2975,367
26615,202988,A6714C443816C19D990E7A07DCADADAD,38154,19,21,2,109.5266,18.28278,1615
26616,203063,8F38E05146537B1A75A31B873BB68479,30891,0,4,4,109.59431,18.28389,1865
26617,203064,8F38E05146537B1A75A31B873BB68479,60631,4,7,3,109.57778,18.27583,1814
26618,203065,8F38E05146537B1A75A31B873BB68479,30591,11,12,1,109.63021,18.3334,2023
26619,203066,8F38E05146537B1A75A31B873BB68479,30891,13,15,2,109.59431,18.28389,1865
26620,203067,8F38E05146537B1A75A31B873BB68479,60631,20,23,3,109.57778,18.27583,1814
26621,203181,4F1F2C63B1D8098AD9ABA50013979078,31461,3,18,15,109.5091,18.25389,1510
26622,203182,4F1F2C63B1D8098AD9ABA50013979078,30151,19,22,3,109.50986,18.25083,1560
26623,203192,EE14FB3C39B357FEEB92988D3DA74974,60331,0,1,1,109.505,18.26507,1512
26624,203193,EE14FB3C39B357FEEB92988D3DA74974,38826,2,4,2,109.50326,18.25514,1510
26625,203194,EE14FB3C39B357FEEB92988D3DA74974,60331,4,7,3,109.505,18.26507,1512
26626,203195,EE14FB3C39B357FEEB92988D3DA74974,30711,7,9,2,109.50271,18.25347,1510
26627,203196,EE14FB3C39B357FEEB92988D3DA74974,60331,10,11,1,109.505,18.26507,1512
26628,203197,EE14FB3C39B357FEEB92988D3DA74974,60291,12,13,1,109.50826,18.24639,1509
26629,203198,EE14FB3C39B357FEEB92988D3DA74974,38017,14,23,9,109.49729,18.21424,1504
26630,203204,30165500CA5F6A8CB10812947A58AC25,60131,17,23,6,109.49819,18.24778,1509
26631,203265,71D35ED12FD809FD321ED1C8285B5582,38951,19,20,1,109.48097,18.28868,1416
26632,203266,71D35ED12FD809FD321ED1C8285B5582,38951,20,23,3,109.48097,18.28868,1416
26633,203326,E6F79A5F6F7C034FE4F98780B21D590B,30281,16,23,7,109.50597,18.27583,1514
26634,203343,D8AD821A5FC20BAF011DEF41BC24FC46,30661,0,2,2,109.37028,18.24361,1008
26635,203344,D8AD821A5FC20BAF011DEF41BC24FC46,60411,2,5,3,109.32514,18.30854,869
26636,203345,D8AD821A5FC20BAF011DEF41BC24FC46,31471,5,7,2,109.34583,18.29563,917
26637,203346,D8AD821A5FC20BAF011DEF41BC24FC46,60411,12,14,2,109.32514,18.30854,869
26638,203347,D8AD821A5FC20BAF011DEF41BC24FC46,31471,16,18,2,109.34583,18.29563,917
26639,203348,D8AD821A5FC20BAF011DEF41BC24FC46,60411,21,23,2,109.32514,18.30854,869
26640,203379,23019CE071DC0B0CEC6E78ADA422CE57,31861,0,5,5,109.49042,18.27549,1464
26641,203380,23019CE071DC0B0CEC6E78ADA422CE57,60261,6,7,1,109.44326,18.3075,1319
26642,203381,23019CE071DC0B0CEC6E78ADA422CE57,39151,11,12,1,109.49875,18.25097,1510
26643,203382,23019CE071DC0B0CEC6E78ADA422CE57,31861,13,16,3,109.49042,18.27549,1464
26644,203383,23019CE071DC0B0CEC6E78ADA422CE57,60291,17,20,3,109.50826,18.24639,1509
26645,203384,23019CE071DC0B0CEC6E78ADA422CE57,30151,22,23,1,109.50986,18.25083,1560
26646,203387,A51C0E173E848AB55C983CAEC8E3EC6F,31781,14,16,2,109.19847,18.2975,367
26647,203388,A51C0E173E848AB55C983CAEC8E3EC6F,30421,20,23,3,109.50021,18.25861,1511
26648,203404,C17A8098B013F904BD9DA05D90234A30,30581,13,18,5,109.62257,18.24951,1959
26649,203405,C17A8098B013F904BD9DA05D90234A30,30731,22,23,1,109.50944,18.22306,1555
26654,203430,591FE6773219F44C74B8131639493332,31571,8,10,2,109.61563,18.23326,1957
26655,203431,591FE6773219F44C74B8131639493332,60594,11,17,6,109.62694,18.22799,1956
26660,203436,DE91F768E6CCDB78867FF54F078574C9,30854,8,9,1,109.56889,18.27076,1763
26661,203437,DE91F768E6CCDB78867FF54F078574C9,60631,9,11,2,109.57778,18.27583,1814
26662,203438,DE91F768E6CCDB78867FF54F078574C9,30854,15,18,3,109.56889,18.27076,1763
26663,203445,44FFDAD9EC2A7281B5299E15C5B9AD3B,31471,13,14,1,109.34583,18.29563,917
26664,203446,44FFDAD9EC2A7281B5299E15C5B9AD3B,60381,17,18,1,109.5241,18.22458,1605
26665,203447,DE53B37CEE1651DC363C1A8BF5282EDE,31081,0,6,6,109.44639,18.30181,1318
26666,203448,DE53B37CEE1651DC363C1A8BF5282EDE,31781,8,9,1,109.19847,18.2975,367
26667,203449,DE53B37CEE1651DC363C1A8BF5282EDE,31471,12,14,2,109.34583,18.29563,917
26668,203463,C0CA4E58B15F58D7F48B8BEF10CEB35A,30851,1,8,7,109.5616,18.27396,1713
26669,203464,C0CA4E58B15F58D7F48B8BEF10CEB35A,60591,12,13,1,109.61118,18.21715,1904
26670,203474,A94AF470D3EAB89524069477242B4D22,31021,17,19,2,109.49021,18.27,1463
26671,203475,A94AF470D3EAB89524069477242B4D22,31701,20,23,3,109.44132,18.28833,1266
26672,203490,E7DB0F55EDE33BB4C08C98B80B7173BF,60371,0,7,7,109.53063,18.30056,1618
26673,203491,E7DB0F55EDE33BB4C08C98B80B7173BF,30921,7,9,2,109.53903,18.29451,1667
26674,203492,E7DB0F55EDE33BB4C08C98B80B7173BF,30421,11,12,1,109.50021,18.25861,1511
26675,203493,E7DB0F55EDE33BB4C08C98B80B7173BF,60371,13,16,3,109.53063,18.30056,1618
26676,203494,E7DB0F55EDE33BB4C08C98B80B7173BF,31864,17,20,3,109.49014,18.28333,1465
26677,203501,7BF65E5054DA81A230AB5423620158E1,60631,0,7,7,109.57778,18.27583,1814
26678,203502,7BF65E5054DA81A230AB5423620158E1,30854,8,19,11,109.56889,18.27076,1763
26679,203581,E6651E3C6D8FEA2077D9EFC6D097D06C,31864,18,20,2,109.49014,18.28333,1465
26680,203582,E6651E3C6D8FEA2077D9EFC6D097D06C,38251,21,23,2,109.49618,18.25493,1510
26681,203639,AAC7E9546787DDB508C41969C1E453E7,38157,18,19,1,109.51483,18.26958,1563
26682,203640,AAC7E9546787DDB508C41969C1E453E7,38881,20,21,1,109.51618,18.26431,1562
26683,203648,4053323049FA57896819CD5356E38746,31071,1,4,3,109.58257,18.28458,1815
26684,203649,4053323049FA57896819CD5356E38746,30854,5,23,18,109.56889,18.27076,1763
26692,203690,C6C3BC01E542B810EF853FEEB6C81198,31391,6,7,1,109.50382,18.24285,1508
26693,203691,C6C3BC01E542B810EF853FEEB6C81198,60361,8,9,1,109.51938,18.29681,1567
26694,203692,C6C3BC01E542B810EF853FEEB6C81198,60221,10,14,4,109.52569,18.29188,1616
26695,203693,C6C3BC01E542B810EF853FEEB6C81198,60274,15,17,2,109.514,18.2933,1567
26700,203750,895819ED5A8DD11C7D2D0F75F1A32EF3,30854,0,17,17,109.56889,18.27076,1763
26701,203751,895819ED5A8DD11C7D2D0F75F1A32EF3,30232,17,21,4,109.6191,18.31701,1971
26702,203752,895819ED5A8DD11C7D2D0F75F1A32EF3,30854,22,23,1,109.56889,18.27076,1763
26709,203799,5257BB62833F353E4A854C5B6B0C57D3,60614,12,14,2,109.48799,18.29521,1467
26710,203800,5257BB62833F353E4A854C5B6B0C57D3,60221,15,17,2,109.52569,18.29188,1616
26711,203815,F141782F156A0C79026F316BE530CBC2,31471,14,16,2,109.34583,18.29563,917
26712,203816,F141782F156A0C79026F316BE530CBC2,38951,18,23,5,109.48097,18.28868,1416
26713,203861,CFFDD1BF3134B9FDD71614F40E1DE0FD,31561,1,3,2,109.56792,18.28479,1765
26714,203862,CFFDD1BF3134B9FDD71614F40E1DE0FD,31071,4,21,17,109.58257,18.28458,1815
26715,203916,E9F21C024419BD4EFA39BBB9E3204A71,31864,0,10,10,109.49014,18.28333,1465
26716,203917,E9F21C024419BD4EFA39BBB9E3204A71,31701,11,14,3,109.44132,18.28833,1266
26717,203918,E9F21C024419BD4EFA39BBB9E3204A71,31781,14,17,3,109.19847,18.2975,367
26718,203919,E9F21C024419BD4EFA39BBB9E3204A71,31701,18,21,3,109.44132,18.28833,1266
26719,203932,FD8E83DD7FF39A687AC2462EEEA479A1,30051,11,16,5,109.48917,18.21215,1453
26720,203982,29B6F28DC818DD1AE018C5F359E62A49,39111,0,7,7,109.5191,18.22597,1555
26721,203983,29B6F28DC818DD1AE018C5F359E62A49,31521,9,11,2,109.51458,18.22542,1555
26722,203984,29B6F28DC818DD1AE018C5F359E62A49,31521,12,19,7,109.51458,18.22542,1555
26723,203985,29B6F28DC818DD1AE018C5F359E62A49,31521,19,20,1,109.51458,18.22542,1555
26724,203986,29B6F28DC818DD1AE018C5F359E62A49,60381,21,23,2,109.5241,18.22458,1605
26725,203997,5A6C2C4A9B4DF43C379FCADC2CCFC5BC,30201,0,7,7,109.4909,18.26465,1462
26726,203998,5A6C2C4A9B4DF43C379FCADC2CCFC5BC,38283,8,13,5,109.62229,18.22618,1956
26727,203999,5A6C2C4A9B4DF43C379FCADC2CCFC5BC,31571,13,15,2,109.61563,18.23326,1957
26728,204000,5A6C2C4A9B4DF43C379FCADC2CCFC5BC,30201,19,20,1,109.4909,18.26465,1462
26729,204001,5A6C2C4A9B4DF43C379FCADC2CCFC5BC,60161,21,23,2,109.49174,18.26181,1461
26734,204039,E8BAAF476E8FE57075BAB1A8D4FF1780,30232,0,3,3,109.6191,18.31701,1971
26735,204040,E8BAAF476E8FE57075BAB1A8D4FF1780,39371,4,19,15,109.56627,18.2646,1762
26736,204041,E8BAAF476E8FE57075BAB1A8D4FF1780,30232,22,23,1,109.6191,18.31701,1971
26737,204063,30CE72A519D49881F23B8123486E3A02,30661,2,3,1,109.37028,18.24361,1008
26738,204064,30CE72A519D49881F23B8123486E3A02,60054,4,6,2,109.3016,18.31229,770
26739,204065,30CE72A519D49881F23B8123486E3A02,30661,8,9,1,109.37028,18.24361,1008
26740,204066,30CE72A519D49881F23B8123486E3A02,31471,10,12,2,109.34583,18.29563,917
26741,204067,30CE72A519D49881F23B8123486E3A02,60411,12,16,4,109.32514,18.30854,869
26742,204100,64FF3E93355E6DCA29977E04D316EABA,31461,0,8,8,109.5091,18.25389,1510
26743,204101,64FF3E93355E6DCA29977E04D316EABA,31171,9,12,3,109.50938,18.24917,1559
26744,204102,64FF3E93355E6DCA29977E04D316EABA,60311,13,15,2,109.52097,18.24319,1558
26745,204103,64FF3E93355E6DCA29977E04D316EABA,60381,18,20,2,109.5241,18.22458,1605
26746,204104,64FF3E93355E6DCA29977E04D316EABA,30191,21,23,2,109.50361,18.22701,1506
26747,204110,C8BA90B71F14C638D3BB67D8000591A9,60381,21,22,1,109.5241,18.22458,1605
26748,204111,C8BA90B71F14C638D3BB67D8000591A9,31521,22,23,1,109.51458,18.22542,1555
26749,204116,9A1D1AA5EE2CD156CC396C667ED8C5B9,31071,0,4,4,109.58257,18.28458,1815
26750,204117,9A1D1AA5EE2CD156CC396C667ED8C5B9,30854,4,6,2,109.56889,18.27076,1763
26751,204118,9A1D1AA5EE2CD156CC396C667ED8C5B9,31071,8,9,1,109.58257,18.28458,1815
26752,204119,9A1D1AA5EE2CD156CC396C667ED8C5B9,30854,16,17,1,109.56889,18.27076,1763
26753,204120,9A1D1AA5EE2CD156CC396C667ED8C5B9,30191,20,22,2,109.50361,18.22701,1506
26754,204193,10BCCD747640470AAA03DB965CE24293,30291,0,7,7,109.50403,18.27028,1513
26755,204194,10BCCD747640470AAA03DB965CE24293,31261,9,10,1,109.51174,18.2466,1559
26756,204196,798BF3B08F72A16A6DEAAA235F1899BB,61011,2,10,8,109.60653,18.19076,1900
26757,204255,4CDEF469091C8CEDD8E49BC000B05A1D,60491,0,15,15,109.43354,18.30847,1269
26758,204256,4CDEF469091C8CEDD8E49BC000B05A1D,60381,19,20,1,109.5241,18.22458,1605
26759,204284,8FEFA204EA7EEB362556D906D163980A,31071,14,16,2,109.58257,18.28458,1815
26760,204285,8FEFA204EA7EEB362556D906D163980A,30854,19,20,1,109.56889,18.27076,1763
26761,204335,7E2EA58FE60AC1C253C1CC188337CCC8,60541,2,11,9,109.4084,18.29208,1167
26762,204336,7E2EA58FE60AC1C253C1CC188337CCC8,39041,16,18,2,109.40021,18.29278,1117
26763,204337,7E2EA58FE60AC1C253C1CC188337CCC8,60463,20,21,1,109.52507,18.22438,1605
26764,204371,A1F17EB69AE1223ABE34664A234EFB68,38111,13,16,3,109.52007,18.22403,1555
26765,204372,A1F17EB69AE1223ABE34664A234EFB68,38111,16,18,2,109.52007,18.22403,1555
26766,204373,A1F17EB69AE1223ABE34664A234EFB68,38111,21,23,2,109.52007,18.22403,1555
26767,204402,BC9FBD966A235C9E8690F2D93EAA6882,31521,13,14,1,109.51458,18.22542,1555
26768,204403,BC9FBD966A235C9E8690F2D93EAA6882,60381,15,16,1,109.5241,18.22458,1605
26769,204404,BC9FBD966A235C9E8690F2D93EAA6882,38111,21,23,2,109.52007,18.22403,1555
26776,204453,942FD8205298EEBE7ED108DC820DF6A5,31521,13,16,3,109.51458,18.22542,1555
26777,204454,942FD8205298EEBE7ED108DC820DF6A5,30361,17,19,2,109.50347,18.24,1508
26778,204455,942FD8205298EEBE7ED108DC820DF6A5,31521,20,23,3,109.51458,18.22542,1555
26782,204471,02C53C5746E38501957FE72E2C83CCA4,38251,11,16,5,109.49618,18.25493,1510
26783,204472,02C53C5746E38501957FE72E2C83CCA4,31251,17,19,2,109.18528,18.2975,317
26787,204515,664E81D16FEEE8383C260AACBBA56CD3,38541,0,15,15,109.73715,18.34875,2426
26788,204516,664E81D16FEEE8383C260AACBBA56CD3,60344,17,20,3,109.68847,18.31931,2221
26789,204522,6E797C1848A21F63AB5DC14D455CFF22,31431,0,8,8,109.44639,18.29042,1316
26790,204523,6E797C1848A21F63AB5DC14D455CFF22,30271,8,9,1,109.49132,18.23153,1456
26791,204524,6E797C1848A21F63AB5DC14D455CFF22,31781,11,13,2,109.19847,18.2975,367
26792,204525,6E797C1848A21F63AB5DC14D455CFF22,31431,18,23,5,109.44639,18.29042,1316
26793,204541,4D4289AE0DFBF4B5C79A47559DC2EBDD,60463,19,20,1,109.52507,18.22438,1605
26794,204542,4D4289AE0DFBF4B5C79A47559DC2EBDD,30854,22,23,1,109.56889,18.27076,1763
26795,204551,68DBE0B52FD0AB95F1DD47068FD7847F,30181,20,21,1,109.51597,18.23313,1557
26796,204552,68DBE0B52FD0AB95F1DD47068FD7847F,60311,21,23,2,109.52097,18.24319,1558
26805,204616,F0F4014EDBA84B976E9E99C8872ACAC4,31561,7,13,6,109.56792,18.28479,1765
26806,204617,F0F4014EDBA84B976E9E99C8872ACAC4,30854,13,15,2,109.56889,18.27076,1763
26807,204618,F0F4014EDBA84B976E9E99C8872ACAC4,31561,15,18,3,109.56792,18.28479,1765
26808,204619,F0F4014EDBA84B976E9E99C8872ACAC4,60331,19,23,4,109.505,18.26507,1512
26813,204667,DECB7B3FC95BFA8620EFD8D9DE328252,30854,2,4,2,109.56889,18.27076,1763
26814,204668,DECB7B3FC95BFA8620EFD8D9DE328252,30791,7,9,2,109.72333,18.40889,2386
26815,204669,DECB7B3FC95BFA8620EFD8D9DE328252,60661,12,13,1,109.548,18.2377,1657
26816,204670,DECB7B3FC95BFA8620EFD8D9DE328252,30854,14,17,3,109.56889,18.27076,1763
26817,204697,172CB232BBE684655CFBDFD055BB1CB5,60491,0,7,7,109.43354,18.30847,1269
26818,204698,172CB232BBE684655CFBDFD055BB1CB5,31031,8,9,1,109.49979,18.25382,1510
26819,204699,172CB232BBE684655CFBDFD055BB1CB5,60491,12,13,1,109.43354,18.30847,1269
26820,204700,172CB232BBE684655CFBDFD055BB1CB5,30831,14,16,2,109.69813,18.32076,2271
26821,204701,172CB232BBE684655CFBDFD055BB1CB5,60491,20,23,3,109.43354,18.30847,1269
26822,204707,C7B596C3998F49DC6B86FB54AB7111B3,31071,0,6,6,109.58257,18.28458,1815
26823,204708,C7B596C3998F49DC6B86FB54AB7111B3,30706,6,8,2,109.58833,18.31125,1820
26824,204709,C7B596C3998F49DC6B86FB54AB7111B3,31071,11,13,2,109.58257,18.28458,1815
26825,204710,C7B596C3998F49DC6B86FB54AB7111B3,30706,14,17,3,109.58833,18.31125,1820
26826,204711,C7B596C3998F49DC6B86FB54AB7111B3,31071,19,23,4,109.58257,18.28458,1815
26827,204712,33048F4905708D565A25CD4E82BC6E99,30711,0,9,9,109.50271,18.25347,1510
26828,204713,33048F4905708D565A25CD4E82BC6E99,60381,12,13,1,109.5241,18.22458,1605
26829,204714,33048F4905708D565A25CD4E82BC6E99,30711,13,16,3,109.50271,18.25347,1510
26830,204715,33048F4905708D565A25CD4E82BC6E99,30711,17,18,1,109.50271,18.25347,1510
26831,204716,33048F4905708D565A25CD4E82BC6E99,30421,20,22,2,109.50021,18.25861,1511
26836,204772,019CCF25DBCE9B21B5D2698F82FCE788,30854,7,8,1,109.56889,18.27076,1763
26837,204773,019CCF25DBCE9B21B5D2698F82FCE788,30234,12,13,1,109.60681,18.29979,1918
26838,204774,019CCF25DBCE9B21B5D2698F82FCE788,60281,18,19,1,109.51743,18.25924,1561
26839,204775,019CCF25DBCE9B21B5D2698F82FCE788,30854,22,23,1,109.56889,18.27076,1763
26840,204779,5D5B29A994BBA3635D38463A75BE58F6,30171,14,18,4,109.48458,18.27139,1463
26841,204780,5D5B29A994BBA3635D38463A75BE58F6,38826,19,20,1,109.50326,18.25514,1510
26842,204788,14BFE46EEAB2E234698393270A62605D,31471,0,5,5,109.34583,18.29563,917
26843,204789,14BFE46EEAB2E234698393270A62605D,30661,6,10,4,109.37028,18.24361,1008
26844,204790,14BFE46EEAB2E234698393270A62605D,60411,11,12,1,109.32514,18.30854,869
26845,204791,14BFE46EEAB2E234698393270A62605D,30661,14,20,6,109.37028,18.24361,1008
26849,204880,F3A1E5EFCE6AF399DB0F684A07A854DA,31071,0,13,13,109.58257,18.28458,1815
26850,204881,F3A1E5EFCE6AF399DB0F684A07A854DA,39091,16,19,3,109.50097,18.25222,1510
26851,204882,F3A1E5EFCE6AF399DB0F684A07A854DA,31071,20,21,1,109.58257,18.28458,1815
26852,204903,7C68E1F4B8B2F3CBBD5427BF66BF9C2E,30581,11,12,1,109.62257,18.24951,1959
26853,204904,7C68E1F4B8B2F3CBBD5427BF66BF9C2E,60591,15,16,1,109.61118,18.21715,1904
26854,204935,15195C578D4A8081B069C4B518039EFC,60161,2,4,2,109.49174,18.26181,1461
26855,204936,15195C578D4A8081B069C4B518039EFC,60501,8,11,3,109.48701,18.29021,1466
26856,204951,212EA0454AC4BCC194B0282F93607BB4,30741,7,8,1,109.49833,18.28681,1516
26857,204952,212EA0454AC4BCC194B0282F93607BB4,31471,11,12,1,109.34583,18.29563,917
26858,204953,212EA0454AC4BCC194B0282F93607BB4,30581,14,15,1,109.62257,18.24951,1959
26859,204976,7F6E66BC10419161F6457A6D79258EDB,60401,8,9,1,109.47444,18.27583,1414
26860,204977,7F6E66BC10419161F6457A6D79258EDB,38251,12,14,2,109.49618,18.25493,1510
26861,204978,7F6E66BC10419161F6457A6D79258EDB,30531,14,16,2,109.53271,18.21472,1604
26862,204982,95E4224EFEFA1EA72F67A01D68EC939D,38541,0,9,9,109.73715,18.34875,2426
26863,204983,95E4224EFEFA1EA72F67A01D68EC939D,38751,13,15,2,109.74903,18.37639,2481
26864,204984,95E4224EFEFA1EA72F67A01D68EC939D,38541,16,18,2,109.73715,18.34875,2426
26865,204985,95E4224EFEFA1EA72F67A01D68EC939D,60131,20,22,2,109.49819,18.24778,1509
26866,204986,AAD6CC23C5CDBF026C42805D3EA95680,31231,0,5,5,109.42597,18.29292,1217
26867,204987,AAD6CC23C5CDBF026C42805D3EA95680,30151,9,12,3,109.50986,18.25083,1560
26868,204988,AAD6CC23C5CDBF026C42805D3EA95680,60552,14,22,8,109.41729,18.30014,1218
26873,204996,ADF0A7CED2B8DFD757D8FCA8B507C37E,31321,10,12,2,109.63799,18.23201,2007
26874,204997,ADF0A7CED2B8DFD757D8FCA8B507C37E,38271,12,13,1,109.62632,18.23049,1956
26875,204998,ADF0A7CED2B8DFD757D8FCA8B507C37E,38283,15,17,2,109.62229,18.22618,1956
26876,204999,ADF0A7CED2B8DFD757D8FCA8B507C37E,39371,21,22,1,109.56627,18.2646,1762
26877,205009,080247CC19405F981D4BEFE1A1E9D339,31931,0,17,17,109.54771,18.29403,1667
26878,205010,080247CC19405F981D4BEFE1A1E9D339,39181,22,23,1,109.55153,18.28035,1715
26879,205026,1B64F4DC850DA18B432360F1D2319D7A,31061,0,7,7,109.53333,18.23257,1607
26880,205027,1B64F4DC850DA18B432360F1D2319D7A,60381,8,9,1,109.5241,18.22458,1605
26881,205028,1B64F4DC850DA18B432360F1D2319D7A,31781,11,13,2,109.19847,18.2975,367
26882,205029,1B64F4DC850DA18B432360F1D2319D7A,60081,17,18,1,109.51097,18.22639,1556
26883,205030,1B64F4DC850DA18B432360F1D2319D7A,31061,21,23,2,109.53333,18.23257,1607
26884,205053,E008ACF509F77C075F3CE6807181F555,30661,13,15,2,109.37028,18.24361,1008
26885,205054,E008ACF509F77C075F3CE6807181F555,30201,20,21,1,109.4909,18.26465,1462
26886,205067,F9F80EDABF5B8107FB24FA24BEE7566E,60201,3,5,2,109.5041,18.2509,1510
26887,205068,F9F80EDABF5B8107FB24FA24BEE7566E,38251,7,8,1,109.49618,18.25493,1510
26888,205069,F9F80EDABF5B8107FB24FA24BEE7566E,31781,10,13,3,109.19847,18.2975,367
26889,205108,E6EF54F1CF70515EF78AA8E68729F281,60614,14,15,1,109.48799,18.29521,1467
26890,205113,F568EAB7DFDD5D41E19A6F375B979656,60361,17,20,3,109.51938,18.29681,1567
26891,205114,F568EAB7DFDD5D41E19A6F375B979656,31861,22,23,1,109.49042,18.27549,1464
26892,205117,B023927CBEC0A8053CBDF64A5B76E367,38017,18,19,1,109.49729,18.21424,1504
26893,205118,B023927CBEC0A8053CBDF64A5B76E367,30361,19,21,2,109.50347,18.24,1508
26903,205204,104EE6D0AC628B9E88D507A87EA8C333,30201,22,23,1,109.4909,18.26465,1462
26904,205220,A9D6360D2777AEED781C57F7264711FD,38951,0,6,6,109.48097,18.28868,1416
26905,205222,A9D6360D2777AEED781C57F7264711FD,60054,12,13,1,109.3016,18.31229,770
26910,205315,546019449B49A5FCBBE36F9F3DB19C8A,31231,0,5,5,109.42597,18.29292,1217
26911,205316,546019449B49A5FCBBE36F9F3DB19C8A,31781,8,12,4,109.19847,18.2975,367
26912,205317,546019449B49A5FCBBE36F9F3DB19C8A,31471,14,15,1,109.34583,18.29563,917
26913,205318,546019449B49A5FCBBE36F9F3DB19C8A,31231,20,21,1,109.42597,18.29292,1217
26914,205396,7A214C2AB4CE0E87DF8DB230B9F95561,30101,0,6,6,109.57299,18.33333,1773
26915,205397,7A214C2AB4CE0E87DF8DB230B9F95561,31631,8,9,1,109.59542,18.36826,1879
26916,205398,7A214C2AB4CE0E87DF8DB230B9F95561,30101,11,14,3,109.57299,18.33333,1773
26917,205399,7A214C2AB4CE0E87DF8DB230B9F95561,31631,18,19,1,109.59542,18.36826,1879
26918,205400,7A214C2AB4CE0E87DF8DB230B9F95561,30101,21,23,2,109.57299,18.33333,1773
26919,205423,A9F97D2464709590426A157138F3C687,31931,0,20,20,109.54771,18.29403,1667
26920,205424,A9F97D2464709590426A157138F3C687,31071,21,22,1,109.58257,18.28458,1815
26921,205475,C17F2EF1DEA79C8C951E3013EE071B2C,60351,19,20,1,109.58403,18.28958,1816
26922,205476,C17F2EF1DEA79C8C951E3013EE071B2C,60354,20,21,1,109.58701,18.28521,1815
26923,205479,3D8ADE80304FD3207128013D43F1118A,60421,1,9,8,109.46333,18.31743,1371
26924,205480,3D8ADE80304FD3207128013D43F1118A,31171,14,15,1,109.50938,18.24917,1559
26925,205481,3D8ADE80304FD3207128013D43F1118A,60274,15,17,2,109.514,18.2933,1567
26926,205482,3D8ADE80304FD3207128013D43F1118A,30721,18,19,1,109.51597,18.28257,1565
26927,205494,7C05FB990908C67257EE8EEE421F2B91,30361,17,18,1,109.50347,18.24,1508
26928,205495,7C05FB990908C67257EE8EEE421F2B91,38094,21,23,2,109.45403,18.28778,1316
26935,205555,33D03C41649B47EDC5176C93FF6F1D8D,60411,1,8,7,109.32514,18.30854,869
26936,205556,33D03C41649B47EDC5176C93FF6F1D8D,30661,11,15,4,109.37028,18.24361,1008
26937,205557,33D03C41649B47EDC5176C93FF6F1D8D,60411,17,18,1,109.32514,18.30854,869
26938,205558,33D03C41649B47EDC5176C93FF6F1D8D,31251,22,23,1,109.18528,18.2975,317
26939,205565,A950B25B10B5260D4693DCD3A4C6281C,31931,7,15,8,109.54771,18.29403,1667
26940,205566,A950B25B10B5260D4693DCD3A4C6281C,39181,16,17,1,109.55153,18.28035,1715
26941,205567,A950B25B10B5260D4693DCD3A4C6281C,31931,19,23,4,109.54771,18.29403,1667
26942,205600,74CF56553C56FC34941FD45214B7C747,31071,0,7,7,109.58257,18.28458,1815
26943,205601,74CF56553C56FC34941FD45214B7C747,30854,10,12,2,109.56889,18.27076,1763
26947,205610,06FF0F05B2BE9154F50882BB32DB7B12,38361,5,7,2,109.43667,18.29201,1267
26948,205611,06FF0F05B2BE9154F50882BB32DB7B12,31781,10,12,2,109.19847,18.2975,367
26949,205612,06FF0F05B2BE9154F50882BB32DB7B12,31471,13,15,2,109.34583,18.29563,917
26950,205688,335B5CB406D45A33C3125AB87085288E,30854,1,7,6,109.56889,18.27076,1763
26951,205689,335B5CB406D45A33C3125AB87085288E,31071,7,21,14,109.58257,18.28458,1815
26952,205694,D5F7EFA0DFDB55DFCF47173578729EA6,30854,0,12,12,109.56889,18.27076,1763
26953,205695,D5F7EFA0DFDB55DFCF47173578729EA6,30731,14,16,2,109.50944,18.22306,1555
26954,205742,EB291EA7E3235FF23960DA865075F183,38911,0,7,7,109.51674,18.24965,1559
26955,205743,EB291EA7E3235FF23960DA865075F183,31801,10,11,1,109.20417,18.32118,371
26956,205744,EB291EA7E3235FF23960DA865075F183,38871,13,14,1,109.44681,18.28625,1316
26957,205745,EB291EA7E3235FF23960DA865075F183,60201,15,17,2,109.5041,18.2509,1510
26958,205746,EB291EA7E3235FF23960DA865075F183,30421,18,21,3,109.50021,18.25861,1511
26959,205747,EB291EA7E3235FF23960DA865075F183,60311,21,23,2,109.52097,18.24319,1558
26960,205802,2191B2AD5C915B8862D4C345F0A13CFB,31071,7,18,11,109.58257,18.28458,1815
26961,205803,2191B2AD5C915B8862D4C345F0A13CFB,60351,19,23,4,109.58403,18.28958,1816
26962,205806,E9F64FD67E39C3E2C15C20715338A941,30921,0,13,13,109.53903,18.29451,1667
26963,205807,E9F64FD67E39C3E2C15C20715338A941,31931,15,17,2,109.54771,18.29403,1667
26964,205808,67D1CD42FE90F28C58E4A4ECE73C13C7,38141,0,8,8,109.39479,18.2916,1116
26965,205809,67D1CD42FE90F28C58E4A4ECE73C13C7,31781,10,13,3,109.19847,18.2975,367
26966,205810,67D1CD42FE90F28C58E4A4ECE73C13C7,30661,15,16,1,109.37028,18.24361,1008
26967,205811,67D1CD42FE90F28C58E4A4ECE73C13C7,38141,19,22,3,109.39479,18.2916,1116
26971,205870,BFD935D49CB103A2B1D4E8EFFB13D28D,31471,14,17,3,109.34583,18.29563,917
26972,205871,BFD935D49CB103A2B1D4E8EFFB13D28D,60371,21,22,1,109.53063,18.30056,1618
26973,205873,26DECA4A496D5594EA57F7546CECA764,60201,12,13,1,109.5041,18.2509,1510
26974,205882,EB316856896788EC8FD871E122E95728,30701,0,6,6,109.59313,18.32007,1871
26975,205883,EB316856896788EC8FD871E122E95728,31811,6,11,5,109.54201,18.31806,1671
26976,205884,EB316856896788EC8FD871E122E95728,30701,12,13,1,109.59313,18.32007,1871
26977,205885,EB316856896788EC8FD871E122E95728,31811,14,16,2,109.54201,18.31806,1671
26978,205886,EB316856896788EC8FD871E122E95728,30701,17,23,6,109.59313,18.32007,1871
26979,205895,DEFDF52078F80D0DB257A40413FF368C,31071,1,6,5,109.58257,18.28458,1815
26980,205896,DEFDF52078F80D0DB257A40413FF368C,30271,7,10,3,109.49132,18.23153,1456
26981,205923,5F05A258CA919BA01045F79DD70FBCC9,39183,13,15,2,109.55542,18.28208,1715
26982,205924,5F05A258CA919BA01045F79DD70FBCC9,31561,16,22,6,109.56792,18.28479,1765
26983,205962,CD3BCBAB8571FB81953C842A434E5DB8,31071,8,10,2,109.58257,18.28458,1815
26984,205963,CD3BCBAB8571FB81953C842A434E5DB8,30854,11,12,1,109.56889,18.27076,1763
26985,205964,CD3BCBAB8571FB81953C842A434E5DB8,31071,12,20,8,109.58257,18.28458,1815
26986,206022,4B004637D3CFBCA65EA00FFD3F1EF7A6,31561,0,7,7,109.56792,18.28479,1765
26987,206023,4B004637D3CFBCA65EA00FFD3F1EF7A6,31931,9,10,1,109.54771,18.29403,1667
26988,206024,4B004637D3CFBCA65EA00FFD3F1EF7A6,31561,11,12,1,109.56792,18.28479,1765
26989,206025,4B004637D3CFBCA65EA00FFD3F1EF7A6,30071,16,18,2,109.52819,18.30472,1619
26990,206026,4B004637D3CFBCA65EA00FFD3F1EF7A6,30854,21,22,1,109.56889,18.27076,1763
26994,206077,DAAE5DFD68A77B087B889719E639CD9C,60381,0,10,10,109.5241,18.22458,1605
26995,206078,DAAE5DFD68A77B087B889719E639CD9C,60491,11,12,1,109.43354,18.30847,1269
26996,206079,DAAE5DFD68A77B087B889719E639CD9C,30861,14,23,9,109.52722,18.22743,1606
26997,206085,95FD09E80C431C5EBD01FFAFF8AFA522,60371,0,7,7,109.53063,18.30056,1618
26998,206086,95FD09E80C431C5EBD01FFAFF8AFA522,31301,9,12,3,109.14493,18.31222,170
26999,206087,95FD09E80C431C5EBD01FFAFF8AFA522,31471,14,16,2,109.34583,18.29563,917
27000,206092,706B8E0F0F5D1C9FC2F8EBB2574EE89F,30711,0,1,1,109.50271,18.25347,1510
27001,206093,706B8E0F0F5D1C9FC2F8EBB2574EE89F,30711,2,3,1,109.50271,18.25347,1510
27002,206094,706B8E0F0F5D1C9FC2F8EBB2574EE89F,31461,6,8,2,109.5091,18.25389,1510
27003,206095,706B8E0F0F5D1C9FC2F8EBB2574EE89F,30711,8,18,10,109.50271,18.25347,1510
27004,206096,706B8E0F0F5D1C9FC2F8EBB2574EE89F,30711,20,21,1,109.50271,18.25347,1510
27005,206097,706B8E0F0F5D1C9FC2F8EBB2574EE89F,38297,21,23,2,109.52576,18.24965,1609
27006,206129,EBD16061EA20EE33D9344D33735E5205,38291,0,6,6,109.51618,18.24313,1558
27007,206130,EBD16061EA20EE33D9344D33735E5205,31261,6,12,6,109.51174,18.2466,1559
27008,206131,EBD16061EA20EE33D9344D33735E5205,31441,12,16,4,109.51181,18.24424,1559
27009,206132,EBD16061EA20EE33D9344D33735E5205,31261,16,20,4,109.51174,18.2466,1559
27010,206133,EBD16061EA20EE33D9344D33735E5205,60311,21,23,2,109.52097,18.24319,1558
27011,206173,D57C96947D36188D750CB1E91A678FDA,39061,15,17,2,109.38222,18.28958,1066
27012,206174,D57C96947D36188D750CB1E91A678FDA,30421,18,23,5,109.50021,18.25861,1511
27013,206179,BB2A705402C0F8D59021F6C4976A196E,30854,19,20,1,109.56889,18.27076,1763
27014,206180,BB2A705402C0F8D59021F6C4976A196E,60631,20,21,1,109.57778,18.27583,1814
27015,206181,B164B8C0AEC0E295C9ED3DBE75B5D547,30581,0,6,6,109.62257,18.24951,1959
27016,206182,B164B8C0AEC0E295C9ED3DBE75B5D547,31851,7,8,1,109.71736,18.29007,2316
27017,206183,B164B8C0AEC0E295C9ED3DBE75B5D547,31571,11,13,2,109.61563,18.23326,1957
27018,206219,C2C9FC62B57DBBBE2D4CFD5ADB03E0F1,30851,11,16,5,109.5616,18.27396,1713
27019,206220,C2C9FC62B57DBBBE2D4CFD5ADB03E0F1,31071,16,23,7,109.58257,18.28458,1815
27020,206231,04257A4027CF767681E241CBFFC5B331,31881,5,7,2,109.7441,18.40785,2436
27021,206254,756F7869BDD7D5958992D7847F42858F,31236,14,19,5,109.42965,18.29111,1216
27022,206255,756F7869BDD7D5958992D7847F42858F,38071,19,23,4,109.40722,18.30938,1169
27026,206294,0402BD114B7D5E20705E302B756CD062,60631,0,6,6,109.57778,18.27583,1814
27027,206295,0402BD114B7D5E20705E302B756CD062,31071,8,19,11,109.58257,18.28458,1815
27028,206309,ACDEAAF45B65DE48CF80A48DBD3C775E,30854,8,14,6,109.56889,18.27076,1763
27029,206310,ACDEAAF45B65DE48CF80A48DBD3C775E,31071,16,18,2,109.58257,18.28458,1815
27030,206311,3E507BA86FBA703DAF19C68A80411CA5,60311,0,1,1,109.52097,18.24319,1558
27031,206312,3E507BA86FBA703DAF19C68A80411CA5,30854,2,9,7,109.56889,18.27076,1763
27032,206313,3E507BA86FBA703DAF19C68A80411CA5,31031,13,14,1,109.49979,18.25382,1510
27033,206314,3E507BA86FBA703DAF19C68A80411CA5,60354,19,20,1,109.58701,18.28521,1815
27034,206315,3E507BA86FBA703DAF19C68A80411CA5,30854,21,23,2,109.56889,18.27076,1763
27035,206316,282786EFD7BB2C684B51EB83D9362631,60501,0,8,8,109.48701,18.29021,1466
27036,206317,282786EFD7BB2C684B51EB83D9362631,30971,12,14,2,109.48708,18.29319,1467
27037,206339,5EBEA276FCB4A19AC5C987F5C7CC8908,60401,0,1,1,109.47444,18.27583,1414
27038,206340,5EBEA276FCB4A19AC5C987F5C7CC8908,60524,2,6,4,109.42951,18.28993,1216
27039,206341,5EBEA276FCB4A19AC5C987F5C7CC8908,60621,6,7,1,109.48354,18.27451,1464
27040,206342,5EBEA276FCB4A19AC5C987F5C7CC8908,60552,8,11,3,109.41729,18.30014,1218
27041,206343,5EBEA276FCB4A19AC5C987F5C7CC8908,60621,14,23,9,109.48354,18.27451,1464
27042,206348,3B6FF1F8D896A0A62DC7E65967011999,39183,0,20,20,109.55542,18.28208,1715
27043,206349,3B6FF1F8D896A0A62DC7E65967011999,31561,20,22,2,109.56792,18.28479,1765
27044,206364,A5678EE319F8EC08843C9F20545373D3,31231,0,11,11,109.42597,18.29292,1217
27045,206365,A5678EE319F8EC08843C9F20545373D3,60524,12,23,11,109.42951,18.28993,1216
27046,206386,F945D1EC910CAA5B207559CC99738BE6,30851,15,17,2,109.5616,18.27396,1713
27047,206387,F945D1EC910CAA5B207559CC99738BE6,30361,19,23,4,109.50347,18.24,1508
27048,206388,DB4DF566D4757FF3BB488F82DE126248,30851,2,3,1,109.5616,18.27396,1713
27049,206389,DB4DF566D4757FF3BB488F82DE126248,31561,3,20,17,109.56792,18.28479,1765
27054,206455,11E9088AC74BC50879349ACDDB708B24,31571,0,5,5,109.61563,18.23326,1957
27055,206456,11E9088AC74BC50879349ACDDB708B24,38054,6,7,1,109.63479,18.23097,2006
27056,206457,11E9088AC74BC50879349ACDDB708B24,31145,11,13,2,109.20431,18.30479,369
27057,206460,063A6C1319C2FB8D51BDBDBC79DDAACC,31521,0,13,13,109.51458,18.22542,1555
27058,206461,063A6C1319C2FB8D51BDBDBC79DDAACC,31471,16,18,2,109.34583,18.29563,917
27059,206462,063A6C1319C2FB8D51BDBDBC79DDAACC,31781,19,20,1,109.19847,18.2975,367
27060,206530,01F0083CC81D0009F9AAB8F7CAA0C106,30854,1,7,6,109.56889,18.27076,1763
27061,206531,01F0083CC81D0009F9AAB8F7CAA0C106,31071,9,16,7,109.58257,18.28458,1815
27062,206542,1994505627B8B8D1C8508885623DB6F8,38251,0,9,9,109.49618,18.25493,1510
27063,206543,1994505627B8B8D1C8508885623DB6F8,31311,11,14,3,109.72299,18.27438,2364
27067,206555,8088BB824557EB3DC3C65BFEE10DC938,30854,12,13,1,109.56889,18.27076,1763
27068,206556,8088BB824557EB3DC3C65BFEE10DC938,60071,15,19,4,109.75674,18.31583,2470
27069,206557,8088BB824557EB3DC3C65BFEE10DC938,60071,21,23,2,109.75674,18.31583,2470
27070,206584,B9273D09079A968E7733706E64683561,31471,12,14,2,109.34583,18.29563,917
27071,206585,68B818C9FDFA6C8A4859B6710E9B6AA7,38391,0,4,4,109.44111,18.29083,1266
27072,206586,68B818C9FDFA6C8A4859B6710E9B6AA7,31701,5,9,4,109.44132,18.28833,1266
27073,206587,68B818C9FDFA6C8A4859B6710E9B6AA7,30661,10,12,2,109.37028,18.24361,1008
27074,206588,68B818C9FDFA6C8A4859B6710E9B6AA7,38162,17,23,6,109.43944,18.28889,1266
27075,206599,296E9ABEFB8BDFEF115E6A6255085681,31411,18,19,1,109.5016,18.23576,1507
27076,206600,296E9ABEFB8BDFEF115E6A6255085681,60161,21,22,1,109.49174,18.26181,1461
27077,206616,D8BF2F572E169414CEFD83D7D44137A4,33481,9,10,1,109.67278,18.41278,2187
27078,206617,D8BF2F572E169414CEFD83D7D44137A4,31301,12,14,2,109.14493,18.31222,170
27079,206623,1791D76BD285CB6677B879C940A7CBDA,30051,15,16,1,109.48917,18.21215,1453
27080,206624,1791D76BD285CB6677B879C940A7CBDA,30731,21,22,1,109.50944,18.22306,1555
27081,206718,CA3896FB33E9BC68E91955EDFF5D709B,30854,0,8,8,109.56889,18.27076,1763
27082,206719,CA3896FB33E9BC68E91955EDFF5D709B,30731,10,12,2,109.50944,18.22306,1555
27083,206724,64F4CDF664AA04E7B79DE93C57128CF6,31931,0,4,4,109.54771,18.29403,1667
27084,206725,64F4CDF664AA04E7B79DE93C57128CF6,39181,8,17,9,109.55153,18.28035,1715
27088,206745,D334A3AB9A5F6BA25F6C66B0B76EC47B,30911,0,7,7,109.50493,18.26181,1511
27089,206746,D334A3AB9A5F6BA25F6C66B0B76EC47B,30421,7,12,5,109.50021,18.25861,1511
27090,206747,D334A3AB9A5F6BA25F6C66B0B76EC47B,31031,14,16,2,109.49979,18.25382,1510
27091,206748,D334A3AB9A5F6BA25F6C66B0B76EC47B,30711,16,19,3,109.50271,18.25347,1510
27092,206749,D334A3AB9A5F6BA25F6C66B0B76EC47B,30421,19,21,2,109.50021,18.25861,1511
27096,206789,354DC607408BB828F25BA014BE4B0A10,30731,0,3,3,109.50944,18.22306,1555
27097,206790,354DC607408BB828F25BA014BE4B0A10,38111,4,5,1,109.52007,18.22403,1555
27098,206791,354DC607408BB828F25BA014BE4B0A10,30731,7,10,3,109.50944,18.22306,1555
27099,206792,354DC607408BB828F25BA014BE4B0A10,30741,10,12,2,109.49833,18.28681,1516
27100,206793,354DC607408BB828F25BA014BE4B0A10,30731,14,16,2,109.50944,18.22306,1555
27101,206794,354DC607408BB828F25BA014BE4B0A10,38111,16,18,2,109.52007,18.22403,1555
27102,206795,354DC607408BB828F25BA014BE4B0A10,30731,20,23,3,109.50944,18.22306,1555
27103,206802,F621296F333E8058687ACD884B135C6E,31901,15,18,3,109.68236,18.35368,2227
27104,206803,F621296F333E8058687ACD884B135C6E,60114,19,22,3,109.73028,18.33847,2374
27105,206825,FA5581D3844E50B2A372DC72CD47A219,38951,0,7,7,109.48097,18.28868,1416
27106,206826,FA5581D3844E50B2A372DC72CD47A219,31101,9,10,1,109.65389,18.23403,2057
27107,206872,56F4A25A0E603B5B2CF39EF89A2DE812,31061,19,20,1,109.53333,18.23257,1607
27108,206873,56F4A25A0E603B5B2CF39EF89A2DE812,31611,22,23,1,109.63076,18.34944,2026
27109,206898,49B3509BB0FF86B3DDAB6DD80329A93A,33051,12,14,2,109.6475,18.46618,2096
27110,206900,49B3509BB0FF86B3DDAB6DD80329A93A,38951,21,22,1,109.48097,18.28868,1416
27114,206956,2C7E329ABF5669760C98EF0FEA876F54,39111,18,22,4,109.5191,18.22597,1555
27115,206967,011859AA130B61CD7FFEFC39AEF2B9BF,31061,0,5,5,109.53333,18.23257,1607
27116,206968,011859AA130B61CD7FFEFC39AEF2B9BF,30821,7,23,16,109.43681,18.33639,1274
27117,206969,CF3B86CDBB32A56F162AF624AA34A4EF,31864,0,7,7,109.49014,18.28333,1465
27118,206970,CF3B86CDBB32A56F162AF624AA34A4EF,60591,9,16,7,109.61118,18.21715,1904
27119,207021,73C621BBBABF29F29DF18108CE1A5D74,38951,0,7,7,109.48097,18.28868,1416
27120,207022,73C621BBBABF29F29DF18108CE1A5D74,31471,10,11,1,109.34583,18.29563,917
27121,207023,73C621BBBABF29F29DF18108CE1A5D74,30661,14,16,2,109.37028,18.24361,1008
27126,207094,7BD1580BA480E545686438B39D58DB57,31124,0,2,2,109.17069,18.35,276
27127,207095,7BD1580BA480E545686438B39D58DB57,30434,3,8,5,109.17083,18.35861,278
27128,207096,7BD1580BA480E545686438B39D58DB57,31781,12,13,1,109.19847,18.2975,367
27129,207102,8511528E14FB4539CD9D9028DC875E91,31561,0,1,1,109.56792,18.28479,1765
27130,207103,8511528E14FB4539CD9D9028DC875E91,31271,2,9,7,109.48958,18.26257,1462
27134,207147,EFDE35289FEC1E13D6F34EFEE66A8AD2,31561,0,1,1,109.56792,18.28479,1765
27135,207148,EFDE35289FEC1E13D6F34EFEE66A8AD2,60631,2,15,13,109.57778,18.27583,1814
27136,207171,DA10676C4DA702E02A2C3FFFAC40ABA2,31561,6,9,3,109.56792,18.28479,1765
27137,207172,DA10676C4DA702E02A2C3FFFAC40ABA2,39183,10,21,11,109.55542,18.28208,1715
27138,207188,EBC6234FE3CA0714B9EB5EC0230C1FEB,31531,0,7,7,109.49583,18.25972,1461
27139,207189,EBC6234FE3CA0714B9EB5EC0230C1FEB,31271,8,9,1,109.48958,18.26257,1462
27140,207190,EBC6234FE3CA0714B9EB5EC0230C1FEB,30711,13,16,3,109.50271,18.25347,1510
27141,207191,EBC6234FE3CA0714B9EB5EC0230C1FEB,38271,17,22,5,109.62632,18.23049,1956
27142,207219,AFFFE5C6CF1F48C4FC9E7C5DE978BF0D,31071,0,1,1,109.58257,18.28458,1815
27143,207220,AFFFE5C6CF1F48C4FC9E7C5DE978BF0D,31761,1,4,3,109.60521,18.27965,1914
27144,207221,AFFFE5C6CF1F48C4FC9E7C5DE978BF0D,60354,5,6,1,109.58701,18.28521,1815
27145,207222,AFFFE5C6CF1F48C4FC9E7C5DE978BF0D,30854,7,10,3,109.56889,18.27076,1763
27146,207223,AFFFE5C6CF1F48C4FC9E7C5DE978BF0D,31071,15,16,1,109.58257,18.28458,1815
27147,207224,AFFFE5C6CF1F48C4FC9E7C5DE978BF0D,30854,17,19,2,109.56889,18.27076,1763
27148,207225,AFFFE5C6CF1F48C4FC9E7C5DE978BF0D,31461,20,21,1,109.5091,18.25389,1510
27149,207236,9C0A03DCBFD1D5F11DF957CDAC9B1222,60161,0,10,10,109.49174,18.26181,1461
27150,207285,998ABE8C520F737BA8B4035E9C6950FC,30271,0,8,8,109.49132,18.23153,1456
27151,207286,998ABE8C520F737BA8B4035E9C6950FC,38754,12,13,1,109.74667,18.37382,2430
27152,207287,998ABE8C520F737BA8B4035E9C6950FC,60221,16,17,1,109.52569,18.29188,1616
27153,207288,998ABE8C520F737BA8B4035E9C6950FC,60381,19,20,1,109.5241,18.22458,1605
27154,207289,998ABE8C520F737BA8B4035E9C6950FC,60084,21,22,1,109.4984,18.2334,1507
27155,207301,187C0A1E258087BFAE75FA12EB6B5B08,31951,14,18,4,109.52174,18.30299,1568
27156,207302,187C0A1E258087BFAE75FA12EB6B5B08,30561,19,20,1,109.52778,18.31938,1621
27157,207303,187C0A1E258087BFAE75FA12EB6B5B08,30031,21,23,2,109.53681,18.33313,1673
27158,207329,0E129C09250C0D46273B4BD7E5225556,30151,0,6,6,109.50986,18.25083,1560
27159,207330,0E129C09250C0D46273B4BD7E5225556,60201,8,11,3,109.5041,18.2509,1510
27160,207331,0E129C09250C0D46273B4BD7E5225556,31303,13,16,3,109.15826,18.29549,217
27161,207332,0E129C09250C0D46273B4BD7E5225556,31301,17,18,1,109.14493,18.31222,170
27162,207333,0E129C09250C0D46273B4BD7E5225556,60281,20,22,2,109.51743,18.25924,1561
27163,207350,075E831221D825E42B68255A703AEB8B,60614,1,7,6,109.48799,18.29521,1467
27164,207351,075E831221D825E42B68255A703AEB8B,31471,9,10,1,109.34583,18.29563,917
27165,207352,075E831221D825E42B68255A703AEB8B,30661,13,16,3,109.37028,18.24361,1008
27166,207353,075E831221D825E42B68255A703AEB8B,38951,21,22,1,109.48097,18.28868,1416
27167,207357,BE7A0BE04118D373FA5A1BB3F88D90A9,30084,12,15,3,109.50118,18.26972,1513
27168,207358,BE7A0BE04118D373FA5A1BB3F88D90A9,31931,15,17,2,109.54771,18.29403,1667
27169,207359,D3CC138F01596B858EB1ECAA73909436,60381,2,4,2,109.5241,18.22458,1605
27170,207360,D3CC138F01596B858EB1ECAA73909436,39111,5,6,1,109.5191,18.22597,1555
27171,207361,D3CC138F01596B858EB1ECAA73909436,31521,8,9,1,109.51458,18.22542,1555
27172,207362,D3CC138F01596B858EB1ECAA73909436,38754,12,13,1,109.74667,18.37382,2430
27173,207363,D3CC138F01596B858EB1ECAA73909436,30181,15,16,1,109.51597,18.23313,1557
27174,207364,D3CC138F01596B858EB1ECAA73909436,30711,17,20,3,109.50271,18.25347,1510
27175,207365,D3CC138F01596B858EB1ECAA73909436,38111,20,23,3,109.52007,18.22403,1555
27180,207382,2269D1065FFE77B23BCA730F1F57BDCE,30361,19,21,2,109.50347,18.24,1508
27181,207383,2269D1065FFE77B23BCA730F1F57BDCE,38961,21,23,2,109.50847,18.23514,1507
27185,207402,C709D01469E0800AF998DFAF42105CDC,60631,0,5,5,109.57778,18.27583,1814
27186,207403,C709D01469E0800AF998DFAF42105CDC,31561,7,10,3,109.56792,18.28479,1765
27187,207404,C709D01469E0800AF998DFAF42105CDC,30854,10,11,1,109.56889,18.27076,1763
27188,207405,C709D01469E0800AF998DFAF42105CDC,31561,12,16,4,109.56792,18.28479,1765
27189,207406,C709D01469E0800AF998DFAF42105CDC,30854,18,23,5,109.56889,18.27076,1763
27193,207435,451E2BF48CD7B253EB0892324E679BCC,31461,0,4,4,109.5091,18.25389,1510
27194,207436,451E2BF48CD7B253EB0892324E679BCC,38297,5,6,1,109.52576,18.24965,1609
27195,207437,451E2BF48CD7B253EB0892324E679BCC,60281,6,11,5,109.51743,18.25924,1561
27196,207438,451E2BF48CD7B253EB0892324E679BCC,38291,11,13,2,109.51618,18.24313,1558
27197,207439,451E2BF48CD7B253EB0892324E679BCC,60281,13,17,4,109.51743,18.25924,1561
27198,207440,451E2BF48CD7B253EB0892324E679BCC,38297,19,22,3,109.52576,18.24965,1609
27202,207524,78D44725626E719FF0C0FCBC8763A33E,31561,15,16,1,109.56792,18.28479,1765
27203,207525,78D44725626E719FF0C0FCBC8763A33E,60361,19,22,3,109.51938,18.29681,1567
27207,207543,DDE77D3A656666992FC3458B84010D43,39183,0,3,3,109.55542,18.28208,1715
27208,207544,DDE77D3A656666992FC3458B84010D43,31561,5,11,6,109.56792,18.28479,1765
27209,207545,15A05498D3CF3495981AAE982CA69170,60161,15,19,4,109.49174,18.26181,1461
27210,207546,15A05498D3CF3495981AAE982CA69170,31031,19,21,2,109.49979,18.25382,1510
27211,207574,529A14F498129B0238F7B12A9FC7F6F7,31205,0,1,1,109.51111,18.23736,1557
27212,207575,529A14F498129B0238F7B12A9FC7F6F7,31671,2,9,7,109.38965,18.29813,1068
27213,207576,529A14F498129B0238F7B12A9FC7F6F7,31081,12,13,1,109.44639,18.30181,1318
27214,207577,529A14F498129B0238F7B12A9FC7F6F7,31701,15,16,1,109.44132,18.28833,1266
27215,207578,529A14F498129B0238F7B12A9FC7F6F7,31671,18,20,2,109.38965,18.29813,1068
27216,207579,529A14F498129B0238F7B12A9FC7F6F7,31701,20,23,3,109.44132,18.28833,1266
27217,207583,4CAA61941552055167911FDA303E0716,60311,19,20,1,109.52097,18.24319,1558
27218,207584,4CAA61941552055167911FDA303E0716,31201,21,22,1,109.51042,18.23819,1558
27219,207602,2C3BD53A8702A47FB82F05FB4993B683,31561,0,6,6,109.56792,18.28479,1765
27220,207603,2C3BD53A8702A47FB82F05FB4993B683,39183,7,8,1,109.55542,18.28208,1715
27221,207604,2C3BD53A8702A47FB82F05FB4993B683,31561,11,13,2,109.56792,18.28479,1765
27222,207605,2C3BD53A8702A47FB82F05FB4993B683,30854,14,15,1,109.56889,18.27076,1763
27223,207606,2C3BD53A8702A47FB82F05FB4993B683,31561,18,22,4,109.56792,18.28479,1765
27227,207663,C2622C284BAD8F487DCD454B3FAF9432,30721,0,12,12,109.51597,18.28257,1565
27228,207664,C2622C284BAD8F487DCD454B3FAF9432,38881,13,14,1,109.51618,18.26431,1562
27229,207665,C2622C284BAD8F487DCD454B3FAF9432,31021,15,18,3,109.49021,18.27,1463
27230,207666,C2622C284BAD8F487DCD454B3FAF9432,39154,20,21,1,109.50201,18.25681,1511
27231,207667,C2622C284BAD8F487DCD454B3FAF9432,60361,21,23,2,109.51938,18.29681,1567
27235,207686,283001ED673D8EDBEF7EEB00BDB31533,38017,1,3,2,109.49729,18.21424,1504
27236,207687,283001ED673D8EDBEF7EEB00BDB31533,31181,6,10,4,109.50382,18.24813,1509
27237,207688,283001ED673D8EDBEF7EEB00BDB31533,39151,11,13,2,109.49875,18.25097,1510
27238,207689,283001ED673D8EDBEF7EEB00BDB31533,60201,13,16,3,109.5041,18.2509,1510
27239,207690,283001ED673D8EDBEF7EEB00BDB31533,31181,16,18,2,109.50382,18.24813,1509
27240,207691,283001ED673D8EDBEF7EEB00BDB31533,30051,19,21,2,109.48917,18.21215,1453
27241,207732,0E1B3CFC64EBB658DA96D0DCA834701E,61011,0,6,6,109.60653,18.19076,1900
27242,207734,0E1B3CFC64EBB658DA96D0DCA834701E,61011,11,18,7,109.60653,18.19076,1900
27243,207759,DD45307798B5E5E871398410DD7318C5,38951,0,1,1,109.48097,18.28868,1416
27244,207760,DD45307798B5E5E871398410DD7318C5,38951,2,23,21,109.48097,18.28868,1416
27245,207776,6CFAB52F14B9F6126A5F32C6F3BFD184,31521,10,12,2,109.51458,18.22542,1555
27246,207777,6CFAB52F14B9F6126A5F32C6F3BFD184,30421,12,13,1,109.50021,18.25861,1511
27247,207778,6CFAB52F14B9F6126A5F32C6F3BFD184,39321,14,15,1,109.529,18.2167,1604
27248,207779,6CFAB52F14B9F6126A5F32C6F3BFD184,31521,18,21,3,109.51458,18.22542,1555
27249,207780,6CFAB52F14B9F6126A5F32C6F3BFD184,60381,21,22,1,109.5241,18.22458,1605
27250,207800,D39D64452E6BBEF7B3056CA239E1B86E,30851,0,5,5,109.5616,18.27396,1713
27251,207801,D39D64452E6BBEF7B3056CA239E1B86E,30854,5,23,18,109.56889,18.27076,1763
27252,207859,D1B09D14086A317457A98E1E3E3BED6B,39181,13,14,1,109.55153,18.28035,1715
27253,207860,D1B09D14086A317457A98E1E3E3BED6B,31931,15,16,1,109.54771,18.29403,1667
27254,207861,D1B09D14086A317457A98E1E3E3BED6B,39181,17,23,6,109.55153,18.28035,1715
27255,207891,34AB502A442AA8EA4A7FB30471B204DB,38094,10,12,2,109.45403,18.28778,1316
27256,207892,34AB502A442AA8EA4A7FB30471B204DB,30341,13,14,1,109.3625,18.29167,966
27257,207893,34AB502A442AA8EA4A7FB30471B204DB,31031,15,17,2,109.49979,18.25382,1510
27258,207894,34AB502A442AA8EA4A7FB30471B204DB,60401,20,21,1,109.47444,18.27583,1414
27265,208028,A7B3BDD8DC79485BA41EC7F220A41345,30854,0,1,1,109.56889,18.27076,1763
27266,208029,A7B3BDD8DC79485BA41EC7F220A41345,60631,3,10,7,109.57778,18.27583,1814
27267,208030,A7B3BDD8DC79485BA41EC7F220A41345,30854,12,13,1,109.56889,18.27076,1763
27268,208031,A7B3BDD8DC79485BA41EC7F220A41345,60631,14,16,2,109.57778,18.27583,1814
27269,208032,A7B3BDD8DC79485BA41EC7F220A41345,30854,18,19,1,109.56889,18.27076,1763
27270,208033,A7B3BDD8DC79485BA41EC7F220A41345,31554,22,23,1,109.55521,18.2459,1709
27274,208104,E755AD63601CF016CD8E32C53EBB1378,31864,2,12,10,109.49014,18.28333,1465
27275,208167,77D805C7CC3CDE277FD34ED04AB294D2,30731,0,1,1,109.50944,18.22306,1555
27276,208168,77D805C7CC3CDE277FD34ED04AB294D2,39321,4,9,5,109.529,18.2167,1604
27277,208188,09605A95AE7BE30FC92DC699DB3FCBD0,31461,18,20,2,109.5091,18.25389,1510
27278,208189,09605A95AE7BE30FC92DC699DB3FCBD0,30711,20,22,2,109.50271,18.25347,1510
27279,208192,8DA7661E8E46B66EF011FB9B9FA15609,60081,3,6,3,109.51097,18.22639,1556
27280,208193,8DA7661E8E46B66EF011FB9B9FA15609,60381,8,10,2,109.5241,18.22458,1605
27281,208194,8DA7661E8E46B66EF011FB9B9FA15609,31521,10,14,4,109.51458,18.22542,1555
27282,208195,8DA7661E8E46B66EF011FB9B9FA15609,30711,18,20,2,109.50271,18.25347,1510
27283,208196,8DA7661E8E46B66EF011FB9B9FA15609,39111,21,22,1,109.5191,18.22597,1555
27284,208242,1B452E7E79B6B7878FCAC5F7CC906FE5,38951,0,8,8,109.48097,18.28868,1416
27285,208244,1B452E7E79B6B7878FCAC5F7CC906FE5,31471,15,16,1,109.34583,18.29563,917
27286,208245,1B452E7E79B6B7878FCAC5F7CC906FE5,30821,19,21,2,109.43681,18.33639,1274
27287,208246,1B452E7E79B6B7878FCAC5F7CC906FE5,38951,22,23,1,109.48097,18.28868,1416
27294,208268,ED45C49A067CEAF327959541A0BCB0AF,38706,0,9,9,109.74625,18.37097,2430
27295,208269,ED45C49A067CEAF327959541A0BCB0AF,31671,13,15,2,109.38965,18.29813,1068
27296,208270,ED45C49A067CEAF327959541A0BCB0AF,38141,15,18,3,109.39479,18.2916,1116
27297,208276,D4451AAE094A43FD2A07E613CA7CF12F,30171,0,8,8,109.48458,18.27139,1463
27298,208277,D4451AAE094A43FD2A07E613CA7CF12F,60501,8,10,2,109.48701,18.29021,1466
27299,208278,D4451AAE094A43FD2A07E613CA7CF12F,30171,12,14,2,109.48458,18.27139,1463
27300,208279,D4451AAE094A43FD2A07E613CA7CF12F,60501,15,17,2,109.48701,18.29021,1466
27301,208280,D4451AAE094A43FD2A07E613CA7CF12F,30611,20,21,1,109.74958,18.40188,2485
27302,208281,182D5101D28D51096306D4EF5FDD4501,30421,17,19,2,109.50021,18.25861,1511
27303,208282,182D5101D28D51096306D4EF5FDD4501,38251,20,21,1,109.49618,18.25493,1510
27304,208291,64EA917EAAD3EB55DA2ABB227203C131,30854,13,14,1,109.56889,18.27076,1763
27305,208292,64EA917EAAD3EB55DA2ABB227203C131,60631,19,22,3,109.57778,18.27583,1814
27306,208355,999DEB7BFC175BF03EAE5DB1D4B2EFB6,60361,2,7,5,109.51938,18.29681,1567
27307,208356,999DEB7BFC175BF03EAE5DB1D4B2EFB6,30161,9,10,1,109.50042,18.24389,1508
27308,208357,999DEB7BFC175BF03EAE5DB1D4B2EFB6,60361,12,17,5,109.51938,18.29681,1567
27309,208358,999DEB7BFC175BF03EAE5DB1D4B2EFB6,31951,22,23,1,109.52174,18.30299,1568
27313,208405,975CB35586D2D95A387E2AA86A5AB719,31351,0,9,9,109.4959,18.28417,1465
27314,208406,975CB35586D2D95A387E2AA86A5AB719,30671,10,22,12,109.43611,18.30139,1268
27322,208445,DD056101D68CBFC24096E8F587CC747C,30071,2,5,3,109.52819,18.30472,1619
27323,208446,DD056101D68CBFC24096E8F587CC747C,31931,7,22,15,109.54771,18.29403,1667
27331,208503,A549C024E6F63EDBD3DC866F10DB11CE,30234,0,5,5,109.60681,18.29979,1918
27332,208504,A549C024E6F63EDBD3DC866F10DB11CE,30854,8,9,1,109.56889,18.27076,1763
27333,208505,A549C024E6F63EDBD3DC866F10DB11CE,31945,12,13,1,109.58021,18.29403,1817
27334,208506,A549C024E6F63EDBD3DC866F10DB11CE,30854,15,17,2,109.56889,18.27076,1763
27335,208507,A549C024E6F63EDBD3DC866F10DB11CE,31071,17,21,4,109.58257,18.28458,1815
27336,208508,A549C024E6F63EDBD3DC866F10DB11CE,30234,22,23,1,109.60681,18.29979,1918
27337,208533,8C2A72A3EA8DBE7544B4A433B2BC3FE0,60261,0,14,14,109.44326,18.3075,1319
27338,208534,8C2A72A3EA8DBE7544B4A433B2BC3FE0,60491,17,19,2,109.43354,18.30847,1269
27339,208535,A749E400BFD3B5908671E939EC104DEE,31071,1,7,6,109.58257,18.28458,1815
27340,208536,A749E400BFD3B5908671E939EC104DEE,30854,7,23,16,109.56889,18.27076,1763
27341,208552,86435198F57620D5DAC23B4A4DA78009,31931,8,10,2,109.54771,18.29403,1667
27342,208553,86435198F57620D5DAC23B4A4DA78009,39183,11,20,9,109.55542,18.28208,1715
27343,208565,5AF4B6D21D340C22355F444305E9AFA1,31951,15,17,2,109.52174,18.30299,1568
27344,208566,5AF4B6D21D340C22355F444305E9AFA1,30421,18,20,2,109.50021,18.25861,1511
27358,208690,6E6193514D8E876D83956A94AD4F3FB1,30921,18,21,3,109.53903,18.29451,1667
27359,208691,6E6193514D8E876D83956A94AD4F3FB1,31931,21,23,2,109.54771,18.29403,1667
27360,208697,C30EF1A03F3ACD87114629BE5EBA14E8,60552,0,7,7,109.41729,18.30014,1218
27361,208698,C30EF1A03F3ACD87114629BE5EBA14E8,31231,9,10,1,109.42597,18.29292,1217
27362,208699,C30EF1A03F3ACD87114629BE5EBA14E8,60041,11,13,2,109.39889,18.31944,1121
27363,208700,C30EF1A03F3ACD87114629BE5EBA14E8,31231,15,16,1,109.42597,18.29292,1217
27364,208701,C30EF1A03F3ACD87114629BE5EBA14E8,60552,18,20,2,109.41729,18.30014,1218
27365,208705,66DAA2740440F603A26B0FC0D4309DF2,30071,0,8,8,109.52819,18.30472,1619
27366,208706,66DAA2740440F603A26B0FC0D4309DF2,31931,10,23,13,109.54771,18.29403,1667
27367,208734,182603D8C7C4BF5CDDF16B2E79D9DF52,30161,8,10,2,109.50042,18.24389,1508
27368,208735,182603D8C7C4BF5CDDF16B2E79D9DF52,31231,13,17,4,109.42597,18.29292,1217
27369,208760,1FDB2743111B6AD36C2D7C9496C22062,30821,19,21,2,109.43681,18.33639,1274
27370,208761,1FDB2743111B6AD36C2D7C9496C22062,38951,21,23,2,109.48097,18.28868,1416
27371,208799,B61666307486DD531F980787F0F8A7B7,31561,0,1,1,109.56792,18.28479,1765
27372,208800,B61666307486DD531F980787F0F8A7B7,60631,4,19,15,109.57778,18.27583,1814
27373,208804,949173524C1E5F3B9BD54D60F0306D0C,31561,0,6,6,109.56792,18.28479,1765
27374,208805,949173524C1E5F3B9BD54D60F0306D0C,30711,8,13,5,109.50271,18.25347,1510
27375,208806,949173524C1E5F3B9BD54D60F0306D0C,31071,17,18,1,109.58257,18.28458,1815
27376,208807,949173524C1E5F3B9BD54D60F0306D0C,31071,20,23,3,109.58257,18.28458,1815
27377,208829,6D0CBC29417959EBDF12F1FD604A5C61,31091,14,15,1,109.41201,18.31222,1170
27378,208830,6D0CBC29417959EBDF12F1FD604A5C61,60661,19,23,4,109.548,18.2377,1657
27379,208851,985A2EA61E10E912EF275486E93274F1,60201,0,3,3,109.5041,18.2509,1510
27380,208852,985A2EA61E10E912EF275486E93274F1,39151,4,5,1,109.49875,18.25097,1510
27381,208853,985A2EA61E10E912EF275486E93274F1,60201,6,7,1,109.5041,18.2509,1510
27382,208854,985A2EA61E10E912EF275486E93274F1,31781,10,13,3,109.19847,18.2975,367
27383,208855,985A2EA61E10E912EF275486E93274F1,31471,16,17,1,109.34583,18.29563,917
27384,208856,985A2EA61E10E912EF275486E93274F1,30361,20,22,2,109.50347,18.24,1508
27385,208857,2C5F898948A2B7909519666936FBF333,60341,0,4,4,109.70597,18.31778,2271
27386,208858,2C5F898948A2B7909519666936FBF333,38707,8,23,15,109.73778,18.35368,2427
27387,208897,C1372D8DF0C6109FD496E05E1E1566AD,30681,0,5,5,109.48493,18.26917,1463
27388,208898,C1372D8DF0C6109FD496E05E1E1566AD,30171,6,8,2,109.48458,18.27139,1463
27389,208899,C1372D8DF0C6109FD496E05E1E1566AD,38251,10,11,1,109.49618,18.25493,1510
27390,208900,C1372D8DF0C6109FD496E05E1E1566AD,60401,14,16,2,109.47444,18.27583,1414
27391,208901,C1372D8DF0C6109FD496E05E1E1566AD,30171,16,20,4,109.48458,18.27139,1463
27392,208902,C1372D8DF0C6109FD496E05E1E1566AD,60401,21,23,2,109.47444,18.27583,1414
27396,208940,DC6FAC9E4085B298085CB0CDBEACDBC4,31101,15,17,2,109.65389,18.23403,2057
27397,208941,DC6FAC9E4085B298085CB0CDBEACDBC4,60552,19,22,3,109.41729,18.30014,1218
27398,208949,1026894DC5FF9A7FAF3A2EE28B95E239,30854,0,22,22,109.56889,18.27076,1763
27399,208950,1026894DC5FF9A7FAF3A2EE28B95E239,39183,22,23,1,109.55542,18.28208,1715
27400,208956,7421066246AAD1C230E7E2A7ADF06E9D,60631,3,7,4,109.57778,18.27583,1814
27401,208957,7421066246AAD1C230E7E2A7ADF06E9D,30854,10,17,7,109.56889,18.27076,1763
27402,208958,7421066246AAD1C230E7E2A7ADF06E9D,60381,20,22,2,109.5241,18.22458,1605
27403,208965,A4823EEC9A8E697E80697432C029B488,60331,1,6,5,109.505,18.26507,1512
27404,208966,A4823EEC9A8E697E80697432C029B488,30421,6,8,2,109.50021,18.25861,1511
27405,208967,A4823EEC9A8E697E80697432C029B488,30391,12,13,1,109.4975,18.27118,1513
27406,208968,A4823EEC9A8E697E80697432C029B488,31021,15,16,1,109.49021,18.27,1463
27407,208969,A4823EEC9A8E697E80697432C029B488,31561,20,21,1,109.56792,18.28479,1765
27414,209017,8394F4F81295DA567F75BB12D1616CF3,31521,15,16,1,109.51458,18.22542,1555
27415,209018,8394F4F81295DA567F75BB12D1616CF3,30511,17,19,2,109.51069,18.24208,1558
27416,209019,8394F4F81295DA567F75BB12D1616CF3,60361,19,23,4,109.51938,18.29681,1567
27417,209056,8E74DEE1D6AD25525E0B9C766B9CBA47,31531,0,9,9,109.49583,18.25972,1461
27418,209057,8E74DEE1D6AD25525E0B9C766B9CBA47,60614,12,13,1,109.48799,18.29521,1467
27419,209058,8E74DEE1D6AD25525E0B9C766B9CBA47,30771,14,16,2,109.49938,18.26042,1511
27420,209059,8E74DEE1D6AD25525E0B9C766B9CBA47,31091,18,20,2,109.41201,18.31222,1170
27421,209060,8E74DEE1D6AD25525E0B9C766B9CBA47,30741,21,22,1,109.49833,18.28681,1516
27422,209086,0A9117B90774715AACE2ED3045D6F579,60552,0,9,9,109.41729,18.30014,1218
27423,209087,0A9117B90774715AACE2ED3045D6F579,31351,10,14,4,109.4959,18.28417,1465
27424,209116,7BAE1D02C0D214D20907C3472A373B1E,31521,10,12,2,109.51458,18.22542,1555
27425,209117,7BAE1D02C0D214D20907C3472A373B1E,30661,13,15,2,109.37028,18.24361,1008
27426,209121,F866B6E34CEF853A6497211DD74A607E,30711,1,5,4,109.50271,18.25347,1510
27427,209122,F866B6E34CEF853A6497211DD74A607E,30591,6,7,1,109.63021,18.3334,2023
27428,209123,F866B6E34CEF853A6497211DD74A607E,60117,8,9,1,109.73604,18.35681,2427
27429,209124,F866B6E34CEF853A6497211DD74A607E,30281,12,14,2,109.50597,18.27583,1514
27430,209125,F866B6E34CEF853A6497211DD74A607E,30711,15,17,2,109.50271,18.25347,1510
27431,209126,F866B6E34CEF853A6497211DD74A607E,31071,18,23,5,109.58257,18.28458,1815
27436,209191,9EF4A95256B94781E773FD041E0B016F,38127,0,9,9,109.50833,18.27222,1513
27441,209233,BCC8232F5CE277D549F349BCFC9101AB,30711,0,9,9,109.50271,18.25347,1510
27442,209234,BCC8232F5CE277D549F349BCFC9101AB,30711,13,16,3,109.50271,18.25347,1510
27443,209235,BCC8232F5CE277D549F349BCFC9101AB,30711,18,20,2,109.50271,18.25347,1510
27444,209236,BCC8232F5CE277D549F349BCFC9101AB,30421,20,21,1,109.50021,18.25861,1511
27445,209237,BCC8232F5CE277D549F349BCFC9101AB,30711,21,23,2,109.50271,18.25347,1510
27449,209319,A509D0CA53CD767E0234236B42930030,38094,0,8,8,109.45403,18.28778,1316
27450,209320,A509D0CA53CD767E0234236B42930030,31781,9,12,3,109.19847,18.2975,367
27451,209321,A509D0CA53CD767E0234236B42930030,60054,13,15,2,109.3016,18.31229,770
27452,209322,A509D0CA53CD767E0234236B42930030,38094,19,23,4,109.45403,18.28778,1316
27457,209368,C85D0B931BEF54F05B9ABBBB03212DB7,31561,4,18,14,109.56792,18.28479,1765
27458,209369,C85D0B931BEF54F05B9ABBBB03212DB7,30854,20,22,2,109.56889,18.27076,1763
27459,209413,3A887AE7038DEACD71C8879078F4404A,30151,0,13,13,109.50986,18.25083,1560
27460,209414,3A887AE7038DEACD71C8879078F4404A,38094,16,17,1,109.45403,18.28778,1316
27461,209415,3A887AE7038DEACD71C8879078F4404A,31821,20,23,3,109.51181,18.24924,1559
27462,209468,740A252E141CF3F62997C00883EFD2C6,31101,0,2,2,109.65389,18.23403,2057
27463,209469,740A252E141CF3F62997C00883EFD2C6,38052,5,7,2,109.62618,18.23042,1956
27464,209470,740A252E141CF3F62997C00883EFD2C6,60594,9,10,1,109.62694,18.22799,1956
27465,209471,740A252E141CF3F62997C00883EFD2C6,38052,14,16,2,109.62618,18.23042,1956
27466,209472,740A252E141CF3F62997C00883EFD2C6,38331,19,22,3,109.62465,18.22736,1956
27470,209491,856FED43C24F39C7284040D716161D86,31081,0,9,9,109.44639,18.30181,1318
27471,209492,856FED43C24F39C7284040D716161D86,38754,11,12,1,109.74667,18.37382,2430
27472,209493,856FED43C24F39C7284040D716161D86,30731,17,18,1,109.50944,18.22306,1555
27473,209494,856FED43C24F39C7284040D716161D86,31701,19,21,2,109.44132,18.28833,1266
27474,209495,856FED43C24F39C7284040D716161D86,31081,22,23,1,109.44639,18.30181,1318
27475,209513,402581B1124C1361D0FBA391D98CFB5F,33051,12,14,2,109.6475,18.46618,2096
27479,209556,62FCB15297A7724012720DDE29CC0405,31145,13,15,2,109.20431,18.30479,369
27480,209557,62FCB15297A7724012720DDE29CC0405,60571,18,21,3,109.50722,18.25056,1510
27481,209558,62FCB15297A7724012720DDE29CC0405,31761,22,23,1,109.60521,18.27965,1914
27482,209573,C90A127FC935FC5139F523C5C932A70E,38017,0,9,9,109.49729,18.21424,1504
27483,209574,C90A127FC935FC5139F523C5C932A70E,31781,12,14,2,109.19847,18.2975,367
27484,209575,C90A127FC935FC5139F523C5C932A70E,38017,19,22,3,109.49729,18.21424,1504
27485,209589,864183CB94ABE5E80322CE852D5C129B,60084,0,7,7,109.4984,18.2334,1507
27486,209590,864183CB94ABE5E80322CE852D5C129B,31781,9,11,2,109.19847,18.2975,367
27487,209591,864183CB94ABE5E80322CE852D5C129B,30211,14,15,1,109.49882,18.23931,1508
27488,209592,864183CB94ABE5E80322CE852D5C129B,60084,18,20,2,109.4984,18.2334,1507
27489,209593,864183CB94ABE5E80322CE852D5C129B,31521,20,21,1,109.51458,18.22542,1555
27490,209597,18EE47452FD5BE7C01D5DBC710576D9F,60274,17,23,6,109.514,18.2933,1567
27491,209607,0D7FD96B164D7D9CD6D0D8B8C05CAF7C,31081,19,21,2,109.44639,18.30181,1318
27492,209608,0D7FD96B164D7D9CD6D0D8B8C05CAF7C,60491,21,22,1,109.43354,18.30847,1269
27493,209634,005F3AEFE6DBF371ED1FD57736434098,31071,0,7,7,109.58257,18.28458,1815
27494,209635,005F3AEFE6DBF371ED1FD57736434098,30854,8,10,2,109.56889,18.27076,1763
27495,209636,005F3AEFE6DBF371ED1FD57736434098,31071,11,12,1,109.58257,18.28458,1815
27496,209637,005F3AEFE6DBF371ED1FD57736434098,30854,18,20,2,109.56889,18.27076,1763
27497,209638,005F3AEFE6DBF371ED1FD57736434098,31071,20,22,2,109.58257,18.28458,1815
27498,209665,E8A62C362548F9D5791FD06549C42092,60054,0,10,10,109.3016,18.31229,770
27499,209666,E8A62C362548F9D5791FD06549C42092,30661,10,11,1,109.37028,18.24361,1008
27500,209667,E8A62C362548F9D5791FD06549C42092,60054,11,23,12,109.3016,18.31229,770
27501,209678,34F3D64B41C252481F72E5CF931AC833,30851,0,12,12,109.5616,18.27396,1713
27502,209679,34F3D64B41C252481F72E5CF931AC833,31071,16,19,3,109.58257,18.28458,1815
27506,209708,769D7D978DB2A1F24C6E03C572F6F52F,38361,0,9,9,109.43667,18.29201,1267
27507,209709,769D7D978DB2A1F24C6E03C572F6F52F,30731,13,17,4,109.50944,18.22306,1555
27508,209710,769D7D978DB2A1F24C6E03C572F6F52F,38361,18,23,5,109.43667,18.29201,1267
27509,209733,00C9D9AB8C31F2634E8E8174C9C57D7E,30181,0,8,8,109.51597,18.23313,1557
27510,209734,00C9D9AB8C31F2634E8E8174C9C57D7E,31781,13,15,2,109.19847,18.2975,367
27511,209735,00C9D9AB8C31F2634E8E8174C9C57D7E,30181,20,23,3,109.51597,18.23313,1557
27512,209757,BD1C8CAB0CA377D9350002A865081450,30251,0,13,13,109.50611,18.26653,1512
27513,209758,BD1C8CAB0CA377D9350002A865081450,31021,15,20,5,109.49021,18.27,1463
27514,209759,ABCD0851CC1C78BCD7AF6DBDF2F5DE49,60551,0,2,2,109.42722,18.30111,1218
27515,209760,ABCD0851CC1C78BCD7AF6DBDF2F5DE49,60552,5,19,14,109.41729,18.30014,1218
27516,209761,B48CF6FA27E864933632BDC922A5DB6B,31781,14,15,1,109.19847,18.2975,367
27517,209762,B48CF6FA27E864933632BDC922A5DB6B,31031,18,22,4,109.49979,18.25382,1510
27526,209822,BA22E9DF5AF7E43CF73CB10FC8453FF1,30854,8,11,3,109.56889,18.27076,1763
27527,209823,BA22E9DF5AF7E43CF73CB10FC8453FF1,31071,12,14,2,109.58257,18.28458,1815
27528,209824,BA22E9DF5AF7E43CF73CB10FC8453FF1,39091,16,18,2,109.50097,18.25222,1510
27529,209825,BA22E9DF5AF7E43CF73CB10FC8453FF1,31071,20,22,2,109.58257,18.28458,1815
27530,209826,04874B86EA4291E8B43131C5ED885BE2,33481,9,11,2,109.67278,18.41278,2187
27531,209827,04874B86EA4291E8B43131C5ED885BE2,33051,15,17,2,109.6475,18.46618,2096
27532,209828,04874B86EA4291E8B43131C5ED885BE2,30854,20,21,1,109.56889,18.27076,1763
27544,209927,B584ECCE32EE4C49FF68F8E796132301,31531,0,1,1,109.49583,18.25972,1461
27545,209928,B584ECCE32EE4C49FF68F8E796132301,30721,1,13,12,109.51597,18.28257,1565
27546,209956,27BCEF3137923B84211F08830816C810,61011,16,17,1,109.60653,18.19076,1900
27547,209957,27BCEF3137923B84211F08830816C810,30851,18,20,2,109.5616,18.27396,1713
27548,209966,5426296000364EE32711CD0E73D782C8,60421,14,17,3,109.46333,18.31743,1371
27549,209967,5426296000364EE32711CD0E73D782C8,30741,18,19,1,109.49833,18.28681,1516
27550,209977,2361E8D6BAB0231B2E8E3C0F34517282,30291,0,7,7,109.50403,18.27028,1513
27551,209978,2361E8D6BAB0231B2E8E3C0F34517282,60501,9,11,2,109.48701,18.29021,1466
27552,209979,2361E8D6BAB0231B2E8E3C0F34517282,60334,12,17,5,109.50215,18.26458,1512
27553,209980,2361E8D6BAB0231B2E8E3C0F34517282,60331,18,19,1,109.505,18.26507,1512
27554,209981,2361E8D6BAB0231B2E8E3C0F34517282,30291,19,22,3,109.50403,18.27028,1513
27555,209982,439C404954398764464D854D76F475D8,30321,15,16,1,109.49563,18.29611,1467
27556,209983,439C404954398764464D854D76F475D8,31864,19,20,1,109.49014,18.28333,1465
27557,209984,439C404954398764464D854D76F475D8,31861,22,23,1,109.49042,18.27549,1464
27561,210042,4E94ADAE7ABEB20EEFAF67519DFCC1BE,31081,0,9,9,109.44639,18.30181,1318
27562,210043,4E94ADAE7ABEB20EEFAF67519DFCC1BE,31031,9,21,12,109.49979,18.25382,1510
27563,210077,3980EAA193EA22B4F7FBFB486C5AD1BA,30111,0,6,6,109.47583,18.30542,1419
27564,210078,3980EAA193EA22B4F7FBFB486C5AD1BA,30241,8,9,1,109.26174,18.3275,622
27565,210079,3980EAA193EA22B4F7FBFB486C5AD1BA,31781,10,12,2,109.19847,18.2975,367
27566,210090,00FD2268DE6E83934D2916174E81532F,30761,18,20,2,109.45201,18.3,1318
27567,210091,00FD2268DE6E83934D2916174E81532F,30111,21,22,1,109.47583,18.30542,1419
27571,210135,22130435C432F057AB9DDA7C1A223C66,60084,0,7,7,109.4984,18.2334,1507
27572,210136,22130435C432F057AB9DDA7C1A223C66,30051,8,11,3,109.48917,18.21215,1453
27573,210137,22130435C432F057AB9DDA7C1A223C66,38251,11,13,2,109.49618,18.25493,1510
27574,210138,22130435C432F057AB9DDA7C1A223C66,31471,15,16,1,109.34583,18.29563,917
27575,210139,22130435C432F057AB9DDA7C1A223C66,60084,21,23,2,109.4984,18.2334,1507
27579,210164,F198CAA1F49ACA5D003FD8F8473B3798,31071,1,14,13,109.58257,18.28458,1815
27580,210165,F198CAA1F49ACA5D003FD8F8473B3798,30854,14,20,6,109.56889,18.27076,1763
27581,210166,F198CAA1F49ACA5D003FD8F8473B3798,30191,21,22,1,109.50361,18.22701,1506
27586,210229,7334BFE245C0E1675EC3C07645407CF3,31121,0,2,2,109.16292,18.37063,230
27587,210230,7334BFE245C0E1675EC3C07645407CF3,31541,3,5,2,109.1809,18.36722,329
27588,210231,7334BFE245C0E1675EC3C07645407CF3,60411,7,12,5,109.32514,18.30854,869
27589,210232,7334BFE245C0E1675EC3C07645407CF3,30661,13,16,3,109.37028,18.24361,1008
27590,210233,7334BFE245C0E1675EC3C07645407CF3,60411,16,18,2,109.32514,18.30854,869
27591,210234,7334BFE245C0E1675EC3C07645407CF3,31121,18,21,3,109.16292,18.37063,230
27592,210249,C7A58F45156649A612134237290C5B69,30821,0,8,8,109.43681,18.33639,1274
27593,210250,C7A58F45156649A612134237290C5B69,31081,9,11,2,109.44639,18.30181,1318
27594,210251,C7A58F45156649A612134237290C5B69,30651,14,16,2,109.42611,18.385,1232
27595,210252,C7A58F45156649A612134237290C5B69,30821,16,18,2,109.43681,18.33639,1274
27596,210253,C7A58F45156649A612134237290C5B69,31081,20,21,1,109.44639,18.30181,1318
27597,210254,C7A58F45156649A612134237290C5B69,30821,21,23,2,109.43681,18.33639,1274
27598,210261,1D2F8DB1F8B6A2081E1A43DDF558491D,31951,11,14,3,109.52174,18.30299,1568
27599,210262,1D2F8DB1F8B6A2081E1A43DDF558491D,60361,15,16,1,109.51938,18.29681,1567
27600,210263,1D2F8DB1F8B6A2081E1A43DDF558491D,31951,16,23,7,109.52174,18.30299,1568
27601,210264,8C5A16299A6D294198C90C34C25C5949,30854,13,14,1,109.56889,18.27076,1763
27602,210265,8C5A16299A6D294198C90C34C25C5949,39183,15,17,2,109.55542,18.28208,1715
27603,210266,8C5A16299A6D294198C90C34C25C5949,31561,17,18,1,109.56792,18.28479,1765
27604,210306,01C2118F7C72B72DC3ED114C4AC903DC,60401,0,8,8,109.47444,18.27583,1414
27605,210307,01C2118F7C72B72DC3ED114C4AC903DC,60552,8,10,2,109.41729,18.30014,1218
27606,210311,10A38EAB1548E22B36293FDAA86FC250,31071,0,8,8,109.58257,18.28458,1815
27607,210312,10A38EAB1548E22B36293FDAA86FC250,30361,12,13,1,109.50347,18.24,1508
27608,210342,F3CFDDD39C8B8B5FE5E615E3E5F400DF,30181,0,8,8,109.51597,18.23313,1557
27609,210343,F3CFDDD39C8B8B5FE5E615E3E5F400DF,60171,10,11,1,109.51292,18.30694,1569
27610,210344,F3CFDDD39C8B8B5FE5E615E3E5F400DF,39111,14,16,2,109.5191,18.22597,1555
27611,210345,F3CFDDD39C8B8B5FE5E615E3E5F400DF,31521,18,21,3,109.51458,18.22542,1555
27612,210346,F3CFDDD39C8B8B5FE5E615E3E5F400DF,30511,21,23,2,109.51069,18.24208,1558
27613,210400,2D39AE6120F2674000C6DBB8A6E572A0,31945,0,7,7,109.58021,18.29403,1817
27614,210401,2D39AE6120F2674000C6DBB8A6E572A0,30854,10,21,11,109.56889,18.27076,1763
27615,210409,0DB031C0FC798B5BDEAA8EA2CB39B9C0,30711,12,13,1,109.50271,18.25347,1510
27616,210410,0DB031C0FC798B5BDEAA8EA2CB39B9C0,31521,14,15,1,109.51458,18.22542,1555
27617,210411,0DB031C0FC798B5BDEAA8EA2CB39B9C0,31521,19,20,1,109.51458,18.22542,1555
27618,210412,0DB031C0FC798B5BDEAA8EA2CB39B9C0,31521,21,23,2,109.51458,18.22542,1555
27625,210441,C1F9914EF577AE2A8300B1A3945A50FF,31561,0,2,2,109.56792,18.28479,1765
27626,210442,C1F9914EF577AE2A8300B1A3945A50FF,30851,3,20,17,109.5616,18.27396,1713
27627,210447,21EA50B7F2072F2024B9F3B7B9174B94,30021,7,11,4,109.12014,18.40986,86
27628,210448,21EA50B7F2072F2024B9F3B7B9174B94,30911,12,14,2,109.50493,18.26181,1511
27629,210455,1F75615E1DADB7B28D1F65C84D87DC7F,38241,15,18,3,109.54111,18.30542,1669
27630,210456,1F75615E1DADB7B28D1F65C84D87DC7F,31031,19,21,2,109.49979,18.25382,1510
27635,210493,3BB007FDF28DB0E7E883BA594F721FFE,31181,0,1,1,109.50382,18.24813,1509
27636,210494,3BB007FDF28DB0E7E883BA594F721FFE,39151,1,6,5,109.49875,18.25097,1510
27637,210495,3BB007FDF28DB0E7E883BA594F721FFE,31181,7,11,4,109.50382,18.24813,1509
27638,210496,3BB007FDF28DB0E7E883BA594F721FFE,30561,12,14,2,109.52778,18.31938,1621
27639,210521,D3FB1B9D3C241050E5FB29B7C0AA31BE,31611,0,6,6,109.63076,18.34944,2026
27640,210522,D3FB1B9D3C241050E5FB29B7C0AA31BE,31061,8,20,12,109.53333,18.23257,1607
27641,210523,D3FB1B9D3C241050E5FB29B7C0AA31BE,31611,22,23,1,109.63076,18.34944,2026
27642,210576,9FEA4B85EAE4FAEE1CAF0EABFF2FAEA1,31561,0,5,5,109.56792,18.28479,1765
27643,210577,9FEA4B85EAE4FAEE1CAF0EABFF2FAEA1,39183,7,8,1,109.55542,18.28208,1715
27644,210578,9FEA4B85EAE4FAEE1CAF0EABFF2FAEA1,31561,12,13,1,109.56792,18.28479,1765
27645,210579,9FEA4B85EAE4FAEE1CAF0EABFF2FAEA1,39183,13,16,3,109.55542,18.28208,1715
27646,210580,9FEA4B85EAE4FAEE1CAF0EABFF2FAEA1,31561,19,21,2,109.56792,18.28479,1765
27647,210585,32A3CE1C280040E7ED0898AB2CE878E8,38165,0,12,12,109.44847,18.28896,1316
27648,210586,32A3CE1C280040E7ED0898AB2CE878E8,31181,13,14,1,109.50382,18.24813,1509
27649,210587,32A3CE1C280040E7ED0898AB2CE878E8,38071,17,18,1,109.40722,18.30938,1169
27650,210601,474C69A25C5BE237EAB7C712686B73B1,60401,0,4,4,109.47444,18.27583,1414
27651,210602,474C69A25C5BE237EAB7C712686B73B1,38951,6,8,2,109.48097,18.28868,1416
27652,210603,474C69A25C5BE237EAB7C712686B73B1,31145,12,14,2,109.20431,18.30479,369
27653,210604,474C69A25C5BE237EAB7C712686B73B1,31471,15,17,2,109.34583,18.29563,917
27654,210605,474C69A25C5BE237EAB7C712686B73B1,30821,20,21,1,109.43681,18.33639,1274
27655,210622,D771BADDFC8F8EC32B8C9D302A579CF4,60084,19,20,1,109.4984,18.2334,1507
27656,210623,D771BADDFC8F8EC32B8C9D302A579CF4,30731,21,22,1,109.50944,18.22306,1555
27657,210636,2A177ADF4F6516EDDF22425D74B17CFB,60221,0,5,5,109.52569,18.29188,1616
27658,210639,D0D16C12E8B96689EDFBB50650CC1F5C,60381,2,3,1,109.5241,18.22458,1605
27659,210640,D0D16C12E8B96689EDFBB50650CC1F5C,38117,4,7,3,109.51611,18.22354,1555
27660,210641,D0D16C12E8B96689EDFBB50650CC1F5C,31781,11,13,2,109.19847,18.2975,367
27661,210642,D0D16C12E8B96689EDFBB50650CC1F5C,38291,18,20,2,109.51618,18.24313,1558
27662,210643,D0D16C12E8B96689EDFBB50650CC1F5C,31521,20,23,3,109.51458,18.22542,1555
27667,210716,E191BF114A3C2277CB7C3323BAA13F43,31561,8,10,2,109.56792,18.28479,1765
27668,210717,E191BF114A3C2277CB7C3323BAA13F43,30854,11,23,12,109.56889,18.27076,1763
27675,210746,289060A56CDB4D33EB944FB1093FD036,33481,12,14,2,109.67278,18.41278,2187
27676,210747,289060A56CDB4D33EB944FB1093FD036,30581,15,16,1,109.62257,18.24951,1959
27687,210928,90B0A60855A43B2DB99A0964CE51D3AF,30854,16,17,1,109.56889,18.27076,1763
27688,210929,90B0A60855A43B2DB99A0964CE51D3AF,31071,17,20,3,109.58257,18.28458,1815
27689,210930,90B0A60855A43B2DB99A0964CE51D3AF,30234,21,22,1,109.60681,18.29979,1918
27690,210942,35C83AAA1A53416FB80F07AE6FF8EDFD,60331,0,2,2,109.505,18.26507,1512
27691,210943,35C83AAA1A53416FB80F07AE6FF8EDFD,30771,6,7,1,109.49938,18.26042,1511
27692,210944,35C83AAA1A53416FB80F07AE6FF8EDFD,30241,8,10,2,109.26174,18.3275,622
27693,210945,35C83AAA1A53416FB80F07AE6FF8EDFD,31781,12,13,1,109.19847,18.2975,367
27711,211065,97DFCEF20461204135ADC6D971200EB4,31091,22,23,1,109.41201,18.31222,1170
27715,211098,B7EDD7EF574DDD321F8378E2BE84CCD6,33051,15,17,2,109.6475,18.46618,2096
27716,211099,B7EDD7EF574DDD321F8378E2BE84CCD6,30854,20,21,1,109.56889,18.27076,1763
27717,211127,F5A39DF146F73F37BA63CAB6EB58C447,31071,0,7,7,109.58257,18.28458,1815
27718,211128,F5A39DF146F73F37BA63CAB6EB58C447,31031,7,10,3,109.49979,18.25382,1510
27719,211129,F5A39DF146F73F37BA63CAB6EB58C447,30711,10,14,4,109.50271,18.25347,1510
27720,211130,F5A39DF146F73F37BA63CAB6EB58C447,31071,16,23,7,109.58257,18.28458,1815
27721,211131,2A028F9A0AC84A80514E52694F20F378,38991,0,6,6,109.52681,18.30368,1618
27722,211132,2A028F9A0AC84A80514E52694F20F378,31931,6,12,6,109.54771,18.29403,1667
27723,211133,2A028F9A0AC84A80514E52694F20F378,31561,14,16,2,109.56792,18.28479,1765
27724,211134,2A028F9A0AC84A80514E52694F20F378,30921,17,18,1,109.53903,18.29451,1667
27725,211135,2A028F9A0AC84A80514E52694F20F378,30071,21,23,2,109.52819,18.30472,1619
27726,211142,E8F8C6C52075F75066BCDBFD2FA15D47,31071,0,6,6,109.58257,18.28458,1815
27727,211143,E8F8C6C52075F75066BCDBFD2FA15D47,30731,9,17,8,109.50944,18.22306,1555
27728,211144,E8F8C6C52075F75066BCDBFD2FA15D47,30854,19,22,3,109.56889,18.27076,1763
27732,211249,84DF4A7C208235D171EF56473BCCF210,30851,1,4,3,109.5616,18.27396,1713
27733,211250,84DF4A7C208235D171EF56473BCCF210,31561,4,6,2,109.56792,18.28479,1765
27734,211251,84DF4A7C208235D171EF56473BCCF210,31411,6,8,2,109.5016,18.23576,1507
27735,211252,84DF4A7C208235D171EF56473BCCF210,60631,10,19,9,109.57778,18.27583,1814
27736,211253,84DF4A7C208235D171EF56473BCCF210,31071,19,20,1,109.58257,18.28458,1815
27737,211263,2873D39E7EAE4EB9FF7882E90907EED7,30764,13,16,3,109.45806,18.29486,1367
27738,211264,2873D39E7EAE4EB9FF7882E90907EED7,30111,16,23,7,109.47583,18.30542,1419
27739,211275,015CDEB9169BCE5537ABAE49B6A63F2B,31071,0,7,7,109.58257,18.28458,1815
27740,211276,015CDEB9169BCE5537ABAE49B6A63F2B,30854,10,11,1,109.56889,18.27076,1763
27741,211277,015CDEB9169BCE5537ABAE49B6A63F2B,60114,15,16,1,109.73028,18.33847,2374
27742,211278,015CDEB9169BCE5537ABAE49B6A63F2B,31071,17,19,2,109.58257,18.28458,1815
27743,211279,015CDEB9169BCE5537ABAE49B6A63F2B,30854,20,22,2,109.56889,18.27076,1763
27744,211292,7E5829ED545598C52143FC1F86559D63,30861,0,6,6,109.52722,18.22743,1606
27745,211293,7E5829ED545598C52143FC1F86559D63,31091,8,10,2,109.41201,18.31222,1170
27746,211295,7E5829ED545598C52143FC1F86559D63,30861,21,23,2,109.52722,18.22743,1606
27750,211307,AD025C3F50B6CF31383182CF8709389F,31431,0,11,11,109.44639,18.29042,1316
27751,211308,AD025C3F50B6CF31383182CF8709389F,31671,12,14,2,109.38965,18.29813,1068
27752,211309,AD025C3F50B6CF31383182CF8709389F,31031,18,19,1,109.49979,18.25382,1510
27753,211310,AD025C3F50B6CF31383182CF8709389F,38141,20,21,1,109.39479,18.2916,1116
27754,211361,B8587D3CED4B79DF3F07DD5419A719F9,31231,0,2,2,109.42597,18.29292,1217
27755,211362,B8587D3CED4B79DF3F07DD5419A719F9,60524,4,6,2,109.42951,18.28993,1216
27756,211363,B8587D3CED4B79DF3F07DD5419A719F9,38251,6,8,2,109.49618,18.25493,1510
27757,211364,B8587D3CED4B79DF3F07DD5419A719F9,31781,12,13,1,109.19847,18.2975,367
27758,211365,B8587D3CED4B79DF3F07DD5419A719F9,31031,16,17,1,109.49979,18.25382,1510
27759,211366,663CE56232D73D50E42DEC41EA33269F,31931,0,21,21,109.54771,18.29403,1667
27760,211367,663CE56232D73D50E42DEC41EA33269F,30171,22,23,1,109.48458,18.27139,1463
27761,211380,D55448AF780DC440D7CB0F00F1D6CA8C,31531,15,21,6,109.49583,18.25972,1461
27762,211381,D55448AF780DC440D7CB0F00F1D6CA8C,31534,21,23,2,109.49368,18.25806,1461
27763,211390,41332C8361F6C8A51074BE394B72EF60,30771,17,21,4,109.49938,18.26042,1511
27764,211391,41332C8361F6C8A51074BE394B72EF60,38094,21,23,2,109.45403,18.28778,1316
27765,211420,4DE3E9C2C0E7F48C3178063DD53BC336,31941,15,16,1,109.62451,18.31222,1970
27766,211421,4DE3E9C2C0E7F48C3178063DD53BC336,30921,19,22,3,109.53903,18.29451,1667
27767,211430,72378A653B4F571F903CABFC8BEF5042,31591,18,19,1,109.46924,18.34882,1376
27768,211431,72378A653B4F571F903CABFC8BEF5042,30111,22,23,1,109.47583,18.30542,1419
27772,211457,1639B81A43FFF124C17E59CAD0C4F339,31931,0,14,14,109.54771,18.29403,1667
27773,211458,1639B81A43FFF124C17E59CAD0C4F339,30921,16,18,2,109.53903,18.29451,1667
27774,211462,48E412C068F936A4922628B0DC57FE76,38251,0,9,9,109.49618,18.25493,1510
27775,211463,48E412C068F936A4922628B0DC57FE76,38754,10,13,3,109.74667,18.37382,2430
27776,211464,48E412C068F936A4922628B0DC57FE76,38251,16,18,2,109.49618,18.25493,1510
27777,211465,48E412C068F936A4922628B0DC57FE76,31021,18,20,2,109.49021,18.27,1463
27778,211466,48E412C068F936A4922628B0DC57FE76,38251,20,23,3,109.49618,18.25493,1510
27779,211474,356E75600A8901067E9EDB6E5BE4617A,30281,12,13,1,109.50597,18.27583,1514
27780,211475,356E75600A8901067E9EDB6E5BE4617A,38157,16,17,1,109.51483,18.26958,1563
27781,211476,356E75600A8901067E9EDB6E5BE4617A,30281,17,20,3,109.50597,18.27583,1514
27785,211502,97F87E25D267410278E74FDFD0CF66D1,30234,0,3,3,109.60681,18.29979,1918
27786,211503,97F87E25D267410278E74FDFD0CF66D1,31071,4,5,1,109.58257,18.28458,1815
27787,211504,97F87E25D267410278E74FDFD0CF66D1,38291,9,12,3,109.51618,18.24313,1558
27788,211529,CE87BCFF4C9FDB07C8CD6075D1328156,60661,17,18,1,109.548,18.2377,1657
27789,211530,CE87BCFF4C9FDB07C8CD6075D1328156,60221,20,23,3,109.52569,18.29188,1616
27790,211539,6ED697962F10CC0C2236463F9FC9376B,30821,8,20,12,109.43681,18.33639,1274
27791,211540,6ED697962F10CC0C2236463F9FC9376B,30761,20,21,1,109.45201,18.3,1318
27795,211571,54A6757CA4BF8A47C41CF1DDCA6EA505,30854,6,13,7,109.56889,18.27076,1763
27796,211572,54A6757CA4BF8A47C41CF1DDCA6EA505,30861,14,16,2,109.52722,18.22743,1606
27797,211573,54A6757CA4BF8A47C41CF1DDCA6EA505,30854,17,18,1,109.56889,18.27076,1763
27802,211606,07169E7114E4F14C073261BAAC0D4491,61011,0,7,7,109.60653,18.19076,1900
27803,211608,07169E7114E4F14C073261BAAC0D4491,61011,19,23,4,109.60653,18.19076,1900
27804,211609,53490AD77ACCA93C3ED0F3DE79CA488B,31071,6,7,1,109.58257,18.28458,1815
27805,211610,53490AD77ACCA93C3ED0F3DE79CA488B,30854,8,21,13,109.56889,18.27076,1763
27806,211670,AA17AFDA929E42B241ADF1BFA6E7435E,31251,15,16,1,109.18528,18.2975,317
27807,211671,AA17AFDA929E42B241ADF1BFA6E7435E,31206,21,22,1,109.50819,18.23549,1507
27808,211681,9C1407835BC54BEBDB541F52E1DA1820,61011,0,1,1,109.60653,18.19076,1900
27809,211683,9C1407835BC54BEBDB541F52E1DA1820,61011,5,10,5,109.60653,18.19076,1900
27810,211707,4E29CE086935B3CD8038A4A6640FE864,30671,1,10,9,109.43611,18.30139,1268
27811,211708,4E29CE086935B3CD8038A4A6640FE864,60041,11,15,4,109.39889,18.31944,1121
27812,211709,4E29CE086935B3CD8038A4A6640FE864,31201,16,17,1,109.51042,18.23819,1558
27813,211710,4E29CE086935B3CD8038A4A6640FE864,60041,17,19,2,109.39889,18.31944,1121
27814,211711,4E29CE086935B3CD8038A4A6640FE864,60291,21,23,2,109.50826,18.24639,1509
27815,211746,C666BDF91E2AEE4AB0E8446E7282D156,31561,0,9,9,109.56792,18.28479,1765
27816,211747,C666BDF91E2AEE4AB0E8446E7282D156,30721,9,12,3,109.51597,18.28257,1565
27817,211748,C666BDF91E2AEE4AB0E8446E7282D156,61011,14,16,2,109.60653,18.19076,1900
27818,211749,C666BDF91E2AEE4AB0E8446E7282D156,30161,18,22,4,109.50042,18.24389,1508
27819,211787,7B9D64657CE26DF907B4C2AC87C9F431,60371,8,10,2,109.53063,18.30056,1618
27820,211788,7B9D64657CE26DF907B4C2AC87C9F431,38241,12,16,4,109.54111,18.30542,1669
27821,211789,7B9D64657CE26DF907B4C2AC87C9F431,31931,19,23,4,109.54771,18.29403,1667
27822,211821,8BFB49F9AE47BA01DA64200A7313BAB6,31951,14,15,1,109.52174,18.30299,1568
27823,211822,8BFB49F9AE47BA01DA64200A7313BAB6,60621,16,17,1,109.48354,18.27451,1464
27824,211823,8BFB49F9AE47BA01DA64200A7313BAB6,30391,18,19,1,109.4975,18.27118,1513
27828,211854,F47B82183D87369F74615895846A6BA9,38721,0,5,5,109.50368,18.27542,1514
27829,211855,F47B82183D87369F74615895846A6BA9,30291,5,8,3,109.50403,18.27028,1513
27830,211856,F47B82183D87369F74615895846A6BA9,31031,9,10,1,109.49979,18.25382,1510
27831,211857,F47B82183D87369F74615895846A6BA9,38171,19,20,1,109.50799,18.28139,1515
27832,211858,F47B82183D87369F74615895846A6BA9,30291,21,22,1,109.50403,18.27028,1513
27836,211862,5A430B3542A9634CA3883245A4BAF022,60381,16,19,3,109.5241,18.22458,1605
27837,211863,5A430B3542A9634CA3883245A4BAF022,31461,19,23,4,109.5091,18.25389,1510
27838,211887,DC29C676832347947F366933ECB88090,39183,16,18,2,109.55542,18.28208,1715
27839,211888,DC29C676832347947F366933ECB88090,31561,21,22,1,109.56792,18.28479,1765
27843,211910,0BABF9C6516F437130A3DD3C99553A57,31201,0,2,2,109.51042,18.23819,1558
27844,211911,0BABF9C6516F437130A3DD3C99553A57,39191,3,11,8,109.51493,18.23472,1557
27845,211912,0BABF9C6516F437130A3DD3C99553A57,31201,13,14,1,109.51042,18.23819,1558
27846,211913,0BABF9C6516F437130A3DD3C99553A57,31521,18,19,1,109.51458,18.22542,1555
27847,211914,0BABF9C6516F437130A3DD3C99553A57,31206,20,23,3,109.50819,18.23549,1507
27852,211985,4E2E832AE9D054F6D1F41FA6FCE0E148,31561,16,17,1,109.56792,18.28479,1765
27853,211986,4E2E832AE9D054F6D1F41FA6FCE0E148,30854,21,23,2,109.56889,18.27076,1763
27858,212007,E34FF61340C5B86CF9FD0AD454D26266,60331,0,6,6,109.505,18.26507,1512
27859,212008,E34FF61340C5B86CF9FD0AD454D26266,60131,7,10,3,109.49819,18.24778,1509
27860,212009,E34FF61340C5B86CF9FD0AD454D26266,30251,11,14,3,109.50611,18.26653,1512
27861,212010,E34FF61340C5B86CF9FD0AD454D26266,38251,15,16,1,109.49618,18.25493,1510
27862,212011,E34FF61340C5B86CF9FD0AD454D26266,60331,19,23,4,109.505,18.26507,1512
27863,212018,94F0184D0BA3E27BCB47A57DA614F9FC,60411,0,13,13,109.32514,18.30854,869
27864,212019,94F0184D0BA3E27BCB47A57DA614F9FC,30661,14,16,2,109.37028,18.24361,1008
27865,212020,94F0184D0BA3E27BCB47A57DA614F9FC,60411,16,17,1,109.32514,18.30854,869
27866,212021,94F0184D0BA3E27BCB47A57DA614F9FC,30661,19,22,3,109.37028,18.24361,1008
27867,212022,94F0184D0BA3E27BCB47A57DA614F9FC,60411,22,23,1,109.32514,18.30854,869
27878,212162,1FE34463C604482338E93206E38E7B82,31321,8,14,6,109.63799,18.23201,2007
27879,212163,1FE34463C604482338E93206E38E7B82,60161,15,19,4,109.49174,18.26181,1461
27880,212231,51061B3DE820AF1C1C713EF684728003,31071,2,6,4,109.58257,18.28458,1815
27881,212232,51061B3DE820AF1C1C713EF684728003,30854,7,20,13,109.56889,18.27076,1763
27882,212233,A8E9C7BB918ADAD29A3EA7ACDDCD32D7,38951,2,10,8,109.48097,18.28868,1416
27883,212234,A8E9C7BB918ADAD29A3EA7ACDDCD32D7,38951,10,14,4,109.48097,18.28868,1416
27884,212250,D356A9515C42A4641DD61B7F30BFB752,60201,0,8,8,109.5041,18.2509,1510
27885,212251,D356A9515C42A4641DD61B7F30BFB752,60161,9,10,1,109.49174,18.26181,1461
27886,212252,D356A9515C42A4641DD61B7F30BFB752,38251,10,12,2,109.49618,18.25493,1510
27887,212253,D356A9515C42A4641DD61B7F30BFB752,31021,13,14,1,109.49021,18.27,1463
27888,212254,D356A9515C42A4641DD61B7F30BFB752,31864,15,17,2,109.49014,18.28333,1465
27889,212255,D356A9515C42A4641DD61B7F30BFB752,31021,18,20,2,109.49021,18.27,1463
27890,212256,D356A9515C42A4641DD61B7F30BFB752,31861,22,23,1,109.49042,18.27549,1464
27891,212280,1980C8D409DE9551539224B3D393CDAA,30071,0,1,1,109.52819,18.30472,1619
27892,212281,1980C8D409DE9551539224B3D393CDAA,30071,4,21,17,109.52819,18.30472,1619
27897,212376,8AFD060E1E9DC727605442142067AD03,38951,0,10,10,109.48097,18.28868,1416
27898,212378,8AFD060E1E9DC727605442142067AD03,38951,21,23,2,109.48097,18.28868,1416
27899,212430,8B9A9BFD1ACAD480EB101A91DBF2024D,38291,15,19,4,109.51618,18.24313,1558
27900,212431,8B9A9BFD1ACAD480EB101A91DBF2024D,30191,22,23,1,109.50361,18.22701,1506
27901,212450,750172FB82300DA02225CC4F7256EE00,39183,13,14,1,109.55542,18.28208,1715
27902,212451,750172FB82300DA02225CC4F7256EE00,30381,16,23,7,109.52521,18.24507,1609
27903,212506,8752BC71725B50257436D50C6598F252,30234,14,15,1,109.60681,18.29979,1918
27904,212507,8752BC71725B50257436D50C6598F252,30854,16,19,3,109.56889,18.27076,1763
27905,212508,8752BC71725B50257436D50C6598F252,31071,20,23,3,109.58257,18.28458,1815
27906,212562,4538154FE025AC6453F6CD695BA5F0AF,38911,1,6,5,109.51674,18.24965,1559
27907,212563,4538154FE025AC6453F6CD695BA5F0AF,31471,8,9,1,109.34583,18.29563,917
27908,212564,4538154FE025AC6453F6CD695BA5F0AF,31821,11,13,2,109.51181,18.24924,1559
27909,212565,4538154FE025AC6453F6CD695BA5F0AF,38297,13,15,2,109.52576,18.24965,1609
27910,212566,4538154FE025AC6453F6CD695BA5F0AF,38754,17,18,1,109.74667,18.37382,2430
27921,212670,37657A593A7A700C5ECCE5BB0AAAABA7,39181,9,10,1,109.55153,18.28035,1715
27922,212671,37657A593A7A700C5ECCE5BB0AAAABA7,31931,13,17,4,109.54771,18.29403,1667
27923,212672,37657A593A7A700C5ECCE5BB0AAAABA7,30721,18,21,3,109.51597,18.28257,1565
27924,212699,6AFD900AAA635A8603B035488C44B76B,30711,10,15,5,109.50271,18.25347,1510
27925,212700,6AFD900AAA635A8603B035488C44B76B,31124,16,17,1,109.17069,18.35,276
27929,212746,4B672ABD46E5A5E3AE2E2A8075F2FA4B,30421,10,11,1,109.50021,18.25861,1511
27930,212747,4B672ABD46E5A5E3AE2E2A8075F2FA4B,30854,13,14,1,109.56889,18.27076,1763
27931,212748,4B672ABD46E5A5E3AE2E2A8075F2FA4B,39183,15,16,1,109.55542,18.28208,1715
27932,212749,4B672ABD46E5A5E3AE2E2A8075F2FA4B,60463,17,18,1,109.52507,18.22438,1605
27933,212760,9AA959ED87D1ECC3053DED17290EFCBD,30854,0,2,2,109.56889,18.27076,1763
27934,212761,9AA959ED87D1ECC3053DED17290EFCBD,31561,3,7,4,109.56792,18.28479,1765
27935,212762,9AA959ED87D1ECC3053DED17290EFCBD,39183,8,9,1,109.55542,18.28208,1715
27936,212763,9AA959ED87D1ECC3053DED17290EFCBD,31561,19,21,2,109.56792,18.28479,1765
27937,212764,9AA959ED87D1ECC3053DED17290EFCBD,30854,21,22,1,109.56889,18.27076,1763
27938,212780,7890099D98AA300C5BF12527E7372DB0,30854,13,14,1,109.56889,18.27076,1763
27939,212781,7890099D98AA300C5BF12527E7372DB0,31071,19,21,2,109.58257,18.28458,1815
27940,212794,C1F80FD61770F46AF18F3BEF2B67E7ED,38171,18,20,2,109.50799,18.28139,1515
27941,212795,C1F80FD61770F46AF18F3BEF2B67E7ED,31551,20,23,3,109.55868,18.24222,1708
27942,212826,D96E01B8E0F0DE9C160C9FEAFDCFDB6D,31071,0,7,7,109.58257,18.28458,1815
27943,212827,D96E01B8E0F0DE9C160C9FEAFDCFDB6D,30854,7,20,13,109.56889,18.27076,1763
27944,212852,3C1A2536A78CF30193CED5E3EEACBE7E,30854,0,17,17,109.56889,18.27076,1763
27945,212853,3C1A2536A78CF30193CED5E3EEACBE7E,30851,19,23,4,109.5616,18.27396,1713
27946,212869,32D92CA589BCDC1A419C60C7E36F8BC2,60614,0,5,5,109.48799,18.29521,1467
27947,212870,32D92CA589BCDC1A419C60C7E36F8BC2,38951,6,7,1,109.48097,18.28868,1416
27948,212889,A23D20D52F2319A584B0A74D271DDBDA,31231,2,7,5,109.42597,18.29292,1217
27949,212890,A23D20D52F2319A584B0A74D271DDBDA,30731,8,10,2,109.50944,18.22306,1555
27950,212891,A23D20D52F2319A584B0A74D271DDBDA,31521,12,13,1,109.51458,18.22542,1555
27954,212952,40285EE8CCE25C38988EC087545664EC,31071,2,7,5,109.58257,18.28458,1815
27955,212953,40285EE8CCE25C38988EC087545664EC,30854,8,22,14,109.56889,18.27076,1763
27956,212985,E16401EA38059619DFCD6F8BB2A2CA65,31261,13,14,1,109.51174,18.2466,1559
27957,213010,3B46764DEE9C1A14D1C3F1D56B4284FD,31931,0,2,2,109.54771,18.29403,1667
27958,213011,3B46764DEE9C1A14D1C3F1D56B4284FD,30071,4,6,2,109.52819,18.30472,1619
27959,213012,3B46764DEE9C1A14D1C3F1D56B4284FD,60361,6,10,4,109.51938,18.29681,1567
27960,213013,3B46764DEE9C1A14D1C3F1D56B4284FD,31121,16,17,1,109.16292,18.37063,230
27961,213014,3B46764DEE9C1A14D1C3F1D56B4284FD,60241,20,21,1,109.53319,18.28667,1616
27962,213022,00262F856825A94933CC2BDE5C3D9737,60581,0,5,5,109.59785,18.29931,1868
27963,213023,00262F856825A94933CC2BDE5C3D9737,31421,7,8,1,109.55382,18.22347,1705
27964,213024,00262F856825A94933CC2BDE5C3D9737,60581,13,17,4,109.59785,18.29931,1868
27965,213025,00262F856825A94933CC2BDE5C3D9737,31421,18,20,2,109.55382,18.22347,1705
27966,213026,00262F856825A94933CC2BDE5C3D9737,60581,20,23,3,109.59785,18.29931,1868
27971,213055,C8922FAF66F21ECAECB6B717FCD5A53B,60614,0,7,7,109.48799,18.29521,1467
27972,213056,C8922FAF66F21ECAECB6B717FCD5A53B,60391,9,11,2,109.47667,18.28757,1416
27973,213057,C8922FAF66F21ECAECB6B717FCD5A53B,60614,11,12,1,109.48799,18.29521,1467
27974,213058,C8922FAF66F21ECAECB6B717FCD5A53B,60391,16,19,3,109.47667,18.28757,1416
27975,213059,C8922FAF66F21ECAECB6B717FCD5A53B,60614,21,23,2,109.48799,18.29521,1467
27982,213098,9F3EB2BFFB1C9BCF2031C397D642D9F1,38094,21,23,2,109.45403,18.28778,1316
27983,213133,A503639E15A0B5D04B0130D882921438,31031,0,13,13,109.49979,18.25382,1510
27984,213134,A503639E15A0B5D04B0130D882921438,30711,14,22,8,109.50271,18.25347,1510
27985,213146,FD5B9AB034F15F72E8BEF02193669238,31931,9,10,1,109.54771,18.29403,1667
27986,213147,FD5B9AB034F15F72E8BEF02193669238,60241,12,23,11,109.53319,18.28667,1616
27987,213197,89E9D5A5271FF46B57D9025356B7D83E,30324,8,10,2,109.50326,18.29257,1517
27988,213198,89E9D5A5271FF46B57D9025356B7D83E,30741,12,13,1,109.49833,18.28681,1516
27993,213215,00678D3F0FE479614070948AEC721AF0,30854,17,18,1,109.56889,18.27076,1763
27997,213271,08A066736557478B1013C0CF834491DF,30921,0,6,6,109.53903,18.29451,1667
27998,213272,08A066736557478B1013C0CF834491DF,31931,7,16,9,109.54771,18.29403,1667
27999,213276,2A4D7C29737BD5444FB22FA470A46C75,31781,12,13,1,109.19847,18.2975,367
28000,213277,2A4D7C29737BD5444FB22FA470A46C75,31471,15,17,2,109.34583,18.29563,917
28001,213278,2A4D7C29737BD5444FB22FA470A46C75,30771,21,22,1,109.49938,18.26042,1511
28002,213320,E75CF54BA14775FEDD26504F9F6B7365,31071,0,6,6,109.58257,18.28458,1815
28003,213321,E75CF54BA14775FEDD26504F9F6B7365,31561,6,9,3,109.56792,18.28479,1765
28004,213322,E75CF54BA14775FEDD26504F9F6B7365,30851,11,13,2,109.5616,18.27396,1713
28005,213323,E75CF54BA14775FEDD26504F9F6B7365,31561,13,18,5,109.56792,18.28479,1765
28006,213324,E75CF54BA14775FEDD26504F9F6B7365,30234,19,21,2,109.60681,18.29979,1918
28007,213348,D8EBCB05DE029B0DEDBF9FBDF3DA3C2D,30211,2,6,4,109.49882,18.23931,1508
28008,213349,D8EBCB05DE029B0DEDBF9FBDF3DA3C2D,30271,8,9,1,109.49132,18.23153,1456
28009,213350,D8EBCB05DE029B0DEDBF9FBDF3DA3C2D,30661,13,15,2,109.37028,18.24361,1008
28010,213351,D8EBCB05DE029B0DEDBF9FBDF3DA3C2D,30271,16,17,1,109.49132,18.23153,1456
28011,213352,D8EBCB05DE029B0DEDBF9FBDF3DA3C2D,30421,18,19,1,109.50021,18.25861,1511
28012,213353,D8EBCB05DE029B0DEDBF9FBDF3DA3C2D,38251,19,21,2,109.49618,18.25493,1510
28013,213354,D8EBCB05DE029B0DEDBF9FBDF3DA3C2D,60084,22,23,1,109.4984,18.2334,1507
28017,213372,176C6455055846C83CDA64CD9B071B7A,60381,17,18,1,109.5241,18.22458,1605
28018,213373,176C6455055846C83CDA64CD9B071B7A,31534,20,22,2,109.49368,18.25806,1461
28019,213374,AFB5BA168951839870415DB36DAB089E,60354,0,8,8,109.58701,18.28521,1815
28020,213375,AFB5BA168951839870415DB36DAB089E,31421,8,9,1,109.55382,18.22347,1705
28021,213376,AFB5BA168951839870415DB36DAB089E,30731,10,11,1,109.50944,18.22306,1555
28022,213377,AFB5BA168951839870415DB36DAB089E,31421,13,14,1,109.55382,18.22347,1705
28023,213378,AFB5BA168951839870415DB36DAB089E,30731,15,17,2,109.50944,18.22306,1555
28024,213379,AFB5BA168951839870415DB36DAB089E,30854,19,21,2,109.56889,18.27076,1763
28025,213380,ED6C06A9523B96BECA45DFE9D14D9117,31701,1,10,9,109.44132,18.28833,1266
28026,213381,ED6C06A9523B96BECA45DFE9D14D9117,30181,11,12,1,109.51597,18.23313,1557
28027,213382,ED6C06A9523B96BECA45DFE9D14D9117,30051,13,14,1,109.48917,18.21215,1453
28028,213383,ED6C06A9523B96BECA45DFE9D14D9117,38251,18,19,1,109.49618,18.25493,1510
28029,213384,ED6C06A9523B96BECA45DFE9D14D9117,38071,21,23,2,109.40722,18.30938,1169
28030,213398,93B7D316229EF1618C51F67797BDF883,30191,0,9,9,109.50361,18.22701,1506
28031,213399,93B7D316229EF1618C51F67797BDF883,38951,12,14,2,109.48097,18.28868,1416
28032,213400,93B7D316229EF1618C51F67797BDF883,38821,15,17,2,109.50354,18.25243,1510
28033,213410,46D4D50B5B9F043295625FA342CF0B25,38911,0,8,8,109.51674,18.24965,1559
28034,213411,46D4D50B5B9F043295625FA342CF0B25,31821,8,9,1,109.51181,18.24924,1559
28035,213412,46D4D50B5B9F043295625FA342CF0B25,31471,11,12,1,109.34583,18.29563,917
28036,213413,46D4D50B5B9F043295625FA342CF0B25,30661,14,16,2,109.37028,18.24361,1008
28052,213575,B34415F599F0ED7D1A073EE314A60B9B,60541,1,6,5,109.4084,18.29208,1167
28053,213576,B34415F599F0ED7D1A073EE314A60B9B,31671,7,22,15,109.38965,18.29813,1068
28057,213613,829F436C92FECF274888E348549D23CB,31931,13,14,1,109.54771,18.29403,1667
28058,213614,829F436C92FECF274888E348549D23CB,60361,16,19,3,109.51938,18.29681,1567
28059,213615,829F436C92FECF274888E348549D23CB,31071,20,23,3,109.58257,18.28458,1815
28060,213616,197B005CFC0BCB591E8EE809CF956AA0,38331,0,6,6,109.62465,18.22736,1956
28061,213617,197B005CFC0BCB591E8EE809CF956AA0,31571,7,8,1,109.61563,18.23326,1957
28062,213618,197B005CFC0BCB591E8EE809CF956AA0,39091,9,11,2,109.50097,18.25222,1510
28063,213619,197B005CFC0BCB591E8EE809CF956AA0,38105,14,15,1,109.40299,18.29229,1117
28064,213620,197B005CFC0BCB591E8EE809CF956AA0,60381,19,20,1,109.5241,18.22458,1605
28065,213661,13BA422D9C6FCE9CD249F0603D3E98AC,31681,7,11,4,109.40396,18.29979,1168
28066,213662,13BA422D9C6FCE9CD249F0603D3E98AC,30201,12,15,3,109.4909,18.26465,1462
28067,213679,5A1FDC762E3A00EF6FB4C515806ADF6A,38911,0,8,8,109.51674,18.24965,1559
28068,213680,5A1FDC762E3A00EF6FB4C515806ADF6A,31261,8,9,1,109.51174,18.2466,1559
28069,213681,5A1FDC762E3A00EF6FB4C515806ADF6A,38291,10,12,2,109.51618,18.24313,1558
28070,213682,5A1FDC762E3A00EF6FB4C515806ADF6A,38911,13,15,2,109.51674,18.24965,1559
28071,213683,5A1FDC762E3A00EF6FB4C515806ADF6A,38291,15,18,3,109.51618,18.24313,1558
28072,213684,5A1FDC762E3A00EF6FB4C515806ADF6A,38911,21,23,2,109.51674,18.24965,1559
28076,213832,301E657A2E52A15D5305B0C9B3D5B8BC,30921,0,8,8,109.53903,18.29451,1667
28077,213842,2D2AA9A27DF87A65B05C7C9802082107,38871,6,10,4,109.44681,18.28625,1316
28078,213843,2D2AA9A27DF87A65B05C7C9802082107,31431,11,12,1,109.44639,18.29042,1316
28079,213844,2D2AA9A27DF87A65B05C7C9802082107,38871,15,16,1,109.44681,18.28625,1316
28080,213845,2D2AA9A27DF87A65B05C7C9802082107,30111,16,18,2,109.47583,18.30542,1419
28081,213846,2D2AA9A27DF87A65B05C7C9802082107,31021,18,19,1,109.49021,18.27,1463
28082,213847,2D2AA9A27DF87A65B05C7C9802082107,31431,21,23,2,109.44639,18.29042,1316
28083,213857,03CEC0FDDD5484124514C6D24A63D4DD,31561,0,19,19,109.56792,18.28479,1765
28084,213858,03CEC0FDDD5484124514C6D24A63D4DD,30854,21,22,1,109.56889,18.27076,1763
28085,213905,7F8955F4F4AC0CABDF46144206275D48,38094,21,23,2,109.45403,18.28778,1316
28089,213950,B7182D0394EEB5B5974D259CBCE91CB4,38241,15,18,3,109.54111,18.30542,1669
28090,213951,B7182D0394EEB5B5974D259CBCE91CB4,31031,19,21,2,109.49979,18.25382,1510
28091,214010,14F1CC63CDA098F9694EAC8584B9C7A5,31041,2,3,1,109.50278,18.23701,1507
28092,214011,14F1CC63CDA098F9694EAC8584B9C7A5,31561,4,22,18,109.56792,18.28479,1765
28093,214015,72DCCAC1A2B013E19459B9B611396AC3,30171,6,10,4,109.48458,18.27139,1463
28094,214016,72DCCAC1A2B013E19459B9B611396AC3,38171,15,19,4,109.50799,18.28139,1515
28095,214017,72DCCAC1A2B013E19459B9B611396AC3,30171,20,23,3,109.48458,18.27139,1463
28096,214036,A6714C443816C19D990E7A07DCADADAD,31206,0,1,1,109.50819,18.23549,1507
28097,214037,A6714C443816C19D990E7A07DCADADAD,60371,1,8,7,109.53063,18.30056,1618
28098,214038,A6714C443816C19D990E7A07DCADADAD,30581,10,13,3,109.62257,18.24951,1959
28099,214039,A6714C443816C19D990E7A07DCADADAD,38271,13,14,1,109.62632,18.23049,1956
28100,214040,A6714C443816C19D990E7A07DCADADAD,38754,15,17,2,109.74667,18.37382,2430
28101,214041,A6714C443816C19D990E7A07DCADADAD,31461,19,20,1,109.5091,18.25389,1510
28102,214042,A6714C443816C19D990E7A07DCADADAD,60371,22,23,1,109.53063,18.30056,1618
28103,214087,96EB2AA1C15710F8D6D518B464991E6E,30711,9,14,5,109.50271,18.25347,1510
28104,214088,96EB2AA1C15710F8D6D518B464991E6E,30711,14,16,2,109.50271,18.25347,1510
28105,214112,1D8B814EC83D52D7C5F3FED99C129EE0,30854,0,9,9,109.56889,18.27076,1763
28106,214113,1D8B814EC83D52D7C5F3FED99C129EE0,38271,10,20,10,109.62632,18.23049,1956
28107,214129,D02479913B5C50E5D55D6F7DB176A542,39183,12,18,6,109.55542,18.28208,1715
28108,214130,D02479913B5C50E5D55D6F7DB176A542,30851,21,22,1,109.5616,18.27396,1713
28109,214131,D02479913B5C50E5D55D6F7DB176A542,39183,22,23,1,109.55542,18.28208,1715
28110,214180,AB8B051428E5E5EDACDABEECED7F5A35,31421,13,17,4,109.55382,18.22347,1705
28111,214181,AB8B051428E5E5EDACDABEECED7F5A35,39371,19,20,1,109.56627,18.2646,1762
28112,214182,AB8B051428E5E5EDACDABEECED7F5A35,31421,20,21,1,109.55382,18.22347,1705
28120,214314,71D35ED12FD809FD321ED1C8285B5582,38951,0,4,4,109.48097,18.28868,1416
28121,214315,71D35ED12FD809FD321ED1C8285B5582,38951,5,7,2,109.48097,18.28868,1416
28122,214316,71D35ED12FD809FD321ED1C8285B5582,30371,7,9,2,109.51,18.24771,1559
28123,214317,71D35ED12FD809FD321ED1C8285B5582,38951,12,21,9,109.48097,18.28868,1416
28124,214327,6BF671BC76B2463D72102139E4EB1018,60371,10,15,5,109.53063,18.30056,1618
28125,214328,6BF671BC76B2463D72102139E4EB1018,38241,16,17,1,109.54111,18.30542,1669
28126,214329,6BF671BC76B2463D72102139E4EB1018,31931,20,22,2,109.54771,18.29403,1667
28127,214391,AB43182259122294244C13D6FC66D4A1,31561,12,18,6,109.56792,18.28479,1765
28128,214392,AB43182259122294244C13D6FC66D4A1,60631,19,23,4,109.57778,18.27583,1814
28129,214406,513EF547BB35B1E6C402224AC99915BE,39111,1,6,5,109.5191,18.22597,1555
28130,214407,513EF547BB35B1E6C402224AC99915BE,31521,7,9,2,109.51458,18.22542,1555
28131,214408,513EF547BB35B1E6C402224AC99915BE,31521,10,16,6,109.51458,18.22542,1555
28132,214409,513EF547BB35B1E6C402224AC99915BE,39321,16,17,1,109.529,18.2167,1604
28133,214410,513EF547BB35B1E6C402224AC99915BE,31521,19,20,1,109.51458,18.22542,1555
28134,214411,513EF547BB35B1E6C402224AC99915BE,60381,21,22,1,109.5241,18.22458,1605
28135,214415,C17A8098B013F904BD9DA05D90234A30,30731,1,8,7,109.50944,18.22306,1555
28136,214416,C17A8098B013F904BD9DA05D90234A30,30581,10,16,6,109.62257,18.24951,1959
28137,214417,C17A8098B013F904BD9DA05D90234A30,30731,19,20,1,109.50944,18.22306,1555
28138,214453,FCFB14BA36BDB7CD6A39612B9AE933B2,31931,14,17,3,109.54771,18.29403,1667
28139,214454,FCFB14BA36BDB7CD6A39612B9AE933B2,60331,20,23,3,109.505,18.26507,1512
28144,214480,ADC7B707FBBD7BF3F9ACE0C092DAADE5,31931,16,17,1,109.54771,18.29403,1667
28145,214481,ADC7B707FBBD7BF3F9ACE0C092DAADE5,30921,17,19,2,109.53903,18.29451,1667
28146,214482,ADC7B707FBBD7BF3F9ACE0C092DAADE5,31931,20,21,1,109.54771,18.29403,1667
28150,214532,FD588CE6BF8E5F650A7E883677D290AD,60201,0,10,10,109.5041,18.2509,1510
28151,214533,FD588CE6BF8E5F650A7E883677D290AD,31145,14,15,1,109.20431,18.30479,369
28152,214534,FD588CE6BF8E5F650A7E883677D290AD,31781,15,16,1,109.19847,18.2975,367
28153,214584,AAC7E9546787DDB508C41969C1E453E7,30711,0,1,1,109.50271,18.25347,1510
28154,214585,AAC7E9546787DDB508C41969C1E453E7,30421,2,12,10,109.50021,18.25861,1511
28155,214586,AAC7E9546787DDB508C41969C1E453E7,31031,12,14,2,109.49979,18.25382,1510
28156,214587,AAC7E9546787DDB508C41969C1E453E7,60114,16,17,1,109.73028,18.33847,2374
28157,214588,AAC7E9546787DDB508C41969C1E453E7,30771,19,21,2,109.49938,18.26042,1511
28158,214589,AAC7E9546787DDB508C41969C1E453E7,30421,21,23,2,109.50021,18.25861,1511
28159,214600,4053323049FA57896819CD5356E38746,31071,0,6,6,109.58257,18.28458,1815
28160,214601,4053323049FA57896819CD5356E38746,30854,6,23,17,109.56889,18.27076,1763
28164,214684,CDF76DCF3BBF11957A82B60E762E0DF7,31201,0,6,6,109.51042,18.23819,1558
28165,214685,CDF76DCF3BBF11957A82B60E762E0DF7,31121,7,12,5,109.16292,18.37063,230
28166,214686,CDF76DCF3BBF11957A82B60E762E0DF7,31201,14,17,3,109.51042,18.23819,1558
28167,214687,CDF76DCF3BBF11957A82B60E762E0DF7,60661,20,22,2,109.548,18.2377,1657
28168,214696,A05C5224EBD39E4769ABC987F547C22B,31611,0,6,6,109.63076,18.34944,2026
28169,214697,A05C5224EBD39E4769ABC987F547C22B,31061,8,10,2,109.53333,18.23257,1607
28170,214698,A05C5224EBD39E4769ABC987F547C22B,30051,14,16,2,109.48917,18.21215,1453
28171,214699,A05C5224EBD39E4769ABC987F547C22B,31061,19,20,1,109.53333,18.23257,1607
28172,214700,A05C5224EBD39E4769ABC987F547C22B,31611,21,23,2,109.63076,18.34944,2026
28173,214708,6C0260646767B781577B5B8CE2471E51,38484,0,13,13,109.53028,18.31528,1620
28174,214709,6C0260646767B781577B5B8CE2471E51,31521,14,20,6,109.51458,18.22542,1555
28175,214710,6C0260646767B781577B5B8CE2471E51,38484,22,23,1,109.53028,18.31528,1620
28176,214714,20C15B76A1E0DF79D86EDEAC7BC3D7B7,30511,0,1,1,109.51069,18.24208,1558
28177,214715,20C15B76A1E0DF79D86EDEAC7BC3D7B7,31071,2,8,6,109.58257,18.28458,1815
28178,214721,895819ED5A8DD11C7D2D0F75F1A32EF3,30232,2,17,15,109.6191,18.31701,1971
28179,214722,895819ED5A8DD11C7D2D0F75F1A32EF3,30854,19,21,2,109.56889,18.27076,1763
28180,214723,AFCD9EE6DC5FA934D04A396BCB0F342C,38061,0,7,7,109.50597,18.23118,1506
28181,214725,AFCD9EE6DC5FA934D04A396BCB0F342C,38061,18,23,5,109.50597,18.23118,1506
28193,214863,A88B35A7108477CCC954BD53412ECC82,31951,0,11,11,109.52174,18.30299,1568
28197,214914,B2035C0684FF9CA861B7EB217CE5A160,60331,0,6,6,109.505,18.26507,1512
28198,214915,B2035C0684FF9CA861B7EB217CE5A160,30809,9,11,2,109.4891,18.28229,1465
28199,214916,B2035C0684FF9CA861B7EB217CE5A160,31471,14,15,1,109.34583,18.29563,917
28200,214917,B2035C0684FF9CA861B7EB217CE5A160,30201,20,23,3,109.4909,18.26465,1462
28204,214986,9ABDF6B7269693E50046DC87610AF02C,60171,17,18,1,109.51292,18.30694,1569
28205,214987,9ABDF6B7269693E50046DC87610AF02C,30854,19,22,3,109.56889,18.27076,1763
28206,215038,30CE72A519D49881F23B8123486E3A02,30661,0,4,4,109.37028,18.24361,1008
28207,215039,30CE72A519D49881F23B8123486E3A02,60411,6,14,8,109.32514,18.30854,869
28208,215040,30CE72A519D49881F23B8123486E3A02,31471,16,18,2,109.34583,18.29563,917
28209,215041,30CE72A519D49881F23B8123486E3A02,60411,21,23,2,109.32514,18.30854,869
28210,215055,C4D5CB245E1DDCF5D6C45439D24370A5,30711,10,13,3,109.50271,18.25347,1510
28211,215056,C4D5CB245E1DDCF5D6C45439D24370A5,60331,13,15,2,109.505,18.26507,1512
28216,215080,7759EF7DB89C14B0A835B8F55ECF34F6,38052,19,20,1,109.62618,18.23042,1956
28217,215081,7759EF7DB89C14B0A835B8F55ECF34F6,60594,20,22,2,109.62694,18.22799,1956
28221,215145,798BF3B08F72A16A6DEAAA235F1899BB,61011,1,7,6,109.60653,18.19076,1900
28222,215147,798BF3B08F72A16A6DEAAA235F1899BB,61011,13,20,7,109.60653,18.19076,1900
28223,215149,AB2302AD7944C06CE36272AAFB1B4F9D,31071,0,6,6,109.58257,18.28458,1815
28224,215150,AB2302AD7944C06CE36272AAFB1B4F9D,31271,10,12,2,109.48958,18.26257,1462
28225,215151,AB2302AD7944C06CE36272AAFB1B4F9D,31101,13,15,2,109.65389,18.23403,2057
28226,215152,AB2302AD7944C06CE36272AAFB1B4F9D,30854,17,19,2,109.56889,18.27076,1763
28227,215153,AB2302AD7944C06CE36272AAFB1B4F9D,38071,21,22,1,109.40722,18.30938,1169
28231,215226,9663F099E8404BD79B503843A8139A66,31701,13,16,3,109.44132,18.28833,1266
28232,215227,9663F099E8404BD79B503843A8139A66,31071,19,20,1,109.58257,18.28458,1815
28233,215228,9663F099E8404BD79B503843A8139A66,31701,21,23,2,109.44132,18.28833,1266
28234,215252,0C412ED9747C602710D1782A20EF4EFD,60201,9,11,2,109.5041,18.2509,1510
28235,215269,7E2EA58FE60AC1C253C1CC188337CCC8,39041,1,12,11,109.40021,18.29278,1117
28236,215270,7E2EA58FE60AC1C253C1CC188337CCC8,31031,13,15,2,109.49979,18.25382,1510
28237,215271,7E2EA58FE60AC1C253C1CC188337CCC8,30681,15,16,1,109.48493,18.26917,1463
28238,215272,7E2EA58FE60AC1C253C1CC188337CCC8,30391,16,18,2,109.4975,18.27118,1513
28239,215273,7E2EA58FE60AC1C253C1CC188337CCC8,30711,19,21,2,109.50271,18.25347,1510
28246,215355,0C0D5781C6ACB120CCF29A5B55073E7D,38271,1,6,5,109.62632,18.23049,1956
28247,215356,0C0D5781C6ACB120CCF29A5B55073E7D,31781,11,13,2,109.19847,18.2975,367
28248,215357,0C0D5781C6ACB120CCF29A5B55073E7D,30361,17,18,1,109.50347,18.24,1508
28255,215383,942FD8205298EEBE7ED108DC820DF6A5,39081,13,14,1,109.19382,18.29111,366
28256,215384,942FD8205298EEBE7ED108DC820DF6A5,31521,16,22,6,109.51458,18.22542,1555
28257,215385,1B6EBBFF3B9D8A3E18753343B6A29EAE,31071,0,6,6,109.58257,18.28458,1815
28258,215386,1B6EBBFF3B9D8A3E18753343B6A29EAE,31561,10,11,1,109.56792,18.28479,1765
28259,215387,1B6EBBFF3B9D8A3E18753343B6A29EAE,31071,12,13,1,109.58257,18.28458,1815
28260,215388,1B6EBBFF3B9D8A3E18753343B6A29EAE,30851,17,18,1,109.5616,18.27396,1713
28261,215389,1B6EBBFF3B9D8A3E18753343B6A29EAE,31071,20,23,3,109.58257,18.28458,1815
28262,215404,EC89B2FFE00F967E6D0A3B697A6D636D,31071,0,4,4,109.58257,18.28458,1815
28263,215405,EC89B2FFE00F967E6D0A3B697A6D636D,31071,5,6,1,109.58257,18.28458,1815
28264,215406,EC89B2FFE00F967E6D0A3B697A6D636D,30854,8,10,2,109.56889,18.27076,1763
28265,215407,EC89B2FFE00F967E6D0A3B697A6D636D,31071,11,13,2,109.58257,18.28458,1815
28266,215408,EC89B2FFE00F967E6D0A3B697A6D636D,30854,13,15,2,109.56889,18.27076,1763
28267,215409,EC89B2FFE00F967E6D0A3B697A6D636D,31071,16,21,5,109.58257,18.28458,1815
28268,215410,EC89B2FFE00F967E6D0A3B697A6D636D,31071,21,22,1,109.58257,18.28458,1815
28269,215463,4D4289AE0DFBF4B5C79A47559DC2EBDD,30854,14,15,1,109.56889,18.27076,1763
28270,215464,4D4289AE0DFBF4B5C79A47559DC2EBDD,30271,18,20,2,109.49132,18.23153,1456
28271,215465,4D4289AE0DFBF4B5C79A47559DC2EBDD,30854,21,22,1,109.56889,18.27076,1763
28272,215470,DFD2E125802FB9E2FB2F393417866810,31071,19,22,3,109.58257,18.28458,1815
28273,215471,DFD2E125802FB9E2FB2F393417866810,31071,22,23,1,109.58257,18.28458,1815
28274,215479,68DBE0B52FD0AB95F1DD47068FD7847F,60311,0,5,5,109.52097,18.24319,1558
28275,215480,68DBE0B52FD0AB95F1DD47068FD7847F,30181,9,11,2,109.51597,18.23313,1557
28276,215481,68DBE0B52FD0AB95F1DD47068FD7847F,60311,12,14,2,109.52097,18.24319,1558
28277,215482,68DBE0B52FD0AB95F1DD47068FD7847F,30181,18,20,2,109.51597,18.23313,1557
28278,215483,68DBE0B52FD0AB95F1DD47068FD7847F,60311,20,22,2,109.52097,18.24319,1558
28279,215494,1D73A39CD9D00E7A842906C3097D7487,30851,14,15,1,109.5616,18.27396,1713
28280,215495,1D73A39CD9D00E7A842906C3097D7487,31561,16,18,2,109.56792,18.28479,1765
28281,215496,1D73A39CD9D00E7A842906C3097D7487,31461,20,23,3,109.5091,18.25389,1510
28282,215513,7A9EDF4DC03F94839B13F40FCA0FD567,60661,0,12,12,109.548,18.2377,1657
28283,215514,7A9EDF4DC03F94839B13F40FCA0FD567,60171,15,16,1,109.51292,18.30694,1569
28284,215515,7A9EDF4DC03F94839B13F40FCA0FD567,60661,20,21,1,109.548,18.2377,1657
28285,215543,794109BFC4D0C5504E1A62AB391C7DDC,30181,11,13,2,109.51597,18.23313,1557
28286,215544,794109BFC4D0C5504E1A62AB391C7DDC,31521,13,15,2,109.51458,18.22542,1555
28287,215545,794109BFC4D0C5504E1A62AB391C7DDC,30181,16,23,7,109.51597,18.23313,1557
28288,215552,FBD855000564CE6EC034501219E56C85,30741,0,6,6,109.49833,18.28681,1516
28289,215553,FBD855000564CE6EC034501219E56C85,31781,7,14,7,109.19847,18.2975,367
28290,215554,FBD855000564CE6EC034501219E56C85,31031,16,19,3,109.49979,18.25382,1510
28291,215555,FBD855000564CE6EC034501219E56C85,30171,19,22,3,109.48458,18.27139,1463
28292,215563,BF81F972CCF4D6D938A0BB87928D3D21,31521,0,9,9,109.51458,18.22542,1555
28293,215564,BF81F972CCF4D6D938A0BB87928D3D21,31781,10,12,2,109.19847,18.2975,367
28294,215565,BF81F972CCF4D6D938A0BB87928D3D21,60381,14,16,2,109.5241,18.22458,1605
28295,215566,BF81F972CCF4D6D938A0BB87928D3D21,30421,19,20,1,109.50021,18.25861,1511
28296,215567,BF81F972CCF4D6D938A0BB87928D3D21,31521,21,23,2,109.51458,18.22542,1555
28297,215605,172CB232BBE684655CFBDFD055BB1CB5,60491,0,14,14,109.43354,18.30847,1269
28298,215606,172CB232BBE684655CFBDFD055BB1CB5,60551,15,23,8,109.42722,18.30111,1218
28302,215660,F91D2D97BDB5B9086FEBA7934E43CF03,60421,0,7,7,109.46333,18.31743,1371
28309,215779,A795428793D2273B4ACFDADC5E61AEC2,60661,11,12,1,109.548,18.2377,1657
28310,215780,A795428793D2273B4ACFDADC5E61AEC2,31061,13,17,4,109.53333,18.23257,1607
28311,215818,15195C578D4A8081B069C4B518039EFC,60231,6,8,2,109.49903,18.21972,1504
28312,215819,15195C578D4A8081B069C4B518039EFC,60084,8,11,3,109.4984,18.2334,1507
28313,215820,15195C578D4A8081B069C4B518039EFC,60231,15,22,7,109.49903,18.21972,1504
28314,215842,7F6E66BC10419161F6457A6D79258EDB,60401,8,10,2,109.47444,18.27583,1414
28315,215843,7F6E66BC10419161F6457A6D79258EDB,38094,10,11,1,109.45403,18.28778,1316
28316,215844,7F6E66BC10419161F6457A6D79258EDB,31031,12,14,2,109.49979,18.25382,1510
28317,215845,7F6E66BC10419161F6457A6D79258EDB,31431,14,15,1,109.44639,18.29042,1316
28318,215846,7F6E66BC10419161F6457A6D79258EDB,60621,19,23,4,109.48354,18.27451,1464
28319,215856,3E314B350F6DFD63303B103E9B7D6941,31521,0,5,5,109.51458,18.22542,1555
28320,215857,3E314B350F6DFD63303B103E9B7D6941,31781,9,11,2,109.19847,18.2975,367
28321,215858,3E314B350F6DFD63303B103E9B7D6941,31471,14,16,2,109.34583,18.29563,917
28322,215859,AAD6CC23C5CDBF026C42805D3EA95680,60552,0,5,5,109.41729,18.30014,1218
28323,215860,AAD6CC23C5CDBF026C42805D3EA95680,31461,10,11,1,109.5091,18.25389,1510
28324,215865,1E2DBE5C967C66E080BAF11FED240B2A,30711,10,12,2,109.50271,18.25347,1510
28325,215866,1E2DBE5C967C66E080BAF11FED240B2A,31181,13,15,2,109.50382,18.24813,1509
28326,215867,1E2DBE5C967C66E080BAF11FED240B2A,31031,16,20,4,109.49979,18.25382,1510
28327,215868,1E2DBE5C967C66E080BAF11FED240B2A,31181,20,22,2,109.50382,18.24813,1509
28328,215873,3B4B2DFBA1D31CE7FAD823FC175E4B2C,31864,0,8,8,109.49014,18.28333,1465
28329,215874,3B4B2DFBA1D31CE7FAD823FC175E4B2C,31101,9,12,3,109.65389,18.23403,2057
28330,215875,3B4B2DFBA1D31CE7FAD823FC175E4B2C,30581,13,14,1,109.62257,18.24951,1959
28331,215876,3B4B2DFBA1D31CE7FAD823FC175E4B2C,30271,19,21,2,109.49132,18.23153,1456
28332,215877,3B4B2DFBA1D31CE7FAD823FC175E4B2C,60084,21,22,1,109.4984,18.2334,1507
28333,215883,372A5433078073EAD18922D679CE0A73,60054,0,1,1,109.3016,18.31229,770
28334,215884,372A5433078073EAD18922D679CE0A73,30661,2,3,1,109.37028,18.24361,1008
28335,215885,372A5433078073EAD18922D679CE0A73,60411,7,18,11,109.32514,18.30854,869
28336,215886,372A5433078073EAD18922D679CE0A73,30661,21,23,2,109.37028,18.24361,1008
28337,215894,F9F80EDABF5B8107FB24FA24BEE7566E,39151,0,4,4,109.49875,18.25097,1510
28338,215895,F9F80EDABF5B8107FB24FA24BEE7566E,60201,4,8,4,109.5041,18.2509,1510
28339,215896,F9F80EDABF5B8107FB24FA24BEE7566E,60161,8,9,1,109.49174,18.26181,1461
28340,215897,F9F80EDABF5B8107FB24FA24BEE7566E,60211,12,13,1,109.63549,18.26049,2011
28341,215910,50F6E2D553B36EAFE6AA22613C3D5EDD,30191,0,7,7,109.50361,18.22701,1506
28342,215911,50F6E2D553B36EAFE6AA22613C3D5EDD,31521,7,9,2,109.51458,18.22542,1555
28343,215912,50F6E2D553B36EAFE6AA22613C3D5EDD,39321,11,13,2,109.529,18.2167,1604
28344,215913,50F6E2D553B36EAFE6AA22613C3D5EDD,60401,16,19,3,109.47444,18.27583,1414
28345,215914,50F6E2D553B36EAFE6AA22613C3D5EDD,38157,19,20,1,109.51483,18.26958,1563
28346,215961,638A4C82143660BDE3EA7A4291713A14,38871,6,8,2,109.44681,18.28625,1316
28347,215962,638A4C82143660BDE3EA7A4291713A14,60411,11,15,4,109.32514,18.30854,869
28348,215968,7D9FE20353178BD0E18334ADA0227839,38903,3,5,2,109.39229,18.29243,1117
28349,215969,7D9FE20353178BD0E18334ADA0227839,31145,9,10,1,109.20431,18.30479,369
28350,215979,A6CF31A63571639AB283D5F43FB98748,31441,18,20,2,109.51181,18.24424,1559
28351,215980,A6CF31A63571639AB283D5F43FB98748,31201,20,23,3,109.51042,18.23819,1558
28352,216014,A7BE283E59850CFEF23FCDC9B4A2FEF4,30731,0,21,21,109.50944,18.22306,1555
28353,216015,A7BE283E59850CFEF23FCDC9B4A2FEF4,39321,22,23,1,109.529,18.2167,1604
28354,216055,943AD2B0B23FF40406FC81AD8E89FDB0,30201,0,9,9,109.4909,18.26465,1462
28355,216056,943AD2B0B23FF40406FC81AD8E89FDB0,31181,12,13,1,109.50382,18.24813,1509
28356,216057,943AD2B0B23FF40406FC81AD8E89FDB0,31271,14,15,1,109.48958,18.26257,1462
28357,216058,943AD2B0B23FF40406FC81AD8E89FDB0,30201,15,21,6,109.4909,18.26465,1462
28358,216059,943AD2B0B23FF40406FC81AD8E89FDB0,31271,21,23,2,109.48958,18.26257,1462
28359,216076,1CB1A7233BC41BA057D58445B53DCE0D,38903,0,6,6,109.39229,18.29243,1117
28360,216077,1CB1A7233BC41BA057D58445B53DCE0D,60552,8,10,2,109.41729,18.30014,1218
28361,216078,1CB1A7233BC41BA057D58445B53DCE0D,38754,12,16,4,109.74667,18.37382,2430
28362,216081,45FC4D7B7AEB1BB8222449DDC064C06B,31945,0,6,6,109.58021,18.29403,1817
28363,216082,45FC4D7B7AEB1BB8222449DDC064C06B,30854,10,11,1,109.56889,18.27076,1763
28364,216083,45FC4D7B7AEB1BB8222449DDC064C06B,31945,13,18,5,109.58021,18.29403,1817
28365,216084,45FC4D7B7AEB1BB8222449DDC064C06B,30201,19,20,1,109.4909,18.26465,1462
28366,216085,45FC4D7B7AEB1BB8222449DDC064C06B,31071,22,23,1,109.58257,18.28458,1815
28373,216294,0442B38E8824E569B00E80CCEFC70940,39183,9,10,1,109.55542,18.28208,1715
28374,216295,0442B38E8824E569B00E80CCEFC70940,31561,13,16,3,109.56792,18.28479,1765
28375,216296,0442B38E8824E569B00E80CCEFC70940,39183,16,18,2,109.55542,18.28208,1715
28376,216297,0442B38E8824E569B00E80CCEFC70940,31561,18,23,5,109.56792,18.28479,1765
28381,216328,33D03C41649B47EDC5176C93FF6F1D8D,30661,1,2,1,109.37028,18.24361,1008
28382,216329,33D03C41649B47EDC5176C93FF6F1D8D,60411,4,8,4,109.32514,18.30854,869
28383,216330,33D03C41649B47EDC5176C93FF6F1D8D,30661,11,17,6,109.37028,18.24361,1008
28384,216331,33D03C41649B47EDC5176C93FF6F1D8D,60411,18,23,5,109.32514,18.30854,869
28385,216332,490A5F2D9652290BBCEA32DFC103B993,60331,15,17,2,109.505,18.26507,1512
28386,216333,490A5F2D9652290BBCEA32DFC103B993,30201,17,18,1,109.4909,18.26465,1462
28387,216334,490A5F2D9652290BBCEA32DFC103B993,31031,19,20,1,109.49979,18.25382,1510
28388,216393,4F49ADA2EE71E2E5C2D426996D3142E6,30661,13,14,1,109.37028,18.24361,1008
28389,216394,4F49ADA2EE71E2E5C2D426996D3142E6,60411,15,22,7,109.32514,18.30854,869
28394,216434,5D19AE00A7DE9CA9A8F4923462026C8B,31231,1,6,5,109.42597,18.29292,1217
28395,216436,5D19AE00A7DE9CA9A8F4923462026C8B,60381,16,18,2,109.5241,18.22458,1605
28396,216437,5D19AE00A7DE9CA9A8F4923462026C8B,31031,19,20,1,109.49979,18.25382,1510
28397,216438,5D19AE00A7DE9CA9A8F4923462026C8B,60081,20,22,2,109.51097,18.22639,1556
28398,216448,8621CFDF1B89A83351494618C53D033F,31071,0,5,5,109.58257,18.28458,1815
28399,216449,8621CFDF1B89A83351494618C53D033F,39181,6,11,5,109.55153,18.28035,1715
28400,216450,8621CFDF1B89A83351494618C53D033F,31071,11,14,3,109.58257,18.28458,1815
28401,216451,8621CFDF1B89A83351494618C53D033F,39181,14,21,7,109.55153,18.28035,1715
28402,216452,8621CFDF1B89A83351494618C53D033F,31071,22,23,1,109.58257,18.28458,1815
28403,216511,BE7763F8096EB5A037146E1CC4190538,31561,11,13,2,109.56792,18.28479,1765
28404,216512,BE7763F8096EB5A037146E1CC4190538,30854,13,15,2,109.56889,18.27076,1763
28405,216519,E8BE10EF1C0A6A216F7B6C008ED029A8,60371,0,7,7,109.53063,18.30056,1618
28406,216520,E8BE10EF1C0A6A216F7B6C008ED029A8,31571,8,11,3,109.61563,18.23326,1957
28407,216547,AE1D2CB811A45E9D0BA691392CEA1100,31071,15,16,1,109.58257,18.28458,1815
28408,216548,AE1D2CB811A45E9D0BA691392CEA1100,31071,17,19,2,109.58257,18.28458,1815
28409,216549,AE1D2CB811A45E9D0BA691392CEA1100,30854,20,22,2,109.56889,18.27076,1763
28414,216720,CD3BCBAB8571FB81953C842A434E5DB8,31071,8,16,8,109.58257,18.28458,1815
28415,216721,CD3BCBAB8571FB81953C842A434E5DB8,30854,16,17,1,109.56889,18.27076,1763
28423,216843,E27729CF5C68766C958C34CEBE1241B2,30351,0,10,10,109.41701,18.29292,1217
28424,216844,E27729CF5C68766C958C34CEBE1241B2,38671,12,13,1,109.41576,18.29285,1167
28425,216845,E27729CF5C68766C958C34CEBE1241B2,31251,14,15,1,109.18528,18.2975,317
28426,216846,E27729CF5C68766C958C34CEBE1241B2,38671,17,19,2,109.41576,18.29285,1167
28427,216847,E27729CF5C68766C958C34CEBE1241B2,31231,19,21,2,109.42597,18.29292,1217
28428,216892,4879DE9CACF93CF08E9DC08004A43027,38951,14,18,4,109.48097,18.28868,1416
28429,216893,4879DE9CACF93CF08E9DC08004A43027,30721,19,21,2,109.51597,18.28257,1565
28434,216944,0402BD114B7D5E20705E302B756CD062,31071,0,7,7,109.58257,18.28458,1815
28435,216945,0402BD114B7D5E20705E302B756CD062,30854,8,11,3,109.56889,18.27076,1763
28436,216946,0402BD114B7D5E20705E302B756CD062,60631,12,13,1,109.57778,18.27583,1814
28437,216947,0402BD114B7D5E20705E302B756CD062,30854,15,21,6,109.56889,18.27076,1763
28438,216948,0402BD114B7D5E20705E302B756CD062,31071,21,23,2,109.58257,18.28458,1815
28451,217036,59B48C7DD533E36B4AA6ADABEB53F8C6,60631,0,6,6,109.57778,18.27583,1814
28452,217037,59B48C7DD533E36B4AA6ADABEB53F8C6,31571,7,9,2,109.61563,18.23326,1957
28453,217038,59B48C7DD533E36B4AA6ADABEB53F8C6,60591,11,16,5,109.61118,18.21715,1904
28454,217053,063A6C1319C2FB8D51BDBDBC79DDAACC,39131,1,4,3,109.2066,18.29639,417
28455,217054,063A6C1319C2FB8D51BDBDBC79DDAACC,31781,9,11,2,109.19847,18.2975,367
28456,217147,179FD4660C817BD29234A518F00339D3,60231,0,10,10,109.49903,18.21972,1504
28457,217148,179FD4660C817BD29234A518F00339D3,60161,14,18,4,109.49174,18.26181,1461
28458,217165,13664B2E5419DDA8E26BAB65AA04153C,31861,19,21,2,109.49042,18.27549,1464
28459,217166,13664B2E5419DDA8E26BAB65AA04153C,31181,21,23,2,109.50382,18.24813,1509
28460,217194,B7A2800FDF738E1064EAD2A5E58F7A3C,61011,1,5,4,109.60653,18.19076,1900
28461,217196,B7A2800FDF738E1064EAD2A5E58F7A3C,61011,19,23,4,109.60653,18.19076,1900
28462,217233,0C8D15C0488D521680F0DE3A28CFE111,31811,0,6,6,109.54201,18.31806,1671
28463,217234,0C8D15C0488D521680F0DE3A28CFE111,30701,7,8,1,109.59313,18.32007,1871
28464,217235,0C8D15C0488D521680F0DE3A28CFE111,31811,10,12,2,109.54201,18.31806,1671
28465,217236,0C8D15C0488D521680F0DE3A28CFE111,30701,12,15,3,109.59313,18.32007,1871
28466,217237,0C8D15C0488D521680F0DE3A28CFE111,31811,20,21,1,109.54201,18.31806,1671
28467,217238,0C8D15C0488D521680F0DE3A28CFE111,30701,22,23,1,109.59313,18.32007,1871
28474,217299,F621296F333E8058687ACD884B135C6E,60114,2,7,5,109.73028,18.33847,2374
28475,217300,F621296F333E8058687ACD884B135C6E,31901,11,13,2,109.68236,18.35368,2227
28476,217360,2B3A265A9E3070334490C5E224B5CAE0,31421,7,9,2,109.55382,18.22347,1705
28477,217361,2B3A265A9E3070334490C5E224B5CAE0,30854,13,14,1,109.56889,18.27076,1763
28478,217362,2B3A265A9E3070334490C5E224B5CAE0,31071,18,22,4,109.58257,18.28458,1815
28486,217458,14DC9638CB494ECD60B58F300BAA61B6,38154,0,6,6,109.5266,18.28278,1615
28487,217459,14DC9638CB494ECD60B58F300BAA61B6,31931,7,9,2,109.54771,18.29403,1667
28488,217460,14DC9638CB494ECD60B58F300BAA61B6,39181,10,13,3,109.55153,18.28035,1715
28489,217461,14DC9638CB494ECD60B58F300BAA61B6,31561,15,16,1,109.56792,18.28479,1765
28490,217462,14DC9638CB494ECD60B58F300BAA61B6,38154,19,23,4,109.5266,18.28278,1615
28491,217473,372BCC9E34709FCD9ED7D887E115E777,31561,0,7,7,109.56792,18.28479,1765
28492,217474,372BCC9E34709FCD9ED7D887E115E777,30854,7,9,2,109.56889,18.27076,1763
28493,217475,372BCC9E34709FCD9ED7D887E115E777,31071,14,15,1,109.58257,18.28458,1815
28494,217476,372BCC9E34709FCD9ED7D887E115E777,31071,15,16,1,109.58257,18.28458,1815
28495,217477,372BCC9E34709FCD9ED7D887E115E777,31071,18,21,3,109.58257,18.28458,1815
28496,217478,4EC716C6116001DCCA61DAB5E48F9371,30421,12,13,1,109.50021,18.25861,1511
28497,217479,4EC716C6116001DCCA61DAB5E48F9371,31781,15,17,2,109.19847,18.2975,367
28498,217480,4EC716C6116001DCCA61DAB5E48F9371,60421,20,21,1,109.46333,18.31743,1371
28502,217532,3E1EE5C3B3EA02D05BA98946F054AD5C,38291,21,22,1,109.51618,18.24313,1558
28503,217533,2B8C748A18FA7D08D4335AD7C9DEF01B,30851,10,14,4,109.5616,18.27396,1713
28504,217534,2B8C748A18FA7D08D4335AD7C9DEF01B,31761,18,23,5,109.60521,18.27965,1914
28505,217541,48EC852B1939DE9DE8D67EA49BF6D736,30071,13,14,1,109.52819,18.30472,1619
28506,217542,48EC852B1939DE9DE8D67EA49BF6D736,60171,18,19,1,109.51292,18.30694,1569
28507,217543,DED64374A4602648AE7C998119F6E01F,60171,12,14,2,109.51292,18.30694,1569
28508,217544,DED64374A4602648AE7C998119F6E01F,30381,19,20,1,109.52521,18.24507,1609
28509,217561,6587551DA47309E484D1302521C8D417,60631,1,6,5,109.57778,18.27583,1814
28510,217562,6587551DA47309E484D1302521C8D417,38275,7,22,15,109.62875,18.22938,2006
28511,217563,01C3A40E8C2D18FB80BE4CD2C78B4B61,39091,0,12,12,109.50097,18.25222,1510
28512,217564,01C3A40E8C2D18FB80BE4CD2C78B4B61,39091,15,21,6,109.50097,18.25222,1510
28513,217583,DA10676C4DA702E02A2C3FFFAC40ABA2,30211,9,10,1,109.49882,18.23931,1508
28514,217584,DA10676C4DA702E02A2C3FFFAC40ABA2,31561,12,22,10,109.56792,18.28479,1765
28515,217589,3977578BE56276DA0700B04B81DC1356,31561,7,11,4,109.56792,18.28479,1765
28516,217590,3977578BE56276DA0700B04B81DC1356,30851,11,16,5,109.5616,18.27396,1713
28517,217610,671F8FFC6DE1C9E23B99BCA5E485BAC3,30084,2,9,7,109.50118,18.26972,1513
28518,217611,671F8FFC6DE1C9E23B99BCA5E485BAC3,30441,11,12,1,109.64021,18.25424,2010
28519,217612,671F8FFC6DE1C9E23B99BCA5E485BAC3,60401,16,20,4,109.47444,18.27583,1414
28520,217613,671F8FFC6DE1C9E23B99BCA5E485BAC3,30201,22,23,1,109.4909,18.26465,1462
28529,217721,44FF3F3995A0081423CE688C5217DF97,31864,18,19,1,109.49014,18.28333,1465
28530,217722,44FF3F3995A0081423CE688C5217DF97,38903,22,23,1,109.39229,18.29243,1117
28531,217742,1D4558B4C0B5F77B61048106C84086AA,31091,0,5,5,109.41201,18.31222,1170
28532,217743,1D4558B4C0B5F77B61048106C84086AA,31231,6,10,4,109.42597,18.29292,1217
28544,217802,451E2BF48CD7B253EB0892324E679BCC,60311,1,2,1,109.52097,18.24319,1558
28545,217803,451E2BF48CD7B253EB0892324E679BCC,38297,3,5,2,109.52576,18.24965,1609
28546,217804,451E2BF48CD7B253EB0892324E679BCC,38291,6,13,7,109.51618,18.24313,1558
28547,217805,451E2BF48CD7B253EB0892324E679BCC,60281,13,16,3,109.51743,18.25924,1561
28548,217806,451E2BF48CD7B253EB0892324E679BCC,38291,19,21,2,109.51618,18.24313,1558
28549,217807,451E2BF48CD7B253EB0892324E679BCC,38297,21,22,1,109.52576,18.24965,1609
28554,217849,CB9F456D1275025691EE74018BA9AEE8,60401,6,8,2,109.47444,18.27583,1414
28555,217850,CB9F456D1275025691EE74018BA9AEE8,31231,12,13,1,109.42597,18.29292,1217
28556,217851,CB9F456D1275025691EE74018BA9AEE8,31231,14,16,2,109.42597,18.29292,1217
28557,217856,5ABFF3E8EB470884C270C0C936A89A00,30421,16,19,3,109.50021,18.25861,1511
28561,217925,529A14F498129B0238F7B12A9FC7F6F7,31205,0,1,1,109.51111,18.23736,1557
28562,217926,529A14F498129B0238F7B12A9FC7F6F7,31701,2,5,3,109.44132,18.28833,1266
28563,217927,529A14F498129B0238F7B12A9FC7F6F7,31671,6,8,2,109.38965,18.29813,1068
28564,217928,529A14F498129B0238F7B12A9FC7F6F7,30421,19,21,2,109.50021,18.25861,1511
28565,217929,529A14F498129B0238F7B12A9FC7F6F7,31671,21,23,2,109.38965,18.29813,1068
28566,218004,C2622C284BAD8F487DCD454B3FAF9432,60361,0,8,8,109.51938,18.29681,1567
28567,218005,C2622C284BAD8F487DCD454B3FAF9432,30721,10,11,1,109.51597,18.28257,1565
28568,218006,C2622C284BAD8F487DCD454B3FAF9432,60274,12,13,1,109.514,18.2933,1567
28569,218007,C2622C284BAD8F487DCD454B3FAF9432,31121,17,20,3,109.16292,18.37063,230
28570,218008,C2622C284BAD8F487DCD454B3FAF9432,30721,22,23,1,109.51597,18.28257,1565
28571,218021,5202825DF51CA068C8B204422480230F,31945,1,2,1,109.58021,18.29403,1817
28572,218022,5202825DF51CA068C8B204422480230F,31071,3,6,3,109.58257,18.28458,1815
28573,218050,0E1B3CFC64EBB658DA96D0DCA834701E,61011,10,12,2,109.60653,18.19076,1900
28574,218066,638CB96B52752860DC8C286EB33044A7,31471,0,4,4,109.34583,18.29563,917
28575,218067,638CB96B52752860DC8C286EB33044A7,30661,5,7,2,109.37028,18.24361,1008
28576,218069,348BC15248D83C0CF0D2494FAD03D52E,30201,9,11,2,109.4909,18.26465,1462
28577,218070,348BC15248D83C0CF0D2494FAD03D52E,39053,12,23,11,109.511,18.2771,1564
28578,218071,6CFAB52F14B9F6126A5F32C6F3BFD184,31521,0,8,8,109.51458,18.22542,1555
28579,218072,6CFAB52F14B9F6126A5F32C6F3BFD184,60381,13,14,1,109.5241,18.22458,1605
28580,218073,6CFAB52F14B9F6126A5F32C6F3BFD184,31521,15,16,1,109.51458,18.22542,1555
28581,218074,6CFAB52F14B9F6126A5F32C6F3BFD184,30201,17,19,2,109.4909,18.26465,1462
28582,218075,6CFAB52F14B9F6126A5F32C6F3BFD184,31521,21,22,1,109.51458,18.22542,1555
28586,218105,4F11D612346C7FFB90217D3B5C38FCCC,31236,0,6,6,109.42965,18.29111,1216
28587,218106,4F11D612346C7FFB90217D3B5C38FCCC,31781,9,11,2,109.19847,18.2975,367
28588,218107,4F11D612346C7FFB90217D3B5C38FCCC,31231,16,19,3,109.42597,18.29292,1217
28589,218108,4F11D612346C7FFB90217D3B5C38FCCC,60551,19,21,2,109.42722,18.30111,1218
28590,218109,4F11D612346C7FFB90217D3B5C38FCCC,60524,21,23,2,109.42951,18.28993,1216
28591,218139,A7D270EF8C74F66D966F17A0E3BC8BC9,31071,0,6,6,109.58257,18.28458,1815
28592,218140,A7D270EF8C74F66D966F17A0E3BC8BC9,30854,8,10,2,109.56889,18.27076,1763
28593,218141,A7D270EF8C74F66D966F17A0E3BC8BC9,31071,12,15,3,109.58257,18.28458,1815
28594,218142,A7D270EF8C74F66D966F17A0E3BC8BC9,38891,18,19,1,109.51486,18.24118,1558
28595,218143,A7D270EF8C74F66D966F17A0E3BC8BC9,31071,22,23,1,109.58257,18.28458,1815
28596,218184,6ECBE8E4C20070F8B38521B2287A305F,31145,14,15,1,109.20431,18.30479,369
28597,218185,6ECBE8E4C20070F8B38521B2287A305F,31071,20,23,3,109.58257,18.28458,1815
28607,218218,B0C6DED232762D9BAF78468BD2731104,60541,13,14,1,109.4084,18.29208,1167
28608,218219,B0C6DED232762D9BAF78468BD2731104,30581,19,23,4,109.62257,18.24951,1959
28613,218308,B712327B6033C61F37801CFD6DAC08AD,31951,0,2,2,109.52174,18.30299,1568
28614,218309,B712327B6033C61F37801CFD6DAC08AD,38484,5,22,17,109.53028,18.31528,1620
28615,218330,135D4111C8DB5F7D1A5E83743F59E45E,30851,4,5,1,109.5616,18.27396,1713
28616,218331,135D4111C8DB5F7D1A5E83743F59E45E,31121,7,12,5,109.16292,18.37063,230
28617,218332,135D4111C8DB5F7D1A5E83743F59E45E,31021,13,16,3,109.49021,18.27,1463
28628,218453,7D632B68A96EBB9D6582527232D6634C,31461,0,8,8,109.5091,18.25389,1510
28629,218454,7D632B68A96EBB9D6582527232D6634C,31231,9,11,2,109.42597,18.29292,1217
28630,218455,7D632B68A96EBB9D6582527232D6634C,31461,11,13,2,109.5091,18.25389,1510
28631,218456,7D632B68A96EBB9D6582527232D6634C,31291,15,16,1,109.30375,18.40729,786
28632,218472,4E42F3C8BFACF58FB6187931BEBBDF23,31931,19,20,1,109.54771,18.29403,1667
28633,218473,4E42F3C8BFACF58FB6187931BEBBDF23,38484,21,23,2,109.53028,18.31528,1620
28634,218474,DA7F75EB1D499DC5A1A7DEE3CAD1DCEE,30731,6,8,2,109.50944,18.22306,1555
28635,218475,DA7F75EB1D499DC5A1A7DEE3CAD1DCEE,60631,13,14,1,109.57778,18.27583,1814
28636,218476,DA7F75EB1D499DC5A1A7DEE3CAD1DCEE,39183,17,18,1,109.55542,18.28208,1715
28641,218526,B78E7295CB13532B4E2C30EF158E297F,30854,0,7,7,109.56889,18.27076,1763
28642,218527,B78E7295CB13532B4E2C30EF158E297F,39183,11,20,9,109.55542,18.28208,1715
28643,218556,D6E72F3649E9FA4F285A8682EF1A1E3A,60381,6,8,2,109.5241,18.22458,1605
28644,218557,D6E72F3649E9FA4F285A8682EF1A1E3A,31521,8,14,6,109.51458,18.22542,1555
28645,218558,D6E72F3649E9FA4F285A8682EF1A1E3A,38071,17,19,2,109.40722,18.30938,1169
28646,218561,AA2A5396AD753E9245AC53C94BAEDECD,61011,1,18,17,109.60653,18.19076,1900
28650,218602,44CE0EC5534779B9EE45B4716AA8F607,60221,18,21,3,109.52569,18.29188,1616
28651,218603,44CE0EC5534779B9EE45B4716AA8F607,31461,21,23,2,109.5091,18.25389,1510
28652,218652,999DEB7BFC175BF03EAE5DB1D4B2EFB6,60361,18,20,2,109.51938,18.29681,1567
28653,218653,999DEB7BFC175BF03EAE5DB1D4B2EFB6,31951,22,23,1,109.52174,18.30299,1568
28654,218667,18073AD9E71B8DFC1E520C5E3653B1BD,30721,1,6,5,109.51597,18.28257,1565
28655,218668,18073AD9E71B8DFC1E520C5E3653B1BD,31951,10,14,4,109.52174,18.30299,1568
28656,218669,18073AD9E71B8DFC1E520C5E3653B1BD,31291,19,23,4,109.30375,18.40729,786
28661,218755,8293619D825F160795AE71B17456FBCB,60631,4,5,1,109.57778,18.27583,1814
28662,218756,8293619D825F160795AE71B17456FBCB,30854,8,10,2,109.56889,18.27076,1763
28663,218757,8293619D825F160795AE71B17456FBCB,38071,14,23,9,109.40722,18.30938,1169
28668,218850,A549C024E6F63EDBD3DC866F10DB11CE,30854,18,21,3,109.56889,18.27076,1763
28669,218882,56C816225242DBDB8077A15C902CFC9F,30421,11,13,2,109.50021,18.25861,1511
28670,218883,56C816225242DBDB8077A15C902CFC9F,60351,14,16,2,109.58403,18.28958,1816
28671,218910,9AF351B3CC27394DFED45513F0E32162,31071,0,7,7,109.58257,18.28458,1815
28672,218911,9AF351B3CC27394DFED45513F0E32162,31551,11,13,2,109.55868,18.24222,1708
28673,218912,9AF351B3CC27394DFED45513F0E32162,30951,14,16,2,109.56208,18.25667,1761
28674,218913,9AF351B3CC27394DFED45513F0E32162,60351,18,21,3,109.58403,18.28958,1816
28675,218914,9AF351B3CC27394DFED45513F0E32162,31071,21,23,2,109.58257,18.28458,1815
28676,218915,EF760E312F2C3813DF12E817771E652B,38017,0,7,7,109.49729,18.21424,1504
28677,218916,EF760E312F2C3813DF12E817771E652B,31521,7,9,2,109.51458,18.22542,1555
28678,218917,EF760E312F2C3813DF12E817771E652B,31145,11,12,1,109.20431,18.30479,369
28679,218918,EF760E312F2C3813DF12E817771E652B,31471,16,18,2,109.34583,18.29563,917
28680,218919,EF760E312F2C3813DF12E817771E652B,38017,21,23,2,109.49729,18.21424,1504
28681,218926,86435198F57620D5DAC23B4A4DA78009,31931,3,5,2,109.54771,18.29403,1667
28682,218927,86435198F57620D5DAC23B4A4DA78009,39183,7,15,8,109.55542,18.28208,1715
28683,218933,17CAFA3F8664F13D5B9674760A5254BD,30854,13,14,1,109.56889,18.27076,1763
28684,218934,17CAFA3F8664F13D5B9674760A5254BD,30071,15,16,1,109.52819,18.30472,1619
28685,218935,17CAFA3F8664F13D5B9674760A5254BD,38991,18,19,1,109.52681,18.30368,1618
28689,218994,85586D73EA48B4F4D520D899B0BE0554,30854,13,15,2,109.56889,18.27076,1763
28690,218995,85586D73EA48B4F4D520D899B0BE0554,30291,19,23,4,109.50403,18.27028,1513
28691,219016,10EBF762D28520B09848288F7052CFDE,30854,0,7,7,109.56889,18.27076,1763
28692,219017,10EBF762D28520B09848288F7052CFDE,31561,8,18,10,109.56792,18.28479,1765
28693,219029,C30EF1A03F3ACD87114629BE5EBA14E8,31231,13,14,1,109.42597,18.29292,1217
28694,219030,C30EF1A03F3ACD87114629BE5EBA14E8,31231,17,18,1,109.42597,18.29292,1217
28695,219031,C30EF1A03F3ACD87114629BE5EBA14E8,60041,22,23,1,109.39889,18.31944,1121
28696,219056,546C572FC49C780F9A9AF62ED98666DF,30351,0,21,21,109.41701,18.29292,1217
28697,219057,546C572FC49C780F9A9AF62ED98666DF,30681,22,23,1,109.48493,18.26917,1463
28698,219058,182603D8C7C4BF5CDDF16B2E79D9DF52,31231,0,9,9,109.42597,18.29292,1217
28699,219059,182603D8C7C4BF5CDDF16B2E79D9DF52,60401,12,13,1,109.47444,18.27583,1414
28700,219067,87F6D9996659541EF975AE3E55004A94,38484,13,14,1,109.53028,18.31528,1620
28701,219068,87F6D9996659541EF975AE3E55004A94,31031,15,19,4,109.49979,18.25382,1510
28702,219069,487FC583F0AF1414583ADA3127598053,60631,12,14,2,109.57778,18.27583,1814
28703,219070,487FC583F0AF1414583ADA3127598053,30854,17,19,2,109.56889,18.27076,1763
28704,219082,B09F6CB43F7BB3E6391589239BFB1120,38951,0,12,12,109.48097,18.28868,1416
28705,219083,B09F6CB43F7BB3E6391589239BFB1120,60041,14,16,2,109.39889,18.31944,1121
28706,219084,B09F6CB43F7BB3E6391589239BFB1120,38951,21,23,2,109.48097,18.28868,1416
28710,219129,13166628932DF36C0AD7B1DB5811240A,30854,14,16,2,109.56889,18.27076,1763
28711,219130,13166628932DF36C0AD7B1DB5811240A,60591,19,23,4,109.61118,18.21715,1904
28712,219148,B621E9075674E792CCB217233825F9D1,39371,3,7,4,109.56627,18.2646,1762
28713,219149,B621E9075674E792CCB217233825F9D1,60591,11,14,3,109.61118,18.21715,1904
28714,219150,E605B26D53F08A0D3360A4541E09F4E2,30721,0,5,5,109.51597,18.28257,1565
28715,219151,E605B26D53F08A0D3360A4541E09F4E2,38283,7,8,1,109.62229,18.22618,1956
28716,219152,E605B26D53F08A0D3360A4541E09F4E2,38283,11,23,12,109.62229,18.22618,1956
28717,219156,AAFC39C1714209381987EB0F1F011F0B,39151,0,8,8,109.49875,18.25097,1510
28718,219157,AAFC39C1714209381987EB0F1F011F0B,31031,8,10,2,109.49979,18.25382,1510
28719,219158,AAFC39C1714209381987EB0F1F011F0B,31471,15,16,1,109.34583,18.29563,917
28720,219159,AAFC39C1714209381987EB0F1F011F0B,30361,19,21,2,109.50347,18.24,1508
28721,219160,AAFC39C1714209381987EB0F1F011F0B,39151,21,23,2,109.49875,18.25097,1510
28725,219233,FD383D619F571E97F6F509FAB965E5A5,60291,0,12,12,109.50826,18.24639,1509
28726,219244,7AF4921BC4D1712A961904D0ECC91550,30071,0,7,7,109.52819,18.30472,1619
28727,219245,7AF4921BC4D1712A961904D0ECC91550,30071,8,11,3,109.52819,18.30472,1619
28728,219247,7AF4921BC4D1712A961904D0ECC91550,60291,18,20,2,109.50826,18.24639,1509
28729,219248,7AF4921BC4D1712A961904D0ECC91550,30281,21,23,2,109.50597,18.27583,1514
28730,219249,0F558B6653C655C7F0BAEA9D66B33F57,31071,0,5,5,109.58257,18.28458,1815
28731,219250,0F558B6653C655C7F0BAEA9D66B33F57,30854,8,10,2,109.56889,18.27076,1763
28732,219251,0F558B6653C655C7F0BAEA9D66B33F57,31071,10,13,3,109.58257,18.28458,1815
28733,219252,0F558B6653C655C7F0BAEA9D66B33F57,30854,13,16,3,109.56889,18.27076,1763
28734,219253,0F558B6653C655C7F0BAEA9D66B33F57,31071,19,21,2,109.58257,18.28458,1815
28735,219254,DC6FAC9E4085B298085CB0CDBEACDBC4,60524,0,5,5,109.42951,18.28993,1216
28736,219255,DC6FAC9E4085B298085CB0CDBEACDBC4,60552,6,8,2,109.41729,18.30014,1218
28737,219256,DC6FAC9E4085B298085CB0CDBEACDBC4,31781,9,11,2,109.19847,18.2975,367
28738,219264,1026894DC5FF9A7FAF3A2EE28B95E239,60631,9,10,1,109.57778,18.27583,1814
28739,219265,1026894DC5FF9A7FAF3A2EE28B95E239,30854,11,14,3,109.56889,18.27076,1763
28740,219270,43F5AB52A0AF3FEB5880C6DCD16BBA02,60011,0,7,7,109.48965,18.30222,1468
28741,219271,43F5AB52A0AF3FEB5880C6DCD16BBA02,31411,8,12,4,109.5016,18.23576,1507
28742,219272,43F5AB52A0AF3FEB5880C6DCD16BBA02,39101,15,16,1,109.50132,18.24931,1509
28743,219273,43F5AB52A0AF3FEB5880C6DCD16BBA02,30271,19,21,2,109.49132,18.23153,1456
28744,219311,6E580E35F1856BA2850385BDFB597BF5,39371,0,14,14,109.56627,18.2646,1762
28745,219312,6E580E35F1856BA2850385BDFB597BF5,38891,17,18,1,109.51486,18.24118,1558
28746,219313,A01B4012B619D942E7CC3AC9B78722B4,31561,0,6,6,109.56792,18.28479,1765
28747,219314,A01B4012B619D942E7CC3AC9B78722B4,31931,7,9,2,109.54771,18.29403,1667
28748,219315,A01B4012B619D942E7CC3AC9B78722B4,31561,11,15,4,109.56792,18.28479,1765
28749,219316,A01B4012B619D942E7CC3AC9B78722B4,39183,17,18,1,109.55542,18.28208,1715
28750,219317,A01B4012B619D942E7CC3AC9B78722B4,31561,19,23,4,109.56792,18.28479,1765
28754,219332,C153552CEA2677B0FF473AE565EA979E,30821,0,7,7,109.43681,18.33639,1274
28755,219333,C153552CEA2677B0FF473AE565EA979E,30651,8,9,1,109.42611,18.385,1232
28756,219334,C153552CEA2677B0FF473AE565EA979E,30821,9,11,2,109.43681,18.33639,1274
28757,219335,C153552CEA2677B0FF473AE565EA979E,30651,18,20,2,109.42611,18.385,1232
28758,219336,C153552CEA2677B0FF473AE565EA979E,30821,21,23,2,109.43681,18.33639,1274
28762,219344,8394F4F81295DA567F75BB12D1616CF3,60361,0,6,6,109.51938,18.29681,1567
28763,219345,8394F4F81295DA567F75BB12D1616CF3,60274,7,9,2,109.514,18.2933,1567
28764,219346,8394F4F81295DA567F75BB12D1616CF3,31521,14,16,2,109.51458,18.22542,1555
28765,219347,8394F4F81295DA567F75BB12D1616CF3,60361,20,23,3,109.51938,18.29681,1567
28769,219426,1BDE433888973A22F2D9A5CC8B5A34FF,31251,0,3,3,109.18528,18.2975,317
28770,219427,1BDE433888973A22F2D9A5CC8B5A34FF,30861,7,8,1,109.52722,18.22743,1606
28771,219428,1BDE433888973A22F2D9A5CC8B5A34FF,60661,11,14,3,109.548,18.2377,1657
28776,219461,690F9954285850032888DF5646F55612,38903,0,6,6,109.39229,18.29243,1117
28777,219462,690F9954285850032888DF5646F55612,38325,7,8,1,109.39792,18.2909,1116
28778,219463,690F9954285850032888DF5646F55612,60552,8,10,2,109.41729,18.30014,1218
28779,219464,690F9954285850032888DF5646F55612,38754,11,14,3,109.74667,18.37382,2430
28780,219465,690F9954285850032888DF5646F55612,30671,17,18,1,109.43611,18.30139,1268
28781,219485,D2A5F87218CF25385163A2F3C4229CB8,30851,1,5,4,109.5616,18.27396,1713
28782,219486,D2A5F87218CF25385163A2F3C4229CB8,31561,5,9,4,109.56792,18.28479,1765
28783,219487,D2A5F87218CF25385163A2F3C4229CB8,30851,9,18,9,109.5616,18.27396,1713
28784,219488,D2A5F87218CF25385163A2F3C4229CB8,31561,18,20,2,109.56792,18.28479,1765
28785,219489,D2A5F87218CF25385163A2F3C4229CB8,30851,20,23,3,109.5616,18.27396,1713
28786,219499,DF49F834C08C7E8FA6D78272EE1FB651,60361,0,7,7,109.51938,18.29681,1567
28787,219500,DF49F834C08C7E8FA6D78272EE1FB651,30951,11,14,3,109.56208,18.25667,1761
28788,219501,DF49F834C08C7E8FA6D78272EE1FB651,60361,19,23,4,109.51938,18.29681,1567
28789,219526,BD4652414D5C17466BA36FD4BD943A94,39181,11,13,2,109.55153,18.28035,1715
28790,219527,BD4652414D5C17466BA36FD4BD943A94,31561,15,17,2,109.56792,18.28479,1765
28791,219528,BD4652414D5C17466BA36FD4BD943A94,30421,20,22,2,109.50021,18.25861,1511
28801,219592,D517610C2076C41FED0ED80CB6FFB44C,31561,0,6,6,109.56792,18.28479,1765
28802,219593,D517610C2076C41FED0ED80CB6FFB44C,30851,6,22,16,109.5616,18.27396,1713
28803,219604,6D2D20F4D67580FE7309C23DCCA820C3,31071,0,7,7,109.58257,18.28458,1815
28804,219605,6D2D20F4D67580FE7309C23DCCA820C3,39371,8,9,1,109.56627,18.2646,1762
28805,219606,6D2D20F4D67580FE7309C23DCCA820C3,31421,14,18,4,109.55382,18.22347,1705
28806,219607,6D2D20F4D67580FE7309C23DCCA820C3,31071,20,23,3,109.58257,18.28458,1815
28807,219631,1BF8178261179ACA5D85408F2640E631,60121,16,18,2,109.74507,18.37472,2430
28808,219632,1BF8178261179ACA5D85408F2640E631,30511,21,23,2,109.51069,18.24208,1558
28813,219655,C85D0B931BEF54F05B9ABBBB03212DB7,30854,0,15,15,109.56889,18.27076,1763
28814,219656,C85D0B931BEF54F05B9ABBBB03212DB7,31561,16,17,1,109.56792,18.28479,1765
28818,219802,62FCB15297A7724012720DDE29CC0405,31761,0,8,8,109.60521,18.27965,1914
28819,219803,62FCB15297A7724012720DDE29CC0405,38121,12,14,2,109.51361,18.27813,1564
28820,219804,62FCB15297A7724012720DDE29CC0405,30321,15,17,2,109.49563,18.29611,1467
28821,219805,62FCB15297A7724012720DDE29CC0405,38261,21,23,2,109.50361,18.28153,1515
28822,219833,75817DB682187A07461734D66E1E6492,60631,0,4,4,109.57778,18.27583,1814
28823,219834,75817DB682187A07461734D66E1E6492,30854,7,15,8,109.56889,18.27076,1763
28824,219835,75817DB682187A07461734D66E1E6492,60631,18,20,2,109.57778,18.27583,1814
28825,219836,75817DB682187A07461734D66E1E6492,31061,22,23,1,109.53333,18.23257,1607
28826,219873,005F3AEFE6DBF371ED1FD57736434098,31071,4,7,3,109.58257,18.28458,1815
28827,219874,005F3AEFE6DBF371ED1FD57736434098,30854,8,9,1,109.56889,18.27076,1763
28828,219875,005F3AEFE6DBF371ED1FD57736434098,31071,12,13,1,109.58257,18.28458,1815
28829,219876,005F3AEFE6DBF371ED1FD57736434098,30854,20,21,1,109.56889,18.27076,1763
28830,219877,005F3AEFE6DBF371ED1FD57736434098,31071,21,23,2,109.58257,18.28458,1815
28831,219901,163EFE976A3776107F7F37C28AD840B9,38145,1,2,1,109.378,18.2912,1066
28832,219902,163EFE976A3776107F7F37C28AD840B9,38903,3,7,4,109.39229,18.29243,1117
28833,219903,163EFE976A3776107F7F37C28AD840B9,38754,11,15,4,109.74667,18.37382,2430
28834,219904,163EFE976A3776107F7F37C28AD840B9,60551,19,20,1,109.42722,18.30111,1218
28838,219942,53875E69050EC42E511A64D3211FA7B3,30854,14,17,3,109.56889,18.27076,1763
28839,219943,53875E69050EC42E511A64D3211FA7B3,30851,18,19,1,109.5616,18.27396,1713
28840,219944,53875E69050EC42E511A64D3211FA7B3,60631,20,21,1,109.57778,18.27583,1814
28841,219945,53875E69050EC42E511A64D3211FA7B3,30891,22,23,1,109.59431,18.28389,1865
28845,219989,8D8AA41210FC9E2D5DD4D81CF4DB18D7,39151,17,19,2,109.49875,18.25097,1510
28846,219990,8D8AA41210FC9E2D5DD4D81CF4DB18D7,31421,19,21,2,109.55382,18.22347,1705
28847,219991,8D8AA41210FC9E2D5DD4D81CF4DB18D7,60361,21,22,1,109.51938,18.29681,1567
28851,220011,BAB9B8A3D1E7FB96DB94A06687C464B3,31471,13,14,1,109.34583,18.29563,917
28852,220012,BAB9B8A3D1E7FB96DB94A06687C464B3,38094,16,18,2,109.45403,18.28778,1316
28853,220013,BAB9B8A3D1E7FB96DB94A06687C464B3,31864,19,23,4,109.49014,18.28333,1465
28854,220016,ABCD0851CC1C78BCD7AF6DBDF2F5DE49,60552,7,10,3,109.41729,18.30014,1218
28855,220017,ABCD0851CC1C78BCD7AF6DBDF2F5DE49,30671,14,18,4,109.43611,18.30139,1268
28859,220099,B643AC77F8D8498A9694D45BA8B0F75F,60631,0,8,8,109.57778,18.27583,1814
28860,220100,B643AC77F8D8498A9694D45BA8B0F75F,30854,9,11,2,109.56889,18.27076,1763
28861,220101,B643AC77F8D8498A9694D45BA8B0F75F,60631,12,14,2,109.57778,18.27583,1814
28862,220102,B643AC77F8D8498A9694D45BA8B0F75F,31561,17,18,1,109.56792,18.28479,1765
28863,220103,B643AC77F8D8498A9694D45BA8B0F75F,30854,19,21,2,109.56889,18.27076,1763
28864,220131,7252A0F90E29EC78621699C082578EF7,60504,14,17,3,109.47917,18.28903,1416
28865,220132,7252A0F90E29EC78621699C082578EF7,30121,18,19,1,109.52861,18.27222,1613
28866,220133,7252A0F90E29EC78621699C082578EF7,60361,20,22,2,109.51938,18.29681,1567
28867,220145,CE70D3AAC3EF6B01DB8A5F34BD94E77D,30821,0,2,2,109.43681,18.33639,1274
28868,220146,CE70D3AAC3EF6B01DB8A5F34BD94E77D,60011,2,6,4,109.48965,18.30222,1468
28869,220147,CE70D3AAC3EF6B01DB8A5F34BD94E77D,30821,9,23,14,109.43681,18.33639,1274
28870,220180,5F8365FB0789CEF561E94F959B476B78,39063,0,6,6,109.386,18.2919,1066
28871,220181,5F8365FB0789CEF561E94F959B476B78,38754,11,16,5,109.74667,18.37382,2430
28872,220182,5F8365FB0789CEF561E94F959B476B78,60551,19,20,1,109.42722,18.30111,1218
28873,220183,5F8365FB0789CEF561E94F959B476B78,38071,21,23,2,109.40722,18.30938,1169
28874,220239,4734AFF1B70F6E2220C283E468A26DA6,38017,0,8,8,109.49729,18.21424,1504
28875,220240,4734AFF1B70F6E2220C283E468A26DA6,31145,11,12,1,109.20431,18.30479,369
28876,220241,4734AFF1B70F6E2220C283E468A26DA6,60234,15,17,2,109.49577,18.2096,1453
28877,220252,CBFB6695A565EE8288E80536B0FF653C,30854,0,1,1,109.56889,18.27076,1763
28878,220253,CBFB6695A565EE8288E80536B0FF653C,60631,4,8,4,109.57778,18.27583,1814
28879,220254,CBFB6695A565EE8288E80536B0FF653C,30854,12,13,1,109.56889,18.27076,1763
28880,220255,CBFB6695A565EE8288E80536B0FF653C,60381,14,15,1,109.5241,18.22458,1605
28881,220256,5426296000364EE32711CD0E73D782C8,31561,1,4,3,109.56792,18.28479,1765
28882,220257,5426296000364EE32711CD0E73D782C8,30771,9,11,2,109.49938,18.26042,1511
28886,220301,4995463B780282C9C030A19D9F49AEAC,31071,0,7,7,109.58257,18.28458,1815
28887,220302,4995463B780282C9C030A19D9F49AEAC,30854,8,18,10,109.56889,18.27076,1763
28888,220303,4995463B780282C9C030A19D9F49AEAC,31071,19,21,2,109.58257,18.28458,1815
28889,220304,4995463B780282C9C030A19D9F49AEAC,30854,21,22,1,109.56889,18.27076,1763
28890,220305,4995463B780282C9C030A19D9F49AEAC,31071,22,23,1,109.58257,18.28458,1815
28891,220316,4E94ADAE7ABEB20EEFAF67519DFCC1BE,31081,1,9,8,109.44639,18.30181,1318
28892,220317,4E94ADAE7ABEB20EEFAF67519DFCC1BE,31031,9,13,4,109.49979,18.25382,1510
28893,220318,4E94ADAE7ABEB20EEFAF67519DFCC1BE,31031,13,22,9,109.49979,18.25382,1510
28894,220397,8C8DB7A18864109B823771C405E00B29,39371,7,10,3,109.56627,18.2646,1762
28895,220398,8C8DB7A18864109B823771C405E00B29,30951,11,12,1,109.56208,18.25667,1761
28896,220399,8C8DB7A18864109B823771C405E00B29,30851,12,15,3,109.5616,18.27396,1713
28897,220400,B340EDEF4A878E8DF5CBEC25E465EACE,30854,9,12,3,109.56889,18.27076,1763
28898,220401,B340EDEF4A878E8DF5CBEC25E465EACE,60631,14,17,3,109.57778,18.27583,1814
28899,220402,B340EDEF4A878E8DF5CBEC25E465EACE,30854,17,23,6,109.56889,18.27076,1763
28900,220418,F198CAA1F49ACA5D003FD8F8473B3798,30191,0,1,1,109.50361,18.22701,1506
28901,220419,F198CAA1F49ACA5D003FD8F8473B3798,30854,4,6,2,109.56889,18.27076,1763
28902,220420,F198CAA1F49ACA5D003FD8F8473B3798,31071,9,10,1,109.58257,18.28458,1815
28903,220421,F198CAA1F49ACA5D003FD8F8473B3798,30854,16,17,1,109.56889,18.27076,1763
28904,220422,F198CAA1F49ACA5D003FD8F8473B3798,31071,22,23,1,109.58257,18.28458,1815
28905,220464,621EE06E912A2B2F41B7CF45E15EDD34,30081,0,4,4,109.50243,18.26632,1512
28906,220465,621EE06E912A2B2F41B7CF45E15EDD34,60161,5,6,1,109.49174,18.26181,1461
28907,220466,621EE06E912A2B2F41B7CF45E15EDD34,30661,10,11,1,109.37028,18.24361,1008
28908,220467,621EE06E912A2B2F41B7CF45E15EDD34,31561,14,15,1,109.56792,18.28479,1765
28909,220484,1D2F8DB1F8B6A2081E1A43DDF558491D,31951,0,3,3,109.52174,18.30299,1568
28910,220485,1D2F8DB1F8B6A2081E1A43DDF558491D,30561,6,10,4,109.52778,18.31938,1621
28911,220486,1D2F8DB1F8B6A2081E1A43DDF558491D,60361,13,14,1,109.51938,18.29681,1567
28912,220487,1D2F8DB1F8B6A2081E1A43DDF558491D,38484,14,15,1,109.53028,18.31528,1620
28913,220488,1D2F8DB1F8B6A2081E1A43DDF558491D,38484,17,20,3,109.53028,18.31528,1620
28914,220489,1D2F8DB1F8B6A2081E1A43DDF558491D,31951,22,23,1,109.52174,18.30299,1568
28915,220492,662D882A6A10D0E6C3566690F0A40636,30854,0,12,12,109.56889,18.27076,1763
28916,220493,662D882A6A10D0E6C3566690F0A40636,31071,13,22,9,109.58257,18.28458,1815
28917,220546,6C1B85A5DA00EF7C1AE90EE47B67586A,31421,12,14,2,109.55382,18.22347,1705
28918,220547,6C1B85A5DA00EF7C1AE90EE47B67586A,39371,14,15,1,109.56627,18.2646,1762
28919,220548,6C1B85A5DA00EF7C1AE90EE47B67586A,60311,18,22,4,109.52097,18.24319,1558
28920,220574,03C62551F9F52C12E6188B98E0F16BF3,30861,13,17,4,109.52722,18.22743,1606
28925,220606,0E0D6E55BB1995EBF85F6B7AA8765E55,30851,2,4,2,109.5616,18.27396,1713
28926,220607,0E0D6E55BB1995EBF85F6B7AA8765E55,30854,4,7,3,109.56889,18.27076,1763
28927,220608,0E0D6E55BB1995EBF85F6B7AA8765E55,38271,7,15,8,109.62632,18.23049,1956
28928,220609,0E0D6E55BB1995EBF85F6B7AA8765E55,30854,19,23,4,109.56889,18.27076,1763
28929,220622,C711EA8F4B039EAC279F7CFC24309A8A,60361,19,20,1,109.51938,18.29681,1567
28930,220623,C711EA8F4B039EAC279F7CFC24309A8A,38157,21,23,2,109.51483,18.26958,1563
28931,220624,2D39AE6120F2674000C6DBB8A6E572A0,31945,0,6,6,109.58021,18.29403,1817
28932,220625,2D39AE6120F2674000C6DBB8A6E572A0,30854,9,12,3,109.56889,18.27076,1763
28933,220659,C1F9914EF577AE2A8300B1A3945A50FF,30854,8,9,1,109.56889,18.27076,1763
28934,220660,C1F9914EF577AE2A8300B1A3945A50FF,31561,9,11,2,109.56792,18.28479,1765
28935,220661,C1F9914EF577AE2A8300B1A3945A50FF,30851,12,22,10,109.5616,18.27396,1713
28936,220730,F5FE23BF42FC224C310CD42E08B0B950,31431,0,7,7,109.44639,18.29042,1316
28937,220731,F5FE23BF42FC224C310CD42E08B0B950,38094,7,9,2,109.45403,18.28778,1316
28938,220732,F5FE23BF42FC224C310CD42E08B0B950,60441,9,10,1,109.46792,18.28604,1366
28939,220733,F5FE23BF42FC224C310CD42E08B0B950,38094,11,13,2,109.45403,18.28778,1316
28940,220734,F5FE23BF42FC224C310CD42E08B0B950,38871,13,14,1,109.44681,18.28625,1316
28941,220735,F5FE23BF42FC224C310CD42E08B0B950,38094,15,18,3,109.45403,18.28778,1316
28942,220736,F5FE23BF42FC224C310CD42E08B0B950,31431,20,23,3,109.44639,18.29042,1316
28943,220778,9FEA4B85EAE4FAEE1CAF0EABFF2FAEA1,31561,0,2,2,109.56792,18.28479,1765
28944,220779,9FEA4B85EAE4FAEE1CAF0EABFF2FAEA1,30854,2,3,1,109.56889,18.27076,1763
28945,220780,9FEA4B85EAE4FAEE1CAF0EABFF2FAEA1,31561,4,6,2,109.56792,18.28479,1765
28946,220781,9FEA4B85EAE4FAEE1CAF0EABFF2FAEA1,39183,16,18,2,109.55542,18.28208,1715
28947,220782,9FEA4B85EAE4FAEE1CAF0EABFF2FAEA1,31561,20,22,2,109.56792,18.28479,1765
28948,220806,C01D7F4C525517694A04D5EAA5AD2420,39181,8,9,1,109.55153,18.28035,1715
28949,220807,C01D7F4C525517694A04D5EAA5AD2420,31945,10,12,2,109.58021,18.29403,1817
28950,220808,C01D7F4C525517694A04D5EAA5AD2420,31071,13,14,1,109.58257,18.28458,1815
28951,220809,C01D7F4C525517694A04D5EAA5AD2420,39181,15,18,3,109.55153,18.28035,1715
28952,220810,C01D7F4C525517694A04D5EAA5AD2420,31071,19,22,3,109.58257,18.28458,1815
28953,220852,C3EF49B0098C6C3C4B26CC8869DE86AF,30854,1,6,5,109.56889,18.27076,1763
28954,220853,C3EF49B0098C6C3C4B26CC8869DE86AF,38271,9,14,5,109.62632,18.23049,1956
28955,220854,94C4D5691F7DFC1AB38806AFFAC1389E,30921,1,16,15,109.53903,18.29451,1667
28956,220855,94C4D5691F7DFC1AB38806AFFAC1389E,31931,18,21,3,109.54771,18.29403,1667
28957,220866,78F4DA0EE4B5885E5D194334926C0B4F,31431,0,1,1,109.44639,18.29042,1316
28958,220867,78F4DA0EE4B5885E5D194334926C0B4F,30051,2,8,6,109.48917,18.21215,1453
28959,220868,78F4DA0EE4B5885E5D194334926C0B4F,31431,8,9,1,109.44639,18.29042,1316
28960,220869,78F4DA0EE4B5885E5D194334926C0B4F,30581,12,13,1,109.62257,18.24951,1959
28965,220917,289060A56CDB4D33EB944FB1093FD036,31071,0,3,3,109.58257,18.28458,1815
28966,220918,289060A56CDB4D33EB944FB1093FD036,30854,3,6,3,109.56889,18.27076,1763
28967,220919,289060A56CDB4D33EB944FB1093FD036,60552,11,12,1,109.41729,18.30014,1218
28968,220928,B616D64706FE00CB4CDA3E3D124853B8,31671,0,7,7,109.38965,18.29813,1068
28969,220929,B616D64706FE00CB4CDA3E3D124853B8,60214,10,12,2,109.63104,18.24493,2009
28970,220930,B616D64706FE00CB4CDA3E3D124853B8,30171,14,20,6,109.48458,18.27139,1463
28971,220939,E4199729A84482014747EE1ECF3FF7D9,30701,0,3,3,109.59313,18.32007,1871
28972,220940,E4199729A84482014747EE1ECF3FF7D9,30931,4,7,3,109.55653,18.32722,1722
28973,220941,E4199729A84482014747EE1ECF3FF7D9,30701,8,9,1,109.59313,18.32007,1871
28974,220942,E4199729A84482014747EE1ECF3FF7D9,30931,11,14,3,109.55653,18.32722,1722
28975,220943,E4199729A84482014747EE1ECF3FF7D9,30701,16,20,4,109.59313,18.32007,1871
28976,220944,E4199729A84482014747EE1ECF3FF7D9,30931,20,23,3,109.55653,18.32722,1722
28977,220953,E8D51F8B53F290BFD73338AD2AD8C728,31561,3,6,3,109.56792,18.28479,1765
28978,220954,E8D51F8B53F290BFD73338AD2AD8C728,39183,6,8,2,109.55542,18.28208,1715
28979,220955,E8D51F8B53F290BFD73338AD2AD8C728,30851,8,9,1,109.5616,18.27396,1713
28980,220956,E8D51F8B53F290BFD73338AD2AD8C728,39183,16,18,2,109.55542,18.28208,1715
28981,220957,E8D51F8B53F290BFD73338AD2AD8C728,31561,19,20,1,109.56792,18.28479,1765
28986,221048,90B0A60855A43B2DB99A0964CE51D3AF,31071,0,7,7,109.58257,18.28458,1815
28987,221049,90B0A60855A43B2DB99A0964CE51D3AF,30854,12,13,1,109.56889,18.27076,1763
28988,221050,90B0A60855A43B2DB99A0964CE51D3AF,31071,15,16,1,109.58257,18.28458,1815
28989,221051,90B0A60855A43B2DB99A0964CE51D3AF,30854,18,19,1,109.56889,18.27076,1763
28990,221052,90B0A60855A43B2DB99A0964CE51D3AF,30234,19,21,2,109.60681,18.29979,1918
28991,221053,90B0A60855A43B2DB99A0964CE51D3AF,30854,22,23,1,109.56889,18.27076,1763
28992,221064,C6C611BB014ED26237271F906108D403,30731,7,9,2,109.50944,18.22306,1555
28993,221065,C6C611BB014ED26237271F906108D403,31071,11,13,2,109.58257,18.28458,1815
28994,221066,C6C611BB014ED26237271F906108D403,30854,13,14,1,109.56889,18.27076,1763
28995,221082,60ACD2B6657BEEA3D1B558DE71329F84,38251,12,14,2,109.49618,18.25493,1510
28996,221083,60ACD2B6657BEEA3D1B558DE71329F84,31311,15,17,2,109.72299,18.27438,2364
28997,221084,60ACD2B6657BEEA3D1B558DE71329F84,60311,21,23,2,109.52097,18.24319,1558
28998,221086,C6DA185F5F0F58094C4390F3E9E2A3DE,31521,13,16,3,109.51458,18.22542,1555
28999,221087,C6DA185F5F0F58094C4390F3E9E2A3DE,60221,18,21,3,109.52569,18.29188,1616
29000,221088,C6DA185F5F0F58094C4390F3E9E2A3DE,30181,21,23,2,109.51597,18.23313,1557
29001,221093,7353E0D0F8DB71C781DB049F9A7D0F1B,30851,20,21,1,109.5616,18.27396,1713
29002,221126,122D07F80E4FAC68FAE7EDBB2DF1AFA3,31071,0,8,8,109.58257,18.28458,1815
29003,221127,122D07F80E4FAC68FAE7EDBB2DF1AFA3,30854,12,13,1,109.56889,18.27076,1763
29004,221128,122D07F80E4FAC68FAE7EDBB2DF1AFA3,31071,13,15,2,109.58257,18.28458,1815
29005,221129,122D07F80E4FAC68FAE7EDBB2DF1AFA3,30854,15,17,2,109.56889,18.27076,1763
29006,221130,122D07F80E4FAC68FAE7EDBB2DF1AFA3,31071,19,21,2,109.58257,18.28458,1815
29007,221157,1472501D05A1FAACE24DF762AD55D1B1,38023,0,15,15,109.37132,18.28993,1016
29008,221158,1472501D05A1FAACE24DF762AD55D1B1,30361,17,20,3,109.50347,18.24,1508
29009,221159,1472501D05A1FAACE24DF762AD55D1B1,38023,21,23,2,109.37132,18.28993,1016
29022,221241,1040BF12FA1471751318415E0E9540B3,30231,0,5,5,109.59924,18.29639,1867
29023,221242,1040BF12FA1471751318415E0E9540B3,31321,8,17,9,109.63799,18.23201,2007
29024,221243,1040BF12FA1471751318415E0E9540B3,30854,20,22,2,109.56889,18.27076,1763
29025,221258,A9FCE0049DB44FE004EAFBF5B783F4A5,31945,0,1,1,109.58021,18.29403,1817
29026,221259,A9FCE0049DB44FE004EAFBF5B783F4A5,31761,1,7,6,109.60521,18.27965,1914
29027,221260,A9FCE0049DB44FE004EAFBF5B783F4A5,30854,8,9,1,109.56889,18.27076,1763
29028,221261,A9FCE0049DB44FE004EAFBF5B783F4A5,31945,12,13,1,109.58021,18.29403,1817
29029,221262,A9FCE0049DB44FE004EAFBF5B783F4A5,31071,14,16,2,109.58257,18.28458,1815
29030,221263,A9FCE0049DB44FE004EAFBF5B783F4A5,31945,17,23,6,109.58021,18.29403,1817
29031,221302,36F5BD1EC1DA32FE1633E251344E0BAC,31471,14,16,2,109.34583,18.29563,917
29032,221303,36F5BD1EC1DA32FE1633E251344E0BAC,31521,21,23,2,109.51458,18.22542,1555
29033,221307,43DCA4A54D551EB9E56C0160DC714BC6,31561,0,6,6,109.56792,18.28479,1765
29034,221308,43DCA4A54D551EB9E56C0160DC714BC6,39053,7,8,1,109.511,18.2771,1564
29035,221309,43DCA4A54D551EB9E56C0160DC714BC6,30084,8,11,3,109.50118,18.26972,1513
29036,221310,43DCA4A54D551EB9E56C0160DC714BC6,31351,14,15,1,109.4959,18.28417,1465
29037,221311,43DCA4A54D551EB9E56C0160DC714BC6,30711,16,17,1,109.50271,18.25347,1510
29038,221312,43DCA4A54D551EB9E56C0160DC714BC6,30854,18,19,1,109.56889,18.27076,1763
29039,221313,43DCA4A54D551EB9E56C0160DC714BC6,60084,20,22,2,109.4984,18.2334,1507
29040,221321,01571BA7F657FDD036DA743344472E7B,31521,0,6,6,109.51458,18.22542,1555
29041,221322,01571BA7F657FDD036DA743344472E7B,31781,11,14,3,109.19847,18.2975,367
29042,221323,01571BA7F657FDD036DA743344472E7B,31471,16,17,1,109.34583,18.29563,917
29043,221324,01571BA7F657FDD036DA743344472E7B,31521,20,23,3,109.51458,18.22542,1555
29044,221346,12A0D13AED64522A8A0ABBA021E92F4C,60361,0,4,4,109.51938,18.29681,1567
29048,221360,D0B130BB73D573D27319D926F1342D67,31271,0,7,7,109.48958,18.26257,1462
29049,221361,D0B130BB73D573D27319D926F1342D67,31781,9,11,2,109.19847,18.2975,367
29050,221362,D0B130BB73D573D27319D926F1342D67,31471,13,14,1,109.34583,18.29563,917
29051,221363,C0D9A8D1FC57A96EA766A127A0E8EAAC,60591,14,17,3,109.61118,18.21715,1904
29052,221364,C0D9A8D1FC57A96EA766A127A0E8EAAC,30581,20,21,1,109.62257,18.24951,1959
29053,221371,2873D39E7EAE4EB9FF7882E90907EED7,30111,0,1,1,109.47583,18.30542,1419
29054,221372,2873D39E7EAE4EB9FF7882E90907EED7,30764,4,23,19,109.45806,18.29486,1367
29055,221373,1411F9F89E8C658605CC1C5E821DCFD9,31071,3,4,1,109.58257,18.28458,1815
29056,221374,1411F9F89E8C658605CC1C5E821DCFD9,31071,5,10,5,109.58257,18.28458,1815
29057,221375,1411F9F89E8C658605CC1C5E821DCFD9,30854,12,17,5,109.56889,18.27076,1763
29058,221376,1411F9F89E8C658605CC1C5E821DCFD9,39091,18,21,3,109.50097,18.25222,1510
29059,221377,015CDEB9169BCE5537ABAE49B6A63F2B,31071,1,7,6,109.58257,18.28458,1815
29060,221378,015CDEB9169BCE5537ABAE49B6A63F2B,30854,9,19,10,109.56889,18.27076,1763
29061,221389,BCE29A3A46F5A479B3F0FA50B11216DE,31071,0,8,8,109.58257,18.28458,1815
29062,221390,BCE29A3A46F5A479B3F0FA50B11216DE,30854,12,19,7,109.56889,18.27076,1763
29070,221478,F6B0C4B9BFBC5C0F5D704098C64B8B01,31864,11,14,3,109.49014,18.28333,1465
29071,221495,3C81431CE72C8A68AA7DD35602A2B093,30861,0,7,7,109.52722,18.22743,1606
29072,221496,3C81431CE72C8A68AA7DD35602A2B093,60551,9,11,2,109.42722,18.30111,1218
29073,221497,3C81431CE72C8A68AA7DD35602A2B093,31571,12,13,1,109.61563,18.23326,1957
29084,221565,96F98526707B06BE1263CCD4F72E07A1,30854,14,16,2,109.56889,18.27076,1763
29085,221566,96F98526707B06BE1263CCD4F72E07A1,31071,17,23,6,109.58257,18.28458,1815
29089,221582,356E75600A8901067E9EDB6E5BE4617A,31741,15,16,1,109.10229,18.37271,30
29094,221607,AA17C9279A63248D7DCDF49F93EB8817,39183,3,4,1,109.55542,18.28208,1715
29095,221608,AA17C9279A63248D7DCDF49F93EB8817,31071,6,7,1,109.58257,18.28458,1815
29096,221609,AA17C9279A63248D7DCDF49F93EB8817,38275,8,18,10,109.62875,18.22938,2006
29097,221618,4EB941D0395ADB322D16D159FEDE659B,60524,17,23,6,109.42951,18.28993,1216
29101,221648,B93185B4820D7E0DEE74EBEA00941D15,30911,1,20,19,109.50493,18.26181,1511
29102,221649,B93185B4820D7E0DEE74EBEA00941D15,38291,21,23,2,109.51618,18.24313,1558
29103,221687,409F5E8F01172D32BBE91132149C037E,31205,0,7,7,109.51111,18.23736,1557
29104,221688,409F5E8F01172D32BBE91132149C037E,60381,10,13,3,109.5241,18.22458,1605
29105,221689,409F5E8F01172D32BBE91132149C037E,38261,15,17,2,109.50361,18.28153,1515
29106,221690,409F5E8F01172D32BBE91132149C037E,30511,17,20,3,109.51069,18.24208,1558
29107,221691,409F5E8F01172D32BBE91132149C037E,31861,21,23,2,109.49042,18.27549,1464
29108,221692,07169E7114E4F14C073261BAAC0D4491,61011,2,6,4,109.60653,18.19076,1900
29109,221694,07169E7114E4F14C073261BAAC0D4491,61011,11,16,5,109.60653,18.19076,1900
29110,221701,53490AD77ACCA93C3ED0F3DE79CA488B,31071,16,17,1,109.58257,18.28458,1815
29111,221702,53490AD77ACCA93C3ED0F3DE79CA488B,30854,20,21,1,109.56889,18.27076,1763
29115,221723,7A78C0FC1F95A27BAD5AE87C12E0EE4B,31031,2,7,5,109.49979,18.25382,1510
29116,221724,7A78C0FC1F95A27BAD5AE87C12E0EE4B,31145,9,10,1,109.20431,18.30479,369
29117,221725,7A78C0FC1F95A27BAD5AE87C12E0EE4B,31781,10,11,1,109.19847,18.2975,367
29118,221726,7A78C0FC1F95A27BAD5AE87C12E0EE4B,31471,12,14,2,109.34583,18.29563,917
29125,221783,9C1407835BC54BEBDB541F52E1DA1820,61011,1,5,4,109.60653,18.19076,1900
29126,221872,7B9D64657CE26DF907B4C2AC87C9F431,38241,9,11,2,109.54111,18.30542,1669
29127,221873,7B9D64657CE26DF907B4C2AC87C9F431,60241,12,13,1,109.53319,18.28667,1616
29128,221874,7B9D64657CE26DF907B4C2AC87C9F431,60371,14,17,3,109.53063,18.30056,1618
29129,221875,7B9D64657CE26DF907B4C2AC87C9F431,31931,19,21,2,109.54771,18.29403,1667
29130,221903,DBB710D279E76C79F1E4B0766F579F8A,31071,16,19,3,109.58257,18.28458,1815
29131,221904,DBB710D279E76C79F1E4B0766F579F8A,30854,19,21,2,109.56889,18.27076,1763
29132,221913,F171E3DE518F39702D793F73F669E12A,31071,0,7,7,109.58257,18.28458,1815
29133,221914,F171E3DE518F39702D793F73F669E12A,30854,10,16,6,109.56889,18.27076,1763
29134,221915,F171E3DE518F39702D793F73F669E12A,39091,19,20,1,109.50097,18.25222,1510
29135,221916,F171E3DE518F39702D793F73F669E12A,31071,22,23,1,109.58257,18.28458,1815
29136,221935,9D08739092826F08F2C268E72E8D5521,38325,0,7,7,109.39792,18.2909,1116
29137,221944,8799356B7181F28146A203E5F86C52F0,31351,0,7,7,109.4959,18.28417,1465
29138,221945,8799356B7181F28146A203E5F86C52F0,60231,11,14,3,109.49903,18.21972,1504
29139,221946,8799356B7181F28146A203E5F86C52F0,60381,19,20,1,109.5241,18.22458,1605
29140,221947,8799356B7181F28146A203E5F86C52F0,60661,20,23,3,109.548,18.2377,1657
29145,221961,EEA35E4D5CC4D9232BFB0C99E2CB356B,30731,7,9,2,109.50944,18.22306,1555
29146,221962,EEA35E4D5CC4D9232BFB0C99E2CB356B,30854,11,19,8,109.56889,18.27076,1763
29147,221963,DC29C676832347947F366933ECB88090,39183,16,18,2,109.55542,18.28208,1715
29148,221964,DC29C676832347947F366933ECB88090,31561,20,23,3,109.56792,18.28479,1765
29149,221976,CD5C4336AE9024E93B35D94EFB29A4ED,60471,0,5,5,109.44653,18.30646,1319
29150,221977,CD5C4336AE9024E93B35D94EFB29A4ED,31351,7,9,2,109.4959,18.28417,1465
29151,221978,CD5C4336AE9024E93B35D94EFB29A4ED,38094,10,12,2,109.45403,18.28778,1316
29152,221979,CD5C4336AE9024E93B35D94EFB29A4ED,39321,14,16,2,109.529,18.2167,1604
29153,221980,CD5C4336AE9024E93B35D94EFB29A4ED,31031,20,22,2,109.49979,18.25382,1510
29157,221990,99CBAA6A65A50998F0A10B72B36210E4,60231,2,5,3,109.49903,18.21972,1504
29158,221991,99CBAA6A65A50998F0A10B72B36210E4,30271,6,10,4,109.49132,18.23153,1456
29159,221992,99CBAA6A65A50998F0A10B72B36210E4,60231,11,14,3,109.49903,18.21972,1504
29160,221993,99CBAA6A65A50998F0A10B72B36210E4,60201,19,20,1,109.5041,18.2509,1510
29161,221994,99CBAA6A65A50998F0A10B72B36210E4,30271,21,23,2,109.49132,18.23153,1456
29162,221995,0A42606864F4219FA2114E5C6B187F5F,30151,0,5,5,109.50986,18.25083,1560
29163,221996,0A42606864F4219FA2114E5C6B187F5F,30151,5,16,11,109.50986,18.25083,1560
29164,221997,0A42606864F4219FA2114E5C6B187F5F,30421,16,18,2,109.50021,18.25861,1511
29165,221998,0A42606864F4219FA2114E5C6B187F5F,30151,19,20,1,109.50986,18.25083,1560
29166,221999,0A42606864F4219FA2114E5C6B187F5F,31461,21,23,2,109.5091,18.25389,1510
29167,222007,6DA732BBEB142DF897DCE85AB09B72FB,38052,17,18,1,109.62618,18.23042,1956
29168,222008,6DA732BBEB142DF897DCE85AB09B72FB,38052,19,21,2,109.62618,18.23042,1956
29169,222042,4E2E832AE9D054F6D1F41FA6FCE0E148,30854,0,6,6,109.56889,18.27076,1763
29170,222043,4E2E832AE9D054F6D1F41FA6FCE0E148,31561,8,9,1,109.56792,18.28479,1765
29171,222044,4E2E832AE9D054F6D1F41FA6FCE0E148,39183,12,13,1,109.55542,18.28208,1715
29172,222045,4E2E832AE9D054F6D1F41FA6FCE0E148,31561,15,16,1,109.56792,18.28479,1765
29173,222046,4E2E832AE9D054F6D1F41FA6FCE0E148,39183,17,18,1,109.55542,18.28208,1715
29174,222049,E34FF61340C5B86CF9FD0AD454D26266,60331,0,7,7,109.505,18.26507,1512
29175,222050,E34FF61340C5B86CF9FD0AD454D26266,60131,7,8,1,109.49819,18.24778,1509
29176,222051,E34FF61340C5B86CF9FD0AD454D26266,60401,9,12,3,109.47444,18.27583,1414
29177,222052,E34FF61340C5B86CF9FD0AD454D26266,60131,14,18,4,109.49819,18.24778,1509
29178,222053,E34FF61340C5B86CF9FD0AD454D26266,60331,19,23,4,109.505,18.26507,1512
29179,222092,653C072409915817F60C156ADD74B0CE,38903,0,6,6,109.39229,18.29243,1117
29180,222093,653C072409915817F60C156ADD74B0CE,38325,7,8,1,109.39792,18.2909,1116
29181,222094,653C072409915817F60C156ADD74B0CE,38754,11,16,5,109.74667,18.37382,2430
29182,222095,653C072409915817F60C156ADD74B0CE,60551,19,20,1,109.42722,18.30111,1218
29183,222096,653C072409915817F60C156ADD74B0CE,38071,21,23,2,109.40722,18.30938,1169
29193,222195,8819F09BB0735F6A8E80552A57CCCF5D,38111,0,9,9,109.52007,18.22403,1555
29194,222196,8819F09BB0735F6A8E80552A57CCCF5D,39111,13,15,2,109.5191,18.22597,1555
29195,222197,8819F09BB0735F6A8E80552A57CCCF5D,39321,15,16,1,109.529,18.2167,1604
29196,222198,8819F09BB0735F6A8E80552A57CCCF5D,60381,17,18,1,109.5241,18.22458,1605
29197,222199,8819F09BB0735F6A8E80552A57CCCF5D,39111,19,23,4,109.5191,18.22597,1555
29198,222265,51061B3DE820AF1C1C713EF684728003,31071,1,6,5,109.58257,18.28458,1815
29199,222266,51061B3DE820AF1C1C713EF684728003,30854,7,19,12,109.56889,18.27076,1763
29200,222271,A8E9C7BB918ADAD29A3EA7ACDDCD32D7,38951,5,15,10,109.48097,18.28868,1416
29201,222272,A8E9C7BB918ADAD29A3EA7ACDDCD32D7,38951,16,23,7,109.48097,18.28868,1416
29202,222288,1DC4D3E6415CD2F16BAC0F0FD6BEA638,60371,0,7,7,109.53063,18.30056,1618
29203,222289,1DC4D3E6415CD2F16BAC0F0FD6BEA638,30151,8,11,3,109.50986,18.25083,1560
29204,222290,1DC4D3E6415CD2F16BAC0F0FD6BEA638,31381,12,15,3,109.1375,18.36833,129
29205,222291,1DC4D3E6415CD2F16BAC0F0FD6BEA638,30151,16,20,4,109.50986,18.25083,1560
29206,222292,1DC4D3E6415CD2F16BAC0F0FD6BEA638,31461,22,23,1,109.5091,18.25389,1510
29210,222327,1980C8D409DE9551539224B3D393CDAA,30071,0,16,16,109.52819,18.30472,1619
29211,222328,1980C8D409DE9551539224B3D393CDAA,30081,17,20,3,109.50243,18.26632,1512
29212,222338,207A3717E11AB3AC89EB226444DE97A9,31031,0,20,20,109.49979,18.25382,1510
29213,222339,207A3717E11AB3AC89EB226444DE97A9,38071,21,23,2,109.40722,18.30938,1169
29214,222340,35336623A064EB876235CF439E741F00,60401,0,7,7,109.47444,18.27583,1414
29215,222341,35336623A064EB876235CF439E741F00,60552,8,10,2,109.41729,18.30014,1218
29216,222342,35336623A064EB876235CF439E741F00,30581,11,12,1,109.62257,18.24951,1959
29217,222343,35336623A064EB876235CF439E741F00,31861,18,20,2,109.49042,18.27549,1464
29218,222344,35336623A064EB876235CF439E741F00,60401,21,23,2,109.47444,18.27583,1414
29219,222362,8060F1CDA5B02D0FFB5AD4CB4F63BD54,38331,12,15,3,109.62465,18.22736,1956
29220,222363,8060F1CDA5B02D0FFB5AD4CB4F63BD54,30581,17,18,1,109.62257,18.24951,1959
29221,222364,8060F1CDA5B02D0FFB5AD4CB4F63BD54,38331,19,23,4,109.62465,18.22736,1956
29228,222396,D5309758D880DC161B61C8C47A33D4DF,31031,12,17,5,109.49979,18.25382,1510
29229,222415,AD0C0928989E5F84A5B5D3B80DD05CE5,30581,14,15,1,109.62257,18.24951,1959
29230,222425,134AFB75C5EE5F34B187E109F7D26A7A,60361,0,12,12,109.51938,18.29681,1567
29234,222446,D61883A9E0C7F2103C981F95E51C66DA,31931,0,6,6,109.54771,18.29403,1667
29235,222447,D61883A9E0C7F2103C981F95E51C66DA,39321,6,11,5,109.529,18.2167,1604
29236,222448,D61883A9E0C7F2103C981F95E51C66DA,60241,15,16,1,109.53319,18.28667,1616
29237,222451,F22E2350B3BBD3E296D591A1B269AAD3,30711,14,15,1,109.50271,18.25347,1510
29238,222456,43E035AE85036EBD9891453E9567CB81,30151,12,15,3,109.50986,18.25083,1560
29239,222457,43E035AE85036EBD9891453E9567CB81,30151,20,23,3,109.50986,18.25083,1560
29240,222462,7573F757DDCCBF2E29AC0A68CDB02052,60501,13,15,2,109.48701,18.29021,1466
29241,222463,7573F757DDCCBF2E29AC0A68CDB02052,30232,18,20,2,109.6191,18.31701,1971
29253,222620,C983E73D646629A775690ECA8920EB29,31631,0,5,5,109.59542,18.36826,1879
29254,222621,C983E73D646629A775690ECA8920EB29,30101,8,23,15,109.57299,18.33333,1773
29262,222683,49C9684FD0CADCB0880FDC9F00AD4E38,31951,0,7,7,109.52174,18.30299,1568
29263,222684,49C9684FD0CADCB0880FDC9F00AD4E38,38484,7,9,2,109.53028,18.31528,1620
29264,222685,49C9684FD0CADCB0880FDC9F00AD4E38,30161,11,14,3,109.50042,18.24389,1508
29265,222686,49C9684FD0CADCB0880FDC9F00AD4E38,38251,16,18,2,109.49618,18.25493,1510
29266,222687,49C9684FD0CADCB0880FDC9F00AD4E38,60161,18,20,2,109.49174,18.26181,1461
29270,222703,8FE97C1052D63DE830211C405D8F5442,30854,10,11,1,109.56889,18.27076,1763
29271,222704,8FE97C1052D63DE830211C405D8F5442,39183,13,15,2,109.55542,18.28208,1715
29272,222736,C8330C25843897A146832CFB6279BF35,30201,0,18,18,109.4909,18.26465,1462
29273,222737,C8330C25843897A146832CFB6279BF35,30911,20,23,3,109.50493,18.26181,1511
29274,222738,E5B7402820F985EB208F9919AD7281A4,30854,18,20,2,109.56889,18.27076,1763
29275,222739,E5B7402820F985EB208F9919AD7281A4,60631,20,21,1,109.57778,18.27583,1814
29276,222757,6422CB87ACC55DDEF6EBE8946593C808,30721,0,7,7,109.51597,18.28257,1565
29277,222758,6422CB87ACC55DDEF6EBE8946593C808,39053,9,12,3,109.511,18.2771,1564
29278,222759,6422CB87ACC55DDEF6EBE8946593C808,60231,14,16,2,109.49903,18.21972,1504
29279,222760,6422CB87ACC55DDEF6EBE8946593C808,60381,18,19,1,109.5241,18.22458,1605
29280,222761,6422CB87ACC55DDEF6EBE8946593C808,30721,21,23,2,109.51597,18.28257,1565
29281,222779,53453D8B736810206EC5A6632D159BE6,60371,14,17,3,109.53063,18.30056,1618
29282,222780,53453D8B736810206EC5A6632D159BE6,31931,17,23,6,109.54771,18.29403,1667
29283,222781,4B672ABD46E5A5E3AE2E2A8075F2FA4B,30854,10,20,10,109.56889,18.27076,1763
29284,222782,4B672ABD46E5A5E3AE2E2A8075F2FA4B,30232,22,23,1,109.6191,18.31701,1971
29285,222792,9AA959ED87D1ECC3053DED17290EFCBD,30851,17,18,1,109.5616,18.27396,1713
29286,222793,9AA959ED87D1ECC3053DED17290EFCBD,31561,20,22,2,109.56792,18.28479,1765
29287,222796,7890099D98AA300C5BF12527E7372DB0,31071,15,17,2,109.58257,18.28458,1815
29288,222797,7890099D98AA300C5BF12527E7372DB0,30854,18,20,2,109.56889,18.27076,1763
29289,222798,7890099D98AA300C5BF12527E7372DB0,60631,20,23,3,109.57778,18.27583,1814
29290,222829,D96E01B8E0F0DE9C160C9FEAFDCFDB6D,31071,0,7,7,109.58257,18.28458,1815
29291,222830,D96E01B8E0F0DE9C160C9FEAFDCFDB6D,30854,7,23,16,109.56889,18.27076,1763
29292,222831,9AEFA19190845F00DF14D3FEC240F037,38871,19,21,2,109.44681,18.28625,1316
29293,222832,9AEFA19190845F00DF14D3FEC240F037,31531,21,23,2,109.49583,18.25972,1461
29297,222883,1EC0B0F463B9D564AF3039640EFE6DA3,60054,12,13,1,109.3016,18.31229,770
29298,222884,1EC0B0F463B9D564AF3039640EFE6DA3,31471,13,15,2,109.34583,18.29563,917
29299,222885,1EC0B0F463B9D564AF3039640EFE6DA3,30361,18,19,1,109.50347,18.24,1508
29300,222886,1EC0B0F463B9D564AF3039640EFE6DA3,60381,20,23,3,109.5241,18.22458,1605
29301,222953,40285EE8CCE25C38988EC087545664EC,31071,4,13,9,109.58257,18.28458,1815
29302,222954,40285EE8CCE25C38988EC087545664EC,30854,13,21,8,109.56889,18.27076,1763
29303,222997,528DF0E8B4B73FA0C9FB75037E21B5BA,31931,0,12,12,109.54771,18.29403,1667
29304,222998,528DF0E8B4B73FA0C9FB75037E21B5BA,60241,15,16,1,109.53319,18.28667,1616
29305,223002,00262F856825A94933CC2BDE5C3D9737,39371,1,3,2,109.56627,18.2646,1762
29306,223003,00262F856825A94933CC2BDE5C3D9737,60581,3,6,3,109.59785,18.29931,1868
29307,223004,00262F856825A94933CC2BDE5C3D9737,31421,7,11,4,109.55382,18.22347,1705
29308,223005,00262F856825A94933CC2BDE5C3D9737,39371,12,13,1,109.56627,18.2646,1762
29309,223006,00262F856825A94933CC2BDE5C3D9737,60581,14,16,2,109.59785,18.29931,1868
29319,223105,A503639E15A0B5D04B0130D882921438,30711,0,12,12,109.50271,18.25347,1510
29320,223106,A503639E15A0B5D04B0130D882921438,31031,13,23,10,109.49979,18.25382,1510
29321,223131,4759B4AA548945325B49F4F737EA2B26,30461,18,20,2,109.5116,18.26313,1562
29322,223132,4759B4AA548945325B49F4F737EA2B26,38094,21,23,2,109.45403,18.28778,1316
29323,223133,51DF765CB634D9549D20AD1F2C37BA18,30854,14,17,3,109.56889,18.27076,1763
29324,223134,51DF765CB634D9549D20AD1F2C37BA18,31071,20,22,2,109.58257,18.28458,1815
29325,223149,6A001C9D1BB80FEAD1801B539C4E1BA7,30731,0,5,5,109.50944,18.22306,1555
29326,223150,6A001C9D1BB80FEAD1801B539C4E1BA7,31781,10,11,1,109.19847,18.2975,367
29327,223151,6A001C9D1BB80FEAD1801B539C4E1BA7,31471,14,16,2,109.34583,18.29563,917
29328,223152,6A001C9D1BB80FEAD1801B539C4E1BA7,31521,16,17,1,109.51458,18.22542,1555
29329,223153,6A001C9D1BB80FEAD1801B539C4E1BA7,30731,18,23,5,109.50944,18.22306,1555
29330,223214,5CFFF8D919E96524101209E188C669B3,31951,19,23,4,109.52174,18.30299,1568
29335,223279,E75CF54BA14775FEDD26504F9F6B7365,31945,0,4,4,109.58021,18.29403,1817
29336,223280,E75CF54BA14775FEDD26504F9F6B7365,31561,7,9,2,109.56792,18.28479,1765
29337,223281,E75CF54BA14775FEDD26504F9F6B7365,30854,9,12,3,109.56889,18.27076,1763
29338,223282,E75CF54BA14775FEDD26504F9F6B7365,31561,13,18,5,109.56792,18.28479,1765
29339,223283,E75CF54BA14775FEDD26504F9F6B7365,31945,21,23,2,109.58021,18.29403,1817
29340,223288,96C474E5BFF92BC21432A4ADDD7A543D,31071,12,13,1,109.58257,18.28458,1815
29341,223289,96C474E5BFF92BC21432A4ADDD7A543D,39371,15,16,1,109.56627,18.2646,1762
29342,223311,D8EBCB05DE029B0DEDBF9FBDF3DA3C2D,38251,17,19,2,109.49618,18.25493,1510
29343,223312,D8EBCB05DE029B0DEDBF9FBDF3DA3C2D,60084,21,23,2,109.4984,18.2334,1507
29344,223319,556BB0E48CDC393D98CC29C252B17ABD,31461,19,21,2,109.5091,18.25389,1510
29345,223320,556BB0E48CDC393D98CC29C252B17ABD,31864,21,23,2,109.49014,18.28333,1465
29349,223371,2AE38FAF341950B0B91404FFCE5A0F3E,30921,12,16,4,109.53903,18.29451,1667
29350,223372,2AE38FAF341950B0B91404FFCE5A0F3E,31931,20,21,1,109.54771,18.29403,1667
29361,223551,EC4B90EDBF35256FDB4D4F8B87DB8A04,31071,4,17,13,109.58257,18.28458,1815
29362,223552,EC4B90EDBF35256FDB4D4F8B87DB8A04,30191,21,23,2,109.50361,18.22701,1506
29363,223559,8CD15CF6B5FB4821940FF9AFE6D6CB84,39181,13,17,4,109.55153,18.28035,1715
29364,223560,8CD15CF6B5FB4821940FF9AFE6D6CB84,31931,19,20,1,109.54771,18.29403,1667
29365,223649,F7B78088C9D5070A9DC85E9635B06C5E,31471,13,14,1,109.34583,18.29563,917
29366,223650,F7B78088C9D5070A9DC85E9635B06C5E,60551,19,20,1,109.42722,18.30111,1218
29367,223651,1CA52953D80A93E278268F121C1B48FB,31206,0,7,7,109.50819,18.23549,1507
29368,223652,1CA52953D80A93E278268F121C1B48FB,38754,11,13,2,109.74667,18.37382,2430
29369,223653,1CA52953D80A93E278268F121C1B48FB,30211,15,16,1,109.49882,18.23931,1508
29370,223654,1CA52953D80A93E278268F121C1B48FB,30161,17,19,2,109.50042,18.24389,1508
29371,223655,1CA52953D80A93E278268F121C1B48FB,31031,19,20,1,109.49979,18.25382,1510
29372,223656,1CA52953D80A93E278268F121C1B48FB,30271,20,23,3,109.49132,18.23153,1456
29373,223713,B0378DF43FA7734384BC89D53958FB62,31531,0,2,2,109.49583,18.25972,1461
29374,223714,B0378DF43FA7734384BC89D53958FB62,38251,3,6,3,109.49618,18.25493,1510
29375,223715,B0378DF43FA7734384BC89D53958FB62,31531,7,8,1,109.49583,18.25972,1461
29376,223716,B0378DF43FA7734384BC89D53958FB62,31471,15,17,2,109.34583,18.29563,917
29377,223717,B0378DF43FA7734384BC89D53958FB62,31531,21,23,2,109.49583,18.25972,1461
29378,223730,4C38E9EA73C70042E952A9DE08A1B2B7,38871,0,18,18,109.44681,18.28625,1316
29379,223731,4C38E9EA73C70042E952A9DE08A1B2B7,60621,20,22,2,109.48354,18.27451,1464
29387,223774,102A3C1C3179D6FF6A52B59C3B4087A1,31181,0,4,4,109.50382,18.24813,1509
29388,223775,102A3C1C3179D6FF6A52B59C3B4087A1,30161,4,12,8,109.50042,18.24389,1508
29389,223776,102A3C1C3179D6FF6A52B59C3B4087A1,31181,12,14,2,109.50382,18.24813,1509
29390,223777,102A3C1C3179D6FF6A52B59C3B4087A1,30161,14,16,2,109.50042,18.24389,1508
29391,223778,102A3C1C3179D6FF6A52B59C3B4087A1,31181,16,23,7,109.50382,18.24813,1509
29392,223869,B75467468326B44066FD3D51F4AC58E8,30661,0,6,6,109.37028,18.24361,1008
29393,223870,B75467468326B44066FD3D51F4AC58E8,39131,11,12,1,109.2066,18.29639,417
29394,223871,B75467468326B44066FD3D51F4AC58E8,30201,16,18,2,109.4909,18.26465,1462
29395,223872,B75467468326B44066FD3D51F4AC58E8,31471,20,22,2,109.34583,18.29563,917
29396,223895,84AE8021499D54593ACB2FDF894A6FF2,38871,0,7,7,109.44681,18.28625,1316
29397,223896,84AE8021499D54593ACB2FDF894A6FF2,38251,7,8,1,109.49618,18.25493,1510
29398,223897,84AE8021499D54593ACB2FDF894A6FF2,60054,11,14,3,109.3016,18.31229,770
29399,223898,84AE8021499D54593ACB2FDF894A6FF2,30361,17,19,2,109.50347,18.24,1508
29400,223899,84AE8021499D54593ACB2FDF894A6FF2,60381,21,23,2,109.5241,18.22458,1605
29401,223917,E218C587552A5DADC05C4E69685FE374,39371,19,21,2,109.56627,18.2646,1762
29402,223918,E218C587552A5DADC05C4E69685FE374,39183,22,23,1,109.55542,18.28208,1715
29403,223976,96EB2AA1C15710F8D6D518B464991E6E,30711,10,11,1,109.50271,18.25347,1510
29404,224001,1D8B814EC83D52D7C5F3FED99C129EE0,38271,10,17,7,109.62632,18.23049,1956
29405,224002,1D8B814EC83D52D7C5F3FED99C129EE0,30854,19,20,1,109.56889,18.27076,1763
29406,224013,2B4762F46C69FA98E9BBA41DCB08BB34,61011,0,14,14,109.60653,18.19076,1900
29407,224014,2B4762F46C69FA98E9BBA41DCB08BB34,31571,18,19,1,109.61563,18.23326,1957
29408,224120,93163425D5E4D00B602BA1B3C48E3D76,30821,0,6,6,109.43681,18.33639,1274
29409,224123,5B9C285272AE492ED486BC17CC95AEAF,60381,18,20,2,109.5241,18.22458,1605
29410,224124,5B9C285272AE492ED486BC17CC95AEAF,30771,21,23,2,109.49938,18.26042,1511
29411,224127,6BF671BC76B2463D72102139E4EB1018,38241,8,14,6,109.54111,18.30542,1669
29412,224128,6BF671BC76B2463D72102139E4EB1018,60371,14,17,3,109.53063,18.30056,1618
29413,224129,DF1B441334AF356197894BB02F2FD2C7,60552,0,5,5,109.41729,18.30014,1218
29414,224130,DF1B441334AF356197894BB02F2FD2C7,31231,5,7,2,109.42597,18.29292,1217
29415,224131,DF1B441334AF356197894BB02F2FD2C7,30854,9,10,1,109.56889,18.27076,1763
29420,224182,5C4B759B8D2905A494B81A3EB710A8F3,60631,1,16,15,109.57778,18.27583,1814
29421,224183,5C4B759B8D2905A494B81A3EB710A8F3,31206,17,18,1,109.50819,18.23549,1507
29422,224189,AB43182259122294244C13D6FC66D4A1,31561,16,17,1,109.56792,18.28479,1765
29423,224190,AB43182259122294244C13D6FC66D4A1,60631,19,23,4,109.57778,18.27583,1814
29424,224203,C17A8098B013F904BD9DA05D90234A30,30581,0,7,7,109.62257,18.24951,1959
29425,224204,C17A8098B013F904BD9DA05D90234A30,31221,9,17,8,109.61333,18.26833,1913
29426,224228,DE91F768E6CCDB78867FF54F078574C9,30854,0,13,13,109.56889,18.27076,1763
29427,224229,DE91F768E6CCDB78867FF54F078574C9,38754,18,20,2,109.74667,18.37382,2430
29428,224230,DE91F768E6CCDB78867FF54F078574C9,30854,22,23,1,109.56889,18.27076,1763
29429,224231,F8D799D9161B0143E0D71C40472A357E,30071,0,14,14,109.52819,18.30472,1619
29430,224232,F8D799D9161B0143E0D71C40472A357E,38484,17,20,3,109.53028,18.31528,1620
29431,224233,F8D799D9161B0143E0D71C40472A357E,31261,20,23,3,109.51174,18.2466,1559
29432,224245,FB3BDA15BDB6B05D4B2E90881ABDD6BD,31071,15,16,1,109.58257,18.28458,1815
29433,224246,FB3BDA15BDB6B05D4B2E90881ABDD6BD,31031,20,21,1,109.49979,18.25382,1510
29434,224281,7BF65E5054DA81A230AB5423620158E1,31071,14,16,2,109.58257,18.28458,1815
29435,224282,7BF65E5054DA81A230AB5423620158E1,30854,16,18,2,109.56889,18.27076,1763
29436,224283,7BF65E5054DA81A230AB5423620158E1,31071,18,21,3,109.58257,18.28458,1815
29437,224284,7BF65E5054DA81A230AB5423620158E1,60631,22,23,1,109.57778,18.27583,1814
29438,224285,ADC7B707FBBD7BF3F9ACE0C092DAADE5,31351,13,15,2,109.4959,18.28417,1465
29439,224286,ADC7B707FBBD7BF3F9ACE0C092DAADE5,30921,15,17,2,109.53903,18.29451,1667
29440,224287,ADC7B707FBBD7BF3F9ACE0C092DAADE5,31931,18,23,5,109.54771,18.29403,1667
29441,224295,D3C9663E989D180AFC5AB38F1AB14DA3,31071,2,7,5,109.58257,18.28458,1815
29442,224296,D3C9663E989D180AFC5AB38F1AB14DA3,30854,11,12,1,109.56889,18.27076,1763
29443,224333,E6651E3C6D8FEA2077D9EFC6D097D06C,38251,0,20,20,109.49618,18.25493,1510
29444,224334,E6651E3C6D8FEA2077D9EFC6D097D06C,31031,21,23,2,109.49979,18.25382,1510
29445,224353,079A114D194FE2EFB0C89059CA4EBC03,31251,17,23,6,109.18528,18.2975,317
29446,224354,F213C5748E79ACD5D5D964220028F628,31521,11,18,7,109.51458,18.22542,1555
29447,224355,F213C5748E79ACD5D5D964220028F628,30911,18,19,1,109.50493,18.26181,1511
29448,224370,095299F3770B7A2302718B195EB336D4,31161,18,19,1,109.70229,18.31361,2270
29449,224371,095299F3770B7A2302718B195EB336D4,30151,21,23,2,109.50986,18.25083,1560
29453,224445,32A9EB9777CB2D1EF5E41D4825060093,30421,14,16,2,109.50021,18.25861,1511
29454,224448,A46BA306DAEA889FAC7ACE9E5FD6A1FF,31171,1,3,2,109.50938,18.24917,1559
29455,224449,A46BA306DAEA889FAC7ACE9E5FD6A1FF,30371,4,9,5,109.51,18.24771,1559
29456,224450,A46BA306DAEA889FAC7ACE9E5FD6A1FF,30421,9,11,2,109.50021,18.25861,1511
29457,224451,A46BA306DAEA889FAC7ACE9E5FD6A1FF,60291,17,18,1,109.50826,18.24639,1509
29458,224452,A46BA306DAEA889FAC7ACE9E5FD6A1FF,31171,19,21,2,109.50938,18.24917,1559
29459,224466,C6C3BC01E542B810EF853FEEB6C81198,60361,14,17,3,109.51938,18.29681,1567
29460,224467,C6C3BC01E542B810EF853FEEB6C81198,31561,20,22,2,109.56792,18.28479,1765
29461,224478,D17842D1E850E617B4B15889C460D1C5,30921,0,5,5,109.53903,18.29451,1667
29462,224479,D17842D1E850E617B4B15889C460D1C5,31931,5,21,16,109.54771,18.29403,1667
29463,224490,6C0260646767B781577B5B8CE2471E51,30321,17,19,2,109.49563,18.29611,1467
29464,224491,6C0260646767B781577B5B8CE2471E51,38484,19,21,2,109.53028,18.31528,1620
29465,224492,6C0260646767B781577B5B8CE2471E51,31951,21,23,2,109.52174,18.30299,1568
29469,224516,39D4F14340B4650E084697607335F122,31031,0,3,3,109.49979,18.25382,1510
29470,224517,39D4F14340B4650E084697607335F122,30161,3,19,16,109.50042,18.24389,1508
29471,224571,E96216D8F4849958E43701C810AEF688,31521,15,16,1,109.51458,18.22542,1555
29472,224572,E96216D8F4849958E43701C810AEF688,31231,21,23,2,109.42597,18.29292,1217
29473,224589,5257BB62833F353E4A854C5B6B0C57D3,38315,11,13,2,109.48979,18.29764,1467
29474,224591,BA20AC03D63076D89C5025E4CF905079,38325,0,1,1,109.39792,18.2909,1116
29475,224592,BA20AC03D63076D89C5025E4CF905079,38325,6,8,2,109.39792,18.2909,1116
29476,224593,BA20AC03D63076D89C5025E4CF905079,31145,9,11,2,109.20431,18.30479,369
29477,224594,BA20AC03D63076D89C5025E4CF905079,31471,13,15,2,109.34583,18.29563,917
29478,224595,BA20AC03D63076D89C5025E4CF905079,38027,19,20,1,109.38833,18.2909,1066
29479,224599,5206B4948238D5BEDA899C0EB669640A,38094,0,7,7,109.45403,18.28778,1316
29480,224600,5206B4948238D5BEDA899C0EB669640A,31781,12,14,2,109.19847,18.2975,367
29481,224601,5206B4948238D5BEDA899C0EB669640A,60221,18,19,1,109.52569,18.29188,1616
29482,224645,8AABF5FDF2B06EB445749240A3894969,31071,0,11,11,109.58257,18.28458,1815
29483,224646,8AABF5FDF2B06EB445749240A3894969,30854,13,14,1,109.56889,18.27076,1763
29484,224647,8AABF5FDF2B06EB445749240A3894969,31851,15,17,2,109.71736,18.29007,2316
29485,224648,8AABF5FDF2B06EB445749240A3894969,31071,19,21,2,109.58257,18.28458,1815
29486,224649,8AABF5FDF2B06EB445749240A3894969,30854,22,23,1,109.56889,18.27076,1763
29487,224669,F315998EC48289C5B7879B7FA5033861,31461,12,14,2,109.5091,18.25389,1510
29488,224670,F315998EC48289C5B7879B7FA5033861,31461,17,23,6,109.5091,18.25389,1510
29492,224689,2684D96F8074AD1F9109C47C4A6D7EF7,31471,15,17,2,109.34583,18.29563,917
29493,224690,2684D96F8074AD1F9109C47C4A6D7EF7,39091,18,23,5,109.50097,18.25222,1510
29494,224691,CC674AAAC7C027C8C72DEA73AA338EF1,30181,0,8,8,109.51597,18.23313,1557
29495,224692,CC674AAAC7C027C8C72DEA73AA338EF1,31031,12,13,1,109.49979,18.25382,1510
29496,224693,CC674AAAC7C027C8C72DEA73AA338EF1,30111,17,23,6,109.47583,18.30542,1419
29497,224753,E8BAAF476E8FE57075BAB1A8D4FF1780,39371,0,16,16,109.56627,18.2646,1762
29498,224754,E8BAAF476E8FE57075BAB1A8D4FF1780,30232,16,18,2,109.6191,18.31701,1971
29499,224755,E8BAAF476E8FE57075BAB1A8D4FF1780,39371,20,22,2,109.56627,18.2646,1762
29500,224777,1FEE70E9EF5E783035F8B1F1E4B483EC,31071,10,13,3,109.58257,18.28458,1815
29501,224778,1FEE70E9EF5E783035F8B1F1E4B483EC,30854,13,16,3,109.56889,18.27076,1763
29502,224779,1FEE70E9EF5E783035F8B1F1E4B483EC,30851,17,19,2,109.5616,18.27396,1713
29503,224780,1FEE70E9EF5E783035F8B1F1E4B483EC,30854,20,21,1,109.56889,18.27076,1763
29510,224829,3EE8EB9E13BDBC14B74108086C37B269,31261,18,20,2,109.51174,18.2466,1559
29511,224830,3EE8EB9E13BDBC14B74108086C37B269,31201,20,22,2,109.51042,18.23819,1558
29512,224843,3B2185E7415B009217EFBA2F675D0372,31571,14,18,4,109.61563,18.23326,1957
29513,224844,3B2185E7415B009217EFBA2F675D0372,31701,21,23,2,109.44132,18.28833,1266
29514,224845,408C4FED868686E7B96333835F4C4205,30854,14,16,2,109.56889,18.27076,1763
29515,224846,408C4FED868686E7B96333835F4C4205,60381,20,21,1,109.5241,18.22458,1605
29516,224865,798BF3B08F72A16A6DEAAA235F1899BB,61011,0,7,7,109.60653,18.19076,1900
29517,224867,798BF3B08F72A16A6DEAAA235F1899BB,61011,21,23,2,109.60653,18.19076,1900
29518,224871,D001062E96DDE99C5A38D3DD89B4A1A5,31071,0,10,10,109.58257,18.28458,1815
29519,224872,D001062E96DDE99C5A38D3DD89B4A1A5,30854,10,11,1,109.56889,18.27076,1763
29520,224873,D001062E96DDE99C5A38D3DD89B4A1A5,31321,15,16,1,109.63799,18.23201,2007
29521,224874,D001062E96DDE99C5A38D3DD89B4A1A5,30854,20,23,3,109.56889,18.27076,1763
29522,224920,C83E4E683A415C41D5DAD6125B64597B,31531,1,3,2,109.49583,18.25972,1461
29523,224921,C83E4E683A415C41D5DAD6125B64597B,38251,3,4,1,109.49618,18.25493,1510
29524,224922,C83E4E683A415C41D5DAD6125B64597B,31531,5,6,1,109.49583,18.25972,1461
29525,224923,C83E4E683A415C41D5DAD6125B64597B,60054,15,17,2,109.3016,18.31229,770
29526,224924,C83E4E683A415C41D5DAD6125B64597B,60541,20,22,2,109.4084,18.29208,1167
29530,224943,0A1180E82C5CC50239F2164B7CC7F6A9,30021,0,1,1,109.12014,18.40986,86
29531,224944,0A1180E82C5CC50239F2164B7CC7F6A9,31124,2,4,2,109.17069,18.35,276
29532,224945,0A1180E82C5CC50239F2164B7CC7F6A9,30021,4,5,1,109.12014,18.40986,86
29533,224997,2EB34315F52BDC60A50691DD7C88DC95,30721,0,8,8,109.51597,18.28257,1565
29534,224998,2EB34315F52BDC60A50691DD7C88DC95,60581,9,10,1,109.59785,18.29931,1868
29535,225026,E4C7AB656E412C7E33554D18277C9478,31461,14,16,2,109.5091,18.25389,1510
29536,225027,E4C7AB656E412C7E33554D18277C9478,30421,21,23,2,109.50021,18.25861,1511
29537,225077,A6FDD6F461ADD11041AF4D599066AA12,33051,16,17,1,109.6475,18.46618,2096
29538,225078,A6FDD6F461ADD11041AF4D599066AA12,60084,19,21,2,109.4984,18.2334,1507
29539,225079,A6FDD6F461ADD11041AF4D599066AA12,30771,22,23,1,109.49938,18.26042,1511
29540,225103,6751CEC3CF9B2AE78246C7287443D2B4,30854,11,15,4,109.56889,18.27076,1763
29541,225104,6751CEC3CF9B2AE78246C7287443D2B4,31945,20,22,2,109.58021,18.29403,1817
29545,225121,EC89B2FFE00F967E6D0A3B697A6D636D,30854,15,18,3,109.56889,18.27076,1763
29546,225122,EC89B2FFE00F967E6D0A3B697A6D636D,60354,19,23,4,109.58701,18.28521,1815
29547,225140,9EF16DF8533539CE4DAE7B335414DA7E,30171,20,21,1,109.48458,18.27139,1463
29551,225149,C9067C88665B737B441D0CB735A19383,38251,12,18,6,109.49618,18.25493,1510
29552,225150,C9067C88665B737B441D0CB735A19383,30051,22,23,1,109.48917,18.21215,1453
29553,225177,59F29435D748531F416A4F1636997ECF,60354,2,8,6,109.58701,18.28521,1815
29554,225178,59F29435D748531F416A4F1636997ECF,30711,9,10,1,109.50271,18.25347,1510
29555,225181,DFD2E125802FB9E2FB2F393417866810,30854,4,9,5,109.56889,18.27076,1763
29556,225182,DFD2E125802FB9E2FB2F393417866810,30731,11,12,1,109.50944,18.22306,1555
29557,225183,68DBE0B52FD0AB95F1DD47068FD7847F,60311,0,6,6,109.52097,18.24319,1558
29558,225184,68DBE0B52FD0AB95F1DD47068FD7847F,30181,7,8,1,109.51597,18.23313,1557
29559,225185,68DBE0B52FD0AB95F1DD47068FD7847F,60311,12,14,2,109.52097,18.24319,1558
29560,225186,68DBE0B52FD0AB95F1DD47068FD7847F,30181,15,20,5,109.51597,18.23313,1557
29561,225187,68DBE0B52FD0AB95F1DD47068FD7847F,60311,21,23,2,109.52097,18.24319,1558
29562,225214,1D73A39CD9D00E7A842906C3097D7487,60571,0,8,8,109.50722,18.25056,1510
29563,225215,1D73A39CD9D00E7A842906C3097D7487,30851,9,17,8,109.5616,18.27396,1713
29568,225248,794109BFC4D0C5504E1A62AB391C7DDC,30181,0,7,7,109.51597,18.23313,1557
29569,225249,794109BFC4D0C5504E1A62AB391C7DDC,30241,10,12,2,109.26174,18.3275,622
29570,225250,794109BFC4D0C5504E1A62AB391C7DDC,31145,13,15,2,109.20431,18.30479,369
29571,225251,794109BFC4D0C5504E1A62AB391C7DDC,31021,18,19,1,109.49021,18.27,1463
29572,225252,794109BFC4D0C5504E1A62AB391C7DDC,30181,20,23,3,109.51597,18.23313,1557
29573,225253,FBD855000564CE6EC034501219E56C85,38171,1,6,5,109.50799,18.28139,1515
29574,225254,FBD855000564CE6EC034501219E56C85,31781,7,10,3,109.19847,18.2975,367
29575,225255,FBD855000564CE6EC034501219E56C85,31351,12,13,1,109.4959,18.28417,1465
29576,225256,FBD855000564CE6EC034501219E56C85,38127,18,20,2,109.50833,18.27222,1513
29577,225259,E58E5EFF0A1D7ADABE8F5BBEE665ED0D,60641,0,7,7,109.53854,18.2359,1657
29578,225260,E58E5EFF0A1D7ADABE8F5BBEE665ED0D,30861,11,22,11,109.52722,18.22743,1606
29579,225267,DECB7B3FC95BFA8620EFD8D9DE328252,30854,0,6,6,109.56889,18.27076,1763
29580,225268,DECB7B3FC95BFA8620EFD8D9DE328252,39021,8,10,2,109.40368,18.41035,1186
29581,225269,DECB7B3FC95BFA8620EFD8D9DE328252,30854,12,13,1,109.56889,18.27076,1763
29582,225270,DECB7B3FC95BFA8620EFD8D9DE328252,31945,15,16,1,109.58021,18.29403,1817
29583,225271,DECB7B3FC95BFA8620EFD8D9DE328252,30854,16,23,7,109.56889,18.27076,1763
29584,225315,A9634A2AD8447824C1C9412CBBCC32E0,31181,0,7,7,109.50382,18.24813,1509
29585,225316,A9634A2AD8447824C1C9412CBBCC32E0,31851,8,10,2,109.71736,18.29007,2316
29586,225317,A9634A2AD8447824C1C9412CBBCC32E0,31181,13,14,1,109.50382,18.24813,1509
29587,225318,A9634A2AD8447824C1C9412CBBCC32E0,31531,15,16,1,109.49583,18.25972,1461
29588,225319,A9634A2AD8447824C1C9412CBBCC32E0,31181,21,23,2,109.50382,18.24813,1509
29589,225346,14BFE46EEAB2E234698393270A62605D,31251,15,17,2,109.18528,18.2975,317
29590,225347,14BFE46EEAB2E234698393270A62605D,30661,18,20,2,109.37028,18.24361,1008
29591,225348,14BFE46EEAB2E234698393270A62605D,60411,21,23,2,109.32514,18.30854,869
29595,225405,A795428793D2273B4ACFDADC5E61AEC2,31421,13,15,2,109.55382,18.22347,1705
29596,225406,A795428793D2273B4ACFDADC5E61AEC2,60641,20,22,2,109.53854,18.2359,1657
29597,225434,D64831AB91543B58745F58E928C5C4B9,30391,13,15,2,109.4975,18.27118,1513
29598,225435,D64831AB91543B58745F58E928C5C4B9,38157,18,21,3,109.51483,18.26958,1563
29603,225467,7171A8398911756415ECFCDCF96F249B,39371,2,18,16,109.56627,18.2646,1762
29604,225468,7171A8398911756415ECFCDCF96F249B,30851,20,21,1,109.5616,18.27396,1713
29605,225476,7F6E66BC10419161F6457A6D79258EDB,60401,19,20,1,109.47444,18.27583,1414
29606,225477,7F6E66BC10419161F6457A6D79258EDB,60621,21,23,2,109.48354,18.27451,1464
29607,225502,BB817C31A3F12EE16D15A558C65FED5B,60354,19,20,1,109.58701,18.28521,1815
29608,225503,BB817C31A3F12EE16D15A558C65FED5B,30854,20,21,1,109.56889,18.27076,1763
29609,225507,3B4B2DFBA1D31CE7FAD823FC175E4B2C,31311,16,17,1,109.72299,18.27438,2364
29610,225508,3B4B2DFBA1D31CE7FAD823FC175E4B2C,31864,22,23,1,109.49014,18.28333,1465
29611,225569,072AC77F929EC299627C26126B4FB4CE,31181,16,18,2,109.50382,18.24813,1509
29612,225570,072AC77F929EC299627C26126B4FB4CE,60131,19,21,2,109.49819,18.24778,1509
29613,225585,958BCA5AB937B4D5786BAEFD072B8D05,30861,14,23,9,109.52722,18.22743,1606
29614,225596,897B0D6D4872744F8715BD66DA63B237,30854,0,11,11,109.56889,18.27076,1763
29615,225597,897B0D6D4872744F8715BD66DA63B237,31521,12,14,2,109.51458,18.22542,1555
29616,225598,897B0D6D4872744F8715BD66DA63B237,60381,15,17,2,109.5241,18.22458,1605
29617,225599,897B0D6D4872744F8715BD66DA63B237,30361,18,20,2,109.50347,18.24,1508
29618,225600,A6CF31A63571639AB283D5F43FB98748,31201,0,2,2,109.51042,18.23819,1558
29619,225601,A6CF31A63571639AB283D5F43FB98748,38961,2,4,2,109.50847,18.23514,1507
29620,225602,A6CF31A63571639AB283D5F43FB98748,39191,5,6,1,109.51493,18.23472,1557
29621,225603,A6CF31A63571639AB283D5F43FB98748,38961,6,7,1,109.50847,18.23514,1507
29622,225604,A6CF31A63571639AB283D5F43FB98748,31201,10,16,6,109.51042,18.23819,1558
29623,225605,A6CF31A63571639AB283D5F43FB98748,38754,17,19,2,109.74667,18.37382,2430
29624,225608,2F57AF45FF7C3D7310AEA860A5A34AF4,30281,15,23,8,109.50597,18.27583,1514
29625,225671,B172E1B17A92EA23226EC822FB6F7B82,39191,0,7,7,109.51493,18.23472,1557
29626,225672,B172E1B17A92EA23226EC822FB6F7B82,31521,12,13,1,109.51458,18.22542,1555
29627,225673,B172E1B17A92EA23226EC822FB6F7B82,30181,14,15,1,109.51597,18.23313,1557
29628,225674,B172E1B17A92EA23226EC822FB6F7B82,30161,17,18,1,109.50042,18.24389,1508
29629,225675,B172E1B17A92EA23226EC822FB6F7B82,30324,20,22,2,109.50326,18.29257,1517
29630,225678,4DFEF4FCCBFCE7F58299570FFFF0AFFF,30771,15,20,5,109.49938,18.26042,1511
29634,225709,3B22FF0293ABF6F27B33414A85B9BAFE,60524,0,6,6,109.42951,18.28993,1216
29635,225710,3B22FF0293ABF6F27B33414A85B9BAFE,31781,10,13,3,109.19847,18.2975,367
29636,225711,3B22FF0293ABF6F27B33414A85B9BAFE,31471,13,15,2,109.34583,18.29563,917
29637,225712,943AD2B0B23FF40406FC81AD8E89FDB0,30201,12,13,1,109.4909,18.26465,1462
29638,225713,943AD2B0B23FF40406FC81AD8E89FDB0,31271,18,19,1,109.48958,18.26257,1462
29642,225758,803884DAE228D36B780CDE250AFE5FD1,31031,13,19,6,109.49979,18.25382,1510
29643,225759,803884DAE228D36B780CDE250AFE5FD1,31031,21,23,2,109.49979,18.25382,1510
29644,225779,1A6EAA2168CC835EA94CCB88CD588780,60551,0,3,3,109.42722,18.30111,1218
29645,225780,1A6EAA2168CC835EA94CCB88CD588780,30731,7,8,1,109.50944,18.22306,1555
29646,225781,1A6EAA2168CC835EA94CCB88CD588780,38291,11,12,1,109.51618,18.24313,1558
29647,225792,52132FCB4C4F2E635BC05915915367CC,38073,3,9,6,109.40813,18.30958,1169
29648,225793,52132FCB4C4F2E635BC05915915367CC,31471,10,11,1,109.34583,18.29563,917
29649,225794,52132FCB4C4F2E635BC05915915367CC,30661,13,23,10,109.37028,18.24361,1008
29650,225795,6F55ACFC3A2BD8567407A1426439CC11,38991,1,7,6,109.52681,18.30368,1618
29651,225796,6F55ACFC3A2BD8567407A1426439CC11,60171,7,8,1,109.51292,18.30694,1569
29652,225797,6F55ACFC3A2BD8567407A1426439CC11,38484,9,10,1,109.53028,18.31528,1620
29653,225798,6F55ACFC3A2BD8567407A1426439CC11,30071,11,12,1,109.52819,18.30472,1619
29654,225799,6F55ACFC3A2BD8567407A1426439CC11,60171,14,16,2,109.51292,18.30694,1569
29655,225800,6F55ACFC3A2BD8567407A1426439CC11,30071,19,21,2,109.52819,18.30472,1619
29659,225811,9B389AE8E9B004176803CCEAFF69104A,30951,7,14,7,109.56208,18.25667,1761
29660,225812,9B389AE8E9B004176803CCEAFF69104A,39371,16,18,2,109.56627,18.2646,1762
29664,225833,97C13EC52CDF5FAD62877D12E655CD2A,33101,0,1,1,109.68438,18.44368,2242
29665,225834,97C13EC52CDF5FAD62877D12E655CD2A,33354,2,5,3,109.67465,18.44583,2192
29666,225835,97C13EC52CDF5FAD62877D12E655CD2A,33101,8,11,3,109.68438,18.44368,2242
29667,225836,97C13EC52CDF5FAD62877D12E655CD2A,31931,13,15,2,109.54771,18.29403,1667
29668,225837,97C13EC52CDF5FAD62877D12E655CD2A,33101,16,23,7,109.68438,18.44368,2242
29669,225862,3CF2D78F1F91A0C91CD3B960F425BF0F,31521,0,10,10,109.51458,18.22542,1555
29670,225863,3CF2D78F1F91A0C91CD3B960F425BF0F,31471,11,14,3,109.34583,18.29563,917
29671,225864,3CF2D78F1F91A0C91CD3B960F425BF0F,31521,17,23,6,109.51458,18.22542,1555
29672,225865,6733B324E753B6172A50174A4CB1E5C2,31251,0,16,16,109.18528,18.2975,317
29673,225880,80779C982E47128931C5479B9B9DAF80,60131,17,19,2,109.49819,18.24778,1509
29674,225881,80779C982E47128931C5479B9B9DAF80,39091,19,23,4,109.50097,18.25222,1510
29675,225884,C17F2EF1DEA79C8C951E3013EE071B2C,30854,16,17,1,109.56889,18.27076,1763
29676,225885,C17F2EF1DEA79C8C951E3013EE071B2C,31071,18,20,2,109.58257,18.28458,1815
29677,225907,B80D6AB96D3D5CEE71A70ED25275F830,60472,0,1,1,109.46625,18.29542,1367
29678,225908,B80D6AB96D3D5CEE71A70ED25275F830,38951,2,3,1,109.48097,18.28868,1416
29679,225909,B80D6AB96D3D5CEE71A70ED25275F830,38951,3,7,4,109.48097,18.28868,1416
29680,225910,B80D6AB96D3D5CEE71A70ED25275F830,30251,12,14,2,109.50611,18.26653,1512
29681,225911,B80D6AB96D3D5CEE71A70ED25275F830,38951,19,20,1,109.48097,18.28868,1416
29682,225912,B80D6AB96D3D5CEE71A70ED25275F830,38951,20,23,3,109.48097,18.28868,1416
29683,225923,17D13F6A66037B54FAB5668CDC734401,31931,13,16,3,109.54771,18.29403,1667
29684,225924,17D13F6A66037B54FAB5668CDC734401,30721,21,22,1,109.51597,18.28257,1565
29696,226104,174A4B9C6ABA56DD185EEFF3295DCED3,30171,0,13,13,109.48458,18.27139,1463
29697,226105,174A4B9C6ABA56DD185EEFF3295DCED3,60381,15,16,1,109.5241,18.22458,1605
29698,226106,174A4B9C6ABA56DD185EEFF3295DCED3,30171,18,20,2,109.48458,18.27139,1463
29699,226107,174A4B9C6ABA56DD185EEFF3295DCED3,30711,21,23,2,109.50271,18.25347,1510
29700,226123,BE7763F8096EB5A037146E1CC4190538,39183,18,19,1,109.55542,18.28208,1715
29701,226124,BE7763F8096EB5A037146E1CC4190538,30854,20,21,1,109.56889,18.27076,1763
29702,226143,332A868849E47177376F9755C981E1C1,60391,3,4,1,109.47667,18.28757,1416
29703,226144,332A868849E47177376F9755C981E1C1,60441,5,6,1,109.46792,18.28604,1366
29704,226145,332A868849E47177376F9755C981E1C1,30111,9,10,1,109.47583,18.30542,1419
29705,226146,332A868849E47177376F9755C981E1C1,60441,10,13,3,109.46792,18.28604,1366
29706,226147,332A868849E47177376F9755C981E1C1,60391,13,19,6,109.47667,18.28757,1416
29707,226148,332A868849E47177376F9755C981E1C1,60441,21,22,1,109.46792,18.28604,1366
29711,226192,0CF6CC5FF24D6A6AB1B738BADBD1459E,31461,17,18,1,109.5091,18.25389,1510
29712,226193,0CF6CC5FF24D6A6AB1B738BADBD1459E,60281,18,23,5,109.51743,18.25924,1561
29713,226227,51B53CEC1B760EF1347019B41B791499,60541,9,12,3,109.4084,18.29208,1167
29714,226228,51B53CEC1B760EF1347019B41B791499,31521,12,14,2,109.51458,18.22542,1555
29715,226229,51B53CEC1B760EF1347019B41B791499,31521,15,17,2,109.51458,18.22542,1555
29716,226230,51B53CEC1B760EF1347019B41B791499,30361,18,19,1,109.50347,18.24,1508
29717,226231,51B53CEC1B760EF1347019B41B791499,31521,21,22,1,109.51458,18.22542,1555
29718,226292,EB316856896788EC8FD871E122E95728,31811,8,10,2,109.54201,18.31806,1671
29719,226293,EB316856896788EC8FD871E122E95728,30701,13,14,1,109.59313,18.32007,1871
29720,226294,EB316856896788EC8FD871E122E95728,31811,14,20,6,109.54201,18.31806,1671
29721,226364,CD3BCBAB8571FB81953C842A434E5DB8,30854,8,11,3,109.56889,18.27076,1763
29722,226365,CD3BCBAB8571FB81953C842A434E5DB8,31071,12,16,4,109.58257,18.28458,1815
29723,226406,9CCF240AA09CA64BC883A0FAC7F89243,31521,0,8,8,109.51458,18.22542,1555
29724,226407,9CCF240AA09CA64BC883A0FAC7F89243,60381,12,14,2,109.5241,18.22458,1605
29725,226408,9CCF240AA09CA64BC883A0FAC7F89243,31521,14,15,1,109.51458,18.22542,1555
29726,226409,9CCF240AA09CA64BC883A0FAC7F89243,60381,18,20,2,109.5241,18.22458,1605
29727,226410,9CCF240AA09CA64BC883A0FAC7F89243,31521,21,23,2,109.51458,18.22542,1555
29728,226421,4B004637D3CFBCA65EA00FFD3F1EF7A6,39183,13,14,1,109.55542,18.28208,1715
29729,226422,4B004637D3CFBCA65EA00FFD3F1EF7A6,31931,15,16,1,109.54771,18.29403,1667
29730,226423,4B004637D3CFBCA65EA00FFD3F1EF7A6,30854,20,23,3,109.56889,18.27076,1763
29731,226432,E5079E88FAE163C2D4174FAA9A13E19E,30681,0,11,11,109.48493,18.26917,1463
29732,226433,E5079E88FAE163C2D4174FAA9A13E19E,30861,11,13,2,109.52722,18.22743,1606
29733,226434,E5079E88FAE163C2D4174FAA9A13E19E,30861,18,19,1,109.52722,18.22743,1606
29734,226435,E5079E88FAE163C2D4174FAA9A13E19E,30731,20,22,2,109.50944,18.22306,1555
29742,226484,8181CAD16E195D45E1DC6491D97F9BEA,30891,0,7,7,109.59431,18.28389,1865
29743,226485,8181CAD16E195D45E1DC6491D97F9BEA,30581,11,17,6,109.62257,18.24951,1959
29744,226486,8181CAD16E195D45E1DC6491D97F9BEA,30181,18,19,1,109.51597,18.23313,1557
29745,226496,3C6B416FA80A7A03E14FC0317D60CB00,30854,0,21,21,109.56889,18.27076,1763
29746,226497,3C6B416FA80A7A03E14FC0317D60CB00,31071,21,22,1,109.58257,18.28458,1815
29755,226559,383C0E06F28B3BC35ED5F39E5789F4E7,30661,13,15,2,109.37028,18.24361,1008
29756,226560,383C0E06F28B3BC35ED5F39E5789F4E7,31201,17,19,2,109.51042,18.23819,1558
29757,226561,383C0E06F28B3BC35ED5F39E5789F4E7,38961,21,23,2,109.50847,18.23514,1507
29758,226566,54EA5A03224802DD904B7C6F69D9E71B,38951,0,7,7,109.48097,18.28868,1416
29759,226567,54EA5A03224802DD904B7C6F69D9E71B,33481,11,12,1,109.67278,18.41278,2187
29760,226578,993300654839821E7CBC0B1D6C1A4599,30232,0,7,7,109.6191,18.31701,1971
29761,226579,993300654839821E7CBC0B1D6C1A4599,61011,8,19,11,109.60653,18.19076,1900
29762,226590,2F440A235E684ECEDD042B3100A4AE95,31071,0,7,7,109.58257,18.28458,1815
29763,226591,2F440A235E684ECEDD042B3100A4AE95,30854,7,11,4,109.56889,18.27076,1763
29764,226592,2F440A235E684ECEDD042B3100A4AE95,31561,11,12,1,109.56792,18.28479,1765
29765,226593,2F440A235E684ECEDD042B3100A4AE95,30854,15,17,2,109.56889,18.27076,1763
29766,226594,2F440A235E684ECEDD042B3100A4AE95,30251,20,23,3,109.50611,18.26653,1512
29767,226595,0402BD114B7D5E20705E302B756CD062,30854,7,8,1,109.56889,18.27076,1763
29768,226596,0402BD114B7D5E20705E302B756CD062,31071,8,10,2,109.58257,18.28458,1815
29769,226597,0402BD114B7D5E20705E302B756CD062,31311,13,14,1,109.72299,18.27438,2364
29770,226613,5EBEA276FCB4A19AC5C987F5C7CC8908,60621,0,7,7,109.48354,18.27451,1464
29771,226614,5EBEA276FCB4A19AC5C987F5C7CC8908,60401,7,22,15,109.47444,18.27583,1414
29772,226615,C6702CA511246E70666F9E56EFC53769,60221,0,6,6,109.52569,18.29188,1616
29773,226616,C6702CA511246E70666F9E56EFC53769,30851,9,14,5,109.5616,18.27396,1713
29774,226639,7B1A07C39637E996C01DF0A3D287D3C6,30854,8,9,1,109.56889,18.27076,1763
29775,226640,7B1A07C39637E996C01DF0A3D287D3C6,39371,13,14,1,109.56627,18.2646,1762
29779,226661,75CDA53495DB73CFDD1D926B26EDAAA8,30861,0,7,7,109.52722,18.22743,1606
29780,226662,75CDA53495DB73CFDD1D926B26EDAAA8,31145,12,13,1,109.20431,18.30479,369
29781,226663,75CDA53495DB73CFDD1D926B26EDAAA8,38094,17,19,2,109.45403,18.28778,1316
29782,226664,75CDA53495DB73CFDD1D926B26EDAAA8,30861,20,23,3,109.52722,18.22743,1606
29783,226676,B55959B64746A18ECF5077B5F7359221,31561,0,19,19,109.56792,18.28479,1765
29784,226677,B55959B64746A18ECF5077B5F7359221,30854,19,21,2,109.56889,18.27076,1763
29788,226779,179FD4660C817BD29234A518F00339D3,60231,0,14,14,109.49903,18.21972,1504
29789,226780,179FD4660C817BD29234A518F00339D3,60084,14,17,3,109.4984,18.2334,1507
29790,226781,179FD4660C817BD29234A518F00339D3,60231,17,19,2,109.49903,18.21972,1504
29791,226782,179FD4660C817BD29234A518F00339D3,30341,19,20,1,109.3625,18.29167,966
29792,226783,179FD4660C817BD29234A518F00339D3,60231,20,23,3,109.49903,18.21972,1504
29793,226827,7EB4F76900011DECC835981CBE847D5E,30854,16,17,1,109.56889,18.27076,1763
29794,226828,7EB4F76900011DECC835981CBE847D5E,31561,19,21,2,109.56792,18.28479,1765
29795,226841,B7A2800FDF738E1064EAD2A5E58F7A3C,61011,0,14,14,109.60653,18.19076,1900
29796,226843,B7A2800FDF738E1064EAD2A5E58F7A3C,61011,19,20,1,109.60653,18.19076,1900
29801,226912,64F4CDF664AA04E7B79DE93C57128CF6,39181,8,18,10,109.55153,18.28035,1715
29802,226913,64F4CDF664AA04E7B79DE93C57128CF6,31931,21,23,2,109.54771,18.29403,1667
29809,226949,5ACB2494699EB2F10AA3427B417842C4,39151,15,16,1,109.49875,18.25097,1510
29810,226993,56F4A25A0E603B5B2CF39EF89A2DE812,38251,13,15,2,109.49618,18.25493,1510
29811,226994,56F4A25A0E603B5B2CF39EF89A2DE812,60161,17,19,2,109.49174,18.26181,1461
29812,226995,56F4A25A0E603B5B2CF39EF89A2DE812,31611,20,22,2,109.63076,18.34944,2026
29813,227010,EBBF71074D6F0C4C82B27902F4E823C5,38145,0,9,9,109.378,18.2912,1066
29814,227011,EBBF71074D6F0C4C82B27902F4E823C5,31471,12,14,2,109.34583,18.29563,917
29815,227012,EBBF71074D6F0C4C82B27902F4E823C5,38145,17,19,2,109.378,18.2912,1066
29816,227013,EBBF71074D6F0C4C82B27902F4E823C5,30681,20,21,1,109.48493,18.26917,1463
29817,227014,EBBF71074D6F0C4C82B27902F4E823C5,38145,21,23,2,109.378,18.2912,1066
29825,227044,E292D83051830D054E89D209EEABA4B9,31071,0,1,1,109.58257,18.28458,1815
29826,227045,E292D83051830D054E89D209EEABA4B9,31561,1,20,19,109.56792,18.28479,1765
29827,227046,2C7E329ABF5669760C98EF0FEA876F54,39111,0,10,10,109.5191,18.22597,1555
29828,227108,4EC716C6116001DCCA61DAB5E48F9371,30111,0,5,5,109.47583,18.30542,1419
29829,227109,4EC716C6116001DCCA61DAB5E48F9371,38391,6,7,1,109.44111,18.29083,1266
29830,227110,4EC716C6116001DCCA61DAB5E48F9371,60201,9,11,2,109.5041,18.2509,1510
29831,227111,4EC716C6116001DCCA61DAB5E48F9371,60441,15,16,1,109.46792,18.28604,1366
29836,227152,9C068F0C3303F33ADE079F339455F990,30181,9,10,1,109.51597,18.23313,1557
29837,227154,9C068F0C3303F33ADE079F339455F990,31031,17,20,3,109.49979,18.25382,1510
29838,227155,9C068F0C3303F33ADE079F339455F990,30181,22,23,1,109.51597,18.23313,1557
29839,227162,2B8C748A18FA7D08D4335AD7C9DEF01B,30851,9,10,1,109.5616,18.27396,1713
29840,227163,2B8C748A18FA7D08D4335AD7C9DEF01B,30951,10,12,2,109.56208,18.25667,1761
29841,227164,2B8C748A18FA7D08D4335AD7C9DEF01B,39371,12,14,2,109.56627,18.2646,1762
29842,227190,5F78EA2742F6109E8DCBBEDB5D54405A,30661,12,13,1,109.37028,18.24361,1008
29843,227191,5F78EA2742F6109E8DCBBEDB5D54405A,60381,17,21,4,109.5241,18.22458,1605
29844,227192,5F78EA2742F6109E8DCBBEDB5D54405A,60401,21,23,2,109.47444,18.27583,1414
29845,227206,6587551DA47309E484D1302521C8D417,38275,7,12,5,109.62875,18.22938,2006
29846,227207,6587551DA47309E484D1302521C8D417,60631,15,16,1,109.57778,18.27583,1814
29847,227208,6587551DA47309E484D1302521C8D417,60381,18,20,2,109.5241,18.22458,1605
29848,227227,2BCF009C69FE42CE27D7818D7C0D0313,60524,1,7,6,109.42951,18.28993,1216
29849,227228,2BCF009C69FE42CE27D7818D7C0D0313,31781,10,12,2,109.19847,18.2975,367
29850,227229,2BCF009C69FE42CE27D7818D7C0D0313,60054,14,15,1,109.3016,18.31229,770
29851,227230,2BCF009C69FE42CE27D7818D7C0D0313,31471,15,16,1,109.34583,18.29563,917
29852,227231,2BCF009C69FE42CE27D7818D7C0D0313,60524,21,23,2,109.42951,18.28993,1216
29853,227263,DA10676C4DA702E02A2C3FFFAC40ABA2,31561,0,3,3,109.56792,18.28479,1765
29854,227264,DA10676C4DA702E02A2C3FFFAC40ABA2,39183,6,22,16,109.55542,18.28208,1715
29855,227281,61F5089BD2CABA4C6A48281A94E5821D,30854,9,12,3,109.56889,18.27076,1763
29856,227282,61F5089BD2CABA4C6A48281A94E5821D,31071,12,14,2,109.58257,18.28458,1815
29857,227283,61F5089BD2CABA4C6A48281A94E5821D,30854,15,16,1,109.56889,18.27076,1763
29858,227284,89DE8482DFDA2DF79D79EDE80E8DF6A7,30581,17,19,2,109.62257,18.24951,1959
29859,227285,89DE8482DFDA2DF79D79EDE80E8DF6A7,60321,19,21,2,109.63611,18.24306,2008
29860,227335,D37BF241A4A35F0F341582CAF9EF0DD2,39191,0,9,9,109.51493,18.23472,1557
29861,227336,D37BF241A4A35F0F341582CAF9EF0DD2,30181,12,16,4,109.51597,18.23313,1557
29862,227385,D3CC138F01596B858EB1ECAA73909436,31391,17,18,1,109.50382,18.24285,1508
29863,227386,D3CC138F01596B858EB1ECAA73909436,31231,21,23,2,109.42597,18.29292,1217
29864,227395,ADD1B12D647B225460C017E17E9790EE,30111,0,5,5,109.47583,18.30542,1419
29865,227396,ADD1B12D647B225460C017E17E9790EE,60391,5,6,1,109.47667,18.28757,1416
29866,227397,ADD1B12D647B225460C017E17E9790EE,31471,8,9,1,109.34583,18.29563,917
29871,227415,BF762132BA656C7D6C16E7D07F31AF3B,30201,8,10,2,109.4909,18.26465,1462
29872,227416,BF762132BA656C7D6C16E7D07F31AF3B,31471,11,16,5,109.34583,18.29563,917
29873,227417,BF762132BA656C7D6C16E7D07F31AF3B,30201,17,23,6,109.4909,18.26465,1462
29874,227421,C709D01469E0800AF998DFAF42105CDC,30854,0,3,3,109.56889,18.27076,1763
29875,227422,C709D01469E0800AF998DFAF42105CDC,31561,7,16,9,109.56792,18.28479,1765
29876,227443,451E2BF48CD7B253EB0892324E679BCC,38297,0,7,7,109.52576,18.24965,1609
29877,227444,451E2BF48CD7B253EB0892324E679BCC,60281,7,12,5,109.51743,18.25924,1561
29878,227445,451E2BF48CD7B253EB0892324E679BCC,38291,12,14,2,109.51618,18.24313,1558
29879,227446,451E2BF48CD7B253EB0892324E679BCC,60281,14,17,3,109.51743,18.25924,1561
29880,227447,451E2BF48CD7B253EB0892324E679BCC,38297,18,22,4,109.52576,18.24965,1609
29881,227515,4F3A073B0E00F2C591EAC7CA3550DBAE,39181,0,6,6,109.55153,18.28035,1715
29882,227516,4F3A073B0E00F2C591EAC7CA3550DBAE,39181,6,8,2,109.55153,18.28035,1715
29883,227517,4F3A073B0E00F2C591EAC7CA3550DBAE,31071,11,13,2,109.58257,18.28458,1815
29884,227518,4F3A073B0E00F2C591EAC7CA3550DBAE,39181,15,16,1,109.55153,18.28035,1715
29885,227519,4F3A073B0E00F2C591EAC7CA3550DBAE,30851,19,21,2,109.5616,18.27396,1713
29886,227529,FE119DB57322892B4DF62B443B992BDF,38871,1,6,5,109.44681,18.28625,1316
29887,227530,FE119DB57322892B4DF62B443B992BDF,31781,9,11,2,109.19847,18.2975,367
29888,227531,FE119DB57322892B4DF62B443B992BDF,31471,13,14,1,109.34583,18.29563,917
29892,227573,C5190185E6A850F6CC88937542E0EA31,30854,7,18,11,109.56889,18.27076,1763
29893,227574,C5190185E6A850F6CC88937542E0EA31,39371,19,20,1,109.56627,18.2646,1762
29894,227575,C5190185E6A850F6CC88937542E0EA31,31071,20,21,1,109.58257,18.28458,1815
29895,227584,4C3E554FCF9940CA0E814B61B4474B2F,38105,0,16,16,109.40299,18.29229,1117
29896,227585,4C3E554FCF9940CA0E814B61B4474B2F,30361,19,22,3,109.50347,18.24,1508
29897,227621,F6A1EBB84FE583E84185C423218578F5,31561,0,13,13,109.56792,18.28479,1765
29898,227622,F6A1EBB84FE583E84185C423218578F5,39183,14,15,1,109.55542,18.28208,1715
29902,227716,E7BFEC31FDC076FECACC6CDB673FEF47,60381,2,16,14,109.5241,18.22458,1605
29903,227717,E7BFEC31FDC076FECACC6CDB673FEF47,30221,17,23,6,109.57833,18.20222,1802
29904,227718,A9FC13A339FBA35C9F749CD7B532151B,60641,12,14,2,109.53854,18.2359,1657
29905,227719,A9FC13A339FBA35C9F749CD7B532151B,39091,14,15,1,109.50097,18.25222,1510
29906,227720,A9FC13A339FBA35C9F749CD7B532151B,31723,17,23,6,109.68563,18.23701,2207
29907,227742,40C57F24FE0409ABB752B2031C349577,38951,0,18,18,109.48097,18.28868,1416
29908,227743,40C57F24FE0409ABB752B2031C349577,38951,19,23,4,109.48097,18.28868,1416
29909,227761,767325C9C51C25E76A4781E7E66DE8D0,38023,15,17,2,109.37132,18.28993,1016
29910,227762,767325C9C51C25E76A4781E7E66DE8D0,31181,18,20,2,109.50382,18.24813,1509
29911,227763,767325C9C51C25E76A4781E7E66DE8D0,38023,21,22,1,109.37132,18.28993,1016
29919,227807,34AB502A442AA8EA4A7FB30471B204DB,60621,0,5,5,109.48354,18.27451,1464
29920,227808,34AB502A442AA8EA4A7FB30471B204DB,60401,8,9,1,109.47444,18.27583,1414
29921,227809,34AB502A442AA8EA4A7FB30471B204DB,30341,13,14,1,109.3625,18.29167,966
29922,227810,34AB502A442AA8EA4A7FB30471B204DB,38094,16,17,1,109.45403,18.28778,1316
29923,227811,34AB502A442AA8EA4A7FB30471B204DB,30171,21,22,1,109.48458,18.27139,1463
29924,227833,B0C6DED232762D9BAF78468BD2731104,60041,12,14,2,109.39889,18.31944,1121
29925,227834,B0C6DED232762D9BAF78468BD2731104,31571,16,17,1,109.61563,18.23326,1957
29926,227835,B0C6DED232762D9BAF78468BD2731104,30581,19,23,4,109.62257,18.24951,1959
29934,227867,CD576F1C1CDFB89E6A99A20E65927346,38251,16,17,1,109.49618,18.25493,1510
29935,227868,CD576F1C1CDFB89E6A99A20E65927346,30854,19,21,2,109.56889,18.27076,1763
29942,227932,B6073F75180440AD0128577E76B732CE,30809,12,14,2,109.4891,18.28229,1465
29943,227933,B6073F75180440AD0128577E76B732CE,31261,17,18,1,109.51174,18.2466,1559
29944,227934,B6073F75180440AD0128577E76B732CE,60401,22,23,1,109.47444,18.27583,1414
29948,227997,225EDE82328108AFB3E7EE610CA3F074,31931,0,11,11,109.54771,18.29403,1667
29949,227998,225EDE82328108AFB3E7EE610CA3F074,31561,12,14,2,109.56792,18.28479,1765
29950,227999,225EDE82328108AFB3E7EE610CA3F074,30361,15,16,1,109.50347,18.24,1508
29951,228022,9E2CAA912E7C38B3460AB2C8B985CA0D,30854,2,22,20,109.56889,18.27076,1763
29952,228023,9E2CAA912E7C38B3460AB2C8B985CA0D,31071,22,23,1,109.58257,18.28458,1815
29956,228064,DA7F75EB1D499DC5A1A7DEE3CAD1DCEE,31561,0,5,5,109.56792,18.28479,1765
29957,228065,DA7F75EB1D499DC5A1A7DEE3CAD1DCEE,31071,8,10,2,109.58257,18.28458,1815
29958,228112,7FF3C6569A3990C03CAF6C52D3C8BC6C,30921,0,3,3,109.53903,18.29451,1667
29959,228113,7FF3C6569A3990C03CAF6C52D3C8BC6C,31931,7,8,1,109.54771,18.29403,1667
29960,228114,7FF3C6569A3990C03CAF6C52D3C8BC6C,30921,10,13,3,109.53903,18.29451,1667
29961,228115,7FF3C6569A3990C03CAF6C52D3C8BC6C,31931,13,19,6,109.54771,18.29403,1667
29962,228116,7FF3C6569A3990C03CAF6C52D3C8BC6C,30921,21,23,2,109.53903,18.29451,1667
29963,228124,BA9F8903EC2A1C9DFCBB7CC5DE07DE50,39151,1,7,6,109.49875,18.25097,1510
29964,228125,BA9F8903EC2A1C9DFCBB7CC5DE07DE50,31071,10,19,9,109.58257,18.28458,1815
29965,228126,BA9F8903EC2A1C9DFCBB7CC5DE07DE50,30854,20,22,2,109.56889,18.27076,1763
29970,228148,066E3B290AAC556F650E56DD0F693AB2,38251,22,23,1,109.49618,18.25493,1510
29971,228168,F47C4E1E39056C43B0AD32AC994AB7C0,31931,0,22,22,109.54771,18.29403,1667
29972,228169,F47C4E1E39056C43B0AD32AC994AB7C0,60361,22,23,1,109.51938,18.29681,1567
29973,228190,182D5101D28D51096306D4EF5FDD4501,60084,0,4,4,109.4984,18.2334,1507
29974,228191,182D5101D28D51096306D4EF5FDD4501,30211,5,6,1,109.49882,18.23931,1508
29975,228192,182D5101D28D51096306D4EF5FDD4501,31031,9,10,1,109.49979,18.25382,1510
29976,228193,182D5101D28D51096306D4EF5FDD4501,31101,11,13,2,109.65389,18.23403,2057
29977,228194,182D5101D28D51096306D4EF5FDD4501,30271,14,16,2,109.49132,18.23153,1456
29978,228195,182D5101D28D51096306D4EF5FDD4501,38251,18,20,2,109.49618,18.25493,1510
29979,228196,182D5101D28D51096306D4EF5FDD4501,31231,21,22,1,109.42597,18.29292,1217
29980,228201,64EA917EAAD3EB55DA2ABB227203C131,60631,0,7,7,109.57778,18.27583,1814
29981,228202,64EA917EAAD3EB55DA2ABB227203C131,30851,10,23,13,109.5616,18.27396,1713
29982,228228,95AA3325BCDA7D9697384F31CB14FBD1,30111,0,7,7,109.47583,18.30542,1419
29983,228229,95AA3325BCDA7D9697384F31CB14FBD1,31781,11,12,1,109.19847,18.2975,367
29984,228230,95AA3325BCDA7D9697384F31CB14FBD1,31471,12,14,2,109.34583,18.29563,917
29985,228231,95AA3325BCDA7D9697384F31CB14FBD1,30111,19,20,1,109.47583,18.30542,1419
29989,228290,5291560AC3CA28497E4CB7832DDE2A8C,30581,18,19,1,109.62257,18.24951,1959
29990,228291,5291560AC3CA28497E4CB7832DDE2A8C,60214,22,23,1,109.63104,18.24493,2009
29991,228292,A9C8F328449201624A136B13BD43BEFF,31521,0,2,2,109.51458,18.22542,1555
29992,228293,A9C8F328449201624A136B13BD43BEFF,60291,4,8,4,109.50826,18.24639,1509
29993,228294,A9C8F328449201624A136B13BD43BEFF,30661,11,14,3,109.37028,18.24361,1008
30000,228412,54CB15055EFF66319A7EAB3FC49E46B1,38891,19,20,1,109.51486,18.24118,1558
30001,228413,54CB15055EFF66319A7EAB3FC49E46B1,30421,20,21,1,109.50021,18.25861,1511
30002,228414,54CB15055EFF66319A7EAB3FC49E46B1,30809,22,23,1,109.4891,18.28229,1465
30003,228426,E6D4DFF479624FE5A6D32ED2123EE444,31521,0,1,1,109.51458,18.22542,1555
30004,228427,E6D4DFF479624FE5A6D32ED2123EE444,38891,3,5,2,109.51486,18.24118,1558
30005,228428,E6D4DFF479624FE5A6D32ED2123EE444,30511,5,6,1,109.51069,18.24208,1558
30006,228429,E6D4DFF479624FE5A6D32ED2123EE444,60291,7,9,2,109.50826,18.24639,1509
30007,228430,E6D4DFF479624FE5A6D32ED2123EE444,33051,13,14,1,109.6475,18.46618,2096
30008,228431,E6D4DFF479624FE5A6D32ED2123EE444,31521,17,19,2,109.51458,18.22542,1555
30009,228432,E6D4DFF479624FE5A6D32ED2123EE444,60291,19,22,3,109.50826,18.24639,1509
30010,228443,A549C024E6F63EDBD3DC866F10DB11CE,31071,12,13,1,109.58257,18.28458,1815
30011,228444,A549C024E6F63EDBD3DC866F10DB11CE,30854,16,18,2,109.56889,18.27076,1763
30012,228458,8C2A72A3EA8DBE7544B4A433B2BC3FE0,31261,0,6,6,109.51174,18.2466,1559
30013,228459,8C2A72A3EA8DBE7544B4A433B2BC3FE0,38291,7,10,3,109.51618,18.24313,1558
30014,228460,8C2A72A3EA8DBE7544B4A433B2BC3FE0,60491,14,15,1,109.43354,18.30847,1269
30015,228461,8C2A72A3EA8DBE7544B4A433B2BC3FE0,31021,18,20,2,109.49021,18.27,1463
30016,228462,8C2A72A3EA8DBE7544B4A433B2BC3FE0,60261,20,23,3,109.44326,18.3075,1319
30021,228504,608A55C14BAB2A5B627ACC1F39B89FB6,30854,13,17,4,109.56889,18.27076,1763
30022,228505,608A55C14BAB2A5B627ACC1F39B89FB6,31071,18,21,3,109.58257,18.28458,1815
30023,228506,608A55C14BAB2A5B627ACC1F39B89FB6,31945,22,23,1,109.58021,18.29403,1817
30027,228564,85586D73EA48B4F4D520D899B0BE0554,30291,0,5,5,109.50403,18.27028,1513
30028,228565,85586D73EA48B4F4D520D899B0BE0554,30854,6,9,3,109.56889,18.27076,1763
30029,228566,85586D73EA48B4F4D520D899B0BE0554,31071,10,15,5,109.58257,18.28458,1815
30030,228567,85586D73EA48B4F4D520D899B0BE0554,30854,15,18,3,109.56889,18.27076,1763
30031,228568,85586D73EA48B4F4D520D899B0BE0554,30291,19,23,4,109.50403,18.27028,1513
30032,228579,C30EF1A03F3ACD87114629BE5EBA14E8,60041,13,14,1,109.39889,18.31944,1121
30033,228580,C30EF1A03F3ACD87114629BE5EBA14E8,60552,14,16,2,109.41729,18.30014,1218
30034,228581,C30EF1A03F3ACD87114629BE5EBA14E8,30711,20,21,1,109.50271,18.25347,1510
30035,228603,546C572FC49C780F9A9AF62ED98666DF,30681,0,14,14,109.48493,18.26917,1463
30036,228604,546C572FC49C780F9A9AF62ED98666DF,30351,14,22,8,109.41701,18.29292,1217
30037,228605,908C7D49FB1480C9AB62D9B8DA7BEC53,30441,13,14,1,109.64021,18.25424,2010
30038,228606,908C7D49FB1480C9AB62D9B8DA7BEC53,31031,15,19,4,109.49979,18.25382,1510
30039,228607,908C7D49FB1480C9AB62D9B8DA7BEC53,31031,19,21,2,109.49979,18.25382,1510
30040,228608,908C7D49FB1480C9AB62D9B8DA7BEC53,38251,21,23,2,109.49618,18.25493,1510
30045,228642,B09F6CB43F7BB3E6391589239BFB1120,38951,0,12,12,109.48097,18.28868,1416
30046,228643,B09F6CB43F7BB3E6391589239BFB1120,60041,13,15,2,109.39889,18.31944,1121
30047,228644,B09F6CB43F7BB3E6391589239BFB1120,38951,19,23,4,109.48097,18.28868,1416
30048,228645,7B537E00BE7633BC2F59AF379F204FC9,38356,0,8,8,109.50201,18.21486,1504
30049,228646,7B537E00BE7633BC2F59AF379F204FC9,38881,10,12,2,109.51618,18.26431,1562
30050,228685,AF53449CC3CDD3E221C0679AB81040FD,60041,0,1,1,109.39889,18.31944,1121
30051,228686,AF53449CC3CDD3E221C0679AB81040FD,38275,2,20,18,109.62875,18.22938,2006
30052,228687,AF53449CC3CDD3E221C0679AB81040FD,39101,21,23,2,109.50132,18.24931,1509
30056,228765,3930042D05CE9089B6239DEA3A3E855C,31471,17,18,1,109.34583,18.29563,917
30057,228766,3930042D05CE9089B6239DEA3A3E855C,30661,19,22,3,109.37028,18.24361,1008
30058,228767,3930042D05CE9089B6239DEA3A3E855C,60411,22,23,1,109.32514,18.30854,869
30070,228806,43F5AB52A0AF3FEB5880C6DCD16BBA02,60011,0,9,9,109.48965,18.30222,1468
30071,228807,43F5AB52A0AF3FEB5880C6DCD16BBA02,39101,14,15,1,109.50132,18.24931,1509
30072,228808,43F5AB52A0AF3FEB5880C6DCD16BBA02,60011,20,23,3,109.48965,18.30222,1468
30073,228833,7421066246AAD1C230E7E2A7ADF06E9D,30711,0,1,1,109.50271,18.25347,1510
30074,228834,7421066246AAD1C230E7E2A7ADF06E9D,60631,2,6,4,109.57778,18.27583,1814
30075,228835,7421066246AAD1C230E7E2A7ADF06E9D,30854,7,10,3,109.56889,18.27076,1763
30076,228848,10026EC528DC65E6B062D4E8B47727C1,38127,0,6,6,109.50833,18.27222,1513
30077,228849,10026EC528DC65E6B062D4E8B47727C1,60117,10,11,1,109.73604,18.35681,2427
30078,228850,10026EC528DC65E6B062D4E8B47727C1,38127,13,23,10,109.50833,18.27222,1513
30079,228869,417408FFDA93B177641D270D3A5C4B2D,30854,17,18,1,109.56889,18.27076,1763
30080,228870,417408FFDA93B177641D270D3A5C4B2D,31071,19,23,4,109.58257,18.28458,1815
30081,228886,C39A87B1BC9DA20E7546ED50A7A8B13C,30854,0,9,9,109.56889,18.27076,1763
30082,228887,C39A87B1BC9DA20E7546ED50A7A8B13C,31321,13,15,2,109.63799,18.23201,2007
30083,228888,C39A87B1BC9DA20E7546ED50A7A8B13C,60631,18,19,1,109.57778,18.27583,1814
30084,228889,C39A87B1BC9DA20E7546ED50A7A8B13C,30854,21,22,1,109.56889,18.27076,1763
30088,228929,E484FD222AE68252EABA732103338917,31071,2,6,4,109.58257,18.28458,1815
30089,228930,E484FD222AE68252EABA732103338917,30854,9,20,11,109.56889,18.27076,1763
30090,228939,AAD294F97E8F953422B544ED61B36D13,39371,12,14,2,109.56627,18.2646,1762
30091,228940,AAD294F97E8F953422B544ED61B36D13,60381,16,17,1,109.5241,18.22458,1605
30092,228941,AAD294F97E8F953422B544ED61B36D13,31071,19,23,4,109.58257,18.28458,1815
30093,228967,EFFEF00C078D502D6D0D1D469ACBA466,39041,0,8,8,109.40021,18.29278,1117
30094,228968,EFFEF00C078D502D6D0D1D469ACBA466,31471,9,11,2,109.34583,18.29563,917
30095,228969,EFFEF00C078D502D6D0D1D469ACBA466,39041,12,14,2,109.40021,18.29278,1117
30096,228970,EFFEF00C078D502D6D0D1D469ACBA466,31471,15,16,1,109.34583,18.29563,917
30097,228971,EFFEF00C078D502D6D0D1D469ACBA466,31534,19,20,1,109.49368,18.25806,1461
30098,228972,EFFEF00C078D502D6D0D1D469ACBA466,30421,22,23,1,109.50021,18.25861,1511
30099,228978,AEB67BDC79FE6552942E6F2DEC149F32,31864,21,23,2,109.49014,18.28333,1465
30103,229012,DF49F834C08C7E8FA6D78272EE1FB651,60361,0,6,6,109.51938,18.29681,1567
30104,229013,DF49F834C08C7E8FA6D78272EE1FB651,30851,6,8,2,109.5616,18.27396,1713
30105,229014,DF49F834C08C7E8FA6D78272EE1FB651,39371,9,10,1,109.56627,18.2646,1762
30106,229015,DF49F834C08C7E8FA6D78272EE1FB651,30851,10,15,5,109.5616,18.27396,1713
30107,229016,DF49F834C08C7E8FA6D78272EE1FB651,60361,19,22,3,109.51938,18.29681,1567
30108,229041,BD4652414D5C17466BA36FD4BD943A94,60221,3,7,4,109.52569,18.29188,1616
30109,229042,BD4652414D5C17466BA36FD4BD943A94,31931,9,10,1,109.54771,18.29403,1667
30110,229069,B421B0364BC07B443944D07A1DCB065A,60571,0,8,8,109.50722,18.25056,1510
30111,229070,B421B0364BC07B443944D07A1DCB065A,30711,9,11,2,109.50271,18.25347,1510
30112,229071,B421B0364BC07B443944D07A1DCB065A,30711,12,14,2,109.50271,18.25347,1510
30113,229072,B421B0364BC07B443944D07A1DCB065A,60131,14,19,5,109.49819,18.24778,1509
30114,229073,B421B0364BC07B443944D07A1DCB065A,60201,20,21,1,109.5041,18.2509,1510
30115,229076,D6B14C7387647D8C883334DAFB518257,31561,16,17,1,109.56792,18.28479,1765
30116,229077,D6B14C7387647D8C883334DAFB518257,39183,20,22,2,109.55542,18.28208,1715
30121,229162,C85D0B931BEF54F05B9ABBBB03212DB7,30854,8,9,1,109.56889,18.27076,1763
30122,229163,C85D0B931BEF54F05B9ABBBB03212DB7,31561,9,11,2,109.56792,18.28479,1765
30123,229164,C85D0B931BEF54F05B9ABBBB03212DB7,30854,12,14,2,109.56889,18.27076,1763
30124,229165,C85D0B931BEF54F05B9ABBBB03212DB7,31031,16,17,1,109.49979,18.25382,1510
30125,229166,C85D0B931BEF54F05B9ABBBB03212DB7,30854,18,20,2,109.56889,18.27076,1763
30126,229225,8F0EF70AFA814412ECB04C3460518F08,38027,0,1,1,109.38833,18.2909,1066
30127,229226,8F0EF70AFA814412ECB04C3460518F08,39061,2,5,3,109.38222,18.28958,1066
30128,229227,8F0EF70AFA814412ECB04C3460518F08,31145,9,11,2,109.20431,18.30479,369
30129,229228,8F0EF70AFA814412ECB04C3460518F08,31781,11,12,1,109.19847,18.2975,367
30130,229229,8F0EF70AFA814412ECB04C3460518F08,38027,13,18,5,109.38833,18.2909,1066
30131,229230,8F0EF70AFA814412ECB04C3460518F08,31671,18,19,1,109.38965,18.29813,1068
30132,229231,8F0EF70AFA814412ECB04C3460518F08,38027,20,21,1,109.38833,18.2909,1066
30133,229232,88ED3F2D6DF6080D65EC7DC0BC60DC48,31071,0,14,14,109.58257,18.28458,1815
30134,229233,88ED3F2D6DF6080D65EC7DC0BC60DC48,31061,19,20,1,109.53333,18.23257,1607
30135,229234,88ED3F2D6DF6080D65EC7DC0BC60DC48,30854,21,22,1,109.56889,18.27076,1763
30136,229239,EE34D692D2A50A103F8F57F242651A73,30711,13,14,1,109.50271,18.25347,1510
30137,229240,EE34D692D2A50A103F8F57F242651A73,38271,16,21,5,109.62632,18.23049,1956
30138,229282,E58F7930139B2ED51DE79005F05C056D,39183,0,16,16,109.55542,18.28208,1715
30139,229283,E58F7930139B2ED51DE79005F05C056D,39181,19,21,2,109.55153,18.28035,1715
30140,229288,EBF906C5498076BCFA3E97DF6001B4F3,60631,0,7,7,109.57778,18.27583,1814
30141,229289,EBF906C5498076BCFA3E97DF6001B4F3,30854,8,9,1,109.56889,18.27076,1763
30142,229319,2A6BA0678DDF16AF08BAC9E3FA3C9391,31561,4,8,4,109.56792,18.28479,1765
30143,229320,2A6BA0678DDF16AF08BAC9E3FA3C9391,30854,8,23,15,109.56889,18.27076,1763
30144,229328,928DF0385E8541CFD2F5858501C04155,60354,0,4,4,109.58701,18.28521,1815
30145,229329,928DF0385E8541CFD2F5858501C04155,30854,7,11,4,109.56889,18.27076,1763
30149,229356,18EE47452FD5BE7C01D5DBC710576D9F,30121,19,20,1,109.52861,18.27222,1613
30150,229357,18EE47452FD5BE7C01D5DBC710576D9F,39131,22,23,1,109.2066,18.29639,417
30155,229391,E16204D131FCD957D5ADB9592C1DD0ED,31071,0,14,14,109.58257,18.28458,1815
30156,229392,E16204D131FCD957D5ADB9592C1DD0ED,30854,14,15,1,109.56889,18.27076,1763
30160,229430,A5AB87B7C2F022350AE3B375F8C35F85,60491,0,6,6,109.43354,18.30847,1269
30161,229431,A5AB87B7C2F022350AE3B375F8C35F85,31145,10,11,1,109.20431,18.30479,369
30162,229446,F57902A58026464B5BDED6D5CB0C8C35,30201,0,3,3,109.4909,18.26465,1462
30163,229447,F57902A58026464B5BDED6D5CB0C8C35,30081,4,12,8,109.50243,18.26632,1512
30168,229498,4DA47CA7E0DF1887A4FCFA8DEF75F8FC,31761,0,3,3,109.60521,18.27965,1914
30169,229499,4DA47CA7E0DF1887A4FCFA8DEF75F8FC,31421,8,11,3,109.55382,18.22347,1705
30170,229500,4DA47CA7E0DF1887A4FCFA8DEF75F8FC,30851,11,13,2,109.5616,18.27396,1713
30171,229508,ABCD0851CC1C78BCD7AF6DBDF2F5DE49,60551,0,4,4,109.42722,18.30111,1218
30172,229509,ABCD0851CC1C78BCD7AF6DBDF2F5DE49,60552,5,23,18,109.41729,18.30014,1218
30173,229510,5E97A4561E11AAC4FBC53FD068EAA52B,30854,0,7,7,109.56889,18.27076,1763
30174,229511,5E97A4561E11AAC4FBC53FD068EAA52B,30531,11,18,7,109.53271,18.21472,1604
30181,229548,15BEF05F9BAA02E1947325DA4F75A74C,38141,0,1,1,109.39479,18.2916,1116
30182,229549,15BEF05F9BAA02E1947325DA4F75A74C,38027,3,4,1,109.38833,18.2909,1066
30183,229550,15BEF05F9BAA02E1947325DA4F75A74C,38141,4,6,2,109.39479,18.2916,1116
30184,229551,15BEF05F9BAA02E1947325DA4F75A74C,38141,7,8,1,109.39479,18.2916,1116
30185,229552,15BEF05F9BAA02E1947325DA4F75A74C,31781,10,12,2,109.19847,18.2975,367
30186,229553,15BEF05F9BAA02E1947325DA4F75A74C,31471,14,15,1,109.34583,18.29563,917
30187,229577,D9E71D1287A0AD1E1349273E1141510C,60552,0,6,6,109.41729,18.30014,1218
30188,229578,D9E71D1287A0AD1E1349273E1141510C,60524,7,8,1,109.42951,18.28993,1216
30189,229579,D9E71D1287A0AD1E1349273E1141510C,60552,9,11,2,109.41729,18.30014,1218
30190,229580,D9E71D1287A0AD1E1349273E1141510C,30361,15,18,3,109.50347,18.24,1508
30191,229581,D9E71D1287A0AD1E1349273E1141510C,60552,19,21,2,109.41729,18.30014,1218
30192,229620,5A8AFFF7EC3EBF07BA91D30C77FA1962,31471,13,14,1,109.34583,18.29563,917
30193,229621,5A8AFFF7EC3EBF07BA91D30C77FA1962,38094,18,19,1,109.45403,18.28778,1316
30194,229622,5A8AFFF7EC3EBF07BA91D30C77FA1962,31271,21,23,2,109.48958,18.26257,1462
30195,229698,91EC74D2B208A10BECBB101C6735C578,30151,12,13,1,109.50986,18.25083,1560
30196,229699,91EC74D2B208A10BECBB101C6735C578,30151,14,16,2,109.50986,18.25083,1560
30197,229700,91EC74D2B208A10BECBB101C6735C578,31864,18,23,5,109.49014,18.28333,1465
30198,229716,4995463B780282C9C030A19D9F49AEAC,31071,0,6,6,109.58257,18.28458,1815
30199,229717,4995463B780282C9C030A19D9F49AEAC,30854,7,14,7,109.56889,18.27076,1763
30200,229718,4995463B780282C9C030A19D9F49AEAC,38251,15,16,1,109.49618,18.25493,1510
30201,229719,4995463B780282C9C030A19D9F49AEAC,30854,21,22,1,109.56889,18.27076,1763
30205,229804,B340EDEF4A878E8DF5CBEC25E465EACE,30854,0,4,4,109.56889,18.27076,1763
30206,229805,B340EDEF4A878E8DF5CBEC25E465EACE,31071,5,7,2,109.58257,18.28458,1815
30207,229806,B340EDEF4A878E8DF5CBEC25E465EACE,30854,7,9,2,109.56889,18.27076,1763
30208,229807,B340EDEF4A878E8DF5CBEC25E465EACE,60631,9,10,1,109.57778,18.27583,1814
30209,229808,B340EDEF4A878E8DF5CBEC25E465EACE,30854,13,15,2,109.56889,18.27076,1763
30210,229809,B340EDEF4A878E8DF5CBEC25E465EACE,60631,15,17,2,109.57778,18.27583,1814
30211,229810,B340EDEF4A878E8DF5CBEC25E465EACE,30191,21,23,2,109.50361,18.22701,1506
30212,229822,F198CAA1F49ACA5D003FD8F8473B3798,31071,0,6,6,109.58257,18.28458,1815
30213,229823,F198CAA1F49ACA5D003FD8F8473B3798,30854,7,23,16,109.56889,18.27076,1763
30214,229846,C860767955774E3494068CF38C009FB6,60391,0,9,9,109.47667,18.28757,1416
30215,229847,C860767955774E3494068CF38C009FB6,31061,10,11,1,109.53333,18.23257,1607
30216,229848,C860767955774E3494068CF38C009FB6,60391,13,15,2,109.47667,18.28757,1416
30217,229849,C860767955774E3494068CF38C009FB6,31061,16,17,1,109.53333,18.23257,1607
30218,229850,C860767955774E3494068CF38C009FB6,31031,19,21,2,109.49979,18.25382,1510
30219,229851,C860767955774E3494068CF38C009FB6,60391,21,23,2,109.47667,18.28757,1416
30220,229871,DAB08D254D49BF150533311BD904D49C,39183,21,22,1,109.55542,18.28208,1715
30221,229872,7334BFE245C0E1675EC3C07645407CF3,31121,0,6,6,109.16292,18.37063,230
30222,229873,7334BFE245C0E1675EC3C07645407CF3,60411,7,11,4,109.32514,18.30854,869
30223,229874,7334BFE245C0E1675EC3C07645407CF3,30661,11,13,2,109.37028,18.24361,1008
30224,229875,7334BFE245C0E1675EC3C07645407CF3,60411,14,18,4,109.32514,18.30854,869
30225,229876,7334BFE245C0E1675EC3C07645407CF3,31121,19,20,1,109.16292,18.37063,230
30229,229894,662D882A6A10D0E6C3566690F0A40636,30854,0,8,8,109.56889,18.27076,1763
30230,229895,662D882A6A10D0E6C3566690F0A40636,31071,9,10,1,109.58257,18.28458,1815
30231,229898,0526FBDD03CECB7E3925506B4441EC17,31441,0,8,8,109.51181,18.24424,1559
30232,229899,0526FBDD03CECB7E3925506B4441EC17,30511,8,19,11,109.51069,18.24208,1558
30233,229949,1C9FB52F3215AC60A67CACDC4AFA4355,60411,0,7,7,109.32514,18.30854,869
30234,229950,1C9FB52F3215AC60A67CACDC4AFA4355,60054,7,9,2,109.3016,18.31229,770
30235,229963,3A3335F59AAFA980A696389C11716C78,60371,19,23,4,109.53063,18.30056,1618
30236,229964,23BB561D2463E4EE34970643BFB775BC,38017,0,7,7,109.49729,18.21424,1504
30237,229965,23BB561D2463E4EE34970643BFB775BC,31851,9,10,1,109.71736,18.29007,2316
30238,229966,23BB561D2463E4EE34970643BFB775BC,38017,12,21,9,109.49729,18.21424,1504
30239,229967,23BB561D2463E4EE34970643BFB775BC,30051,21,23,2,109.48917,18.21215,1453
30240,230008,C711EA8F4B039EAC279F7CFC24309A8A,38157,0,1,1,109.51483,18.26958,1563
30241,230009,C711EA8F4B039EAC279F7CFC24309A8A,31951,4,5,1,109.52174,18.30299,1568
30242,230010,C711EA8F4B039EAC279F7CFC24309A8A,30071,6,8,2,109.52819,18.30472,1619
30243,230011,C711EA8F4B039EAC279F7CFC24309A8A,30071,10,11,1,109.52819,18.30472,1619
30244,230012,C711EA8F4B039EAC279F7CFC24309A8A,38157,14,16,2,109.51483,18.26958,1563
30245,230058,A6CCB3B38301DFF4978B708468E178C6,30281,13,14,1,109.50597,18.27583,1514
30246,230059,A6CCB3B38301DFF4978B708468E178C6,31864,17,18,1,109.49014,18.28333,1465
30247,230060,A6CCB3B38301DFF4978B708468E178C6,38185,19,23,4,109.51333,18.27347,1563
30252,230099,D3FB1B9D3C241050E5FB29B7C0AA31BE,31611,1,8,7,109.63076,18.34944,2026
30253,230100,D3FB1B9D3C241050E5FB29B7C0AA31BE,30711,9,11,2,109.50271,18.25347,1510
30254,230101,D3FB1B9D3C241050E5FB29B7C0AA31BE,60231,13,18,5,109.49903,18.21972,1504
30255,230102,D3FB1B9D3C241050E5FB29B7C0AA31BE,31611,21,23,2,109.63076,18.34944,2026
30263,230244,5C8931079B2869B17047E4E857E99006,30921,0,14,14,109.53903,18.29451,1667
30264,230245,5C8931079B2869B17047E4E857E99006,60371,17,18,1,109.53063,18.30056,1618
30268,230260,8AD9F37216B2D3FCE05CA77434307672,30741,0,7,7,109.49833,18.28681,1516
30269,230261,8AD9F37216B2D3FCE05CA77434307672,31041,8,15,7,109.50278,18.23701,1507
30270,230283,B81DEDE33B0853E35D97557F334A4861,60361,0,6,6,109.51938,18.29681,1567
30271,230284,B81DEDE33B0853E35D97557F334A4861,31931,7,8,1,109.54771,18.29403,1667
30272,230285,B81DEDE33B0853E35D97557F334A4861,60371,8,10,2,109.53063,18.30056,1618
30273,230286,B81DEDE33B0853E35D97557F334A4861,31931,12,15,3,109.54771,18.29403,1667
30274,230287,B81DEDE33B0853E35D97557F334A4861,60371,15,17,2,109.53063,18.30056,1618
30275,230288,B81DEDE33B0853E35D97557F334A4861,60361,18,23,5,109.51938,18.29681,1567
30283,230317,E8D51F8B53F290BFD73338AD2AD8C728,31561,4,6,2,109.56792,18.28479,1765
30284,230318,E8D51F8B53F290BFD73338AD2AD8C728,39183,8,9,1,109.55542,18.28208,1715
30285,230319,E8D51F8B53F290BFD73338AD2AD8C728,31561,10,13,3,109.56792,18.28479,1765
30286,230320,E8D51F8B53F290BFD73338AD2AD8C728,30854,14,18,4,109.56889,18.27076,1763
30287,230321,E8D51F8B53F290BFD73338AD2AD8C728,31561,20,22,2,109.56792,18.28479,1765
30288,230330,D77A5C2E97A74D805A87772560CE2BFF,60661,2,8,6,109.548,18.2377,1657
30289,230331,D77A5C2E97A74D805A87772560CE2BFF,31421,8,10,2,109.55382,18.22347,1705
30290,230332,D77A5C2E97A74D805A87772560CE2BFF,60381,10,11,1,109.5241,18.22458,1605
30291,230333,D77A5C2E97A74D805A87772560CE2BFF,60661,13,15,2,109.548,18.2377,1657
30292,230334,D77A5C2E97A74D805A87772560CE2BFF,31551,18,21,3,109.55868,18.24222,1708
30293,230352,FA60FF8C4CEE422324352ED1E74F3300,31521,16,18,2,109.51458,18.22542,1555
30294,230353,FA60FF8C4CEE422324352ED1E74F3300,39321,18,19,1,109.529,18.2167,1604
30295,230354,FA60FF8C4CEE422324352ED1E74F3300,31521,20,23,3,109.51458,18.22542,1555
30299,230377,E93606C251F3F3CCDD3B5586D2DAFE77,30854,14,17,3,109.56889,18.27076,1763
30300,230378,E93606C251F3F3CCDD3B5586D2DAFE77,31041,19,20,1,109.50278,18.23701,1507
30301,230379,E93606C251F3F3CCDD3B5586D2DAFE77,30854,22,23,1,109.56889,18.27076,1763
30302,230426,60ACD2B6657BEEA3D1B558DE71329F84,60084,19,21,2,109.4984,18.2334,1507
30303,230427,60ACD2B6657BEEA3D1B558DE71329F84,30271,22,23,1,109.49132,18.23153,1456
30304,230432,7353E0D0F8DB71C781DB049F9A7D0F1B,30854,21,22,1,109.56889,18.27076,1763
30313,230485,00145806BBF2F60A963743509F901155,30081,0,7,7,109.50243,18.26632,1512
30314,230486,00145806BBF2F60A963743509F901155,30081,7,12,5,109.50243,18.26632,1512
30315,230487,00145806BBF2F60A963743509F901155,38754,13,14,1,109.74667,18.37382,2430
30319,230643,C0D9A8D1FC57A96EA766A127A0E8EAAC,30854,2,6,4,109.56889,18.27076,1763
30320,230644,C0D9A8D1FC57A96EA766A127A0E8EAAC,31571,7,16,9,109.61563,18.23326,1957
30321,230645,1411F9F89E8C658605CC1C5E821DCFD9,60361,13,14,1,109.51938,18.29681,1567
30322,230646,1411F9F89E8C658605CC1C5E821DCFD9,30854,14,17,3,109.56889,18.27076,1763
30323,230650,015CDEB9169BCE5537ABAE49B6A63F2B,60354,1,6,5,109.58701,18.28521,1815
30324,230651,015CDEB9169BCE5537ABAE49B6A63F2B,30854,10,20,10,109.56889,18.27076,1763
30325,230677,E4D199FCE009427481C9D06B9609AB1E,31931,12,14,2,109.54771,18.29403,1667
30326,230678,E4D199FCE009427481C9D06B9609AB1E,39181,17,18,1,109.55153,18.28035,1715
30327,230679,E4D199FCE009427481C9D06B9609AB1E,31931,19,20,1,109.54771,18.29403,1667
30328,230680,E4D199FCE009427481C9D06B9609AB1E,39181,20,23,3,109.55153,18.28035,1715
30332,230693,17E33F98086F9D71B1BE47BE6FC58756,30681,0,8,8,109.48493,18.26917,1463
30333,230694,17E33F98086F9D71B1BE47BE6FC58756,31145,11,13,2,109.20431,18.30479,369
30334,230695,17E33F98086F9D71B1BE47BE6FC58756,38271,15,17,2,109.62632,18.23049,1956
30335,230696,17E33F98086F9D71B1BE47BE6FC58756,30171,21,23,2,109.48458,18.27139,1463
30339,230704,68D17CEA0DFC47DDDEC25D4A4CC5A3DB,30421,15,16,1,109.50021,18.25861,1511
30340,230705,68D17CEA0DFC47DDDEC25D4A4CC5A3DB,60381,17,19,2,109.5241,18.22458,1605
30341,230714,663CE56232D73D50E42DEC41EA33269F,31931,0,1,1,109.54771,18.29403,1667
30342,230715,663CE56232D73D50E42DEC41EA33269F,30921,2,3,1,109.53903,18.29451,1667
30343,230716,663CE56232D73D50E42DEC41EA33269F,31931,3,17,14,109.54771,18.29403,1667
30344,230717,663CE56232D73D50E42DEC41EA33269F,39191,18,20,2,109.51493,18.23472,1557
30345,230718,D6A345956751BA2ACC5430EDF68A104F,31931,12,17,5,109.54771,18.29403,1667
30346,230719,D6A345956751BA2ACC5430EDF68A104F,39181,18,23,5,109.55153,18.28035,1715
30347,230744,A3EBD017781EF0DCA61FC195095D2D3C,31471,13,14,1,109.34583,18.29563,917
30348,230745,A3EBD017781EF0DCA61FC195095D2D3C,30761,18,23,5,109.45201,18.3,1318
30352,230784,F00821368F615DCDAF214035D8EC4A44,31071,1,2,1,109.58257,18.28458,1815
30353,230785,F00821368F615DCDAF214035D8EC4A44,31945,3,5,2,109.58021,18.29403,1817
30354,230786,F00821368F615DCDAF214035D8EC4A44,30854,7,17,10,109.56889,18.27076,1763
30355,230787,F00821368F615DCDAF214035D8EC4A44,31821,18,20,2,109.51181,18.24924,1559
30356,230788,F00821368F615DCDAF214035D8EC4A44,30854,22,23,1,109.56889,18.27076,1763
30361,230815,934029FB5F97BCE114EDCE88F0393A63,30854,12,15,3,109.56889,18.27076,1763
30362,230816,934029FB5F97BCE114EDCE88F0393A63,39371,19,20,1,109.56627,18.2646,1762
30363,230845,D947D8D9432E18EA6A214259B6E2987E,60411,1,2,1,109.32514,18.30854,869
30364,230846,D947D8D9432E18EA6A214259B6E2987E,30661,3,4,1,109.37028,18.24361,1008
30365,230847,D947D8D9432E18EA6A214259B6E2987E,60411,4,15,11,109.32514,18.30854,869
30366,230848,D947D8D9432E18EA6A214259B6E2987E,30661,16,19,3,109.37028,18.24361,1008
30367,230849,D947D8D9432E18EA6A214259B6E2987E,60411,20,23,3,109.32514,18.30854,869
30371,230856,E082FB5BD091C5B334EC1176FF352EE0,30071,6,7,1,109.52819,18.30472,1619
30372,230857,E082FB5BD091C5B334EC1176FF352EE0,31931,11,12,1,109.54771,18.29403,1667
30373,230858,E082FB5BD091C5B334EC1176FF352EE0,30071,13,14,1,109.52819,18.30472,1619
30374,230859,E082FB5BD091C5B334EC1176FF352EE0,39181,15,16,1,109.55153,18.28035,1715
30375,230860,E082FB5BD091C5B334EC1176FF352EE0,30071,21,22,1,109.52819,18.30472,1619
30376,230867,D5B91D126489D960AE97CC8A6C1B036B,31571,0,11,11,109.61563,18.23326,1957
30377,230868,D5B91D126489D960AE97CC8A6C1B036B,38071,16,18,2,109.40722,18.30938,1169
30381,230909,6ED697962F10CC0C2236463F9FC9376B,30821,8,14,6,109.43681,18.33639,1274
30382,230910,6ED697962F10CC0C2236463F9FC9376B,30761,19,21,2,109.45201,18.3,1318
30383,230911,7050D1E0A5553A00BB03B768ACFBCA8F,30211,0,6,6,109.49882,18.23931,1508
30388,230943,54A6757CA4BF8A47C41CF1DDCA6EA505,30854,0,6,6,109.56889,18.27076,1763
30389,230944,54A6757CA4BF8A47C41CF1DDCA6EA505,30434,7,9,2,109.17083,18.35861,278
30390,230945,54A6757CA4BF8A47C41CF1DDCA6EA505,30854,13,14,1,109.56889,18.27076,1763
30391,230956,4B0C0C6341A3C2E5744F0897553B14A8,31345,14,17,3,109.39,18.29,1066
30392,230957,4B0C0C6341A3C2E5744F0897553B14A8,39151,19,22,3,109.49875,18.25097,1510
30399,230987,6E2021B014C4D0B652A2E4FE8D2CF038,30854,16,18,2,109.56889,18.27076,1763
30400,230988,6E2021B014C4D0B652A2E4FE8D2CF038,31071,21,22,1,109.58257,18.28458,1815
30401,231009,55CBF233BA3606523955A1093C92D734,31864,0,6,6,109.49014,18.28333,1465
30402,231075,8F5513F47F2EB8223DE46B4728AB5258,38145,0,10,10,109.378,18.2912,1066
30403,231076,8F5513F47F2EB8223DE46B4728AB5258,31471,12,14,2,109.34583,18.29563,917
30404,231077,8F5513F47F2EB8223DE46B4728AB5258,60054,14,15,1,109.3016,18.31229,770
30405,231078,8F5513F47F2EB8223DE46B4728AB5258,38145,17,18,1,109.378,18.2912,1066
30406,231079,8F5513F47F2EB8223DE46B4728AB5258,38145,21,23,2,109.378,18.2912,1066
30415,231102,9C1407835BC54BEBDB541F52E1DA1820,61011,0,10,10,109.60653,18.19076,1900
30416,231104,9C1407835BC54BEBDB541F52E1DA1820,61011,13,16,3,109.60653,18.19076,1900
30420,231229,C82725A09C032EE9BFF2088FCCC60D1D,60354,0,2,2,109.58701,18.28521,1815
30421,231230,C82725A09C032EE9BFF2088FCCC60D1D,31761,3,7,4,109.60521,18.27965,1914
30422,231231,C82725A09C032EE9BFF2088FCCC60D1D,30731,11,13,2,109.50944,18.22306,1555
30423,231232,C82725A09C032EE9BFF2088FCCC60D1D,60631,15,17,2,109.57778,18.27583,1814
30424,231233,C82725A09C032EE9BFF2088FCCC60D1D,30854,20,23,3,109.56889,18.27076,1763
30425,231237,DBB710D279E76C79F1E4B0766F579F8A,31071,0,6,6,109.58257,18.28458,1815
30426,231238,DBB710D279E76C79F1E4B0766F579F8A,30854,7,9,2,109.56889,18.27076,1763
30427,231239,DBB710D279E76C79F1E4B0766F579F8A,60631,9,10,1,109.57778,18.27583,1814
30428,231240,DBB710D279E76C79F1E4B0766F579F8A,31071,12,13,1,109.58257,18.28458,1815
30429,231241,DBB710D279E76C79F1E4B0766F579F8A,30854,18,19,1,109.56889,18.27076,1763
30439,231294,EEA35E4D5CC4D9232BFB0C99E2CB356B,30854,6,7,1,109.56889,18.27076,1763
30440,231295,EEA35E4D5CC4D9232BFB0C99E2CB356B,30711,8,11,3,109.50271,18.25347,1510
30441,231296,EEA35E4D5CC4D9232BFB0C99E2CB356B,30854,13,16,3,109.56889,18.27076,1763
30442,231300,DC29C676832347947F366933ECB88090,39183,15,16,1,109.55542,18.28208,1715
30443,231301,DC29C676832347947F366933ECB88090,31561,18,23,5,109.56792,18.28479,1765
30444,231320,86C993124F0A6688CA06DBAE1F6DEC77,31951,1,15,14,109.52174,18.30299,1568
30449,231331,000584B3023702F3E9DDF521B1C35B1A,60354,1,6,5,109.58701,18.28521,1815
30450,231332,000584B3023702F3E9DDF521B1C35B1A,31071,9,10,1,109.58257,18.28458,1815
30457,231397,DF1914B7230B32BA806E8A8749CAD846,60491,0,14,14,109.43354,18.30847,1269
30458,231398,DF1914B7230B32BA806E8A8749CAD846,60261,18,20,2,109.44326,18.3075,1319
30459,231406,1A64C98E678C33D33EBB9AF4943063A2,30854,0,14,14,109.56889,18.27076,1763
30460,231407,1A64C98E678C33D33EBB9AF4943063A2,31071,17,21,4,109.58257,18.28458,1815
30461,231410,94F0184D0BA3E27BCB47A57DA614F9FC,60411,0,4,4,109.32514,18.30854,869
30462,231411,94F0184D0BA3E27BCB47A57DA614F9FC,30661,4,9,5,109.37028,18.24361,1008
30463,231412,94F0184D0BA3E27BCB47A57DA614F9FC,60411,10,11,1,109.32514,18.30854,869
30464,231413,94F0184D0BA3E27BCB47A57DA614F9FC,30661,11,14,3,109.37028,18.24361,1008
30465,231414,94F0184D0BA3E27BCB47A57DA614F9FC,60411,17,19,2,109.32514,18.30854,869
30466,231415,94F0184D0BA3E27BCB47A57DA614F9FC,30661,19,23,4,109.37028,18.24361,1008
30470,231421,79BABDF74F5861A434085432A23D4B92,31071,2,11,9,109.58257,18.28458,1815
30471,231422,79BABDF74F5861A434085432A23D4B92,30854,14,19,5,109.56889,18.27076,1763
30472,231432,5CC4EB91087C17C4BD77E4324091759F,60524,0,6,6,109.42951,18.28993,1216
30473,231437,E5E2DA460104E389257158E8D8C9FBDA,60281,0,5,5,109.51743,18.25924,1561
30474,231438,E5E2DA460104E389257158E8D8C9FBDA,60311,6,7,1,109.52097,18.24319,1558
30475,231439,E5E2DA460104E389257158E8D8C9FBDA,38291,9,14,5,109.51618,18.24313,1558
30476,231440,E5E2DA460104E389257158E8D8C9FBDA,60311,14,17,3,109.52097,18.24319,1558
30477,231441,E5E2DA460104E389257158E8D8C9FBDA,60281,18,23,5,109.51743,18.25924,1561
30478,231466,020753EF78F0A0C39658113A3377EA1E,30071,16,18,2,109.52819,18.30472,1619
30479,231467,020753EF78F0A0C39658113A3377EA1E,31561,19,21,2,109.56792,18.28479,1765
30480,231468,208924560927AE5872A8D9BB3F5EF3B6,30764,0,1,1,109.45806,18.29486,1367
30481,231469,208924560927AE5872A8D9BB3F5EF3B6,38171,1,5,4,109.50799,18.28139,1515
30482,231498,B7CCC709A3C9F7475C199BE4055253B6,38721,12,18,6,109.50368,18.27542,1514
30483,231499,B7CCC709A3C9F7475C199BE4055253B6,31951,20,21,1,109.52174,18.30299,1568
30484,231500,3971E288F0FB50DDE06A11C534E966DA,31071,13,17,4,109.58257,18.28458,1815
30485,231501,3971E288F0FB50DDE06A11C534E966DA,30854,20,21,1,109.56889,18.27076,1763
30486,231509,7FD31F65A9E7574FDAD4A110ACBA289D,31206,15,16,1,109.50819,18.23549,1507
30487,231510,7FD31F65A9E7574FDAD4A110ACBA289D,60371,18,19,1,109.53063,18.30056,1618
30488,231511,7FD31F65A9E7574FDAD4A110ACBA289D,31931,21,23,2,109.54771,18.29403,1667
30489,231535,76F6A54588C8DF7DDADFC50CAA11D44C,31571,13,15,2,109.61563,18.23326,1957
30490,231536,76F6A54588C8DF7DDADFC50CAA11D44C,38085,16,17,1,109.6291,18.23625,2007
30491,231599,56F818D0924E7BDB02CCC04065747626,31421,0,19,19,109.55382,18.22347,1705
30492,231600,56F818D0924E7BDB02CCC04065747626,38205,20,23,3,109.62743,18.23139,1956
30500,231649,8AB002F52B01E966C9A29627703ED688,31391,0,7,7,109.50382,18.24285,1508
30501,231650,8AB002F52B01E966C9A29627703ED688,31471,9,11,2,109.34583,18.29563,917
30502,231651,8AB002F52B01E966C9A29627703ED688,31181,14,16,2,109.50382,18.24813,1509
30507,231660,1980C8D409DE9551539224B3D393CDAA,31951,0,3,3,109.52174,18.30299,1568
30508,231661,1980C8D409DE9551539224B3D393CDAA,30071,6,13,7,109.52819,18.30472,1619
30509,231662,1980C8D409DE9551539224B3D393CDAA,31951,13,14,1,109.52174,18.30299,1568
30510,231663,1980C8D409DE9551539224B3D393CDAA,30071,14,19,5,109.52819,18.30472,1619
30511,231664,1980C8D409DE9551539224B3D393CDAA,30071,20,22,2,109.52819,18.30472,1619
30516,231703,D9AE11CD16B231308C3F0FB3F53BC3E9,30854,0,8,8,109.56889,18.27076,1763
30517,231704,D9AE11CD16B231308C3F0FB3F53BC3E9,31071,8,13,5,109.58257,18.28458,1815
30518,231705,D9AE11CD16B231308C3F0FB3F53BC3E9,30854,15,17,2,109.56889,18.27076,1763
30519,231706,D9AE11CD16B231308C3F0FB3F53BC3E9,31071,18,19,1,109.58257,18.28458,1815
30520,231707,D9AE11CD16B231308C3F0FB3F53BC3E9,30854,22,23,1,109.56889,18.27076,1763
30521,231712,7CE7C06285D7493A1117F256B3BBCC56,30151,0,14,14,109.50986,18.25083,1560
30522,231713,7CE7C06285D7493A1117F256B3BBCC56,30371,18,23,5,109.51,18.24771,1559
30529,231787,AD5AB89DB5C961852FD7AC69F7F5D882,30854,15,16,1,109.56889,18.27076,1763
30533,231926,4400F433FA6469B70604006808D90C30,60381,0,1,1,109.5241,18.22458,1605
30534,231927,4400F433FA6469B70604006808D90C30,31421,2,22,20,109.55382,18.22347,1705
30535,231952,F1FA54BCDE7297F39D6C0507CA898D49,38361,0,6,6,109.43667,18.29201,1267
30536,231953,F1FA54BCDE7297F39D6C0507CA898D49,60551,8,9,1,109.42722,18.30111,1218
30537,231954,F1FA54BCDE7297F39D6C0507CA898D49,60524,9,11,2,109.42951,18.28993,1216
30538,231955,F1FA54BCDE7297F39D6C0507CA898D49,60552,11,12,1,109.41729,18.30014,1218
30539,231956,F1FA54BCDE7297F39D6C0507CA898D49,38361,12,23,11,109.43667,18.29201,1267
30540,231972,D4AA3869830031578B573FD0033C24A8,30921,3,5,2,109.53903,18.29451,1667
30541,231973,D4AA3869830031578B573FD0033C24A8,31931,7,16,9,109.54771,18.29403,1667
30545,232018,789033FF9671BBE480F6F60FF87489C2,31541,19,20,1,109.1809,18.36722,329
30546,232019,789033FF9671BBE480F6F60FF87489C2,30434,21,22,1,109.17083,18.35861,278
30556,232081,9AA959ED87D1ECC3053DED17290EFCBD,39183,0,1,1,109.55542,18.28208,1715
30557,232082,9AA959ED87D1ECC3053DED17290EFCBD,31561,1,7,6,109.56792,18.28479,1765
30558,232083,9AA959ED87D1ECC3053DED17290EFCBD,30854,8,9,1,109.56889,18.27076,1763
30559,232084,9AA959ED87D1ECC3053DED17290EFCBD,39183,10,11,1,109.55542,18.28208,1715
30560,232085,9AA959ED87D1ECC3053DED17290EFCBD,31561,11,12,1,109.56792,18.28479,1765
30561,232086,9AA959ED87D1ECC3053DED17290EFCBD,39183,13,17,4,109.55542,18.28208,1715
30568,232142,3C1A2536A78CF30193CED5E3EEACBE7E,30854,0,3,3,109.56889,18.27076,1763
30569,232143,3C1A2536A78CF30193CED5E3EEACBE7E,30851,4,23,19,109.5616,18.27396,1713
30570,232184,135A88CD829AF2C6F8DE6655F28EC360,31931,11,16,5,109.54771,18.29403,1667
30571,232185,135A88CD829AF2C6F8DE6655F28EC360,60371,16,18,2,109.53063,18.30056,1618
30572,232230,40285EE8CCE25C38988EC087545664EC,30854,7,17,10,109.56889,18.27076,1763
30573,232231,40285EE8CCE25C38988EC087545664EC,60661,18,21,3,109.548,18.2377,1657
30574,232232,40285EE8CCE25C38988EC087545664EC,60381,22,23,1,109.5241,18.22458,1605
30575,232238,2830CAA81E07F1E0509E8845A87AD419,30161,0,10,10,109.50042,18.24389,1508
30576,232239,2830CAA81E07F1E0509E8845A87AD419,31471,11,13,2,109.34583,18.29563,917
30577,232240,2830CAA81E07F1E0509E8845A87AD419,30901,13,15,2,109.27597,18.3134,670
30578,232241,2830CAA81E07F1E0509E8845A87AD419,30161,17,23,6,109.50042,18.24389,1508
30583,232271,566423B784470FF1F6B17BF1D21CA750,38961,0,2,2,109.50847,18.23514,1507
30584,232272,566423B784470FF1F6B17BF1D21CA750,38171,5,10,5,109.50799,18.28139,1515
30585,232273,566423B784470FF1F6B17BF1D21CA750,60211,13,16,3,109.63549,18.26049,2011
30586,232274,566423B784470FF1F6B17BF1D21CA750,31701,19,20,1,109.44132,18.28833,1266
30587,232275,566423B784470FF1F6B17BF1D21CA750,38171,21,23,2,109.50799,18.28139,1515
30591,232322,C8922FAF66F21ECAECB6B717FCD5A53B,60614,6,14,8,109.48799,18.29521,1467
30592,232323,C8922FAF66F21ECAECB6B717FCD5A53B,60391,15,17,2,109.47667,18.28757,1416
30593,232324,C8922FAF66F21ECAECB6B717FCD5A53B,60504,17,18,1,109.47917,18.28903,1416
30594,232325,C8922FAF66F21ECAECB6B717FCD5A53B,60614,20,23,3,109.48799,18.29521,1467
30598,232397,51DF765CB634D9549D20AD1F2C37BA18,30854,1,11,10,109.56889,18.27076,1763
30599,232398,51DF765CB634D9549D20AD1F2C37BA18,31561,14,15,1,109.56792,18.28479,1765
30600,232399,487521C796C9B83A04D2BF725345DF16,31521,14,18,4,109.51458,18.22542,1555
30601,232400,487521C796C9B83A04D2BF725345DF16,31521,19,21,2,109.51458,18.22542,1555
30602,232401,487521C796C9B83A04D2BF725345DF16,60381,21,23,2,109.5241,18.22458,1605
30610,232473,08A066736557478B1013C0CF834491DF,30921,0,7,7,109.53903,18.29451,1667
30611,232474,08A066736557478B1013C0CF834491DF,31931,9,11,2,109.54771,18.29403,1667
30612,232478,3A4D58C03EB6FFBD8D8160CFC0ADA249,30111,0,22,22,109.47583,18.30542,1419
30613,232479,3A4D58C03EB6FFBD8D8160CFC0ADA249,60131,22,23,1,109.49819,18.24778,1509
30623,232540,D8EBCB05DE029B0DEDBF9FBDF3DA3C2D,30421,17,19,2,109.50021,18.25861,1511
30624,232541,D8EBCB05DE029B0DEDBF9FBDF3DA3C2D,60084,20,22,2,109.4984,18.2334,1507
30625,232550,D04CD9DD8CE80FB000DDFF2A9F0DD83D,30771,0,8,8,109.49938,18.26042,1511
30626,232551,D04CD9DD8CE80FB000DDFF2A9F0DD83D,30771,9,13,4,109.49938,18.26042,1511
30627,232552,D04CD9DD8CE80FB000DDFF2A9F0DD83D,30771,16,18,2,109.49938,18.26042,1511
30628,232553,D04CD9DD8CE80FB000DDFF2A9F0DD83D,30391,18,20,2,109.4975,18.27118,1513
30629,232554,D04CD9DD8CE80FB000DDFF2A9F0DD83D,60131,21,23,2,109.49819,18.24778,1509
30630,232592,2AE38FAF341950B0B91404FFCE5A0F3E,30921,6,18,12,109.53903,18.29451,1667
30631,232593,2AE38FAF341950B0B91404FFCE5A0F3E,39183,20,21,1,109.55542,18.28208,1715
30632,232594,2AE38FAF341950B0B91404FFCE5A0F3E,31931,21,22,1,109.54771,18.29403,1667
30633,232600,39F25FE146A03325C93C111F2A943B6C,31945,0,7,7,109.58021,18.29403,1817
30634,232601,39F25FE146A03325C93C111F2A943B6C,31071,8,21,13,109.58257,18.28458,1815
30638,232658,14AE6C820CE45F96077630992CABD33D,31551,9,10,1,109.55868,18.24222,1708
30639,232659,14AE6C820CE45F96077630992CABD33D,39371,12,16,4,109.56627,18.2646,1762
30640,232660,14AE6C820CE45F96077630992CABD33D,31551,17,18,1,109.55868,18.24222,1708
30641,232663,CFA6DB42B4EA79576A8AEA8F93765E81,30721,0,7,7,109.51597,18.28257,1565
30642,232664,CFA6DB42B4EA79576A8AEA8F93765E81,30084,12,15,3,109.50118,18.26972,1513
30646,232682,B8B175F9D4B3A6BE919C03568EC254A7,30131,0,6,6,109.6959,18.215,2254
30647,232683,B8B175F9D4B3A6BE919C03568EC254A7,30851,7,9,2,109.5616,18.27396,1713
30648,232684,B8B175F9D4B3A6BE919C03568EC254A7,60641,12,14,2,109.53854,18.2359,1657
30649,232685,B8B175F9D4B3A6BE919C03568EC254A7,60201,14,15,1,109.5041,18.2509,1510
30650,232686,B8B175F9D4B3A6BE919C03568EC254A7,31723,18,20,2,109.68563,18.23701,2207
30651,232724,DD386856863F7E131E32C81950505B78,30711,10,15,5,109.50271,18.25347,1510
30652,232725,DD386856863F7E131E32C81950505B78,31031,15,23,8,109.49979,18.25382,1510
30656,232762,10E6DCB22C04D9E1B01193CDA87B3193,31561,14,15,1,109.56792,18.28479,1765
30657,232763,10E6DCB22C04D9E1B01193CDA87B3193,30721,20,21,1,109.51597,18.28257,1565
30658,232764,10E6DCB22C04D9E1B01193CDA87B3193,38154,22,23,1,109.5266,18.28278,1615
30659,232771,DB48AA878B132AB3008870DF5EDEF58A,31701,16,18,2,109.44132,18.28833,1266
30660,232772,DB48AA878B132AB3008870DF5EDEF58A,38162,21,23,2,109.43944,18.28889,1266
30664,232806,8C54F679DD59F109DAF19BDB41D1658A,60121,15,16,1,109.74507,18.37472,2430
30665,232807,8C54F679DD59F109DAF19BDB41D1658A,38271,20,21,1,109.62632,18.23049,1956
30666,232808,8C54F679DD59F109DAF19BDB41D1658A,30441,22,23,1,109.64021,18.25424,2010
30667,232889,61CCBFBC45E266F13FBC5AB00CB5A2E1,31471,13,14,1,109.34583,18.29563,917
30668,232890,61CCBFBC45E266F13FBC5AB00CB5A2E1,39321,16,18,2,109.529,18.2167,1604
30669,232891,61CCBFBC45E266F13FBC5AB00CB5A2E1,60381,18,20,2,109.5241,18.22458,1605
30670,232892,61CCBFBC45E266F13FBC5AB00CB5A2E1,39321,20,23,3,109.529,18.2167,1604
30671,232913,1428E8B6DBD9DB5B29DD45307A677470,30111,0,4,4,109.47583,18.30542,1419
30672,232914,1428E8B6DBD9DB5B29DD45307A677470,31471,7,8,1,109.34583,18.29563,917
30673,232925,353D5D9D3440E88066F84F662B26A25B,31461,14,15,1,109.5091,18.25389,1510
30680,232949,102A3C1C3179D6FF6A52B59C3B4087A1,39101,0,1,1,109.50132,18.24931,1509
30681,232950,102A3C1C3179D6FF6A52B59C3B4087A1,30161,3,13,10,109.50042,18.24389,1508
30682,232951,102A3C1C3179D6FF6A52B59C3B4087A1,31181,13,18,5,109.50382,18.24813,1509
30683,232952,102A3C1C3179D6FF6A52B59C3B4087A1,30161,19,21,2,109.50042,18.24389,1508
30684,232953,102A3C1C3179D6FF6A52B59C3B4087A1,31181,21,23,2,109.50382,18.24813,1509
30685,233008,B7182D0394EEB5B5974D259CBCE91CB4,60231,14,16,2,109.49903,18.21972,1504
30686,233009,B7182D0394EEB5B5974D259CBCE91CB4,38241,17,20,3,109.54111,18.30542,1669
30687,233067,E218C587552A5DADC05C4E69685FE374,30421,15,16,1,109.50021,18.25861,1511
30688,233068,E218C587552A5DADC05C4E69685FE374,60201,19,20,1,109.5041,18.2509,1510
30689,233069,E218C587552A5DADC05C4E69685FE374,39371,22,23,1,109.56627,18.2646,1762
30693,233117,1D8B814EC83D52D7C5F3FED99C129EE0,30854,2,3,1,109.56889,18.27076,1763
30694,233118,1D8B814EC83D52D7C5F3FED99C129EE0,60631,4,9,5,109.57778,18.27583,1814
30695,233119,1D8B814EC83D52D7C5F3FED99C129EE0,38271,11,19,8,109.62632,18.23049,1956
30696,233148,E49583CA7DCFF2BB28C62ECBE9D165BD,31031,0,8,8,109.49979,18.25382,1510
30697,233149,E49583CA7DCFF2BB28C62ECBE9D165BD,31471,10,12,2,109.34583,18.29563,917
30698,233150,E49583CA7DCFF2BB28C62ECBE9D165BD,31181,15,21,6,109.50382,18.24813,1509
30699,233181,135EE8DF22FD9C3BDEB0E1201CDDDB65,30161,0,8,8,109.50042,18.24389,1508
30700,233182,135EE8DF22FD9C3BDEB0E1201CDDDB65,31471,12,13,1,109.34583,18.29563,917
30701,233183,135EE8DF22FD9C3BDEB0E1201CDDDB65,30661,13,15,2,109.37028,18.24361,1008
30702,233184,135EE8DF22FD9C3BDEB0E1201CDDDB65,30161,17,19,2,109.50042,18.24389,1508
30703,233185,135EE8DF22FD9C3BDEB0E1201CDDDB65,31031,20,21,1,109.49979,18.25382,1510
30704,233186,135EE8DF22FD9C3BDEB0E1201CDDDB65,30161,22,23,1,109.50042,18.24389,1508
30712,233259,E6F79A5F6F7C034FE4F98780B21D590B,30281,6,9,3,109.50597,18.27583,1514
30713,233260,E6F79A5F6F7C034FE4F98780B21D590B,31161,12,13,1,109.70229,18.31361,2270
30714,233261,E6F79A5F6F7C034FE4F98780B21D590B,30281,14,15,1,109.50597,18.27583,1514
30715,233262,E6F79A5F6F7C034FE4F98780B21D590B,38157,16,18,2,109.51483,18.26958,1563
30716,233278,5C4B759B8D2905A494B81A3EB710A8F3,60631,8,18,10,109.57778,18.27583,1814
30717,233279,5C4B759B8D2905A494B81A3EB710A8F3,38094,20,22,2,109.45403,18.28778,1316
30718,233280,5C4B759B8D2905A494B81A3EB710A8F3,31031,22,23,1,109.49979,18.25382,1510
30719,233281,AB43182259122294244C13D6FC66D4A1,60631,0,6,6,109.57778,18.27583,1814
30720,233282,AB43182259122294244C13D6FC66D4A1,31561,7,12,5,109.56792,18.28479,1765
30721,233283,23019CE071DC0B0CEC6E78ADA422CE57,60281,0,3,3,109.51743,18.25924,1561
30722,233284,23019CE071DC0B0CEC6E78ADA422CE57,38973,3,13,10,109.51097,18.25389,1560
30723,233285,23019CE071DC0B0CEC6E78ADA422CE57,30151,14,16,2,109.50986,18.25083,1560
30724,233286,23019CE071DC0B0CEC6E78ADA422CE57,31381,18,20,2,109.1375,18.36833,129
30725,233287,23019CE071DC0B0CEC6E78ADA422CE57,30711,22,23,1,109.50271,18.25347,1510
30726,233288,C462628FF36F8FF2D0B7493E6DDA38BB,60411,1,9,8,109.32514,18.30854,869
30727,233289,C462628FF36F8FF2D0B7493E6DDA38BB,30661,9,14,5,109.37028,18.24361,1008
30728,233290,C462628FF36F8FF2D0B7493E6DDA38BB,60411,16,19,3,109.32514,18.30854,869
30729,233291,C462628FF36F8FF2D0B7493E6DDA38BB,31471,19,21,2,109.34583,18.29563,917
30730,233319,F8D799D9161B0143E0D71C40472A357E,30071,7,12,5,109.52819,18.30472,1619
30731,233320,F8D799D9161B0143E0D71C40472A357E,60371,14,15,1,109.53063,18.30056,1618
30732,233321,F8D799D9161B0143E0D71C40472A357E,30071,15,22,7,109.52819,18.30472,1619
30733,233322,5EE25A6E7DD554FFDA0C9C1A504114B7,31071,0,8,8,109.58257,18.28458,1815
30734,233323,5EE25A6E7DD554FFDA0C9C1A504114B7,30711,9,11,2,109.50271,18.25347,1510
30735,233324,5EE25A6E7DD554FFDA0C9C1A504114B7,31461,12,13,1,109.5091,18.25389,1510
30736,233325,5EE25A6E7DD554FFDA0C9C1A504114B7,31071,17,23,6,109.58257,18.28458,1815
30737,233349,7BF65E5054DA81A230AB5423620158E1,31071,0,7,7,109.58257,18.28458,1815
30738,233350,7BF65E5054DA81A230AB5423620158E1,30854,7,23,16,109.56889,18.27076,1763
30745,233421,D9E60CECBCF3335BA62A418C133E83E2,31521,17,19,2,109.51458,18.22542,1555
30746,233422,D9E60CECBCF3335BA62A418C133E83E2,30731,19,22,3,109.50944,18.22306,1555
30747,233464,4053323049FA57896819CD5356E38746,30854,2,3,1,109.56889,18.27076,1763
30748,233465,4053323049FA57896819CD5356E38746,31071,4,5,1,109.58257,18.28458,1815
30749,233466,4053323049FA57896819CD5356E38746,30854,6,8,2,109.56889,18.27076,1763
30750,233467,4053323049FA57896819CD5356E38746,30681,9,10,1,109.48493,18.26917,1463
30751,233468,4053323049FA57896819CD5356E38746,30854,12,16,4,109.56889,18.27076,1763
30752,233469,4053323049FA57896819CD5356E38746,31945,20,23,3,109.58021,18.29403,1817
30756,233528,6C0260646767B781577B5B8CE2471E51,38484,9,12,3,109.53028,18.31528,1620
30757,233529,6C0260646767B781577B5B8CE2471E51,30071,14,17,3,109.52819,18.30472,1619
30758,233530,6C0260646767B781577B5B8CE2471E51,38484,18,22,4,109.53028,18.31528,1620
30759,233531,20C15B76A1E0DF79D86EDEAC7BC3D7B7,31071,0,14,14,109.58257,18.28458,1815
30760,233532,20C15B76A1E0DF79D86EDEAC7BC3D7B7,31031,15,16,1,109.49979,18.25382,1510
30761,233533,20C15B76A1E0DF79D86EDEAC7BC3D7B7,30854,18,23,5,109.56889,18.27076,1763
30762,233553,8F6EA1C108FADA76A214A7ED71ECE3D1,30232,1,4,3,109.6191,18.31701,1971
30763,233554,8F6EA1C108FADA76A214A7ED71ECE3D1,30854,8,9,1,109.56889,18.27076,1763
30764,233555,8F6EA1C108FADA76A214A7ED71ECE3D1,60117,13,15,2,109.73604,18.35681,2427
30765,233556,8F6EA1C108FADA76A214A7ED71ECE3D1,30854,20,21,1,109.56889,18.27076,1763
30766,233618,E988DA8DA294A7CCEAA28AECB6C26A8F,31701,13,15,2,109.44132,18.28833,1266
30767,233619,E988DA8DA294A7CCEAA28AECB6C26A8F,30711,18,20,2,109.50271,18.25347,1510
30768,233629,8AABF5FDF2B06EB445749240A3894969,31071,1,12,11,109.58257,18.28458,1815
30769,233630,8AABF5FDF2B06EB445749240A3894969,31851,16,17,1,109.71736,18.29007,2316
30770,233631,8AABF5FDF2B06EB445749240A3894969,31071,21,22,1,109.58257,18.28458,1815
30771,233661,B2035C0684FF9CA861B7EB217CE5A160,60524,2,7,5,109.42951,18.28993,1216
30772,233662,B2035C0684FF9CA861B7EB217CE5A160,31471,8,17,9,109.34583,18.29563,917
30773,233663,B2035C0684FF9CA861B7EB217CE5A160,60552,18,19,1,109.41729,18.30014,1218
30774,233664,B2035C0684FF9CA861B7EB217CE5A160,31031,19,21,2,109.49979,18.25382,1510
30775,233675,FE95B3A32EFBC2838F293DF38F55FDD1,39183,0,4,4,109.55542,18.28208,1715
30776,233676,FE95B3A32EFBC2838F293DF38F55FDD1,30071,7,11,4,109.52819,18.30472,1619
30777,233729,2C4F6A9565FCA7FBA040CF077F5F71B3,31534,0,9,9,109.49368,18.25806,1461
30778,233747,30CE72A519D49881F23B8123486E3A02,31471,18,20,2,109.34583,18.29563,917
30779,233748,30CE72A519D49881F23B8123486E3A02,60411,21,23,2,109.32514,18.30854,869
30780,233754,DBD424CB499D5AB1C47BB7F6EFB84A2C,30271,0,1,1,109.49132,18.23153,1456
30781,233755,DBD424CB499D5AB1C47BB7F6EFB84A2C,60084,3,6,3,109.4984,18.2334,1507
30782,233756,DBD424CB499D5AB1C47BB7F6EFB84A2C,30661,11,12,1,109.37028,18.24361,1008
30783,233757,DBD424CB499D5AB1C47BB7F6EFB84A2C,31301,15,16,1,109.14493,18.31222,170
30784,233758,1FEE70E9EF5E783035F8B1F1E4B483EC,39183,1,8,7,109.55542,18.28208,1715
30785,233759,1FEE70E9EF5E783035F8B1F1E4B483EC,38071,12,13,1,109.40722,18.30938,1169
30786,233798,408C4FED868686E7B96333835F4C4205,31071,2,7,5,109.58257,18.28458,1815
30787,233799,408C4FED868686E7B96333835F4C4205,30854,12,14,2,109.56889,18.27076,1763
30788,233816,F7035E4742EE25797FD00CAEBC81D218,31251,0,19,19,109.18528,18.2975,317
30789,233817,F7035E4742EE25797FD00CAEBC81D218,30441,19,21,2,109.64021,18.25424,2010
30790,233818,798BF3B08F72A16A6DEAAA235F1899BB,61011,0,5,5,109.60653,18.19076,1900
30791,233820,798BF3B08F72A16A6DEAAA235F1899BB,61011,9,20,11,109.60653,18.19076,1900
30799,233884,D56A67341D1DA856D04BC2181FD404FB,60552,20,21,1,109.41729,18.30014,1218
30800,233885,D56A67341D1DA856D04BC2181FD404FB,60541,22,23,1,109.4084,18.29208,1167
30801,234010,6751CEC3CF9B2AE78246C7287443D2B4,31071,13,15,2,109.58257,18.28458,1815
30802,234011,6751CEC3CF9B2AE78246C7287443D2B4,30854,16,21,5,109.56889,18.27076,1763
30803,234031,1B6EBBFF3B9D8A3E18753343B6A29EAE,31071,0,6,6,109.58257,18.28458,1815
30804,234032,1B6EBBFF3B9D8A3E18753343B6A29EAE,31561,9,11,2,109.56792,18.28479,1765
30805,234033,1B6EBBFF3B9D8A3E18753343B6A29EAE,31071,11,13,2,109.58257,18.28458,1815
30806,234034,1B6EBBFF3B9D8A3E18753343B6A29EAE,30851,17,18,1,109.5616,18.27396,1713
30807,234035,1B6EBBFF3B9D8A3E18753343B6A29EAE,31071,19,21,2,109.58257,18.28458,1815
30808,234095,59F29435D748531F416A4F1636997ECF,31201,0,2,2,109.51042,18.23819,1558
30809,234096,59F29435D748531F416A4F1636997ECF,31071,4,7,3,109.58257,18.28458,1815
30810,234097,59F29435D748531F416A4F1636997ECF,31781,10,11,1,109.19847,18.2975,367
30811,234098,59F29435D748531F416A4F1636997ECF,31301,11,12,1,109.14493,18.31222,170
30812,234109,68DBE0B52FD0AB95F1DD47068FD7847F,60311,0,5,5,109.52097,18.24319,1558
30813,234110,68DBE0B52FD0AB95F1DD47068FD7847F,30181,8,11,3,109.51597,18.23313,1557
30814,234127,A8ABE4987042D12DD458C81CFD9663F5,38127,0,6,6,109.50833,18.27222,1513
30815,234128,A8ABE4987042D12DD458C81CFD9663F5,60571,8,9,1,109.50722,18.25056,1510
30816,234129,A8ABE4987042D12DD458C81CFD9663F5,30771,10,11,1,109.49938,18.26042,1511
30817,234130,A8ABE4987042D12DD458C81CFD9663F5,60524,12,13,1,109.42951,18.28993,1216
30818,234131,A8ABE4987042D12DD458C81CFD9663F5,30421,17,18,1,109.50021,18.25861,1511
30819,234132,A8ABE4987042D12DD458C81CFD9663F5,38127,20,23,3,109.50833,18.27222,1513
30820,234133,1D73A39CD9D00E7A842906C3097D7487,60571,0,7,7,109.50722,18.25056,1510
30821,234134,1D73A39CD9D00E7A842906C3097D7487,30851,8,10,2,109.5616,18.27396,1713
30822,234135,1D73A39CD9D00E7A842906C3097D7487,31561,13,15,2,109.56792,18.28479,1765
30826,234168,69EA58E2C68065F45F7A1847747C7961,60081,15,18,3,109.51097,18.22639,1556
30827,234169,69EA58E2C68065F45F7A1847747C7961,31205,18,20,2,109.51111,18.23736,1557
30828,234170,69EA58E2C68065F45F7A1847747C7961,60081,22,23,1,109.51097,18.22639,1556
30829,234171,22CF7007721E0F1D863F25E4633BE1AD,38291,13,15,2,109.51618,18.24313,1558
30830,234172,22CF7007721E0F1D863F25E4633BE1AD,60311,19,23,4,109.52097,18.24319,1558
30831,234254,EE64858856622F3C84C475424C7DD813,60221,0,7,7,109.52569,18.29188,1616
30832,234255,EE64858856622F3C84C475424C7DD813,31931,7,10,3,109.54771,18.29403,1667
30833,234256,EE64858856622F3C84C475424C7DD813,60221,12,14,2,109.52569,18.29188,1616
30834,234257,EE64858856622F3C84C475424C7DD813,60371,14,18,4,109.53063,18.30056,1618
30835,234258,EE64858856622F3C84C475424C7DD813,60221,20,23,3,109.52569,18.29188,1616
30840,234347,2CF83F5125C6075E2ACA9C17C2979C64,31071,1,9,8,109.58257,18.28458,1815
30841,234348,2CF83F5125C6075E2ACA9C17C2979C64,30854,14,15,1,109.56889,18.27076,1763
30842,234349,2CF83F5125C6075E2ACA9C17C2979C64,31071,16,19,3,109.58257,18.28458,1815
30843,234350,2CF83F5125C6075E2ACA9C17C2979C64,30854,20,21,1,109.56889,18.27076,1763
30844,234351,2CF83F5125C6075E2ACA9C17C2979C64,31071,22,23,1,109.58257,18.28458,1815
30845,234352,6456DEC363530A787C41268FA27E3CAD,31471,15,17,2,109.34583,18.29563,917
30846,234353,6456DEC363530A787C41268FA27E3CAD,60221,18,21,3,109.52569,18.29188,1616
30847,234354,6456DEC363530A787C41268FA27E3CAD,60261,21,23,2,109.44326,18.3075,1319
30848,234394,46D10B971C10D2856504DC61068F66E7,31091,13,15,2,109.41201,18.31222,1170
30849,234423,20D67F66127BDA58E8931E7738FE6E65,30441,1,2,1,109.64021,18.25424,2010
30850,234424,20D67F66127BDA58E8931E7738FE6E65,31071,3,7,4,109.58257,18.28458,1815
30851,234425,20D67F66127BDA58E8931E7738FE6E65,30854,8,9,1,109.56889,18.27076,1763
30852,234426,20D67F66127BDA58E8931E7738FE6E65,31071,10,12,2,109.58257,18.28458,1815
30853,234427,20D67F66127BDA58E8931E7738FE6E65,30854,14,16,2,109.56889,18.27076,1763
30854,234449,BA9833B5432B77210DF0C38140389BAD,38117,0,5,5,109.51611,18.22354,1555
30855,234450,BA9833B5432B77210DF0C38140389BAD,30191,6,13,7,109.50361,18.22701,1506
30856,234451,BA9833B5432B77210DF0C38140389BAD,31251,16,17,1,109.18528,18.2975,317
30857,234452,BA9833B5432B77210DF0C38140389BAD,31461,19,21,2,109.5091,18.25389,1510
30858,234453,BA9833B5432B77210DF0C38140389BAD,38117,22,23,1,109.51611,18.22354,1555
30859,234471,5DA31B6468DF5449C1F287501972F73D,31271,0,7,7,109.48958,18.26257,1462
30860,234472,5DA31B6468DF5449C1F287501972F73D,31781,10,12,2,109.19847,18.2975,367
30861,234473,5DA31B6468DF5449C1F287501972F73D,60054,13,15,2,109.3016,18.31229,770
30862,234474,5DA31B6468DF5449C1F287501972F73D,30771,19,20,1,109.49938,18.26042,1511
30863,234475,5DA31B6468DF5449C1F287501972F73D,31271,22,23,1,109.48958,18.26257,1462
30864,234507,2E1B710612E1C9FE838A221C1A8E8C66,38903,0,1,1,109.39229,18.29243,1117
30865,234508,2E1B710612E1C9FE838A221C1A8E8C66,38325,5,7,2,109.39792,18.2909,1116
30866,234516,ADF0A7CED2B8DFD757D8FCA8B507C37E,38283,11,12,1,109.62229,18.22618,1956
30867,234517,ADF0A7CED2B8DFD757D8FCA8B507C37E,31561,17,19,2,109.56792,18.28479,1765
30868,234518,080247CC19405F981D4BEFE1A1E9D339,31931,18,19,1,109.54771,18.29403,1667
30869,234519,080247CC19405F981D4BEFE1A1E9D339,39181,21,22,1,109.55153,18.28035,1715
30870,234520,080247CC19405F981D4BEFE1A1E9D339,31931,22,23,1,109.54771,18.29403,1667
30871,234527,372A5433078073EAD18922D679CE0A73,60054,0,3,3,109.3016,18.31229,770
30872,234528,372A5433078073EAD18922D679CE0A73,60411,4,10,6,109.32514,18.30854,869
30873,234529,372A5433078073EAD18922D679CE0A73,60054,12,13,1,109.3016,18.31229,770
30874,234530,372A5433078073EAD18922D679CE0A73,60411,14,18,4,109.32514,18.30854,869
30875,234531,372A5433078073EAD18922D679CE0A73,30661,19,21,2,109.37028,18.24361,1008
30876,234532,372A5433078073EAD18922D679CE0A73,60054,21,23,2,109.3016,18.31229,770
30877,234533,F9F80EDABF5B8107FB24FA24BEE7566E,60161,0,2,2,109.49174,18.26181,1461
30878,234534,F9F80EDABF5B8107FB24FA24BEE7566E,60201,4,5,1,109.5041,18.2509,1510
30879,234535,F9F80EDABF5B8107FB24FA24BEE7566E,30211,8,10,2,109.49882,18.23931,1508
30880,234536,F9F80EDABF5B8107FB24FA24BEE7566E,38754,12,15,3,109.74667,18.37382,2430
30881,234599,B023927CBEC0A8053CBDF64A5B76E367,30051,0,6,6,109.48917,18.21215,1453
30882,234600,B023927CBEC0A8053CBDF64A5B76E367,31931,9,12,3,109.54771,18.29403,1667
30883,234601,B023927CBEC0A8053CBDF64A5B76E367,30921,12,13,1,109.53903,18.29451,1667
30884,234602,B023927CBEC0A8053CBDF64A5B76E367,31931,13,15,2,109.54771,18.29403,1667
30885,234603,B023927CBEC0A8053CBDF64A5B76E367,30051,18,19,1,109.48917,18.21215,1453
30886,234604,B023927CBEC0A8053CBDF64A5B76E367,60231,22,23,1,109.49903,18.21972,1504
30887,234662,BA987FAAC62A550769ECB5E13AC256A5,30191,0,1,1,109.50361,18.22701,1506
30888,234663,BA987FAAC62A550769ECB5E13AC256A5,38261,2,8,6,109.50361,18.28153,1515
30889,234679,A3B0EE5751B9E452997C5AA979B90C91,38951,0,8,8,109.48097,18.28868,1416
30890,234680,A3B0EE5751B9E452997C5AA979B90C91,39131,9,10,1,109.2066,18.29639,417
30891,234681,A3B0EE5751B9E452997C5AA979B90C91,31471,13,14,1,109.34583,18.29563,917
30892,234682,A3B0EE5751B9E452997C5AA979B90C91,30821,17,18,1,109.43681,18.33639,1274
30893,234683,A3B0EE5751B9E452997C5AA979B90C91,38951,20,23,3,109.48097,18.28868,1416
30894,234719,D4EE8E1A4C04A1FF0596E4221D0B8B42,31071,0,7,7,109.58257,18.28458,1815
30895,234720,D4EE8E1A4C04A1FF0596E4221D0B8B42,30854,8,21,13,109.56889,18.27076,1763
30899,234806,1A6EAA2168CC835EA94CCB88CD588780,60551,0,5,5,109.42722,18.30111,1218
30900,234807,1A6EAA2168CC835EA94CCB88CD588780,60552,6,8,2,109.41729,18.30014,1218
30901,234808,1A6EAA2168CC835EA94CCB88CD588780,60551,10,11,1,109.42722,18.30111,1218
30902,234809,1A6EAA2168CC835EA94CCB88CD588780,60524,11,12,1,109.42951,18.28993,1216
30903,234810,1A6EAA2168CC835EA94CCB88CD588780,60551,15,23,8,109.42722,18.30111,1218
30904,234820,D2D609608AA1D4DD8E18DD3745793D0D,31071,1,8,7,109.58257,18.28458,1815
30905,234821,D2D609608AA1D4DD8E18DD3745793D0D,30421,11,12,1,109.50021,18.25861,1511
30906,234822,D2D609608AA1D4DD8E18DD3745793D0D,31071,16,17,1,109.58257,18.28458,1815
30907,234823,D2D609608AA1D4DD8E18DD3745793D0D,30854,17,20,3,109.56889,18.27076,1763
30914,234851,6733B324E753B6172A50174A4CB1E5C2,31251,0,15,15,109.18528,18.2975,317
30915,234866,E07DFD25EAC694A41002C6648E3A4E3C,38911,19,20,1,109.51674,18.24965,1559
30916,234867,E07DFD25EAC694A41002C6648E3A4E3C,30084,21,22,1,109.50118,18.26972,1513
30917,234908,80779C982E47128931C5479B9B9DAF80,30421,0,10,10,109.50021,18.25861,1511
30918,234909,80779C982E47128931C5479B9B9DAF80,30854,11,12,1,109.56889,18.27076,1763
30919,234910,80779C982E47128931C5479B9B9DAF80,31071,15,17,2,109.58257,18.28458,1815
30920,234911,80779C982E47128931C5479B9B9DAF80,30771,21,23,2,109.49938,18.26042,1511
30921,234935,86431DA9F6D3A0F087AFBE2023050B39,30071,12,14,2,109.52819,18.30472,1619
30922,234936,86431DA9F6D3A0F087AFBE2023050B39,31071,16,18,2,109.58257,18.28458,1815
30923,234937,86431DA9F6D3A0F087AFBE2023050B39,31951,19,21,2,109.52174,18.30299,1568
30931,234992,106CA3A9375076B84A466DFC7E9F4CF9,30081,0,6,6,109.50243,18.26632,1512
30932,234993,106CA3A9375076B84A466DFC7E9F4CF9,60591,7,17,10,109.61118,18.21715,1904
30933,234994,106CA3A9375076B84A466DFC7E9F4CF9,30081,20,23,3,109.50243,18.26632,1512
30934,235015,2C222853895C7F3CD32A59ECC6E42FBB,38151,18,19,1,109.51361,18.26542,1562
30935,235016,2C222853895C7F3CD32A59ECC6E42FBB,30681,20,23,3,109.48493,18.26917,1463
30936,235035,490A5F2D9652290BBCEA32DFC103B993,31181,18,19,1,109.50382,18.24813,1509
30937,235036,490A5F2D9652290BBCEA32DFC103B993,31171,20,21,1,109.50938,18.24917,1559
30941,235112,855D815DC19AA779325469411A9E7B8A,30251,2,6,4,109.50611,18.26653,1512
30942,235113,855D815DC19AA779325469411A9E7B8A,38157,7,19,12,109.51483,18.26958,1563
30943,235144,A5CE8EC163B2D3DFB2CA8F669B7180D4,38205,15,16,1,109.62743,18.23139,1956
30944,235145,A5CE8EC163B2D3DFB2CA8F669B7180D4,31861,18,23,5,109.49042,18.27549,1464
30951,235235,C96547CFFA00338796E1443E47F99499,39321,14,16,2,109.529,18.2167,1604
30952,235236,C96547CFFA00338796E1443E47F99499,38361,20,21,1,109.43667,18.29201,1267
30953,235268,07E1A2BEF06E96D54732D75ED1E262EB,31471,15,16,1,109.34583,18.29563,917
30954,235269,07E1A2BEF06E96D54732D75ED1E262EB,31554,21,23,2,109.55521,18.2459,1709
30955,235278,AE1D2CB811A45E9D0BA691392CEA1100,31945,4,6,2,109.58021,18.29403,1817
30956,235279,AE1D2CB811A45E9D0BA691392CEA1100,31071,9,22,13,109.58257,18.28458,1815
30957,235316,5A01EB8FA74506E0F21D58D31F716299,30791,13,14,1,109.72333,18.40889,2386
30958,235317,5A01EB8FA74506E0F21D58D31F716299,31461,18,19,1,109.5091,18.25389,1510
30959,235318,5A01EB8FA74506E0F21D58D31F716299,39053,20,21,1,109.511,18.2771,1564
30960,235389,B9910ED12590156FA874C8F711421C56,60084,0,2,2,109.4984,18.2334,1507
30961,235390,B9910ED12590156FA874C8F711421C56,30051,2,5,3,109.48917,18.21215,1453
30962,235391,B9910ED12590156FA874C8F711421C56,60381,9,10,1,109.5241,18.22458,1605
30963,235392,B9910ED12590156FA874C8F711421C56,31145,13,14,1,109.20431,18.30479,369
30964,235393,B9910ED12590156FA874C8F711421C56,30051,19,21,2,109.48917,18.21215,1453
30965,235394,B9910ED12590156FA874C8F711421C56,60084,21,23,2,109.4984,18.2334,1507
30970,235413,0EEF00D524FC221E0814F0ECEF97AD09,31351,12,14,2,109.4959,18.28417,1465
30971,235415,0EEF00D524FC221E0814F0ECEF97AD09,31351,19,23,4,109.4959,18.28417,1465
30972,235438,5F05A258CA919BA01045F79DD70FBCC9,30854,1,6,5,109.56889,18.27076,1763
30973,235439,5F05A258CA919BA01045F79DD70FBCC9,31561,6,7,1,109.56792,18.28479,1765
30974,235440,5F05A258CA919BA01045F79DD70FBCC9,39183,8,10,2,109.55542,18.28208,1715
30975,235441,5F05A258CA919BA01045F79DD70FBCC9,30071,15,16,1,109.52819,18.30472,1619
30976,235442,5F05A258CA919BA01045F79DD70FBCC9,31561,19,20,1,109.56792,18.28479,1765
30977,235469,CD3BCBAB8571FB81953C842A434E5DB8,30854,6,10,4,109.56889,18.27076,1763
30978,235470,CD3BCBAB8571FB81953C842A434E5DB8,31071,11,22,11,109.58257,18.28458,1815
30985,235587,E27729CF5C68766C958C34CEBE1241B2,39041,0,4,4,109.40021,18.29278,1117
30986,235588,E27729CF5C68766C958C34CEBE1241B2,38903,5,6,1,109.39229,18.29243,1117
30987,235589,E27729CF5C68766C958C34CEBE1241B2,30351,7,9,2,109.41701,18.29292,1217
30988,235590,E27729CF5C68766C958C34CEBE1241B2,30351,16,17,1,109.41701,18.29292,1217
30989,235591,E27729CF5C68766C958C34CEBE1241B2,30351,17,19,2,109.41701,18.29292,1217
30990,235592,E27729CF5C68766C958C34CEBE1241B2,31236,19,22,3,109.42965,18.29111,1216
30991,235605,C2C5F3D1EDFF2B77820D06649C507C1B,31021,8,13,5,109.49021,18.27,1463
30992,235619,B164B8C0AEC0E295C9ED3DBE75B5D547,30391,1,7,6,109.4975,18.27118,1513
30993,235620,B164B8C0AEC0E295C9ED3DBE75B5D547,31181,8,9,1,109.50382,18.24813,1509
30994,235621,B164B8C0AEC0E295C9ED3DBE75B5D547,30361,9,11,2,109.50347,18.24,1508
30995,235622,B164B8C0AEC0E295C9ED3DBE75B5D547,30084,12,14,2,109.50118,18.26972,1513
30996,235623,B164B8C0AEC0E295C9ED3DBE75B5D547,60291,16,17,1,109.50826,18.24639,1509
30997,235624,B164B8C0AEC0E295C9ED3DBE75B5D547,30151,18,19,1,109.50986,18.25083,1560
30998,235681,5264833F0013AE6B294396000613EF89,31351,12,13,1,109.4959,18.28417,1465
30999,235682,5264833F0013AE6B294396000613EF89,31041,15,16,1,109.50278,18.23701,1507
31000,235683,5264833F0013AE6B294396000613EF89,31041,18,19,1,109.50278,18.23701,1507
31001,235687,54EA5A03224802DD904B7C6F69D9E71B,31471,15,16,1,109.34583,18.29563,917
31002,235688,54EA5A03224802DD904B7C6F69D9E71B,38951,21,23,2,109.48097,18.28868,1416
31003,235700,993300654839821E7CBC0B1D6C1A4599,61011,2,21,19,109.60653,18.19076,1900
31004,235713,2F440A235E684ECEDD042B3100A4AE95,31071,6,7,1,109.58257,18.28458,1815
31005,235714,2F440A235E684ECEDD042B3100A4AE95,31561,12,14,2,109.56792,18.28479,1765
31006,235717,0402BD114B7D5E20705E302B756CD062,31071,0,6,6,109.58257,18.28458,1815
31007,235718,0402BD114B7D5E20705E302B756CD062,30854,9,11,2,109.56889,18.27076,1763
31008,235719,0402BD114B7D5E20705E302B756CD062,60631,12,13,1,109.57778,18.27583,1814
31009,235720,0402BD114B7D5E20705E302B756CD062,30854,14,15,1,109.56889,18.27076,1763
31010,235721,0402BD114B7D5E20705E302B756CD062,31071,16,18,2,109.58257,18.28458,1815
31011,235722,0402BD114B7D5E20705E302B756CD062,30854,19,21,2,109.56889,18.27076,1763
31012,235748,5EBEA276FCB4A19AC5C987F5C7CC8908,60552,1,3,2,109.41729,18.30014,1218
31013,235749,5EBEA276FCB4A19AC5C987F5C7CC8908,60524,5,6,1,109.42951,18.28993,1216
31014,235750,5EBEA276FCB4A19AC5C987F5C7CC8908,60552,10,11,1,109.41729,18.30014,1218
31015,235751,5EBEA276FCB4A19AC5C987F5C7CC8908,60401,11,13,2,109.47444,18.27583,1414
31016,235752,5EBEA276FCB4A19AC5C987F5C7CC8908,60621,13,15,2,109.48354,18.27451,1464
31017,235753,5EBEA276FCB4A19AC5C987F5C7CC8908,38361,19,20,1,109.43667,18.29201,1267
31018,235754,C6702CA511246E70666F9E56EFC53769,60221,1,7,6,109.52569,18.29188,1616
31019,235755,C6702CA511246E70666F9E56EFC53769,30851,8,9,1,109.5616,18.27396,1713
31020,235756,C6702CA511246E70666F9E56EFC53769,31561,10,12,2,109.56792,18.28479,1765
31021,235757,C6702CA511246E70666F9E56EFC53769,30851,15,16,1,109.5616,18.27396,1713
31022,235758,C6702CA511246E70666F9E56EFC53769,31561,16,18,2,109.56792,18.28479,1765
31023,235765,EEF2FC7D161D746ED74FFF65C3D590CD,31781,12,14,2,109.19847,18.2975,367
31024,235766,EEF2FC7D161D746ED74FFF65C3D590CD,31271,19,20,1,109.48958,18.26257,1462
31025,235767,EEF2FC7D161D746ED74FFF65C3D590CD,30171,20,23,3,109.48458,18.27139,1463
31029,235781,7B1A07C39637E996C01DF0A3D287D3C6,39371,1,14,13,109.56627,18.2646,1762
31030,235782,7B1A07C39637E996C01DF0A3D287D3C6,31071,17,19,2,109.58257,18.28458,1815
31031,235792,DEEF519781F9588D37AD928845C2355A,31781,13,15,2,109.19847,18.2975,367
31032,235793,DEEF519781F9588D37AD928845C2355A,31521,18,21,3,109.51458,18.22542,1555
31033,235794,DEEF519781F9588D37AD928845C2355A,30511,22,23,1,109.51069,18.24208,1558
31034,235795,DB4DF566D4757FF3BB488F82DE126248,30851,10,11,1,109.5616,18.27396,1713
31035,235796,DB4DF566D4757FF3BB488F82DE126248,31561,12,17,5,109.56792,18.28479,1765
31036,235813,25DF9BDDEDA9DA85FA8972A7B6B93BF8,30681,0,10,10,109.48493,18.26917,1463
31037,235814,25DF9BDDEDA9DA85FA8972A7B6B93BF8,60054,12,15,3,109.3016,18.31229,770
31038,235815,25DF9BDDEDA9DA85FA8972A7B6B93BF8,30681,18,19,1,109.48493,18.26917,1463
31039,235816,25DF9BDDEDA9DA85FA8972A7B6B93BF8,30361,20,21,1,109.50347,18.24,1508
31043,235826,0312B43ACF9ED1D8304E325E851AEE29,30851,0,9,9,109.5616,18.27396,1713
31044,235827,0312B43ACF9ED1D8304E325E851AEE29,31561,10,12,2,109.56792,18.28479,1765
31045,235828,0312B43ACF9ED1D8304E325E851AEE29,30851,13,14,1,109.5616,18.27396,1713
31046,235829,0312B43ACF9ED1D8304E325E851AEE29,31561,14,15,1,109.56792,18.28479,1765
31047,235830,0312B43ACF9ED1D8304E325E851AEE29,30851,15,19,4,109.5616,18.27396,1713
31048,235835,EEAA904909853FCE4C1006E1C626BEA2,60231,0,11,11,109.49903,18.21972,1504
31049,235838,EEAA904909853FCE4C1006E1C626BEA2,60231,21,23,2,109.49903,18.21972,1504
31050,235844,1FC5887E4053936D3ED4D738338DC172,31421,0,7,7,109.55382,18.22347,1705
31051,235845,1FC5887E4053936D3ED4D738338DC172,30851,11,23,12,109.5616,18.27396,1713
31055,235919,91FC837E1F046F1B43F9D8C2C0F1555F,30321,19,21,2,109.49563,18.29611,1467
31056,235920,91FC837E1F046F1B43F9D8C2C0F1555F,39321,21,23,2,109.529,18.2167,1604
31057,235966,7DE63B500AAA8596FED98730536D4512,30351,0,11,11,109.41701,18.29292,1217
31058,235967,7DE63B500AAA8596FED98730536D4512,30661,12,13,1,109.37028,18.24361,1008
31059,235968,7DE63B500AAA8596FED98730536D4512,30341,13,14,1,109.3625,18.29167,966
31063,236014,2C3EB493C3D5668656C0F89E35138F88,30111,0,1,1,109.47583,18.30542,1419
31064,236015,2C3EB493C3D5668656C0F89E35138F88,60421,1,4,3,109.46333,18.31743,1371
31065,236016,2C3EB493C3D5668656C0F89E35138F88,30821,5,6,1,109.43681,18.33639,1274
31066,236017,2C3EB493C3D5668656C0F89E35138F88,60221,18,21,3,109.52569,18.29188,1616
31067,236018,2C3EB493C3D5668656C0F89E35138F88,30821,22,23,1,109.43681,18.33639,1274
31071,236026,7B28F954C024CD32BD4419981FD19B1F,31781,12,14,2,109.19847,18.2975,367
31072,236027,7B28F954C024CD32BD4419981FD19B1F,38105,18,23,5,109.40299,18.29229,1117
31073,236035,8265A029C672FE0377EF574CC3ADF2A8,39183,14,16,2,109.55542,18.28208,1715
31074,236036,8265A029C672FE0377EF574CC3ADF2A8,30854,21,23,2,109.56889,18.27076,1763
31075,236050,CA3896FB33E9BC68E91955EDFF5D709B,30234,18,20,2,109.60681,18.29979,1918
31076,236051,CA3896FB33E9BC68E91955EDFF5D709B,30854,22,23,1,109.56889,18.27076,1763
31077,236061,64F4CDF664AA04E7B79DE93C57128CF6,31931,2,7,5,109.54771,18.29403,1667
31078,236062,64F4CDF664AA04E7B79DE93C57128CF6,39181,10,18,8,109.55153,18.28035,1715
31079,236080,6B806948BC9187A91D033B4096721B00,31561,1,7,6,109.56792,18.28479,1765
31080,236081,6B806948BC9187A91D033B4096721B00,31071,9,20,11,109.58257,18.28458,1815
31081,236113,5A31AA15CC197C9237A9A16B14069CB4,31864,19,23,4,109.49014,18.28333,1465
31082,236150,56F4A25A0E603B5B2CF39EF89A2DE812,31611,0,8,8,109.63076,18.34944,2026
31083,236151,56F4A25A0E603B5B2CF39EF89A2DE812,60231,11,13,2,109.49903,18.21972,1504
31084,236152,56F4A25A0E603B5B2CF39EF89A2DE812,30711,16,18,2,109.50271,18.25347,1510
31085,236153,56F4A25A0E603B5B2CF39EF89A2DE812,30421,18,21,3,109.50021,18.25861,1511
31086,236154,56F4A25A0E603B5B2CF39EF89A2DE812,31611,22,23,1,109.63076,18.34944,2026
31087,236159,C45AE1932A145D3CA4B8A65E78F9575D,38291,1,9,8,109.51618,18.24313,1558
31088,236160,C45AE1932A145D3CA4B8A65E78F9575D,60311,11,12,1,109.52097,18.24319,1558
31089,236161,C45AE1932A145D3CA4B8A65E78F9575D,31261,12,13,1,109.51174,18.2466,1559
31090,236162,C45AE1932A145D3CA4B8A65E78F9575D,38291,14,16,2,109.51618,18.24313,1558
31091,236163,C45AE1932A145D3CA4B8A65E78F9575D,30421,18,20,2,109.50021,18.25861,1511
31096,236217,1895F5980F209DD67ED920915EFD0AEA,60401,0,8,8,109.47444,18.27583,1414
31097,236269,4EC716C6116001DCCA61DAB5E48F9371,38391,0,7,7,109.44111,18.29083,1266
31098,236270,4EC716C6116001DCCA61DAB5E48F9371,60421,7,13,6,109.46333,18.31743,1371
31099,236271,4EC716C6116001DCCA61DAB5E48F9371,60201,14,17,3,109.5041,18.2509,1510
31108,236360,6587551DA47309E484D1302521C8D417,38275,10,15,5,109.62875,18.22938,2006
31109,236361,6587551DA47309E484D1302521C8D417,38054,19,21,2,109.63479,18.23097,2006
31114,236383,FA1A0E0BAAE42E33A894437D15AB1110,60631,2,7,5,109.57778,18.27583,1814
31115,236384,FA1A0E0BAAE42E33A894437D15AB1110,31071,9,11,2,109.58257,18.28458,1815
31116,236385,FA1A0E0BAAE42E33A894437D15AB1110,60631,13,15,2,109.57778,18.27583,1814
31117,236386,FA1A0E0BAAE42E33A894437D15AB1110,39091,16,17,1,109.50097,18.25222,1510
31118,236387,FA1A0E0BAAE42E33A894437D15AB1110,30854,19,20,1,109.56889,18.27076,1763
31119,236388,FA1A0E0BAAE42E33A894437D15AB1110,60631,22,23,1,109.57778,18.27583,1814
31123,236398,17D6DB95A76434E18528B9C94350AA97,31531,0,8,8,109.49583,18.25972,1461
31124,236399,17D6DB95A76434E18528B9C94350AA97,31471,11,15,4,109.34583,18.29563,917
31125,236400,17D6DB95A76434E18528B9C94350AA97,31531,20,23,3,109.49583,18.25972,1461
31126,236406,3977578BE56276DA0700B04B81DC1356,30851,1,6,5,109.5616,18.27396,1713
31127,236407,3977578BE56276DA0700B04B81DC1356,31561,7,8,1,109.56792,18.28479,1765
31128,236408,3977578BE56276DA0700B04B81DC1356,31071,11,14,3,109.58257,18.28458,1815
31129,236409,3977578BE56276DA0700B04B81DC1356,31561,14,17,3,109.56792,18.28479,1765
31130,236410,3977578BE56276DA0700B04B81DC1356,30851,19,20,1,109.5616,18.27396,1713
31131,236411,3977578BE56276DA0700B04B81DC1356,31561,21,22,1,109.56792,18.28479,1765
31132,236416,5205655EC583F6392BC68C8BB9865108,30854,14,20,6,109.56889,18.27076,1763
31133,236417,5205655EC583F6392BC68C8BB9865108,31171,22,23,1,109.50938,18.24917,1559
31134,236467,B7E330D15F4B46614A332696B5F7027D,31561,0,4,4,109.56792,18.28479,1765
31135,236468,B7E330D15F4B46614A332696B5F7027D,31931,7,23,16,109.54771,18.29403,1667
31136,236499,F2DDFA8B80CE24F358EB38920C9A6AA9,31571,15,16,1,109.61563,18.23326,1957
31137,236500,F2DDFA8B80CE24F358EB38920C9A6AA9,38017,19,20,1,109.49729,18.21424,1504
31138,236501,F2DDFA8B80CE24F358EB38920C9A6AA9,30441,21,22,1,109.64021,18.25424,2010
31139,236527,9272327B359F9A8CB4E9C533C10E8BE6,30681,0,18,18,109.48493,18.26917,1463
31140,236528,9272327B359F9A8CB4E9C533C10E8BE6,60401,19,21,2,109.47444,18.27583,1414
31144,236567,7C085508C36749F188C75B401CBDAD91,31521,0,8,8,109.51458,18.22542,1555
31145,236569,7C085508C36749F188C75B401CBDAD91,31471,13,15,2,109.34583,18.29563,917
31146,236570,7C085508C36749F188C75B401CBDAD91,60221,18,21,3,109.52569,18.29188,1616
31147,236573,5F8A4BDCC5D1941BEB6DBBEA7E0B606A,38826,4,7,3,109.50326,18.25514,1510
31148,236574,5F8A4BDCC5D1941BEB6DBBEA7E0B606A,30911,9,11,2,109.50493,18.26181,1511
31149,236575,5F8A4BDCC5D1941BEB6DBBEA7E0B606A,60214,13,14,1,109.63104,18.24493,2009
31150,236576,5F8A4BDCC5D1941BEB6DBBEA7E0B606A,31031,19,21,2,109.49979,18.25382,1510
31151,236577,5F8A4BDCC5D1941BEB6DBBEA7E0B606A,60214,22,23,1,109.63104,18.24493,2009
31155,236590,6917A8E1AE4CE33049FC189B3388DF85,60261,0,6,6,109.44326,18.3075,1319
31156,236591,6917A8E1AE4CE33049FC189B3388DF85,60201,8,10,2,109.5041,18.2509,1510
31157,236592,6917A8E1AE4CE33049FC189B3388DF85,60171,11,13,2,109.51292,18.30694,1569
31158,236593,6917A8E1AE4CE33049FC189B3388DF85,31461,14,16,2,109.5091,18.25389,1510
31159,236594,6917A8E1AE4CE33049FC189B3388DF85,38127,19,20,1,109.50833,18.27222,1513
31160,236595,6917A8E1AE4CE33049FC189B3388DF85,60261,21,23,2,109.44326,18.3075,1319
31161,236614,451E2BF48CD7B253EB0892324E679BCC,38297,1,6,5,109.52576,18.24965,1609
31162,236615,451E2BF48CD7B253EB0892324E679BCC,60281,7,11,4,109.51743,18.25924,1561
31163,236616,451E2BF48CD7B253EB0892324E679BCC,38297,11,13,2,109.52576,18.24965,1609
31164,236617,451E2BF48CD7B253EB0892324E679BCC,60281,13,15,2,109.51743,18.25924,1561
31165,236618,451E2BF48CD7B253EB0892324E679BCC,60671,15,17,2,109.52979,18.31757,1621
31166,236619,451E2BF48CD7B253EB0892324E679BCC,38297,17,18,1,109.52576,18.24965,1609
31174,236676,05C6A2C14509DD9617D330FE89E3643D,30891,0,2,2,109.59431,18.28389,1865
31175,236677,05C6A2C14509DD9617D330FE89E3643D,31071,3,5,2,109.58257,18.28458,1815
31176,236678,05C6A2C14509DD9617D330FE89E3643D,60631,6,7,1,109.57778,18.27583,1814
31177,236679,05C6A2C14509DD9617D330FE89E3643D,60381,8,9,1,109.5241,18.22458,1605
31178,236680,05C6A2C14509DD9617D330FE89E3643D,31781,12,14,2,109.19847,18.2975,367
31179,236728,86E10BC3307CFF28C676C9C7B0F51200,60552,19,20,1,109.41729,18.30014,1218
31180,236729,86E10BC3307CFF28C676C9C7B0F51200,38361,21,23,2,109.43667,18.29201,1267
31181,236752,529A14F498129B0238F7B12A9FC7F6F7,31205,0,1,1,109.51111,18.23736,1557
31182,236753,529A14F498129B0238F7B12A9FC7F6F7,31671,3,17,14,109.38965,18.29813,1068
31183,236754,529A14F498129B0238F7B12A9FC7F6F7,30324,18,20,2,109.50326,18.29257,1517
31184,236755,529A14F498129B0238F7B12A9FC7F6F7,30711,21,23,2,109.50271,18.25347,1510
31189,236768,5E8FF49D1CCDA711846608608C7FAE0D,31071,0,11,11,109.58257,18.28458,1815
31190,236769,5E8FF49D1CCDA711846608608C7FAE0D,30854,16,19,3,109.56889,18.27076,1763
31191,236770,2C3BD53A8702A47FB82F05FB4993B683,39183,15,16,1,109.55542,18.28208,1715
31192,236771,2C3BD53A8702A47FB82F05FB4993B683,31561,21,22,1,109.56792,18.28479,1765
31193,236786,866460FA5062A635337B6369BB2AADDA,31071,3,5,2,109.58257,18.28458,1815
31194,236787,866460FA5062A635337B6369BB2AADDA,30854,9,23,14,109.56889,18.27076,1763
31195,236807,999F394CBA35AFBAE3B26337712A5850,30854,16,22,6,109.56889,18.27076,1763
31196,236808,999F394CBA35AFBAE3B26337712A5850,31071,22,23,1,109.58257,18.28458,1815
31197,236878,D42D82F7F77C55013F0EAB7E35E2211F,30854,2,3,1,109.56889,18.27076,1763
31198,236879,D42D82F7F77C55013F0EAB7E35E2211F,31071,6,10,4,109.58257,18.28458,1815
31199,236880,D42D82F7F77C55013F0EAB7E35E2211F,30531,14,22,8,109.53271,18.21472,1604
31200,236895,D39D64452E6BBEF7B3056CA239E1B86E,30854,0,6,6,109.56889,18.27076,1763
31201,236896,D39D64452E6BBEF7B3056CA239E1B86E,31561,6,7,1,109.56792,18.28479,1765
31202,236897,D39D64452E6BBEF7B3056CA239E1B86E,30854,8,9,1,109.56889,18.27076,1763
31203,236898,D39D64452E6BBEF7B3056CA239E1B86E,31561,9,11,2,109.56792,18.28479,1765
31204,236899,D39D64452E6BBEF7B3056CA239E1B86E,30854,12,13,1,109.56889,18.27076,1763
31205,236900,D39D64452E6BBEF7B3056CA239E1B86E,31561,14,19,5,109.56792,18.28479,1765
31206,236901,D39D64452E6BBEF7B3056CA239E1B86E,30854,19,23,4,109.56889,18.27076,1763
31213,237000,B0C6DED232762D9BAF78468BD2731104,60041,13,14,1,109.39889,18.31944,1121
31214,237001,B0C6DED232762D9BAF78468BD2731104,30581,18,23,5,109.62257,18.24951,1959
31215,237038,D41B754FD260B71E1D8B72C191605B3D,60114,13,14,1,109.73028,18.33847,2374
31216,237042,CD576F1C1CDFB89E6A99A20E65927346,31561,2,8,6,109.56792,18.28479,1765
31217,237043,CD576F1C1CDFB89E6A99A20E65927346,30854,9,23,14,109.56889,18.27076,1763
31218,237049,2E4974DC6B5DC914D4BEF4B8CF2CC13B,60391,13,16,3,109.47667,18.28757,1416
31219,237050,2E4974DC6B5DC914D4BEF4B8CF2CC13B,31081,21,23,2,109.44639,18.30181,1318
31228,237087,B712327B6033C61F37801CFD6DAC08AD,30561,1,2,1,109.52778,18.31938,1621
31229,237088,B712327B6033C61F37801CFD6DAC08AD,31951,3,5,2,109.52174,18.30299,1568
31230,237089,B712327B6033C61F37801CFD6DAC08AD,38484,6,9,3,109.53028,18.31528,1620
31231,237090,B712327B6033C61F37801CFD6DAC08AD,30561,10,13,3,109.52778,18.31938,1621
31232,237091,B712327B6033C61F37801CFD6DAC08AD,38484,13,16,3,109.53028,18.31528,1620
31233,237092,B712327B6033C61F37801CFD6DAC08AD,38484,16,18,2,109.53028,18.31528,1620
31234,237093,B712327B6033C61F37801CFD6DAC08AD,30561,18,19,1,109.52778,18.31938,1621
31235,237094,B712327B6033C61F37801CFD6DAC08AD,30771,20,21,1,109.49938,18.26042,1511
31236,237095,B712327B6033C61F37801CFD6DAC08AD,30561,22,23,1,109.52778,18.31938,1621
31240,237132,DF296B63A64E364FCDA4C38B0935EEEE,30511,0,20,20,109.51069,18.24208,1558
31241,237133,DF296B63A64E364FCDA4C38B0935EEEE,31201,21,23,2,109.51042,18.23819,1558
31242,237135,070ADE02B3AE6F1159A3DDFA12578616,30361,10,23,13,109.50347,18.24,1508
31243,237159,225EDE82328108AFB3E7EE610CA3F074,60371,4,5,1,109.53063,18.30056,1618
31244,237160,225EDE82328108AFB3E7EE610CA3F074,31931,7,23,16,109.54771,18.29403,1667
31245,237193,89362A3CA3AE6F5B75871F2110924F99,31551,12,14,2,109.55868,18.24222,1708
31246,237194,89362A3CA3AE6F5B75871F2110924F99,39371,14,16,2,109.56627,18.2646,1762
31247,237195,89362A3CA3AE6F5B75871F2110924F99,30851,19,23,4,109.5616,18.27396,1713
31251,237263,7FF3C6569A3990C03CAF6C52D3C8BC6C,30921,0,6,6,109.53903,18.29451,1667
31252,237264,7FF3C6569A3990C03CAF6C52D3C8BC6C,31931,7,11,4,109.54771,18.29403,1667
31253,237265,7FF3C6569A3990C03CAF6C52D3C8BC6C,30921,12,13,1,109.53903,18.29451,1667
31254,237266,7FF3C6569A3990C03CAF6C52D3C8BC6C,31931,14,15,1,109.54771,18.29403,1667
31255,237267,7FF3C6569A3990C03CAF6C52D3C8BC6C,30921,17,23,6,109.53903,18.29451,1667
31256,237276,BA9F8903EC2A1C9DFCBB7CC5DE07DE50,30021,0,5,5,109.12014,18.40986,86
31257,237277,BA9F8903EC2A1C9DFCBB7CC5DE07DE50,30854,9,11,2,109.56889,18.27076,1763
31258,237278,BA9F8903EC2A1C9DFCBB7CC5DE07DE50,31071,15,16,1,109.58257,18.28458,1815
31259,237279,BA9F8903EC2A1C9DFCBB7CC5DE07DE50,30854,16,18,2,109.56889,18.27076,1763
31260,237296,066E3B290AAC556F650E56DD0F693AB2,38251,0,8,8,109.49618,18.25493,1510
31261,237297,066E3B290AAC556F650E56DD0F693AB2,30601,10,12,2,109.66521,18.3875,2132
31262,237298,066E3B290AAC556F650E56DD0F693AB2,30581,14,18,4,109.62257,18.24951,1959
31263,237305,AA2A5396AD753E9245AC53C94BAEDECD,61011,9,17,8,109.60653,18.19076,1900
31264,237327,182D5101D28D51096306D4EF5FDD4501,60084,0,6,6,109.4984,18.2334,1507
31265,237328,182D5101D28D51096306D4EF5FDD4501,30271,8,10,2,109.49132,18.23153,1456
31266,237338,64EA917EAAD3EB55DA2ABB227203C131,60631,15,16,1,109.57778,18.27583,1814
31267,237347,5C88F2693E57AFE9DC179450D039A684,39181,0,8,8,109.55153,18.28035,1715
31268,237348,5C88F2693E57AFE9DC179450D039A684,38271,10,15,5,109.62632,18.23049,1956
31269,237349,5C88F2693E57AFE9DC179450D039A684,39181,19,23,4,109.55153,18.28035,1715
31270,237383,3738BCD5F22BB841A8E524306ADFE0A0,38261,0,7,7,109.50361,18.28153,1515
31271,237384,3738BCD5F22BB841A8E524306ADFE0A0,38751,8,13,5,109.74903,18.37639,2481
31272,237385,3738BCD5F22BB841A8E524306ADFE0A0,38261,14,18,4,109.50361,18.28153,1515
31273,237386,3738BCD5F22BB841A8E524306ADFE0A0,31031,19,20,1,109.49979,18.25382,1510
31274,237387,3738BCD5F22BB841A8E524306ADFE0A0,38261,21,22,1,109.50361,18.28153,1515
31275,237403,0302A2EBE6E506DC381134D2966F2AA4,38951,6,8,2,109.48097,18.28868,1416
31276,237404,0302A2EBE6E506DC381134D2966F2AA4,31471,13,14,1,109.34583,18.29563,917
31277,237405,0302A2EBE6E506DC381134D2966F2AA4,30821,16,18,2,109.43681,18.33639,1274
31278,237406,0302A2EBE6E506DC381134D2966F2AA4,60504,22,23,1,109.47917,18.28903,1416
31283,237458,686A151A10363ED54A6F439954DA26E0,31761,0,2,2,109.60521,18.27965,1914
31284,237459,686A151A10363ED54A6F439954DA26E0,60594,2,13,11,109.62694,18.22799,1956
31285,237460,686A151A10363ED54A6F439954DA26E0,60221,15,17,2,109.52569,18.29188,1616
31286,237461,686A151A10363ED54A6F439954DA26E0,31221,19,21,2,109.61333,18.26833,1913
31287,237462,686A151A10363ED54A6F439954DA26E0,60594,21,22,1,109.62694,18.22799,1956
31292,237475,367FEEED2C09304141141F7892D4FBC2,30291,0,7,7,109.50403,18.27028,1513
31293,237476,367FEEED2C09304141141F7892D4FBC2,30084,8,21,13,109.50118,18.26972,1513
31294,237477,975CB35586D2D95A387E2AA86A5AB719,31351,0,6,6,109.4959,18.28417,1465
31295,237478,975CB35586D2D95A387E2AA86A5AB719,30671,8,17,9,109.43611,18.30139,1268
31296,237522,3F320FCC97654DBDACE66BB1BF09E301,30341,14,16,2,109.3625,18.29167,966
31300,237553,E6D4DFF479624FE5A6D32ED2123EE444,60291,0,1,1,109.50826,18.24639,1509
31301,237554,E6D4DFF479624FE5A6D32ED2123EE444,30511,4,5,1,109.51069,18.24208,1558
31302,237555,E6D4DFF479624FE5A6D32ED2123EE444,30731,6,7,1,109.50944,18.22306,1555
31303,237556,E6D4DFF479624FE5A6D32ED2123EE444,60291,10,13,3,109.50826,18.24639,1509
31304,237557,E6D4DFF479624FE5A6D32ED2123EE444,60541,13,15,2,109.4084,18.29208,1167
31305,237558,97C31877CA4226D0F1BA1C0E12066B56,60331,0,6,6,109.505,18.26507,1512
31306,237559,97C31877CA4226D0F1BA1C0E12066B56,30854,8,9,1,109.56889,18.27076,1763
31307,237560,97C31877CA4226D0F1BA1C0E12066B56,31071,12,13,1,109.58257,18.28458,1815
31308,237561,97C31877CA4226D0F1BA1C0E12066B56,30854,13,18,5,109.56889,18.27076,1763
31309,237562,97C31877CA4226D0F1BA1C0E12066B56,60331,19,23,4,109.505,18.26507,1512
31310,237587,A7D344B7B6FA604F8D0B73C56E3BBEF1,60371,19,21,2,109.53063,18.30056,1618
31311,237588,A7D344B7B6FA604F8D0B73C56E3BBEF1,60241,21,23,2,109.53319,18.28667,1616
31316,237600,BDFAC327288611EBD473916D4CB9B192,60411,0,10,10,109.32514,18.30854,869
31317,237601,BDFAC327288611EBD473916D4CB9B192,38251,13,14,1,109.49618,18.25493,1510
31318,237602,BDFAC327288611EBD473916D4CB9B192,30711,18,20,2,109.50271,18.25347,1510
31319,237603,BDFAC327288611EBD473916D4CB9B192,60411,21,23,2,109.32514,18.30854,869
31323,237636,9AF351B3CC27394DFED45513F0E32162,31421,8,10,2,109.55382,18.22347,1705
31324,237637,9AF351B3CC27394DFED45513F0E32162,30951,13,17,4,109.56208,18.25667,1761
31325,237638,9AF351B3CC27394DFED45513F0E32162,31761,18,21,3,109.60521,18.27965,1914
31326,237639,9AF351B3CC27394DFED45513F0E32162,60351,22,23,1,109.58403,18.28958,1816
31327,237673,608A55C14BAB2A5B627ACC1F39B89FB6,31945,0,7,7,109.58021,18.29403,1817
31328,237674,608A55C14BAB2A5B627ACC1F39B89FB6,30854,7,9,2,109.56889,18.27076,1763
31329,237675,608A55C14BAB2A5B627ACC1F39B89FB6,31945,12,13,1,109.58021,18.29403,1817
31330,237676,608A55C14BAB2A5B627ACC1F39B89FB6,30854,13,16,3,109.56889,18.27076,1763
31331,237677,608A55C14BAB2A5B627ACC1F39B89FB6,31945,21,23,2,109.58021,18.29403,1817
31335,237750,85586D73EA48B4F4D520D899B0BE0554,30291,0,5,5,109.50403,18.27028,1513
31336,237751,85586D73EA48B4F4D520D899B0BE0554,30854,6,8,2,109.56889,18.27076,1763
31337,237752,85586D73EA48B4F4D520D899B0BE0554,31071,13,15,2,109.58257,18.28458,1815
31338,237753,85586D73EA48B4F4D520D899B0BE0554,30854,16,17,1,109.56889,18.27076,1763
31339,237754,85586D73EA48B4F4D520D899B0BE0554,30291,19,23,4,109.50403,18.27028,1513
31340,237761,10EBF762D28520B09848288F7052CFDE,39101,8,16,8,109.50132,18.24931,1509
31341,237762,10EBF762D28520B09848288F7052CFDE,30854,20,22,2,109.56889,18.27076,1763
31342,237769,C30EF1A03F3ACD87114629BE5EBA14E8,31091,19,20,1,109.41201,18.31222,1170
31343,237770,C30EF1A03F3ACD87114629BE5EBA14E8,60552,21,23,2,109.41729,18.30014,1218
31351,237861,DF5348A8E25901EBB63BBF3F6126BB02,31071,2,9,7,109.58257,18.28458,1815
31352,237862,DF5348A8E25901EBB63BBF3F6126BB02,30854,9,21,12,109.56889,18.27076,1763
31353,237878,E605B26D53F08A0D3360A4541E09F4E2,38283,0,12,12,109.62229,18.22618,1956
31354,237879,E605B26D53F08A0D3360A4541E09F4E2,38283,12,13,1,109.62229,18.22618,1956
31355,237884,B621E9075674E792CCB217233825F9D1,30851,1,5,4,109.5616,18.27396,1713
31356,237885,B621E9075674E792CCB217233825F9D1,30232,5,6,1,109.6191,18.31701,1971
31357,237902,985A2EA61E10E912EF275486E93274F1,60161,0,5,5,109.49174,18.26181,1461
31358,237903,985A2EA61E10E912EF275486E93274F1,60201,7,10,3,109.5041,18.2509,1510
31359,237904,985A2EA61E10E912EF275486E93274F1,38754,11,16,5,109.74667,18.37382,2430
31360,237905,985A2EA61E10E912EF275486E93274F1,30711,21,23,2,109.50271,18.25347,1510
31361,237911,187E4246482015B90D2FCF3E336B729B,30854,12,13,1,109.56889,18.27076,1763
31362,237912,187E4246482015B90D2FCF3E336B729B,31561,15,17,2,109.56792,18.28479,1765
31363,237928,F34F0762CFAEDFE0B6E04516A3061D6D,38484,15,16,1,109.53028,18.31528,1620
31367,237984,1026894DC5FF9A7FAF3A2EE28B95E239,30232,12,14,2,109.6191,18.31701,1971
31368,237985,1026894DC5FF9A7FAF3A2EE28B95E239,30854,18,19,1,109.56889,18.27076,1763
31369,237986,43F5AB52A0AF3FEB5880C6DCD16BBA02,31041,14,17,3,109.50278,18.23701,1507
31370,237987,43F5AB52A0AF3FEB5880C6DCD16BBA02,60011,19,20,1,109.48965,18.30222,1468
31371,237988,43F5AB52A0AF3FEB5880C6DCD16BBA02,38017,21,22,1,109.49729,18.21424,1504
31372,238003,7421066246AAD1C230E7E2A7ADF06E9D,30854,13,16,3,109.56889,18.27076,1763
31373,238004,7421066246AAD1C230E7E2A7ADF06E9D,31071,18,19,1,109.58257,18.28458,1815
31374,238005,7421066246AAD1C230E7E2A7ADF06E9D,30854,19,21,2,109.56889,18.27076,1763
31375,238018,6D9FA4DCEF58F1F06A04A77E6B79A7E0,31124,2,5,3,109.17069,18.35,276
31376,238019,6D9FA4DCEF58F1F06A04A77E6B79A7E0,30434,5,9,4,109.17083,18.35861,278
31377,238020,6D9FA4DCEF58F1F06A04A77E6B79A7E0,31031,11,13,2,109.49979,18.25382,1510
31378,238021,6D9FA4DCEF58F1F06A04A77E6B79A7E0,31271,13,15,2,109.48958,18.26257,1462
31379,238022,6D9FA4DCEF58F1F06A04A77E6B79A7E0,60641,18,20,2,109.53854,18.2359,1657
31380,238023,6D9FA4DCEF58F1F06A04A77E6B79A7E0,31271,21,23,2,109.48958,18.26257,1462
31381,238024,A01B4012B619D942E7CC3AC9B78722B4,31561,11,16,5,109.56792,18.28479,1765
31382,238025,A01B4012B619D942E7CC3AC9B78722B4,30854,17,18,1,109.56889,18.27076,1763
31383,238026,A01B4012B619D942E7CC3AC9B78722B4,31561,20,21,1,109.56792,18.28479,1765
31384,238036,7A2366BD23884470C887501F5D242DE3,60221,19,20,1,109.52569,18.29188,1616
31385,238037,7A2366BD23884470C887501F5D242DE3,31521,22,23,1,109.51458,18.22542,1555
31386,238040,0A48A76A646C70DF6B9924881BA2168A,60241,14,15,1,109.53319,18.28667,1616
31387,238041,0A48A76A646C70DF6B9924881BA2168A,30071,19,23,4,109.52819,18.30472,1619
31388,238046,417408FFDA93B177641D270D3A5C4B2D,31071,0,5,5,109.58257,18.28458,1815
31389,238047,417408FFDA93B177641D270D3A5C4B2D,30854,6,10,4,109.56889,18.27076,1763
31390,238048,417408FFDA93B177641D270D3A5C4B2D,31071,12,13,1,109.58257,18.28458,1815
31391,238049,417408FFDA93B177641D270D3A5C4B2D,30854,15,16,1,109.56889,18.27076,1763
31392,238050,417408FFDA93B177641D270D3A5C4B2D,31071,21,23,2,109.58257,18.28458,1815
31393,238098,2F5414222852C38E31C908162F37072A,38754,16,17,1,109.74667,18.37382,2430
31394,238099,2F5414222852C38E31C908162F37072A,60231,19,22,3,109.49903,18.21972,1504
31395,238102,2A3E5205AC8230AFA039AD71C1DA60B8,31421,19,21,2,109.55382,18.22347,1705
31396,238103,2A3E5205AC8230AFA039AD71C1DA60B8,60661,21,23,2,109.548,18.2377,1657
31397,238104,D29579433637905809D9DF6839E94DB4,31071,0,5,5,109.58257,18.28458,1815
31398,238105,D29579433637905809D9DF6839E94DB4,30854,6,9,3,109.56889,18.27076,1763
31399,238126,E484FD222AE68252EABA732103338917,31071,0,6,6,109.58257,18.28458,1815
31400,238127,E484FD222AE68252EABA732103338917,30854,10,11,1,109.56889,18.27076,1763
31401,238128,6E3295BE038630AA5C3C9528B9405511,31101,0,12,12,109.65389,18.23403,2057
31402,238129,6E3295BE038630AA5C3C9528B9405511,60381,13,15,2,109.5241,18.22458,1605
31403,238130,6E3295BE038630AA5C3C9528B9405511,31521,19,22,3,109.51458,18.22542,1555
31404,238134,3499E731A877B5132E572C7056EDDA83,31261,0,5,5,109.51174,18.2466,1559
31405,238135,3499E731A877B5132E572C7056EDDA83,38911,5,7,2,109.51674,18.24965,1559
31406,238136,3499E731A877B5132E572C7056EDDA83,31261,7,9,2,109.51174,18.2466,1559
31407,238137,3499E731A877B5132E572C7056EDDA83,31261,10,13,3,109.51174,18.2466,1559
31408,238138,3499E731A877B5132E572C7056EDDA83,31261,15,18,3,109.51174,18.2466,1559
31409,238139,3499E731A877B5132E572C7056EDDA83,30421,18,19,1,109.50021,18.25861,1511
31410,238140,3499E731A877B5132E572C7056EDDA83,31261,20,22,2,109.51174,18.2466,1559
31414,238148,A11F3A10732BFDE382AECA973824C570,60614,0,1,1,109.48799,18.29521,1467
31415,238149,A11F3A10732BFDE382AECA973824C570,30111,2,3,1,109.47583,18.30542,1419
31416,238150,A11F3A10732BFDE382AECA973824C570,30821,5,6,1,109.43681,18.33639,1274
31417,238161,EFFEF00C078D502D6D0D1D469ACBA466,30421,0,7,7,109.50021,18.25861,1511
31418,238162,EFFEF00C078D502D6D0D1D469ACBA466,31031,9,10,1,109.49979,18.25382,1510
31419,238163,EFFEF00C078D502D6D0D1D469ACBA466,39041,12,15,3,109.40021,18.29278,1117
31420,238164,EFFEF00C078D502D6D0D1D469ACBA466,31471,15,17,2,109.34583,18.29563,917
31421,238165,EFFEF00C078D502D6D0D1D469ACBA466,30421,19,23,4,109.50021,18.25861,1511
31422,238192,DA5E6B13E9B86E6A18C6646FBB376A74,31251,19,22,3,109.18528,18.2975,317
31426,238235,8DD23AA43C0F7967C45F7488D66F9159,31945,1,3,2,109.58021,18.29403,1817
31427,238236,8DD23AA43C0F7967C45F7488D66F9159,30854,5,17,12,109.56889,18.27076,1763
31428,238237,8DD23AA43C0F7967C45F7488D66F9159,31821,18,20,2,109.51181,18.24924,1559
31429,238238,8DD23AA43C0F7967C45F7488D66F9159,31071,22,23,1,109.58257,18.28458,1815
31430,238247,BD4652414D5C17466BA36FD4BD943A94,30721,0,3,3,109.51597,18.28257,1565
31431,238248,BD4652414D5C17466BA36FD4BD943A94,60221,3,4,1,109.52569,18.29188,1616
31432,238249,BD4652414D5C17466BA36FD4BD943A94,30721,5,6,1,109.51597,18.28257,1565
31433,238250,BD4652414D5C17466BA36FD4BD943A94,31931,9,17,8,109.54771,18.29403,1667
31434,238251,BD4652414D5C17466BA36FD4BD943A94,30281,21,23,2,109.50597,18.27583,1514
31435,238252,DF49F834C08C7E8FA6D78272EE1FB651,60361,0,6,6,109.51938,18.29681,1567
31436,238253,DF49F834C08C7E8FA6D78272EE1FB651,30951,7,12,5,109.56208,18.25667,1761
31437,238254,DF49F834C08C7E8FA6D78272EE1FB651,39371,13,14,1,109.56627,18.2646,1762
31438,238255,DF49F834C08C7E8FA6D78272EE1FB651,31551,15,17,2,109.55868,18.24222,1708
31439,238256,DF49F834C08C7E8FA6D78272EE1FB651,60361,19,23,4,109.51938,18.29681,1567
31440,238257,20A86C2AFD3DB5CCAEE5E583E8659561,60411,15,16,1,109.32514,18.30854,869
31441,238258,20A86C2AFD3DB5CCAEE5E583E8659561,31471,17,18,1,109.34583,18.29563,917
31445,238318,6D2D20F4D67580FE7309C23DCCA820C3,39371,12,15,3,109.56627,18.2646,1762
31446,238319,6D2D20F4D67580FE7309C23DCCA820C3,31071,18,23,5,109.58257,18.28458,1815
31454,238345,CCA3BC1D276A172225FD62BE51B3EFF1,30071,0,8,8,109.52819,18.30472,1619
31455,238346,CCA3BC1D276A172225FD62BE51B3EFF1,30854,10,22,12,109.56889,18.27076,1763
31459,238366,C85D0B931BEF54F05B9ABBBB03212DB7,31561,17,20,3,109.56792,18.28479,1765
31460,238367,C85D0B931BEF54F05B9ABBBB03212DB7,30854,20,22,2,109.56889,18.27076,1763
31464,238393,DCA1D430D03AF7D60DA281B113343E54,31181,12,16,4,109.50382,18.24813,1509
31465,238394,DCA1D430D03AF7D60DA281B113343E54,31181,20,23,3,109.50382,18.24813,1509
31466,238395,484EFAC2C861BC20EAA5F2A8AB0F5DBE,31851,0,9,9,109.71736,18.29007,2316
31467,238396,484EFAC2C861BC20EAA5F2A8AB0F5DBE,38023,13,15,2,109.37132,18.28993,1016
31468,238397,484EFAC2C861BC20EAA5F2A8AB0F5DBE,30361,19,21,2,109.50347,18.24,1508
31473,238478,25B4C854981734ED59D516788F928C4F,30651,0,1,1,109.42611,18.385,1232
31474,238479,25B4C854981734ED59D516788F928C4F,60524,1,4,3,109.42951,18.28993,1216
31475,238480,25B4C854981734ED59D516788F928C4F,60491,5,6,1,109.43354,18.30847,1269
31476,238481,25B4C854981734ED59D516788F928C4F,31101,12,17,5,109.65389,18.23403,2057
31477,238482,25B4C854981734ED59D516788F928C4F,60381,19,20,1,109.5241,18.22458,1605
31478,238487,2A6BA0678DDF16AF08BAC9E3FA3C9391,31561,0,1,1,109.56792,18.28479,1765
31479,238488,2A6BA0678DDF16AF08BAC9E3FA3C9391,30854,1,21,20,109.56889,18.27076,1763
31480,238500,928DF0385E8541CFD2F5858501C04155,60631,14,15,1,109.57778,18.27583,1814
31481,238501,928DF0385E8541CFD2F5858501C04155,30854,17,18,1,109.56889,18.27076,1763
31488,238538,75817DB682187A07461734D66E1E6492,60631,0,4,4,109.57778,18.27583,1814
31489,238539,75817DB682187A07461734D66E1E6492,30854,4,15,11,109.56889,18.27076,1763
31490,238540,75817DB682187A07461734D66E1E6492,31061,19,20,1,109.53333,18.23257,1607
31491,238541,75817DB682187A07461734D66E1E6492,60631,21,23,2,109.57778,18.27583,1814
31492,238557,E16204D131FCD957D5ADB9592C1DD0ED,31071,15,16,1,109.58257,18.28458,1815
31493,238558,E16204D131FCD957D5ADB9592C1DD0ED,30151,18,20,2,109.50986,18.25083,1560
31494,238559,E16204D131FCD957D5ADB9592C1DD0ED,30854,22,23,1,109.56889,18.27076,1763
31495,238562,005F3AEFE6DBF371ED1FD57736434098,31071,0,7,7,109.58257,18.28458,1815
31496,238563,005F3AEFE6DBF371ED1FD57736434098,30854,7,16,9,109.56889,18.27076,1763
31497,238571,A0044447FA8420B2798FCE6C61B6C8EC,60221,18,21,3,109.52569,18.29188,1616
31498,238572,A0044447FA8420B2798FCE6C61B6C8EC,30821,21,22,1,109.43681,18.33639,1274
31499,238582,0BC29A1A1F07D7BE709DDB240D6FBF8E,38261,0,8,8,109.50361,18.28153,1515
31500,238583,0BC29A1A1F07D7BE709DDB240D6FBF8E,38171,10,16,6,109.50799,18.28139,1515
31501,238584,0BC29A1A1F07D7BE709DDB240D6FBF8E,31521,17,18,1,109.51458,18.22542,1555
31502,238585,0BC29A1A1F07D7BE709DDB240D6FBF8E,30084,21,23,2,109.50118,18.26972,1513
31503,238598,21C679D1B9FF307EA1AC2A89744209FE,38291,0,19,19,109.51618,18.24313,1558
31504,238599,21C679D1B9FF307EA1AC2A89744209FE,60281,20,21,1,109.51743,18.25924,1561
31505,238628,BAB9B8A3D1E7FB96DB94A06687C464B3,60504,12,14,2,109.47917,18.28903,1416
31506,238629,BAB9B8A3D1E7FB96DB94A06687C464B3,60281,18,21,3,109.51743,18.25924,1561
31507,238630,BAB9B8A3D1E7FB96DB94A06687C464B3,60504,21,23,2,109.47917,18.28903,1416
31508,238633,4DA47CA7E0DF1887A4FCFA8DEF75F8FC,31761,0,7,7,109.60521,18.27965,1914
31509,238634,4DA47CA7E0DF1887A4FCFA8DEF75F8FC,31421,8,11,3,109.55382,18.22347,1705
31510,238635,4DA47CA7E0DF1887A4FCFA8DEF75F8FC,30951,12,15,3,109.56208,18.25667,1761
31511,238636,4DA47CA7E0DF1887A4FCFA8DEF75F8FC,31421,15,17,2,109.55382,18.22347,1705
31512,238637,4DA47CA7E0DF1887A4FCFA8DEF75F8FC,31761,19,23,4,109.60521,18.27965,1914
31516,238660,0E8806AF5B9D2CE792CB9EAFD9A3F05B,31471,13,15,2,109.34583,18.29563,917
31517,238661,0E8806AF5B9D2CE792CB9EAFD9A3F05B,31031,18,19,1,109.49979,18.25382,1510
31518,238662,0E8806AF5B9D2CE792CB9EAFD9A3F05B,60131,19,23,4,109.49819,18.24778,1509
31532,238713,A578E4F421C7FF132B9DFBF29E0D4AA7,31206,18,20,2,109.50819,18.23549,1507
31533,238714,A578E4F421C7FF132B9DFBF29E0D4AA7,30111,21,23,2,109.47583,18.30542,1419
31534,238732,9C59465A99C2310EA18900FDBD540F4D,60221,15,17,2,109.52569,18.29188,1616
31535,238733,9C59465A99C2310EA18900FDBD540F4D,30211,19,20,1,109.49882,18.23931,1508
31536,238742,7252A0F90E29EC78621699C082578EF7,31361,0,6,6,109.47417,18.28292,1415
31537,238743,7252A0F90E29EC78621699C082578EF7,60504,8,9,1,109.47917,18.28903,1416
31538,238744,7252A0F90E29EC78621699C082578EF7,31201,14,15,1,109.51042,18.23819,1558
31539,238745,7252A0F90E29EC78621699C082578EF7,38971,17,19,2,109.50743,18.25125,1510
31544,238764,DF5EBFA9D0614A60E8475DE83F0E910D,30151,0,8,8,109.50986,18.25083,1560
31545,238765,DF5EBFA9D0614A60E8475DE83F0E910D,30711,12,16,4,109.50271,18.25347,1510
31546,238766,DF5EBFA9D0614A60E8475DE83F0E910D,30421,16,18,2,109.50021,18.25861,1511
31547,238767,DF5EBFA9D0614A60E8475DE83F0E910D,30711,18,20,2,109.50271,18.25347,1510
31548,238768,DF5EBFA9D0614A60E8475DE83F0E910D,30151,21,23,2,109.50986,18.25083,1560
31549,238814,27BCEF3137923B84211F08830816C810,30851,0,8,8,109.5616,18.27396,1713
31553,238819,B8CB04B5978E578E24238F20101B548F,31521,0,7,7,109.51458,18.22542,1555
31554,238820,B8CB04B5978E578E24238F20101B548F,33051,11,13,2,109.6475,18.46618,2096
31555,238822,B8CB04B5978E578E24238F20101B548F,60221,19,21,2,109.52569,18.29188,1616
31559,238892,4995463B780282C9C030A19D9F49AEAC,31561,3,4,1,109.56792,18.28479,1765
31560,238893,4995463B780282C9C030A19D9F49AEAC,30854,8,19,11,109.56889,18.27076,1763
31561,238925,C46F5343DCC792762EF674294DA84608,31471,9,12,3,109.34583,18.29563,917
31562,238926,C46F5343DCC792762EF674294DA84608,30731,15,16,1,109.50944,18.22306,1555
31563,238927,C46F5343DCC792762EF674294DA84608,31521,17,18,1,109.51458,18.22542,1555
31564,238928,C46F5343DCC792762EF674294DA84608,60524,20,21,1,109.42951,18.28993,1216
31565,238929,C46F5343DCC792762EF674294DA84608,30731,22,23,1,109.50944,18.22306,1555
31566,238971,4CA9DD8009173FEDF1859DA7E6FBCAB5,38271,10,11,1,109.62632,18.23049,1956
31567,238972,4CA9DD8009173FEDF1859DA7E6FBCAB5,31101,12,16,4,109.65389,18.23403,2057
31568,238973,4CA9DD8009173FEDF1859DA7E6FBCAB5,60011,19,20,1,109.48965,18.30222,1468
31569,238990,5D50FA1646C1483F562F3711A49AB3EA,31021,2,4,2,109.49021,18.27,1463
31570,238991,5D50FA1646C1483F562F3711A49AB3EA,30201,4,6,2,109.4909,18.26465,1462
31571,238992,5D50FA1646C1483F562F3711A49AB3EA,31021,7,10,3,109.49021,18.27,1463
31572,238993,5D50FA1646C1483F562F3711A49AB3EA,31471,13,14,1,109.34583,18.29563,917
31573,238994,5D50FA1646C1483F562F3711A49AB3EA,31021,16,22,6,109.49021,18.27,1463
31574,239013,6FBDDF7419820F8908B8A8CE3C81E7C3,60621,16,17,1,109.48354,18.27451,1464
31575,239014,6FBDDF7419820F8908B8A8CE3C81E7C3,60401,19,22,3,109.47444,18.27583,1414
31576,239018,8C8DB7A18864109B823771C405E00B29,60351,0,6,6,109.58403,18.28958,1816
31577,239019,8C8DB7A18864109B823771C405E00B29,30851,11,12,1,109.5616,18.27396,1713
31578,239020,8C8DB7A18864109B823771C405E00B29,30951,13,14,1,109.56208,18.25667,1761
31579,239021,8C8DB7A18864109B823771C405E00B29,31421,17,23,6,109.55382,18.22347,1705
31580,239033,B340EDEF4A878E8DF5CBEC25E465EACE,30191,0,1,1,109.50361,18.22701,1506
31581,239034,B340EDEF4A878E8DF5CBEC25E465EACE,30854,2,10,8,109.56889,18.27076,1763
31582,239035,B340EDEF4A878E8DF5CBEC25E465EACE,31071,12,14,2,109.58257,18.28458,1815
31583,239036,B340EDEF4A878E8DF5CBEC25E465EACE,30854,15,17,2,109.56889,18.27076,1763
31584,239037,B340EDEF4A878E8DF5CBEC25E465EACE,31551,20,21,1,109.55868,18.24222,1708
31585,239083,BD5AAE5CF6AC8F1E6005714E36EC9220,30161,0,9,9,109.50042,18.24389,1508
31586,239084,BD5AAE5CF6AC8F1E6005714E36EC9220,60131,11,20,9,109.49819,18.24778,1509
31590,239102,662D882A6A10D0E6C3566690F0A40636,31071,1,8,7,109.58257,18.28458,1815
31591,239103,662D882A6A10D0E6C3566690F0A40636,30854,8,9,1,109.56889,18.27076,1763
31592,239104,662D882A6A10D0E6C3566690F0A40636,31071,11,20,9,109.58257,18.28458,1815
31593,239105,662D882A6A10D0E6C3566690F0A40636,30191,21,23,2,109.50361,18.22701,1506
31597,239148,292F7AA5A13D44513985CC059AB0B0E9,60641,19,21,2,109.53854,18.2359,1657
31598,239149,292F7AA5A13D44513985CC059AB0B0E9,60354,21,22,1,109.58701,18.28521,1815
31599,239185,D1EBD1A5A8A922DEF994C933F10DD8DB,30161,0,5,5,109.50042,18.24389,1508
31600,239186,D1EBD1A5A8A922DEF994C933F10DD8DB,39151,7,8,1,109.49875,18.25097,1510
31601,239187,D1EBD1A5A8A922DEF994C933F10DD8DB,60381,11,15,4,109.5241,18.22458,1605
31602,239188,D1EBD1A5A8A922DEF994C933F10DD8DB,30721,17,19,2,109.51597,18.28257,1565
31603,239189,D1EBD1A5A8A922DEF994C933F10DD8DB,60131,21,23,2,109.49819,18.24778,1509
31604,239202,F71405344B971967BDA24B8D31704EA3,30854,1,5,4,109.56889,18.27076,1763
31605,239203,F71405344B971967BDA24B8D31704EA3,39331,9,16,7,109.62125,18.22708,1956
31606,239204,F71405344B971967BDA24B8D31704EA3,30854,18,20,2,109.56889,18.27076,1763
31607,239205,F71405344B971967BDA24B8D31704EA3,31071,22,23,1,109.58257,18.28458,1815
31608,239221,0E0D6E55BB1995EBF85F6B7AA8765E55,30854,0,10,10,109.56889,18.27076,1763
31609,239222,0E0D6E55BB1995EBF85F6B7AA8765E55,38271,15,22,7,109.62632,18.23049,1956
31610,239237,2D39AE6120F2674000C6DBB8A6E572A0,31945,1,7,6,109.58021,18.29403,1817
31611,239238,2D39AE6120F2674000C6DBB8A6E572A0,30854,7,12,5,109.56889,18.27076,1763
31612,239239,2D39AE6120F2674000C6DBB8A6E572A0,31945,12,13,1,109.58021,18.29403,1817
31613,239240,2D39AE6120F2674000C6DBB8A6E572A0,31071,14,15,1,109.58257,18.28458,1815
31614,239241,2D39AE6120F2674000C6DBB8A6E572A0,30854,16,17,1,109.56889,18.27076,1763
31615,239242,2D39AE6120F2674000C6DBB8A6E572A0,31071,21,22,1,109.58257,18.28458,1815
31619,239266,8E26BB9FD64561D71CF8747E8BA22405,60441,15,17,2,109.46792,18.28604,1366
31620,239267,8E26BB9FD64561D71CF8747E8BA22405,30354,18,20,2,109.42813,18.29076,1216
31621,239268,8E26BB9FD64561D71CF8747E8BA22405,31231,21,23,2,109.42597,18.29292,1217
31626,239296,CAD1873E143F5B0D99D502636D066F27,33051,13,14,1,109.6475,18.46618,2096
31627,239297,CAD1873E143F5B0D99D502636D066F27,60401,18,23,5,109.47444,18.27583,1414
31628,239301,F5FE23BF42FC224C310CD42E08B0B950,31431,0,7,7,109.44639,18.29042,1316
31629,239302,F5FE23BF42FC224C310CD42E08B0B950,30764,7,11,4,109.45806,18.29486,1367
31630,239303,F5FE23BF42FC224C310CD42E08B0B950,38094,12,14,2,109.45403,18.28778,1316
31631,239304,F5FE23BF42FC224C310CD42E08B0B950,60441,14,16,2,109.46792,18.28604,1366
31632,239305,F5FE23BF42FC224C310CD42E08B0B950,31431,18,22,4,109.44639,18.29042,1316
31633,239369,FFFC0994E5C15BDB165344716912442C,31554,0,1,1,109.55521,18.2459,1709
31634,239370,FFFC0994E5C15BDB165344716912442C,30854,2,6,4,109.56889,18.27076,1763
31635,239371,FFFC0994E5C15BDB165344716912442C,31554,6,17,11,109.55521,18.2459,1709
31636,239372,FFFC0994E5C15BDB165344716912442C,31551,19,20,1,109.55868,18.24222,1708
31637,239373,FFFC0994E5C15BDB165344716912442C,30854,21,23,2,109.56889,18.27076,1763
31638,239374,1236E803BFC9C4343D57A1C8A6EC03E5,30441,18,20,2,109.64021,18.25424,2010
31639,239375,1236E803BFC9C4343D57A1C8A6EC03E5,38271,20,23,3,109.62632,18.23049,1956
31649,239474,C3EF49B0098C6C3C4B26CC8869DE86AF,30854,0,6,6,109.56889,18.27076,1763
31650,239475,C3EF49B0098C6C3C4B26CC8869DE86AF,38271,8,15,7,109.62632,18.23049,1956
31651,239476,C3EF49B0098C6C3C4B26CC8869DE86AF,30854,19,23,4,109.56889,18.27076,1763
31652,239509,9FC721E86703223349C05C95FE4BBB6F,60081,0,10,10,109.51097,18.22639,1556
31653,239510,9FC721E86703223349C05C95FE4BBB6F,31521,11,13,2,109.51458,18.22542,1555
31654,239511,9FC721E86703223349C05C95FE4BBB6F,60381,13,16,3,109.5241,18.22458,1605
31655,239512,9FC721E86703223349C05C95FE4BBB6F,31521,19,20,1,109.51458,18.22542,1555
31656,239513,9FC721E86703223349C05C95FE4BBB6F,60087,21,23,2,109.50688,18.22299,1505
31661,239564,A68637AA89BD62624E677D9E66C32FAD,30161,16,18,2,109.50042,18.24389,1508
31662,239565,A68637AA89BD62624E677D9E66C32FAD,30161,18,20,2,109.50042,18.24389,1508
31663,239566,A68637AA89BD62624E677D9E66C32FAD,30361,20,23,3,109.50347,18.24,1508
31664,239579,E8D51F8B53F290BFD73338AD2AD8C728,30851,6,11,5,109.5616,18.27396,1713
31665,239580,E8D51F8B53F290BFD73338AD2AD8C728,31561,14,22,8,109.56792,18.28479,1765
31666,239594,B5EEA30F2FFAABF51AE99311CDE9203E,39111,13,16,3,109.5191,18.22597,1555
31667,239595,B5EEA30F2FFAABF51AE99311CDE9203E,31851,20,23,3,109.71736,18.29007,2316
31668,239596,D77A5C2E97A74D805A87772560CE2BFF,60381,0,1,1,109.5241,18.22458,1605
31669,239597,D77A5C2E97A74D805A87772560CE2BFF,60661,4,14,10,109.548,18.2377,1657
31670,239598,D77A5C2E97A74D805A87772560CE2BFF,60381,14,15,1,109.5241,18.22458,1605
31671,239599,D77A5C2E97A74D805A87772560CE2BFF,31421,15,19,4,109.55382,18.22347,1705
31672,239600,D77A5C2E97A74D805A87772560CE2BFF,60381,21,23,2,109.5241,18.22458,1605
31673,239652,B17D654C0C5F0BF2FDFE2DB8B9C0B83F,60201,1,12,11,109.5041,18.2509,1510
31674,239653,B17D654C0C5F0BF2FDFE2DB8B9C0B83F,31551,14,23,9,109.55868,18.24222,1708
31675,239656,0CB59E8D868A989F35AA087C24245C30,31145,12,14,2,109.20431,18.30479,369
31676,239657,0CB59E8D868A989F35AA087C24245C30,31531,16,22,6,109.49583,18.25972,1461
31677,239685,F592C1A402E42DAA2D50FA0B88EFA69E,31781,12,13,1,109.19847,18.2975,367
31678,239686,F592C1A402E42DAA2D50FA0B88EFA69E,31471,15,16,1,109.34583,18.29563,917
31679,239687,F592C1A402E42DAA2D50FA0B88EFA69E,31473,16,17,1,109.34792,18.29465,917
31680,239688,F592C1A402E42DAA2D50FA0B88EFA69E,60621,20,23,3,109.48354,18.27451,1464
31681,239695,41BFDF202AA15C7D0EC7487840A4D094,30854,4,16,12,109.56889,18.27076,1763
31682,239696,41BFDF202AA15C7D0EC7487840A4D094,30851,19,23,4,109.5616,18.27396,1713
31683,239708,C4438C562FDBCEB6780A30DCF3B1E6F9,38361,0,7,7,109.43667,18.29201,1267
31684,239709,C4438C562FDBCEB6780A30DCF3B1E6F9,31781,10,12,2,109.19847,18.2975,367
31685,239710,C4438C562FDBCEB6780A30DCF3B1E6F9,38754,14,15,1,109.74667,18.37382,2430
31686,239711,C4438C562FDBCEB6780A30DCF3B1E6F9,31701,19,21,2,109.44132,18.28833,1266
31687,239712,C4438C562FDBCEB6780A30DCF3B1E6F9,30671,21,23,2,109.43611,18.30139,1268
31688,239770,0D3DA8126B134D203BB35373EAFFB116,31071,1,7,6,109.58257,18.28458,1815
31689,239771,0D3DA8126B134D203BB35373EAFFB116,30854,7,19,12,109.56889,18.27076,1763
31694,239784,00145806BBF2F60A963743509F901155,30251,13,14,1,109.50611,18.26653,1512
31695,239785,00145806BBF2F60A963743509F901155,38127,14,17,3,109.50833,18.27222,1513
31696,239786,00145806BBF2F60A963743509F901155,30291,20,23,3,109.50403,18.27028,1513
31697,239860,A4AA22255ADB44C4AEE3D0925A88CC85,33481,11,12,1,109.67278,18.41278,2187
31698,239861,A4AA22255ADB44C4AEE3D0925A88CC85,60631,16,19,3,109.57778,18.27583,1814
31699,239862,A4AA22255ADB44C4AEE3D0925A88CC85,39371,21,23,2,109.56627,18.2646,1762
31700,239863,1F299DFBDC4CE2BBEA4B3C7942B5689A,30111,0,5,5,109.47583,18.30542,1419
31701,239864,1F299DFBDC4CE2BBEA4B3C7942B5689A,30761,6,7,1,109.45201,18.3,1318
31708,239921,A0A64B9DC3ED1CC036ADF6A1DF77C5F0,60111,7,9,2,109.72556,18.31924,2371
31709,239941,57F32DEB2DABC348C903B63D4D932E2A,33481,14,15,1,109.67278,18.41278,2187
31710,239942,57F32DEB2DABC348C903B63D4D932E2A,31521,19,21,2,109.51458,18.22542,1555
31711,239943,8E06EAC16B0EF776FA1BAAC5B9747325,30511,0,5,5,109.51069,18.24208,1558
31712,239944,8E06EAC16B0EF776FA1BAAC5B9747325,60114,7,15,8,109.73028,18.33847,2374
31713,239952,201045A9C980BD8E53B16B9129DFE596,31071,0,6,6,109.58257,18.28458,1815
31714,239953,201045A9C980BD8E53B16B9129DFE596,30854,10,12,2,109.56889,18.27076,1763
31715,239954,201045A9C980BD8E53B16B9129DFE596,31071,12,16,4,109.58257,18.28458,1815
31716,239955,201045A9C980BD8E53B16B9129DFE596,30854,18,19,1,109.56889,18.27076,1763
31717,239956,201045A9C980BD8E53B16B9129DFE596,31071,19,21,2,109.58257,18.28458,1815
31718,239963,7235BA08EE35A76A07D4EF6E9B8C7C54,38251,15,18,3,109.49618,18.25493,1510
31719,239964,7235BA08EE35A76A07D4EF6E9B8C7C54,60131,20,22,2,109.49819,18.24778,1509
31720,239965,7235BA08EE35A76A07D4EF6E9B8C7C54,38251,22,23,1,109.49618,18.25493,1510
31724,239980,A01700F052FB9835E044C88292490989,60631,0,8,8,109.57778,18.27583,1814
31725,239981,A01700F052FB9835E044C88292490989,30854,10,15,5,109.56889,18.27076,1763
31730,239995,015CDEB9169BCE5537ABAE49B6A63F2B,31071,0,7,7,109.58257,18.28458,1815
31731,239996,015CDEB9169BCE5537ABAE49B6A63F2B,30854,8,15,7,109.56889,18.27076,1763
31732,240003,DC9A97A54E5D5ED65CCD9F39FA1D137B,31521,0,8,8,109.51458,18.22542,1555
31733,240004,DC9A97A54E5D5ED65CCD9F39FA1D137B,31781,11,12,1,109.19847,18.2975,367
31734,240010,EC721F8259E3B17F432086B3F60AECE1,31554,0,5,5,109.55521,18.2459,1709
31735,240011,EC721F8259E3B17F432086B3F60AECE1,30051,6,17,11,109.48917,18.21215,1453
31736,240012,EC721F8259E3B17F432086B3F60AECE1,31554,19,22,3,109.55521,18.2459,1709
31737,240013,41815364176C8443FB68908501751D76,39091,0,10,10,109.50097,18.25222,1510
31741,240023,1C18ED6F5D8A7E272B4C124E5AF1F041,38871,2,3,1,109.44681,18.28625,1316
31742,240024,1C18ED6F5D8A7E272B4C124E5AF1F041,38251,4,6,2,109.49618,18.25493,1510
31743,240025,1C18ED6F5D8A7E272B4C124E5AF1F041,31781,9,11,2,109.19847,18.2975,367
31744,240026,1C18ED6F5D8A7E272B4C124E5AF1F041,31471,14,16,2,109.34583,18.29563,917
31745,240027,1C18ED6F5D8A7E272B4C124E5AF1F041,38251,18,21,3,109.49618,18.25493,1510
31746,240043,9905C3E423D151CCE1280F3A1732CE90,30854,0,6,6,109.56889,18.27076,1763
31747,240044,9905C3E423D151CCE1280F3A1732CE90,30851,7,13,6,109.5616,18.27396,1713
31748,240045,9905C3E423D151CCE1280F3A1732CE90,31071,14,15,1,109.58257,18.28458,1815
31749,240046,9905C3E423D151CCE1280F3A1732CE90,30851,17,18,1,109.5616,18.27396,1713
31750,240047,9905C3E423D151CCE1280F3A1732CE90,30854,19,23,4,109.56889,18.27076,1763
31751,240075,D6A345956751BA2ACC5430EDF68A104F,31931,13,14,1,109.54771,18.29403,1667
31752,240076,D6A345956751BA2ACC5430EDF68A104F,39181,17,19,2,109.55153,18.28035,1715
31753,240077,D6A345956751BA2ACC5430EDF68A104F,39181,21,23,2,109.55153,18.28035,1715
31754,240137,4DE3E9C2C0E7F48C3178063DD53BC336,39091,0,8,8,109.50097,18.25222,1510
31755,240138,4DE3E9C2C0E7F48C3178063DD53BC336,31941,13,17,4,109.62451,18.31222,1970
31756,240155,8C0E6B51FAFE21C31FB9AE08C36DF0A2,30921,0,17,17,109.53903,18.29451,1667
31757,240156,8C0E6B51FAFE21C31FB9AE08C36DF0A2,31931,19,22,3,109.54771,18.29403,1667
31758,240165,934029FB5F97BCE114EDCE88F0393A63,30854,13,18,5,109.56889,18.27076,1763
31759,240166,934029FB5F97BCE114EDCE88F0393A63,39371,22,23,1,109.56627,18.2646,1762
31760,240178,96F98526707B06BE1263CCD4F72E07A1,30854,14,17,3,109.56889,18.27076,1763
31761,240179,96F98526707B06BE1263CCD4F72E07A1,31071,22,23,1,109.58257,18.28458,1815
31766,240191,E082FB5BD091C5B334EC1176FF352EE0,60131,15,16,1,109.49819,18.24778,1509
31767,240192,E082FB5BD091C5B334EC1176FF352EE0,30071,19,21,2,109.52819,18.30472,1619
31772,240216,AA17C9279A63248D7DCDF49F93EB8817,30854,3,5,2,109.56889,18.27076,1763
31773,240217,AA17C9279A63248D7DCDF49F93EB8817,38275,9,18,9,109.62875,18.22938,2006
31774,240218,AA17C9279A63248D7DCDF49F93EB8817,60371,19,21,2,109.53063,18.30056,1618
31775,240219,AA17C9279A63248D7DCDF49F93EB8817,30854,21,23,2,109.56889,18.27076,1763
31776,240247,7050D1E0A5553A00BB03B768ACFBCA8F,31461,19,20,1,109.5091,18.25389,1510
31777,240274,4B0C0C6341A3C2E5744F0897553B14A8,31345,0,9,9,109.39,18.29,1066
31778,240275,4B0C0C6341A3C2E5744F0897553B14A8,31145,10,12,2,109.20431,18.30479,369
31779,240276,4B0C0C6341A3C2E5744F0897553B14A8,38754,14,17,3,109.74667,18.37382,2430
31780,240277,4B0C0C6341A3C2E5744F0897553B14A8,31345,22,23,1,109.39,18.29,1066
31788,240367,9C1407835BC54BEBDB541F52E1DA1820,61011,13,20,7,109.60653,18.19076,1900
31789,240403,FBCD6DE6EFAEE2EEF57FF44D1B832782,31081,0,6,6,109.44639,18.30181,1318
31790,240404,FBCD6DE6EFAEE2EEF57FF44D1B832782,60631,9,10,1,109.57778,18.27583,1814
31791,240465,D9689370CD6256E9753C2B0B13067E2B,30854,17,18,1,109.56889,18.27076,1763
31792,240466,D9689370CD6256E9753C2B0B13067E2B,31071,21,23,2,109.58257,18.28458,1815
31801,240520,8799356B7181F28146A203E5F86C52F0,31351,0,7,7,109.4959,18.28417,1465
31802,240521,8799356B7181F28146A203E5F86C52F0,60231,8,12,4,109.49903,18.21972,1504
31806,240541,C9C1294C451697C4C43F0735BF6751F8,60381,0,8,8,109.5241,18.22458,1605
31807,240542,C9C1294C451697C4C43F0735BF6751F8,60311,9,10,1,109.52097,18.24319,1558
31808,240543,C9C1294C451697C4C43F0735BF6751F8,38754,12,13,1,109.74667,18.37382,2430
31809,240544,C9C1294C451697C4C43F0735BF6751F8,60381,15,18,3,109.5241,18.22458,1605
31810,240545,C9C1294C451697C4C43F0735BF6751F8,60381,20,23,3,109.5241,18.22458,1605
31814,240569,A2DBFF4E352E7B7C1EE25431C02FC741,31931,0,15,15,109.54771,18.29403,1667
31815,240570,A2DBFF4E352E7B7C1EE25431C02FC741,38127,19,21,2,109.50833,18.27222,1513
31816,240575,0BABF9C6516F437130A3DD3C99553A57,31206,0,2,2,109.50819,18.23549,1507
31817,240576,0BABF9C6516F437130A3DD3C99553A57,39191,3,7,4,109.51493,18.23472,1557
31818,240577,0BABF9C6516F437130A3DD3C99553A57,30421,9,11,2,109.50021,18.25861,1511
31819,240578,0BABF9C6516F437130A3DD3C99553A57,31205,11,12,1,109.51111,18.23736,1557
31820,240579,0BABF9C6516F437130A3DD3C99553A57,38157,16,17,1,109.51483,18.26958,1563
31821,240580,0BABF9C6516F437130A3DD3C99553A57,31206,19,23,4,109.50819,18.23549,1507
31822,240627,49970562AFC9FC24214EC6AA61F5B801,60131,0,7,7,109.49819,18.24778,1509
31823,240628,49970562AFC9FC24214EC6AA61F5B801,60381,9,13,4,109.5241,18.22458,1605
31824,240629,49970562AFC9FC24214EC6AA61F5B801,60131,16,18,2,109.49819,18.24778,1509
31825,240630,49970562AFC9FC24214EC6AA61F5B801,38251,20,21,1,109.49618,18.25493,1510
31826,240631,49970562AFC9FC24214EC6AA61F5B801,60131,21,23,2,109.49819,18.24778,1509
31827,240676,1A64C98E678C33D33EBB9AF4943063A2,31071,0,12,12,109.58257,18.28458,1815
31828,240677,1A64C98E678C33D33EBB9AF4943063A2,30854,12,13,1,109.56889,18.27076,1763
31829,240678,1A64C98E678C33D33EBB9AF4943063A2,31071,15,16,1,109.58257,18.28458,1815
31830,240679,1A64C98E678C33D33EBB9AF4943063A2,30201,19,21,2,109.4909,18.26465,1462
31831,240683,94F0184D0BA3E27BCB47A57DA614F9FC,30661,0,8,8,109.37028,18.24361,1008
31832,240684,94F0184D0BA3E27BCB47A57DA614F9FC,60411,8,19,11,109.32514,18.30854,869
31833,240685,94F0184D0BA3E27BCB47A57DA614F9FC,30661,19,22,3,109.37028,18.24361,1008
31834,240686,94F0184D0BA3E27BCB47A57DA614F9FC,60411,22,23,1,109.32514,18.30854,869
31838,240743,BAE056E8B3936B2115FBE7D3C75BEB1E,31031,16,17,1,109.49979,18.25382,1510
31839,240744,BAE056E8B3936B2115FBE7D3C75BEB1E,60551,18,22,4,109.42722,18.30111,1218
31840,240746,208924560927AE5872A8D9BB3F5EF3B6,38171,12,13,1,109.50799,18.28139,1515
31841,240747,208924560927AE5872A8D9BB3F5EF3B6,38261,14,17,3,109.50361,18.28153,1515
31842,240748,208924560927AE5872A8D9BB3F5EF3B6,38171,19,20,1,109.50799,18.28139,1515
31843,240749,208924560927AE5872A8D9BB3F5EF3B6,38171,22,23,1,109.50799,18.28139,1515
31844,240768,1AE87A1A31A67C66BE8B0545FB82EAD0,31561,20,22,2,109.56792,18.28479,1765
31845,240769,1AE87A1A31A67C66BE8B0545FB82EAD0,30851,22,23,1,109.5616,18.27396,1713
31846,240770,1122041491C04B199A15F6E1E401D68F,30461,1,7,6,109.5116,18.26313,1562
31847,240771,1122041491C04B199A15F6E1E401D68F,60281,10,14,4,109.51743,18.25924,1561
31848,240772,1122041491C04B199A15F6E1E401D68F,31821,15,17,2,109.51181,18.24924,1559
31849,240773,1122041491C04B199A15F6E1E401D68F,60281,17,18,1,109.51743,18.25924,1561
31850,240774,1122041491C04B199A15F6E1E401D68F,30461,18,19,1,109.5116,18.26313,1562
31851,240798,821F9E394C1481084AC8949BB7C843D9,30201,0,9,9,109.4909,18.26465,1462
31852,240799,821F9E394C1481084AC8949BB7C843D9,30361,11,12,1,109.50347,18.24,1508
31853,240800,821F9E394C1481084AC8949BB7C843D9,60381,15,17,2,109.5241,18.22458,1605
31854,240801,821F9E394C1481084AC8949BB7C843D9,30161,18,19,1,109.50042,18.24389,1508
31855,240802,821F9E394C1481084AC8949BB7C843D9,30201,20,23,3,109.4909,18.26465,1462
31856,240827,17AA4FA64FF251DAD8C0604E6DEFD71D,30891,0,11,11,109.59431,18.28389,1865
31857,240828,17AA4FA64FF251DAD8C0604E6DEFD71D,30201,13,15,2,109.4909,18.26465,1462
31858,240871,C823928BF46762FC84E04CF2DE7DD0A2,30181,18,19,1,109.51597,18.23313,1557
31859,240872,C823928BF46762FC84E04CF2DE7DD0A2,31061,21,23,2,109.53333,18.23257,1607
31860,240892,012ABD06F231728C214A4BA917E75B1C,31561,0,3,3,109.56792,18.28479,1765
31861,240893,012ABD06F231728C214A4BA917E75B1C,30851,5,11,6,109.5616,18.27396,1713
31862,240894,012ABD06F231728C214A4BA917E75B1C,31561,12,14,2,109.56792,18.28479,1765
31863,240895,012ABD06F231728C214A4BA917E75B1C,30851,14,21,7,109.5616,18.27396,1713
31864,240896,012ABD06F231728C214A4BA917E75B1C,31561,22,23,1,109.56792,18.28479,1765
31865,240903,825AF4749EA05C462EA3CA6A1D524BEA,31101,17,18,1,109.65389,18.23403,2057
31866,240904,825AF4749EA05C462EA3CA6A1D524BEA,30421,19,21,2,109.50021,18.25861,1511
31867,240905,51061B3DE820AF1C1C713EF684728003,30854,1,16,15,109.56889,18.27076,1763
31868,240906,51061B3DE820AF1C1C713EF684728003,31071,20,23,3,109.58257,18.28458,1815
31873,240948,73FC49A89676FB4107071248ADBDF948,39183,12,14,2,109.55542,18.28208,1715
31874,240949,73FC49A89676FB4107071248ADBDF948,31561,19,23,4,109.56792,18.28479,1765
31875,240955,3042523F837593809C64E77150AECD92,30721,0,7,7,109.51597,18.28257,1565
31876,240956,3042523F837593809C64E77150AECD92,30771,8,9,1,109.49938,18.26042,1511
31877,240957,3042523F837593809C64E77150AECD92,30771,10,14,4,109.49938,18.26042,1511
31878,240958,3042523F837593809C64E77150AECD92,30531,15,17,2,109.53271,18.21472,1604
31879,240959,3042523F837593809C64E77150AECD92,38154,18,20,2,109.5266,18.28278,1615
31883,240971,2133BBAAAA8DED2520884D436D70440D,30391,18,20,2,109.4975,18.27118,1513
31884,240972,2133BBAAAA8DED2520884D436D70440D,30741,20,23,3,109.49833,18.28681,1516
31888,241018,F22E2350B3BBD3E296D591A1B269AAD3,38754,10,13,3,109.74667,18.37382,2430
31889,241139,9DB1F2EC09C49DCC6FAB72F1F7C09C78,39053,2,10,8,109.511,18.2771,1564
31890,241140,9DB1F2EC09C49DCC6FAB72F1F7C09C78,60381,12,14,2,109.5241,18.22458,1605
31891,241141,9DB1F2EC09C49DCC6FAB72F1F7C09C78,60371,18,20,2,109.53063,18.30056,1618
31892,241142,9DB1F2EC09C49DCC6FAB72F1F7C09C78,60381,21,22,1,109.5241,18.22458,1605
31893,241169,189633BA4D39EBA8A203BC9E364D4B1F,30051,11,14,3,109.48917,18.21215,1453
31894,241170,189633BA4D39EBA8A203BC9E364D4B1F,60231,14,17,3,109.49903,18.21972,1504
31895,241171,189633BA4D39EBA8A203BC9E364D4B1F,31261,21,23,2,109.51174,18.2466,1559
31896,241178,C983E73D646629A775690ECA8920EB29,31631,0,5,5,109.59542,18.36826,1879
31897,241179,C983E73D646629A775690ECA8920EB29,30101,7,9,2,109.57299,18.33333,1773
31898,241180,C983E73D646629A775690ECA8920EB29,31631,9,11,2,109.59542,18.36826,1879
31899,241181,C983E73D646629A775690ECA8920EB29,30101,11,13,2,109.57299,18.33333,1773
31900,241182,C983E73D646629A775690ECA8920EB29,31631,15,20,5,109.59542,18.36826,1879
31901,241245,23073B802C909D3D46ECEB73A8309E22,38291,19,20,1,109.51618,18.24313,1558
31902,241246,23073B802C909D3D46ECEB73A8309E22,30854,22,23,1,109.56889,18.27076,1763
31906,241291,6422CB87ACC55DDEF6EBE8946593C808,31351,0,7,7,109.4959,18.28417,1465
31907,241292,6422CB87ACC55DDEF6EBE8946593C808,30051,9,10,1,109.48917,18.21215,1453
31908,241293,6422CB87ACC55DDEF6EBE8946593C808,60231,11,17,6,109.49903,18.21972,1504
31909,241294,6422CB87ACC55DDEF6EBE8946593C808,60235,18,21,3,109.49269,18.2253,1455
31910,241295,6422CB87ACC55DDEF6EBE8946593C808,31351,21,22,1,109.4959,18.28417,1465
31914,241346,1BAA4EB92824E45EC2E36C90288F6A84,31031,0,1,1,109.49979,18.25382,1510
31915,241347,1BAA4EB92824E45EC2E36C90288F6A84,60401,2,9,7,109.47444,18.27583,1414
31916,241348,1BAA4EB92824E45EC2E36C90288F6A84,31031,9,11,2,109.49979,18.25382,1510
31917,241349,1BAA4EB92824E45EC2E36C90288F6A84,30711,17,20,3,109.50271,18.25347,1510
31918,241350,1BAA4EB92824E45EC2E36C90288F6A84,31031,21,23,2,109.49979,18.25382,1510
31919,241362,9AA959ED87D1ECC3053DED17290EFCBD,30854,14,15,1,109.56889,18.27076,1763
31920,241363,9AA959ED87D1ECC3053DED17290EFCBD,31561,15,19,4,109.56792,18.28479,1765
31921,241384,EBF551BDD30B7EEB2F877A91C244C4A5,30681,14,15,1,109.48493,18.26917,1463
31922,241385,EBF551BDD30B7EEB2F877A91C244C4A5,30161,19,21,2,109.50042,18.24389,1508
31923,241410,D96E01B8E0F0DE9C160C9FEAFDCFDB6D,31071,0,7,7,109.58257,18.28458,1815
31924,241411,D96E01B8E0F0DE9C160C9FEAFDCFDB6D,30854,9,22,13,109.56889,18.27076,1763
31933,241472,826EBD07021610B18F3D38A2C6C13D56,30771,19,21,2,109.49938,18.26042,1511
31934,241473,826EBD07021610B18F3D38A2C6C13D56,31271,22,23,1,109.48958,18.26257,1462
31942,241572,03E3094FE0344513E64DAE470C33E920,39181,0,7,7,109.55153,18.28035,1715
31943,241573,03E3094FE0344513E64DAE470C33E920,31931,7,8,1,109.54771,18.29403,1667
31944,241574,03E3094FE0344513E64DAE470C33E920,39181,13,14,1,109.55153,18.28035,1715
31945,241575,03E3094FE0344513E64DAE470C33E920,31931,14,16,2,109.54771,18.29403,1667
31946,241576,03E3094FE0344513E64DAE470C33E920,39181,19,23,4,109.55153,18.28035,1715
31947,241608,C8922FAF66F21ECAECB6B717FCD5A53B,60614,0,14,14,109.48799,18.29521,1467
31948,241609,C8922FAF66F21ECAECB6B717FCD5A53B,60391,18,20,2,109.47667,18.28757,1416
31949,241630,7D1ED6067ECBD941EFC43CE0A6ADAE71,31071,15,16,1,109.58257,18.28458,1815
31950,241631,7D1ED6067ECBD941EFC43CE0A6ADAE71,30854,17,23,6,109.56889,18.27076,1763
31951,241651,85BD5DFF2A9B6AA28BAAC8993DD4D426,31531,0,9,9,109.49583,18.25972,1461
31952,241652,85BD5DFF2A9B6AA28BAAC8993DD4D426,60054,13,15,2,109.3016,18.31229,770
31953,241653,85BD5DFF2A9B6AA28BAAC8993DD4D426,31531,16,23,7,109.49583,18.25972,1461
31957,241675,5605B5FEA58FE66425ABEFD16E75AB1F,60614,0,10,10,109.48799,18.29521,1467
31961,241682,D709A996A64F98F0D634C81CB0E94EF4,38951,0,8,8,109.48097,18.28868,1416
31962,241683,D709A996A64F98F0D634C81CB0E94EF4,31471,13,14,1,109.34583,18.29563,917
31963,241684,D709A996A64F98F0D634C81CB0E94EF4,30821,15,18,3,109.43681,18.33639,1274
31964,241685,D709A996A64F98F0D634C81CB0E94EF4,31431,19,20,1,109.44639,18.29042,1316
31965,241686,D709A996A64F98F0D634C81CB0E94EF4,38951,20,23,3,109.48097,18.28868,1416
31973,241734,1419F2503130508E06D5FA0D4A5CF329,31461,11,13,2,109.5091,18.25389,1510
31974,241735,1419F2503130508E06D5FA0D4A5CF329,31031,14,18,4,109.49979,18.25382,1510
31975,241736,1419F2503130508E06D5FA0D4A5CF329,38891,19,20,1,109.51486,18.24118,1558
31976,241737,1419F2503130508E06D5FA0D4A5CF329,31031,21,22,1,109.49979,18.25382,1510
31980,241809,B1715BAACD2551A031737B51F74CE832,30371,0,9,9,109.51,18.24771,1559
31981,241810,B1715BAACD2551A031737B51F74CE832,30711,9,11,2,109.50271,18.25347,1510
31982,241811,B1715BAACD2551A031737B51F74CE832,30421,12,15,3,109.50021,18.25861,1511
31983,241812,B1715BAACD2551A031737B51F74CE832,30711,19,21,2,109.50271,18.25347,1510
31984,241813,B1715BAACD2551A031737B51F74CE832,30371,21,23,2,109.51,18.24771,1559
31992,241865,176C6455055846C83CDA64CD9B071B7A,38134,2,3,1,109.63931,18.23451,2007
31993,241866,176C6455055846C83CDA64CD9B071B7A,31571,4,5,1,109.61563,18.23326,1957
31994,241867,176C6455055846C83CDA64CD9B071B7A,30581,6,8,2,109.62257,18.24951,1959
31995,241868,176C6455055846C83CDA64CD9B071B7A,31071,11,13,2,109.58257,18.28458,1815
31999,241907,D46DE9169E4BACF1D272EA5E0FDEF68F,39183,0,15,15,109.55542,18.28208,1715
32000,241908,D46DE9169E4BACF1D272EA5E0FDEF68F,31561,18,23,5,109.56792,18.28479,1765
32001,241938,2AE38FAF341950B0B91404FFCE5A0F3E,30921,6,15,9,109.53903,18.29451,1667
32002,241939,2AE38FAF341950B0B91404FFCE5A0F3E,31931,19,20,1,109.54771,18.29403,1667
32010,242023,1E36640BE395A4EE8CCB2697222419A5,60631,0,2,2,109.57778,18.27583,1814
32011,242024,1E36640BE395A4EE8CCB2697222419A5,31071,2,6,4,109.58257,18.28458,1815
32012,242025,1E36640BE395A4EE8CCB2697222419A5,30854,8,17,9,109.56889,18.27076,1763
32013,242026,1E36640BE395A4EE8CCB2697222419A5,39091,19,21,2,109.50097,18.25222,1510
32014,242027,1E36640BE395A4EE8CCB2697222419A5,30191,21,22,1,109.50361,18.22701,1506
32026,242106,EC4B90EDBF35256FDB4D4F8B87DB8A04,31071,0,17,17,109.58257,18.28458,1815
32027,242107,EC4B90EDBF35256FDB4D4F8B87DB8A04,30854,19,20,1,109.56889,18.27076,1763
32028,242111,8CD15CF6B5FB4821940FF9AFE6D6CB84,31931,0,20,20,109.54771,18.29403,1667
32029,242112,8CD15CF6B5FB4821940FF9AFE6D6CB84,30921,21,23,2,109.53903,18.29451,1667
32033,242117,EE2B9FA1FE5C77473C44003104939CD4,30211,0,2,2,109.49882,18.23931,1508
32034,242146,AE01F02800A46BE78317CCA6998E50DC,30271,12,13,1,109.49132,18.23153,1456
32035,242149,10E6DCB22C04D9E1B01193CDA87B3193,30721,19,21,2,109.51597,18.28257,1565
32036,242150,10E6DCB22C04D9E1B01193CDA87B3193,38154,21,23,2,109.5266,18.28278,1615
32037,242189,8C54F679DD59F109DAF19BDB41D1658A,30441,0,9,9,109.64021,18.25424,2010
32038,242190,8C54F679DD59F109DAF19BDB41D1658A,31473,10,12,2,109.34792,18.29465,917
32039,242191,8C54F679DD59F109DAF19BDB41D1658A,30611,13,14,1,109.74958,18.40188,2485
32040,242262,69998C60A6E00459C2EA67259A550AAF,31071,0,7,7,109.58257,18.28458,1815
32041,242263,69998C60A6E00459C2EA67259A550AAF,30851,9,10,1,109.5616,18.27396,1713
32042,242264,69998C60A6E00459C2EA67259A550AAF,60381,14,16,2,109.5241,18.22458,1605
32043,242265,69998C60A6E00459C2EA67259A550AAF,30221,19,21,2,109.57833,18.20222,1802
32044,242279,04C0729B38628739B5D19433D7909981,30211,0,4,4,109.49882,18.23931,1508
32045,242280,04C0729B38628739B5D19433D7909981,30191,5,8,3,109.50361,18.22701,1506
32046,242281,04C0729B38628739B5D19433D7909981,31301,10,13,3,109.14493,18.31222,170
32047,242282,04C0729B38628739B5D19433D7909981,60054,14,15,1,109.3016,18.31229,770
32048,242283,04C0729B38628739B5D19433D7909981,30191,19,23,4,109.50361,18.22701,1506
32059,242397,93C8A9BFC982F63705EDC3214DA05AC8,30721,21,23,2,109.51597,18.28257,1565
32060,242412,B824B22132E063AA0786E40144CD7E97,31571,13,14,1,109.61563,18.23326,1957
32061,242413,B824B22132E063AA0786E40144CD7E97,30711,16,19,3,109.50271,18.25347,1510
32062,242414,B824B22132E063AA0786E40144CD7E97,31461,19,23,4,109.5091,18.25389,1510
32063,242454,1D8B814EC83D52D7C5F3FED99C129EE0,30854,3,8,5,109.56889,18.27076,1763
32064,242455,1D8B814EC83D52D7C5F3FED99C129EE0,38271,10,19,9,109.62632,18.23049,1956
32065,242513,02BA1B28C28D4C4E10AA258EED00ADF2,60261,3,5,2,109.44326,18.3075,1319
32066,242514,02BA1B28C28D4C4E10AA258EED00ADF2,30241,8,9,1,109.26174,18.3275,622
32067,242595,6BF671BC76B2463D72102139E4EB1018,38241,9,16,7,109.54111,18.30542,1669
32068,242596,6BF671BC76B2463D72102139E4EB1018,31931,18,20,2,109.54771,18.29403,1667
32069,242648,2F64FEF19C86AA0A8AA3E3FA37CC4F2D,39371,18,19,1,109.56627,18.2646,1762
32070,242649,2F64FEF19C86AA0A8AA3E3FA37CC4F2D,60631,20,22,2,109.57778,18.27583,1814
32071,242650,5C4B759B8D2905A494B81A3EB710A8F3,60631,0,17,17,109.57778,18.27583,1814
32072,242651,5C4B759B8D2905A494B81A3EB710A8F3,31231,19,20,1,109.42597,18.29292,1217
32073,242658,23019CE071DC0B0CEC6E78ADA422CE57,38973,1,4,3,109.51097,18.25389,1560
32074,242659,23019CE071DC0B0CEC6E78ADA422CE57,31381,7,10,3,109.1375,18.36833,129
32075,242660,23019CE071DC0B0CEC6E78ADA422CE57,30711,13,15,2,109.50271,18.25347,1510
32076,242661,23019CE071DC0B0CEC6E78ADA422CE57,38291,19,20,1,109.51618,18.24313,1558
32083,242725,4027759DA4AA4E8EAD8331A27147F405,31071,0,17,17,109.58257,18.28458,1815
32084,242726,4027759DA4AA4E8EAD8331A27147F405,39091,19,20,1,109.50097,18.25222,1510
32088,242763,BE22E1F27552B309245231CD4F4B6422,38027,14,15,1,109.38833,18.2909,1066
32089,242764,BE22E1F27552B309245231CD4F4B6422,30421,20,21,1,109.50021,18.25861,1511
32090,242809,D9E60CECBCF3335BA62A418C133E83E2,38117,0,6,6,109.51611,18.22354,1555
32091,242810,D9E60CECBCF3335BA62A418C133E83E2,60381,7,8,1,109.5241,18.22458,1605
32092,242811,D9E60CECBCF3335BA62A418C133E83E2,30731,10,11,1,109.50944,18.22306,1555
32093,242812,D9E60CECBCF3335BA62A418C133E83E2,39321,13,15,2,109.529,18.2167,1604
32094,242813,D9E60CECBCF3335BA62A418C133E83E2,31521,16,17,1,109.51458,18.22542,1555
32095,242814,D9E60CECBCF3335BA62A418C133E83E2,31521,19,22,3,109.51458,18.22542,1555
32106,242918,E429EA352745E371AD6E9A2D803C68B6,60424,0,5,5,109.44611,18.31736,1321
32107,242919,E429EA352745E371AD6E9A2D803C68B6,30821,6,7,1,109.43681,18.33639,1274
32108,242920,E429EA352745E371AD6E9A2D803C68B6,31931,8,10,2,109.54771,18.29403,1667
32109,242921,E429EA352745E371AD6E9A2D803C68B6,30921,15,17,2,109.53903,18.29451,1667
32110,242922,E429EA352745E371AD6E9A2D803C68B6,30821,20,21,1,109.43681,18.33639,1274
32111,242929,6C0260646767B781577B5B8CE2471E51,38484,0,7,7,109.53028,18.31528,1620
32112,242930,6C0260646767B781577B5B8CE2471E51,30071,11,13,2,109.52819,18.30472,1619
32113,242931,6C0260646767B781577B5B8CE2471E51,38484,14,16,2,109.53028,18.31528,1620
32114,242932,6C0260646767B781577B5B8CE2471E51,30321,17,19,2,109.49563,18.29611,1467
32115,242933,6C0260646767B781577B5B8CE2471E51,30071,20,22,2,109.52819,18.30472,1619
32116,242934,6C0260646767B781577B5B8CE2471E51,38484,22,23,1,109.53028,18.31528,1620
32117,242935,20C15B76A1E0DF79D86EDEAC7BC3D7B7,30854,2,7,5,109.56889,18.27076,1763
32118,242936,20C15B76A1E0DF79D86EDEAC7BC3D7B7,31945,9,11,2,109.58021,18.29403,1817
32119,242937,20C15B76A1E0DF79D86EDEAC7BC3D7B7,60631,12,14,2,109.57778,18.27583,1814
32120,242938,20C15B76A1E0DF79D86EDEAC7BC3D7B7,60381,19,20,1,109.5241,18.22458,1605
32121,242939,20C15B76A1E0DF79D86EDEAC7BC3D7B7,31071,21,23,2,109.58257,18.28458,1815
32125,242946,8F6EA1C108FADA76A214A7ED71ECE3D1,30232,1,2,1,109.6191,18.31701,1971
32126,242947,8F6EA1C108FADA76A214A7ED71ECE3D1,30891,3,4,1,109.59431,18.28389,1865
32127,242948,8F6EA1C108FADA76A214A7ED71ECE3D1,30854,8,17,9,109.56889,18.27076,1763
32131,243075,8AABF5FDF2B06EB445749240A3894969,30854,8,9,1,109.56889,18.27076,1763
32132,243076,8AABF5FDF2B06EB445749240A3894969,31851,12,16,4,109.71736,18.29007,2316
32133,243077,8AABF5FDF2B06EB445749240A3894969,31071,17,18,1,109.58257,18.28458,1815
32141,243141,FE95B3A32EFBC2838F293DF38F55FDD1,39181,2,3,1,109.55153,18.28035,1715
32142,243142,FE95B3A32EFBC2838F293DF38F55FDD1,39183,4,5,1,109.55542,18.28208,1715
32143,243143,FE95B3A32EFBC2838F293DF38F55FDD1,30071,7,8,1,109.52819,18.30472,1619
32144,243144,FE95B3A32EFBC2838F293DF38F55FDD1,39183,13,19,6,109.55542,18.28208,1715
32145,243145,FE95B3A32EFBC2838F293DF38F55FDD1,31931,20,23,3,109.54771,18.29403,1667
32146,243146,7B832C4EEA998F0828995CEC1FF24330,30854,19,21,2,109.56889,18.27076,1763
32147,243147,7B832C4EEA998F0828995CEC1FF24330,30371,22,23,1,109.51,18.24771,1559
32148,243184,FC8552628F8A5A5219C1C30314657039,60661,0,8,8,109.548,18.2377,1657
32149,243185,FC8552628F8A5A5219C1C30314657039,38111,10,11,1,109.52007,18.22403,1555
32150,243188,91A4B18B10CFB3885EEC99A3CDDB8545,30971,15,17,2,109.48708,18.29319,1467
32151,243228,E8BAAF476E8FE57075BAB1A8D4FF1780,60631,1,5,4,109.57778,18.27583,1814
32152,243229,E8BAAF476E8FE57075BAB1A8D4FF1780,39371,7,23,16,109.56627,18.2646,1762
32153,243282,82FFBAA5929CD368E9B5AC0A4DEDBC26,60241,15,17,2,109.53319,18.28667,1616
32154,243283,82FFBAA5929CD368E9B5AC0A4DEDBC26,30051,19,23,4,109.48917,18.21215,1453
32155,243305,408C4FED868686E7B96333835F4C4205,31206,0,2,2,109.50819,18.23549,1507
32156,243306,408C4FED868686E7B96333835F4C4205,31071,4,8,4,109.58257,18.28458,1815
32157,243307,408C4FED868686E7B96333835F4C4205,31145,9,10,1,109.20431,18.30479,369
32158,243308,408C4FED868686E7B96333835F4C4205,31301,11,13,2,109.14493,18.31222,170
32159,243309,408C4FED868686E7B96333835F4C4205,60381,18,20,2,109.5241,18.22458,1605
32160,243310,BAF784C90E903A1C0CEDF594F05C3F50,60361,0,8,8,109.51938,18.29681,1567
32161,243311,BAF784C90E903A1C0CEDF594F05C3F50,30711,9,10,1,109.50271,18.25347,1510
32162,243312,BAF784C90E903A1C0CEDF594F05C3F50,30731,13,15,2,109.50944,18.22306,1555
32163,243313,BAF784C90E903A1C0CEDF594F05C3F50,30181,15,20,5,109.51597,18.23313,1557
32164,243327,6532548CEFFF043086FECA37F4D65565,31071,10,15,5,109.58257,18.28458,1815
32165,243328,6532548CEFFF043086FECA37F4D65565,30854,15,17,2,109.56889,18.27076,1763
32166,243342,F7035E4742EE25797FD00CAEBC81D218,31251,0,9,9,109.18528,18.2975,317
32167,243343,F7035E4742EE25797FD00CAEBC81D218,30441,9,11,2,109.64021,18.25424,2010
32168,243344,F7035E4742EE25797FD00CAEBC81D218,31251,13,23,10,109.18528,18.2975,317
32169,243346,798BF3B08F72A16A6DEAAA235F1899BB,61011,4,5,1,109.60653,18.19076,1900
32170,243348,798BF3B08F72A16A6DEAAA235F1899BB,61011,18,21,3,109.60653,18.19076,1900
32171,243366,6C09CE755C8436D31143C1E3AA51623D,30854,15,16,1,109.56889,18.27076,1763
32172,243367,6C09CE755C8436D31143C1E3AA51623D,31071,17,18,1,109.58257,18.28458,1815
32173,243368,6C09CE755C8436D31143C1E3AA51623D,30854,19,21,2,109.56889,18.27076,1763
32174,243404,8173BA5756C17B85ED9415F619E926FB,31021,0,8,8,109.49021,18.27,1463
32175,243405,8173BA5756C17B85ED9415F619E926FB,31161,10,12,2,109.70229,18.31361,2270
32176,243406,8173BA5756C17B85ED9415F619E926FB,60171,13,19,6,109.51292,18.30694,1569
32177,243407,8173BA5756C17B85ED9415F619E926FB,30201,22,23,1,109.4909,18.26465,1462
32178,243488,E4C7AB656E412C7E33554D18277C9478,30371,12,14,2,109.51,18.24771,1559
32179,243489,E4C7AB656E412C7E33554D18277C9478,60331,16,17,1,109.505,18.26507,1512
32180,243490,E4C7AB656E412C7E33554D18277C9478,30911,17,18,1,109.50493,18.26181,1511
32181,243491,E4C7AB656E412C7E33554D18277C9478,31461,21,22,1,109.5091,18.25389,1510
32182,243526,66E9B7976F1EC626FEB04A97A1EEA045,30721,0,6,6,109.51597,18.28257,1565
32183,243527,66E9B7976F1EC626FEB04A97A1EEA045,31821,8,9,1,109.51181,18.24924,1559
32184,243562,D64B32EAC84F970E1B2B563AF70BEA64,60281,17,18,1,109.51743,18.25924,1561
32185,243577,6751CEC3CF9B2AE78246C7287443D2B4,31945,5,7,2,109.58021,18.29403,1817
32186,243578,6751CEC3CF9B2AE78246C7287443D2B4,30854,7,23,16,109.56889,18.27076,1763
32191,243607,EC89B2FFE00F967E6D0A3B697A6D636D,30191,19,21,2,109.50361,18.22701,1506
32192,243608,EC89B2FFE00F967E6D0A3B697A6D636D,31521,21,23,2,109.51458,18.22542,1555
32193,243629,616C1CD7DAC998574082232ED7666D81,30181,8,10,2,109.51597,18.23313,1557
32194,243630,616C1CD7DAC998574082232ED7666D81,31521,10,14,4,109.51458,18.22542,1555
32195,243631,616C1CD7DAC998574082232ED7666D81,30181,15,17,2,109.51597,18.23313,1557
32196,243632,616C1CD7DAC998574082232ED7666D81,31534,18,22,4,109.49368,18.25806,1461
32197,243638,4D4289AE0DFBF4B5C79A47559DC2EBDD,39371,1,3,2,109.56627,18.2646,1762
32198,243639,4D4289AE0DFBF4B5C79A47559DC2EBDD,30854,8,23,15,109.56889,18.27076,1763
32199,243640,59F29435D748531F416A4F1636997ECF,31071,0,7,7,109.58257,18.28458,1815
32200,243641,59F29435D748531F416A4F1636997ECF,33101,10,11,1,109.68438,18.44368,2242
32201,243642,59F29435D748531F416A4F1636997ECF,33481,13,14,1,109.67278,18.41278,2187
32202,243643,59F29435D748531F416A4F1636997ECF,30731,19,20,1,109.50944,18.22306,1555
32211,243724,369C26B411BBFC36DC6FE3529EBBC042,31071,2,7,5,109.58257,18.28458,1815
32212,243725,369C26B411BBFC36DC6FE3529EBBC042,30854,7,8,1,109.56889,18.27076,1763
32213,243726,369C26B411BBFC36DC6FE3529EBBC042,39371,11,13,2,109.56627,18.2646,1762
32214,243727,369C26B411BBFC36DC6FE3529EBBC042,30891,13,15,2,109.59431,18.28389,1865
32215,243728,369C26B411BBFC36DC6FE3529EBBC042,30854,15,16,1,109.56889,18.27076,1763
32216,243729,369C26B411BBFC36DC6FE3529EBBC042,39371,19,20,1,109.56627,18.2646,1762
32220,243804,F104684B0D453E1772CF3FC2E8F8DFBE,60201,10,11,1,109.5041,18.2509,1510
32221,243805,F104684B0D453E1772CF3FC2E8F8DFBE,60161,13,14,1,109.49174,18.26181,1461
32222,243806,F104684B0D453E1772CF3FC2E8F8DFBE,31041,18,20,2,109.50278,18.23701,1507
32223,243807,F104684B0D453E1772CF3FC2E8F8DFBE,30191,21,23,2,109.50361,18.22701,1506
32224,243886,2CF83F5125C6075E2ACA9C17C2979C64,31945,0,1,1,109.58021,18.29403,1817
32225,243887,2CF83F5125C6075E2ACA9C17C2979C64,31071,5,9,4,109.58257,18.28458,1815
32226,243888,2CF83F5125C6075E2ACA9C17C2979C64,30854,10,12,2,109.56889,18.27076,1763
32227,243889,2CF83F5125C6075E2ACA9C17C2979C64,31071,14,17,3,109.58257,18.28458,1815
32228,243890,2CF83F5125C6075E2ACA9C17C2979C64,30854,18,20,2,109.56889,18.27076,1763
32229,243900,16CCFF81838B15A70A44E8C4B6CCB914,30171,15,17,2,109.48458,18.27139,1463
32230,243901,16CCFF81838B15A70A44E8C4B6CCB914,60661,21,22,1,109.548,18.2377,1657
32231,243902,222E0B6922623CE9FBB280F81068D40E,60614,14,16,2,109.48799,18.29521,1467
32232,243903,222E0B6922623CE9FBB280F81068D40E,31071,19,21,2,109.58257,18.28458,1815
32233,243937,A795428793D2273B4ACFDADC5E61AEC2,31421,8,9,1,109.55382,18.22347,1705
32234,243938,A795428793D2273B4ACFDADC5E61AEC2,60661,12,15,3,109.548,18.2377,1657
32235,243939,A795428793D2273B4ACFDADC5E61AEC2,31421,15,18,3,109.55382,18.22347,1705
32236,243957,14DD9E5DCCEFE8BE7425556E4E04FC9A,30854,15,17,2,109.56889,18.27076,1763
32237,243958,14DD9E5DCCEFE8BE7425556E4E04FC9A,31561,20,23,3,109.56792,18.28479,1765
32238,243975,0534435998BA85FF6F729B13993555F5,31071,6,7,1,109.58257,18.28458,1815
32239,243976,0534435998BA85FF6F729B13993555F5,31931,8,10,2,109.54771,18.29403,1667
32240,243977,0534435998BA85FF6F729B13993555F5,31561,12,13,1,109.56792,18.28479,1765
32241,243990,15195C578D4A8081B069C4B518039EFC,30421,16,18,2,109.50021,18.25861,1511
32242,243991,15195C578D4A8081B069C4B518039EFC,31201,21,23,2,109.51042,18.23819,1558
32250,244042,372A5433078073EAD18922D679CE0A73,30661,2,4,2,109.37028,18.24361,1008
32251,244043,372A5433078073EAD18922D679CE0A73,60411,6,16,10,109.32514,18.30854,869
32252,244094,185085A773728237A34663A038E61890,31471,13,15,2,109.34583,18.29563,917
32253,244095,185085A773728237A34663A038E61890,31231,18,19,1,109.42597,18.29292,1217
32254,244119,B023927CBEC0A8053CBDF64A5B76E367,60231,0,2,2,109.49903,18.21972,1504
32255,244120,B023927CBEC0A8053CBDF64A5B76E367,30051,4,5,1,109.48917,18.21215,1453
32256,244121,B023927CBEC0A8053CBDF64A5B76E367,31931,7,9,2,109.54771,18.29403,1667
32257,244122,B023927CBEC0A8053CBDF64A5B76E367,30071,10,12,2,109.52819,18.30472,1619
32258,244123,B023927CBEC0A8053CBDF64A5B76E367,31931,12,15,3,109.54771,18.29403,1667
32259,244124,B023927CBEC0A8053CBDF64A5B76E367,60231,19,23,4,109.49903,18.21972,1504
32260,244143,7D9FE20353178BD0E18334ADA0227839,31671,11,13,2,109.38965,18.29813,1068
32261,244144,7D9FE20353178BD0E18334ADA0227839,38903,13,15,2,109.39229,18.29243,1117
32262,244145,7D9FE20353178BD0E18334ADA0227839,60541,16,17,1,109.4084,18.29208,1167
32263,244146,7D9FE20353178BD0E18334ADA0227839,38325,18,20,2,109.39792,18.2909,1116
32264,244147,7D9FE20353178BD0E18334ADA0227839,38903,22,23,1,109.39229,18.29243,1117
32265,244155,2402F47602CE5EB75F62A444E17991D1,31561,14,15,1,109.56792,18.28479,1765
32266,244156,2402F47602CE5EB75F62A444E17991D1,30851,17,18,1,109.5616,18.27396,1713
32267,244210,7BDC7962058E5B3507F7C37155585188,38881,2,5,3,109.51618,18.26431,1562
32268,244211,7BDC7962058E5B3507F7C37155585188,60131,9,12,3,109.49819,18.24778,1509
32273,244221,50B65AC8D2C37EA95C5135CC7670F4EA,39181,0,8,8,109.55153,18.28035,1715
32274,244222,50B65AC8D2C37EA95C5135CC7670F4EA,31021,10,11,1,109.49021,18.27,1463
32275,244235,570FC5697D4CEEA6951BDA07BB9D84E2,30031,12,13,1,109.53681,18.33313,1673
32276,244287,F715F8942B68CC23C9F5DCA00F01A0F8,60131,0,7,7,109.49819,18.24778,1509
32277,244288,F715F8942B68CC23C9F5DCA00F01A0F8,31471,9,10,1,109.34583,18.29563,917
32278,244289,F715F8942B68CC23C9F5DCA00F01A0F8,31471,13,14,1,109.34583,18.29563,917
32279,244290,F715F8942B68CC23C9F5DCA00F01A0F8,31471,14,16,2,109.34583,18.29563,917
32280,244291,F715F8942B68CC23C9F5DCA00F01A0F8,60131,20,23,3,109.49819,18.24778,1509
32281,244309,2EC9A01B9F6379C2C079528EAEB98D6B,31181,13,14,1,109.50382,18.24813,1509
32282,244310,2EC9A01B9F6379C2C079528EAEB98D6B,30861,16,19,3,109.52722,18.22743,1606
32283,244311,2EC9A01B9F6379C2C079528EAEB98D6B,31421,20,23,3,109.55382,18.22347,1705
32284,244312,1A6EAA2168CC835EA94CCB88CD588780,60551,2,6,4,109.42722,18.30111,1218
32285,244313,1A6EAA2168CC835EA94CCB88CD588780,31781,10,11,1,109.19847,18.2975,367
32286,244314,D2D609608AA1D4DD8E18DD3745793D0D,30854,0,1,1,109.56889,18.27076,1763
32287,244315,D2D609608AA1D4DD8E18DD3745793D0D,31071,1,6,5,109.58257,18.28458,1815
32288,244316,D2D609608AA1D4DD8E18DD3745793D0D,30854,7,17,10,109.56889,18.27076,1763
32289,244317,D2D609608AA1D4DD8E18DD3745793D0D,31071,17,18,1,109.58257,18.28458,1815
32290,244318,D2D609608AA1D4DD8E18DD3745793D0D,30854,20,21,1,109.56889,18.27076,1763
32291,244330,EAB13D8DCF040DFD77DED2DC4F282C5E,31071,4,5,1,109.58257,18.28458,1815
32292,244331,EAB13D8DCF040DFD77DED2DC4F282C5E,30531,6,16,10,109.53271,18.21472,1604
32293,244332,EAB13D8DCF040DFD77DED2DC4F282C5E,31071,18,19,1,109.58257,18.28458,1815
32298,244364,A8E229AD359BAFAD8DE94B2EA508C4AD,38291,1,8,7,109.51618,18.24313,1558
32299,244365,A8E229AD359BAFAD8DE94B2EA508C4AD,60087,9,15,6,109.50688,18.22299,1505
32300,244366,A8E229AD359BAFAD8DE94B2EA508C4AD,31201,16,18,2,109.51042,18.23819,1558
32301,244367,A8E229AD359BAFAD8DE94B2EA508C4AD,30421,18,20,2,109.50021,18.25861,1511
32302,244368,A8E229AD359BAFAD8DE94B2EA508C4AD,30191,21,23,2,109.50361,18.22701,1506
32303,244398,C4637BB33A8AE1046D9835B859742468,30854,9,12,3,109.56889,18.27076,1763
32304,244399,C4637BB33A8AE1046D9835B859742468,31071,13,15,2,109.58257,18.28458,1815
32305,244400,C4637BB33A8AE1046D9835B859742468,30854,15,21,6,109.56889,18.27076,1763
32306,244406,C17F2EF1DEA79C8C951E3013EE071B2C,31945,15,16,1,109.58021,18.29403,1817
32307,244407,C17F2EF1DEA79C8C951E3013EE071B2C,60381,19,20,1,109.5241,18.22458,1605
32308,244438,BCA001FBB8FD352D450AB5BA721CDF88,31431,0,6,6,109.44639,18.29042,1316
32309,244444,0442B38E8824E569B00E80CCEFC70940,39183,0,1,1,109.55542,18.28208,1715
32310,244445,0442B38E8824E569B00E80CCEFC70940,31561,1,4,3,109.56792,18.28479,1765
32311,244446,0442B38E8824E569B00E80CCEFC70940,39183,7,9,2,109.55542,18.28208,1715
32312,244447,0442B38E8824E569B00E80CCEFC70940,30854,18,20,2,109.56889,18.27076,1763
32313,244448,0442B38E8824E569B00E80CCEFC70940,31951,21,23,2,109.52174,18.30299,1568
32314,244449,90F3300D143E0362CC2D61396D0D92D9,30661,0,4,4,109.37028,18.24361,1008
32315,244450,90F3300D143E0362CC2D61396D0D92D9,38834,4,6,2,109.47639,18.21146,1403
32316,244451,90F3300D143E0362CC2D61396D0D92D9,31781,11,12,1,109.19847,18.2975,367
32317,244452,90F3300D143E0362CC2D61396D0D92D9,31471,14,16,2,109.34583,18.29563,917
32321,244466,E8360EC7045D7533E018C0DD4BA3F683,31851,16,22,6,109.71736,18.29007,2316
32322,244502,0207E1FFE1F4E812F7B60ECDB11A3A32,31531,0,10,10,109.49583,18.25972,1461
32323,244505,66864E1E8AC0EC5BDABE36A6259E7E95,31811,0,6,6,109.54201,18.31806,1671
32324,244506,66864E1E8AC0EC5BDABE36A6259E7E95,60501,7,8,1,109.48701,18.29021,1466
32325,244507,66864E1E8AC0EC5BDABE36A6259E7E95,38251,9,11,2,109.49618,18.25493,1510
32326,244508,66864E1E8AC0EC5BDABE36A6259E7E95,30211,11,12,1,109.49882,18.23931,1508
32327,244565,B686D3B43D34677518993C0625C36D62,31561,15,17,2,109.56792,18.28479,1765
32328,244566,B686D3B43D34677518993C0625C36D62,30851,17,18,1,109.5616,18.27396,1713
32329,244572,16D0D368FD3BC47081E9D9081C1E1F90,30854,7,8,1,109.56889,18.27076,1763
32330,244573,16D0D368FD3BC47081E9D9081C1E1F90,31071,10,12,2,109.58257,18.28458,1815
32331,244574,16D0D368FD3BC47081E9D9081C1E1F90,30854,14,21,7,109.56889,18.27076,1763
32342,244643,3E244234D69B8A1AEE01C39E0BA72446,30851,10,11,1,109.5616,18.27396,1713
32343,244644,3E244234D69B8A1AEE01C39E0BA72446,31145,13,15,2,109.20431,18.30479,369
32344,244645,14F257919D1F3A7CE4674DF72BE93FA3,60084,0,7,7,109.4984,18.2334,1507
32345,244646,14F257919D1F3A7CE4674DF72BE93FA3,31781,10,11,1,109.19847,18.2975,367
32346,244647,14F257919D1F3A7CE4674DF72BE93FA3,60054,15,16,1,109.3016,18.31229,770
32347,244648,14F257919D1F3A7CE4674DF72BE93FA3,60221,18,20,2,109.52569,18.29188,1616
32348,244649,14F257919D1F3A7CE4674DF72BE93FA3,60084,22,23,1,109.4984,18.2334,1507
32349,244664,6208C975549EEEB8D4C55F71CEB62229,30854,10,12,2,109.56889,18.27076,1763
32350,244665,6208C975549EEEB8D4C55F71CEB62229,31071,13,16,3,109.58257,18.28458,1815
32351,244666,6208C975549EEEB8D4C55F71CEB62229,30854,20,21,1,109.56889,18.27076,1763
32352,244671,BE7763F8096EB5A037146E1CC4190538,30854,0,2,2,109.56889,18.27076,1763
32353,244672,BE7763F8096EB5A037146E1CC4190538,31561,3,5,2,109.56792,18.28479,1765
32354,244673,BE7763F8096EB5A037146E1CC4190538,39183,9,10,1,109.55542,18.28208,1715
32355,244674,BE7763F8096EB5A037146E1CC4190538,30854,12,13,1,109.56889,18.27076,1763
32356,244675,BE7763F8096EB5A037146E1CC4190538,30851,14,16,2,109.5616,18.27396,1713
32365,244710,332A868849E47177376F9755C981E1C1,60391,6,7,1,109.47667,18.28757,1416
32366,244711,332A868849E47177376F9755C981E1C1,31931,8,16,8,109.54771,18.29403,1667
32367,244721,AE1D2CB811A45E9D0BA691392CEA1100,31071,1,10,9,109.58257,18.28458,1815
32368,244722,AE1D2CB811A45E9D0BA691392CEA1100,31071,14,16,2,109.58257,18.28458,1815
32372,244858,EB316856896788EC8FD871E122E95728,31811,12,13,1,109.54201,18.31806,1671
32373,244859,EB316856896788EC8FD871E122E95728,30701,13,19,6,109.59313,18.32007,1871
32386,244962,4B004637D3CFBCA65EA00FFD3F1EF7A6,31561,0,1,1,109.56792,18.28479,1765
32387,244963,4B004637D3CFBCA65EA00FFD3F1EF7A6,30854,3,5,2,109.56889,18.27076,1763
32388,244964,4B004637D3CFBCA65EA00FFD3F1EF7A6,39183,7,10,3,109.55542,18.28208,1715
32389,244965,4B004637D3CFBCA65EA00FFD3F1EF7A6,60371,14,16,2,109.53063,18.30056,1618
32390,244966,4B004637D3CFBCA65EA00FFD3F1EF7A6,30854,18,19,1,109.56889,18.27076,1763
32394,245010,3018A59307B3FCF174C9259743A17A51,31071,15,16,1,109.58257,18.28458,1815
32395,245011,3018A59307B3FCF174C9259743A17A51,31071,20,22,2,109.58257,18.28458,1815
32396,245052,E27729CF5C68766C958C34CEBE1241B2,30351,0,1,1,109.41701,18.29292,1217
32397,245053,E27729CF5C68766C958C34CEBE1241B2,60552,2,7,5,109.41729,18.30014,1218
32398,245054,E27729CF5C68766C958C34CEBE1241B2,60054,11,13,2,109.3016,18.31229,770
32405,245076,B164B8C0AEC0E295C9ED3DBE75B5D547,30084,19,20,1,109.50118,18.26972,1513
32406,245077,B164B8C0AEC0E295C9ED3DBE75B5D547,31031,20,22,2,109.49979,18.25382,1510
32407,245124,5264833F0013AE6B294396000613EF89,31041,0,17,17,109.50278,18.23701,1507
32408,245125,5264833F0013AE6B294396000613EF89,30721,22,23,1,109.51597,18.28257,1565
32413,245137,54EA5A03224802DD904B7C6F69D9E71B,38951,0,7,7,109.48097,18.28868,1416
32414,245138,54EA5A03224802DD904B7C6F69D9E71B,31231,10,11,1,109.42597,18.29292,1217
32415,245139,54EA5A03224802DD904B7C6F69D9E71B,30661,13,16,3,109.37028,18.24361,1008
32416,245140,54EA5A03224802DD904B7C6F69D9E71B,60381,18,19,1,109.5241,18.22458,1605
32417,245141,54EA5A03224802DD904B7C6F69D9E71B,38951,21,23,2,109.48097,18.28868,1416
32418,245157,993300654839821E7CBC0B1D6C1A4599,61011,1,12,11,109.60653,18.19076,1900
32419,245159,2F440A235E684ECEDD042B3100A4AE95,31561,12,14,2,109.56792,18.28479,1765
32420,245160,2F440A235E684ECEDD042B3100A4AE95,30854,14,18,4,109.56889,18.27076,1763
32424,245167,3E507BA86FBA703DAF19C68A80411CA5,30854,22,23,1,109.56889,18.27076,1763
32425,245168,282786EFD7BB2C684B51EB83D9362631,30971,0,8,8,109.48708,18.29319,1467
32426,245169,282786EFD7BB2C684B51EB83D9362631,30971,12,15,3,109.48708,18.29319,1467
32427,245170,282786EFD7BB2C684B51EB83D9362631,30791,16,17,1,109.72333,18.40889,2386
32428,245177,5EBEA276FCB4A19AC5C987F5C7CC8908,60524,0,5,5,109.42951,18.28993,1216
32429,245178,5EBEA276FCB4A19AC5C987F5C7CC8908,60401,6,8,2,109.47444,18.27583,1414
32430,245179,5EBEA276FCB4A19AC5C987F5C7CC8908,60621,8,10,2,109.48354,18.27451,1464
32431,245180,5EBEA276FCB4A19AC5C987F5C7CC8908,60524,13,14,1,109.42951,18.28993,1216
32432,245181,5EBEA276FCB4A19AC5C987F5C7CC8908,60621,14,16,2,109.48354,18.27451,1464
32433,245182,5EBEA276FCB4A19AC5C987F5C7CC8908,60552,20,23,3,109.41729,18.30014,1218
32434,245186,3B6FF1F8D896A0A62DC7E65967011999,39183,0,10,10,109.55542,18.28208,1715
32435,245187,3B6FF1F8D896A0A62DC7E65967011999,31561,15,22,7,109.56792,18.28479,1765
32436,245200,8D381F127A95193D387DCE543867137E,39091,21,22,1,109.50097,18.25222,1510
32441,245250,1B4CC2DF3534E139B7BDB2BC1E7BA919,30861,0,6,6,109.52722,18.22743,1606
32442,245251,1B4CC2DF3534E139B7BDB2BC1E7BA919,31145,10,12,2,109.20431,18.30479,369
32443,245252,1B4CC2DF3534E139B7BDB2BC1E7BA919,31471,14,15,1,109.34583,18.29563,917
32444,245253,59B48C7DD533E36B4AA6ADABEB53F8C6,60631,0,5,5,109.57778,18.27583,1814
32445,245254,59B48C7DD533E36B4AA6ADABEB53F8C6,31571,7,8,1,109.61563,18.23326,1957
32446,245283,043146C5CE5F8CF55A3C39C0EBF4DEF0,31471,14,16,2,109.34583,18.29563,917
32447,245284,043146C5CE5F8CF55A3C39C0EBF4DEF0,30421,19,21,2,109.50021,18.25861,1511
32448,245332,C8135D3E403B7CC96352A41CBCD291A7,31171,16,17,1,109.50938,18.24917,1559
32449,245333,C8135D3E403B7CC96352A41CBCD291A7,31931,20,21,1,109.54771,18.29403,1667
32450,245358,179FD4660C817BD29234A518F00339D3,60231,6,20,14,109.49903,18.21972,1504
32451,245359,179FD4660C817BD29234A518F00339D3,60084,22,23,1,109.4984,18.2334,1507
32452,245374,4EEB87EFD2F33BBAF42BE530271C40CA,31161,0,8,8,109.70229,18.31361,2270
32453,245375,4EEB87EFD2F33BBAF42BE530271C40CA,31881,12,14,2,109.7441,18.40785,2436
32454,245383,D40486BFA9AC720A5137C9EAFB418BFA,30854,13,15,2,109.56889,18.27076,1763
32455,245384,D40486BFA9AC720A5137C9EAFB418BFA,31931,15,16,1,109.54771,18.29403,1667
32456,245385,D40486BFA9AC720A5137C9EAFB418BFA,60361,19,23,4,109.51938,18.29681,1567
32460,245420,B7A2800FDF738E1064EAD2A5E58F7A3C,61011,0,14,14,109.60653,18.19076,1900
32461,245422,B7A2800FDF738E1064EAD2A5E58F7A3C,61011,20,22,2,109.60653,18.19076,1900
32466,245488,64F4CDF664AA04E7B79DE93C57128CF6,30851,14,16,2,109.5616,18.27396,1713
32467,245489,64F4CDF664AA04E7B79DE93C57128CF6,31931,20,21,1,109.54771,18.29403,1667
32468,245507,478D8ECA4D0ED449A4B0B8758C69C071,30084,14,15,1,109.50118,18.26972,1513
32469,245508,478D8ECA4D0ED449A4B0B8758C69C071,30741,17,19,2,109.49833,18.28681,1516
32470,245509,478D8ECA4D0ED449A4B0B8758C69C071,30741,21,23,2,109.49833,18.28681,1516
32475,245539,542AC211E6240BA31C29EF3A8CB800AF,31421,0,9,9,109.55382,18.22347,1705
32476,245540,542AC211E6240BA31C29EF3A8CB800AF,31461,11,12,1,109.5091,18.25389,1510
32477,245541,542AC211E6240BA31C29EF3A8CB800AF,60111,13,17,4,109.72556,18.31924,2371
32478,245542,542AC211E6240BA31C29EF3A8CB800AF,60201,19,22,3,109.5041,18.2509,1510
32485,245600,2045F87259C3396ECF12D73ACA58A5D3,31071,3,10,7,109.58257,18.28458,1815
32486,245601,2045F87259C3396ECF12D73ACA58A5D3,30854,11,23,12,109.56889,18.27076,1763
32490,245646,C93386A9D86FE22A1FD4E5116045DD8D,30851,13,17,4,109.5616,18.27396,1713
32491,245647,C93386A9D86FE22A1FD4E5116045DD8D,31561,21,23,2,109.56792,18.28479,1765
32492,245673,BAFDD3A022A674BA6CCC93E365FAFC36,30084,17,18,1,109.50118,18.26972,1513
32493,245674,BAFDD3A022A674BA6CCC93E365FAFC36,31461,18,20,2,109.5091,18.25389,1510
32497,245734,7A02B47CA444ED227E88DEEC4D609540,31781,12,15,3,109.19847,18.2975,367
32498,245735,7A02B47CA444ED227E88DEEC4D609540,31471,15,17,2,109.34583,18.29563,917
32499,245736,7A02B47CA444ED227E88DEEC4D609540,30361,19,20,1,109.50347,18.24,1508
32503,245746,3977578BE56276DA0700B04B81DC1356,30851,11,14,3,109.5616,18.27396,1713
32504,245747,3977578BE56276DA0700B04B81DC1356,31561,14,16,2,109.56792,18.28479,1765
32505,245748,3977578BE56276DA0700B04B81DC1356,30851,16,20,4,109.5616,18.27396,1713
32506,245765,E185F7F6F36381B5DE13870782051008,60381,19,20,1,109.5241,18.22458,1605
32507,245807,B7E330D15F4B46614A332696B5F7027D,30854,14,15,1,109.56889,18.27076,1763
32508,245808,B7E330D15F4B46614A332696B5F7027D,31931,18,23,5,109.54771,18.29403,1667
32509,245850,0E129C09250C0D46273B4BD7E5225556,31471,13,16,3,109.34583,18.29563,917
32510,245851,0E129C09250C0D46273B4BD7E5225556,60201,18,20,2,109.5041,18.2509,1510
32511,245852,0E129C09250C0D46273B4BD7E5225556,30151,20,23,3,109.50986,18.25083,1560
32522,245974,7D700D7B939DF0B50E1623297FA9AE05,31931,14,19,5,109.54771,18.29403,1667
32523,245975,7D700D7B939DF0B50E1623297FA9AE05,60241,21,22,1,109.53319,18.28667,1616
32524,245976,8A0382A2385C362EFE2664E8795F133E,30854,19,20,1,109.56889,18.27076,1763
32525,245977,8A0382A2385C362EFE2664E8795F133E,31561,20,23,3,109.56792,18.28479,1765
32529,246017,FF44A01712CEF692A20866E24012EF28,31561,17,20,3,109.56792,18.28479,1765
32530,246053,FE119DB57322892B4DF62B443B992BDF,38871,0,6,6,109.44681,18.28625,1316
32531,246054,FE119DB57322892B4DF62B443B992BDF,31701,6,10,4,109.44132,18.28833,1266
32532,246055,FE119DB57322892B4DF62B443B992BDF,33051,13,14,1,109.6475,18.46618,2096
32533,246056,FE119DB57322892B4DF62B443B992BDF,60221,16,18,2,109.52569,18.29188,1616
32534,246057,FE119DB57322892B4DF62B443B992BDF,30051,20,21,1,109.48917,18.21215,1453
32538,246126,807F73DE76DFE56E472FA61396F0887C,30711,11,14,3,109.50271,18.25347,1510
32539,246127,807F73DE76DFE56E472FA61396F0887C,30711,17,18,1,109.50271,18.25347,1510
32540,246128,807F73DE76DFE56E472FA61396F0887C,30321,20,22,2,109.49563,18.29611,1467
32541,246143,866460FA5062A635337B6369BB2AADDA,30441,13,18,5,109.64021,18.25424,2010
32542,246144,866460FA5062A635337B6369BB2AADDA,30854,22,23,1,109.56889,18.27076,1763
32543,246153,F6A1EBB84FE583E84185C423218578F5,31561,0,5,5,109.56792,18.28479,1765
32544,246154,F6A1EBB84FE583E84185C423218578F5,31931,7,9,2,109.54771,18.29403,1667
32545,246164,860D8FD1FD466E2189F245D42B766A0C,30271,0,8,8,109.49132,18.23153,1456
32546,246165,860D8FD1FD466E2189F245D42B766A0C,30671,10,11,1,109.43611,18.30139,1268
32547,246166,860D8FD1FD466E2189F245D42B766A0C,30271,14,15,1,109.49132,18.23153,1456
32548,246167,860D8FD1FD466E2189F245D42B766A0C,60381,17,18,1,109.5241,18.22458,1605
32549,246168,860D8FD1FD466E2189F245D42B766A0C,30271,21,23,2,109.49132,18.23153,1456
32550,246179,EAD0F857A028E27AEC5E665129C31CC4,38706,0,5,5,109.74625,18.37097,2430
32551,246180,EAD0F857A028E27AEC5E665129C31CC4,30961,7,10,3,109.74042,18.37903,2431
32552,246182,5202825DF51CA068C8B204422480230F,31071,3,7,4,109.58257,18.28458,1815
32553,246183,5202825DF51CA068C8B204422480230F,31761,7,10,3,109.60521,18.27965,1914
32554,246229,D39D64452E6BBEF7B3056CA239E1B86E,31561,14,15,1,109.56792,18.28479,1765
32555,246230,D39D64452E6BBEF7B3056CA239E1B86E,30854,16,23,7,109.56889,18.27076,1763
32556,246236,40C57F24FE0409ABB752B2031C349577,38951,16,18,2,109.48097,18.28868,1416
32557,246237,40C57F24FE0409ABB752B2031C349577,39091,20,21,1,109.50097,18.25222,1510
32558,246238,40C57F24FE0409ABB752B2031C349577,38951,21,23,2,109.48097,18.28868,1416
32562,246257,767325C9C51C25E76A4781E7E66DE8D0,38023,0,7,7,109.37132,18.28993,1016
32563,246258,767325C9C51C25E76A4781E7E66DE8D0,30341,7,8,1,109.3625,18.29167,966
32564,246260,A7D270EF8C74F66D966F17A0E3BC8BC9,33481,12,14,2,109.67278,18.41278,2187
32565,246261,A7D270EF8C74F66D966F17A0E3BC8BC9,30854,15,22,7,109.56889,18.27076,1763
32566,246301,34AB502A442AA8EA4A7FB30471B204DB,60621,0,2,2,109.48354,18.27451,1464
32567,246302,34AB502A442AA8EA4A7FB30471B204DB,38325,4,7,3,109.39792,18.2909,1116
32568,246303,34AB502A442AA8EA4A7FB30471B204DB,60401,8,11,3,109.47444,18.27583,1414
32569,246304,34AB502A442AA8EA4A7FB30471B204DB,38251,11,13,2,109.49618,18.25493,1510
32570,246305,34AB502A442AA8EA4A7FB30471B204DB,30341,13,17,4,109.3625,18.29167,966
32571,246316,1A3EA2E067124B6FFA24EC348CDAFF81,30051,0,3,3,109.48917,18.21215,1453
32572,246317,1A3EA2E067124B6FFA24EC348CDAFF81,30661,3,7,4,109.37028,18.24361,1008
32573,246318,1A3EA2E067124B6FFA24EC348CDAFF81,31781,9,12,3,109.19847,18.2975,367
32574,246319,1A3EA2E067124B6FFA24EC348CDAFF81,60231,19,21,2,109.49903,18.21972,1504
32575,246320,1A3EA2E067124B6FFA24EC348CDAFF81,30051,22,23,1,109.48917,18.21215,1453
32576,246329,4BCFB9B7DA47F954D069C9FF9050BF88,31071,0,2,2,109.58257,18.28458,1815
32577,246330,4BCFB9B7DA47F954D069C9FF9050BF88,30854,4,22,18,109.56889,18.27076,1763
32584,246382,0695D4E7B3E726CA09D841B87798B560,30854,2,17,15,109.56889,18.27076,1763
32585,246383,0695D4E7B3E726CA09D841B87798B560,31071,19,21,2,109.58257,18.28458,1815
32589,246421,A7B3BDD8DC79485BA41EC7F220A41345,60631,0,9,9,109.57778,18.27583,1814
32590,246422,A7B3BDD8DC79485BA41EC7F220A41345,30891,10,11,1,109.59431,18.28389,1865
32594,246513,CBF71892C67A397772665402624216C5,39183,0,10,10,109.55542,18.28208,1715
32595,246514,CBF71892C67A397772665402624216C5,31931,14,19,5,109.54771,18.29403,1667
32600,246527,21572EF63648BA9F4120E83EB6995193,60211,0,9,9,109.63549,18.26049,2011
32601,246528,21572EF63648BA9F4120E83EB6995193,31161,9,17,8,109.70229,18.31361,2270
32606,246624,A5F3D2AD273A8099B929F81757B36465,30861,18,20,2,109.52722,18.22743,1606
32607,246625,A5F3D2AD273A8099B929F81757B36465,60311,21,23,2,109.52097,18.24319,1558
32608,246653,30F5D42A1A8F1CF26F5C9617FCB06C4F,31561,0,5,5,109.56792,18.28479,1765
32609,246654,30F5D42A1A8F1CF26F5C9617FCB06C4F,39183,9,10,1,109.55542,18.28208,1715
32610,246655,30F5D42A1A8F1CF26F5C9617FCB06C4F,30854,11,12,1,109.56889,18.27076,1763
32611,246656,30F5D42A1A8F1CF26F5C9617FCB06C4F,31931,14,15,1,109.54771,18.29403,1667
32612,246657,30F5D42A1A8F1CF26F5C9617FCB06C4F,31561,15,22,7,109.56792,18.28479,1765
32617,246779,97C31877CA4226D0F1BA1C0E12066B56,60331,2,6,4,109.505,18.26507,1512
32618,246780,97C31877CA4226D0F1BA1C0E12066B56,30854,7,8,1,109.56889,18.27076,1763
32619,246781,97C31877CA4226D0F1BA1C0E12066B56,31561,8,10,2,109.56792,18.28479,1765
32620,246782,97C31877CA4226D0F1BA1C0E12066B56,30854,15,18,3,109.56889,18.27076,1763
32621,246783,97C31877CA4226D0F1BA1C0E12066B56,30251,20,23,3,109.50611,18.26653,1512
32625,246834,3C77BAC9CB4768E90972AC2C164CBD19,60631,0,14,14,109.57778,18.27583,1814
32626,246835,3C77BAC9CB4768E90972AC2C164CBD19,30854,15,16,1,109.56889,18.27076,1763
32627,246836,3C77BAC9CB4768E90972AC2C164CBD19,31181,18,20,2,109.50382,18.24813,1509
32628,246837,8C2A72A3EA8DBE7544B4A433B2BC3FE0,38291,12,16,4,109.51618,18.24313,1558
32629,246838,8C2A72A3EA8DBE7544B4A433B2BC3FE0,60491,19,22,3,109.43354,18.30847,1269
32634,246866,A2CBC4EC9AE7595B393C856E6E6033FF,31521,0,9,9,109.51458,18.22542,1555
32635,246867,A2CBC4EC9AE7595B393C856E6E6033FF,31781,11,14,3,109.19847,18.2975,367
32636,246868,A2CBC4EC9AE7595B393C856E6E6033FF,31021,18,20,2,109.49021,18.27,1463
32637,246869,A2CBC4EC9AE7595B393C856E6E6033FF,60381,20,23,3,109.5241,18.22458,1605
32644,247005,39B496BBEDAF80FAB2852AC3F417A930,30391,11,16,5,109.4975,18.27118,1513
32648,247021,3066D3BA0EF6F55E10FAD924A6ADDDEF,60201,0,1,1,109.5041,18.2509,1510
32649,247022,3066D3BA0EF6F55E10FAD924A6ADDDEF,60291,1,6,5,109.50826,18.24639,1509
32650,247023,3066D3BA0EF6F55E10FAD924A6ADDDEF,30151,7,12,5,109.50986,18.25083,1560
32651,247024,3066D3BA0EF6F55E10FAD924A6ADDDEF,30151,14,18,4,109.50986,18.25083,1560
32652,247025,3066D3BA0EF6F55E10FAD924A6ADDDEF,60201,21,23,2,109.5041,18.2509,1510
32656,247067,7E72E50B4F301EDC5663E8EF46336DB9,39061,2,3,1,109.38222,18.28958,1066
32657,247068,7E72E50B4F301EDC5663E8EF46336DB9,30341,4,6,2,109.3625,18.29167,966
32668,247116,89A01963B06628A3D6B13DA41FA507D1,31164,13,15,2,109.69993,18.27215,2263
32669,247117,89A01963B06628A3D6B13DA41FA507D1,31161,17,19,2,109.70229,18.31361,2270
32670,247118,89A01963B06628A3D6B13DA41FA507D1,30854,20,22,2,109.56889,18.27076,1763
32671,247119,89A01963B06628A3D6B13DA41FA507D1,31561,22,23,1,109.56792,18.28479,1765
32683,247144,7421066246AAD1C230E7E2A7ADF06E9D,31071,0,5,5,109.58257,18.28458,1815
32684,247145,7421066246AAD1C230E7E2A7ADF06E9D,60631,6,7,1,109.57778,18.27583,1814
32685,247146,7421066246AAD1C230E7E2A7ADF06E9D,31071,10,12,2,109.58257,18.28458,1815
32686,247147,7421066246AAD1C230E7E2A7ADF06E9D,30854,15,19,4,109.56889,18.27076,1763
32687,247148,7421066246AAD1C230E7E2A7ADF06E9D,30084,19,22,3,109.50118,18.26972,1513
32688,247172,A01B4012B619D942E7CC3AC9B78722B4,31931,14,16,2,109.54771,18.29403,1667
32689,247173,A01B4012B619D942E7CC3AC9B78722B4,30854,17,18,1,109.56889,18.27076,1763
32690,247188,417408FFDA93B177641D270D3A5C4B2D,31071,0,6,6,109.58257,18.28458,1815
32691,247189,417408FFDA93B177641D270D3A5C4B2D,30854,9,12,3,109.56889,18.27076,1763
32692,247190,417408FFDA93B177641D270D3A5C4B2D,31071,12,13,1,109.58257,18.28458,1815
32693,247191,417408FFDA93B177641D270D3A5C4B2D,30854,14,18,4,109.56889,18.27076,1763
32694,247192,417408FFDA93B177641D270D3A5C4B2D,31071,18,20,2,109.58257,18.28458,1815
32695,247193,417408FFDA93B177641D270D3A5C4B2D,30891,21,23,2,109.59431,18.28389,1865
32696,247203,C39A87B1BC9DA20E7546ED50A7A8B13C,30854,7,9,2,109.56889,18.27076,1763
32697,247207,7F83FE9CEAC12AB02197A912DB558E4C,30191,0,6,6,109.50361,18.22701,1506
32698,247208,7F83FE9CEAC12AB02197A912DB558E4C,31781,8,13,5,109.19847,18.2975,367
32699,247209,7F83FE9CEAC12AB02197A912DB558E4C,31521,14,15,1,109.51458,18.22542,1555
32700,247210,7F83FE9CEAC12AB02197A912DB558E4C,31521,16,18,2,109.51458,18.22542,1555
32701,247211,7F83FE9CEAC12AB02197A912DB558E4C,31521,19,20,1,109.51458,18.22542,1555
32705,247248,E484FD222AE68252EABA732103338917,31071,8,10,2,109.58257,18.28458,1815
32706,247249,E484FD222AE68252EABA732103338917,30854,13,16,3,109.56889,18.27076,1763
32707,247250,E484FD222AE68252EABA732103338917,31071,16,18,2,109.58257,18.28458,1815
32708,247251,E484FD222AE68252EABA732103338917,31071,21,23,2,109.58257,18.28458,1815
32709,247252,6E3295BE038630AA5C3C9528B9405511,60381,0,1,1,109.5241,18.22458,1605
32710,247253,6E3295BE038630AA5C3C9528B9405511,38117,1,2,1,109.51611,18.22354,1555
32711,247254,6E3295BE038630AA5C3C9528B9405511,39321,5,7,2,109.529,18.2167,1604
32712,247255,6E3295BE038630AA5C3C9528B9405511,31781,11,13,2,109.19847,18.2975,367
32713,247256,6E3295BE038630AA5C3C9528B9405511,60381,16,17,1,109.5241,18.22458,1605
32714,247272,EFFEF00C078D502D6D0D1D469ACBA466,30421,0,7,7,109.50021,18.25861,1511
32715,247273,EFFEF00C078D502D6D0D1D469ACBA466,39371,9,11,2,109.56627,18.2646,1762
32716,247274,EFFEF00C078D502D6D0D1D469ACBA466,38325,13,14,1,109.39792,18.2909,1116
32717,247275,EFFEF00C078D502D6D0D1D469ACBA466,30421,19,22,3,109.50021,18.25861,1511
32721,247294,D4448A1349B0563C78F16B479359A95F,30854,14,16,2,109.56889,18.27076,1763
32722,247295,D4448A1349B0563C78F16B479359A95F,31071,19,21,2,109.58257,18.28458,1815
32723,247311,FD20A7AF137B3BF6EC80FAD25D4BEAFA,31206,18,20,2,109.50819,18.23549,1507
32724,247312,FD20A7AF137B3BF6EC80FAD25D4BEAFA,30711,21,23,2,109.50271,18.25347,1510
32728,247328,8DD23AA43C0F7967C45F7488D66F9159,31071,0,3,3,109.58257,18.28458,1815
32729,247329,8DD23AA43C0F7967C45F7488D66F9159,30854,3,4,1,109.56889,18.27076,1763
32730,247330,8DD23AA43C0F7967C45F7488D66F9159,39371,5,6,1,109.56627,18.2646,1762
32731,247331,8DD23AA43C0F7967C45F7488D66F9159,30854,7,21,14,109.56889,18.27076,1763
32732,247332,8DD23AA43C0F7967C45F7488D66F9159,30851,22,23,1,109.5616,18.27396,1713
32736,247380,E4617DCF84AE9969BA971CE4779E46DF,38484,0,10,10,109.53028,18.31528,1620
32737,247381,E4617DCF84AE9969BA971CE4779E46DF,39151,12,13,1,109.49875,18.25097,1510
32738,247382,E4617DCF84AE9969BA971CE4779E46DF,38484,14,16,2,109.53028,18.31528,1620
32749,247440,215C928B327B7E5094BF191870565A5D,39151,3,7,4,109.49875,18.25097,1510
32750,247441,215C928B327B7E5094BF191870565A5D,60201,7,15,8,109.5041,18.2509,1510
32754,247475,EE0804F129D0F96C287A44865905653C,38251,9,10,1,109.49618,18.25493,1510
32761,247522,A64F0864B99B42C4602C17C645042912,30921,0,10,10,109.53903,18.29451,1667
32762,247523,A64F0864B99B42C4602C17C645042912,31931,11,20,9,109.54771,18.29403,1667
32763,247524,3A887AE7038DEACD71C8879078F4404A,31031,0,12,12,109.49979,18.25382,1510
32764,247525,3A887AE7038DEACD71C8879078F4404A,30351,15,17,2,109.41701,18.29292,1217
32765,247526,3A887AE7038DEACD71C8879078F4404A,31031,19,22,3,109.49979,18.25382,1510
32766,247527,C21D2EC796F0044DE4CA162C449C4B3B,30854,13,15,2,109.56889,18.27076,1763
32767,247528,C21D2EC796F0044DE4CA162C449C4B3B,60631,17,18,1,109.57778,18.27583,1814
32768,247545,8F0EF70AFA814412ECB04C3460518F08,38145,0,7,7,109.378,18.2912,1066
32769,247546,8F0EF70AFA814412ECB04C3460518F08,38027,7,8,1,109.38833,18.2909,1066
32770,247547,8F0EF70AFA814412ECB04C3460518F08,38027,9,10,1,109.38833,18.2909,1066
32771,247548,8F0EF70AFA814412ECB04C3460518F08,38301,13,15,2,109.38632,18.29104,1066
32772,247549,8F0EF70AFA814412ECB04C3460518F08,38027,15,19,4,109.38833,18.2909,1066
32773,247550,8F0EF70AFA814412ECB04C3460518F08,31671,19,20,1,109.38965,18.29813,1068
32774,247551,8F0EF70AFA814412ECB04C3460518F08,38027,21,23,2,109.38833,18.2909,1066
32775,247566,88ED3F2D6DF6080D65EC7DC0BC60DC48,30854,12,16,4,109.56889,18.27076,1763
32776,247567,88ED3F2D6DF6080D65EC7DC0BC60DC48,39151,19,20,1,109.49875,18.25097,1510
32777,247606,928DF0385E8541CFD2F5858501C04155,30234,0,7,7,109.60681,18.29979,1918
32778,247607,928DF0385E8541CFD2F5858501C04155,30854,8,21,13,109.56889,18.27076,1763
32782,247637,E16204D131FCD957D5ADB9592C1DD0ED,30151,18,19,1,109.50986,18.25083,1560
32783,247638,E16204D131FCD957D5ADB9592C1DD0ED,31561,21,23,2,109.56792,18.28479,1765
32784,247641,005F3AEFE6DBF371ED1FD57736434098,30854,11,19,8,109.56889,18.27076,1763
32785,247642,005F3AEFE6DBF371ED1FD57736434098,31071,20,21,1,109.58257,18.28458,1815
32786,247643,005F3AEFE6DBF371ED1FD57736434098,60631,21,23,2,109.57778,18.27583,1814
32790,247663,5FB3A2DA28B4E8800621337B3FFA5576,31671,11,12,1,109.38965,18.29813,1068
32791,247664,5FB3A2DA28B4E8800621337B3FFA5576,31471,13,15,2,109.34583,18.29563,917
32792,247665,5FB3A2DA28B4E8800621337B3FFA5576,31671,18,23,5,109.38965,18.29813,1068
32793,247672,F57902A58026464B5BDED6D5CB0C8C35,39151,0,9,9,109.49875,18.25097,1510
32794,247673,F57902A58026464B5BDED6D5CB0C8C35,31031,13,14,1,109.49979,18.25382,1510
32795,247674,F57902A58026464B5BDED6D5CB0C8C35,30201,16,18,2,109.4909,18.26465,1462
32796,247675,F57902A58026464B5BDED6D5CB0C8C35,60131,18,20,2,109.49819,18.24778,1509
32797,247676,F57902A58026464B5BDED6D5CB0C8C35,30161,20,23,3,109.50042,18.24389,1508
32798,247681,A249BB92E18839D454C438B797D69714,60311,0,4,4,109.52097,18.24319,1558
32802,247688,05DA91756164E5EE566D718E5FCD0EDE,30921,0,2,2,109.53903,18.29451,1667
32803,247689,05DA91756164E5EE566D718E5FCD0EDE,31931,2,6,4,109.54771,18.29403,1667
32804,247690,05DA91756164E5EE566D718E5FCD0EDE,33481,9,13,4,109.67278,18.41278,2187
32805,247691,05DA91756164E5EE566D718E5FCD0EDE,60241,16,18,2,109.53319,18.28667,1616
32806,247706,53875E69050EC42E511A64D3211FA7B3,30851,18,20,2,109.5616,18.27396,1713
32807,247707,53875E69050EC42E511A64D3211FA7B3,60631,21,22,1,109.57778,18.27583,1814
32811,247759,1DCF37EE2927C479B1032CB369D26049,30441,18,20,2,109.64021,18.25424,2010
32812,247760,1DCF37EE2927C479B1032CB369D26049,31531,21,23,2,109.49583,18.25972,1461
32826,247918,C51531E3BB1CF6B001516042658BD073,30361,0,7,7,109.50347,18.24,1508
32827,247919,C51531E3BB1CF6B001516042658BD073,31411,10,22,12,109.5016,18.23576,1507
32828,247938,5426296000364EE32711CD0E73D782C8,31561,13,16,3,109.56792,18.28479,1765
32829,247939,5426296000364EE32711CD0E73D782C8,31071,19,20,1,109.58257,18.28458,1815
32830,247940,5426296000364EE32711CD0E73D782C8,31561,22,23,1,109.56792,18.28479,1765
32831,247978,4D944399BAAD1AD37CC1D68A51FA53FD,30161,0,13,13,109.50042,18.24389,1508
32832,247980,4D944399BAAD1AD37CC1D68A51FA53FD,30161,20,23,3,109.50042,18.24389,1508
32833,247991,4995463B780282C9C030A19D9F49AEAC,31071,0,12,12,109.58257,18.28458,1815
32834,247992,4995463B780282C9C030A19D9F49AEAC,30854,14,16,2,109.56889,18.27076,1763
32835,248012,C46F5343DCC792762EF674294DA84608,30731,0,7,7,109.50944,18.22306,1555
32836,248013,C46F5343DCC792762EF674294DA84608,31521,8,9,1,109.51458,18.22542,1555
32841,248068,6FBDDF7419820F8908B8A8CE3C81E7C3,60401,8,11,3,109.47444,18.27583,1414
32842,248069,6FBDDF7419820F8908B8A8CE3C81E7C3,60621,14,18,4,109.48354,18.27451,1464
32846,248099,B9E4016373F9EAECBE9B1879E1F3B739,38165,1,8,7,109.44847,18.28896,1316
32847,248100,B9E4016373F9EAECBE9B1879E1F3B739,38361,12,13,1,109.43667,18.29201,1267
32848,248101,B9E4016373F9EAECBE9B1879E1F3B739,38391,14,15,1,109.44111,18.29083,1266
32849,248102,B9E4016373F9EAECBE9B1879E1F3B739,38165,18,19,1,109.44847,18.28896,1316
32850,248103,B9E4016373F9EAECBE9B1879E1F3B739,31701,20,21,1,109.44132,18.28833,1266
32851,248109,C860767955774E3494068CF38C009FB6,60391,0,9,9,109.47667,18.28757,1416
32852,248110,C860767955774E3494068CF38C009FB6,38291,12,13,1,109.51618,18.24313,1558
32853,248111,C860767955774E3494068CF38C009FB6,31061,13,19,6,109.53333,18.23257,1607
32854,248112,C860767955774E3494068CF38C009FB6,39151,21,23,2,109.49875,18.25097,1510
32855,248127,BD5AAE5CF6AC8F1E6005714E36EC9220,60131,0,20,20,109.49819,18.24778,1509
32856,248128,BD5AAE5CF6AC8F1E6005714E36EC9220,30511,21,22,1,109.51069,18.24208,1558
32857,248147,1D2F8DB1F8B6A2081E1A43DDF558491D,30071,15,18,3,109.52819,18.30472,1619
32858,248148,1D2F8DB1F8B6A2081E1A43DDF558491D,30741,18,21,3,109.49833,18.28681,1516
32859,248149,1D2F8DB1F8B6A2081E1A43DDF558491D,31951,22,23,1,109.52174,18.30299,1568
32860,248150,662D882A6A10D0E6C3566690F0A40636,30191,0,4,4,109.50361,18.22701,1506
32861,248151,662D882A6A10D0E6C3566690F0A40636,30854,8,10,2,109.56889,18.27076,1763
32862,248152,662D882A6A10D0E6C3566690F0A40636,31071,11,13,2,109.58257,18.28458,1815
32863,248153,35C6EDC8AAC6B5ABA770190223528BA2,60381,1,8,7,109.5241,18.22458,1605
32864,248154,35C6EDC8AAC6B5ABA770190223528BA2,31061,9,10,1,109.53333,18.23257,1607
32869,248229,D1EBD1A5A8A922DEF994C933F10DD8DB,31851,13,16,3,109.71736,18.29007,2316
32870,248230,D1EBD1A5A8A922DEF994C933F10DD8DB,31164,17,18,1,109.69993,18.27215,2263
32871,248241,77E0479537D8350123531CE1FA2E6649,60631,0,7,7,109.57778,18.27583,1814
32872,248242,77E0479537D8350123531CE1FA2E6649,60591,11,13,2,109.61118,18.21715,1904
32873,248243,77E0479537D8350123531CE1FA2E6649,31101,14,15,1,109.65389,18.23403,2057
32874,248244,77E0479537D8350123531CE1FA2E6649,60591,17,18,1,109.61118,18.21715,1904
32875,248245,77E0479537D8350123531CE1FA2E6649,30854,22,23,1,109.56889,18.27076,1763
32876,248249,CB54BD5ACB93CE60508AFE3883399EDE,30921,0,8,8,109.53903,18.29451,1667
32877,248250,CB54BD5ACB93CE60508AFE3883399EDE,31931,8,18,10,109.54771,18.29403,1667
32878,248265,2D39AE6120F2674000C6DBB8A6E572A0,31945,1,6,5,109.58021,18.29403,1817
32879,248266,2D39AE6120F2674000C6DBB8A6E572A0,30854,9,10,1,109.56889,18.27076,1763
32880,248281,F418DE163D69F8F4F422D7CC67E3A86A,60661,0,7,7,109.548,18.2377,1657
32881,248282,F418DE163D69F8F4F422D7CC67E3A86A,30084,9,10,1,109.50118,18.26972,1513
32882,248283,F418DE163D69F8F4F422D7CC67E3A86A,60641,11,12,1,109.53854,18.2359,1657
32883,248284,F418DE163D69F8F4F422D7CC67E3A86A,31061,13,15,2,109.53333,18.23257,1607
32884,248285,F418DE163D69F8F4F422D7CC67E3A86A,60381,18,19,1,109.5241,18.22458,1605
32885,248286,F418DE163D69F8F4F422D7CC67E3A86A,60661,20,23,3,109.548,18.2377,1657
32889,248307,B49997E558EBA6E6EDC3CFE777E3F80C,31931,15,16,1,109.54771,18.29403,1667
32890,248308,B49997E558EBA6E6EDC3CFE777E3F80C,30071,16,18,2,109.52819,18.30472,1619
32891,248309,B49997E558EBA6E6EDC3CFE777E3F80C,31561,19,21,2,109.56792,18.28479,1765
32896,248344,47D232A92516FC961C7881B5391F911A,60221,15,18,3,109.52569,18.29188,1616
32897,248345,47D232A92516FC961C7881B5391F911A,31031,18,20,2,109.49979,18.25382,1510
32898,248373,DC0EB400EA24BEE9EB39D315B0E6AEF0,31701,12,15,3,109.44132,18.28833,1266
32899,248375,DC0EB400EA24BEE9EB39D315B0E6AEF0,38316,22,23,1,109.48542,18.27424,1464
32900,248379,FFFC0994E5C15BDB165344716912442C,30854,0,1,1,109.56889,18.27076,1763
32901,248380,FFFC0994E5C15BDB165344716912442C,39371,2,4,2,109.56627,18.2646,1762
32902,248381,FFFC0994E5C15BDB165344716912442C,30854,4,6,2,109.56889,18.27076,1763
32903,248382,FFFC0994E5C15BDB165344716912442C,31554,7,18,11,109.55521,18.2459,1709
32904,248383,FFFC0994E5C15BDB165344716912442C,30854,20,22,2,109.56889,18.27076,1763
32908,248466,C3EF49B0098C6C3C4B26CC8869DE86AF,30854,0,6,6,109.56889,18.27076,1763
32909,248467,C3EF49B0098C6C3C4B26CC8869DE86AF,31761,8,9,1,109.60521,18.27965,1914
32910,248468,C3EF49B0098C6C3C4B26CC8869DE86AF,38271,12,15,3,109.62632,18.23049,1956
32911,248469,C3EF49B0098C6C3C4B26CC8869DE86AF,30854,16,23,7,109.56889,18.27076,1763
32912,248488,8AD9F37216B2D3FCE05CA77434307672,30741,0,9,9,109.49833,18.28681,1516
32913,248489,8AD9F37216B2D3FCE05CA77434307672,31851,13,15,2,109.71736,18.29007,2316
32914,248490,8AD9F37216B2D3FCE05CA77434307672,30711,19,21,2,109.50271,18.25347,1510
32915,248491,8AD9F37216B2D3FCE05CA77434307672,30741,21,23,2,109.49833,18.28681,1516
32928,248559,E8D51F8B53F290BFD73338AD2AD8C728,30854,6,9,3,109.56889,18.27076,1763
32929,248560,E8D51F8B53F290BFD73338AD2AD8C728,31561,13,18,5,109.56792,18.28479,1765
32930,248575,ADAF731053DBFEEA361A1E7F418AE4CE,31124,12,22,10,109.17069,18.35,276
32934,248581,D77A5C2E97A74D805A87772560CE2BFF,31421,1,5,4,109.55382,18.22347,1705
32935,248582,D77A5C2E97A74D805A87772560CE2BFF,60381,7,12,5,109.5241,18.22458,1605
32936,248583,D77A5C2E97A74D805A87772560CE2BFF,60661,12,13,1,109.548,18.2377,1657
32937,248584,D77A5C2E97A74D805A87772560CE2BFF,60381,14,18,4,109.5241,18.22458,1605
32938,248585,D77A5C2E97A74D805A87772560CE2BFF,39321,19,23,4,109.529,18.2167,1604
32939,248604,6345097D7939CBDA931E36976B04F54A,30671,0,8,8,109.43611,18.30139,1268
32940,248605,6345097D7939CBDA931E36976B04F54A,31301,9,12,3,109.14493,18.31222,170
32941,248626,B17D654C0C5F0BF2FDFE2DB8B9C0B83F,38153,15,16,1,109.51819,18.25736,1561
32942,248627,B17D654C0C5F0BF2FDFE2DB8B9C0B83F,31551,19,23,4,109.55868,18.24222,1708
32943,248679,23AF668A3BF61DB4555AFB95018A20E1,39183,0,10,10,109.55542,18.28208,1715
32944,248680,23AF668A3BF61DB4555AFB95018A20E1,31931,14,15,1,109.54771,18.29403,1667
32945,248686,C6DA185F5F0F58094C4390F3E9E2A3DE,31521,10,12,2,109.51458,18.22542,1555
32946,248687,C6DA185F5F0F58094C4390F3E9E2A3DE,31521,13,14,1,109.51458,18.22542,1555
32947,248688,C6DA185F5F0F58094C4390F3E9E2A3DE,38754,15,18,3,109.74667,18.37382,2430
32948,248689,C6DA185F5F0F58094C4390F3E9E2A3DE,31521,21,23,2,109.51458,18.22542,1555
32952,248776,F6C5549A66D77909CD4E9BDDA0C298A6,60381,0,8,8,109.5241,18.22458,1605
32953,248777,F6C5549A66D77909CD4E9BDDA0C298A6,38754,11,13,2,109.74667,18.37382,2430
32954,248778,F6C5549A66D77909CD4E9BDDA0C298A6,60381,14,23,9,109.5241,18.22458,1605
32955,248784,97DFCEF20461204135ADC6D971200EB4,30151,11,14,3,109.50986,18.25083,1560
32956,248811,47A18820FDA9856131F74091D44B6BCB,31071,1,5,4,109.58257,18.28458,1815
32957,248812,47A18820FDA9856131F74091D44B6BCB,31561,7,21,14,109.56792,18.28479,1765
32958,248875,A9FCE0049DB44FE004EAFBF5B783F4A5,31945,3,8,5,109.58021,18.29403,1817
32959,248876,A9FCE0049DB44FE004EAFBF5B783F4A5,30854,8,14,6,109.56889,18.27076,1763
32960,248877,A9FCE0049DB44FE004EAFBF5B783F4A5,31421,19,20,1,109.55382,18.22347,1705
32961,248901,A64494D6F3A0AF8BF93D9FAA1169011A,38811,13,18,5,109.50875,18.2175,1504
32962,248902,A64494D6F3A0AF8BF93D9FAA1169011A,31201,19,20,1,109.51042,18.23819,1558
32963,248903,A64494D6F3A0AF8BF93D9FAA1169011A,39154,22,23,1,109.50201,18.25681,1511
32964,248904,40222537E299DD1E80FAFC454D4AB30F,31071,0,1,1,109.58257,18.28458,1815
32965,248905,40222537E299DD1E80FAFC454D4AB30F,60354,3,5,2,109.58701,18.28521,1815
32966,248906,40222537E299DD1E80FAFC454D4AB30F,31071,6,8,2,109.58257,18.28458,1815
32967,248907,40222537E299DD1E80FAFC454D4AB30F,30854,16,17,1,109.56889,18.27076,1763
32968,248908,40222537E299DD1E80FAFC454D4AB30F,31071,17,19,2,109.58257,18.28458,1815
32972,248924,2CE19795F2549AFE8556FD3526787FA2,30851,13,15,2,109.5616,18.27396,1713
32973,248925,2CE19795F2549AFE8556FD3526787FA2,31561,16,17,1,109.56792,18.28479,1765
32974,248926,2CE19795F2549AFE8556FD3526787FA2,31071,20,21,1,109.58257,18.28458,1815
32975,248927,8E06EAC16B0EF776FA1BAAC5B9747325,30511,4,5,1,109.51069,18.24208,1558
32976,248928,8E06EAC16B0EF776FA1BAAC5B9747325,60114,7,18,11,109.73028,18.33847,2374
32977,248929,8E06EAC16B0EF776FA1BAAC5B9747325,30511,20,23,3,109.51069,18.24208,1558
32982,248934,7235BA08EE35A76A07D4EF6E9B8C7C54,31231,0,8,8,109.42597,18.29292,1217
32983,248935,7235BA08EE35A76A07D4EF6E9B8C7C54,60401,8,9,1,109.47444,18.27583,1414
32984,248936,7235BA08EE35A76A07D4EF6E9B8C7C54,60054,12,14,2,109.3016,18.31229,770
32985,248937,7235BA08EE35A76A07D4EF6E9B8C7C54,60084,18,19,1,109.4984,18.2334,1507
32990,248942,F01C629B7C3C6D21B5D0029F90433BD6,31181,15,17,2,109.50382,18.24813,1509
32991,248943,F01C629B7C3C6D21B5D0029F90433BD6,30361,17,20,3,109.50347,18.24,1508
32992,248944,F01C629B7C3C6D21B5D0029F90433BD6,31391,21,23,2,109.50382,18.24285,1508
32993,248945,29A908E24ED92D20D54AB211989C3B7F,30151,0,11,11,109.50986,18.25083,1560
32994,248946,29A908E24ED92D20D54AB211989C3B7F,31311,13,18,5,109.72299,18.27438,2364
32995,248947,29A908E24ED92D20D54AB211989C3B7F,30151,22,23,1,109.50986,18.25083,1560
32999,248963,015CDEB9169BCE5537ABAE49B6A63F2B,31071,1,6,5,109.58257,18.28458,1815
33000,248964,015CDEB9169BCE5537ABAE49B6A63F2B,30854,7,16,9,109.56889,18.27076,1763
33004,248994,E4D199FCE009427481C9D06B9609AB1E,31931,1,21,20,109.54771,18.29403,1667
33005,248995,E4D199FCE009427481C9D06B9609AB1E,60671,22,23,1,109.52979,18.31757,1621
33006,249002,7024F3A14F6F554DC6E80063E30315F0,30854,0,4,4,109.56889,18.27076,1763
33007,249003,7024F3A14F6F554DC6E80063E30315F0,31561,4,23,19,109.56792,18.28479,1765
33008,249029,C316CE65034FB3C77BE459147CBF943A,60291,0,7,7,109.50826,18.24639,1509
33009,249030,C316CE65034FB3C77BE459147CBF943A,30161,8,13,5,109.50042,18.24389,1508
33010,249031,C316CE65034FB3C77BE459147CBF943A,30161,14,15,1,109.50042,18.24389,1508
33011,249032,C316CE65034FB3C77BE459147CBF943A,31521,15,19,4,109.51458,18.22542,1555
33012,249033,C316CE65034FB3C77BE459147CBF943A,60291,21,23,2,109.50826,18.24639,1509
33016,249069,D6A345956751BA2ACC5430EDF68A104F,39181,0,8,8,109.55153,18.28035,1715
33017,249070,D6A345956751BA2ACC5430EDF68A104F,31931,10,22,12,109.54771,18.29403,1667
33018,249078,368F8386B4B30BA941A3FE088E284383,60381,0,8,8,109.5241,18.22458,1605
33019,249079,368F8386B4B30BA941A3FE088E284383,60171,9,11,2,109.51292,18.30694,1569
33020,249080,368F8386B4B30BA941A3FE088E284383,60381,14,23,9,109.5241,18.22458,1605
33021,249084,C1C49DF6492ABE12D028E9E9E32B69EC,38751,13,17,4,109.74903,18.37639,2481
33022,249085,C1C49DF6492ABE12D028E9E9E32B69EC,38751,20,23,3,109.74903,18.37639,2481
33023,249100,480F6CB671CBAC39FE514AA75FDFC7DA,31071,0,9,9,109.58257,18.28458,1815
33024,249101,480F6CB671CBAC39FE514AA75FDFC7DA,38751,12,17,5,109.74903,18.37639,2481
33025,249105,4DE3E9C2C0E7F48C3178063DD53BC336,30711,1,3,2,109.50271,18.25347,1510
33026,249106,4DE3E9C2C0E7F48C3178063DD53BC336,60241,5,14,9,109.53319,18.28667,1616
33027,249107,4DE3E9C2C0E7F48C3178063DD53BC336,31941,16,18,2,109.62451,18.31222,1970
33028,249108,4DE3E9C2C0E7F48C3178063DD53BC336,30191,19,20,1,109.50361,18.22701,1506
33039,249160,356E75600A8901067E9EDB6E5BE4617A,30021,9,10,1,109.12014,18.40986,86
33040,249161,356E75600A8901067E9EDB6E5BE4617A,38185,13,14,1,109.51333,18.27347,1563
33044,249231,6D02AB3E12E4EDF1821AFE48CDBCDAEC,38961,0,7,7,109.50847,18.23514,1507
33045,249232,6D02AB3E12E4EDF1821AFE48CDBCDAEC,31781,10,11,1,109.19847,18.2975,367
33046,249233,6D02AB3E12E4EDF1821AFE48CDBCDAEC,60411,12,13,1,109.32514,18.30854,869
33047,249234,6D02AB3E12E4EDF1821AFE48CDBCDAEC,31471,13,15,2,109.34583,18.29563,917
33048,249235,6D02AB3E12E4EDF1821AFE48CDBCDAEC,30361,19,20,1,109.50347,18.24,1508
33049,249236,6D02AB3E12E4EDF1821AFE48CDBCDAEC,31205,21,23,2,109.51111,18.23736,1557
33050,249237,71048DA762610C5657DD6D8242833DC9,39371,0,12,12,109.56627,18.2646,1762
33051,249238,71048DA762610C5657DD6D8242833DC9,30854,16,17,1,109.56889,18.27076,1763
33052,249256,54A6757CA4BF8A47C41CF1DDCA6EA505,30854,0,4,4,109.56889,18.27076,1763
33053,249258,54A6757CA4BF8A47C41CF1DDCA6EA505,30434,8,11,3,109.17083,18.35861,278
33054,249259,54A6757CA4BF8A47C41CF1DDCA6EA505,30854,13,17,4,109.56889,18.27076,1763
33058,249300,7EB52A3F4A5DBE03536C9A0833D21C62,31421,0,6,6,109.55382,18.22347,1705
33059,249301,7EB52A3F4A5DBE03536C9A0833D21C62,60071,10,14,4,109.75674,18.31583,2470
33060,249302,7EB52A3F4A5DBE03536C9A0833D21C62,30854,18,19,1,109.56889,18.27076,1763
33061,249303,7EB52A3F4A5DBE03536C9A0833D21C62,31521,21,23,2,109.51458,18.22542,1555
33062,249336,9C1407835BC54BEBDB541F52E1DA1820,61011,0,13,13,109.60653,18.19076,1900
33063,249359,C3A94957E1E7D6DF853752575E39572E,38361,17,23,6,109.43667,18.29201,1267
33064,249367,9051969BBCBF8B78870D88A07EF566D6,31701,15,16,1,109.44132,18.28833,1266
33065,249394,FE4417CAF3A5150C206378A6D3A89051,30921,1,2,1,109.53903,18.29451,1667
33066,249395,FE4417CAF3A5150C206378A6D3A89051,31931,2,6,4,109.54771,18.29403,1667
33067,249406,45A5987C18932F268DB10593230F9A7C,60231,14,16,2,109.49903,18.21972,1504
33068,249407,45A5987C18932F268DB10593230F9A7C,38251,17,22,5,109.49618,18.25493,1510
33076,249471,D8DA23A64562A02CC1EF1AE0493551E1,60541,12,14,2,109.4084,18.29208,1167
33077,249472,D8DA23A64562A02CC1EF1AE0493551E1,31471,14,15,1,109.34583,18.29563,917
33078,249473,D8DA23A64562A02CC1EF1AE0493551E1,38071,18,21,3,109.40722,18.30938,1169
33079,249497,CCCD2290FB632A48009771412BE68ADD,31561,2,13,11,109.56792,18.28479,1765
33080,249498,CCCD2290FB632A48009771412BE68ADD,30851,14,15,1,109.5616,18.27396,1713
33081,249499,680970852212DD0BF6E2D40630BA722B,30861,18,20,2,109.52722,18.22743,1606
33082,249509,DC29C676832347947F366933ECB88090,31561,0,20,20,109.56792,18.28479,1765
33083,249510,DC29C676832347947F366933ECB88090,38484,21,23,2,109.53028,18.31528,1620
33084,249517,71E594D6D69285F426A56C720984D655,38071,3,5,2,109.40722,18.30938,1169
33085,249518,71E594D6D69285F426A56C720984D655,30854,6,9,3,109.56889,18.27076,1763
33086,249519,71E594D6D69285F426A56C720984D655,60631,10,20,10,109.57778,18.27583,1814
33090,249542,2FE0F3A82C27452F04A6B927F514EFA7,31554,0,15,15,109.55521,18.2459,1709
33091,249543,2FE0F3A82C27452F04A6B927F514EFA7,31551,18,23,5,109.55868,18.24222,1708
33092,249600,9B49BEB65E16F10DE8E30D5D01D652E3,38154,19,20,1,109.5266,18.28278,1615
33093,249601,9B49BEB65E16F10DE8E30D5D01D652E3,31811,20,21,1,109.54201,18.31806,1671
33094,249602,1A64C98E678C33D33EBB9AF4943063A2,31271,20,21,1,109.48958,18.26257,1462
33095,249603,1A64C98E678C33D33EBB9AF4943063A2,30854,22,23,1,109.56889,18.27076,1763
33096,249612,EF24901D99384F703B20FE07F2784FA0,30101,0,7,7,109.57299,18.33333,1773
33097,249613,EF24901D99384F703B20FE07F2784FA0,31631,7,8,1,109.59542,18.36826,1879
33098,249614,EF24901D99384F703B20FE07F2784FA0,30101,10,11,1,109.57299,18.33333,1773
33099,249615,EF24901D99384F703B20FE07F2784FA0,31631,12,18,6,109.59542,18.36826,1879
33100,249616,EF24901D99384F703B20FE07F2784FA0,30101,18,23,5,109.57299,18.33333,1773
33101,249621,FE6A1003E9A2A3F2E79DF975FEE0245E,31554,0,7,7,109.55521,18.2459,1709
33102,249625,5262ABE790766FD3345CF84BDACCA78B,60501,10,12,2,109.48701,18.29021,1466
33106,249651,F5E480BCE870DAE347CB60AA32F4CA1B,31071,0,5,5,109.58257,18.28458,1815
33107,249652,F5E480BCE870DAE347CB60AA32F4CA1B,30854,7,11,4,109.56889,18.27076,1763
33108,249653,F5E480BCE870DAE347CB60AA32F4CA1B,30421,14,15,1,109.50021,18.25861,1511
33109,249669,020753EF78F0A0C39658113A3377EA1E,31561,0,6,6,109.56792,18.28479,1765
33110,249670,020753EF78F0A0C39658113A3377EA1E,31931,7,8,1,109.54771,18.29403,1667
33111,249671,020753EF78F0A0C39658113A3377EA1E,39183,8,10,2,109.55542,18.28208,1715
33112,249672,020753EF78F0A0C39658113A3377EA1E,31561,11,14,3,109.56792,18.28479,1765
33113,249673,020753EF78F0A0C39658113A3377EA1E,31931,14,15,1,109.54771,18.29403,1667
33114,249674,020753EF78F0A0C39658113A3377EA1E,31561,16,20,4,109.56792,18.28479,1765
33118,249683,DDE4D5D00B726E239E6B8A96A765D262,38105,0,7,7,109.40299,18.29229,1117
33119,249684,DDE4D5D00B726E239E6B8A96A765D262,31091,8,10,2,109.41201,18.31222,1170
33120,249685,DDE4D5D00B726E239E6B8A96A765D262,30731,11,13,2,109.50944,18.22306,1555
33121,249686,DDE4D5D00B726E239E6B8A96A765D262,60381,16,18,2,109.5241,18.22458,1605
33122,249702,1122041491C04B199A15F6E1E401D68F,38881,1,3,2,109.51618,18.26431,1562
33123,249703,1122041491C04B199A15F6E1E401D68F,30461,4,5,1,109.5116,18.26313,1562
33124,249704,1122041491C04B199A15F6E1E401D68F,60281,7,8,1,109.51743,18.25924,1561
33125,249705,1122041491C04B199A15F6E1E401D68F,31031,9,10,1,109.49979,18.25382,1510
33126,249706,1122041491C04B199A15F6E1E401D68F,60291,15,17,2,109.50826,18.24639,1509
33127,249712,DF8390F1DCB42D608CF73F54089514BD,60371,0,3,3,109.53063,18.30056,1618
33128,249713,DF8390F1DCB42D608CF73F54089514BD,30071,3,6,3,109.52819,18.30472,1619
33129,249714,DF8390F1DCB42D608CF73F54089514BD,30851,9,10,1,109.5616,18.27396,1713
33130,249715,DF8390F1DCB42D608CF73F54089514BD,31561,12,15,3,109.56792,18.28479,1765
33131,249716,DF8390F1DCB42D608CF73F54089514BD,30851,17,20,3,109.5616,18.27396,1713
33132,249787,51061B3DE820AF1C1C713EF684728003,30854,9,21,12,109.56889,18.27076,1763
33133,249788,51061B3DE820AF1C1C713EF684728003,31071,21,23,2,109.58257,18.28458,1815
33137,249851,346507E97DF433BFFC969BAE643FC14C,31061,20,21,1,109.53333,18.23257,1607
33138,249852,346507E97DF433BFFC969BAE643FC14C,39154,22,23,1,109.50201,18.25681,1511
33142,249910,8B9A9BFD1ACAD480EB101A91DBF2024D,30371,14,16,2,109.51,18.24771,1559
33143,249911,8B9A9BFD1ACAD480EB101A91DBF2024D,38291,17,22,5,109.51618,18.24313,1558
33144,249916,43E035AE85036EBD9891453E9567CB81,30171,11,14,3,109.48458,18.27139,1463
33145,249917,43E035AE85036EBD9891453E9567CB81,38316,19,20,1,109.48542,18.27424,1464
33146,249918,43E035AE85036EBD9891453E9567CB81,30171,21,23,2,109.48458,18.27139,1463
33147,249938,F477CD0D1BA571DFDAA4F6B37DA3B938,38903,12,14,2,109.39229,18.29243,1117
33148,249939,F477CD0D1BA571DFDAA4F6B37DA3B938,60381,15,18,3,109.5241,18.22458,1605
33149,249940,F477CD0D1BA571DFDAA4F6B37DA3B938,38903,20,23,3,109.39229,18.29243,1117
33150,249965,71F956FFA2F92F0EAA3851BFD1FB3491,38162,14,15,1,109.43944,18.28889,1266
33151,249966,71F956FFA2F92F0EAA3851BFD1FB3491,31701,16,17,1,109.44132,18.28833,1266
33152,249989,92E14A6094471B9C1A50CE8585136EC6,30791,3,15,12,109.72333,18.40889,2386
33153,249990,92E14A6094471B9C1A50CE8585136EC6,60087,16,18,2,109.50688,18.22299,1505
33154,249991,92E14A6094471B9C1A50CE8585136EC6,30731,20,23,3,109.50944,18.22306,1555
33158,250023,5B025497FF30AC7A9FE53FC20E1F1A77,31945,12,15,3,109.58021,18.29403,1817
33159,250024,5B025497FF30AC7A9FE53FC20E1F1A77,30854,16,23,7,109.56889,18.27076,1763
33160,250031,189633BA4D39EBA8A203BC9E364D4B1F,30381,0,1,1,109.52521,18.24507,1609
33161,250032,189633BA4D39EBA8A203BC9E364D4B1F,38297,2,4,2,109.52576,18.24965,1609
33162,250033,189633BA4D39EBA8A203BC9E364D4B1F,30381,4,7,3,109.52521,18.24507,1609
33163,250034,189633BA4D39EBA8A203BC9E364D4B1F,30051,12,17,5,109.48917,18.21215,1453
33164,250035,189633BA4D39EBA8A203BC9E364D4B1F,30281,19,20,1,109.50597,18.27583,1514
33165,250036,189633BA4D39EBA8A203BC9E364D4B1F,30381,22,23,1,109.52521,18.24507,1609
33166,250040,B4122A296B24739BBA040B55E12FC1E8,31271,8,11,3,109.48958,18.26257,1462
33167,250041,B4122A296B24739BBA040B55E12FC1E8,60491,11,16,5,109.43354,18.30847,1269
33176,250127,ACAB8C7B92298FFCEC0006246A6D65D6,39183,0,10,10,109.55542,18.28208,1715
33177,250128,ACAB8C7B92298FFCEC0006246A6D65D6,31931,12,14,2,109.54771,18.29403,1667
33178,250129,9A0B6BA153A1BEC43BEEC25807F83E36,39181,0,8,8,109.55153,18.28035,1715
33179,250130,9A0B6BA153A1BEC43BEEC25807F83E36,60211,12,13,1,109.63549,18.26049,2011
33180,250153,1412BA3B65BC1A2354CCBE297098A0E1,31071,13,15,2,109.58257,18.28458,1815
33181,250154,1412BA3B65BC1A2354CCBE297098A0E1,30854,18,20,2,109.56889,18.27076,1763
33182,250173,74CA422FA73474DEA022E959D07273D0,31431,0,7,7,109.44639,18.29042,1316
33183,250174,74CA422FA73474DEA022E959D07273D0,31145,8,12,4,109.20431,18.30479,369
33184,250175,74CA422FA73474DEA022E959D07273D0,31431,17,23,6,109.44639,18.29042,1316
33188,250181,4D2B4F6ABE9B534A86E40EBE41504501,30271,0,8,8,109.49132,18.23153,1456
33189,250182,4D2B4F6ABE9B534A86E40EBE41504501,31145,12,14,2,109.20431,18.30479,369
33190,250183,4D2B4F6ABE9B534A86E40EBE41504501,30271,17,23,6,109.49132,18.23153,1456
33191,250184,1BAA4EB92824E45EC2E36C90288F6A84,30361,13,14,1,109.50347,18.24,1508
33192,250185,1BAA4EB92824E45EC2E36C90288F6A84,31201,15,16,1,109.51042,18.23819,1558
33193,250186,1BAA4EB92824E45EC2E36C90288F6A84,30181,18,19,1,109.51597,18.23313,1557
33194,250190,D1700FD0B8D8B8304DC420C1C5EAA5DF,31521,0,9,9,109.51458,18.22542,1555
33195,250191,D1700FD0B8D8B8304DC420C1C5EAA5DF,31521,9,13,4,109.51458,18.22542,1555
33196,250192,D1700FD0B8D8B8304DC420C1C5EAA5DF,60524,16,17,1,109.42951,18.28993,1216
33197,250193,D1700FD0B8D8B8304DC420C1C5EAA5DF,31521,18,23,5,109.51458,18.22542,1555
33198,250199,B64A5CE900AAEBADCEE980963A983652,30421,20,21,1,109.50021,18.25861,1511
33199,250200,B64A5CE900AAEBADCEE980963A983652,39154,22,23,1,109.50201,18.25681,1511
33200,250201,9AA959ED87D1ECC3053DED17290EFCBD,31561,20,21,1,109.56792,18.28479,1765
33201,250202,9AA959ED87D1ECC3053DED17290EFCBD,30854,21,23,2,109.56889,18.27076,1763
33202,250216,7890099D98AA300C5BF12527E7372DB0,30854,17,18,1,109.56889,18.27076,1763
33203,250217,7890099D98AA300C5BF12527E7372DB0,31071,19,20,1,109.58257,18.28458,1815
33204,250218,7890099D98AA300C5BF12527E7372DB0,30854,21,23,2,109.56889,18.27076,1763
33209,250258,C757F371202F08FFC057C6F0916CABAF,39181,0,9,9,109.55153,18.28035,1715
33210,250259,C757F371202F08FFC057C6F0916CABAF,30251,9,13,4,109.50611,18.26653,1512
33211,250260,C757F371202F08FFC057C6F0916CABAF,60281,13,15,2,109.51743,18.25924,1561
33212,250261,C757F371202F08FFC057C6F0916CABAF,31561,17,19,2,109.56792,18.28479,1765
33213,250262,C757F371202F08FFC057C6F0916CABAF,60671,21,23,2,109.52979,18.31757,1621
33218,250301,4995022FCBD847726F99CCAFCB44B40B,31021,19,21,2,109.49021,18.27,1463
33219,250302,4995022FCBD847726F99CCAFCB44B40B,30171,22,23,1,109.48458,18.27139,1463
33220,250335,5B5FB16F9BE2A1826D497C2695908410,31561,1,18,17,109.56792,18.28479,1765
33221,250336,5B5FB16F9BE2A1826D497C2695908410,31931,19,22,3,109.54771,18.29403,1667
33222,250337,4CC3058F56A42FB99DF66B1D4EA3395F,38251,19,20,1,109.49618,18.25493,1510
33223,250338,4CC3058F56A42FB99DF66B1D4EA3395F,38721,22,23,1,109.50368,18.27542,1514
33224,250372,769C1D2959A803615D424036A210FF8E,31231,0,8,8,109.42597,18.29292,1217
33225,250373,769C1D2959A803615D424036A210FF8E,31781,9,11,2,109.19847,18.2975,367
33226,250374,769C1D2959A803615D424036A210FF8E,31471,13,15,2,109.34583,18.29563,917
33227,250375,769C1D2959A803615D424036A210FF8E,31231,19,22,3,109.42597,18.29292,1217
33228,250405,3CF44FDCEEB2872CB96488ED4D42BF11,30371,18,23,5,109.51,18.24771,1559
33229,250414,C8922FAF66F21ECAECB6B717FCD5A53B,60391,2,3,1,109.47667,18.28757,1416
33230,250415,C8922FAF66F21ECAECB6B717FCD5A53B,60614,3,9,6,109.48799,18.29521,1467
33231,250416,C8922FAF66F21ECAECB6B717FCD5A53B,60391,9,11,2,109.47667,18.28757,1416
33232,250417,C8922FAF66F21ECAECB6B717FCD5A53B,60614,11,15,4,109.48799,18.29521,1467
33233,250418,C8922FAF66F21ECAECB6B717FCD5A53B,60391,17,19,2,109.47667,18.28757,1416
33234,250419,C8922FAF66F21ECAECB6B717FCD5A53B,60614,21,23,2,109.48799,18.29521,1467
33239,250429,95282C4B9C9218D16517DDF120466DDD,31271,0,7,7,109.48958,18.26257,1462
33240,250430,95282C4B9C9218D16517DDF120466DDD,39191,8,9,1,109.51493,18.23472,1557
33241,250431,95282C4B9C9218D16517DDF120466DDD,31231,10,11,1,109.42597,18.29292,1217
33242,250438,7D1ED6067ECBD941EFC43CE0A6ADAE71,30854,0,11,11,109.56889,18.27076,1763
33243,250439,7D1ED6067ECBD941EFC43CE0A6ADAE71,31071,12,17,5,109.58257,18.28458,1815
33244,250440,9E8746086915F9D4A063A74CF0B5B7AB,30854,17,18,1,109.56889,18.27076,1763
33245,250441,9E8746086915F9D4A063A74CF0B5B7AB,31561,18,19,1,109.56792,18.28479,1765
33246,250448,424101E7C02D0D0936011E209F4CA05E,31031,0,10,10,109.49979,18.25382,1510
33247,250449,424101E7C02D0D0936011E209F4CA05E,31101,11,13,2,109.65389,18.23403,2057
33248,250456,1A014D5097A523363D6AD8E40BC6F102,30161,19,20,1,109.50042,18.24389,1508
33249,250457,1A014D5097A523363D6AD8E40BC6F102,30771,20,22,2,109.49938,18.26042,1511
33250,250490,51DF765CB634D9549D20AD1F2C37BA18,31561,5,17,12,109.56792,18.28479,1765
33251,250491,51DF765CB634D9549D20AD1F2C37BA18,30854,18,19,1,109.56889,18.27076,1763
33255,250526,40C540F65657B427986BE1CE5332D3EA,31781,14,15,1,109.19847,18.2975,367
33256,250527,40C540F65657B427986BE1CE5332D3EA,30271,18,22,4,109.49132,18.23153,1456
33257,250528,CD7EA899C61E04F81B7437C6D410F253,31531,1,4,3,109.49583,18.25972,1461
33258,250529,CD7EA899C61E04F81B7437C6D410F253,31031,5,8,3,109.49979,18.25382,1510
33259,250530,CD7EA899C61E04F81B7437C6D410F253,31781,11,12,1,109.19847,18.2975,367
33260,250531,CD7EA899C61E04F81B7437C6D410F253,31471,13,15,2,109.34583,18.29563,917
33261,250532,CD7EA899C61E04F81B7437C6D410F253,30771,19,21,2,109.49938,18.26042,1511
33262,250562,E9E473F09C342630187345312F4A31D8,39181,0,8,8,109.55153,18.28035,1715
33263,250563,E9E473F09C342630187345312F4A31D8,31931,12,23,11,109.54771,18.29403,1667
33264,250587,79FD298D94ED606250C160861575CD8F,31554,16,19,3,109.55521,18.2459,1709
33265,250588,79FD298D94ED606250C160861575CD8F,31551,20,21,1,109.55868,18.24222,1708
33266,250604,166E7C87007490CCD3244B1CD8B43BF4,30854,14,18,4,109.56889,18.27076,1763
33267,250605,166E7C87007490CCD3244B1CD8B43BF4,31071,18,19,1,109.58257,18.28458,1815
33268,250606,166E7C87007490CCD3244B1CD8B43BF4,30854,19,21,2,109.56889,18.27076,1763
33269,250607,E75CF54BA14775FEDD26504F9F6B7365,31945,0,6,6,109.58021,18.29403,1817
33270,250608,E75CF54BA14775FEDD26504F9F6B7365,31561,7,8,1,109.56792,18.28479,1765
33271,250609,E75CF54BA14775FEDD26504F9F6B7365,30854,10,12,2,109.56889,18.27076,1763
33272,250610,E75CF54BA14775FEDD26504F9F6B7365,31561,12,17,5,109.56792,18.28479,1765
33273,250611,E75CF54BA14775FEDD26504F9F6B7365,31071,22,23,1,109.58257,18.28458,1815
33274,250612,00FC332040A284DA251A8D0705989FE9,31945,4,6,2,109.58021,18.29403,1817
33275,250613,00FC332040A284DA251A8D0705989FE9,30854,9,16,7,109.56889,18.27076,1763
33276,250616,788E7908839DB224D3AA84E576AF97F5,30921,1,6,5,109.53903,18.29451,1667
33277,250617,788E7908839DB224D3AA84E576AF97F5,60221,10,11,1,109.52569,18.29188,1616
33278,250625,8FFDB178B42E132A09286D0A8A4D99CA,31521,0,5,5,109.51458,18.22542,1555
33279,250626,8FFDB178B42E132A09286D0A8A4D99CA,31521,6,9,3,109.51458,18.22542,1555
33280,250627,8FFDB178B42E132A09286D0A8A4D99CA,60054,11,12,1,109.3016,18.31229,770
33281,250628,8FFDB178B42E132A09286D0A8A4D99CA,31781,14,16,2,109.19847,18.2975,367
33282,250629,8FFDB178B42E132A09286D0A8A4D99CA,31521,17,19,2,109.51458,18.22542,1555
33283,250630,8FFDB178B42E132A09286D0A8A4D99CA,31521,20,22,2,109.51458,18.22542,1555
33284,250638,71301D5A92E929B402E9BF477ED34700,31071,1,14,13,109.58257,18.28458,1815
33285,250639,71301D5A92E929B402E9BF477ED34700,30854,19,20,1,109.56889,18.27076,1763
33286,250645,5169AE4C4AE9067320D7FAAA8A39A4BE,31511,20,23,3,109.26326,18.40521,635
33293,250695,39F25FE146A03325C93C111F2A943B6C,31945,0,7,7,109.58021,18.29403,1817
33294,250696,39F25FE146A03325C93C111F2A943B6C,30854,7,8,1,109.56889,18.27076,1763
33295,250697,39F25FE146A03325C93C111F2A943B6C,31071,9,10,1,109.58257,18.28458,1815
33296,250698,39F25FE146A03325C93C111F2A943B6C,30854,14,16,2,109.56889,18.27076,1763
33297,250699,39F25FE146A03325C93C111F2A943B6C,31071,17,18,1,109.58257,18.28458,1815
33304,250726,4CA0AAFC0F7CF61913EEDBE418D853BD,60441,3,17,14,109.46792,18.28604,1366
33305,250727,4CA0AAFC0F7CF61913EEDBE418D853BD,60401,17,21,4,109.47444,18.27583,1414
33306,250762,AB8F95D841F69DCC3177A6274025E5E6,31931,14,19,5,109.54771,18.29403,1667
33307,250763,AB8F95D841F69DCC3177A6274025E5E6,30854,21,22,1,109.56889,18.27076,1763
33315,250843,EC4B90EDBF35256FDB4D4F8B87DB8A04,31071,2,5,3,109.58257,18.28458,1815
33316,250844,EC4B90EDBF35256FDB4D4F8B87DB8A04,30854,8,21,13,109.56889,18.27076,1763
33320,250883,0D69669D4DBC1CEB06269A084D86E853,30854,0,6,6,109.56889,18.27076,1763
33321,250884,0D69669D4DBC1CEB06269A084D86E853,30581,9,17,8,109.62257,18.24951,1959
33322,250920,D87CFD0B7BF12BC12310D3A55CC54E5C,38145,0,5,5,109.378,18.2912,1066
33323,250921,D87CFD0B7BF12BC12310D3A55CC54E5C,60561,5,8,3,109.38229,18.29785,1067
33324,250922,D87CFD0B7BF12BC12310D3A55CC54E5C,38023,9,10,1,109.37132,18.28993,1016
33325,250923,D87CFD0B7BF12BC12310D3A55CC54E5C,60021,15,16,1,109.23174,18.30146,468
33326,250924,D87CFD0B7BF12BC12310D3A55CC54E5C,38707,18,22,4,109.73778,18.35368,2427
33327,250967,C6579823835B85A254880E72927E82BB,30854,3,4,1,109.56889,18.27076,1763
33328,250968,C6579823835B85A254880E72927E82BB,30891,7,20,13,109.59431,18.28389,1865
33329,250985,301E657A2E52A15D5305B0C9B3D5B8BC,30921,0,9,9,109.53903,18.29451,1667
33330,250986,301E657A2E52A15D5305B0C9B3D5B8BC,31931,13,22,9,109.54771,18.29403,1667
33331,251028,A538A8C1144013F8D5F89234B7CAA827,38291,15,16,1,109.51618,18.24313,1558
33332,251034,1B810331266478325A9C525A64BDFAB6,30854,14,21,7,109.56889,18.27076,1763
33333,251085,14F1CC63CDA098F9694EAC8584B9C7A5,31071,9,10,1,109.58257,18.28458,1815
33334,251086,14F1CC63CDA098F9694EAC8584B9C7A5,30854,14,16,2,109.56889,18.27076,1763
33335,251087,14F1CC63CDA098F9694EAC8584B9C7A5,31561,20,21,1,109.56792,18.28479,1765
33336,251116,82FA50C876D91311B7DA8BB626927288,31761,1,6,5,109.60521,18.27965,1914
33337,251117,82FA50C876D91311B7DA8BB626927288,31071,7,8,1,109.58257,18.28458,1815
33338,251118,82FA50C876D91311B7DA8BB626927288,31271,12,13,1,109.48958,18.26257,1462
33339,251119,82FA50C876D91311B7DA8BB626927288,30854,17,18,1,109.56889,18.27076,1763
33340,251161,C8501DFE42E6954852B7593EDA5D3099,30151,14,15,1,109.50986,18.25083,1560
33341,251162,C8501DFE42E6954852B7593EDA5D3099,31351,16,17,1,109.4959,18.28417,1465
33342,251163,C8501DFE42E6954852B7593EDA5D3099,31421,19,20,1,109.55382,18.22347,1705
33343,251164,C8501DFE42E6954852B7593EDA5D3099,30111,21,22,1,109.47583,18.30542,1419
33344,251176,1D8B814EC83D52D7C5F3FED99C129EE0,30854,1,8,7,109.56889,18.27076,1763
33345,251177,1D8B814EC83D52D7C5F3FED99C129EE0,38271,10,20,10,109.62632,18.23049,1956
33346,251215,94809C00F2FF497D1CB05735B4C9C70D,39183,0,9,9,109.55542,18.28208,1715
33347,251216,94809C00F2FF497D1CB05735B4C9C70D,30854,13,23,10,109.56889,18.27076,1763
33348,251228,80D5971B84EF3A2477C3F057B855AF63,31071,0,14,14,109.58257,18.28458,1815
33349,251229,80D5971B84EF3A2477C3F057B855AF63,30854,15,20,5,109.56889,18.27076,1763
33354,251269,7C4B45B599684104AFE3AA992CD3924A,31761,0,6,6,109.60521,18.27965,1914
33355,251270,7C4B45B599684104AFE3AA992CD3924A,30811,8,10,2,109.65188,18.26257,2062
33356,251271,7C4B45B599684104AFE3AA992CD3924A,30711,12,15,3,109.50271,18.25347,1510
33357,251272,7C4B45B599684104AFE3AA992CD3924A,30811,18,19,1,109.65188,18.26257,2062
33358,251273,7C4B45B599684104AFE3AA992CD3924A,38127,21,23,2,109.50833,18.27222,1513
33359,251274,EC48DC043ECC2BB1E277836344D8B9F9,31071,2,8,6,109.58257,18.28458,1815
33360,251275,EC48DC043ECC2BB1E277836344D8B9F9,30854,10,23,13,109.56889,18.27076,1763
33361,251298,6BF671BC76B2463D72102139E4EB1018,38241,7,9,2,109.54111,18.30542,1669
33362,251299,6BF671BC76B2463D72102139E4EB1018,60371,10,11,1,109.53063,18.30056,1618
33363,251300,6BF671BC76B2463D72102139E4EB1018,38241,13,15,2,109.54111,18.30542,1669
33364,251301,6BF671BC76B2463D72102139E4EB1018,31931,18,22,4,109.54771,18.29403,1667
33365,251328,E6F79A5F6F7C034FE4F98780B21D590B,30281,18,23,5,109.50597,18.27583,1514
33374,251364,C462628FF36F8FF2D0B7493E6DDA38BB,30661,3,6,3,109.37028,18.24361,1008
33375,251365,C462628FF36F8FF2D0B7493E6DDA38BB,60411,8,10,2,109.32514,18.30854,869
33376,251366,C462628FF36F8FF2D0B7493E6DDA38BB,30661,11,12,1,109.37028,18.24361,1008
33377,251367,C462628FF36F8FF2D0B7493E6DDA38BB,60411,12,14,2,109.32514,18.30854,869
33378,251378,DE91F768E6CCDB78867FF54F078574C9,30854,2,17,15,109.56889,18.27076,1763
33379,251379,DE91F768E6CCDB78867FF54F078574C9,60463,19,21,2,109.52507,18.22438,1605
33380,251380,DE91F768E6CCDB78867FF54F078574C9,30854,22,23,1,109.56889,18.27076,1763
33384,251384,5EE25A6E7DD554FFDA0C9C1A504114B7,60381,1,7,6,109.5241,18.22458,1605
33385,251385,5EE25A6E7DD554FFDA0C9C1A504114B7,30221,12,23,11,109.57833,18.20222,1802
33386,251397,C0CA4E58B15F58D7F48B8BEF10CEB35A,30854,4,7,3,109.56889,18.27076,1763
33387,251398,C0CA4E58B15F58D7F48B8BEF10CEB35A,60591,12,16,4,109.61118,18.21715,1904
33388,251403,4027759DA4AA4E8EAD8331A27147F405,31071,0,10,10,109.58257,18.28458,1815
33389,251404,4027759DA4AA4E8EAD8331A27147F405,30854,13,23,10,109.56889,18.27076,1763
33390,251405,01B87D483E44795571C3E4AB55CA6210,60594,0,6,6,109.62694,18.22799,1956
33391,251406,01B87D483E44795571C3E4AB55CA6210,38331,6,8,2,109.62465,18.22736,1956
33392,251407,01B87D483E44795571C3E4AB55CA6210,31781,11,13,2,109.19847,18.2975,367
33393,251408,01B87D483E44795571C3E4AB55CA6210,38052,16,17,1,109.62618,18.23042,1956
33394,251409,01B87D483E44795571C3E4AB55CA6210,38331,19,23,4,109.62465,18.22736,1956
33395,251416,7BF65E5054DA81A230AB5423620158E1,31071,4,7,3,109.58257,18.28458,1815
33396,251417,7BF65E5054DA81A230AB5423620158E1,30854,9,23,14,109.56889,18.27076,1763
33397,251431,D1A5E6081E70F748BFD3C6895B141C01,31473,2,3,1,109.34792,18.29465,917
33398,251432,D1A5E6081E70F748BFD3C6895B141C01,60411,5,7,2,109.32514,18.30854,869
33399,251433,D1A5E6081E70F748BFD3C6895B141C01,30661,8,14,6,109.37028,18.24361,1008
33400,251434,D1A5E6081E70F748BFD3C6895B141C01,60411,18,21,3,109.32514,18.30854,869
33401,251465,A7B25709FE412024EFA55603332D5E9B,38951,0,1,1,109.48097,18.28868,1416
33402,251466,A7B25709FE412024EFA55603332D5E9B,38951,2,6,4,109.48097,18.28868,1416
33403,251467,A7B25709FE412024EFA55603332D5E9B,38951,7,8,1,109.48097,18.28868,1416
33404,251468,A7B25709FE412024EFA55603332D5E9B,30581,13,14,1,109.62257,18.24951,1959
33405,251469,A7B25709FE412024EFA55603332D5E9B,38951,19,21,2,109.48097,18.28868,1416
33406,251470,A7B25709FE412024EFA55603332D5E9B,38951,21,23,2,109.48097,18.28868,1416
33407,251479,D9E60CECBCF3335BA62A418C133E83E2,31145,10,14,4,109.20431,18.30479,369
33408,251480,D9E60CECBCF3335BA62A418C133E83E2,30731,15,16,1,109.50944,18.22306,1555
33409,251481,D9E60CECBCF3335BA62A418C133E83E2,31521,20,22,2,109.51458,18.22542,1555
33410,251495,AAC7E9546787DDB508C41969C1E453E7,30711,13,15,2,109.50271,18.25347,1510
33411,251496,AAC7E9546787DDB508C41969C1E453E7,30421,16,20,4,109.50021,18.25861,1511
33412,251497,AAC7E9546787DDB508C41969C1E453E7,39154,22,23,1,109.50201,18.25681,1511
33413,251542,FF898816F5AB968DB896F672436E99BE,31561,14,18,4,109.56792,18.28479,1765
33414,251543,FF898816F5AB968DB896F672436E99BE,30854,22,23,1,109.56889,18.27076,1763
33419,251566,41E1FA52CB6486CE3AFD44197134334F,38251,19,20,1,109.49618,18.25493,1510
33420,251567,41E1FA52CB6486CE3AFD44197134334F,30351,22,23,1,109.41701,18.29292,1217
33421,251588,6C0260646767B781577B5B8CE2471E51,60361,4,5,1,109.51938,18.29681,1567
33422,251589,6C0260646767B781577B5B8CE2471E51,38484,7,8,1,109.53028,18.31528,1620
33423,251590,6C0260646767B781577B5B8CE2471E51,38484,9,10,1,109.53028,18.31528,1620
33424,251591,6C0260646767B781577B5B8CE2471E51,38484,12,20,8,109.53028,18.31528,1620
33425,251592,6C0260646767B781577B5B8CE2471E51,31951,21,22,1,109.52174,18.30299,1568
33429,251614,5C2E5594DBCFD5372253A405BCF686FC,60401,6,7,1,109.47444,18.27583,1414
33430,251615,5C2E5594DBCFD5372253A405BCF686FC,31091,8,10,2,109.41201,18.31222,1170
33431,251616,5C2E5594DBCFD5372253A405BCF686FC,30581,11,12,1,109.62257,18.24951,1959
33432,251617,5C2E5594DBCFD5372253A405BCF686FC,60401,17,21,4,109.47444,18.27583,1414
33433,251618,B85E59A5F7A67DEC44CFA6188E05977A,30051,16,17,1,109.48917,18.21215,1453
33434,251619,B85E59A5F7A67DEC44CFA6188E05977A,38094,18,19,1,109.45403,18.28778,1316
33435,251620,B85E59A5F7A67DEC44CFA6188E05977A,38325,20,21,1,109.39792,18.2909,1116
33436,251621,B85E59A5F7A67DEC44CFA6188E05977A,60524,22,23,1,109.42951,18.28993,1216
33437,251627,8F6EA1C108FADA76A214A7ED71ECE3D1,30891,3,4,1,109.59431,18.28389,1865
33438,251628,8F6EA1C108FADA76A214A7ED71ECE3D1,30854,9,12,3,109.56889,18.27076,1763
33439,251629,8F6EA1C108FADA76A214A7ED71ECE3D1,30232,13,14,1,109.6191,18.31701,1971
33440,251630,8F6EA1C108FADA76A214A7ED71ECE3D1,30854,16,19,3,109.56889,18.27076,1763
33441,251631,8F6EA1C108FADA76A214A7ED71ECE3D1,30891,19,20,1,109.59431,18.28389,1865
33442,251715,CFFDD1BF3134B9FDD71614F40E1DE0FD,31071,7,8,1,109.58257,18.28458,1815
33443,251716,CFFDD1BF3134B9FDD71614F40E1DE0FD,30361,13,15,2,109.50347,18.24,1508
33444,251717,A88B35A7108477CCC954BD53412ECC82,60171,0,5,5,109.51292,18.30694,1569
33445,251718,A88B35A7108477CCC954BD53412ECC82,38991,8,9,1,109.52681,18.30368,1618
33446,251719,A88B35A7108477CCC954BD53412ECC82,60221,12,14,2,109.52569,18.29188,1616
33447,251720,A88B35A7108477CCC954BD53412ECC82,30071,17,18,1,109.52819,18.30472,1619
33448,251721,A88B35A7108477CCC954BD53412ECC82,31951,20,23,3,109.52174,18.30299,1568
33449,251729,8AABF5FDF2B06EB445749240A3894969,31071,0,7,7,109.58257,18.28458,1815
33450,251730,8AABF5FDF2B06EB445749240A3894969,30854,8,10,2,109.56889,18.27076,1763
33451,251731,8AABF5FDF2B06EB445749240A3894969,31071,10,11,1,109.58257,18.28458,1815
33452,251732,8AABF5FDF2B06EB445749240A3894969,30854,12,16,4,109.56889,18.27076,1763
33453,251733,8AABF5FDF2B06EB445749240A3894969,31851,16,18,2,109.71736,18.29007,2316
33454,251734,8AABF5FDF2B06EB445749240A3894969,31161,19,21,2,109.70229,18.31361,2270
33455,251763,22A8C784120E0ECB26B7876A46A934FF,31431,15,17,2,109.44639,18.29042,1316
33456,251764,22A8C784120E0ECB26B7876A46A934FF,30421,18,23,5,109.50021,18.25861,1511
33457,251765,B2035C0684FF9CA861B7EB217CE5A160,60041,2,3,1,109.39889,18.31944,1121
33458,251766,B2035C0684FF9CA861B7EB217CE5A160,60524,3,4,1,109.42951,18.28993,1216
33459,251767,B2035C0684FF9CA861B7EB217CE5A160,60041,5,6,1,109.39889,18.31944,1121
33460,251768,B2035C0684FF9CA861B7EB217CE5A160,31471,13,14,1,109.34583,18.29563,917
33461,251769,B2035C0684FF9CA861B7EB217CE5A160,60552,19,21,2,109.41729,18.30014,1218
33462,251770,B2035C0684FF9CA861B7EB217CE5A160,60331,21,23,2,109.505,18.26507,1512
33463,251780,A81CD054527D0434AE311D6C97FF6CEE,39281,15,18,3,109.21333,18.30271,418
33464,251781,A81CD054527D0434AE311D6C97FF6CEE,31251,18,20,2,109.18528,18.2975,317
33465,251796,2C303B1DBEEAF6FB7E8F89545513E0AE,30081,0,7,7,109.50243,18.26632,1512
33466,251797,2C303B1DBEEAF6FB7E8F89545513E0AE,39181,7,10,3,109.55153,18.28035,1715
33467,251798,2C303B1DBEEAF6FB7E8F89545513E0AE,30081,11,13,2,109.50243,18.26632,1512
33468,251799,2C303B1DBEEAF6FB7E8F89545513E0AE,31931,13,18,5,109.54771,18.29403,1667
33469,251800,2C303B1DBEEAF6FB7E8F89545513E0AE,30081,18,19,1,109.50243,18.26632,1512
33470,251801,2C303B1DBEEAF6FB7E8F89545513E0AE,31271,20,21,1,109.48958,18.26257,1462
33471,251802,2C303B1DBEEAF6FB7E8F89545513E0AE,30081,22,23,1,109.50243,18.26632,1512
33472,251821,FC8552628F8A5A5219C1C30314657039,60661,0,7,7,109.548,18.2377,1657
33473,251822,FC8552628F8A5A5219C1C30314657039,30421,9,10,1,109.50021,18.25861,1511
33474,251846,E8BAAF476E8FE57075BAB1A8D4FF1780,39371,0,2,2,109.56627,18.2646,1762
33475,251847,E8BAAF476E8FE57075BAB1A8D4FF1780,30232,3,13,10,109.6191,18.31701,1971
33476,251848,E8BAAF476E8FE57075BAB1A8D4FF1780,39371,15,18,3,109.56627,18.2646,1762
33477,251849,E8BAAF476E8FE57075BAB1A8D4FF1780,60381,19,20,1,109.5241,18.22458,1605
33478,251850,E8BAAF476E8FE57075BAB1A8D4FF1780,39371,21,22,1,109.56627,18.2646,1762
33483,251906,9A1D1AA5EE2CD156CC396C667ED8C5B9,31071,1,5,4,109.58257,18.28458,1815
33484,251907,9A1D1AA5EE2CD156CC396C667ED8C5B9,30854,8,9,1,109.56889,18.27076,1763
33485,251913,610275798AB59486D52727134DFD1B86,31206,1,6,5,109.50819,18.23549,1507
33486,251914,610275798AB59486D52727134DFD1B86,60084,6,8,2,109.4984,18.2334,1507
33487,251915,610275798AB59486D52727134DFD1B86,30181,11,12,1,109.51597,18.23313,1557
33488,251916,610275798AB59486D52727134DFD1B86,30191,14,16,2,109.50361,18.22701,1506
33489,251917,610275798AB59486D52727134DFD1B86,30421,18,20,2,109.50021,18.25861,1511
33490,251929,408C4FED868686E7B96333835F4C4205,60631,0,7,7,109.57778,18.27583,1814
33491,251930,408C4FED868686E7B96333835F4C4205,33521,9,12,3,109.66313,18.45174,2143
33492,251931,408C4FED868686E7B96333835F4C4205,30854,15,16,1,109.56889,18.27076,1763
33493,251932,408C4FED868686E7B96333835F4C4205,60631,21,23,2,109.57778,18.27583,1814
33494,251939,6532548CEFFF043086FECA37F4D65565,30854,10,11,1,109.56889,18.27076,1763
33495,251940,6532548CEFFF043086FECA37F4D65565,38315,13,16,3,109.48979,18.29764,1467
33496,251955,798BF3B08F72A16A6DEAAA235F1899BB,61011,4,20,16,109.60653,18.19076,1900
33497,251965,6C09CE755C8436D31143C1E3AA51623D,30854,12,14,2,109.56889,18.27076,1763
33498,251966,6C09CE755C8436D31143C1E3AA51623D,31071,17,18,1,109.58257,18.28458,1815
33499,252074,E4C7AB656E412C7E33554D18277C9478,60201,10,12,2,109.5041,18.2509,1510
33500,252075,E4C7AB656E412C7E33554D18277C9478,60291,12,22,10,109.50826,18.24639,1509
33501,252099,8401B75264E9301421036C68C0E8016B,38911,2,8,6,109.51674,18.24965,1559
33502,252100,8401B75264E9301421036C68C0E8016B,30151,10,11,1,109.50986,18.25083,1560
33503,252101,8401B75264E9301421036C68C0E8016B,38291,11,13,2,109.51618,18.24313,1558
33504,252102,8401B75264E9301421036C68C0E8016B,30071,17,19,2,109.52819,18.30472,1619
33505,252131,86D3006AEF049E89938D7A9A9936BB9C,31071,1,15,14,109.58257,18.28458,1815
33506,252132,86D3006AEF049E89938D7A9A9936BB9C,30854,19,20,1,109.56889,18.27076,1763
33507,252146,0ECAA77148BC3CC3B9A4A65F40F94BCA,31031,12,13,1,109.49979,18.25382,1510
33508,252147,0ECAA77148BC3CC3B9A4A65F40F94BCA,31031,15,18,3,109.49979,18.25382,1510
33509,252169,6751CEC3CF9B2AE78246C7287443D2B4,31945,0,5,5,109.58021,18.29403,1817
33510,252170,6751CEC3CF9B2AE78246C7287443D2B4,30854,9,18,9,109.56889,18.27076,1763
33511,252175,6751CEC3CF9B2AE78246C7287443D2B4,31071,2,7,5,109.58257,18.28458,1815
33512,252176,6751CEC3CF9B2AE78246C7287443D2B4,30854,7,9,2,109.56889,18.27076,1763
33513,252177,6751CEC3CF9B2AE78246C7287443D2B4,31071,12,15,3,109.58257,18.28458,1815
33514,252178,6751CEC3CF9B2AE78246C7287443D2B4,30854,16,18,2,109.56889,18.27076,1763
33515,252199,DC9885AE38AE7598214BC46FD2D819A5,38991,0,6,6,109.52681,18.30368,1618
33516,252200,DC9885AE38AE7598214BC46FD2D819A5,38171,6,9,3,109.50799,18.28139,1515
33517,252214,4D4289AE0DFBF4B5C79A47559DC2EBDD,39371,2,9,7,109.56627,18.2646,1762
33518,252215,4D4289AE0DFBF4B5C79A47559DC2EBDD,31071,9,11,2,109.58257,18.28458,1815
33519,252216,4D4289AE0DFBF4B5C79A47559DC2EBDD,30854,11,12,1,109.56889,18.27076,1763
33520,252217,4D4289AE0DFBF4B5C79A47559DC2EBDD,60381,13,19,6,109.5241,18.22458,1605
33521,252218,4D4289AE0DFBF4B5C79A47559DC2EBDD,39371,20,22,2,109.56627,18.2646,1762
33522,252219,59F29435D748531F416A4F1636997ECF,31071,0,1,1,109.58257,18.28458,1815
33523,252220,59F29435D748531F416A4F1636997ECF,31071,3,7,4,109.58257,18.28458,1815
33527,252250,69EA58E2C68065F45F7A1847747C7961,39191,0,5,5,109.51493,18.23472,1557
33528,252251,69EA58E2C68065F45F7A1847747C7961,38961,6,8,2,109.50847,18.23514,1507
33529,252252,69EA58E2C68065F45F7A1847747C7961,31781,11,13,2,109.19847,18.2975,367
33530,252276,CBEC85B23D166297F931D8AA26FC2B44,30421,17,19,2,109.50021,18.25861,1511
33531,252277,CBEC85B23D166297F931D8AA26FC2B44,38251,20,21,1,109.49618,18.25493,1510
33532,252287,522E8CB42AF22D75F3E9D0FD1FDCEEA6,39371,0,1,1,109.56627,18.2646,1762
33533,252288,522E8CB42AF22D75F3E9D0FD1FDCEEA6,30854,2,4,2,109.56889,18.27076,1763
33534,252289,522E8CB42AF22D75F3E9D0FD1FDCEEA6,39371,5,6,1,109.56627,18.2646,1762
33535,252290,522E8CB42AF22D75F3E9D0FD1FDCEEA6,30854,7,9,2,109.56889,18.27076,1763
33536,252291,522E8CB42AF22D75F3E9D0FD1FDCEEA6,39371,11,14,3,109.56627,18.2646,1762
33537,252341,5D5B29A994BBA3635D38463A75BE58F6,30201,0,7,7,109.4909,18.26465,1462
33538,252343,5D5B29A994BBA3635D38463A75BE58F6,30201,13,15,2,109.4909,18.26465,1462
33539,252366,2CF83F5125C6075E2ACA9C17C2979C64,30854,12,18,6,109.56889,18.27076,1763
33540,252367,2CF83F5125C6075E2ACA9C17C2979C64,31071,22,23,1,109.58257,18.28458,1815
33541,252378,16CCFF81838B15A70A44E8C4B6CCB914,60661,0,7,7,109.548,18.2377,1657
33542,252379,16CCFF81838B15A70A44E8C4B6CCB914,31461,8,9,1,109.5091,18.25389,1510
33543,252380,16CCFF81838B15A70A44E8C4B6CCB914,38171,13,14,1,109.50799,18.28139,1515
33544,252381,222E0B6922623CE9FBB280F81068D40E,38154,0,1,1,109.5266,18.28278,1615
33545,252382,222E0B6922623CE9FBB280F81068D40E,31521,2,8,6,109.51458,18.22542,1555
33546,252383,222E0B6922623CE9FBB280F81068D40E,30854,9,10,1,109.56889,18.27076,1763
33547,252384,222E0B6922623CE9FBB280F81068D40E,30321,14,15,1,109.49563,18.29611,1467
33548,252385,222E0B6922623CE9FBB280F81068D40E,31061,18,21,3,109.53333,18.23257,1607
33549,252407,2CDAE88307C6499C1237039C0E27A7F5,60261,0,6,6,109.44326,18.3075,1319
33550,252408,2CDAE88307C6499C1237039C0E27A7F5,31561,9,10,1,109.56792,18.28479,1765
33551,252409,2CDAE88307C6499C1237039C0E27A7F5,30851,12,14,2,109.5616,18.27396,1713
33552,252410,2CDAE88307C6499C1237039C0E27A7F5,60421,18,22,4,109.46333,18.31743,1371
33553,252417,A795428793D2273B4ACFDADC5E61AEC2,60381,14,16,2,109.5241,18.22458,1605
33554,252418,A795428793D2273B4ACFDADC5E61AEC2,60641,20,22,2,109.53854,18.2359,1657
33555,252430,14DD9E5DCCEFE8BE7425556E4E04FC9A,31561,0,5,5,109.56792,18.28479,1765
33556,252431,14DD9E5DCCEFE8BE7425556E4E04FC9A,30854,6,7,1,109.56889,18.27076,1763
33557,252432,14DD9E5DCCEFE8BE7425556E4E04FC9A,31071,10,12,2,109.58257,18.28458,1815
33558,252433,14DD9E5DCCEFE8BE7425556E4E04FC9A,31071,13,19,6,109.58257,18.28458,1815
33559,252434,14DD9E5DCCEFE8BE7425556E4E04FC9A,60354,20,23,3,109.58701,18.28521,1815
33560,252474,BB817C31A3F12EE16D15A558C65FED5B,31071,1,2,1,109.58257,18.28458,1815
33561,252475,BB817C31A3F12EE16D15A558C65FED5B,30854,5,6,1,109.56889,18.27076,1763
33562,252476,BB817C31A3F12EE16D15A558C65FED5B,31071,6,8,2,109.58257,18.28458,1815
33563,252477,BB817C31A3F12EE16D15A558C65FED5B,30854,11,20,9,109.56889,18.27076,1763
33564,252478,BB817C31A3F12EE16D15A558C65FED5B,31071,20,21,1,109.58257,18.28458,1815
33565,252480,F51750B4A76BF6CF96537CEE75AA6CF8,60161,21,22,1,109.49174,18.26181,1461
33570,252548,65AD296DD65C9EEA3C22EA02904A768E,31561,2,4,2,109.56792,18.28479,1765
33571,252549,65AD296DD65C9EEA3C22EA02904A768E,30854,9,15,6,109.56889,18.27076,1763
33572,252563,4A6E6277F47F7550E2618B9C1ADC3166,31391,14,16,2,109.50382,18.24285,1508
33573,252564,4A6E6277F47F7550E2618B9C1ADC3166,30711,17,18,1,109.50271,18.25347,1510
33574,252565,4A6E6277F47F7550E2618B9C1ADC3166,30361,20,23,3,109.50347,18.24,1508
33575,252580,BB31DF7CD95EBDC65D12089CF34DDE37,31521,0,6,6,109.51458,18.22542,1555
33579,252594,D4EE8E1A4C04A1FF0596E4221D0B8B42,30854,1,18,17,109.56889,18.27076,1763
33580,252595,D4EE8E1A4C04A1FF0596E4221D0B8B42,31071,21,22,1,109.58257,18.28458,1815
33584,252645,803884DAE228D36B780CDE250AFE5FD1,38911,15,18,3,109.51674,18.24965,1559
33585,252646,803884DAE228D36B780CDE250AFE5FD1,38251,21,23,2,109.49618,18.25493,1510
33595,252685,9B389AE8E9B004176803CCEAFF69104A,39371,0,6,6,109.56627,18.2646,1762
33596,252686,9B389AE8E9B004176803CCEAFF69104A,60631,7,10,3,109.57778,18.27583,1814
33597,252748,90F3300D143E0362CC2D61396D0D92D9,60054,2,4,2,109.3016,18.31229,770
33598,252749,90F3300D143E0362CC2D61396D0D92D9,60231,4,18,14,109.49903,18.21972,1504
33599,252750,106CA3A9375076B84A466DFC7E9F4CF9,30081,4,7,3,109.50243,18.26632,1512
33600,252751,106CA3A9375076B84A466DFC7E9F4CF9,60591,8,10,2,109.61118,18.21715,1904
33601,252752,106CA3A9375076B84A466DFC7E9F4CF9,38336,12,15,3,109.61111,18.21806,1904
33602,252753,139FA6FF337FC827A4AC3BA48C6CF2AF,60291,7,9,2,109.50826,18.24639,1509
33603,252754,139FA6FF337FC827A4AC3BA48C6CF2AF,60241,11,18,7,109.53319,18.28667,1616
33604,252818,5977B7597B86A7D3A555436201A15FE0,30711,0,6,6,109.50271,18.25347,1510
33605,252819,5977B7597B86A7D3A555436201A15FE0,60131,6,8,2,109.49819,18.24778,1509
33606,252820,5977B7597B86A7D3A555436201A15FE0,30421,11,12,1,109.50021,18.25861,1511
33607,252821,5977B7597B86A7D3A555436201A15FE0,31101,14,23,9,109.65389,18.23403,2057
33611,252865,E43761FEBE209371C105554567258124,31321,0,6,6,109.63799,18.23201,2007
33612,252866,E43761FEBE209371C105554567258124,31931,7,11,4,109.54771,18.29403,1667
33613,252867,E43761FEBE209371C105554567258124,31321,12,13,1,109.63799,18.23201,2007
33614,252868,E43761FEBE209371C105554567258124,31931,14,17,3,109.54771,18.29403,1667
33615,252869,E43761FEBE209371C105554567258124,60241,17,18,1,109.53319,18.28667,1616
33616,252870,E43761FEBE209371C105554567258124,31321,20,23,3,109.63799,18.23201,2007
33617,252904,3E0CC1F431A959DE24ABB41EC7702F6D,30351,0,1,1,109.41701,18.29292,1217
33618,252905,3E0CC1F431A959DE24ABB41EC7702F6D,60524,2,3,1,109.42951,18.28993,1216
33619,252906,3E0CC1F431A959DE24ABB41EC7702F6D,31231,4,6,2,109.42597,18.29292,1217
33620,252907,3E0CC1F431A959DE24ABB41EC7702F6D,60552,7,8,1,109.41729,18.30014,1218
33621,252908,3E0CC1F431A959DE24ABB41EC7702F6D,60071,12,16,4,109.75674,18.31583,2470
33622,252941,9DA18E32D5BC3B3B3E933A918C5F29CA,30151,0,14,14,109.50986,18.25083,1560
33623,252942,9DA18E32D5BC3B3B3E933A918C5F29CA,31461,14,16,2,109.5091,18.25389,1510
33624,252955,63CB222117AB8A54673799718246EF46,30391,18,19,1,109.4975,18.27118,1513
33625,252956,63CB222117AB8A54673799718246EF46,31864,20,21,1,109.49014,18.28333,1465
33630,252983,0CF6CC5FF24D6A6AB1B738BADBD1459E,31461,0,8,8,109.5091,18.25389,1510
33631,252984,0CF6CC5FF24D6A6AB1B738BADBD1459E,31471,11,15,4,109.34583,18.29563,917
33632,252985,0CF6CC5FF24D6A6AB1B738BADBD1459E,30151,16,17,1,109.50986,18.25083,1560
33633,253028,91F494773E6D64BA1F7E2CDDDA7EB44B,30721,0,8,8,109.51597,18.28257,1565
33634,253029,91F494773E6D64BA1F7E2CDDDA7EB44B,38127,8,11,3,109.50833,18.27222,1513
33639,253071,CBA29FB366E4111071C95C99C696D0E6,31321,7,16,9,109.63799,18.23201,2007
33640,253072,CBA29FB366E4111071C95C99C696D0E6,31561,19,20,1,109.56792,18.28479,1765
33641,253085,DD406D33A3DCAF10F3838DF55666D7A6,31431,0,7,7,109.44639,18.29042,1316
33642,253086,DD406D33A3DCAF10F3838DF55666D7A6,31181,8,10,2,109.50382,18.24813,1509
33643,253087,DD406D33A3DCAF10F3838DF55666D7A6,60504,12,13,1,109.47917,18.28903,1416
33644,253088,DD406D33A3DCAF10F3838DF55666D7A6,31461,17,20,3,109.5091,18.25389,1510
33645,253089,DD406D33A3DCAF10F3838DF55666D7A6,31201,20,22,2,109.51042,18.23819,1558
33646,253107,39B59369A593F4590BA7B46095F37DD4,30171,0,9,9,109.48458,18.27139,1463
33647,253108,39B59369A593F4590BA7B46095F37DD4,31471,10,12,2,109.34583,18.29563,917
33648,253109,39B59369A593F4590BA7B46095F37DD4,30661,14,16,2,109.37028,18.24361,1008
33649,253110,39B59369A593F4590BA7B46095F37DD4,30681,19,22,3,109.48493,18.26917,1463
33650,253123,CD3BCBAB8571FB81953C842A434E5DB8,31761,7,9,2,109.60521,18.27965,1914
33651,253124,CD3BCBAB8571FB81953C842A434E5DB8,31071,10,15,5,109.58257,18.28458,1815
33652,253125,CD3BCBAB8571FB81953C842A434E5DB8,31071,19,23,4,109.58257,18.28458,1815
33656,253196,2DDF3A993BD69F79020EB97CF3A71819,38171,0,7,7,109.50799,18.28139,1515
33657,253197,2DDF3A993BD69F79020EB97CF3A71819,30161,8,9,1,109.50042,18.24389,1508
33658,253198,2DDF3A993BD69F79020EB97CF3A71819,38171,13,15,2,109.50799,18.28139,1515
33659,253199,2DDF3A993BD69F79020EB97CF3A71819,30161,16,18,2,109.50042,18.24389,1508
33660,253200,2DDF3A993BD69F79020EB97CF3A71819,60463,20,21,1,109.52507,18.22438,1605
33661,253240,6EC37ACBAC0C5AEE7B19344F1CE4D7FD,60401,11,12,1,109.47444,18.27583,1414
33662,253241,6EC37ACBAC0C5AEE7B19344F1CE4D7FD,30171,15,19,4,109.48458,18.27139,1463
33663,253242,6EC37ACBAC0C5AEE7B19344F1CE4D7FD,60621,20,23,3,109.48354,18.27451,1464
33664,253299,5264833F0013AE6B294396000613EF89,31411,18,20,2,109.5016,18.23576,1507
33665,253300,5264833F0013AE6B294396000613EF89,31201,21,23,2,109.51042,18.23819,1558
33666,253312,993300654839821E7CBC0B1D6C1A4599,61011,1,4,3,109.60653,18.19076,1900
33667,253314,993300654839821E7CBC0B1D6C1A4599,61011,17,22,5,109.60653,18.19076,1900
33668,253330,ACDEAAF45B65DE48CF80A48DBD3C775E,30854,2,3,1,109.56889,18.27076,1763
33669,253331,ACDEAAF45B65DE48CF80A48DBD3C775E,31071,3,5,2,109.58257,18.28458,1815
33670,253332,ACDEAAF45B65DE48CF80A48DBD3C775E,30854,7,8,1,109.56889,18.27076,1763
33671,253333,ACDEAAF45B65DE48CF80A48DBD3C775E,31071,18,20,2,109.58257,18.28458,1815
33672,253334,ACDEAAF45B65DE48CF80A48DBD3C775E,30854,20,21,1,109.56889,18.27076,1763
33676,253340,3B6FF1F8D896A0A62DC7E65967011999,31561,0,19,19,109.56792,18.28479,1765
33677,253341,3B6FF1F8D896A0A62DC7E65967011999,39183,20,21,1,109.55542,18.28208,1715
33678,253356,7B1A07C39637E996C01DF0A3D287D3C6,31071,11,13,2,109.58257,18.28458,1815
33679,253357,7B1A07C39637E996C01DF0A3D287D3C6,39371,17,18,1,109.56627,18.2646,1762
33680,253358,7B1A07C39637E996C01DF0A3D287D3C6,30854,21,23,2,109.56889,18.27076,1763
33681,253361,DEEF519781F9588D37AD928845C2355A,39321,13,16,3,109.529,18.2167,1604
33682,253362,DEEF519781F9588D37AD928845C2355A,60381,19,21,2,109.5241,18.22458,1605
33683,253363,DEEF519781F9588D37AD928845C2355A,31521,21,23,2,109.51458,18.22542,1555
33684,253373,0312B43ACF9ED1D8304E325E851AEE29,31561,12,13,1,109.56792,18.28479,1765
33685,253374,0312B43ACF9ED1D8304E325E851AEE29,30851,13,15,2,109.5616,18.27396,1713
33686,253375,0312B43ACF9ED1D8304E325E851AEE29,31561,15,16,1,109.56792,18.28479,1765
33687,253440,C8135D3E403B7CC96352A41CBCD291A7,38241,0,6,6,109.54111,18.30542,1669
33688,253441,C8135D3E403B7CC96352A41CBCD291A7,31021,8,10,2,109.49021,18.27,1463
33689,253460,179FD4660C817BD29234A518F00339D3,39151,3,5,2,109.49875,18.25097,1510
33690,253461,179FD4660C817BD29234A518F00339D3,60231,5,8,3,109.49903,18.21972,1504
33691,253462,179FD4660C817BD29234A518F00339D3,60161,11,14,3,109.49174,18.26181,1461
33692,253463,179FD4660C817BD29234A518F00339D3,60231,14,16,2,109.49903,18.21972,1504
33693,253464,179FD4660C817BD29234A518F00339D3,30161,20,23,3,109.50042,18.24389,1508
33701,253495,7EB4F76900011DECC835981CBE847D5E,31561,12,15,3,109.56792,18.28479,1765
33702,253496,7EB4F76900011DECC835981CBE847D5E,30854,16,17,1,109.56889,18.27076,1763
33706,253543,CA3896FB33E9BC68E91955EDFF5D709B,60631,0,6,6,109.57778,18.27583,1814
33707,253544,CA3896FB33E9BC68E91955EDFF5D709B,30854,7,8,1,109.56889,18.27076,1763
33708,253549,64F4CDF664AA04E7B79DE93C57128CF6,31931,0,7,7,109.54771,18.29403,1667
33709,253550,64F4CDF664AA04E7B79DE93C57128CF6,31561,8,15,7,109.56792,18.28479,1765
33710,253603,A8B250EB4B4FCB9AA28B7DB7DA08558B,38157,1,3,2,109.51483,18.26958,1563
33711,253604,A8B250EB4B4FCB9AA28B7DB7DA08558B,38911,3,7,4,109.51674,18.24965,1559
33715,253682,C93386A9D86FE22A1FD4E5116045DD8D,31561,0,5,5,109.56792,18.28479,1765
33716,253683,C93386A9D86FE22A1FD4E5116045DD8D,30851,8,10,2,109.5616,18.27396,1713
33717,253684,C93386A9D86FE22A1FD4E5116045DD8D,31561,13,14,1,109.56792,18.28479,1765
33718,253685,C93386A9D86FE22A1FD4E5116045DD8D,30851,14,17,3,109.5616,18.27396,1713
33719,253686,C93386A9D86FE22A1FD4E5116045DD8D,31561,22,23,1,109.56792,18.28479,1765
33720,253739,01C3A40E8C2D18FB80BE4CD2C78B4B61,39151,0,4,4,109.49875,18.25097,1510
33721,253740,01C3A40E8C2D18FB80BE4CD2C78B4B61,30611,4,5,1,109.74958,18.40188,2485
33722,253755,3977578BE56276DA0700B04B81DC1356,30851,0,20,20,109.5616,18.27396,1713
33723,253756,3977578BE56276DA0700B04B81DC1356,31561,22,23,1,109.56792,18.28479,1765
33724,253775,1A5F33BA51312ECE9B56E6B834EAB28E,31071,18,19,1,109.58257,18.28458,1815
33725,253776,1A5F33BA51312ECE9B56E6B834EAB28E,31945,21,23,2,109.58021,18.29403,1817
33726,253831,0E129C09250C0D46273B4BD7E5225556,30151,0,7,7,109.50986,18.25083,1560
33727,253832,0E129C09250C0D46273B4BD7E5225556,60201,7,10,3,109.5041,18.2509,1510
33728,253833,0E129C09250C0D46273B4BD7E5225556,60401,11,17,6,109.47444,18.27583,1414
33729,253834,0E129C09250C0D46273B4BD7E5225556,38291,19,21,2,109.51618,18.24313,1558
33730,253835,0E129C09250C0D46273B4BD7E5225556,30151,22,23,1,109.50986,18.25083,1560
33731,253848,D3CC138F01596B858EB1ECAA73909436,31231,0,7,7,109.42597,18.29292,1217
33732,253849,D3CC138F01596B858EB1ECAA73909436,31521,12,14,2,109.51458,18.22542,1555
33733,253850,D3CC138F01596B858EB1ECAA73909436,38721,15,23,8,109.50368,18.27542,1514
33734,253896,4AB147D8833CB4682B303AB3B1B54716,31531,0,6,6,109.49583,18.25972,1461
33735,253897,4AB147D8833CB4682B303AB3B1B54716,30711,7,10,3,109.50271,18.25347,1510
33736,253898,4AB147D8833CB4682B303AB3B1B54716,30421,11,15,4,109.50021,18.25861,1511
33737,253899,4AB147D8833CB4682B303AB3B1B54716,30711,15,17,2,109.50271,18.25347,1510
33738,253900,4AB147D8833CB4682B303AB3B1B54716,30511,21,23,2,109.51069,18.24208,1558
33743,253919,451E2BF48CD7B253EB0892324E679BCC,60281,6,12,6,109.51743,18.25924,1561
33744,253920,451E2BF48CD7B253EB0892324E679BCC,38291,13,14,1,109.51618,18.24313,1558
33745,253921,451E2BF48CD7B253EB0892324E679BCC,60281,15,18,3,109.51743,18.25924,1561
33746,253922,451E2BF48CD7B253EB0892324E679BCC,38297,22,23,1,109.52576,18.24965,1609
33753,253944,25022AD294B6F87A9AD511C3C16A0BF7,31671,0,3,3,109.38965,18.29813,1068
33754,253945,25022AD294B6F87A9AD511C3C16A0BF7,30341,8,9,1,109.3625,18.29167,966
33755,253946,25022AD294B6F87A9AD511C3C16A0BF7,30661,11,13,2,109.37028,18.24361,1008
33756,253957,46D86CDF53B012A1EE50CB271AED98F8,38903,0,7,7,109.39229,18.29243,1117
33757,253958,46D86CDF53B012A1EE50CB271AED98F8,38325,7,10,3,109.39792,18.2909,1116
33758,253959,46D86CDF53B012A1EE50CB271AED98F8,30771,13,14,1,109.49938,18.26042,1511
33765,254001,40667E55EDAC334B8D18CEA71CBD34F4,31031,14,16,2,109.49979,18.25382,1510
33766,254002,40667E55EDAC334B8D18CEA71CBD34F4,30111,16,17,1,109.47583,18.30542,1419
33767,254003,40667E55EDAC334B8D18CEA71CBD34F4,31081,17,23,6,109.44639,18.30181,1318
33768,254007,F5CD8B129D27723E0AB5614F6CDDABBC,30671,0,7,7,109.43611,18.30139,1268
33769,254008,F5CD8B129D27723E0AB5614F6CDDABBC,30371,11,12,1,109.51,18.24771,1559
33770,254009,F5CD8B129D27723E0AB5614F6CDDABBC,31101,13,15,2,109.65389,18.23403,2057
33771,254016,EB86D6046E376669621AB1CCFD0E07BA,30351,0,3,3,109.41701,18.29292,1217
33772,254017,EB86D6046E376669621AB1CCFD0E07BA,60524,4,21,17,109.42951,18.28993,1216
33779,254048,866460FA5062A635337B6369BB2AADDA,30854,5,6,1,109.56889,18.27076,1763
33780,254049,866460FA5062A635337B6369BB2AADDA,30581,9,10,1,109.62257,18.24951,1959
33781,254050,866460FA5062A635337B6369BB2AADDA,31321,12,14,2,109.63799,18.23201,2007
33785,254102,D42D82F7F77C55013F0EAB7E35E2211F,31071,14,15,1,109.58257,18.28458,1815
33786,254103,D42D82F7F77C55013F0EAB7E35E2211F,30851,15,18,3,109.5616,18.27396,1713
33791,254111,348BC15248D83C0CF0D2494FAD03D52E,60084,12,13,1,109.4984,18.2334,1507
33792,254112,348BC15248D83C0CF0D2494FAD03D52E,38185,14,15,1,109.51333,18.27347,1563
33793,254127,40C57F24FE0409ABB752B2031C349577,38951,17,20,3,109.48097,18.28868,1416
33794,254128,40C57F24FE0409ABB752B2031C349577,38951,21,23,2,109.48097,18.28868,1416
33795,254142,6EE4BADDDC65BCBDC03FAC1E025EC013,31421,0,6,6,109.55382,18.22347,1705
33796,254143,6EE4BADDDC65BCBDC03FAC1E025EC013,31021,10,11,1,109.49021,18.27,1463
33797,254144,6EE4BADDDC65BCBDC03FAC1E025EC013,31421,12,18,6,109.55382,18.22347,1705
33798,254175,E1B4EE5B2DAE31219B37A92CAB40AC2A,30051,2,6,4,109.48917,18.21215,1453
33799,254176,E1B4EE5B2DAE31219B37A92CAB40AC2A,60231,6,12,6,109.49903,18.21972,1504
33800,254177,E1B4EE5B2DAE31219B37A92CAB40AC2A,31164,17,18,1,109.69993,18.27215,2263
33801,254178,E1B4EE5B2DAE31219B37A92CAB40AC2A,31311,19,23,4,109.72299,18.27438,2364
33805,254203,4BCFB9B7DA47F954D069C9FF9050BF88,60354,0,7,7,109.58701,18.28521,1815
33806,254204,4BCFB9B7DA47F954D069C9FF9050BF88,30854,12,13,1,109.56889,18.27076,1763
33813,254249,070984703178D21DC5287E457C03691A,31561,0,5,5,109.56792,18.28479,1765
33814,254250,070984703178D21DC5287E457C03691A,30851,6,7,1,109.5616,18.27396,1713
33815,254251,070984703178D21DC5287E457C03691A,31931,7,9,2,109.54771,18.29403,1667
33816,254252,070984703178D21DC5287E457C03691A,31561,11,14,3,109.56792,18.28479,1765
33817,254253,070984703178D21DC5287E457C03691A,39181,18,23,5,109.55153,18.28035,1715
33818,254298,FCC7FFA36CCAFA7D306338AD42FEB181,60401,0,5,5,109.47444,18.27583,1414
33819,254299,FCC7FFA36CCAFA7D306338AD42FEB181,60161,5,6,1,109.49174,18.26181,1461
33820,254343,7FF3C6569A3990C03CAF6C52D3C8BC6C,60241,1,16,15,109.53319,18.28667,1616
33821,254344,7FF3C6569A3990C03CAF6C52D3C8BC6C,30921,18,23,5,109.53903,18.29451,1667
33822,254361,F47C4E1E39056C43B0AD32AC994AB7C0,31931,0,18,18,109.54771,18.29403,1667
33823,254362,F47C4E1E39056C43B0AD32AC994AB7C0,60361,22,23,1,109.51938,18.29681,1567
33824,254415,30F5D42A1A8F1CF26F5C9617FCB06C4F,31931,14,18,4,109.54771,18.29403,1667
33825,254416,30F5D42A1A8F1CF26F5C9617FCB06C4F,31561,21,22,1,109.56792,18.28479,1765
33829,254469,EAD13A75363C2F507BC612C5DDC48D11,31071,0,7,7,109.58257,18.28458,1815
33830,254470,EAD13A75363C2F507BC612C5DDC48D11,30854,7,9,2,109.56889,18.27076,1763
33831,254471,EAD13A75363C2F507BC612C5DDC48D11,30731,13,15,2,109.50944,18.22306,1555
33836,254553,0F09C2BE6A190F4BF3D635D6A9F19FD3,60661,0,8,8,109.548,18.2377,1657
33837,254554,0F09C2BE6A190F4BF3D635D6A9F19FD3,60241,8,10,2,109.53319,18.28667,1616
33838,254555,0F09C2BE6A190F4BF3D635D6A9F19FD3,31391,10,11,1,109.50382,18.24285,1508
33839,254556,0F09C2BE6A190F4BF3D635D6A9F19FD3,60661,17,19,2,109.548,18.2377,1657
33840,254557,0F09C2BE6A190F4BF3D635D6A9F19FD3,60281,20,22,2,109.51743,18.25924,1561
33844,254648,52A2A4B81F4AA52093B9BBEA3C2A529D,30351,13,15,2,109.41701,18.29292,1217
33845,254649,52A2A4B81F4AA52093B9BBEA3C2A529D,31236,16,17,1,109.42965,18.29111,1216
33846,254650,52A2A4B81F4AA52093B9BBEA3C2A529D,31236,19,23,4,109.42965,18.29111,1216
33850,254697,F36C6564687A0314919430BBFB5CDF5A,31101,0,15,15,109.65389,18.23403,2057
33851,254698,F36C6564687A0314919430BBFB5CDF5A,31031,19,22,3,109.49979,18.25382,1510
33863,254754,7421066246AAD1C230E7E2A7ADF06E9D,60631,1,6,5,109.57778,18.27583,1814
33864,254755,7421066246AAD1C230E7E2A7ADF06E9D,30854,7,16,9,109.56889,18.27076,1763
33865,254756,7421066246AAD1C230E7E2A7ADF06E9D,31071,18,20,2,109.58257,18.28458,1815
33866,254757,7421066246AAD1C230E7E2A7ADF06E9D,30191,21,23,2,109.50361,18.22701,1506
33873,254781,1689A3686513311C5F0C7A0EDAD5A242,31931,18,19,1,109.54771,18.29403,1667
33874,254782,1689A3686513311C5F0C7A0EDAD5A242,60371,19,20,1,109.53063,18.30056,1618
33875,254783,1689A3686513311C5F0C7A0EDAD5A242,30921,22,23,1,109.53903,18.29451,1667
33876,254861,F866B6E34CEF853A6497211DD74A607E,31071,0,7,7,109.58257,18.28458,1815
33877,254862,F866B6E34CEF853A6497211DD74A607E,30711,7,12,5,109.50271,18.25347,1510
33882,254912,8DD23AA43C0F7967C45F7488D66F9159,30851,2,4,2,109.5616,18.27396,1713
33883,254913,8DD23AA43C0F7967C45F7488D66F9159,31071,5,6,1,109.58257,18.28458,1815
33884,254914,8DD23AA43C0F7967C45F7488D66F9159,30854,9,12,3,109.56889,18.27076,1763
33885,254915,8DD23AA43C0F7967C45F7488D66F9159,31071,18,19,1,109.58257,18.28458,1815
33886,254916,8DD23AA43C0F7967C45F7488D66F9159,30854,20,22,2,109.56889,18.27076,1763
33887,254923,147470AD3D3B8724582C30D5F244A8B6,60421,0,17,17,109.46333,18.31743,1371
33888,254924,147470AD3D3B8724582C30D5F244A8B6,30111,18,19,1,109.47583,18.30542,1419
33889,254964,EBD33964FCE275C1E00E1A22DCBD8F60,31931,13,16,3,109.54771,18.29403,1667
33890,254965,EBD33964FCE275C1E00E1A22DCBD8F60,30921,19,21,2,109.53903,18.29451,1667
33897,254993,C85D0B931BEF54F05B9ABBBB03212DB7,31561,7,9,2,109.56792,18.28479,1765
33898,254994,C85D0B931BEF54F05B9ABBBB03212DB7,30854,10,21,11,109.56889,18.27076,1763
33899,255032,C21D2EC796F0044DE4CA162C449C4B3B,31071,0,5,5,109.58257,18.28458,1815
33900,255033,C21D2EC796F0044DE4CA162C449C4B3B,30854,5,8,3,109.56889,18.27076,1763
33901,255034,C21D2EC796F0044DE4CA162C449C4B3B,30221,9,11,2,109.57833,18.20222,1802
33902,255035,C21D2EC796F0044DE4CA162C449C4B3B,30731,15,17,2,109.50944,18.22306,1555
33903,255054,7B2AEE2086698683607EDDDB4B678234,38154,0,13,13,109.5266,18.28278,1615
33904,255055,7B2AEE2086698683607EDDDB4B678234,60221,13,15,2,109.52569,18.29188,1616
33905,255062,410D55EA73A3884577B7B9B7E86B067E,30084,0,7,7,109.50118,18.26972,1513
33906,255063,410D55EA73A3884577B7B9B7E86B067E,30084,8,10,2,109.50118,18.26972,1513
33907,255064,410D55EA73A3884577B7B9B7E86B067E,30101,13,14,1,109.57299,18.33333,1773
33908,255071,6846D911A5FA1223889E01CD52440A91,31071,2,7,5,109.58257,18.28458,1815
33909,255072,6846D911A5FA1223889E01CD52440A91,30854,7,20,13,109.56889,18.27076,1763
33910,255073,6846D911A5FA1223889E01CD52440A91,30191,21,23,2,109.50361,18.22701,1506
33918,255126,75817DB682187A07461734D66E1E6492,60631,0,4,4,109.57778,18.27583,1814
33919,255127,75817DB682187A07461734D66E1E6492,30854,4,7,3,109.56889,18.27076,1763
33920,255128,75817DB682187A07461734D66E1E6492,31561,7,9,2,109.56792,18.28479,1765
33921,255129,75817DB682187A07461734D66E1E6492,30854,9,14,5,109.56889,18.27076,1763
33922,255130,75817DB682187A07461734D66E1E6492,31061,19,21,2,109.53333,18.23257,1607
33927,255181,21C679D1B9FF307EA1AC2A89744209FE,38291,0,9,9,109.51618,18.24313,1558
33928,255182,21C679D1B9FF307EA1AC2A89744209FE,60281,13,15,2,109.51743,18.25924,1561
33932,255212,A4C98A5BCABB1C0C8728FA75C4037070,31206,0,12,12,109.50819,18.23549,1507
33933,255213,A4C98A5BCABB1C0C8728FA75C4037070,31021,14,15,1,109.49021,18.27,1463
33934,255214,ABCD0851CC1C78BCD7AF6DBDF2F5DE49,30211,6,11,5,109.49882,18.23931,1508
33935,255215,ABCD0851CC1C78BCD7AF6DBDF2F5DE49,60041,11,13,2,109.39889,18.31944,1121
33936,255262,B643AC77F8D8498A9694D45BA8B0F75F,31561,4,5,1,109.56792,18.28479,1765
33937,255263,B643AC77F8D8498A9694D45BA8B0F75F,60631,5,16,11,109.57778,18.27583,1814
33938,255274,7252A0F90E29EC78621699C082578EF7,31361,0,6,6,109.47417,18.28292,1415
33939,255275,7252A0F90E29EC78621699C082578EF7,60504,8,16,8,109.47917,18.28903,1416
33940,255278,F73DB45474E9091AA79E623BDF11C321,31561,0,5,5,109.56792,18.28479,1765
33941,255279,F73DB45474E9091AA79E623BDF11C321,30851,6,17,11,109.5616,18.27396,1713
33942,255359,4D5F13041F22071C2B5C93BBDF1863E3,30951,13,15,2,109.56208,18.25667,1761
33943,255360,4D5F13041F22071C2B5C93BBDF1863E3,31421,15,17,2,109.55382,18.22347,1705
33944,255361,4D5F13041F22071C2B5C93BBDF1863E3,30854,18,19,1,109.56889,18.27076,1763
33945,255362,4D5F13041F22071C2B5C93BBDF1863E3,60131,20,21,1,109.49819,18.24778,1509
33949,255412,BD85969D888F94131C562624432FF75B,30854,5,8,3,109.56889,18.27076,1763
33950,255413,BD85969D888F94131C562624432FF75B,30221,10,13,3,109.57833,18.20222,1802
33951,255414,BD85969D888F94131C562624432FF75B,31071,15,23,8,109.58257,18.28458,1815
33952,255438,B340EDEF4A878E8DF5CBEC25E465EACE,31071,0,7,7,109.58257,18.28458,1815
33953,255439,B340EDEF4A878E8DF5CBEC25E465EACE,60631,9,10,1,109.57778,18.27583,1814
33954,255440,B340EDEF4A878E8DF5CBEC25E465EACE,31071,11,12,1,109.58257,18.28458,1815
33955,255441,B340EDEF4A878E8DF5CBEC25E465EACE,30854,12,13,1,109.56889,18.27076,1763
33956,255443,B340EDEF4A878E8DF5CBEC25E465EACE,31164,19,20,1,109.69993,18.27215,2263
33957,255469,B9E4016373F9EAECBE9B1879E1F3B739,60291,16,17,1,109.50826,18.24639,1509
33958,255470,B9E4016373F9EAECBE9B1879E1F3B739,31431,18,19,1,109.44639,18.29042,1316
33959,255471,B9E4016373F9EAECBE9B1879E1F3B739,31701,19,22,3,109.44132,18.28833,1266
33960,255495,BD5AAE5CF6AC8F1E6005714E36EC9220,39101,0,2,2,109.50132,18.24931,1509
33961,255496,BD5AAE5CF6AC8F1E6005714E36EC9220,39101,4,7,3,109.50132,18.24931,1509
33962,255497,BD5AAE5CF6AC8F1E6005714E36EC9220,30511,7,8,1,109.51069,18.24208,1558
33963,255498,BD5AAE5CF6AC8F1E6005714E36EC9220,60131,13,14,1,109.49819,18.24778,1509
33964,255499,BD5AAE5CF6AC8F1E6005714E36EC9220,60221,15,19,4,109.52569,18.29188,1616
33965,255500,BD5AAE5CF6AC8F1E6005714E36EC9220,60131,20,23,3,109.49819,18.24778,1509
33966,255501,7334BFE245C0E1675EC3C07645407CF3,31121,1,6,5,109.16292,18.37063,230
33967,255502,7334BFE245C0E1675EC3C07645407CF3,60054,7,16,9,109.3016,18.31229,770
33968,255507,8C5A16299A6D294198C90C34C25C5949,30854,12,17,5,109.56889,18.27076,1763
33969,255508,8C5A16299A6D294198C90C34C25C5949,31561,17,19,2,109.56792,18.28479,1765
33970,255515,3B2AB4D108FF2A2838F54611E6E21C22,60401,16,17,1,109.47444,18.27583,1414
33971,255516,3B2AB4D108FF2A2838F54611E6E21C22,38361,18,21,3,109.43667,18.29201,1267
33972,255517,3B2AB4D108FF2A2838F54611E6E21C22,38071,21,22,1,109.40722,18.30938,1169
33973,255518,0526FBDD03CECB7E3925506B4441EC17,30511,0,19,19,109.51069,18.24208,1558
33974,255519,0526FBDD03CECB7E3925506B4441EC17,31443,19,23,4,109.5116,18.24438,1559
33975,255520,CC3204A8217F846065F3857472A7A709,60524,3,8,5,109.42951,18.28993,1216
33976,255521,CC3204A8217F846065F3857472A7A709,30854,12,16,4,109.56889,18.27076,1763
33977,255522,CC3204A8217F846065F3857472A7A709,31561,20,23,3,109.56792,18.28479,1765
33978,255538,292F7AA5A13D44513985CC059AB0B0E9,30854,18,19,1,109.56889,18.27076,1763
33979,255539,292F7AA5A13D44513985CC059AB0B0E9,31071,20,23,3,109.58257,18.28458,1815
33980,255554,7EADF8FB347FDDDBCB094AA8D0A5E8F9,33051,15,16,1,109.6475,18.46618,2096
33981,255555,7EADF8FB347FDDDBCB094AA8D0A5E8F9,38951,20,23,3,109.48097,18.28868,1416
33982,255569,D1EBD1A5A8A922DEF994C933F10DD8DB,30161,14,15,1,109.50042,18.24389,1508
33983,255570,D1EBD1A5A8A922DEF994C933F10DD8DB,60131,20,23,3,109.49819,18.24778,1509
33984,255579,7D32C75E1D43B778466C6B80F3328830,31071,13,14,1,109.58257,18.28458,1815
33985,255580,7D32C75E1D43B778466C6B80F3328830,30854,14,18,4,109.56889,18.27076,1763
33986,255581,CB54BD5ACB93CE60508AFE3883399EDE,31931,2,3,1,109.54771,18.29403,1667
33987,255582,CB54BD5ACB93CE60508AFE3883399EDE,60241,7,8,1,109.53319,18.28667,1616
33988,255600,2D39AE6120F2674000C6DBB8A6E572A0,31071,0,7,7,109.58257,18.28458,1815
33989,255601,2D39AE6120F2674000C6DBB8A6E572A0,30854,7,19,12,109.56889,18.27076,1763
33990,255610,770A00BDAFE9BCA8C9E9FA68066EED7D,31561,17,19,2,109.56792,18.28479,1765
33991,255611,770A00BDAFE9BCA8C9E9FA68066EED7D,31071,20,23,3,109.58257,18.28458,1815
33992,255629,F7FA9EDDDD22A3605AF235C1758649A3,39321,1,8,7,109.529,18.2167,1604
33993,255630,F7FA9EDDDD22A3605AF235C1758649A3,31521,9,11,2,109.51458,18.22542,1555
33994,255631,F7FA9EDDDD22A3605AF235C1758649A3,60401,15,16,1,109.47444,18.27583,1414
33995,255680,FFFC0994E5C15BDB165344716912442C,39371,0,2,2,109.56627,18.2646,1762
33996,255681,FFFC0994E5C15BDB165344716912442C,30854,3,6,3,109.56889,18.27076,1763
33997,255682,FFFC0994E5C15BDB165344716912442C,31554,7,17,10,109.55521,18.2459,1709
33998,255683,FFFC0994E5C15BDB165344716912442C,31551,18,20,2,109.55868,18.24222,1708
33999,255684,FFFC0994E5C15BDB165344716912442C,39371,21,23,2,109.56627,18.2646,1762
34000,255708,46D3900FF4CD0CE137E6DB2E5BBC5B87,30854,0,5,5,109.56889,18.27076,1763
34001,255709,46D3900FF4CD0CE137E6DB2E5BBC5B87,31561,7,9,2,109.56792,18.28479,1765
34002,255710,46D3900FF4CD0CE137E6DB2E5BBC5B87,30854,10,11,1,109.56889,18.27076,1763
34003,255711,46D3900FF4CD0CE137E6DB2E5BBC5B87,31931,13,14,1,109.54771,18.29403,1667
34004,255712,46D3900FF4CD0CE137E6DB2E5BBC5B87,39183,19,23,4,109.55542,18.28208,1715
34005,255719,C3EF49B0098C6C3C4B26CC8869DE86AF,38271,13,15,2,109.62632,18.23049,1956
34006,255720,C3EF49B0098C6C3C4B26CC8869DE86AF,30854,16,17,1,109.56889,18.27076,1763
34014,255782,E8D51F8B53F290BFD73338AD2AD8C728,30851,14,15,1,109.5616,18.27396,1713
34015,255783,E8D51F8B53F290BFD73338AD2AD8C728,31561,18,20,2,109.56792,18.28479,1765
34016,255795,D77A5C2E97A74D805A87772560CE2BFF,39321,0,7,7,109.529,18.2167,1604
34017,255796,D77A5C2E97A74D805A87772560CE2BFF,60381,10,12,2,109.5241,18.22458,1605
34018,255797,D77A5C2E97A74D805A87772560CE2BFF,60661,13,14,1,109.548,18.2377,1657
34019,255798,D77A5C2E97A74D805A87772560CE2BFF,31421,16,17,1,109.55382,18.22347,1705
34020,255799,D77A5C2E97A74D805A87772560CE2BFF,39321,18,23,5,109.529,18.2167,1604
34021,255808,FACA7C472055342CB52356ECCA18D789,30771,18,20,2,109.49938,18.26042,1511
34022,255809,FACA7C472055342CB52356ECCA18D789,31461,21,23,2,109.5091,18.25389,1510
34023,255853,16B2859E8374D62B4663118E0A8B2252,60501,11,12,1,109.48701,18.29021,1466
34027,255858,23AF668A3BF61DB4555AFB95018A20E1,31931,11,12,1,109.54771,18.29403,1667
34028,255859,23AF668A3BF61DB4555AFB95018A20E1,30851,13,14,1,109.5616,18.27396,1713
34029,255860,23AF668A3BF61DB4555AFB95018A20E1,39183,19,23,4,109.55542,18.28208,1715
34033,255915,0D3DA8126B134D203BB35373EAFFB116,31071,0,16,16,109.58257,18.28458,1815
34034,255916,0D3DA8126B134D203BB35373EAFFB116,31071,18,23,5,109.58257,18.28458,1815
34035,255928,D334753E33AD01D79142036B3D85543F,31931,13,15,2,109.54771,18.29403,1667
34036,255929,D334753E33AD01D79142036B3D85543F,31561,18,20,2,109.56792,18.28479,1765
34037,255994,FB5187175661EC895E80982358346864,31321,10,23,13,109.63799,18.23201,2007
34042,256005,B5CEF203D0E1B618DE0B5B0BA08CFDD8,60354,1,3,2,109.58701,18.28521,1815
34043,256006,B5CEF203D0E1B618DE0B5B0BA08CFDD8,31071,4,6,2,109.58257,18.28458,1815
34044,256007,B5CEF203D0E1B618DE0B5B0BA08CFDD8,30854,7,9,2,109.56889,18.27076,1763
34045,256008,B5CEF203D0E1B618DE0B5B0BA08CFDD8,30731,12,16,4,109.50944,18.22306,1555
34046,256013,201045A9C980BD8E53B16B9129DFE596,30854,13,17,4,109.56889,18.27076,1763
34047,256014,201045A9C980BD8E53B16B9129DFE596,31071,17,23,6,109.58257,18.28458,1815
34051,256022,015CDEB9169BCE5537ABAE49B6A63F2B,31071,1,5,4,109.58257,18.28458,1815
34052,256023,015CDEB9169BCE5537ABAE49B6A63F2B,30854,8,21,13,109.56889,18.27076,1763
34056,256031,E4D199FCE009427481C9D06B9609AB1E,60671,1,6,5,109.52979,18.31757,1621
34057,256032,E4D199FCE009427481C9D06B9609AB1E,31931,6,7,1,109.54771,18.29403,1667
34058,256033,E4D199FCE009427481C9D06B9609AB1E,60671,8,10,2,109.52979,18.31757,1621
34059,256034,E4D199FCE009427481C9D06B9609AB1E,31931,11,17,6,109.54771,18.29403,1667
34060,256035,E4D199FCE009427481C9D06B9609AB1E,39181,20,21,1,109.55153,18.28035,1715
34065,256065,833001CDF394BB3F6E4F040C2A70AC27,31071,1,16,15,109.58257,18.28458,1815
34066,256066,833001CDF394BB3F6E4F040C2A70AC27,30854,16,18,2,109.56889,18.27076,1763
34070,256076,F6B0C4B9BFBC5C0F5D704098C64B8B01,31864,11,12,1,109.49014,18.28333,1465
34071,256077,F6B0C4B9BFBC5C0F5D704098C64B8B01,30201,14,15,1,109.4909,18.26465,1462
34078,256109,8C0E6B51FAFE21C31FB9AE08C36DF0A2,30371,14,15,1,109.51,18.24771,1559
34079,256110,8C0E6B51FAFE21C31FB9AE08C36DF0A2,30921,19,23,4,109.53903,18.29451,1667
34080,256122,934029FB5F97BCE114EDCE88F0393A63,39371,0,7,7,109.56627,18.2646,1762
34081,256123,934029FB5F97BCE114EDCE88F0393A63,30854,9,22,13,109.56889,18.27076,1763
34085,256161,AA17C9279A63248D7DCDF49F93EB8817,30854,0,5,5,109.56889,18.27076,1763
34086,256162,AA17C9279A63248D7DCDF49F93EB8817,38275,9,17,8,109.62875,18.22938,2006
34087,256191,B93185B4820D7E0DEE74EBEA00941D15,30371,0,9,9,109.51,18.24771,1559
34088,256192,B93185B4820D7E0DEE74EBEA00941D15,30911,10,11,1,109.50493,18.26181,1511
34089,256193,B93185B4820D7E0DEE74EBEA00941D15,60201,11,13,2,109.5041,18.2509,1510
34090,256194,B93185B4820D7E0DEE74EBEA00941D15,30911,13,15,2,109.50493,18.26181,1511
34091,256195,B93185B4820D7E0DEE74EBEA00941D15,60201,18,20,2,109.5041,18.2509,1510
34092,256207,455A82AACA188D6F7BC0FB53DB8E23C1,31161,18,23,5,109.70229,18.31361,2270
34096,256306,7B9D64657CE26DF907B4C2AC87C9F431,31931,1,4,3,109.54771,18.29403,1667
34097,256307,7B9D64657CE26DF907B4C2AC87C9F431,38241,7,15,8,109.54111,18.30542,1669
34102,256368,2FE0F3A82C27452F04A6B927F514EFA7,31551,0,8,8,109.55868,18.24222,1708
34103,256369,2FE0F3A82C27452F04A6B927F514EFA7,31554,9,11,2,109.55521,18.2459,1709
34104,256371,2FE0F3A82C27452F04A6B927F514EFA7,31841,21,22,1,109.73201,18.33382,2373
34105,256402,1A64C98E678C33D33EBB9AF4943063A2,31071,1,2,1,109.58257,18.28458,1815
34106,256403,1A64C98E678C33D33EBB9AF4943063A2,39371,5,6,1,109.56627,18.2646,1762
34110,256450,020753EF78F0A0C39658113A3377EA1E,31561,0,6,6,109.56792,18.28479,1765
34111,256451,020753EF78F0A0C39658113A3377EA1E,31931,7,15,8,109.54771,18.29403,1667
34112,256461,1122041491C04B199A15F6E1E401D68F,31261,15,18,3,109.51174,18.2466,1559
34113,256462,1122041491C04B199A15F6E1E401D68F,30461,21,23,2,109.5116,18.26313,1562
34114,256491,76F6A54588C8DF7DDADFC50CAA11D44C,31071,2,11,9,109.58257,18.28458,1815
34115,256492,76F6A54588C8DF7DDADFC50CAA11D44C,38085,16,22,6,109.6291,18.23625,2007
34116,256516,63F3396E81ABDC9FBFF9C1CFE997FF69,48574,9,17,8,109.48931,18.28458,1465
34117,256517,63F3396E81ABDC9FBFF9C1CFE997FF69,31041,19,20,1,109.50278,18.23701,1507
34118,256520,5056B3DD1B49217356D6750375F238B9,38325,0,8,8,109.39792,18.2909,1116
34119,256553,1DC4D3E6415CD2F16BAC0F0FD6BEA638,60371,0,7,7,109.53063,18.30056,1618
34120,256554,1DC4D3E6415CD2F16BAC0F0FD6BEA638,31461,8,13,5,109.5091,18.25389,1510
34121,256555,1DC4D3E6415CD2F16BAC0F0FD6BEA638,38751,13,15,2,109.74903,18.37639,2481
34122,256567,4E8D795F40D47DACACC3FDDF22027131,31931,16,17,1,109.54771,18.29403,1667
34123,256568,4E8D795F40D47DACACC3FDDF22027131,31041,21,22,1,109.50278,18.23701,1507
34124,256574,1980C8D409DE9551539224B3D393CDAA,30071,6,8,2,109.52819,18.30472,1619
34125,256575,1980C8D409DE9551539224B3D393CDAA,31951,8,10,2,109.52174,18.30299,1568
34126,256576,1980C8D409DE9551539224B3D393CDAA,30071,10,16,6,109.52819,18.30472,1619
34130,256607,CE9457D3E3C1E3CCC08B3BEEFAB57B0C,30391,0,8,8,109.4975,18.27118,1513
34131,256616,5C3AF23B43D26582C5A8FB4D1CB9A5DB,60281,19,21,2,109.51743,18.25924,1561
34132,256617,5C3AF23B43D26582C5A8FB4D1CB9A5DB,38105,21,23,2,109.40299,18.29229,1117
34140,256657,71F956FFA2F92F0EAA3851BFD1FB3491,31701,19,21,2,109.44132,18.28833,1266
34141,256658,71F956FFA2F92F0EAA3851BFD1FB3491,38162,21,22,1,109.43944,18.28889,1266
34142,256735,189633BA4D39EBA8A203BC9E364D4B1F,60231,13,17,4,109.49903,18.21972,1504
34143,256736,189633BA4D39EBA8A203BC9E364D4B1F,30151,21,23,2,109.50986,18.25083,1560
34155,256829,6422CB87ACC55DDEF6EBE8946593C808,60231,12,17,5,109.49903,18.21972,1504
34156,256830,6422CB87ACC55DDEF6EBE8946593C808,31351,19,23,4,109.4959,18.28417,1465
34157,256851,A60AFDDB15A742DA3A715B1BA7F8BDC8,60081,0,6,6,109.51097,18.22639,1556
34158,256852,A60AFDDB15A742DA3A715B1BA7F8BDC8,30181,7,8,1,109.51597,18.23313,1557
34159,256853,A60AFDDB15A742DA3A715B1BA7F8BDC8,30661,10,13,3,109.37028,18.24361,1008
34160,256854,A60AFDDB15A742DA3A715B1BA7F8BDC8,30421,18,20,2,109.50021,18.25861,1511
34161,256855,A60AFDDB15A742DA3A715B1BA7F8BDC8,31031,21,22,1,109.49979,18.25382,1510
34166,256882,9EBFE19AEC38C3A6F47AE2D903294BAE,31071,0,6,6,109.58257,18.28458,1815
34167,256883,9EBFE19AEC38C3A6F47AE2D903294BAE,30854,6,12,6,109.56889,18.27076,1763
34183,256991,69F4307E378774E8E49F5A5A6F5C64A6,60241,0,15,15,109.53319,18.28667,1616
34184,256992,69F4307E378774E8E49F5A5A6F5C64A6,30921,19,22,3,109.53903,18.29451,1667
34189,257038,9E8746086915F9D4A063A74CF0B5B7AB,39183,19,20,1,109.55542,18.28208,1715
34190,257039,9E8746086915F9D4A063A74CF0B5B7AB,31561,21,23,2,109.56792,18.28479,1765
34191,257127,6FD88D74D66E8FAB66A93CB5D0609C41,30854,11,15,4,109.56889,18.27076,1763
34192,257128,6FD88D74D66E8FAB66A93CB5D0609C41,39371,18,21,3,109.56627,18.2646,1762
34196,257159,166E7C87007490CCD3244B1CD8B43BF4,30854,0,2,2,109.56889,18.27076,1763
34197,257160,166E7C87007490CCD3244B1CD8B43BF4,31071,3,5,2,109.58257,18.28458,1815
34198,257161,166E7C87007490CCD3244B1CD8B43BF4,30854,5,9,4,109.56889,18.27076,1763
34199,257162,166E7C87007490CCD3244B1CD8B43BF4,31071,11,13,2,109.58257,18.28458,1815
34200,257163,166E7C87007490CCD3244B1CD8B43BF4,31071,13,15,2,109.58257,18.28458,1815
34201,257164,166E7C87007490CCD3244B1CD8B43BF4,60354,16,17,1,109.58701,18.28521,1815
34202,257165,166E7C87007490CCD3244B1CD8B43BF4,31071,22,23,1,109.58257,18.28458,1815
34207,257188,71301D5A92E929B402E9BF477ED34700,30854,4,8,4,109.56889,18.27076,1763
34208,257189,71301D5A92E929B402E9BF477ED34700,30731,9,16,7,109.50944,18.22306,1555
34213,257217,31A35D1F4FE97CCC4436EF0B61B8BAAF,60411,1,3,2,109.32514,18.30854,869
34214,257218,31A35D1F4FE97CCC4436EF0B61B8BAAF,30511,4,7,3,109.51069,18.24208,1558
34215,257219,31A35D1F4FE97CCC4436EF0B61B8BAAF,30711,7,12,5,109.50271,18.25347,1510
34216,257220,31A35D1F4FE97CCC4436EF0B61B8BAAF,30511,15,17,2,109.51069,18.24208,1558
34217,257221,31A35D1F4FE97CCC4436EF0B61B8BAAF,31031,18,23,5,109.49979,18.25382,1510
34218,257235,2AE38FAF341950B0B91404FFCE5A0F3E,31931,4,6,2,109.54771,18.29403,1667
34219,257236,2AE38FAF341950B0B91404FFCE5A0F3E,60241,9,15,6,109.53319,18.28667,1616
34223,257243,58418A9EA4A7DC03127CB79C039A5185,60354,0,10,10,109.58701,18.28521,1815
34224,257244,58418A9EA4A7DC03127CB79C039A5185,30854,12,14,2,109.56889,18.27076,1763
34225,257245,58418A9EA4A7DC03127CB79C039A5185,30421,19,21,2,109.50021,18.25861,1511
34226,257246,58418A9EA4A7DC03127CB79C039A5185,30771,22,23,1,109.49938,18.26042,1511
34227,257249,F3ADE38A6219C04719D8BAB38E16EC80,31701,18,22,4,109.44132,18.28833,1266
34234,257363,FDEFD8CE6000F3540C5597EAB2B625A9,30391,0,9,9,109.4975,18.27118,1513
34235,257372,F25C237DB3948CAE74585CD60FBB2501,30854,10,11,1,109.56889,18.27076,1763
34236,257373,F25C237DB3948CAE74585CD60FBB2501,31561,15,16,1,109.56792,18.28479,1765
34237,257374,F25C237DB3948CAE74585CD60FBB2501,39183,19,23,4,109.55542,18.28208,1715
34238,257405,C6579823835B85A254880E72927E82BB,31531,11,13,2,109.49583,18.25972,1461
34239,257406,C6579823835B85A254880E72927E82BB,39371,15,18,3,109.56627,18.2646,1762
34240,257407,C6579823835B85A254880E72927E82BB,60381,20,22,2,109.5241,18.22458,1605
34241,257436,2C7DB696A14A5E061C2912E5376233C9,31071,0,5,5,109.58257,18.28458,1815
34242,257437,2C7DB696A14A5E061C2912E5376233C9,30854,5,9,4,109.56889,18.27076,1763
34243,257438,2C7DB696A14A5E061C2912E5376233C9,31071,11,12,1,109.58257,18.28458,1815
34244,257439,2C7DB696A14A5E061C2912E5376233C9,31071,12,16,4,109.58257,18.28458,1815
34245,257440,2C7DB696A14A5E061C2912E5376233C9,39371,16,23,7,109.56627,18.2646,1762
34249,257478,994DC93B9722A2091C776CECB337EA56,30181,15,16,1,109.51597,18.23313,1557
34250,257479,994DC93B9722A2091C776CECB337EA56,31421,17,23,6,109.55382,18.22347,1705
34251,257547,14F1CC63CDA098F9694EAC8584B9C7A5,31561,5,7,2,109.56792,18.28479,1765
34252,257548,14F1CC63CDA098F9694EAC8584B9C7A5,30854,7,21,14,109.56889,18.27076,1763
34256,257596,59BBE0E26F333D0DEE0C9B342559408B,30071,0,7,7,109.52819,18.30472,1619
34257,257597,59BBE0E26F333D0DEE0C9B342559408B,30371,8,10,2,109.51,18.24771,1559
34258,257598,59BBE0E26F333D0DEE0C9B342559408B,31471,15,16,1,109.34583,18.29563,917
34259,257599,59BBE0E26F333D0DEE0C9B342559408B,38484,21,23,2,109.53028,18.31528,1620
34260,257600,5C90AB97E54FA5E1554549C9409AC61B,30851,9,16,7,109.5616,18.27396,1713
34261,257601,5C90AB97E54FA5E1554549C9409AC61B,39183,18,23,5,109.55542,18.28208,1715
34262,257613,1D8B814EC83D52D7C5F3FED99C129EE0,30854,0,19,19,109.56889,18.27076,1763
34263,257614,1D8B814EC83D52D7C5F3FED99C129EE0,31071,22,23,1,109.58257,18.28458,1815
34274,257775,4027759DA4AA4E8EAD8331A27147F405,30854,7,8,1,109.56889,18.27076,1763
34275,257776,4027759DA4AA4E8EAD8331A27147F405,30731,12,13,1,109.50944,18.22306,1555
34276,257779,E7DB0F55EDE33BB4C08C98B80B7173BF,60371,0,6,6,109.53063,18.30056,1618
34277,257780,E7DB0F55EDE33BB4C08C98B80B7173BF,31811,7,8,1,109.54201,18.31806,1671
34278,257781,E7DB0F55EDE33BB4C08C98B80B7173BF,31071,11,13,2,109.58257,18.28458,1815
34279,257782,E7DB0F55EDE33BB4C08C98B80B7173BF,30711,14,15,1,109.50271,18.25347,1510
34280,257783,E7DB0F55EDE33BB4C08C98B80B7173BF,60371,20,23,3,109.53063,18.30056,1618
34284,257792,565E7A3B20C63D384DB57315C3ED30CC,30371,0,2,2,109.51,18.24771,1559
34285,257793,565E7A3B20C63D384DB57315C3ED30CC,30371,2,9,7,109.51,18.24771,1559
34286,257794,565E7A3B20C63D384DB57315C3ED30CC,38971,11,13,2,109.50743,18.25125,1510
34287,257795,565E7A3B20C63D384DB57315C3ED30CC,31811,18,19,1,109.54201,18.31806,1671
34288,257796,565E7A3B20C63D384DB57315C3ED30CC,60571,19,21,2,109.50722,18.25056,1510
34289,257797,565E7A3B20C63D384DB57315C3ED30CC,30151,21,23,2,109.50986,18.25083,1560
34293,257823,9352766CE000C006A9C46226806783DB,31561,0,1,1,109.56792,18.28479,1765
34294,257824,9352766CE000C006A9C46226806783DB,31071,2,7,5,109.58257,18.28458,1815
34295,257825,9352766CE000C006A9C46226806783DB,60541,10,23,13,109.4084,18.29208,1167
34296,257841,D9E60CECBCF3335BA62A418C133E83E2,39321,0,3,3,109.529,18.2167,1604
34297,257842,D9E60CECBCF3335BA62A418C133E83E2,38117,3,7,4,109.51611,18.22354,1555
34298,257843,D9E60CECBCF3335BA62A418C133E83E2,30731,8,14,6,109.50944,18.22306,1555
34299,257844,D9E60CECBCF3335BA62A418C133E83E2,60381,14,16,2,109.5241,18.22458,1605
34300,257845,D9E60CECBCF3335BA62A418C133E83E2,30731,18,19,1,109.50944,18.22306,1555
34301,257875,E2E58CCB11EC6D0A9D6583CCE0AE87DB,31931,12,13,1,109.54771,18.29403,1667
34302,257876,E2E58CCB11EC6D0A9D6583CCE0AE87DB,30071,18,23,5,109.52819,18.30472,1619
34303,257891,D330F554F47597493CAFD08520A037E1,30854,5,9,4,109.56889,18.27076,1763
34304,257892,D330F554F47597493CAFD08520A037E1,31101,10,23,13,109.65389,18.23403,2057
34305,257899,D11413926A77900569DEBC57CAD49AB3,60131,0,6,6,109.49819,18.24778,1509
34306,257900,D11413926A77900569DEBC57CAD49AB3,31411,6,9,3,109.5016,18.23576,1507
34307,257901,D11413926A77900569DEBC57CAD49AB3,31781,12,14,2,109.19847,18.2975,367
34308,257921,6C0260646767B781577B5B8CE2471E51,38484,8,11,3,109.53028,18.31528,1620
34309,257922,6C0260646767B781577B5B8CE2471E51,38484,14,17,3,109.53028,18.31528,1620
34310,257944,8F6EA1C108FADA76A214A7ED71ECE3D1,30891,0,4,4,109.59431,18.28389,1865
34311,257945,8F6EA1C108FADA76A214A7ED71ECE3D1,30854,6,12,6,109.56889,18.27076,1763
34328,258039,FE95B3A32EFBC2838F293DF38F55FDD1,31561,16,18,2,109.56792,18.28479,1765
34329,258040,FE95B3A32EFBC2838F293DF38F55FDD1,39183,19,23,4,109.55542,18.28208,1715
34334,258059,6129539226098723AEE329F9D345089D,31071,0,4,4,109.58257,18.28458,1815
34335,258060,6129539226098723AEE329F9D345089D,30854,4,6,2,109.56889,18.27076,1763
34336,258061,6129539226098723AEE329F9D345089D,30681,8,10,2,109.48493,18.26917,1463
34337,258062,6129539226098723AEE329F9D345089D,31071,15,16,1,109.58257,18.28458,1815
34338,258063,6129539226098723AEE329F9D345089D,30854,16,17,1,109.56889,18.27076,1763
34339,258064,6129539226098723AEE329F9D345089D,31945,22,23,1,109.58021,18.29403,1817
34343,258124,9A1D1AA5EE2CD156CC396C667ED8C5B9,31071,14,16,2,109.58257,18.28458,1815
34344,258125,9A1D1AA5EE2CD156CC396C667ED8C5B9,30854,20,22,2,109.56889,18.27076,1763
34351,258158,43A422D32148E3FF9BC0EC7D857AA8BB,60214,0,8,8,109.63104,18.24493,2009
34352,258159,43A422D32148E3FF9BC0EC7D857AA8BB,31521,12,15,3,109.51458,18.22542,1555
34353,258160,43A422D32148E3FF9BC0EC7D857AA8BB,31521,15,17,2,109.51458,18.22542,1555
34354,258161,43A422D32148E3FF9BC0EC7D857AA8BB,31521,18,23,5,109.51458,18.22542,1555
34355,258229,9B979E9430BCD0DDB6C78BBE525EBD2D,60631,1,3,2,109.57778,18.27583,1814
34356,258230,9B979E9430BCD0DDB6C78BBE525EBD2D,30854,7,22,15,109.56889,18.27076,1763
34357,258257,C91F430AC30B55A21F7C58F74A11754B,31421,12,13,1,109.55382,18.22347,1705
34358,258258,C91F430AC30B55A21F7C58F74A11754B,30731,13,15,2,109.50944,18.22306,1555
34359,258286,C1F100A79C441D3FFDBAE922D32DC8D2,30854,0,22,22,109.56889,18.27076,1763
34360,258287,C1F100A79C441D3FFDBAE922D32DC8D2,31945,22,23,1,109.58021,18.29403,1817
34361,258359,4D4289AE0DFBF4B5C79A47559DC2EBDD,30854,0,11,11,109.56889,18.27076,1763
34362,258360,4D4289AE0DFBF4B5C79A47559DC2EBDD,31071,13,14,1,109.58257,18.28458,1815
34367,258388,86141D8542832B6339FFC177369DDE6C,38094,1,10,9,109.45403,18.28778,1316
34368,258389,86141D8542832B6339FFC177369DDE6C,60054,12,14,2,109.3016,18.31229,770
34369,258390,86141D8542832B6339FFC177369DDE6C,31391,18,21,3,109.50382,18.24285,1508
34370,258442,7F377D9BD4A6752A92F213BA9B3E59E5,30281,0,9,9,109.50597,18.27583,1514
34371,258443,7F377D9BD4A6752A92F213BA9B3E59E5,30421,11,22,11,109.50021,18.25861,1511
34372,258444,CBEC85B23D166297F931D8AA26FC2B44,31231,1,4,3,109.42597,18.29292,1217
34373,258445,CBEC85B23D166297F931D8AA26FC2B44,30351,4,6,2,109.41701,18.29292,1217
34374,258463,522E8CB42AF22D75F3E9D0FD1FDCEEA6,30854,0,1,1,109.56889,18.27076,1763
34375,258464,522E8CB42AF22D75F3E9D0FD1FDCEEA6,39371,4,7,3,109.56627,18.2646,1762
34376,258465,522E8CB42AF22D75F3E9D0FD1FDCEEA6,30854,8,9,1,109.56889,18.27076,1763
34377,258466,522E8CB42AF22D75F3E9D0FD1FDCEEA6,31071,9,11,2,109.58257,18.28458,1815
34378,258467,522E8CB42AF22D75F3E9D0FD1FDCEEA6,30854,11,13,2,109.56889,18.27076,1763
34379,258468,522E8CB42AF22D75F3E9D0FD1FDCEEA6,31071,17,19,2,109.58257,18.28458,1815
34380,258469,522E8CB42AF22D75F3E9D0FD1FDCEEA6,30854,19,22,3,109.56889,18.27076,1763
34381,258475,772A9B492969611EE6751A5B3AA967DA,39321,0,5,5,109.529,18.2167,1604
34382,258476,772A9B492969611EE6751A5B3AA967DA,31521,5,7,2,109.51458,18.22542,1555
34383,258477,772A9B492969611EE6751A5B3AA967DA,33051,11,14,3,109.6475,18.46618,2096
34384,258478,772A9B492969611EE6751A5B3AA967DA,31521,19,22,3,109.51458,18.22542,1555
34385,258496,066CC6CBB5ADF978A93AF5D0C3292806,31931,14,15,1,109.54771,18.29403,1667
34386,258497,066CC6CBB5ADF978A93AF5D0C3292806,60581,18,20,2,109.59785,18.29931,1868
34387,258498,B2EAF2370DACE0D2E981BAA0267B94BE,39183,0,8,8,109.55542,18.28208,1715
34388,258503,F104684B0D453E1772CF3FC2E8F8DFBE,60231,17,18,1,109.49903,18.21972,1504
34389,258504,F104684B0D453E1772CF3FC2E8F8DFBE,60161,19,20,1,109.49174,18.26181,1461
34390,258505,F104684B0D453E1772CF3FC2E8F8DFBE,39151,21,22,1,109.49875,18.25097,1510
34391,258543,2CF83F5125C6075E2ACA9C17C2979C64,31071,0,9,9,109.58257,18.28458,1815
34392,258544,2CF83F5125C6075E2ACA9C17C2979C64,30854,12,18,6,109.56889,18.27076,1763
34393,258572,46D10B971C10D2856504DC61068F66E7,31821,0,10,10,109.51181,18.24924,1559
34394,258581,3C8AF8540BA6F9080D5A38C029FF5CF0,30661,11,12,1,109.37028,18.24361,1008
34395,258582,3C8AF8540BA6F9080D5A38C029FF5CF0,31471,12,16,4,109.34583,18.29563,917
34396,258583,3C8AF8540BA6F9080D5A38C029FF5CF0,60081,20,21,1,109.51097,18.22639,1556
34397,258590,926FBA523DAEDABC03774AE3ED899479,30511,15,17,2,109.51069,18.24208,1558
34398,258591,926FBA523DAEDABC03774AE3ED899479,38316,19,20,1,109.48542,18.27424,1464
34399,258592,926FBA523DAEDABC03774AE3ED899479,38127,22,23,1,109.50833,18.27222,1513
34404,258608,7C68E1F4B8B2F3CBBD5427BF66BF9C2E,30891,3,5,2,109.59431,18.28389,1865
34405,258609,7C68E1F4B8B2F3CBBD5427BF66BF9C2E,31571,9,10,1,109.61563,18.23326,1957
34406,258610,7C68E1F4B8B2F3CBBD5427BF66BF9C2E,31471,13,15,2,109.34583,18.29563,917
34407,258619,9264B3ED3A6BDC081378DA6F2A7F2371,30921,17,18,1,109.53903,18.29451,1667
34408,258620,9264B3ED3A6BDC081378DA6F2A7F2371,31071,18,19,1,109.58257,18.28458,1815
34409,258621,9264B3ED3A6BDC081378DA6F2A7F2371,31931,21,23,2,109.54771,18.29403,1667
34410,258671,7F6E66BC10419161F6457A6D79258EDB,60401,8,9,1,109.47444,18.27583,1414
34411,258672,7F6E66BC10419161F6457A6D79258EDB,38094,10,11,1,109.45403,18.28778,1316
34412,258673,7F6E66BC10419161F6457A6D79258EDB,31431,14,16,2,109.44639,18.29042,1316
34419,258690,1E2DBE5C967C66E080BAF11FED240B2A,39071,11,15,4,109.19917,18.29472,367
34420,258691,1E2DBE5C967C66E080BAF11FED240B2A,30711,16,19,3,109.50271,18.25347,1510
34421,258760,65AD296DD65C9EEA3C22EA02904A768E,30854,9,18,9,109.56889,18.27076,1763
34422,258761,65AD296DD65C9EEA3C22EA02904A768E,31561,20,22,2,109.56792,18.28479,1765
34423,258785,45FA8AF959A216E06C82392E21728E7F,31561,0,10,10,109.56792,18.28479,1765
34424,258786,45FA8AF959A216E06C82392E21728E7F,31071,13,17,4,109.58257,18.28458,1815
34425,258796,B172E1B17A92EA23226EC822FB6F7B82,30181,1,7,6,109.51597,18.23313,1557
34426,258797,B172E1B17A92EA23226EC822FB6F7B82,30181,9,12,3,109.51597,18.23313,1557
34427,258798,B172E1B17A92EA23226EC822FB6F7B82,60131,12,14,2,109.49819,18.24778,1509
34428,258799,B172E1B17A92EA23226EC822FB6F7B82,30281,15,17,2,109.50597,18.27583,1514
34429,258800,B172E1B17A92EA23226EC822FB6F7B82,31021,19,21,2,109.49021,18.27,1463
34430,258801,B172E1B17A92EA23226EC822FB6F7B82,30181,22,23,1,109.51597,18.23313,1557
34434,258829,1906A29FB327E3B92177040E39162827,30854,14,16,2,109.56889,18.27076,1763
34435,258830,1906A29FB327E3B92177040E39162827,31071,20,21,1,109.58257,18.28458,1815
34436,258849,5C0000CB27D689AADC6B456D8ACCA631,31321,13,14,1,109.63799,18.23201,2007
34437,258850,5C0000CB27D689AADC6B456D8ACCA631,38201,15,19,4,109.63729,18.23194,2006
34438,258851,5C0000CB27D689AADC6B456D8ACCA631,30711,21,22,1,109.50271,18.25347,1510
34439,258944,56B310842D84169C664B7D5E5FA918BC,60661,7,10,3,109.548,18.2377,1657
34440,258945,56B310842D84169C664B7D5E5FA918BC,31551,10,12,2,109.55868,18.24222,1708
34441,258946,56B310842D84169C664B7D5E5FA918BC,38111,18,19,1,109.52007,18.22403,1555
34442,258947,56B310842D84169C664B7D5E5FA918BC,31551,19,23,4,109.55868,18.24222,1708
34449,258990,CCD868165AA895E9C13DD53FF32CC3A8,38241,0,2,2,109.54111,18.30542,1669
34450,258991,CCD868165AA895E9C13DD53FF32CC3A8,60671,3,7,4,109.52979,18.31757,1621
34451,258992,CCD868165AA895E9C13DD53FF32CC3A8,30561,9,11,2,109.52778,18.31938,1621
34452,258993,CCD868165AA895E9C13DD53FF32CC3A8,38241,12,13,1,109.54111,18.30542,1669
34453,258994,CCD868165AA895E9C13DD53FF32CC3A8,30561,18,21,3,109.52778,18.31938,1621
34454,258995,CCD868165AA895E9C13DD53FF32CC3A8,38241,21,23,2,109.54111,18.30542,1669
34455,259009,106CA3A9375076B84A466DFC7E9F4CF9,30081,0,6,6,109.50243,18.26632,1512
34456,259010,106CA3A9375076B84A466DFC7E9F4CF9,38336,7,9,2,109.61111,18.21806,1904
34457,259011,106CA3A9375076B84A466DFC7E9F4CF9,30581,9,11,2,109.62257,18.24951,1959
34458,259012,106CA3A9375076B84A466DFC7E9F4CF9,38336,12,15,3,109.61111,18.21806,1904
34459,259033,3E64B806539E880054DA9285CD72C502,39321,0,5,5,109.529,18.2167,1604
34460,259034,3E64B806539E880054DA9285CD72C502,31521,5,7,2,109.51458,18.22542,1555
34461,259035,3E64B806539E880054DA9285CD72C502,31521,8,9,1,109.51458,18.22542,1555
34462,259036,3E64B806539E880054DA9285CD72C502,31521,14,17,3,109.51458,18.22542,1555
34463,259037,3E64B806539E880054DA9285CD72C502,31521,18,21,3,109.51458,18.22542,1555
34464,259038,3A145BF69DF902E1EF820C356086EF54,30731,6,8,2,109.50944,18.22306,1555
34465,259039,3A145BF69DF902E1EF820C356086EF54,30854,12,15,3,109.56889,18.27076,1763
34472,259062,8D3B10FD4DBC46DB93DA60040668F697,30854,0,6,6,109.56889,18.27076,1763
34473,259063,8D3B10FD4DBC46DB93DA60040668F697,39183,7,9,2,109.55542,18.28208,1715
34474,259064,8D3B10FD4DBC46DB93DA60040668F697,30854,11,13,2,109.56889,18.27076,1763
34475,259065,8D3B10FD4DBC46DB93DA60040668F697,30071,15,16,1,109.52819,18.30472,1619
34476,259066,8D3B10FD4DBC46DB93DA60040668F697,30854,18,23,5,109.56889,18.27076,1763
34480,259111,E43761FEBE209371C105554567258124,31321,0,6,6,109.63799,18.23201,2007
34481,259112,E43761FEBE209371C105554567258124,31931,7,8,1,109.54771,18.29403,1667
34482,259113,E43761FEBE209371C105554567258124,60241,8,10,2,109.53319,18.28667,1616
34483,259114,E43761FEBE209371C105554567258124,31931,10,15,5,109.54771,18.29403,1667
34487,259118,A7003B7BCC0077E98CD8FD4D16862BCA,30721,19,20,1,109.51597,18.28257,1565
34488,259119,A7003B7BCC0077E98CD8FD4D16862BCA,30201,20,22,2,109.4909,18.26465,1462
34489,259132,981FF39DB0050476FC5E5BA7D49F90F5,31951,0,7,7,109.52174,18.30299,1568
34504,259213,332A868849E47177376F9755C981E1C1,60441,2,4,2,109.46792,18.28604,1366
34505,259214,332A868849E47177376F9755C981E1C1,60391,4,6,2,109.47667,18.28757,1416
34506,259215,332A868849E47177376F9755C981E1C1,60441,7,8,1,109.46792,18.28604,1366
34507,259216,332A868849E47177376F9755C981E1C1,60391,9,10,1,109.47667,18.28757,1416
34508,259217,332A868849E47177376F9755C981E1C1,60441,10,14,4,109.46792,18.28604,1366
34516,259296,BBB180103068E98D503C4D3D2B6186F0,30451,13,19,6,109.1791,18.36229,278
34517,259297,BBB180103068E98D503C4D3D2B6186F0,30711,21,22,1,109.50271,18.25347,1510
34518,259317,EB316856896788EC8FD871E122E95728,31811,15,16,1,109.54201,18.31806,1671
34519,259318,EB316856896788EC8FD871E122E95728,30701,17,18,1,109.59313,18.32007,1871
34520,259319,EB316856896788EC8FD871E122E95728,31811,19,22,3,109.54201,18.31806,1671
34521,259320,EB316856896788EC8FD871E122E95728,30701,22,23,1,109.59313,18.32007,1871
34522,259337,878FC5EBB1B28FAABA6E6BFD01664318,30251,0,17,17,109.50611,18.26653,1512
34523,259338,878FC5EBB1B28FAABA6E6BFD01664318,30711,17,18,1,109.50271,18.25347,1510
34527,259398,8FEEC16C9D6ED01472328535C36E8269,38141,0,9,9,109.39479,18.2916,1116
34528,259401,8FEEC16C9D6ED01472328535C36E8269,38141,18,23,5,109.39479,18.2916,1116
34529,259402,384EBE8B0466F623B706DB371094FC98,31471,15,16,1,109.34583,18.29563,917
34530,259403,384EBE8B0466F623B706DB371094FC98,31471,18,23,5,109.34583,18.29563,917
34531,259414,62CBF94D737D513D371567F698917827,31561,4,9,5,109.56792,18.28479,1765
34532,259415,62CBF94D737D513D371567F698917827,30854,11,15,4,109.56889,18.27076,1763
34536,259442,3C6B416FA80A7A03E14FC0317D60CB00,30854,6,13,7,109.56889,18.27076,1763
34537,259443,3C6B416FA80A7A03E14FC0317D60CB00,31101,15,16,1,109.65389,18.23403,2057
34538,259444,3C6B416FA80A7A03E14FC0317D60CB00,31164,18,19,1,109.69993,18.27215,2263
34539,259445,3C6B416FA80A7A03E14FC0317D60CB00,39371,22,23,1,109.56627,18.2646,1762
34540,259446,F8D81869027CCFD6139762C81772F076,39321,14,19,5,109.529,18.2167,1604
34541,259447,F8D81869027CCFD6139762C81772F076,31271,21,23,2,109.48958,18.26257,1462
34542,259451,9B43F93397D8AD2193F77AAD4D6186E5,30721,0,9,9,109.51597,18.28257,1565
34543,259453,9B43F93397D8AD2193F77AAD4D6186E5,30721,17,23,6,109.51597,18.28257,1565
34544,259458,019EB913544B8855829875D27D9C85B6,60131,17,18,1,109.49819,18.24778,1509
34545,259459,019EB913544B8855829875D27D9C85B6,30071,21,23,2,109.52819,18.30472,1619
34546,259467,5E4A74B5A77D08CB1929834DB6645E3F,30431,12,13,1,109.16931,18.37486,280
34547,259468,5E4A74B5A77D08CB1929834DB6645E3F,31121,14,16,2,109.16292,18.37063,230
34548,259469,5E4A74B5A77D08CB1929834DB6645E3F,30771,18,20,2,109.49938,18.26042,1511
34549,259470,5E4A74B5A77D08CB1929834DB6645E3F,60201,21,23,2,109.5041,18.2509,1510
34550,259481,A2D2E4451F37992A08A5A50B06EE68ED,31181,1,6,5,109.50382,18.24813,1509
34551,259482,A2D2E4451F37992A08A5A50B06EE68ED,30711,7,9,2,109.50271,18.25347,1510
34552,259483,A2D2E4451F37992A08A5A50B06EE68ED,30431,10,12,2,109.16931,18.37486,280
34553,259484,A2D2E4451F37992A08A5A50B06EE68ED,31181,14,15,1,109.50382,18.24813,1509
34554,259510,AE6DC7ACB81DB5F351E45AC25E5F5A3B,31206,0,1,1,109.50819,18.23549,1507
34555,259511,AE6DC7ACB81DB5F351E45AC25E5F5A3B,38297,3,15,12,109.52576,18.24965,1609
34556,259512,AE6DC7ACB81DB5F351E45AC25E5F5A3B,31181,17,18,1,109.50382,18.24813,1509
34557,259513,AE6DC7ACB81DB5F351E45AC25E5F5A3B,38297,18,20,2,109.52576,18.24965,1609
34558,259514,AE6DC7ACB81DB5F351E45AC25E5F5A3B,60281,21,23,2,109.51743,18.25924,1561
34562,259536,ACDEAAF45B65DE48CF80A48DBD3C775E,31071,14,15,1,109.58257,18.28458,1815
34563,259537,ACDEAAF45B65DE48CF80A48DBD3C775E,30854,16,22,6,109.56889,18.27076,1763
34564,259549,5EBEA276FCB4A19AC5C987F5C7CC8908,60401,11,13,2,109.47444,18.27583,1414
34565,259550,5EBEA276FCB4A19AC5C987F5C7CC8908,60621,15,16,1,109.48354,18.27451,1464
34570,259579,7B1A07C39637E996C01DF0A3D287D3C6,30854,0,2,2,109.56889,18.27076,1763
34571,259580,7B1A07C39637E996C01DF0A3D287D3C6,39371,3,5,2,109.56627,18.2646,1762
34572,259581,7B1A07C39637E996C01DF0A3D287D3C6,31071,6,10,4,109.58257,18.28458,1815
34573,259582,7B1A07C39637E996C01DF0A3D287D3C6,39371,11,12,1,109.56627,18.2646,1762
34574,259583,7B1A07C39637E996C01DF0A3D287D3C6,30854,13,17,4,109.56889,18.27076,1763
34575,259584,7B1A07C39637E996C01DF0A3D287D3C6,39371,18,20,2,109.56627,18.2646,1762
34576,259592,F945D1EC910CAA5B207559CC99738BE6,60354,0,9,9,109.58701,18.28521,1815
34577,259593,F945D1EC910CAA5B207559CC99738BE6,31561,12,14,2,109.56792,18.28479,1765
34578,259594,F945D1EC910CAA5B207559CC99738BE6,30361,18,23,5,109.50347,18.24,1508
34579,259603,DB4DF566D4757FF3BB488F82DE126248,31561,13,15,2,109.56792,18.28479,1765
34580,259604,DB4DF566D4757FF3BB488F82DE126248,30851,17,18,1,109.5616,18.27396,1713
34581,259605,DB4DF566D4757FF3BB488F82DE126248,31561,22,23,1,109.56792,18.28479,1765
34582,259616,FBC323A047041F71D8997C22FDE88F17,38153,0,9,9,109.51819,18.25736,1561
34583,259617,FBC323A047041F71D8997C22FDE88F17,30151,13,14,1,109.50986,18.25083,1560
34584,259720,7DE63B500AAA8596FED98730536D4512,30351,0,11,11,109.41701,18.29292,1217
34585,259721,7DE63B500AAA8596FED98730536D4512,31561,12,13,1,109.56792,18.28479,1765
34586,259722,7DE63B500AAA8596FED98730536D4512,38071,15,16,1,109.40722,18.30938,1169
34591,259821,F621296F333E8058687ACD884B135C6E,30504,3,8,5,109.705,18.35368,2277
34592,259822,F621296F333E8058687ACD884B135C6E,31031,9,11,2,109.49979,18.25382,1510
34593,259823,F621296F333E8058687ACD884B135C6E,31841,11,14,3,109.73201,18.33382,2373
34594,259824,F621296F333E8058687ACD884B135C6E,31351,15,21,6,109.4959,18.28417,1465
34595,259825,39ED38B7840BCFA7D4C7F932FCDCF5D8,30361,12,13,1,109.50347,18.24,1508
34596,259826,39ED38B7840BCFA7D4C7F932FCDCF5D8,31031,15,16,1,109.49979,18.25382,1510
34597,259827,39ED38B7840BCFA7D4C7F932FCDCF5D8,60161,19,21,2,109.49174,18.26181,1461
34598,259828,39ED38B7840BCFA7D4C7F932FCDCF5D8,60201,21,22,1,109.5041,18.2509,1510
34599,259829,5ACB2494699EB2F10AA3427B417842C4,38251,14,16,2,109.49618,18.25493,1510
34600,259866,C608AF81E00885FA602816017BA139C9,39183,12,16,4,109.55542,18.28208,1715
34601,259867,C608AF81E00885FA602816017BA139C9,30854,17,23,6,109.56889,18.27076,1763
34602,259878,D38EA5391364D89D3829E3A8AAB18EB4,39301,0,7,7,109.48361,18.21153,1453
34603,259879,D38EA5391364D89D3829E3A8AAB18EB4,31781,10,12,2,109.19847,18.2975,367
34604,259880,D38EA5391364D89D3829E3A8AAB18EB4,30351,17,18,1,109.41701,18.29292,1217
34605,259898,E292D83051830D054E89D209EEABA4B9,31561,3,19,16,109.56792,18.28479,1765
34606,259899,E292D83051830D054E89D209EEABA4B9,30161,21,22,1,109.50042,18.24389,1508
34613,259949,EF0AF6DFF11E792E87881ED5E6F91398,30854,12,14,2,109.56889,18.27076,1763
34614,259950,EF0AF6DFF11E792E87881ED5E6F91398,31561,16,17,1,109.56792,18.28479,1765
34615,259980,DCF02478AC5ACC5C3190CEB09210F280,31351,19,23,4,109.4959,18.28417,1465
34616,260010,EFDE35289FEC1E13D6F34EFEE66A8AD2,60631,1,14,13,109.57778,18.27583,1814
34617,260011,EFDE35289FEC1E13D6F34EFEE66A8AD2,30854,15,22,7,109.56889,18.27076,1763
34618,260026,BE74D5A2C373F8231889AF03B59762B2,30232,15,18,3,109.6191,18.31701,1971
34619,260027,BE74D5A2C373F8231889AF03B59762B2,60301,19,23,4,109.60715,18.30993,1919
34620,260030,DA10676C4DA702E02A2C3FFFAC40ABA2,39183,3,5,2,109.55542,18.28208,1715
34621,260031,DA10676C4DA702E02A2C3FFFAC40ABA2,31561,6,21,15,109.56792,18.28479,1765
34622,260036,5205655EC583F6392BC68C8BB9865108,31071,0,2,2,109.58257,18.28458,1815
34623,260037,5205655EC583F6392BC68C8BB9865108,30854,4,21,17,109.56889,18.27076,1763
34627,260140,537CA9C3FED012868AB5E4DF92AD232C,38127,14,15,1,109.50833,18.27222,1513
34628,260141,537CA9C3FED012868AB5E4DF92AD232C,30861,16,17,1,109.52722,18.22743,1606
34629,260142,537CA9C3FED012868AB5E4DF92AD232C,31351,18,20,2,109.4959,18.28417,1465
34630,260143,537CA9C3FED012868AB5E4DF92AD232C,30861,21,23,2,109.52722,18.22743,1606
34631,260169,C709D01469E0800AF998DFAF42105CDC,31561,10,17,7,109.56792,18.28479,1765
34632,260170,C709D01469E0800AF998DFAF42105CDC,30854,21,23,2,109.56889,18.27076,1763
34636,260214,8883DF5E66B5FC284A8EF97DE8EAAAB3,30854,8,13,5,109.56889,18.27076,1763
34637,260215,8883DF5E66B5FC284A8EF97DE8EAAAB3,60631,13,23,10,109.57778,18.27583,1814
34648,260297,C5190185E6A850F6CC88937542E0EA31,39371,0,6,6,109.56627,18.2646,1762
34649,260298,C5190185E6A850F6CC88937542E0EA31,30854,9,18,9,109.56889,18.27076,1763
34650,260299,C5190185E6A850F6CC88937542E0EA31,38071,21,22,1,109.40722,18.30938,1169
34651,260305,529A14F498129B0238F7B12A9FC7F6F7,60381,0,2,2,109.5241,18.22458,1605
34652,260306,529A14F498129B0238F7B12A9FC7F6F7,31671,3,9,6,109.38965,18.29813,1068
34653,260307,529A14F498129B0238F7B12A9FC7F6F7,30341,10,11,1,109.3625,18.29167,966
34654,260308,529A14F498129B0238F7B12A9FC7F6F7,31671,15,20,5,109.38965,18.29813,1068
34655,260314,5E8FF49D1CCDA711846608608C7FAE0D,30854,17,21,4,109.56889,18.27076,1763
34656,260315,5E8FF49D1CCDA711846608608C7FAE0D,31071,22,23,1,109.58257,18.28458,1815
34657,260323,2C3BD53A8702A47FB82F05FB4993B683,31561,0,6,6,109.56792,18.28479,1765
34658,260324,2C3BD53A8702A47FB82F05FB4993B683,30854,6,8,2,109.56889,18.27076,1763
34659,260325,2C3BD53A8702A47FB82F05FB4993B683,39181,8,10,2,109.55153,18.28035,1715
34660,260326,2C3BD53A8702A47FB82F05FB4993B683,31561,11,13,2,109.56792,18.28479,1765
34661,260327,2C3BD53A8702A47FB82F05FB4993B683,39183,14,16,2,109.55542,18.28208,1715
34662,260328,2C3BD53A8702A47FB82F05FB4993B683,31561,17,19,2,109.56792,18.28479,1765
34663,260345,866460FA5062A635337B6369BB2AADDA,60631,21,22,1,109.57778,18.27583,1814
34664,260346,866460FA5062A635337B6369BB2AADDA,30854,22,23,1,109.56889,18.27076,1763
34668,260372,283001ED673D8EDBEF7EEB00BDB31533,31231,1,3,2,109.42597,18.29292,1217
34669,260373,283001ED673D8EDBEF7EEB00BDB31533,30351,3,6,3,109.41701,18.29292,1217
34670,260374,283001ED673D8EDBEF7EEB00BDB31533,60552,6,11,5,109.41729,18.30014,1218
34671,260375,283001ED673D8EDBEF7EEB00BDB31533,31231,12,13,1,109.42597,18.29292,1217
34672,260376,283001ED673D8EDBEF7EEB00BDB31533,60552,13,15,2,109.41729,18.30014,1218
34673,260416,B40196DEC9296D47DEAFEA139FA4FED8,38961,19,20,1,109.50847,18.23514,1507
34674,260417,B40196DEC9296D47DEAFEA139FA4FED8,30371,20,23,3,109.51,18.24771,1559
34675,260422,D42D82F7F77C55013F0EAB7E35E2211F,30531,0,6,6,109.53271,18.21472,1604
34676,260423,D42D82F7F77C55013F0EAB7E35E2211F,31071,8,14,6,109.58257,18.28458,1815
34677,260437,B35A1B5FE0A9EDD216862BACC2A50CDF,30661,19,20,1,109.37028,18.24361,1008
34678,260438,B35A1B5FE0A9EDD216862BACC2A50CDF,60411,21,23,2,109.32514,18.30854,869
34679,260439,40C57F24FE0409ABB752B2031C349577,38951,0,13,13,109.48097,18.28868,1416
34680,260440,40C57F24FE0409ABB752B2031C349577,30711,15,19,4,109.50271,18.25347,1510
34681,260441,40C57F24FE0409ABB752B2031C349577,60463,20,21,1,109.52507,18.22438,1605
34682,260444,DECFC49E54B6810E60D19758307AF1CD,60594,12,13,1,109.62694,18.22799,1956
34683,260445,DECFC49E54B6810E60D19758307AF1CD,38052,14,15,1,109.62618,18.23042,1956
34684,260446,DECFC49E54B6810E60D19758307AF1CD,38052,16,18,2,109.62618,18.23042,1956
34685,260447,DECFC49E54B6810E60D19758307AF1CD,39331,19,21,2,109.62125,18.22708,1956
34686,260460,A7D270EF8C74F66D966F17A0E3BC8BC9,30854,10,11,1,109.56889,18.27076,1763
34687,260461,A7D270EF8C74F66D966F17A0E3BC8BC9,31071,13,16,3,109.58257,18.28458,1815
34688,260462,A7D270EF8C74F66D966F17A0E3BC8BC9,30854,17,18,1,109.56889,18.27076,1763
34689,260463,A7D270EF8C74F66D966F17A0E3BC8BC9,31071,18,22,4,109.58257,18.28458,1815
34690,260466,1B28D49AE0589113EE30D593B5B6F95E,31931,8,9,1,109.54771,18.29403,1667
34691,260467,1B28D49AE0589113EE30D593B5B6F95E,60371,9,10,1,109.53063,18.30056,1618
34695,260475,D6B54C643B88B86782DC30A38AD291FD,31561,4,19,15,109.56792,18.28479,1765
34696,260476,D6B54C643B88B86782DC30A38AD291FD,30854,20,21,1,109.56889,18.27076,1763
34701,260531,B0C6DED232762D9BAF78468BD2731104,30051,12,14,2,109.48917,18.21215,1453
34702,260533,6FDD8510FC3FD17D36965B0963BD7329,30854,0,3,3,109.56889,18.27076,1763
34703,260534,6FDD8510FC3FD17D36965B0963BD7329,31561,3,6,3,109.56792,18.28479,1765
34704,260535,6FDD8510FC3FD17D36965B0963BD7329,39183,6,8,2,109.55542,18.28208,1715
34705,260536,6FDD8510FC3FD17D36965B0963BD7329,30854,9,16,7,109.56889,18.27076,1763
34706,260537,6FDD8510FC3FD17D36965B0963BD7329,31561,20,22,2,109.56792,18.28479,1765
34707,260562,CD576F1C1CDFB89E6A99A20E65927346,31071,1,5,4,109.58257,18.28458,1815
34708,260563,CD576F1C1CDFB89E6A99A20E65927346,31561,7,18,11,109.56792,18.28479,1765
34709,260580,B712327B6033C61F37801CFD6DAC08AD,38484,0,7,7,109.53028,18.31528,1620
34710,260581,B712327B6033C61F37801CFD6DAC08AD,30561,7,8,1,109.52778,18.31938,1621
34711,260582,B712327B6033C61F37801CFD6DAC08AD,38484,13,16,3,109.53028,18.31528,1620
34712,260583,B712327B6033C61F37801CFD6DAC08AD,31951,16,17,1,109.52174,18.30299,1568
34713,260584,B712327B6033C61F37801CFD6DAC08AD,30561,19,23,4,109.52778,18.31938,1621
34714,260598,A7B3BDD8DC79485BA41EC7F220A41345,60631,3,8,5,109.57778,18.27583,1814
34715,260599,A7B3BDD8DC79485BA41EC7F220A41345,30854,11,12,1,109.56889,18.27076,1763
34722,260636,8EF00336DF81276A821E166696CFF524,60291,0,8,8,109.50826,18.24639,1509
34723,260637,8EF00336DF81276A821E166696CFF524,38754,10,13,3,109.74667,18.37382,2430
34724,260638,8EF00336DF81276A821E166696CFF524,31931,16,18,2,109.54771,18.29403,1667
34725,260639,8EF00336DF81276A821E166696CFF524,60501,18,20,2,109.48701,18.29021,1466
34726,260640,8EF00336DF81276A821E166696CFF524,30921,20,22,2,109.53903,18.29451,1667
34730,260688,FCC7FFA36CCAFA7D306338AD42FEB181,31231,0,4,4,109.42597,18.29292,1217
34731,260689,FCC7FFA36CCAFA7D306338AD42FEB181,60161,5,6,1,109.49174,18.26181,1461
34732,260690,FCC7FFA36CCAFA7D306338AD42FEB181,31021,11,12,1,109.49021,18.27,1463
34733,260739,7FF3C6569A3990C03CAF6C52D3C8BC6C,30921,0,6,6,109.53903,18.29451,1667
34734,260740,7FF3C6569A3990C03CAF6C52D3C8BC6C,31931,7,10,3,109.54771,18.29403,1667
34735,260741,7FF3C6569A3990C03CAF6C52D3C8BC6C,60221,11,12,1,109.52569,18.29188,1616
34736,260742,7FF3C6569A3990C03CAF6C52D3C8BC6C,31931,14,16,2,109.54771,18.29403,1667
34737,260743,7FF3C6569A3990C03CAF6C52D3C8BC6C,30921,16,23,7,109.53903,18.29451,1667
34744,260820,5291560AC3CA28497E4CB7832DDE2A8C,31761,0,9,9,109.60521,18.27965,1914
34748,260886,A585E60286B0A8AE3B57F133CE8318C1,31461,11,14,3,109.5091,18.25389,1510
34749,260887,A585E60286B0A8AE3B57F133CE8318C1,60221,15,18,3,109.52569,18.29188,1616
34753,260928,42158B50A96F4BB50162AD5AAF8D7E2D,31201,0,8,8,109.51042,18.23819,1558
34754,260929,42158B50A96F4BB50162AD5AAF8D7E2D,30251,13,14,1,109.50611,18.26653,1512
34759,260941,97C31877CA4226D0F1BA1C0E12066B56,30854,11,18,7,109.56889,18.27076,1763
34760,260942,97C31877CA4226D0F1BA1C0E12066B56,30251,19,21,2,109.50611,18.26653,1512
34761,260966,0F09C2BE6A190F4BF3D635D6A9F19FD3,31071,0,6,6,109.58257,18.28458,1815
34762,260967,0F09C2BE6A190F4BF3D635D6A9F19FD3,60661,8,12,4,109.548,18.2377,1657
34763,260968,0F09C2BE6A190F4BF3D635D6A9F19FD3,31951,16,23,7,109.52174,18.30299,1568
34764,260986,E4B522EF4348156010E5C578EC13D60F,30854,15,18,3,109.56889,18.27076,1763
34765,260987,560794A44CA17A43FA34D0FA6C339747,30731,14,15,1,109.50944,18.22306,1555
34766,260988,560794A44CA17A43FA34D0FA6C339747,60361,17,19,2,109.51938,18.29681,1567
34767,260989,560794A44CA17A43FA34D0FA6C339747,31351,20,21,1,109.4959,18.28417,1465
34768,260990,560794A44CA17A43FA34D0FA6C339747,60361,22,23,1,109.51938,18.29681,1567
34772,261010,608A55C14BAB2A5B627ACC1F39B89FB6,31945,0,7,7,109.58021,18.29403,1817
34773,261011,608A55C14BAB2A5B627ACC1F39B89FB6,30854,11,14,3,109.56889,18.27076,1763
34774,261012,608A55C14BAB2A5B627ACC1F39B89FB6,31164,15,21,6,109.69993,18.27215,2263
34775,261013,608A55C14BAB2A5B627ACC1F39B89FB6,31945,22,23,1,109.58021,18.29403,1817
34784,261073,A786C2DB315949831D3D4F5064647FEF,31531,0,7,7,109.49583,18.25972,1461
34785,261074,A786C2DB315949831D3D4F5064647FEF,31145,9,10,1,109.20431,18.30479,369
34786,261075,A786C2DB315949831D3D4F5064647FEF,60054,13,15,2,109.3016,18.31229,770
34787,261098,546C572FC49C780F9A9AF62ED98666DF,30351,0,8,8,109.41701,18.29292,1217
34788,261099,546C572FC49C780F9A9AF62ED98666DF,30681,8,10,2,109.48493,18.26917,1463
34789,261100,546C572FC49C780F9A9AF62ED98666DF,30351,10,12,2,109.41701,18.29292,1217
34790,261101,546C572FC49C780F9A9AF62ED98666DF,30681,12,13,1,109.48493,18.26917,1463
34791,261102,546C572FC49C780F9A9AF62ED98666DF,30351,15,18,3,109.41701,18.29292,1217
34792,261103,546C572FC49C780F9A9AF62ED98666DF,30171,18,21,3,109.48458,18.27139,1463
34793,261104,546C572FC49C780F9A9AF62ED98666DF,30351,21,23,2,109.41701,18.29292,1217
34794,261136,DF5348A8E25901EBB63BBF3F6126BB02,31071,0,8,8,109.58257,18.28458,1815
34795,261137,DF5348A8E25901EBB63BBF3F6126BB02,30854,10,22,12,109.56889,18.27076,1763
34796,261145,6D0CBC29417959EBDF12F1FD604A5C61,31521,20,21,1,109.51458,18.22542,1555
34797,261146,6D0CBC29417959EBDF12F1FD604A5C61,39321,22,23,1,109.529,18.2167,1604
34798,261156,2C5F898948A2B7909519666936FBF333,38707,0,12,12,109.73778,18.35368,2427
34799,261157,2C5F898948A2B7909519666936FBF333,38707,17,18,1,109.73778,18.35368,2427
34804,261222,0F558B6653C655C7F0BAEA9D66B33F57,31071,2,8,6,109.58257,18.28458,1815
34805,261223,0F558B6653C655C7F0BAEA9D66B33F57,30854,11,14,3,109.56889,18.27076,1763
34806,261224,0F558B6653C655C7F0BAEA9D66B33F57,31071,14,15,1,109.58257,18.28458,1815
34807,261225,0F558B6653C655C7F0BAEA9D66B33F57,60211,16,18,2,109.63549,18.26049,2011
34808,261226,0F558B6653C655C7F0BAEA9D66B33F57,30191,22,23,1,109.50361,18.22701,1506
34809,261229,1026894DC5FF9A7FAF3A2EE28B95E239,39183,1,5,4,109.55542,18.28208,1715
34810,261230,1026894DC5FF9A7FAF3A2EE28B95E239,30854,10,23,13,109.56889,18.27076,1763
34811,261236,F9F2694056D54C70B8E94D439CF649C0,38331,16,18,2,109.62465,18.22736,1956
34812,261237,F9F2694056D54C70B8E94D439CF649C0,30161,20,22,2,109.50042,18.24389,1508
34813,261251,7421066246AAD1C230E7E2A7ADF06E9D,60631,3,6,3,109.57778,18.27583,1814
34814,261252,7421066246AAD1C230E7E2A7ADF06E9D,30854,8,9,1,109.56889,18.27076,1763
34815,261253,7421066246AAD1C230E7E2A7ADF06E9D,60631,11,13,2,109.57778,18.27583,1814
34816,261254,7421066246AAD1C230E7E2A7ADF06E9D,30854,14,15,1,109.56889,18.27076,1763
34817,261255,7421066246AAD1C230E7E2A7ADF06E9D,60211,18,21,3,109.63549,18.26049,2011
34818,261270,D70D11871FB47AB4743A9AB8A25E5AA8,38241,0,2,2,109.54111,18.30542,1669
34819,261271,D70D11871FB47AB4743A9AB8A25E5AA8,60671,3,4,1,109.52979,18.31757,1621
34820,261272,D70D11871FB47AB4743A9AB8A25E5AA8,38241,5,6,1,109.54111,18.30542,1669
34821,261273,D70D11871FB47AB4743A9AB8A25E5AA8,60241,9,16,7,109.53319,18.28667,1616
34822,261274,D70D11871FB47AB4743A9AB8A25E5AA8,60671,20,21,1,109.52979,18.31757,1621
34823,261275,D70D11871FB47AB4743A9AB8A25E5AA8,38241,22,23,1,109.54111,18.30542,1669
34827,261288,304C30E2FC5C661AED14B0A3EC5AD4C3,31931,0,13,13,109.54771,18.29403,1667
34828,261308,79F9F95B3990F4F0729635A63B021CCE,60661,0,6,6,109.548,18.2377,1657
34829,261309,79F9F95B3990F4F0729635A63B021CCE,60381,8,10,2,109.5241,18.22458,1605
34830,261310,79F9F95B3990F4F0729635A63B021CCE,60641,10,18,8,109.53854,18.2359,1657
34831,261311,79F9F95B3990F4F0729635A63B021CCE,60381,19,20,1,109.5241,18.22458,1605
34832,261312,79F9F95B3990F4F0729635A63B021CCE,60381,21,23,2,109.5241,18.22458,1605
34833,261337,A4743972EC2FC58546DD11935BDC0E1A,31521,0,2,2,109.51458,18.22542,1555
34834,261338,A4743972EC2FC58546DD11935BDC0E1A,39091,2,14,12,109.50097,18.25222,1510
34835,261390,D4448A1349B0563C78F16B479359A95F,31071,6,12,6,109.58257,18.28458,1815
34836,261391,D4448A1349B0563C78F16B479359A95F,30854,13,14,1,109.56889,18.27076,1763
34837,261417,8DD23AA43C0F7967C45F7488D66F9159,39371,0,7,7,109.56627,18.2646,1762
34838,261418,8DD23AA43C0F7967C45F7488D66F9159,30854,7,11,4,109.56889,18.27076,1763
34839,261419,8DD23AA43C0F7967C45F7488D66F9159,31945,12,13,1,109.58021,18.29403,1817
34840,261420,8DD23AA43C0F7967C45F7488D66F9159,30854,14,16,2,109.56889,18.27076,1763
34841,261421,8DD23AA43C0F7967C45F7488D66F9159,31071,18,22,4,109.58257,18.28458,1815
34842,261436,147470AD3D3B8724582C30D5F244A8B6,60421,0,2,2,109.46333,18.31743,1371
34843,261437,147470AD3D3B8724582C30D5F244A8B6,30111,5,10,5,109.47583,18.30542,1419
34844,261438,147470AD3D3B8724582C30D5F244A8B6,60421,11,16,5,109.46333,18.31743,1371
34845,261439,147470AD3D3B8724582C30D5F244A8B6,30111,17,18,1,109.47583,18.30542,1419
34846,261440,147470AD3D3B8724582C30D5F244A8B6,60421,20,22,2,109.46333,18.31743,1371
34850,261470,9B56C9E8F296BB0BD3749C5E72B4BBD9,60631,8,13,5,109.57778,18.27583,1814
34851,261471,9B56C9E8F296BB0BD3749C5E72B4BBD9,30511,17,19,2,109.51069,18.24208,1558
34852,261472,9B56C9E8F296BB0BD3749C5E72B4BBD9,60631,21,23,2,109.57778,18.27583,1814
34853,261570,D6CC1FC0E328F94E96D4D1F260DF9F7F,31071,12,14,2,109.58257,18.28458,1815
34854,261571,D6CC1FC0E328F94E96D4D1F260DF9F7F,31071,18,23,5,109.58257,18.28458,1815
34855,261579,FC3A0E75CA2AB7A7F2493FF9F12595DC,31171,0,8,8,109.50938,18.24917,1559
34856,261593,B3F4E43DA3C4E855A3ED684A6CB97F36,31931,1,8,7,109.54771,18.29403,1667
34857,261594,B3F4E43DA3C4E855A3ED684A6CB97F36,30921,10,11,1,109.53903,18.29451,1667
34858,261595,B3F4E43DA3C4E855A3ED684A6CB97F36,31931,12,14,2,109.54771,18.29403,1667
34859,261596,B3F4E43DA3C4E855A3ED684A6CB97F36,31071,18,20,2,109.58257,18.28458,1815
34860,261597,B3F4E43DA3C4E855A3ED684A6CB97F36,31931,21,23,2,109.54771,18.29403,1667
34861,261598,7B2AEE2086698683607EDDDB4B678234,31461,14,15,1,109.5091,18.25389,1510
34862,261599,7B2AEE2086698683607EDDDB4B678234,38154,18,22,4,109.5266,18.28278,1615
34863,261607,6846D911A5FA1223889E01CD52440A91,31071,3,6,3,109.58257,18.28458,1815
34864,261608,6846D911A5FA1223889E01CD52440A91,30854,8,9,1,109.56889,18.27076,1763
34868,261627,2A6BA0678DDF16AF08BAC9E3FA3C9391,31561,0,2,2,109.56792,18.28479,1765
34869,261628,2A6BA0678DDF16AF08BAC9E3FA3C9391,30854,3,20,17,109.56889,18.27076,1763
34870,261639,AD66901AE8DA9E70C69F33D262CADCE7,31521,10,12,2,109.51458,18.22542,1555
34871,261640,AD66901AE8DA9E70C69F33D262CADCE7,39321,12,13,1,109.529,18.2167,1604
34872,261641,AD66901AE8DA9E70C69F33D262CADCE7,38111,17,18,1,109.52007,18.22403,1555
34873,261642,AD66901AE8DA9E70C69F33D262CADCE7,31521,20,21,1,109.51458,18.22542,1555
34874,261663,8BB15E7C959475309A269AAF24FD7109,30421,20,21,1,109.50021,18.25861,1511
34875,261664,8BB15E7C959475309A269AAF24FD7109,60291,22,23,1,109.50826,18.24639,1509
34879,261681,E16204D131FCD957D5ADB9592C1DD0ED,38291,14,16,2,109.51618,18.24313,1558
34880,261682,E16204D131FCD957D5ADB9592C1DD0ED,31821,18,20,2,109.51181,18.24924,1559
34881,261683,E16204D131FCD957D5ADB9592C1DD0ED,31071,21,23,2,109.58257,18.28458,1815
34886,261694,D9993ECC22BF2983B88088E38AF85C01,30854,14,16,2,109.56889,18.27076,1763
34887,261695,D9993ECC22BF2983B88088E38AF85C01,60631,18,21,3,109.57778,18.27583,1814
34888,261696,D9993ECC22BF2983B88088E38AF85C01,60354,22,23,1,109.58701,18.28521,1815
34893,261737,34F3D64B41C252481F72E5CF931AC833,30854,7,10,3,109.56889,18.27076,1763
34894,261738,34F3D64B41C252481F72E5CF931AC833,30851,13,16,3,109.5616,18.27396,1713
34895,261739,34F3D64B41C252481F72E5CF931AC833,30854,16,18,2,109.56889,18.27076,1763
34905,261786,5E97A4561E11AAC4FBC53FD068EAA52B,30891,0,2,2,109.59431,18.28389,1865
34906,261787,5E97A4561E11AAC4FBC53FD068EAA52B,60631,2,10,8,109.57778,18.27583,1814
34907,261788,5E97A4561E11AAC4FBC53FD068EAA52B,30854,11,12,1,109.56889,18.27076,1763
34908,261789,5E97A4561E11AAC4FBC53FD068EAA52B,38251,17,18,1,109.49618,18.25493,1510
34909,261790,5E97A4561E11AAC4FBC53FD068EAA52B,30854,22,23,1,109.56889,18.27076,1763
34910,261793,1DCF37EE2927C479B1032CB369D26049,31571,0,5,5,109.61563,18.23326,1957
34911,261794,1DCF37EE2927C479B1032CB369D26049,60421,5,6,1,109.46333,18.31743,1371
34912,261795,1DCF37EE2927C479B1032CB369D26049,38052,7,8,1,109.62618,18.23042,1956
34916,261810,9F708CFC0857E7A2A3B7B0FC8BC7087D,30181,0,9,9,109.51597,18.23313,1557
34917,261811,9F708CFC0857E7A2A3B7B0FC8BC7087D,31471,12,14,2,109.34583,18.29563,917
34918,261812,9F708CFC0857E7A2A3B7B0FC8BC7087D,31521,18,19,1,109.51458,18.22542,1555
34919,261816,69674649043EDB81804188C1D4601ECF,38023,14,17,3,109.37132,18.28993,1016
34920,261817,69674649043EDB81804188C1D4601ECF,38027,20,22,2,109.38833,18.2909,1066
34924,261894,C6B911445627E1FADD20639DE87ABED6,31431,19,22,3,109.44639,18.29042,1316
34929,261942,4E94ADAE7ABEB20EEFAF67519DFCC1BE,31081,0,9,9,109.44639,18.30181,1318
34930,261943,4E94ADAE7ABEB20EEFAF67519DFCC1BE,31031,9,21,12,109.49979,18.25382,1510
34931,261955,5513A4EBEB51AF5647B29C75D8B8CC2C,30421,19,20,1,109.50021,18.25861,1511
34932,261956,5513A4EBEB51AF5647B29C75D8B8CC2C,31345,22,23,1,109.39,18.29,1066
34933,262012,B340EDEF4A878E8DF5CBEC25E465EACE,31071,12,14,2,109.58257,18.28458,1815
34934,262013,B340EDEF4A878E8DF5CBEC25E465EACE,30854,15,16,1,109.56889,18.27076,1763
34935,262025,F198CAA1F49ACA5D003FD8F8473B3798,30854,1,8,7,109.56889,18.27076,1763
34936,262026,F198CAA1F49ACA5D003FD8F8473B3798,31071,10,12,2,109.58257,18.28458,1815
34937,262070,DAB08D254D49BF150533311BD904D49C,30854,0,9,9,109.56889,18.27076,1763
34938,262071,DAB08D254D49BF150533311BD904D49C,31071,12,13,1,109.58257,18.28458,1815
34939,262072,DAB08D254D49BF150533311BD904D49C,30854,14,16,2,109.56889,18.27076,1763
34940,262073,DAB08D254D49BF150533311BD904D49C,60463,16,18,2,109.52507,18.22438,1605
34941,262074,DAB08D254D49BF150533311BD904D49C,39321,19,20,1,109.529,18.2167,1604
34945,262080,8C5A16299A6D294198C90C34C25C5949,31561,0,2,2,109.56792,18.28479,1765
34946,262081,8C5A16299A6D294198C90C34C25C5949,39183,5,6,1,109.55542,18.28208,1715
34947,262082,662D882A6A10D0E6C3566690F0A40636,30854,0,17,17,109.56889,18.27076,1763
34948,262083,662D882A6A10D0E6C3566690F0A40636,31071,19,20,1,109.58257,18.28458,1815
34949,262093,ECC87D4B92C9C8DFEF66B8ADE6C84FBA,38541,0,9,9,109.73715,18.34875,2426
34950,262094,ECC87D4B92C9C8DFEF66B8ADE6C84FBA,38291,12,14,2,109.51618,18.24313,1558
34951,262095,ECC87D4B92C9C8DFEF66B8ADE6C84FBA,38017,15,17,2,109.49729,18.21424,1504
34952,262096,ECC87D4B92C9C8DFEF66B8ADE6C84FBA,38541,22,23,1,109.73715,18.34875,2426
34953,262107,292F7AA5A13D44513985CC059AB0B0E9,31071,0,5,5,109.58257,18.28458,1815
34954,262108,292F7AA5A13D44513985CC059AB0B0E9,30854,9,19,10,109.56889,18.27076,1763
34955,262155,77E0479537D8350123531CE1FA2E6649,60631,0,12,12,109.57778,18.27583,1814
34956,262156,77E0479537D8350123531CE1FA2E6649,30854,16,23,7,109.56889,18.27076,1763
34957,262157,1FC1EE9261830F63E0A5F4681C41D592,30711,13,15,2,109.50271,18.25347,1510
34958,262158,1FC1EE9261830F63E0A5F4681C41D592,31031,18,19,1,109.49979,18.25382,1510
34959,262166,EEA9FE6C36184B76E616449954E6C55B,30201,14,15,1,109.4909,18.26465,1462
34960,262167,EEA9FE6C36184B76E616449954E6C55B,38212,18,23,5,109.48889,18.26306,1462
34961,262190,BF77B653864ED8DD6CB6952D60F33BB5,30171,0,6,6,109.48458,18.27139,1463
34962,262197,2D39AE6120F2674000C6DBB8A6E572A0,31945,0,15,15,109.58021,18.29403,1817
34963,262198,2D39AE6120F2674000C6DBB8A6E572A0,30854,17,18,1,109.56889,18.27076,1763
34967,262253,F7FA9EDDDD22A3605AF235C1758649A3,60401,0,6,6,109.47444,18.27583,1414
34968,262254,F7FA9EDDDD22A3605AF235C1758649A3,31781,11,12,1,109.19847,18.2975,367
34969,262255,F7FA9EDDDD22A3605AF235C1758649A3,31471,13,14,1,109.34583,18.29563,917
34970,262256,F7FA9EDDDD22A3605AF235C1758649A3,30361,15,17,2,109.50347,18.24,1508
34971,262307,DC0EB400EA24BEE9EB39D315B0E6AEF0,30171,18,21,3,109.48458,18.27139,1463
34972,262308,DC0EB400EA24BEE9EB39D315B0E6AEF0,60041,21,23,2,109.39889,18.31944,1121
34977,262350,E34C10F1C8BC04C7EF99531DA4E2FBE8,60281,19,20,1,109.51743,18.25924,1561
34978,262351,E34C10F1C8BC04C7EF99531DA4E2FBE8,30211,21,23,2,109.49882,18.23931,1508
34979,262363,EF428BA2D8FF285B80F14CDB1F80FC95,60211,0,9,9,109.63549,18.26049,2011
34980,262364,EF428BA2D8FF285B80F14CDB1F80FC95,30711,10,13,3,109.50271,18.25347,1510
34981,262365,EF428BA2D8FF285B80F14CDB1F80FC95,38283,13,23,10,109.62229,18.22618,1956
34982,262366,B128AECFAC76B09AA7B5F873BBC97F1F,31061,0,6,6,109.53333,18.23257,1607
34983,262367,B128AECFAC76B09AA7B5F873BBC97F1F,31301,10,12,2,109.14493,18.31222,170
34984,262368,B128AECFAC76B09AA7B5F873BBC97F1F,60054,14,15,1,109.3016,18.31229,770
34988,262424,34CDE58722D425921983509B878EB515,30181,15,22,7,109.51597,18.23313,1557
34989,262456,A68637AA89BD62624E677D9E66C32FAD,30361,2,6,4,109.50347,18.24,1508
34990,262457,A68637AA89BD62624E677D9E66C32FAD,30161,6,9,3,109.50042,18.24389,1508
34991,262458,A68637AA89BD62624E677D9E66C32FAD,30361,9,11,2,109.50347,18.24,1508
34992,262459,A68637AA89BD62624E677D9E66C32FAD,30161,11,14,3,109.50042,18.24389,1508
34993,262460,A68637AA89BD62624E677D9E66C32FAD,60261,16,23,7,109.44326,18.3075,1319
34994,262489,E8D51F8B53F290BFD73338AD2AD8C728,30854,14,17,3,109.56889,18.27076,1763
34995,262490,E8D51F8B53F290BFD73338AD2AD8C728,31561,20,21,1,109.56792,18.28479,1765
34996,262526,135B81D7EF945BBFA54C0C2F91CFFDD8,38261,0,7,7,109.50361,18.28153,1515
34997,262575,41BFDF202AA15C7D0EC7487840A4D094,30854,0,17,17,109.56889,18.27076,1763
34998,262576,41BFDF202AA15C7D0EC7487840A4D094,60631,20,22,2,109.57778,18.27583,1814
34999,262616,0D3DA8126B134D203BB35373EAFFB116,31071,2,7,5,109.58257,18.28458,1815
35000,262617,0D3DA8126B134D203BB35373EAFFB116,30854,10,17,7,109.56889,18.27076,1763
35001,262639,47A18820FDA9856131F74091D44B6BCB,31071,0,7,7,109.58257,18.28458,1815
35002,262640,47A18820FDA9856131F74091D44B6BCB,31561,7,16,9,109.56792,18.28479,1765
35007,262684,DD04F693D1086357462FD164DAD08818,31931,8,10,2,109.54771,18.29403,1667
35008,262685,DD04F693D1086357462FD164DAD08818,30921,10,11,1,109.53903,18.29451,1667
35009,262686,DD04F693D1086357462FD164DAD08818,31931,11,13,2,109.54771,18.29403,1667
35010,262710,A9FCE0049DB44FE004EAFBF5B783F4A5,31071,0,6,6,109.58257,18.28458,1815
35011,262711,A9FCE0049DB44FE004EAFBF5B783F4A5,30854,10,17,7,109.56889,18.27076,1763
35015,262752,84DF4A7C208235D171EF56473BCCF210,60631,13,18,5,109.57778,18.27583,1814
35016,262753,84DF4A7C208235D171EF56473BCCF210,30851,20,23,3,109.5616,18.27396,1713
35017,262762,015CDEB9169BCE5537ABAE49B6A63F2B,31071,0,7,7,109.58257,18.28458,1815
35018,262763,015CDEB9169BCE5537ABAE49B6A63F2B,30854,11,14,3,109.56889,18.27076,1763
35019,262764,015CDEB9169BCE5537ABAE49B6A63F2B,30421,15,16,1,109.50021,18.25861,1511
35020,262765,015CDEB9169BCE5537ABAE49B6A63F2B,30371,20,22,2,109.51,18.24771,1559
35021,262771,EC721F8259E3B17F432086B3F60AECE1,31554,0,15,15,109.55521,18.2459,1709
35022,262772,EC721F8259E3B17F432086B3F60AECE1,31551,15,16,1,109.55868,18.24222,1708
35027,262801,BE586ACB441383CC10D7CF3923850B73,31931,2,8,6,109.54771,18.29403,1667
35028,262802,BE586ACB441383CC10D7CF3923850B73,30921,8,9,1,109.53903,18.29451,1667
35029,262803,BE586ACB441383CC10D7CF3923850B73,31931,12,14,2,109.54771,18.29403,1667
35030,262804,BE586ACB441383CC10D7CF3923850B73,60371,15,16,1,109.53063,18.30056,1618
35031,262805,BE586ACB441383CC10D7CF3923850B73,31271,20,21,1,109.48958,18.26257,1462
35032,262821,833001CDF394BB3F6E4F040C2A70AC27,31071,1,7,6,109.58257,18.28458,1815
35033,262822,833001CDF394BB3F6E4F040C2A70AC27,30854,10,12,2,109.56889,18.27076,1763
35034,262863,15C58AA4098F7C3C06247EBC0EBAF235,31521,14,17,3,109.51458,18.22542,1555
35035,262864,15C58AA4098F7C3C06247EBC0EBAF235,60381,19,20,1,109.5241,18.22458,1605
35036,262865,15C58AA4098F7C3C06247EBC0EBAF235,31031,20,21,1,109.49979,18.25382,1510
35037,262866,15C58AA4098F7C3C06247EBC0EBAF235,39321,22,23,1,109.529,18.2167,1604
35041,262923,934029FB5F97BCE114EDCE88F0393A63,30421,8,14,6,109.50021,18.25861,1511
35042,262924,934029FB5F97BCE114EDCE88F0393A63,31071,16,17,1,109.58257,18.28458,1815
35043,262925,934029FB5F97BCE114EDCE88F0393A63,30711,18,20,2,109.50271,18.25347,1510
35044,262934,96F98526707B06BE1263CCD4F72E07A1,30854,15,17,2,109.56889,18.27076,1763
35045,262935,96F98526707B06BE1263CCD4F72E07A1,31071,17,18,1,109.58257,18.28458,1815
35046,262936,96F98526707B06BE1263CCD4F72E07A1,30854,19,21,2,109.56889,18.27076,1763
35050,262951,E082FB5BD091C5B334EC1176FF352EE0,30071,0,13,13,109.52819,18.30472,1619
35051,262952,E082FB5BD091C5B334EC1176FF352EE0,31931,17,19,2,109.54771,18.29403,1667
35052,262990,7D5E9CAF0010A9154C77C17BC4001BF8,31231,1,7,6,109.42597,18.29292,1217
35053,262991,7D5E9CAF0010A9154C77C17BC4001BF8,38102,11,13,2,109.40875,18.29111,1166
35054,262995,7050D1E0A5553A00BB03B768ACFBCA8F,31551,10,12,2,109.55868,18.24222,1708
35059,263011,209E8D959023269E16675F9705586E6A,38071,22,23,1,109.40722,18.30938,1169
35064,263048,75BB5F056A285E641293B913E6CE7C17,30741,12,13,1,109.49833,18.28681,1516
35065,263049,75BB5F056A285E641293B913E6CE7C17,31431,14,17,3,109.44639,18.29042,1316
35066,263050,75BB5F056A285E641293B913E6CE7C17,31411,19,22,3,109.5016,18.23576,1507
35067,263096,CD77A45360FB53F816FCE62F008EEE28,30071,0,7,7,109.52819,18.30472,1619
35068,263097,CD77A45360FB53F816FCE62F008EEE28,31931,7,10,3,109.54771,18.29403,1667
35075,263147,EE40D0798B945060F5E3D3F0B9F1FF61,60381,0,7,7,109.5241,18.22458,1605
35076,263148,EE40D0798B945060F5E3D3F0B9F1FF61,30661,10,12,2,109.37028,18.24361,1008
35077,263149,EE40D0798B945060F5E3D3F0B9F1FF61,31471,14,15,1,109.34583,18.29563,917
35078,263150,EE40D0798B945060F5E3D3F0B9F1FF61,31021,18,19,1,109.49021,18.27,1463
35079,263151,EE40D0798B945060F5E3D3F0B9F1FF61,60381,20,23,3,109.5241,18.22458,1605
35080,263193,D5BEC8AF00E93F31B9CBBFA811022B26,31031,19,20,1,109.49979,18.25382,1510
35081,263194,D5BEC8AF00E93F31B9CBBFA811022B26,60161,21,22,1,109.49174,18.26181,1461
35082,263200,7B9D64657CE26DF907B4C2AC87C9F431,38241,8,18,10,109.54111,18.30542,1669
35083,263201,7B9D64657CE26DF907B4C2AC87C9F431,31931,18,20,2,109.54771,18.29403,1667
35084,263219,92A852F4802D3D92C195A90A9645A57F,38325,16,17,1,109.39792,18.2909,1116
35085,263220,92A852F4802D3D92C195A90A9645A57F,38903,21,22,1,109.39229,18.29243,1117
35089,263224,DBB710D279E76C79F1E4B0766F579F8A,30854,14,17,3,109.56889,18.27076,1763
35090,263225,DBB710D279E76C79F1E4B0766F579F8A,31931,17,19,2,109.54771,18.29403,1667
35091,263226,DBB710D279E76C79F1E4B0766F579F8A,30854,21,22,1,109.56889,18.27076,1763
35092,263235,8799356B7181F28146A203E5F86C52F0,31351,0,19,19,109.4959,18.28417,1465
35093,263236,8799356B7181F28146A203E5F86C52F0,30741,20,23,3,109.49833,18.28681,1516
35097,263268,3DF04EEBD52CECF1C5996BD8607451EE,60084,14,15,1,109.4984,18.2334,1507
35098,263269,3DF04EEBD52CECF1C5996BD8607451EE,30441,19,20,1,109.64021,18.25424,2010
35099,263286,66A68DF7322984DDFD4069A80816FA0D,38052,13,14,1,109.62618,18.23042,1956
35100,263287,66A68DF7322984DDFD4069A80816FA0D,31221,18,19,1,109.61333,18.26833,1913
35101,263288,A2DBFF4E352E7B7C1EE25431C02FC741,30921,2,4,2,109.53903,18.29451,1667
35102,263289,A2DBFF4E352E7B7C1EE25431C02FC741,31931,5,19,14,109.54771,18.29403,1667
35103,263313,000584B3023702F3E9DDF521B1C35B1A,31945,1,2,1,109.58021,18.29403,1817
35104,263314,000584B3023702F3E9DDF521B1C35B1A,60354,3,5,2,109.58701,18.28521,1815
35105,263315,000584B3023702F3E9DDF521B1C35B1A,31945,6,7,1,109.58021,18.29403,1817
35106,263316,000584B3023702F3E9DDF521B1C35B1A,30221,15,17,2,109.57833,18.20222,1802
35107,263317,000584B3023702F3E9DDF521B1C35B1A,30854,18,20,2,109.56889,18.27076,1763
35108,263318,7EBC20D0E5F0FBA046CA1D08E7FF47C1,31071,6,8,2,109.58257,18.28458,1815
35109,263319,7EBC20D0E5F0FBA046CA1D08E7FF47C1,30854,12,13,1,109.56889,18.27076,1763
35113,263365,116946A75ECB7D461042B4C21CF61908,30111,3,8,5,109.47583,18.30542,1419
35114,263366,116946A75ECB7D461042B4C21CF61908,31181,10,11,1,109.50382,18.24813,1509
35115,263367,116946A75ECB7D461042B4C21CF61908,30111,13,14,1,109.47583,18.30542,1419
35119,263417,020753EF78F0A0C39658113A3377EA1E,31931,14,17,3,109.54771,18.29403,1667
35120,263418,020753EF78F0A0C39658113A3377EA1E,31561,19,20,1,109.56792,18.28479,1765
35121,263419,78F41A3C97446FDE39A7BB3208341D35,31021,2,6,4,109.49021,18.27,1463
35122,263420,78F41A3C97446FDE39A7BB3208341D35,31271,6,8,2,109.48958,18.26257,1462
35123,263421,78F41A3C97446FDE39A7BB3208341D35,31021,8,9,1,109.49021,18.27,1463
35124,263422,78F41A3C97446FDE39A7BB3208341D35,30201,11,16,5,109.4909,18.26465,1462
35125,263423,78F41A3C97446FDE39A7BB3208341D35,31021,17,20,3,109.49021,18.27,1463
35126,263424,78F41A3C97446FDE39A7BB3208341D35,39061,22,23,1,109.38222,18.28958,1066
35127,263433,06FE0B1385071A4A7D315725DC72CBEB,38754,18,19,1,109.74667,18.37382,2430
35128,263434,06FE0B1385071A4A7D315725DC72CBEB,60201,21,23,2,109.5041,18.2509,1510
35132,263441,855A60A5BCB36D799943E99FBF88EAD0,31864,0,8,8,109.49014,18.28333,1465
35133,263442,855A60A5BCB36D799943E99FBF88EAD0,60551,9,10,1,109.42722,18.30111,1218
35134,263443,855A60A5BCB36D799943E99FBF88EAD0,31781,11,13,2,109.19847,18.2975,367
35135,263444,855A60A5BCB36D799943E99FBF88EAD0,60054,14,16,2,109.3016,18.31229,770
35136,263501,A0D3E6D96C80E44901F7F9B3B58D5A1A,30421,10,13,3,109.50021,18.25861,1511
35137,263502,A0D3E6D96C80E44901F7F9B3B58D5A1A,31121,16,17,1,109.16292,18.37063,230
35138,263520,2F578B567AB440CCCFAE4543FB5BCFD7,30421,14,16,2,109.50021,18.25861,1511
35139,263521,2F578B567AB440CCCFAE4543FB5BCFD7,60201,16,18,2,109.5041,18.2509,1510
35140,263522,2F578B567AB440CCCFAE4543FB5BCFD7,60161,18,19,1,109.49174,18.26181,1461
35144,263530,213AF2099653A4ADAEF799CCC144B279,30021,3,10,7,109.12014,18.40986,86
35145,263544,4C677DC1CDBE32E026FB887DD09EFEC7,60201,0,7,7,109.5041,18.2509,1510
35146,263545,4C677DC1CDBE32E026FB887DD09EFEC7,31781,10,13,3,109.19847,18.2975,367
35147,263546,4C677DC1CDBE32E026FB887DD09EFEC7,31471,16,17,1,109.34583,18.29563,917
35151,263595,D9AE11CD16B231308C3F0FB3F53BC3E9,30854,0,17,17,109.56889,18.27076,1763
35152,263596,D9AE11CD16B231308C3F0FB3F53BC3E9,31931,18,21,3,109.54771,18.29403,1667
35153,263642,8B9A9BFD1ACAD480EB101A91DBF2024D,38291,4,15,11,109.51618,18.24313,1558
35154,263643,8B9A9BFD1ACAD480EB101A91DBF2024D,30371,16,18,2,109.51,18.24771,1559
35155,263711,D618A6C3100C9BD1930907167F1B2D2D,31251,18,23,5,109.18528,18.2975,317
35163,263802,BA661398B83717FCC0BF595ECF74D89D,30561,0,9,9,109.52778,18.31938,1621
35164,263803,BA661398B83717FCC0BF595ECF74D89D,31031,10,12,2,109.49979,18.25382,1510
35165,263804,BA661398B83717FCC0BF595ECF74D89D,60361,13,17,4,109.51938,18.29681,1567
35166,263805,BA661398B83717FCC0BF595ECF74D89D,60381,18,21,3,109.5241,18.22458,1605
35167,263806,BA661398B83717FCC0BF595ECF74D89D,30561,22,23,1,109.52778,18.31938,1621
35171,263861,9EBFE19AEC38C3A6F47AE2D903294BAE,30854,0,2,2,109.56889,18.27076,1763
35172,263862,9EBFE19AEC38C3A6F47AE2D903294BAE,31561,3,5,2,109.56792,18.28479,1765
35173,263863,9EBFE19AEC38C3A6F47AE2D903294BAE,30854,6,10,4,109.56889,18.27076,1763
35174,263864,9EBFE19AEC38C3A6F47AE2D903294BAE,31761,13,14,1,109.60521,18.27965,1914
35175,263865,9EBFE19AEC38C3A6F47AE2D903294BAE,30854,14,16,2,109.56889,18.27076,1763
35176,263866,9EBFE19AEC38C3A6F47AE2D903294BAE,31164,17,20,3,109.69993,18.27215,2263
35177,263867,7890099D98AA300C5BF12527E7372DB0,31071,13,17,4,109.58257,18.28458,1815
35178,263868,7890099D98AA300C5BF12527E7372DB0,60631,19,23,4,109.57778,18.27583,1814
35179,263908,C5062DBE2A03371DC4B3A666E439E273,60077,14,16,2,109.75764,18.31424,2470
35180,263910,C5062DBE2A03371DC4B3A666E439E273,60077,19,23,4,109.75764,18.31424,2470
35187,263960,40285EE8CCE25C38988EC087545664EC,31071,2,7,5,109.58257,18.28458,1815
35188,263961,40285EE8CCE25C38988EC087545664EC,30854,7,15,8,109.56889,18.27076,1763
35192,264040,7D1ED6067ECBD941EFC43CE0A6ADAE71,31071,13,17,4,109.58257,18.28458,1815
35193,264041,7D1ED6067ECBD941EFC43CE0A6ADAE71,31071,19,21,2,109.58257,18.28458,1815
35194,264046,9E8746086915F9D4A063A74CF0B5B7AB,31561,0,6,6,109.56792,18.28479,1765
35195,264047,9E8746086915F9D4A063A74CF0B5B7AB,39183,9,10,1,109.55542,18.28208,1715
35196,264064,83F5F6CBF2A63352524671B510BBFB08,30281,20,21,1,109.50597,18.27583,1514
35197,264065,83F5F6CBF2A63352524671B510BBFB08,30191,21,22,1,109.50361,18.22701,1506
35198,264090,51DF765CB634D9549D20AD1F2C37BA18,31561,5,6,1,109.56792,18.28479,1765
35199,264091,51DF765CB634D9549D20AD1F2C37BA18,30854,11,12,1,109.56889,18.27076,1763
35200,264092,51DF765CB634D9549D20AD1F2C37BA18,31561,12,13,1,109.56792,18.28479,1765
35201,264093,51DF765CB634D9549D20AD1F2C37BA18,30854,14,20,6,109.56889,18.27076,1763
35202,264094,51DF765CB634D9549D20AD1F2C37BA18,31561,20,23,3,109.56792,18.28479,1765
35203,264095,487521C796C9B83A04D2BF725345DF16,33481,15,17,2,109.67278,18.41278,2187
35204,264096,487521C796C9B83A04D2BF725345DF16,38754,18,19,1,109.74667,18.37382,2430
35208,264161,31C925B9876FE9FFC3F673B5040150FB,31521,0,6,6,109.51458,18.22542,1555
35209,264162,31C925B9876FE9FFC3F673B5040150FB,31521,7,9,2,109.51458,18.22542,1555
35210,264163,31C925B9876FE9FFC3F673B5040150FB,31781,11,13,2,109.19847,18.2975,367
35211,264164,31C925B9876FE9FFC3F673B5040150FB,31521,15,22,7,109.51458,18.22542,1555
35212,264167,968E09217B26E1E21B124536BDB6DBAA,31931,0,9,9,109.54771,18.29403,1667
35213,264168,968E09217B26E1E21B124536BDB6DBAA,30921,12,13,1,109.53903,18.29451,1667
35214,264173,6FD88D74D66E8FAB66A93CB5D0609C41,31071,13,15,2,109.58257,18.28458,1815
35215,264174,6FD88D74D66E8FAB66A93CB5D0609C41,30854,17,19,2,109.56889,18.27076,1763
35216,264175,6FD88D74D66E8FAB66A93CB5D0609C41,31071,20,22,2,109.58257,18.28458,1815
35220,264184,F3C7AE04A75E030C03A36AADCEE442EA,38321,10,14,4,109.39854,18.29132,1116
35221,264185,F3C7AE04A75E030C03A36AADCEE442EA,38321,19,23,4,109.39854,18.29132,1116
35240,264295,140E49D84073576933F5061FC541290E,31321,0,7,7,109.63799,18.23201,2007
35241,264296,140E49D84073576933F5061FC541290E,60381,8,9,1,109.5241,18.22458,1605
35242,264297,140E49D84073576933F5061FC541290E,31781,11,14,3,109.19847,18.2975,367
35243,264298,140E49D84073576933F5061FC541290E,31471,15,17,2,109.34583,18.29563,917
35244,264299,140E49D84073576933F5061FC541290E,30581,20,21,1,109.62257,18.24951,1959
35245,264315,58418A9EA4A7DC03127CB79C039A5185,31851,7,10,3,109.71736,18.29007,2316
35246,264316,58418A9EA4A7DC03127CB79C039A5185,30854,13,17,4,109.56889,18.27076,1763
35250,264409,B34415F599F0ED7D1A073EE314A60B9B,31671,0,11,11,109.38965,18.29813,1068
35251,264410,B34415F599F0ED7D1A073EE314A60B9B,60041,12,13,1,109.39889,18.31944,1121
35252,264411,B34415F599F0ED7D1A073EE314A60B9B,31671,16,19,3,109.38965,18.29813,1068
35253,264412,B34415F599F0ED7D1A073EE314A60B9B,31031,20,21,1,109.49979,18.25382,1510
35254,264421,31B5749A66C854438247EB4202810257,39321,12,14,2,109.529,18.2167,1604
35255,264422,31B5749A66C854438247EB4202810257,60381,14,17,3,109.5241,18.22458,1605
35256,264423,31B5749A66C854438247EB4202810257,30161,18,19,1,109.50042,18.24389,1508
35257,264424,31B5749A66C854438247EB4202810257,60381,20,21,1,109.5241,18.22458,1605
35258,264454,70655AD92B06CDB42EC8BC912F906F64,60231,13,16,3,109.49903,18.21972,1504
35259,264455,70655AD92B06CDB42EC8BC912F906F64,39091,20,21,1,109.50097,18.25222,1510
35260,264461,EC4B90EDBF35256FDB4D4F8B87DB8A04,30854,15,16,1,109.56889,18.27076,1763
35261,264462,EC4B90EDBF35256FDB4D4F8B87DB8A04,30271,19,21,2,109.49132,18.23153,1456
35262,264543,90AC20E6CC0B4ABA3A4EAC5C3086C030,31351,18,19,1,109.4959,18.28417,1465
35263,264544,90AC20E6CC0B4ABA3A4EAC5C3086C030,30391,21,23,2,109.4975,18.27118,1513
35264,264597,2C7DB696A14A5E061C2912E5376233C9,31071,6,12,6,109.58257,18.28458,1815
35265,264598,2C7DB696A14A5E061C2912E5376233C9,30854,14,16,2,109.56889,18.27076,1763
35266,264599,2C7DB696A14A5E061C2912E5376233C9,31071,19,23,4,109.58257,18.28458,1815
35267,264618,0509306A3FC9EC5D9E03F62CADA412D1,31471,15,17,2,109.34583,18.29563,917
35268,264619,0509306A3FC9EC5D9E03F62CADA412D1,31061,21,23,2,109.53333,18.23257,1607
35269,264624,03CEC0FDDD5484124514C6D24A63D4DD,39183,14,16,2,109.55542,18.28208,1715
35270,264625,03CEC0FDDD5484124514C6D24A63D4DD,31561,18,19,1,109.56792,18.28479,1765
35271,264676,5F5C4FD8AEBF5C6D1106F430084E66FA,31931,6,11,5,109.54771,18.29403,1667
35272,264677,5F5C4FD8AEBF5C6D1106F430084E66FA,30921,11,13,2,109.53903,18.29451,1667
35273,264690,AF125EFCC483E24833CBDDBC7248BDF1,38721,0,8,8,109.50368,18.27542,1514
35274,264691,AF125EFCC483E24833CBDDBC7248BDF1,30281,11,16,5,109.50597,18.27583,1514
35275,264714,14F1CC63CDA098F9694EAC8584B9C7A5,31071,4,7,3,109.58257,18.28458,1815
35276,264715,14F1CC63CDA098F9694EAC8584B9C7A5,30854,11,13,2,109.56889,18.27076,1763
35277,264739,E218C587552A5DADC05C4E69685FE374,30854,0,2,2,109.56889,18.27076,1763
35278,264740,E218C587552A5DADC05C4E69685FE374,39183,5,19,14,109.55542,18.28208,1715
35279,264741,E218C587552A5DADC05C4E69685FE374,38071,21,22,1,109.40722,18.30938,1169
35280,264742,82FA50C876D91311B7DA8BB626927288,31945,9,10,1,109.58021,18.29403,1817
35281,264743,82FA50C876D91311B7DA8BB626927288,30854,11,16,5,109.56889,18.27076,1763
35282,264744,82FA50C876D91311B7DA8BB626927288,38141,17,23,6,109.39479,18.2916,1116
35283,264788,1D8B814EC83D52D7C5F3FED99C129EE0,30854,0,10,10,109.56889,18.27076,1763
35284,264789,1D8B814EC83D52D7C5F3FED99C129EE0,31071,10,13,3,109.58257,18.28458,1815
35285,264790,1D8B814EC83D52D7C5F3FED99C129EE0,38271,14,18,4,109.62632,18.23049,1956
35286,264791,1D8B814EC83D52D7C5F3FED99C129EE0,31861,20,23,3,109.49042,18.27549,1464
35287,264797,0CBDBB0FD86E41225B8F6BD8B7F216EA,38541,19,21,2,109.73715,18.34875,2426
35291,264975,2F64FEF19C86AA0A8AA3E3FA37CC4F2D,30851,0,2,2,109.5616,18.27396,1713
35292,264976,2F64FEF19C86AA0A8AA3E3FA37CC4F2D,60631,2,23,21,109.57778,18.27583,1814
35293,265000,5BC86F424BAF4B877A98262DEDE87053,38154,2,12,10,109.5266,18.28278,1615
35294,265001,5BC86F424BAF4B877A98262DEDE87053,60201,13,15,2,109.5041,18.2509,1510
35295,265002,C17A8098B013F904BD9DA05D90234A30,30581,0,8,8,109.62257,18.24951,1959
35296,265003,C17A8098B013F904BD9DA05D90234A30,31221,11,15,4,109.61333,18.26833,1913
35297,265011,DE91F768E6CCDB78867FF54F078574C9,30854,13,17,4,109.56889,18.27076,1763
35298,265012,DE91F768E6CCDB78867FF54F078574C9,60381,19,21,2,109.5241,18.22458,1605
35299,265039,7BF65E5054DA81A230AB5423620158E1,30854,11,15,4,109.56889,18.27076,1763
35300,265040,7BF65E5054DA81A230AB5423620158E1,31164,17,19,2,109.69993,18.27215,2263
35301,265041,7BF65E5054DA81A230AB5423620158E1,30191,22,23,1,109.50361,18.22701,1506
35306,265070,440F19E22CD489CB40DEAEB72E820CF6,31421,0,6,6,109.55382,18.22347,1705
35307,265071,440F19E22CD489CB40DEAEB72E820CF6,31561,9,10,1,109.56792,18.28479,1765
35308,265072,440F19E22CD489CB40DEAEB72E820CF6,30221,14,15,1,109.57833,18.20222,1802
35309,265096,21EC4C8BDFA621F6D49F50C6AB1C3F22,30821,16,17,1,109.43681,18.33639,1274
35310,265097,21EC4C8BDFA621F6D49F50C6AB1C3F22,38951,19,23,4,109.48097,18.28868,1416
35311,265098,FF374776E6D44861C88B04D75BCDE244,30181,0,14,14,109.51597,18.23313,1557
35312,265099,FF374776E6D44861C88B04D75BCDE244,31201,14,23,9,109.51042,18.23819,1558
35313,265116,9352766CE000C006A9C46226806783DB,31561,6,7,1,109.56792,18.28479,1765
35314,265117,9352766CE000C006A9C46226806783DB,60541,10,12,2,109.4084,18.29208,1167
35315,265118,9352766CE000C006A9C46226806783DB,31561,14,15,1,109.56792,18.28479,1765
35316,265119,9352766CE000C006A9C46226806783DB,30854,16,18,2,109.56889,18.27076,1763
35324,265249,28A67AC0647BDCD2E98A0545DD1F804F,30854,12,13,1,109.56889,18.27076,1763
35325,265250,28A67AC0647BDCD2E98A0545DD1F804F,60361,17,19,2,109.51938,18.29681,1567
35326,265251,28A67AC0647BDCD2E98A0545DD1F804F,30741,19,21,2,109.49833,18.28681,1516
35327,265260,8F6EA1C108FADA76A214A7ED71ECE3D1,30891,4,5,1,109.59431,18.28389,1865
35328,265261,8F6EA1C108FADA76A214A7ED71ECE3D1,30854,7,14,7,109.56889,18.27076,1763
35329,265289,D3CAC84BD13A9221A0C5DFD0311E5931,31151,0,8,8,109.75549,18.4191,2488
35330,265290,D3CAC84BD13A9221A0C5DFD0311E5931,60117,9,11,2,109.73604,18.35681,2427
35331,265291,D3CAC84BD13A9221A0C5DFD0311E5931,31151,12,14,2,109.75549,18.4191,2488
35332,265292,D3CAC84BD13A9221A0C5DFD0311E5931,60381,15,16,1,109.5241,18.22458,1605
35333,265293,D3CAC84BD13A9221A0C5DFD0311E5931,31031,17,21,4,109.49979,18.25382,1510
35334,265294,D3CAC84BD13A9221A0C5DFD0311E5931,60571,21,22,1,109.50722,18.25056,1510
35335,265301,7E6785B0140786E78D38CB13406ECE42,60054,14,16,2,109.3016,18.31229,770
35336,265302,7E6785B0140786E78D38CB13406ECE42,30861,18,23,5,109.52722,18.22743,1606
35337,265319,74B59B7AC338E4BD1734CAA94AEFECB9,39321,2,12,10,109.529,18.2167,1604
35338,265320,74B59B7AC338E4BD1734CAA94AEFECB9,31041,13,15,2,109.50278,18.23701,1507
35339,265327,FC538491B51012B0C69C7B5B7058D494,48571,15,17,2,109.48368,18.28854,1466
35340,265328,FC538491B51012B0C69C7B5B7058D494,48571,21,23,2,109.48368,18.28854,1466
35341,265329,EF7DCA5602FCDF14AF156D676A8ED902,30851,0,1,1,109.5616,18.27396,1713
35342,265330,EF7DCA5602FCDF14AF156D676A8ED902,31561,4,19,15,109.56792,18.28479,1765
35343,265371,99B228F0AF2782D11BEEBEDCE5C3BC46,30421,11,13,2,109.50021,18.25861,1511
35344,265372,99B228F0AF2782D11BEEBEDCE5C3BC46,60084,13,16,3,109.4984,18.2334,1507
35349,265397,162C9DF38B34BB5029840E39407B0BD5,39191,0,7,7,109.51493,18.23472,1557
35350,265398,162C9DF38B34BB5029840E39407B0BD5,31041,8,22,14,109.50278,18.23701,1507
35354,265508,64FF3E93355E6DCA29977E04D316EABA,31381,1,10,9,109.1375,18.36833,129
35355,265510,64FF3E93355E6DCA29977E04D316EABA,30151,16,21,5,109.50986,18.25083,1560
35356,265511,64FF3E93355E6DCA29977E04D316EABA,60131,21,22,1,109.49819,18.24778,1509
35364,265580,4DACD9C7A334B4FC26114503CE8EB0EA,60551,0,4,4,109.42722,18.30111,1218
35365,265581,4DACD9C7A334B4FC26114503CE8EB0EA,60524,4,6,2,109.42951,18.28993,1216
35366,265582,4DACD9C7A334B4FC26114503CE8EB0EA,30351,7,8,1,109.41701,18.29292,1217
35367,265583,4DACD9C7A334B4FC26114503CE8EB0EA,31301,10,12,2,109.14493,18.31222,170
35368,265584,4DACD9C7A334B4FC26114503CE8EB0EA,60054,13,14,1,109.3016,18.31229,770
35369,265585,4DACD9C7A334B4FC26114503CE8EB0EA,31201,16,18,2,109.51042,18.23819,1558
35370,265586,4DACD9C7A334B4FC26114503CE8EB0EA,60551,21,23,2,109.42722,18.30111,1218
35374,265741,C1F100A79C441D3FFDBAE922D32DC8D2,39371,3,4,1,109.56627,18.2646,1762
35375,265742,C1F100A79C441D3FFDBAE922D32DC8D2,30854,6,23,17,109.56889,18.27076,1763
35376,265743,6751CEC3CF9B2AE78246C7287443D2B4,30854,10,19,9,109.56889,18.27076,1763
35377,265744,6751CEC3CF9B2AE78246C7287443D2B4,31945,20,21,1,109.58021,18.29403,1817
35378,265745,FE25DC2B1C76400A045638C7D9F97891,30851,0,6,6,109.5616,18.27396,1713
35379,265746,FE25DC2B1C76400A045638C7D9F97891,60631,7,16,9,109.57778,18.27583,1814
35380,265806,4D4289AE0DFBF4B5C79A47559DC2EBDD,31071,0,11,11,109.58257,18.28458,1815
35381,265807,4D4289AE0DFBF4B5C79A47559DC2EBDD,30854,11,15,4,109.56889,18.27076,1763
35382,265808,4D4289AE0DFBF4B5C79A47559DC2EBDD,60463,17,18,1,109.52507,18.22438,1605
35383,265809,59F29435D748531F416A4F1636997ECF,31071,0,7,7,109.58257,18.28458,1815
35384,265810,59F29435D748531F416A4F1636997ECF,30854,7,9,2,109.56889,18.27076,1763
35389,265843,C031035D6C98ABF453B46DABD1995154,30201,0,8,8,109.4909,18.26465,1462
35390,265844,C031035D6C98ABF453B46DABD1995154,31301,9,11,2,109.14493,18.31222,170
35391,265845,C031035D6C98ABF453B46DABD1995154,30371,15,16,1,109.51,18.24771,1559
35392,265846,C031035D6C98ABF453B46DABD1995154,31431,17,18,1,109.44639,18.29042,1316
35393,265847,C031035D6C98ABF453B46DABD1995154,31271,19,23,4,109.48958,18.26257,1462
35394,265853,5C58BF30923366F68B9E9B57492E4E6A,30201,0,6,6,109.4909,18.26465,1462
35395,265854,5C58BF30923366F68B9E9B57492E4E6A,31781,10,12,2,109.19847,18.2975,367
35396,265855,5C58BF30923366F68B9E9B57492E4E6A,30201,17,23,6,109.4909,18.26465,1462
35397,265867,7F377D9BD4A6752A92F213BA9B3E59E5,38251,0,10,10,109.49618,18.25493,1510
35398,265868,7F377D9BD4A6752A92F213BA9B3E59E5,30421,10,12,2,109.50021,18.25861,1511
35399,265869,7F377D9BD4A6752A92F213BA9B3E59E5,38251,12,14,2,109.49618,18.25493,1510
35400,265870,7F377D9BD4A6752A92F213BA9B3E59E5,30421,15,16,1,109.50021,18.25861,1511
35401,265871,7F377D9BD4A6752A92F213BA9B3E59E5,38251,17,18,1,109.49618,18.25493,1510
35402,265872,7F377D9BD4A6752A92F213BA9B3E59E5,30421,20,23,3,109.50021,18.25861,1511
35403,265891,522E8CB42AF22D75F3E9D0FD1FDCEEA6,30854,12,14,2,109.56889,18.27076,1763
35404,265892,522E8CB42AF22D75F3E9D0FD1FDCEEA6,31521,18,20,2,109.51458,18.22542,1555
35408,265912,24C0932BD5754CA1476755EEBD27CEBD,31811,0,13,13,109.54201,18.31806,1671
35409,265913,24C0932BD5754CA1476755EEBD27CEBD,30741,13,15,2,109.49833,18.28681,1516
35410,265914,24C0932BD5754CA1476755EEBD27CEBD,38251,16,17,1,109.49618,18.25493,1510
35411,265915,24C0932BD5754CA1476755EEBD27CEBD,60361,21,23,2,109.51938,18.29681,1567
35412,265918,B2EAF2370DACE0D2E981BAA0267B94BE,39183,22,23,1,109.55542,18.28208,1715
35413,265945,0EA31DC24D5B7028E03AA286B0DB11EF,31071,0,1,1,109.58257,18.28458,1815
35414,265946,0EA31DC24D5B7028E03AA286B0DB11EF,30854,2,14,12,109.56889,18.27076,1763
35415,265947,0EA31DC24D5B7028E03AA286B0DB11EF,60661,17,18,1,109.548,18.2377,1657
35416,265948,0EA31DC24D5B7028E03AA286B0DB11EF,30854,19,22,3,109.56889,18.27076,1763
35421,266042,EA4EEEA6F324C3F08DBAE63BA2B33BB6,30084,0,7,7,109.50118,18.26972,1513
35422,266043,EA4EEEA6F324C3F08DBAE63BA2B33BB6,31391,7,9,2,109.50382,18.24285,1508
35423,266044,EA4EEEA6F324C3F08DBAE63BA2B33BB6,30511,13,14,1,109.51069,18.24208,1558
35424,266045,EA4EEEA6F324C3F08DBAE63BA2B33BB6,31181,17,19,2,109.50382,18.24813,1509
35425,266046,EA4EEEA6F324C3F08DBAE63BA2B33BB6,30084,22,23,1,109.50118,18.26972,1513
35426,266050,B19D039FEBAFACB75FE183A18A8FD559,30854,0,6,6,109.56889,18.27076,1763
35427,266051,B19D039FEBAFACB75FE183A18A8FD559,33481,9,13,4,109.67278,18.41278,2187
35428,266121,372A5433078073EAD18922D679CE0A73,60054,4,8,4,109.3016,18.31229,770
35429,266122,372A5433078073EAD18922D679CE0A73,30661,9,10,1,109.37028,18.24361,1008
35430,266123,372A5433078073EAD18922D679CE0A73,60054,10,11,1,109.3016,18.31229,770
35431,266124,372A5433078073EAD18922D679CE0A73,30661,12,13,1,109.37028,18.24361,1008
35432,266125,372A5433078073EAD18922D679CE0A73,60054,14,23,9,109.3016,18.31229,770
35433,266133,2B52FA76118CEF84900876F721F81416,31351,19,22,3,109.4959,18.28417,1465
35437,266216,D2112FF97338A1691790D531295A7953,30201,0,9,9,109.4909,18.26465,1462
35438,266217,D2112FF97338A1691790D531295A7953,31781,11,12,1,109.19847,18.2975,367
35439,266218,D2112FF97338A1691790D531295A7953,60054,15,16,1,109.3016,18.31229,770
35440,266219,D2112FF97338A1691790D531295A7953,30201,17,18,1,109.4909,18.26465,1462
35441,266220,D2112FF97338A1691790D531295A7953,30361,19,20,1,109.50347,18.24,1508
35452,266359,96664497BF518F17E0695975FE9417F5,31421,15,17,2,109.55382,18.22347,1705
35453,266360,96664497BF518F17E0695975FE9417F5,30861,19,23,4,109.52722,18.22743,1606
35458,266387,5561961A41FEBE8B8B0A897BFF076F9F,31121,0,2,2,109.16292,18.37063,230
35459,266388,5561961A41FEBE8B8B0A897BFF076F9F,31301,2,10,8,109.14493,18.31222,170
35460,266389,5561961A41FEBE8B8B0A897BFF076F9F,30854,11,16,5,109.56889,18.27076,1763
35461,266390,5561961A41FEBE8B8B0A897BFF076F9F,31071,19,23,4,109.58257,18.28458,1815
35462,266391,92AE5D206344DB3ADEF2488FC532EBB9,30854,8,10,2,109.56889,18.27076,1763
35463,266392,92AE5D206344DB3ADEF2488FC532EBB9,31411,11,13,2,109.5016,18.23576,1507
35464,266393,92AE5D206344DB3ADEF2488FC532EBB9,30361,13,15,2,109.50347,18.24,1508
35465,266394,92AE5D206344DB3ADEF2488FC532EBB9,31071,18,20,2,109.58257,18.28458,1815
35466,266395,92AE5D206344DB3ADEF2488FC532EBB9,30854,20,22,2,109.56889,18.27076,1763
35476,266414,9B389AE8E9B004176803CCEAFF69104A,39101,12,13,1,109.50132,18.24931,1509
35477,266415,9B389AE8E9B004176803CCEAFF69104A,60631,17,18,1,109.57778,18.27583,1814
35478,266416,56B310842D84169C664B7D5E5FA918BC,60661,0,6,6,109.548,18.2377,1657
35479,266417,56B310842D84169C664B7D5E5FA918BC,60641,6,10,4,109.53854,18.2359,1657
35480,266418,56B310842D84169C664B7D5E5FA918BC,60661,10,12,2,109.548,18.2377,1657
35481,266419,56B310842D84169C664B7D5E5FA918BC,60381,12,14,2,109.5241,18.22458,1605
35482,266420,56B310842D84169C664B7D5E5FA918BC,31554,14,16,2,109.55521,18.2459,1709
35483,266421,56B310842D84169C664B7D5E5FA918BC,38017,20,21,1,109.49729,18.21424,1504
35484,266422,56B310842D84169C664B7D5E5FA918BC,31554,22,23,1,109.55521,18.2459,1709
35485,266495,3D8ADE80304FD3207128013D43F1118A,60421,0,12,12,109.46333,18.31743,1371
35486,266496,3D8ADE80304FD3207128013D43F1118A,60274,13,15,2,109.514,18.2933,1567
35487,266508,8E244E94833DBF281BCBFE2F4A36E102,30581,11,19,8,109.62257,18.24951,1959
35488,266509,8E244E94833DBF281BCBFE2F4A36E102,60641,21,23,2,109.53854,18.2359,1657
35489,266513,29ECA8B496C1247488B5C7D877F65A99,30191,3,16,13,109.50361,18.22701,1506
35490,266514,29ECA8B496C1247488B5C7D877F65A99,31521,20,23,3,109.51458,18.22542,1555
35491,266515,1319E1E416A553CAED80375F3946B3EF,31521,0,3,3,109.51458,18.22542,1555
35492,266516,1319E1E416A553CAED80375F3946B3EF,60381,3,8,5,109.5241,18.22458,1605
35493,266517,1319E1E416A553CAED80375F3946B3EF,31521,9,10,1,109.51458,18.22542,1555
35494,266518,1319E1E416A553CAED80375F3946B3EF,31521,13,16,3,109.51458,18.22542,1555
35495,266519,1319E1E416A553CAED80375F3946B3EF,60381,18,23,5,109.5241,18.22458,1605
35499,266530,D2CD25D7A8500787C486CAD0AAC0DD3D,38134,0,8,8,109.63931,18.23451,2007
35500,266531,D2CD25D7A8500787C486CAD0AAC0DD3D,31101,8,9,1,109.65389,18.23403,2057
35501,266532,D2CD25D7A8500787C486CAD0AAC0DD3D,31411,13,14,1,109.5016,18.23576,1507
35502,266533,D2CD25D7A8500787C486CAD0AAC0DD3D,31471,16,18,2,109.34583,18.29563,917
35503,266552,3456594AEC9E6FDA19A05A8636C616BD,30854,15,17,2,109.56889,18.27076,1763
35504,266553,3456594AEC9E6FDA19A05A8636C616BD,31071,19,21,2,109.58257,18.28458,1815
35505,266554,3456594AEC9E6FDA19A05A8636C616BD,30854,21,23,2,109.56889,18.27076,1763
35506,266597,2FCF6CC7813BBC7D82090A44235F4CA9,39111,0,6,6,109.5191,18.22597,1555
35507,266598,2FCF6CC7813BBC7D82090A44235F4CA9,38291,6,8,2,109.51618,18.24313,1558
35508,266599,2FCF6CC7813BBC7D82090A44235F4CA9,31521,12,14,2,109.51458,18.22542,1555
35509,266600,2FCF6CC7813BBC7D82090A44235F4CA9,60231,14,16,2,109.49903,18.21972,1504
35510,266601,2FCF6CC7813BBC7D82090A44235F4CA9,31521,17,20,3,109.51458,18.22542,1555
35511,266602,2FCF6CC7813BBC7D82090A44235F4CA9,60381,21,23,2,109.5241,18.22458,1605
35516,266701,5664C5FF6B352F96C7620F94430DAC4F,31391,0,8,8,109.50382,18.24285,1508
35517,266702,5664C5FF6B352F96C7620F94430DAC4F,31521,9,11,2,109.51458,18.22542,1555
35518,266703,5664C5FF6B352F96C7620F94430DAC4F,31521,11,14,3,109.51458,18.22542,1555
35519,266704,5664C5FF6B352F96C7620F94430DAC4F,31521,15,16,1,109.51458,18.22542,1555
35520,266705,5664C5FF6B352F96C7620F94430DAC4F,31521,17,22,5,109.51458,18.22542,1555
35521,266714,5A52D514A004C406B3CAF14D74C40F10,31206,0,7,7,109.50819,18.23549,1507
35522,266715,5A52D514A004C406B3CAF14D74C40F10,31145,9,11,2,109.20431,18.30479,369
35523,266716,5A52D514A004C406B3CAF14D74C40F10,31206,14,16,2,109.50819,18.23549,1507
35524,266717,5A52D514A004C406B3CAF14D74C40F10,60241,17,21,4,109.53319,18.28667,1616
35525,266718,5A52D514A004C406B3CAF14D74C40F10,31201,21,23,2,109.51042,18.23819,1558
35526,266730,F7F33BB1C68494D5DA2069CBA2A8F745,31071,11,17,6,109.58257,18.28458,1815
35527,266731,F7F33BB1C68494D5DA2069CBA2A8F745,60381,20,21,1,109.5241,18.22458,1605
35528,266752,550F79FAD9D15F325A21DE6477758CB2,31071,0,10,10,109.58257,18.28458,1815
35529,266753,550F79FAD9D15F325A21DE6477758CB2,30854,12,18,6,109.56889,18.27076,1763
35530,266759,4A25CB3E62B66E3D1E498BE9F1B6F120,60291,12,13,1,109.50826,18.24639,1509
35531,266760,4A25CB3E62B66E3D1E498BE9F1B6F120,31521,16,18,2,109.51458,18.22542,1555
35532,266761,4A25CB3E62B66E3D1E498BE9F1B6F120,31041,20,21,1,109.50278,18.23701,1507
35533,266770,4540D133CCD3F1F52D06D03C8E81B25F,60201,17,19,2,109.5041,18.2509,1510
35534,266771,4540D133CCD3F1F52D06D03C8E81B25F,60381,20,23,3,109.5241,18.22458,1605
35535,266778,6BC6C104B718F24B54085D1A3B005DEC,38951,0,7,7,109.48097,18.28868,1416
35536,266779,6BC6C104B718F24B54085D1A3B005DEC,33481,10,11,1,109.67278,18.41278,2187
35537,266787,B64A184E0F7798F21B07EE969AEA1D55,60621,0,8,8,109.48354,18.27451,1464
35538,266788,B64A184E0F7798F21B07EE969AEA1D55,30171,8,11,3,109.48458,18.27139,1463
35539,266789,B64A184E0F7798F21B07EE969AEA1D55,31521,12,19,7,109.51458,18.22542,1555
35540,266790,571CEC7BB90FE0F62C63BE8E8DBB7663,30351,16,17,1,109.41701,18.29292,1217
35541,266791,571CEC7BB90FE0F62C63BE8E8DBB7663,60551,19,21,2,109.42722,18.30111,1218
35542,266792,571CEC7BB90FE0F62C63BE8E8DBB7663,30351,21,23,2,109.41701,18.29292,1217
35543,266830,A8D0FB018199C38EC19D3E276F96B59B,60614,0,7,7,109.48799,18.29521,1467
35544,266831,A8D0FB018199C38EC19D3E276F96B59B,38297,8,9,1,109.52576,18.24965,1609
35545,266832,A8D0FB018199C38EC19D3E276F96B59B,30741,11,13,2,109.49833,18.28681,1516
35546,266833,A8D0FB018199C38EC19D3E276F96B59B,60381,14,16,2,109.5241,18.22458,1605
35547,266834,A8D0FB018199C38EC19D3E276F96B59B,30171,18,20,2,109.48458,18.27139,1463
35548,266835,A8D0FB018199C38EC19D3E276F96B59B,30741,21,22,1,109.49833,18.28681,1516
35552,266851,30CA9F654BC78FDC50E8DFCBBF7F78A4,60291,15,16,1,109.50826,18.24639,1509
35553,266852,30CA9F654BC78FDC50E8DFCBBF7F78A4,30211,18,19,1,109.49882,18.23931,1508
35554,266856,EB316856896788EC8FD871E122E95728,31811,0,8,8,109.54201,18.31806,1671
35555,266857,EB316856896788EC8FD871E122E95728,30701,12,23,11,109.59313,18.32007,1871
35556,266863,CBA29FB366E4111071C95C99C696D0E6,31561,1,20,19,109.56792,18.28479,1765
35557,266864,CBA29FB366E4111071C95C99C696D0E6,30854,21,22,1,109.56889,18.27076,1763
35558,266865,262E046EBFA868FC382B93913F636846,31431,0,7,7,109.44639,18.29042,1316
35559,266866,262E046EBFA868FC382B93913F636846,31701,8,23,15,109.44132,18.28833,1266
35560,266879,4E251813AD45491A420BC7D07E468163,30421,10,14,4,109.50021,18.25861,1511
35561,266880,4E251813AD45491A420BC7D07E468163,30421,16,23,7,109.50021,18.25861,1511
35562,266909,CD3BCBAB8571FB81953C842A434E5DB8,30854,8,11,3,109.56889,18.27076,1763
35563,266910,CD3BCBAB8571FB81953C842A434E5DB8,31071,13,15,2,109.58257,18.28458,1815
35564,266911,CD3BCBAB8571FB81953C842A434E5DB8,30854,16,17,1,109.56889,18.27076,1763
35565,266912,CD3BCBAB8571FB81953C842A434E5DB8,31071,18,21,3,109.58257,18.28458,1815
35566,266971,31C2FEDE332FAF9474479CF6CA42337C,38073,0,7,7,109.40813,18.30958,1169
35567,266972,31C2FEDE332FAF9474479CF6CA42337C,60551,8,9,1,109.42722,18.30111,1218
35568,266973,31C2FEDE332FAF9474479CF6CA42337C,30661,12,13,1,109.37028,18.24361,1008
35569,266974,31C2FEDE332FAF9474479CF6CA42337C,60551,17,18,1,109.42722,18.30111,1218
35570,266975,31C2FEDE332FAF9474479CF6CA42337C,31231,18,20,2,109.42597,18.29292,1217
35571,266976,31C2FEDE332FAF9474479CF6CA42337C,60551,20,22,2,109.42722,18.30111,1218
35576,266988,9DE8C13901CC7D63E2F1A6CC92603604,30854,7,16,9,109.56889,18.27076,1763
35577,266989,9DE8C13901CC7D63E2F1A6CC92603604,31071,19,21,2,109.58257,18.28458,1815
35578,266999,2DDF3A993BD69F79020EB97CF3A71819,38171,0,8,8,109.50799,18.28139,1515
35579,267000,2DDF3A993BD69F79020EB97CF3A71819,30161,8,10,2,109.50042,18.24389,1508
35580,267001,2DDF3A993BD69F79020EB97CF3A71819,30161,14,17,3,109.50042,18.24389,1508
35581,267002,2DDF3A993BD69F79020EB97CF3A71819,38171,17,19,2,109.50799,18.28139,1515
35582,267003,2DDF3A993BD69F79020EB97CF3A71819,38171,21,23,2,109.50799,18.28139,1515
35583,267015,B816B8FE4A901BFADB45B598DE8D9EF0,60161,4,8,4,109.49174,18.26181,1461
35584,267016,B816B8FE4A901BFADB45B598DE8D9EF0,38754,12,16,4,109.74667,18.37382,2430
35585,267017,B816B8FE4A901BFADB45B598DE8D9EF0,31271,20,22,2,109.48958,18.26257,1462
35586,267035,74A8DA1A239BA74C3424A36505B6E3A6,31945,0,7,7,109.58021,18.29403,1817
35587,267036,74A8DA1A239BA74C3424A36505B6E3A6,31561,8,9,1,109.56792,18.28479,1765
35588,267037,74A8DA1A239BA74C3424A36505B6E3A6,30854,11,18,7,109.56889,18.27076,1763
35589,267038,74A8DA1A239BA74C3424A36505B6E3A6,60381,21,23,2,109.5241,18.22458,1605
35590,267041,019EB913544B8855829875D27D9C85B6,31201,3,11,8,109.51042,18.23819,1558
35591,267042,019EB913544B8855829875D27D9C85B6,60614,12,14,2,109.48799,18.29521,1467
35592,267043,018C2271047AC8D414777DBC331B95FD,30111,0,2,2,109.47583,18.30542,1419
35593,267044,018C2271047AC8D414777DBC331B95FD,60391,5,7,2,109.47667,18.28757,1416
35594,267045,018C2271047AC8D414777DBC331B95FD,31541,11,13,2,109.1809,18.36722,329
35595,267046,018C2271047AC8D414777DBC331B95FD,30434,14,18,4,109.17083,18.35861,278
35596,267084,580E03A111E839B85E7FD8688310DCFE,30851,0,13,13,109.5616,18.27396,1713
35597,267085,580E03A111E839B85E7FD8688310DCFE,30854,17,18,1,109.56889,18.27076,1763
35598,267109,B9E554958CF29F9447541E7C1F71C9EF,60011,0,3,3,109.48965,18.30222,1468
35599,267110,B9E554958CF29F9447541E7C1F71C9EF,60614,3,8,5,109.48799,18.29521,1467
35600,267118,0402BD114B7D5E20705E302B756CD062,31071,0,5,5,109.58257,18.28458,1815
35601,267119,0402BD114B7D5E20705E302B756CD062,60631,6,7,1,109.57778,18.27583,1814
35602,267120,0402BD114B7D5E20705E302B756CD062,30854,8,10,2,109.56889,18.27076,1763
35603,267121,0402BD114B7D5E20705E302B756CD062,60381,17,19,2,109.5241,18.22458,1605
35604,267122,0402BD114B7D5E20705E302B756CD062,31071,20,23,3,109.58257,18.28458,1815
35608,267156,5EBEA276FCB4A19AC5C987F5C7CC8908,60621,0,5,5,109.48354,18.27451,1464
35609,267157,5EBEA276FCB4A19AC5C987F5C7CC8908,60401,6,12,6,109.47444,18.27583,1414
35610,267158,5EBEA276FCB4A19AC5C987F5C7CC8908,60524,12,14,2,109.42951,18.28993,1216
35611,267159,5EBEA276FCB4A19AC5C987F5C7CC8908,60621,15,17,2,109.48354,18.27451,1464
35612,267160,5EBEA276FCB4A19AC5C987F5C7CC8908,60524,20,22,2,109.42951,18.28993,1216
35613,267165,3B6FF1F8D896A0A62DC7E65967011999,39183,0,6,6,109.55542,18.28208,1715
35614,267166,3B6FF1F8D896A0A62DC7E65967011999,31931,6,7,1,109.54771,18.29403,1667
35615,267167,3B6FF1F8D896A0A62DC7E65967011999,39183,10,11,1,109.55542,18.28208,1715
35616,267168,3B6FF1F8D896A0A62DC7E65967011999,31561,12,15,3,109.56792,18.28479,1765
35617,267169,3B6FF1F8D896A0A62DC7E65967011999,30854,17,19,2,109.56889,18.27076,1763
35618,267170,3B6FF1F8D896A0A62DC7E65967011999,30711,19,21,2,109.50271,18.25347,1510
35629,267211,7E136DFDE7B8F9A2B858AC3F2A5E145B,30854,11,17,6,109.56889,18.27076,1763
35630,267212,7E136DFDE7B8F9A2B858AC3F2A5E145B,31561,18,19,1,109.56792,18.28479,1765
35631,267213,7E136DFDE7B8F9A2B858AC3F2A5E145B,30854,19,20,1,109.56889,18.27076,1763
35632,267216,16E640D9FA5593E85AD54BDFBAF952D8,31561,0,4,4,109.56792,18.28479,1765
35633,267217,16E640D9FA5593E85AD54BDFBAF952D8,31071,8,16,8,109.58257,18.28458,1815
35643,267300,BA6378F71A53EDA04060B74ABD747D3D,30661,1,2,1,109.37028,18.24361,1008
35644,267301,BA6378F71A53EDA04060B74ABD747D3D,60524,4,12,8,109.42951,18.28993,1216
35645,267302,BA6378F71A53EDA04060B74ABD747D3D,31471,13,15,2,109.34583,18.29563,917
35646,267303,BA6378F71A53EDA04060B74ABD747D3D,60524,17,22,5,109.42951,18.28993,1216
35647,267309,BFBD6F9C556CC332740750D0B1B81265,38951,15,16,1,109.48097,18.28868,1416
35648,267310,BFBD6F9C556CC332740750D0B1B81265,60504,21,23,2,109.47917,18.28903,1416
35649,267321,41D4EB5552A7A416EEB26FAA30F55A4B,39183,0,7,7,109.55542,18.28208,1715
35650,267322,41D4EB5552A7A416EEB26FAA30F55A4B,39181,9,21,12,109.55153,18.28035,1715
35651,267328,7EB4F76900011DECC835981CBE847D5E,30854,0,11,11,109.56889,18.27076,1763
35652,267329,7EB4F76900011DECC835981CBE847D5E,31561,12,14,2,109.56792,18.28479,1765
35653,267362,8265A029C672FE0377EF574CC3ADF2A8,31561,11,16,5,109.56792,18.28479,1765
35654,267363,8265A029C672FE0377EF574CC3ADF2A8,39181,17,18,1,109.55153,18.28035,1715
35655,267411,6B806948BC9187A91D033B4096721B00,30854,0,8,8,109.56889,18.27076,1763
35656,267412,6B806948BC9187A91D033B4096721B00,31071,9,18,9,109.58257,18.28458,1815
35657,267460,56F4A25A0E603B5B2CF39EF89A2DE812,31611,0,5,5,109.63076,18.34944,2026
35658,267461,56F4A25A0E603B5B2CF39EF89A2DE812,60231,7,15,8,109.49903,18.21972,1504
35659,267462,56F4A25A0E603B5B2CF39EF89A2DE812,31611,15,23,8,109.63076,18.34944,2026
35660,267463,7D995CB95F238B8B307F54EE2D50BDB6,30221,4,8,4,109.57833,18.20222,1802
35661,267464,7D995CB95F238B8B307F54EE2D50BDB6,31421,9,10,1,109.55382,18.22347,1705
35662,267465,7D995CB95F238B8B307F54EE2D50BDB6,31561,14,15,1,109.56792,18.28479,1765
35663,267466,7D995CB95F238B8B307F54EE2D50BDB6,31421,19,21,2,109.55382,18.22347,1705
35664,267467,7D995CB95F238B8B307F54EE2D50BDB6,30221,21,23,2,109.57833,18.20222,1802
35665,267500,E65658506C2BF9C993BA69EE6D38B3C6,31951,2,8,6,109.52174,18.30299,1568
35666,267501,E65658506C2BF9C993BA69EE6D38B3C6,60361,10,16,6,109.51938,18.29681,1567
35667,267532,149F44702DEC8C73589BE6524F0A1FFD,30854,3,12,9,109.56889,18.27076,1763
35668,267533,149F44702DEC8C73589BE6524F0A1FFD,38085,15,16,1,109.6291,18.23625,2007
35669,267534,149F44702DEC8C73589BE6524F0A1FFD,31571,17,20,3,109.61563,18.23326,1957
35670,267548,B4188FCF77E77B10794A61864ECCAF69,31521,12,15,3,109.51458,18.22542,1555
35671,267549,B4188FCF77E77B10794A61864ECCAF69,31521,18,23,5,109.51458,18.22542,1555
35675,267594,C93386A9D86FE22A1FD4E5116045DD8D,31561,0,5,5,109.56792,18.28479,1765
35676,267595,C93386A9D86FE22A1FD4E5116045DD8D,39183,6,8,2,109.55542,18.28208,1715
35677,267596,C93386A9D86FE22A1FD4E5116045DD8D,31561,8,10,2,109.56792,18.28479,1765
35678,267597,C93386A9D86FE22A1FD4E5116045DD8D,30711,15,16,1,109.50271,18.25347,1510
35679,267598,C93386A9D86FE22A1FD4E5116045DD8D,30854,19,20,1,109.56889,18.27076,1763
35680,267599,C93386A9D86FE22A1FD4E5116045DD8D,31561,22,23,1,109.56792,18.28479,1765
35681,267650,01C3A40E8C2D18FB80BE4CD2C78B4B61,30771,0,8,8,109.49938,18.26042,1511
35682,267651,01C3A40E8C2D18FB80BE4CD2C78B4B61,39091,13,16,3,109.50097,18.25222,1510
35683,267652,01C3A40E8C2D18FB80BE4CD2C78B4B61,30071,19,22,3,109.52819,18.30472,1619
35684,267669,BE74D5A2C373F8231889AF03B59762B2,60301,2,5,3,109.60715,18.30993,1919
35685,267670,BE74D5A2C373F8231889AF03B59762B2,30232,6,7,1,109.6191,18.31701,1971
35686,267671,BE74D5A2C373F8231889AF03B59762B2,60301,8,9,1,109.60715,18.30993,1919
35687,267672,BE74D5A2C373F8231889AF03B59762B2,60241,13,14,1,109.53319,18.28667,1616
35688,267673,BE74D5A2C373F8231889AF03B59762B2,30854,16,17,1,109.56889,18.27076,1763
35689,267674,BE74D5A2C373F8231889AF03B59762B2,30851,19,20,1,109.5616,18.27396,1713
35693,267722,10D0DA0CDE594144AD7B0AF9906F5575,31561,8,20,12,109.56792,18.28479,1765
35694,267723,10D0DA0CDE594144AD7B0AF9906F5575,30854,21,22,1,109.56889,18.27076,1763
35695,267737,834384AB36BC69B3ECBD6E385DAC921F,31071,0,2,2,109.58257,18.28458,1815
35696,267738,834384AB36BC69B3ECBD6E385DAC921F,30441,3,7,4,109.64021,18.25424,2010
35697,267739,834384AB36BC69B3ECBD6E385DAC921F,30854,7,12,5,109.56889,18.27076,1763
35698,267740,834384AB36BC69B3ECBD6E385DAC921F,38754,15,16,1,109.74667,18.37382,2430
35702,267827,3F80F6C7ECC59E36D89C8EF1746C8724,38157,3,14,11,109.51483,18.26958,1563
35703,267828,3F80F6C7ECC59E36D89C8EF1746C8724,31181,14,16,2,109.50382,18.24813,1509
35704,267834,56C8C781972E8BFAF8A768A19AD7F590,30281,0,6,6,109.50597,18.27583,1514
35705,267836,56C8C781972E8BFAF8A768A19AD7F590,31531,20,22,2,109.49583,18.25972,1461
35712,267853,451E2BF48CD7B253EB0892324E679BCC,38297,3,4,1,109.52576,18.24965,1609
35713,267854,451E2BF48CD7B253EB0892324E679BCC,38291,7,10,3,109.51618,18.24313,1558
35714,267855,451E2BF48CD7B253EB0892324E679BCC,38297,10,15,5,109.52576,18.24965,1609
35715,267856,451E2BF48CD7B253EB0892324E679BCC,38291,15,17,2,109.51618,18.24313,1558
35716,267857,451E2BF48CD7B253EB0892324E679BCC,38297,20,22,2,109.52576,18.24965,1609
35721,267935,0E5593A90D661690BE3DAAA17AD936E2,38127,0,10,10,109.50833,18.27222,1513
35722,267936,0E5593A90D661690BE3DAAA17AD936E2,38073,11,14,3,109.40813,18.30958,1169
35723,267937,DDE77D3A656666992FC3458B84010D43,39183,0,3,3,109.55542,18.28208,1715
35724,267938,DDE77D3A656666992FC3458B84010D43,31561,6,9,3,109.56792,18.28479,1765
35725,267939,DDE77D3A656666992FC3458B84010D43,39183,10,12,2,109.55542,18.28208,1715
35726,267940,DDE77D3A656666992FC3458B84010D43,30854,14,15,1,109.56889,18.27076,1763
35727,267941,DDE77D3A656666992FC3458B84010D43,39183,18,19,1,109.55542,18.28208,1715
35728,267959,529A14F498129B0238F7B12A9FC7F6F7,31205,0,1,1,109.51111,18.23736,1557
35729,267960,529A14F498129B0238F7B12A9FC7F6F7,31671,2,23,21,109.38965,18.29813,1068
35730,267967,2C3BD53A8702A47FB82F05FB4993B683,31561,0,6,6,109.56792,18.28479,1765
35731,267968,2C3BD53A8702A47FB82F05FB4993B683,39183,9,10,1,109.55542,18.28208,1715
35732,267969,2C3BD53A8702A47FB82F05FB4993B683,39321,14,15,1,109.529,18.2167,1604
35733,267970,2C3BD53A8702A47FB82F05FB4993B683,31561,19,23,4,109.56792,18.28479,1765
35734,267995,7FE8039F0B43D97751DD03EAC1234AA8,31521,2,11,9,109.51458,18.22542,1555
35735,267996,7FE8039F0B43D97751DD03EAC1234AA8,60071,13,15,2,109.75674,18.31583,2470
35736,267997,7FE8039F0B43D97751DD03EAC1234AA8,31521,19,23,4,109.51458,18.22542,1555
35740,268016,5202825DF51CA068C8B204422480230F,31071,1,5,4,109.58257,18.28458,1815
35741,268017,5202825DF51CA068C8B204422480230F,31945,7,9,2,109.58021,18.29403,1817
35742,268018,5202825DF51CA068C8B204422480230F,30854,10,11,1,109.56889,18.27076,1763
35743,268019,5202825DF51CA068C8B204422480230F,31071,12,15,3,109.58257,18.28458,1815
35744,268020,5202825DF51CA068C8B204422480230F,31561,15,16,1,109.56792,18.28479,1765
35745,268021,5202825DF51CA068C8B204422480230F,60381,21,22,1,109.5241,18.22458,1605
35746,268052,74D362264AC1D256D4D64FB1B1D480D1,31521,0,9,9,109.51458,18.22542,1555
35747,268053,74D362264AC1D256D4D64FB1B1D480D1,31521,11,12,1,109.51458,18.22542,1555
35748,268054,74D362264AC1D256D4D64FB1B1D480D1,60381,12,14,2,109.5241,18.22458,1605
35749,268055,74D362264AC1D256D4D64FB1B1D480D1,31521,14,16,2,109.51458,18.22542,1555
35750,268056,74D362264AC1D256D4D64FB1B1D480D1,60221,16,18,2,109.52569,18.29188,1616
35751,268057,74D362264AC1D256D4D64FB1B1D480D1,31521,19,20,1,109.51458,18.22542,1555
35752,268064,C3EC43179E51E2CA8AF203A259981D18,31071,17,18,1,109.58257,18.28458,1815
35756,268078,5100BDEFDFF3241811C94A14D7D61508,60661,17,18,1,109.548,18.2377,1657
35757,268079,5100BDEFDFF3241811C94A14D7D61508,30854,20,22,2,109.56889,18.27076,1763
35758,268080,C83989AE2DFF8530CB3DF7DC45038FE9,38094,11,12,1,109.45403,18.28778,1316
35759,268081,C83989AE2DFF8530CB3DF7DC45038FE9,60441,14,15,1,109.46792,18.28604,1366
35760,268082,C83989AE2DFF8530CB3DF7DC45038FE9,38094,17,18,1,109.45403,18.28778,1316
35761,268093,D39D64452E6BBEF7B3056CA239E1B86E,30854,0,2,2,109.56889,18.27076,1763
35762,268094,D39D64452E6BBEF7B3056CA239E1B86E,30851,3,4,1,109.5616,18.27396,1713
35763,268095,D39D64452E6BBEF7B3056CA239E1B86E,30854,6,8,2,109.56889,18.27076,1763
35764,268096,D39D64452E6BBEF7B3056CA239E1B86E,31561,9,11,2,109.56792,18.28479,1765
35765,268097,D39D64452E6BBEF7B3056CA239E1B86E,30854,12,14,2,109.56889,18.27076,1763
35766,268098,D39D64452E6BBEF7B3056CA239E1B86E,31561,15,17,2,109.56792,18.28479,1765
35767,268099,D39D64452E6BBEF7B3056CA239E1B86E,30854,17,19,2,109.56889,18.27076,1763
35768,268129,970D6BC437EA1378FAE0DFD7B07AAE0B,60221,8,9,1,109.52569,18.29188,1616
35769,268130,970D6BC437EA1378FAE0DFD7B07AAE0B,30171,11,21,10,109.48458,18.27139,1463
35770,268134,43E6B9C1B72B40FA7B91611D276BDEC1,31231,0,16,16,109.42597,18.29292,1217
35771,268135,43E6B9C1B72B40FA7B91611D276BDEC1,30354,20,23,3,109.42813,18.29076,1216
35775,268143,812FF2AD7CDC56800927AA5D19BA4232,38991,0,7,7,109.52681,18.30368,1618
35776,268176,34AB502A442AA8EA4A7FB30471B204DB,60621,1,6,5,109.48354,18.27451,1464
35777,268177,34AB502A442AA8EA4A7FB30471B204DB,60401,8,10,2,109.47444,18.27583,1414
35778,268178,34AB502A442AA8EA4A7FB30471B204DB,38094,10,11,1,109.45403,18.28778,1316
35779,268179,34AB502A442AA8EA4A7FB30471B204DB,31031,11,13,2,109.49979,18.25382,1510
35780,268180,34AB502A442AA8EA4A7FB30471B204DB,38325,13,15,2,109.39792,18.2909,1116
35781,268196,6FDD8510FC3FD17D36965B0963BD7329,31561,4,6,2,109.56792,18.28479,1765
35782,268197,6FDD8510FC3FD17D36965B0963BD7329,30854,6,18,12,109.56889,18.27076,1763
35783,268226,CD576F1C1CDFB89E6A99A20E65927346,31561,0,19,19,109.56792,18.28479,1765
35784,268227,CD576F1C1CDFB89E6A99A20E65927346,30854,20,22,2,109.56889,18.27076,1763
35785,268244,0695D4E7B3E726CA09D841B87798B560,30854,0,16,16,109.56889,18.27076,1763
35786,268245,0695D4E7B3E726CA09D841B87798B560,31071,20,21,1,109.58257,18.28458,1815
35791,268255,B712327B6033C61F37801CFD6DAC08AD,30561,10,14,4,109.52778,18.31938,1621
35792,268256,B712327B6033C61F37801CFD6DAC08AD,31951,16,17,1,109.52174,18.30299,1568
35793,268257,B712327B6033C61F37801CFD6DAC08AD,38484,17,19,2,109.53028,18.31528,1620
35794,268258,B712327B6033C61F37801CFD6DAC08AD,38484,20,23,3,109.53028,18.31528,1620
35795,268264,5032297453241F06691AD56818B16DB5,60524,2,3,1,109.42951,18.28993,1216
35796,268265,5032297453241F06691AD56818B16DB5,30651,7,9,2,109.42611,18.385,1232
35797,268273,DE105C397F26A3ACFAEB1809DD2E4C8C,30971,0,6,6,109.48708,18.29319,1467
35798,268274,DE105C397F26A3ACFAEB1809DD2E4C8C,30971,7,8,1,109.48708,18.29319,1467
35799,268275,DE105C397F26A3ACFAEB1809DD2E4C8C,38484,9,10,1,109.53028,18.31528,1620
35800,268276,DE105C397F26A3ACFAEB1809DD2E4C8C,30421,10,12,2,109.50021,18.25861,1511
35801,268277,DE105C397F26A3ACFAEB1809DD2E4C8C,30971,13,23,10,109.48708,18.29319,1467
35805,268292,276CA6638E360F26911F834ACA3BF972,30151,0,8,8,109.50986,18.25083,1560
35806,268293,276CA6638E360F26911F834ACA3BF972,31461,10,12,2,109.5091,18.25389,1510
35807,268297,B7911D9D9A3AB9DF64A3B23E6A7B118E,60201,0,2,2,109.5041,18.2509,1510
35808,268298,B7911D9D9A3AB9DF64A3B23E6A7B118E,30711,6,10,4,109.50271,18.25347,1510
35809,268299,B7911D9D9A3AB9DF64A3B23E6A7B118E,30711,10,14,4,109.50271,18.25347,1510
35810,268300,B7911D9D9A3AB9DF64A3B23E6A7B118E,31471,16,17,1,109.34583,18.29563,917
35811,268301,B7911D9D9A3AB9DF64A3B23E6A7B118E,31431,18,19,1,109.44639,18.29042,1316
35812,268302,B7911D9D9A3AB9DF64A3B23E6A7B118E,30711,20,21,1,109.50271,18.25347,1510
35813,268303,B7911D9D9A3AB9DF64A3B23E6A7B118E,30711,22,23,1,109.50271,18.25347,1510
35814,268325,530F0AE3A2D48DD91CDC3A17D13BA70F,38707,0,9,9,109.73778,18.35368,2427
35815,268326,530F0AE3A2D48DD91CDC3A17D13BA70F,38707,12,17,5,109.73778,18.35368,2427
35816,268360,47C8C71AB8A291B23C6D0393C8109E46,38171,0,8,8,109.50799,18.28139,1515
35817,268361,47C8C71AB8A291B23C6D0393C8109E46,38261,11,15,4,109.50361,18.28153,1515
35818,268362,47C8C71AB8A291B23C6D0393C8109E46,31781,16,17,1,109.19847,18.2975,367
35819,268363,47C8C71AB8A291B23C6D0393C8109E46,38171,20,23,3,109.50799,18.28139,1515
35820,268364,FCC7FFA36CCAFA7D306338AD42FEB181,60161,0,5,5,109.49174,18.26181,1461
35821,268365,FCC7FFA36CCAFA7D306338AD42FEB181,60401,6,8,2,109.47444,18.27583,1414
35822,268387,EDECB31C6334C9294412C6687241266D,39151,19,20,1,109.49875,18.25097,1510
35823,268388,EDECB31C6334C9294412C6687241266D,30271,22,23,1,109.49132,18.23153,1456
35827,268428,E46795A590C643FCDE6B993B35621D2F,31861,12,13,1,109.49042,18.27549,1464
35828,268429,E46795A590C643FCDE6B993B35621D2F,38027,18,19,1,109.38833,18.2909,1066
35829,268548,A02F58F4D887D8C7AFCC5C3BF1733917,31061,0,6,6,109.53333,18.23257,1607
35834,268598,CFBECCF1033E4C2AF15DC8693C77CEB1,31471,12,13,1,109.34583,18.29563,917
35835,268599,CFBECCF1033E4C2AF15DC8693C77CEB1,30661,15,17,2,109.37028,18.24361,1008
35836,268600,CFBECCF1033E4C2AF15DC8693C77CEB1,60391,18,19,1,109.47667,18.28757,1416
35837,268601,CFBECCF1033E4C2AF15DC8693C77CEB1,30111,21,23,2,109.47583,18.30542,1419
35838,268608,491A112CD81B9085F752897809919691,31261,9,11,2,109.51174,18.2466,1559
35839,268609,491A112CD81B9085F752897809919691,30511,15,19,4,109.51069,18.24208,1558
35840,268610,491A112CD81B9085F752897809919691,60381,20,21,1,109.5241,18.22458,1605
35841,268611,491A112CD81B9085F752897809919691,31201,21,23,2,109.51042,18.23819,1558
35842,268616,8B08E339C0353F4553A7E5299B8AD99A,38241,0,9,9,109.54111,18.30542,1669
35843,268617,8B08E339C0353F4553A7E5299B8AD99A,60054,13,15,2,109.3016,18.31229,770
35851,268696,A749E400BFD3B5908671E939EC104DEE,30854,11,15,4,109.56889,18.27076,1763
35852,268697,A749E400BFD3B5908671E939EC104DEE,31071,15,17,2,109.58257,18.28458,1815
35853,268698,A749E400BFD3B5908671E939EC104DEE,30854,19,21,2,109.56889,18.27076,1763
35854,268699,A749E400BFD3B5908671E939EC104DEE,31071,21,23,2,109.58257,18.28458,1815
35855,268704,E4B522EF4348156010E5C578EC13D60F,30854,0,7,7,109.56889,18.27076,1763
35856,268705,E4B522EF4348156010E5C578EC13D60F,31945,7,8,1,109.58021,18.29403,1817
35857,268706,E4B522EF4348156010E5C578EC13D60F,30854,10,11,1,109.56889,18.27076,1763
35858,268707,E4B522EF4348156010E5C578EC13D60F,31071,18,19,1,109.58257,18.28458,1815
35859,268708,E4B522EF4348156010E5C578EC13D60F,30854,22,23,1,109.56889,18.27076,1763
35866,268731,D984F4ED609CD4BB7417303EF42B896E,38361,0,8,8,109.43667,18.29201,1267
35867,268732,D984F4ED609CD4BB7417303EF42B896E,30711,11,12,1,109.50271,18.25347,1510
35868,268733,D984F4ED609CD4BB7417303EF42B896E,30854,13,14,1,109.56889,18.27076,1763
35869,268734,D984F4ED609CD4BB7417303EF42B896E,31041,18,19,1,109.50278,18.23701,1507
35870,268735,D984F4ED609CD4BB7417303EF42B896E,31345,21,23,2,109.39,18.29,1066
35871,268742,D090D23BEAB243AAF74CB3648E81F65B,30854,0,7,7,109.56889,18.27076,1763
35872,268743,D090D23BEAB243AAF74CB3648E81F65B,31561,8,23,15,109.56792,18.28479,1765
35873,268764,2913724A9957EDEB24A0554F9C389C52,31521,0,1,1,109.51458,18.22542,1555
35882,268824,546C572FC49C780F9A9AF62ED98666DF,30351,4,8,4,109.41701,18.29292,1217
35883,268825,546C572FC49C780F9A9AF62ED98666DF,30681,8,10,2,109.48493,18.26917,1463
35884,268826,546C572FC49C780F9A9AF62ED98666DF,30351,10,18,8,109.41701,18.29292,1217
35885,268827,546C572FC49C780F9A9AF62ED98666DF,30681,18,21,3,109.48493,18.26917,1463
35886,268828,546C572FC49C780F9A9AF62ED98666DF,30351,21,23,2,109.41701,18.29292,1217
35887,268836,3AC7F2DEECA5F36461EF3FD31BBBC1FC,30661,12,13,1,109.37028,18.24361,1008
35888,268837,3AC7F2DEECA5F36461EF3FD31BBBC1FC,31471,14,15,1,109.34583,18.29563,917
35889,268838,3AC7F2DEECA5F36461EF3FD31BBBC1FC,39181,19,23,4,109.55153,18.28035,1715
35890,268853,E6BFF9D5149779739DDE4340D165B642,31351,16,19,3,109.4959,18.28417,1465
35891,268854,E6BFF9D5149779739DDE4340D165B642,60161,20,21,1,109.49174,18.26181,1461
35892,268855,E6BFF9D5149779739DDE4340D165B642,31861,22,23,1,109.49042,18.27549,1464
35896,268859,66B36EAB2804138C84FF096B3B06E748,31031,12,18,6,109.49979,18.25382,1510
35897,268860,66B36EAB2804138C84FF096B3B06E748,30421,18,23,5,109.50021,18.25861,1511
35898,268874,8953AAE870A5455B1CCDFF6A18139D8A,38054,15,23,8,109.63479,18.23097,2006
35899,268893,065F1687C35F3C827A2EA4A378A0E2C6,60354,0,3,3,109.58701,18.28521,1815
35900,268894,065F1687C35F3C827A2EA4A378A0E2C6,39371,4,22,18,109.56627,18.2646,1762
35901,268900,DF5348A8E25901EBB63BBF3F6126BB02,31071,0,7,7,109.58257,18.28458,1815
35902,268901,DF5348A8E25901EBB63BBF3F6126BB02,30854,9,13,4,109.56889,18.27076,1763
35903,268902,DF5348A8E25901EBB63BBF3F6126BB02,31071,14,15,1,109.58257,18.28458,1815
35904,268903,DF5348A8E25901EBB63BBF3F6126BB02,31345,18,19,1,109.39,18.29,1066
35905,268904,DF5348A8E25901EBB63BBF3F6126BB02,30854,22,23,1,109.56889,18.27076,1763
35906,268916,502F5C6B66964DC1CB5492352683E4F7,38111,7,9,2,109.52007,18.22403,1555
35907,268917,502F5C6B66964DC1CB5492352683E4F7,30771,11,13,2,109.49938,18.26042,1511
35908,268918,502F5C6B66964DC1CB5492352683E4F7,38271,15,16,1,109.62632,18.23049,1956
35909,268926,6D0CBC29417959EBDF12F1FD604A5C61,38754,14,16,2,109.74667,18.37382,2430
35910,268927,6D0CBC29417959EBDF12F1FD604A5C61,60661,20,23,3,109.548,18.2377,1657
35911,268942,08298D6D3F79F7819C6B0F651C6D5327,31521,0,2,2,109.51458,18.22542,1555
35912,268943,08298D6D3F79F7819C6B0F651C6D5327,30731,2,6,4,109.50944,18.22306,1555
35913,268944,08298D6D3F79F7819C6B0F651C6D5327,31521,6,9,3,109.51458,18.22542,1555
35914,268945,08298D6D3F79F7819C6B0F651C6D5327,30731,9,10,1,109.50944,18.22306,1555
35915,268946,08298D6D3F79F7819C6B0F651C6D5327,30421,11,14,3,109.50021,18.25861,1511
35920,268976,77F5A37783010C53E376197FE3F1043D,31421,18,19,1,109.55382,18.22347,1705
35921,268977,77F5A37783010C53E376197FE3F1043D,38111,20,21,1,109.52007,18.22403,1555
35922,269003,43F5AB52A0AF3FEB5880C6DCD16BBA02,39101,14,20,6,109.50132,18.24931,1509
35923,269004,43F5AB52A0AF3FEB5880C6DCD16BBA02,60011,20,23,3,109.48965,18.30222,1468
35924,269032,9AE74F5A5B1B66625275FB429D7BDF53,30771,19,21,2,109.49938,18.26042,1511
35925,269033,9AE74F5A5B1B66625275FB429D7BDF53,31081,22,23,1,109.44639,18.30181,1318
35926,269034,A01B4012B619D942E7CC3AC9B78722B4,31561,1,2,1,109.56792,18.28479,1765
35927,269035,A01B4012B619D942E7CC3AC9B78722B4,30854,2,3,1,109.56889,18.27076,1763
35928,269036,A01B4012B619D942E7CC3AC9B78722B4,31561,4,8,4,109.56792,18.28479,1765
35929,269037,A01B4012B619D942E7CC3AC9B78722B4,60381,13,17,4,109.5241,18.22458,1605
35930,269038,A01B4012B619D942E7CC3AC9B78722B4,31561,20,22,2,109.56792,18.28479,1765
35934,269067,DE323AA9A239491ADDE7A783A5799ADA,30681,17,18,1,109.48493,18.26917,1463
35935,269068,DE323AA9A239491ADDE7A783A5799ADA,30211,21,23,2,109.49882,18.23931,1508
35936,269116,A4743972EC2FC58546DD11935BDC0E1A,39091,1,5,4,109.50097,18.25222,1510
35937,269117,A4743972EC2FC58546DD11935BDC0E1A,30711,9,14,5,109.50271,18.25347,1510
35938,269118,A4743972EC2FC58546DD11935BDC0E1A,31091,15,18,3,109.41201,18.31222,1170
35939,269119,A4743972EC2FC58546DD11935BDC0E1A,39091,21,23,2,109.50097,18.25222,1510
35940,269126,3499E731A877B5132E572C7056EDDA83,31261,13,15,2,109.51174,18.2466,1559
35941,269127,3499E731A877B5132E572C7056EDDA83,31181,16,18,2,109.50382,18.24813,1509
35942,269128,3499E731A877B5132E572C7056EDDA83,39151,18,19,1,109.49875,18.25097,1510
35943,269129,3499E731A877B5132E572C7056EDDA83,60311,21,23,2,109.52097,18.24319,1558
35944,269138,F866B6E34CEF853A6497211DD74A607E,60631,0,9,9,109.57778,18.27583,1814
35945,269139,F866B6E34CEF853A6497211DD74A607E,60501,9,12,3,109.48701,18.29021,1466
35946,269140,F866B6E34CEF853A6497211DD74A607E,30791,16,18,2,109.72333,18.40889,2386
35947,269141,F866B6E34CEF853A6497211DD74A607E,30891,21,23,2,109.59431,18.28389,1865
35948,269180,D4448A1349B0563C78F16B479359A95F,31071,3,7,4,109.58257,18.28458,1815
35949,269181,D4448A1349B0563C78F16B479359A95F,30854,10,23,13,109.56889,18.27076,1763
35950,269192,D2A5F87218CF25385163A2F3C4229CB8,31561,0,13,13,109.56792,18.28479,1765
35951,269193,D2A5F87218CF25385163A2F3C4229CB8,60381,14,17,3,109.5241,18.22458,1605
35952,269199,DD335423604E66F8128DEC8F07467E33,31521,0,7,7,109.51458,18.22542,1555
35953,269200,DD335423604E66F8128DEC8F07467E33,31781,10,12,2,109.19847,18.2975,367
35954,269201,DD335423604E66F8128DEC8F07467E33,31471,14,15,1,109.34583,18.29563,917
35955,269202,DD335423604E66F8128DEC8F07467E33,30191,18,23,5,109.50361,18.22701,1506
35956,269215,8438CC455C7563000E5EA4C29E329C92,31781,15,16,1,109.19847,18.2975,367
35957,269216,8438CC455C7563000E5EA4C29E329C92,39131,19,23,4,109.2066,18.29639,417
35958,269233,8DD23AA43C0F7967C45F7488D66F9159,30854,1,16,15,109.56889,18.27076,1763
35959,269234,8DD23AA43C0F7967C45F7488D66F9159,31071,17,19,2,109.58257,18.28458,1815
35963,269256,8839938E8B61375A5BD6E99D0F7E2901,60221,0,7,7,109.52569,18.29188,1616
35964,269257,8839938E8B61375A5BD6E99D0F7E2901,60381,11,12,1,109.5241,18.22458,1605
35965,269258,8839938E8B61375A5BD6E99D0F7E2901,60421,14,16,2,109.46333,18.31743,1371
35966,269259,8839938E8B61375A5BD6E99D0F7E2901,31061,17,19,2,109.53333,18.23257,1607
35967,269317,BC2EDF4DF9C7FAD55BDEABA03DFA7284,31561,0,5,5,109.56792,18.28479,1765
35968,269318,BC2EDF4DF9C7FAD55BDEABA03DFA7284,39183,8,11,3,109.55542,18.28208,1715
35969,269319,BC2EDF4DF9C7FAD55BDEABA03DFA7284,31561,11,13,2,109.56792,18.28479,1765
35970,269320,BC2EDF4DF9C7FAD55BDEABA03DFA7284,30851,14,15,1,109.5616,18.27396,1713
35971,269321,BC2EDF4DF9C7FAD55BDEABA03DFA7284,30711,17,19,2,109.50271,18.25347,1510
35972,269322,BC2EDF4DF9C7FAD55BDEABA03DFA7284,31561,21,23,2,109.56792,18.28479,1765
35973,269375,D6CC1FC0E328F94E96D4D1F260DF9F7F,31071,0,2,2,109.58257,18.28458,1815
35974,269376,D6CC1FC0E328F94E96D4D1F260DF9F7F,31071,2,5,3,109.58257,18.28458,1815
35975,269377,D6CC1FC0E328F94E96D4D1F260DF9F7F,31071,7,8,1,109.58257,18.28458,1815
35976,269378,D6CC1FC0E328F94E96D4D1F260DF9F7F,39371,14,15,1,109.56627,18.2646,1762
35977,269379,D6CC1FC0E328F94E96D4D1F260DF9F7F,31071,16,23,7,109.58257,18.28458,1815
35978,269391,FC3A0E75CA2AB7A7F2493FF9F12595DC,31171,11,13,2,109.50938,18.24917,1559
35979,269393,FC3A0E75CA2AB7A7F2493FF9F12595DC,60291,19,23,4,109.50826,18.24639,1509
35980,269402,B3F4E43DA3C4E855A3ED684A6CB97F36,31931,2,15,13,109.54771,18.29403,1667
35981,269403,B3F4E43DA3C4E855A3ED684A6CB97F36,60221,16,19,3,109.52569,18.29188,1616
35982,269413,7B2AEE2086698683607EDDDB4B678234,60241,17,19,2,109.53319,18.28667,1616
35983,269414,7B2AEE2086698683607EDDDB4B678234,38154,20,22,2,109.5266,18.28278,1615
35984,269471,CBC8159D1FCA35AFB9DA003A5F4078C2,31861,12,13,1,109.49042,18.27549,1464
35985,269472,CBC8159D1FCA35AFB9DA003A5F4078C2,60501,14,16,2,109.48701,18.29021,1466
35986,269490,5551596F41F816D6747C858927EE7E59,39181,16,18,2,109.55153,18.28035,1715
35987,269491,5551596F41F816D6747C858927EE7E59,39183,21,23,2,109.55542,18.28208,1715
35988,269513,B60C324D7CDB0C0FB6C857406F6733E1,30771,19,21,2,109.49938,18.26042,1511
35989,269514,B60C324D7CDB0C0FB6C857406F6733E1,31081,22,23,1,109.44639,18.30181,1318
35990,269515,75817DB682187A07461734D66E1E6492,60631,0,4,4,109.57778,18.27583,1814
35991,269516,75817DB682187A07461734D66E1E6492,30854,5,13,8,109.56889,18.27076,1763
35992,269517,28AD4F4A057EAD61FC013015642C4D8F,60081,1,5,4,109.51097,18.22639,1556
35993,269518,28AD4F4A057EAD61FC013015642C4D8F,30191,5,7,2,109.50361,18.22701,1506
35994,269519,28AD4F4A057EAD61FC013015642C4D8F,39183,10,11,1,109.55542,18.28208,1715
35995,269520,28AD4F4A057EAD61FC013015642C4D8F,60081,12,13,1,109.51097,18.22639,1556
35996,269521,28AD4F4A057EAD61FC013015642C4D8F,30191,15,23,8,109.50361,18.22701,1506
36003,269533,95F6D81D9D517084554E43C715595D83,30661,14,16,2,109.37028,18.24361,1008
36004,269534,95F6D81D9D517084554E43C715595D83,31471,16,22,6,109.34583,18.29563,917
36011,269564,32BB9E509788D1658D578FE7E9B0A887,30121,1,12,11,109.52861,18.27222,1613
36012,269565,32BB9E509788D1658D578FE7E9B0A887,38017,13,22,9,109.49729,18.21424,1504
36013,269572,69AA5F0353755F3C9E2FFDDC62335D4F,31521,0,6,6,109.51458,18.22542,1555
36014,269573,69AA5F0353755F3C9E2FFDDC62335D4F,33051,11,14,3,109.6475,18.46618,2096
36015,269574,69AA5F0353755F3C9E2FFDDC62335D4F,31521,16,18,2,109.51458,18.22542,1555
36016,269575,69AA5F0353755F3C9E2FFDDC62335D4F,60381,20,22,2,109.5241,18.22458,1605
36017,269597,F84D88C8F576C165CF03207AB14A530C,30771,19,21,2,109.49938,18.26042,1511
36018,269598,F84D88C8F576C165CF03207AB14A530C,31081,22,23,1,109.44639,18.30181,1318
36019,269603,ABCD0851CC1C78BCD7AF6DBDF2F5DE49,60524,1,5,4,109.42951,18.28993,1216
36020,269604,ABCD0851CC1C78BCD7AF6DBDF2F5DE49,30211,5,7,2,109.49882,18.23931,1508
36021,269605,ABCD0851CC1C78BCD7AF6DBDF2F5DE49,60552,9,17,8,109.41729,18.30014,1218
36022,269606,ABCD0851CC1C78BCD7AF6DBDF2F5DE49,60524,18,19,1,109.42951,18.28993,1216
36023,269607,ABCD0851CC1C78BCD7AF6DBDF2F5DE49,60552,20,22,2,109.41729,18.30014,1218
36024,269608,B93D357AAB05700B15F775F104378052,38141,0,8,8,109.39479,18.2916,1116
36025,269609,B93D357AAB05700B15F775F104378052,38271,13,18,5,109.62632,18.23049,1956
36029,269660,B643AC77F8D8498A9694D45BA8B0F75F,30854,6,7,1,109.56889,18.27076,1763
36030,269661,B643AC77F8D8498A9694D45BA8B0F75F,60631,8,16,8,109.57778,18.27583,1814
36031,269662,B643AC77F8D8498A9694D45BA8B0F75F,30854,17,21,4,109.56889,18.27076,1763
36032,269678,7252A0F90E29EC78621699C082578EF7,31361,16,23,7,109.47417,18.28292,1415
36033,269722,ABC75A24C8B7485C35E87659D236B1BA,60401,0,9,9,109.47444,18.27583,1414
36034,269723,ABC75A24C8B7485C35E87659D236B1BA,60411,13,15,2,109.32514,18.30854,869
36035,269724,ABC75A24C8B7485C35E87659D236B1BA,60054,16,17,1,109.3016,18.31229,770
36036,269725,ABC75A24C8B7485C35E87659D236B1BA,31471,17,18,1,109.34583,18.29563,917
36037,269726,ABC75A24C8B7485C35E87659D236B1BA,60411,19,21,2,109.32514,18.30854,869
36038,269748,27BCEF3137923B84211F08830816C810,30851,19,21,2,109.5616,18.27396,1713
36045,269834,22DF08AB8625FB5CE36A655BC50A3649,60501,15,16,1,109.48701,18.29021,1466
36046,269835,22DF08AB8625FB5CE36A655BC50A3649,30711,19,23,4,109.50271,18.25347,1510
36047,269846,D6CEBF9F3036F9FB69CD0D53FE57EFC2,39131,17,23,6,109.2066,18.29639,417
36048,269861,9E1D23B2A9B6A11EA4641E27DBFA4B82,60381,0,13,13,109.5241,18.22458,1605
36049,269862,9E1D23B2A9B6A11EA4641E27DBFA4B82,30161,15,17,2,109.50042,18.24389,1508
36050,269873,EB30E1F8D2A0B8547D27259B11A72616,38271,0,8,8,109.62632,18.23049,1956
36051,269874,EB30E1F8D2A0B8547D27259B11A72616,31391,13,14,1,109.50382,18.24285,1508
36052,269875,EB30E1F8D2A0B8547D27259B11A72616,31041,14,16,2,109.50278,18.23701,1507
36053,269876,EB30E1F8D2A0B8547D27259B11A72616,38271,20,23,3,109.62632,18.23049,1956
36058,269890,40D6808616C3B61093B96D47DEDB77AD,30511,0,9,9,109.51069,18.24208,1558
36059,269891,40D6808616C3B61093B96D47DEDB77AD,30201,12,13,1,109.4909,18.26465,1462
36060,269894,F94EBB0B32E924A93A488CBC5BF180F4,31701,18,19,1,109.44132,18.28833,1266
36061,269895,F94EBB0B32E924A93A488CBC5BF180F4,38105,20,22,2,109.40299,18.29229,1117
36062,269913,F198CAA1F49ACA5D003FD8F8473B3798,31071,1,4,3,109.58257,18.28458,1815
36063,269914,F198CAA1F49ACA5D003FD8F8473B3798,30854,8,9,1,109.56889,18.27076,1763
36064,269967,C810233D58458ECBDA6B41A0E080954F,30771,16,17,1,109.49938,18.26042,1511
36065,269968,C810233D58458ECBDA6B41A0E080954F,39151,19,23,4,109.49875,18.25097,1510
36069,269990,8C5A16299A6D294198C90C34C25C5949,39183,0,2,2,109.55542,18.28208,1715
36070,269991,8C5A16299A6D294198C90C34C25C5949,30851,3,5,2,109.5616,18.27396,1713
36071,269992,8C5A16299A6D294198C90C34C25C5949,30854,9,11,2,109.56889,18.27076,1763
36072,269993,8C5A16299A6D294198C90C34C25C5949,30851,14,16,2,109.5616,18.27396,1713
36073,269994,8C5A16299A6D294198C90C34C25C5949,30854,17,19,2,109.56889,18.27076,1763
36074,269995,8C5A16299A6D294198C90C34C25C5949,39183,21,23,2,109.55542,18.28208,1715
36078,270021,58CDDF83DCFC1E60490503CB846BF15A,30854,14,16,2,109.56889,18.27076,1763
36079,270022,58CDDF83DCFC1E60490503CB846BF15A,31561,21,23,2,109.56792,18.28479,1765
36084,270096,2D39AE6120F2674000C6DBB8A6E572A0,31945,1,6,5,109.58021,18.29403,1817
36085,270097,2D39AE6120F2674000C6DBB8A6E572A0,30854,8,20,12,109.56889,18.27076,1763
36086,270111,49780829974BE414545DBC0680DF8A28,30854,11,18,7,109.56889,18.27076,1763
36087,270112,49780829974BE414545DBC0680DF8A28,31071,21,23,2,109.58257,18.28458,1815
36088,270128,770A00BDAFE9BCA8C9E9FA68066EED7D,31561,12,13,1,109.56792,18.28479,1765
36089,270129,770A00BDAFE9BCA8C9E9FA68066EED7D,30854,16,18,2,109.56889,18.27076,1763
36090,270130,770A00BDAFE9BCA8C9E9FA68066EED7D,31071,21,23,2,109.58257,18.28458,1815
36091,270163,F7CECA14E444D79FC66F453D0CDB5754,31321,15,23,8,109.63799,18.23201,2007
36092,270206,FFFC0994E5C15BDB165344716912442C,31554,0,2,2,109.55521,18.2459,1709
36093,270207,FFFC0994E5C15BDB165344716912442C,39371,3,6,3,109.56627,18.2646,1762
36094,270208,FFFC0994E5C15BDB165344716912442C,31554,7,10,3,109.55521,18.2459,1709
36095,270209,FFFC0994E5C15BDB165344716912442C,31421,10,12,2,109.55382,18.22347,1705
36096,270210,FFFC0994E5C15BDB165344716912442C,31554,12,23,11,109.55521,18.2459,1709
36097,270216,B6A8225D84CC06865D19854E19C5D3FF,30561,0,11,11,109.52778,18.31938,1621
36098,270217,B6A8225D84CC06865D19854E19C5D3FF,30711,11,14,3,109.50271,18.25347,1510
36099,270218,B6A8225D84CC06865D19854E19C5D3FF,30911,14,17,3,109.50493,18.26181,1511
36100,270219,B6A8225D84CC06865D19854E19C5D3FF,30711,17,19,2,109.50271,18.25347,1510
36101,270220,B6A8225D84CC06865D19854E19C5D3FF,38484,20,23,3,109.53028,18.31528,1620
36105,270305,2F4C1C91886E87D50AD517FFA0255365,60381,18,21,3,109.5241,18.22458,1605
36106,270306,2F4C1C91886E87D50AD517FFA0255365,38951,22,23,1,109.48097,18.28868,1416
36107,270318,E191BF114A3C2277CB7C3323BAA13F43,30854,10,13,3,109.56889,18.27076,1763
36108,270319,E191BF114A3C2277CB7C3323BAA13F43,38154,17,20,3,109.5266,18.28278,1615
36109,270323,9FC721E86703223349C05C95FE4BBB6F,30731,0,10,10,109.50944,18.22306,1555
36110,270324,9FC721E86703223349C05C95FE4BBB6F,60381,11,14,3,109.5241,18.22458,1605
36111,270325,9FC721E86703223349C05C95FE4BBB6F,31521,14,16,2,109.51458,18.22542,1555
36112,270326,9FC721E86703223349C05C95FE4BBB6F,60381,18,20,2,109.5241,18.22458,1605
36113,270327,9FC721E86703223349C05C95FE4BBB6F,60081,21,23,2,109.51097,18.22639,1556
36114,270359,0A4F42A6BEA3B55EB10690E35CCB86A0,38361,0,8,8,109.43667,18.29201,1267
36115,270360,0A4F42A6BEA3B55EB10690E35CCB86A0,31301,12,13,1,109.14493,18.31222,170
36116,270361,0A4F42A6BEA3B55EB10690E35CCB86A0,31471,14,16,2,109.34583,18.29563,917
36117,270362,0A4F42A6BEA3B55EB10690E35CCB86A0,38361,19,23,4,109.43667,18.29201,1267
36118,270368,E8D51F8B53F290BFD73338AD2AD8C728,31561,15,16,1,109.56792,18.28479,1765
36119,270369,E8D51F8B53F290BFD73338AD2AD8C728,30711,18,19,1,109.50271,18.25347,1510
36120,270370,E8D51F8B53F290BFD73338AD2AD8C728,31561,20,22,2,109.56792,18.28479,1765
36121,270375,1FC565965746807D5CEEE5746DEC2EDB,31061,1,5,4,109.53333,18.23257,1607
36122,270376,1FC565965746807D5CEEE5746DEC2EDB,60211,5,6,1,109.63549,18.26049,2011
36123,270377,1FC565965746807D5CEEE5746DEC2EDB,31061,6,10,4,109.53333,18.23257,1607
36124,270378,1FC565965746807D5CEEE5746DEC2EDB,60381,10,11,1,109.5241,18.22458,1605
36125,270379,1FC565965746807D5CEEE5746DEC2EDB,31061,13,23,10,109.53333,18.23257,1607
36126,270387,FACA7C472055342CB52356ECCA18D789,60281,0,1,1,109.51743,18.25924,1561
36127,270388,FACA7C472055342CB52356ECCA18D789,31461,1,12,11,109.5091,18.25389,1510
36128,270389,FACA7C472055342CB52356ECCA18D789,30421,12,13,1,109.50021,18.25861,1511
36129,270390,FACA7C472055342CB52356ECCA18D789,60281,14,20,6,109.51743,18.25924,1561
36130,270391,FACA7C472055342CB52356ECCA18D789,30421,20,22,2,109.50021,18.25861,1511
36131,270443,B3314CC1A9932E46ABE32B43A9CE4E61,31521,14,16,2,109.51458,18.22542,1555
36132,270444,B3314CC1A9932E46ABE32B43A9CE4E61,60221,19,23,4,109.52569,18.29188,1616
36133,270445,837D6F2B70308AF8E153EC6E3EB7BC0F,30861,0,2,2,109.52722,18.22743,1606
36134,270446,837D6F2B70308AF8E153EC6E3EB7BC0F,30854,3,7,4,109.56889,18.27076,1763
36135,270462,27F8982923E7FB8E96EFC86B9D9B43A5,31031,10,15,5,109.49979,18.25382,1510
36136,270467,30B65052F35DDEF849EA88BF5D44AAAC,30324,11,12,1,109.50326,18.29257,1517
36137,270468,30B65052F35DDEF849EA88BF5D44AAAC,31621,13,17,4,109.51035,18.29826,1568
36145,270603,783BD28003E162AB1A89D7CEEED7100D,30421,18,20,2,109.50021,18.25861,1511
36146,270605,48F96D4A7859D993A1FE7B58F8723D73,38951,19,22,3,109.48097,18.28868,1416
36147,270630,A9FCE0049DB44FE004EAFBF5B783F4A5,31945,2,7,5,109.58021,18.29403,1817
36148,270631,A9FCE0049DB44FE004EAFBF5B783F4A5,30854,7,16,9,109.56889,18.27076,1763
36149,270679,A64494D6F3A0AF8BF93D9FAA1169011A,31351,16,19,3,109.4959,18.28417,1465
36150,270680,A64494D6F3A0AF8BF93D9FAA1169011A,38811,20,23,3,109.50875,18.2175,1504
36155,270713,201045A9C980BD8E53B16B9129DFE596,31071,0,6,6,109.58257,18.28458,1815
36156,270714,201045A9C980BD8E53B16B9129DFE596,30854,6,10,4,109.56889,18.27076,1763
36157,270715,201045A9C980BD8E53B16B9129DFE596,31071,10,12,2,109.58257,18.28458,1815
36158,270716,201045A9C980BD8E53B16B9129DFE596,30854,14,16,2,109.56889,18.27076,1763
36159,270717,201045A9C980BD8E53B16B9129DFE596,31071,16,23,7,109.58257,18.28458,1815
36163,270724,2873D39E7EAE4EB9FF7882E90907EED7,30764,0,12,12,109.45806,18.29486,1367
36164,270725,2873D39E7EAE4EB9FF7882E90907EED7,60054,15,16,1,109.3016,18.31229,770
36165,270726,2873D39E7EAE4EB9FF7882E90907EED7,31471,17,18,1,109.34583,18.29563,917
36166,270727,2873D39E7EAE4EB9FF7882E90907EED7,31231,19,20,1,109.42597,18.29292,1217
36167,270728,2873D39E7EAE4EB9FF7882E90907EED7,30764,21,23,2,109.45806,18.29486,1367
36168,270738,015CDEB9169BCE5537ABAE49B6A63F2B,31071,1,7,6,109.58257,18.28458,1815
36169,270739,015CDEB9169BCE5537ABAE49B6A63F2B,30854,7,10,3,109.56889,18.27076,1763
36170,270740,015CDEB9169BCE5537ABAE49B6A63F2B,60463,12,16,4,109.52507,18.22438,1605
36171,270741,015CDEB9169BCE5537ABAE49B6A63F2B,31071,17,19,2,109.58257,18.28458,1815
36172,270750,3B7F4B71C655A8575FEAE798DEE249A5,31473,13,14,1,109.34792,18.29465,917
36173,270751,3B7F4B71C655A8575FEAE798DEE249A5,39111,19,23,4,109.5191,18.22597,1555
36174,270756,83F8DEFB45E9970F803B6E01CF53475C,30681,3,4,1,109.48493,18.26917,1463
36175,270757,83F8DEFB45E9970F803B6E01CF53475C,38871,5,6,1,109.44681,18.28625,1316
36176,270758,83F8DEFB45E9970F803B6E01CF53475C,30681,8,12,4,109.48493,18.26917,1463
36177,270759,83F8DEFB45E9970F803B6E01CF53475C,30171,17,18,1,109.48458,18.27139,1463
36178,270760,83F8DEFB45E9970F803B6E01CF53475C,31021,19,21,2,109.49021,18.27,1463
36179,270770,E4D199FCE009427481C9D06B9609AB1E,31931,1,8,7,109.54771,18.29403,1667
36180,270771,E4D199FCE009427481C9D06B9609AB1E,39181,8,10,2,109.55153,18.28035,1715
36181,270772,E4D199FCE009427481C9D06B9609AB1E,31931,11,12,1,109.54771,18.29403,1667
36182,270773,E4D199FCE009427481C9D06B9609AB1E,39181,12,21,9,109.55153,18.28035,1715
36183,270774,E4D199FCE009427481C9D06B9609AB1E,31931,22,23,1,109.54771,18.29403,1667
36184,270777,0EDCFC899F380C41F9A2EE3D4C482F01,39151,0,1,1,109.49875,18.25097,1510
36185,270778,0EDCFC899F380C41F9A2EE3D4C482F01,31231,3,6,3,109.42597,18.29292,1217
36189,270863,CEE029BCE37FDC8F7F38CBD43D03FD52,31561,1,19,18,109.56792,18.28479,1765
36190,270864,CEE029BCE37FDC8F7F38CBD43D03FD52,30851,22,23,1,109.5616,18.27396,1713
36191,270865,15C58AA4098F7C3C06247EBC0EBAF235,31145,15,16,1,109.20431,18.30479,369
36192,270866,15C58AA4098F7C3C06247EBC0EBAF235,31521,18,19,1,109.51458,18.22542,1555
36193,270867,15C58AA4098F7C3C06247EBC0EBAF235,60381,19,22,3,109.5241,18.22458,1605
36198,270874,0D00E0CA974DDA00224ACCD00B993468,30851,18,19,1,109.5616,18.27396,1713
36199,270875,0D00E0CA974DDA00224ACCD00B993468,31071,19,22,3,109.58257,18.28458,1815
36200,270888,C5536869E807B602F99387523BE0105F,38291,17,22,5,109.51618,18.24313,1558
36201,270889,4F19CF91A90D82A7A316A166A92A1B65,31021,1,7,6,109.49021,18.27,1463
36202,270890,4F19CF91A90D82A7A316A166A92A1B65,31471,11,12,1,109.34583,18.29563,917
36203,270891,4F19CF91A90D82A7A316A166A92A1B65,60054,15,16,1,109.3016,18.31229,770
36213,270963,71048DA762610C5657DD6D8242833DC9,30854,16,17,1,109.56889,18.27076,1763
36214,270964,71048DA762610C5657DD6D8242833DC9,30234,18,19,1,109.60681,18.29979,1918
36215,270965,71048DA762610C5657DD6D8242833DC9,30854,20,22,2,109.56889,18.27076,1763
36216,270971,B93185B4820D7E0DEE74EBEA00941D15,31261,0,2,2,109.51174,18.2466,1559
36217,270972,B93185B4820D7E0DEE74EBEA00941D15,30911,3,17,14,109.50493,18.26181,1511
36218,270989,B53BDB0E641543CDF2C1AD769CF0243E,48574,15,17,2,109.48931,18.28458,1465
36219,270990,B53BDB0E641543CDF2C1AD769CF0243E,60381,19,20,1,109.5241,18.22458,1605
36220,270991,B53BDB0E641543CDF2C1AD769CF0243E,48574,21,23,2,109.48931,18.28458,1465
36225,271010,6E2021B014C4D0B652A2E4FE8D2CF038,31071,0,8,8,109.58257,18.28458,1815
36226,271011,6E2021B014C4D0B652A2E4FE8D2CF038,30854,9,11,2,109.56889,18.27076,1763
36227,271012,6E2021B014C4D0B652A2E4FE8D2CF038,31071,15,17,2,109.58257,18.28458,1815
36228,271013,6E2021B014C4D0B652A2E4FE8D2CF038,30854,18,19,1,109.56889,18.27076,1763
36229,271014,6E2021B014C4D0B652A2E4FE8D2CF038,60354,19,21,2,109.58701,18.28521,1815
36233,271041,95BE48C021B50D6A6455D1E388D02603,30661,0,7,7,109.37028,18.24361,1008
36234,271042,95BE48C021B50D6A6455D1E388D02603,60411,8,9,1,109.32514,18.30854,869
36235,271043,95BE48C021B50D6A6455D1E388D02603,30661,14,16,2,109.37028,18.24361,1008
36236,271044,95BE48C021B50D6A6455D1E388D02603,31471,20,22,2,109.34583,18.29563,917
36237,271062,CD77A45360FB53F816FCE62F008EEE28,39131,10,11,1,109.2066,18.29639,417
36238,271063,CD77A45360FB53F816FCE62F008EEE28,60241,13,19,6,109.53319,18.28667,1616
36239,271064,CD77A45360FB53F816FCE62F008EEE28,39154,20,22,2,109.50201,18.25681,1511
36240,271080,5CA55CD8D4F566164B5FC97C1F60F037,60381,1,12,11,109.5241,18.22458,1605
36241,271081,5CA55CD8D4F566164B5FC97C1F60F037,31471,15,16,1,109.34583,18.29563,917
36242,271097,C70F13EBED98CEA95256B69B55849D14,39111,0,10,10,109.5191,18.22597,1555
36243,271098,C70F13EBED98CEA95256B69B55849D14,39321,10,13,3,109.529,18.2167,1604
36244,271099,C70F13EBED98CEA95256B69B55849D14,39111,14,17,3,109.5191,18.22597,1555
36245,271100,C70F13EBED98CEA95256B69B55849D14,39321,19,20,1,109.529,18.2167,1604
36246,271101,C70F13EBED98CEA95256B69B55849D14,30731,20,23,3,109.50944,18.22306,1555
36247,271102,52C15F07544D9CC60D46BD6BA2551891,31945,18,20,2,109.58021,18.29403,1817
36248,271103,52C15F07544D9CC60D46BD6BA2551891,31181,22,23,1,109.50382,18.24813,1509
36249,271111,C162E20472DBB598395501A28AA53C86,31351,0,1,1,109.4959,18.28417,1465
36250,271112,C162E20472DBB598395501A28AA53C86,31671,2,7,5,109.38965,18.29813,1068
36251,271113,C162E20472DBB598395501A28AA53C86,38185,9,12,3,109.51333,18.27347,1563
36252,271114,C162E20472DBB598395501A28AA53C86,31671,12,15,3,109.38965,18.29813,1068
36253,271155,48C572DE45F47C4C9AC9760072E5355D,31781,13,15,2,109.19847,18.2975,367
36254,271156,48C572DE45F47C4C9AC9760072E5355D,60401,16,18,2,109.47444,18.27583,1414
36255,271157,48C572DE45F47C4C9AC9760072E5355D,31521,21,23,2,109.51458,18.22542,1555
36256,271166,92A852F4802D3D92C195A90A9645A57F,31471,13,14,1,109.34583,18.29563,917
36257,271167,92A852F4802D3D92C195A90A9645A57F,38325,18,20,2,109.39792,18.2909,1116
36258,271168,92A852F4802D3D92C195A90A9645A57F,38903,21,22,1,109.39229,18.29243,1117
36262,271184,59127DC6B0F65E35F1A06151B98097C8,31521,12,15,3,109.51458,18.22542,1555
36263,271185,59127DC6B0F65E35F1A06151B98097C8,31521,17,23,6,109.51458,18.22542,1555
36264,271224,78DA7A4E680FDAB27461B8DE1108145A,31071,1,3,2,109.58257,18.28458,1815
36265,271225,78DA7A4E680FDAB27461B8DE1108145A,30854,3,20,17,109.56889,18.27076,1763
36266,271226,99CBAA6A65A50998F0A10B72B36210E4,60231,1,12,11,109.49903,18.21972,1504
36267,271227,99CBAA6A65A50998F0A10B72B36210E4,38251,12,15,3,109.49618,18.25493,1510
36268,271228,99CBAA6A65A50998F0A10B72B36210E4,31091,18,19,1,109.41201,18.31222,1170
36269,271229,99CBAA6A65A50998F0A10B72B36210E4,38251,19,21,2,109.49618,18.25493,1510
36270,271234,F0A193984741E1FF945C798D00267316,38251,0,11,11,109.49618,18.25493,1510
36271,271235,F0A193984741E1FF945C798D00267316,31471,15,16,1,109.34583,18.29563,917
36272,271236,F0A193984741E1FF945C798D00267316,38251,20,23,3,109.49618,18.25493,1510
36273,271244,66A68DF7322984DDFD4069A80816FA0D,38052,8,9,1,109.62618,18.23042,1956
36274,271245,66A68DF7322984DDFD4069A80816FA0D,38331,10,14,4,109.62465,18.22736,1956
36275,271246,66A68DF7322984DDFD4069A80816FA0D,60594,15,16,1,109.62694,18.22799,1956
36279,271267,7EBC20D0E5F0FBA046CA1D08E7FF47C1,31071,19,21,2,109.58257,18.28458,1815
36280,271268,7EBC20D0E5F0FBA046CA1D08E7FF47C1,30854,21,23,2,109.56889,18.27076,1763
36281,271290,A35D2DDD81A64779F2A13924D85B1FB0,38315,12,13,1,109.48979,18.29764,1467
36282,271298,37D38EF0062E64D55C94EB554B76F9EE,31071,0,6,6,109.58257,18.28458,1815
36283,271299,37D38EF0062E64D55C94EB554B76F9EE,30854,10,15,5,109.56889,18.27076,1763
36284,271302,4E2E832AE9D054F6D1F41FA6FCE0E148,30851,18,19,1,109.5616,18.27396,1713
36285,271303,4E2E832AE9D054F6D1F41FA6FCE0E148,31561,19,22,3,109.56792,18.28479,1765
36286,271310,3C5AEA306E8A69C707195C4150E77D90,31931,1,2,1,109.54771,18.29403,1667
36287,271311,3C5AEA306E8A69C707195C4150E77D90,39181,5,6,1,109.55153,18.28035,1715
36288,271312,3C5AEA306E8A69C707195C4150E77D90,31931,9,11,2,109.54771,18.29403,1667
36289,271313,3C5AEA306E8A69C707195C4150E77D90,60371,15,16,1,109.53063,18.30056,1618
36290,271314,3C5AEA306E8A69C707195C4150E77D90,31931,20,23,3,109.54771,18.29403,1667
36291,271348,116946A75ECB7D461042B4C21CF61908,30111,1,11,10,109.47583,18.30542,1419
36292,271349,116946A75ECB7D461042B4C21CF61908,30361,13,15,2,109.50347,18.24,1508
36293,271350,116946A75ECB7D461042B4C21CF61908,38094,16,17,1,109.45403,18.28778,1316
36294,271363,F5E480BCE870DAE347CB60AA32F4CA1B,60281,13,14,1,109.51743,18.25924,1561
36295,271364,F5E480BCE870DAE347CB60AA32F4CA1B,31206,18,20,2,109.50819,18.23549,1507
36296,271365,F5E480BCE870DAE347CB60AA32F4CA1B,31461,20,23,3,109.5091,18.25389,1510
36297,271377,020753EF78F0A0C39658113A3377EA1E,30854,1,2,1,109.56889,18.27076,1763
36298,271378,020753EF78F0A0C39658113A3377EA1E,31561,3,19,16,109.56792,18.28479,1765
36299,271382,3971E288F0FB50DDE06A11C534E966DA,39151,19,20,1,109.49875,18.25097,1510
36300,271383,3971E288F0FB50DDE06A11C534E966DA,30191,21,22,1,109.50361,18.22701,1506
36301,271411,76F6A54588C8DF7DDADFC50CAA11D44C,30854,4,15,11,109.56889,18.27076,1763
36302,271412,76F6A54588C8DF7DDADFC50CAA11D44C,38085,15,23,8,109.6291,18.23625,2007
36303,271462,2F578B567AB440CCCFAE4543FB5BCFD7,30361,12,14,2,109.50347,18.24,1508
36304,271463,2F578B567AB440CCCFAE4543FB5BCFD7,60401,14,16,2,109.47444,18.27583,1414
36305,271464,012ABD06F231728C214A4BA917E75B1C,31561,0,5,5,109.56792,18.28479,1765
36306,271465,012ABD06F231728C214A4BA917E75B1C,30854,7,8,1,109.56889,18.27076,1763
36307,271466,012ABD06F231728C214A4BA917E75B1C,31561,9,10,1,109.56792,18.28479,1765
36308,271467,012ABD06F231728C214A4BA917E75B1C,30851,11,13,2,109.5616,18.27396,1713
36309,271468,012ABD06F231728C214A4BA917E75B1C,31561,14,15,1,109.56792,18.28479,1765
36310,271469,012ABD06F231728C214A4BA917E75B1C,30851,15,16,1,109.5616,18.27396,1713
36315,271474,213AF2099653A4ADAEF799CCC144B279,30021,1,21,20,109.12014,18.40986,86
36316,271476,A8E9C7BB918ADAD29A3EA7ACDDCD32D7,31261,0,7,7,109.51174,18.2466,1559
36317,271477,A8E9C7BB918ADAD29A3EA7ACDDCD32D7,38951,7,19,12,109.48097,18.28868,1416
36318,271478,A8E9C7BB918ADAD29A3EA7ACDDCD32D7,38951,19,23,4,109.48097,18.28868,1416
36319,271509,BC9379F60A71CB59CD8F3A1655FC51C1,30161,20,21,1,109.50042,18.24389,1508
36320,271510,BC9379F60A71CB59CD8F3A1655FC51C1,30361,21,23,2,109.50347,18.24,1508
36321,271529,8468419E5C597B7D73CBDE87F8FF8BC8,38171,14,23,9,109.50799,18.28139,1515
36322,271551,9D6121CD6282CA9FECC2A1981BC306C6,31071,5,15,10,109.58257,18.28458,1815
36323,271552,9D6121CD6282CA9FECC2A1981BC306C6,31561,19,22,3,109.56792,18.28479,1765
36324,271556,A0CFD24F8D50ABCF6002C5FC96CEAB76,39183,0,12,12,109.55542,18.28208,1715
36325,271557,A0CFD24F8D50ABCF6002C5FC96CEAB76,39181,16,21,5,109.55153,18.28035,1715
36326,271562,304893F9D89FE7F975345BDEC6DE10AD,39131,17,23,6,109.2066,18.29639,417
36331,271571,BEE3A0C9BB09D7F210E3490BED90A1BE,30791,0,16,16,109.72333,18.40889,2386
36332,271572,BEE3A0C9BB09D7F210E3490BED90A1BE,30071,19,21,2,109.52819,18.30472,1619
36333,271573,D9AE11CD16B231308C3F0FB3F53BC3E9,31071,13,14,1,109.58257,18.28458,1815
36334,271574,D9AE11CD16B231308C3F0FB3F53BC3E9,30854,19,23,4,109.56889,18.27076,1763
36335,271582,E2D4D9AB60C01F4DDBFF32F06C5B8E99,30854,9,10,1,109.56889,18.27076,1763
36336,271584,59C8F522837794F40F5181683B9A3A94,31271,0,7,7,109.48958,18.26257,1462
36337,271647,D61883A9E0C7F2103C981F95E51C66DA,38291,0,1,1,109.51618,18.24313,1558
36338,271648,D61883A9E0C7F2103C981F95E51C66DA,31821,3,4,1,109.51181,18.24924,1559
36339,271649,D61883A9E0C7F2103C981F95E51C66DA,31931,5,8,3,109.54771,18.29403,1667
36340,271650,D61883A9E0C7F2103C981F95E51C66DA,60241,10,11,1,109.53319,18.28667,1616
36341,271663,68CEAA977F13F8E6482609B7352C0B52,30921,0,13,13,109.53903,18.29451,1667
36342,271664,68CEAA977F13F8E6482609B7352C0B52,30361,17,19,2,109.50347,18.24,1508
36343,271665,68CEAA977F13F8E6482609B7352C0B52,30921,21,23,2,109.53903,18.29451,1667
36344,271668,F477CD0D1BA571DFDAA4F6B37DA3B938,60117,0,11,11,109.73604,18.35681,2427
36354,271778,C983E73D646629A775690ECA8920EB29,31631,0,2,2,109.59542,18.36826,1879
36355,271779,C983E73D646629A775690ECA8920EB29,30101,2,21,19,109.57299,18.33333,1773
36356,271835,3C41A72AB684AF05AAF7A1837796966D,30361,17,19,2,109.50347,18.24,1508
36357,271836,3C41A72AB684AF05AAF7A1837796966D,38961,20,23,3,109.50847,18.23514,1507
36358,271840,B67077454AD8A4D5B7466F7FC75A23B9,60411,0,15,15,109.32514,18.30854,869
36359,271841,B67077454AD8A4D5B7466F7FC75A23B9,30661,17,20,3,109.37028,18.24361,1008
36360,271842,B67077454AD8A4D5B7466F7FC75A23B9,60411,22,23,1,109.32514,18.30854,869
36361,271843,23073B802C909D3D46ECEB73A8309E22,30961,4,6,2,109.74042,18.37903,2431
36362,271844,23073B802C909D3D46ECEB73A8309E22,60631,11,12,1,109.57778,18.27583,1814
36363,271845,23073B802C909D3D46ECEB73A8309E22,30854,12,14,2,109.56889,18.27076,1763
36367,271863,36B4A30042EDB6D7667588D6680D6E56,30234,16,17,1,109.60681,18.29979,1918
36368,271874,F1114751990E9EE36CDB7660EAA9CD6F,31071,0,6,6,109.58257,18.28458,1815
36369,271875,F1114751990E9EE36CDB7660EAA9CD6F,30854,6,7,1,109.56889,18.27076,1763
36370,271876,F1114751990E9EE36CDB7660EAA9CD6F,31071,9,13,4,109.58257,18.28458,1815
36371,271877,F1114751990E9EE36CDB7660EAA9CD6F,30854,14,16,2,109.56889,18.27076,1763
36372,271878,F1114751990E9EE36CDB7660EAA9CD6F,31071,16,20,4,109.58257,18.28458,1815
36373,271882,5310F66B3196EF90D8CF1E7831B3063C,38132,0,9,9,109.64632,18.23417,2057
36374,271883,5310F66B3196EF90D8CF1E7831B3063C,31471,14,15,1,109.34583,18.29563,917
36375,271884,5310F66B3196EF90D8CF1E7831B3063C,30771,18,19,1,109.49938,18.26042,1511
36376,271905,117CDF2D41FFFF099F62724091D8605A,60631,0,1,1,109.57778,18.27583,1814
36377,271906,117CDF2D41FFFF099F62724091D8605A,30854,5,9,4,109.56889,18.27076,1763
36384,271939,9EBFE19AEC38C3A6F47AE2D903294BAE,30854,2,6,4,109.56889,18.27076,1763
36385,271940,9EBFE19AEC38C3A6F47AE2D903294BAE,31164,10,14,4,109.69993,18.27215,2263
36386,271941,7890099D98AA300C5BF12527E7372DB0,60631,0,7,7,109.57778,18.27583,1814
36387,271942,7890099D98AA300C5BF12527E7372DB0,30854,9,10,1,109.56889,18.27076,1763
36388,271943,7890099D98AA300C5BF12527E7372DB0,31071,12,13,1,109.58257,18.28458,1815
36389,271944,7890099D98AA300C5BF12527E7372DB0,30854,15,17,2,109.56889,18.27076,1763
36390,271945,7890099D98AA300C5BF12527E7372DB0,60631,21,23,2,109.57778,18.27583,1814
36391,271962,D96E01B8E0F0DE9C160C9FEAFDCFDB6D,31071,0,7,7,109.58257,18.28458,1815
36392,271963,D96E01B8E0F0DE9C160C9FEAFDCFDB6D,30854,11,13,2,109.56889,18.27076,1763
36393,271986,9E45264EC835227EA5B2232A2B85D7B9,31521,14,16,2,109.51458,18.22542,1555
36394,271987,9E45264EC835227EA5B2232A2B85D7B9,60381,18,19,1,109.5241,18.22458,1605
36395,272005,2261FA59C58CA1DB4ED476451BEA0AD4,60361,19,20,1,109.51938,18.29681,1567
36396,272006,2261FA59C58CA1DB4ED476451BEA0AD4,31021,21,22,1,109.49021,18.27,1463
36397,272032,40285EE8CCE25C38988EC087545664EC,30854,10,12,2,109.56889,18.27076,1763
36398,272033,40285EE8CCE25C38988EC087545664EC,31071,14,17,3,109.58257,18.28458,1815
36399,272034,40285EE8CCE25C38988EC087545664EC,30854,21,23,2,109.56889,18.27076,1763
36400,272095,C8922FAF66F21ECAECB6B717FCD5A53B,60614,0,2,2,109.48799,18.29521,1467
36401,272096,C8922FAF66F21ECAECB6B717FCD5A53B,60504,2,6,4,109.47917,18.28903,1416
36402,272097,C8922FAF66F21ECAECB6B717FCD5A53B,60614,6,15,9,109.48799,18.29521,1467
36403,272098,C8922FAF66F21ECAECB6B717FCD5A53B,60504,17,18,1,109.47917,18.28903,1416
36404,272099,C8922FAF66F21ECAECB6B717FCD5A53B,31031,20,21,1,109.49979,18.25382,1510
36408,272131,601485EE1975CD21F8AEB362220395E5,31231,17,18,1,109.42597,18.29292,1217
36409,272132,601485EE1975CD21F8AEB362220395E5,30361,19,20,1,109.50347,18.24,1508
36410,272139,20113F117BF3A764361CF4D37F432D52,48574,0,8,8,109.48931,18.28458,1465
36411,272151,89E718E5F535407ABE60C96AFD69F690,30421,1,7,6,109.50021,18.25861,1511
36412,272152,89E718E5F535407ABE60C96AFD69F690,30911,11,12,1,109.50493,18.26181,1511
36413,272153,89E718E5F535407ABE60C96AFD69F690,30421,13,14,1,109.50021,18.25861,1511
36414,272154,89E718E5F535407ABE60C96AFD69F690,30211,14,16,2,109.49882,18.23931,1508
36415,272155,89E718E5F535407ABE60C96AFD69F690,30361,18,20,2,109.50347,18.24,1508
36416,272173,8A19D38C67DEBBE2072401E23B2467C5,31161,0,4,4,109.70229,18.31361,2270
36417,272174,8A19D38C67DEBBE2072401E23B2467C5,60211,6,8,2,109.63549,18.26049,2011
36418,272176,8A19D38C67DEBBE2072401E23B2467C5,31161,14,23,9,109.70229,18.31361,2270
36419,272181,FA867EC4A75F48065A30E6C5CB1A5293,30771,19,21,2,109.49938,18.26042,1511
36420,272186,51DF765CB634D9549D20AD1F2C37BA18,30854,10,12,2,109.56889,18.27076,1763
36421,272187,51DF765CB634D9549D20AD1F2C37BA18,31071,13,16,3,109.58257,18.28458,1815
36422,272201,04ABA8BFD5D63DDF1B83BA0577C9019C,39371,1,8,7,109.56627,18.2646,1762
36423,272202,04ABA8BFD5D63DDF1B83BA0577C9019C,31071,12,15,3,109.58257,18.28458,1815
36432,272262,6FD88D74D66E8FAB66A93CB5D0609C41,30711,7,9,2,109.50271,18.25347,1510
36433,272263,6FD88D74D66E8FAB66A93CB5D0609C41,30854,13,23,10,109.56889,18.27076,1763
36434,272264,6D8E3C1E96FE4721446F9F86A4DCFD4B,30324,17,19,2,109.50326,18.29257,1517
36435,272265,6D8E3C1E96FE4721446F9F86A4DCFD4B,30051,21,23,2,109.48917,18.21215,1453
36436,272277,79FD298D94ED606250C160861575CD8F,31551,7,9,2,109.55868,18.24222,1708
36437,272278,79FD298D94ED606250C160861575CD8F,31554,10,21,11,109.55521,18.2459,1709
36444,272316,96C474E5BFF92BC21432A4ADDD7A543D,30854,0,17,17,109.56889,18.27076,1763
36445,272317,96C474E5BFF92BC21432A4ADDD7A543D,30861,18,19,1,109.52722,18.22743,1606
36446,272348,D46DE9169E4BACF1D272EA5E0FDEF68F,30711,19,20,1,109.50271,18.25347,1510
36447,272349,D46DE9169E4BACF1D272EA5E0FDEF68F,31561,20,23,3,109.56792,18.28479,1765
36448,272374,2AE38FAF341950B0B91404FFCE5A0F3E,30921,7,16,9,109.53903,18.29451,1667
36449,272375,2AE38FAF341950B0B91404FFCE5A0F3E,39183,19,21,2,109.55542,18.28208,1715
36453,272393,F3ADE38A6219C04719D8BAB38E16EC80,31701,0,5,5,109.44132,18.28833,1266
36454,272394,F3ADE38A6219C04719D8BAB38E16EC80,39043,5,8,3,109.40778,18.29049,1166
36455,272409,D8917A2A43EA8070EEC2FA46A7C72FE1,30504,0,8,8,109.705,18.35368,2277
36456,272410,D8917A2A43EA8070EEC2FA46A7C72FE1,30711,9,12,3,109.50271,18.25347,1510
36457,272411,D8917A2A43EA8070EEC2FA46A7C72FE1,39091,15,23,8,109.50097,18.25222,1510
36458,272444,ECD0945121CF92E8C5C4049D02E0987F,38871,0,6,6,109.44681,18.28625,1316
36459,272445,ECD0945121CF92E8C5C4049D02E0987F,30661,8,9,1,109.37028,18.24361,1008
36460,272446,ECD0945121CF92E8C5C4049D02E0987F,31471,10,13,3,109.34583,18.29563,917
36461,272447,ECD0945121CF92E8C5C4049D02E0987F,60054,13,14,1,109.3016,18.31229,770
36462,272448,DFFF17B7FE30E79B8AABBB5CE171272F,31561,2,9,7,109.56792,18.28479,1765
36463,272449,DFFF17B7FE30E79B8AABBB5CE171272F,30854,12,14,2,109.56889,18.27076,1763
36464,272450,DFFF17B7FE30E79B8AABBB5CE171272F,31561,15,16,1,109.56792,18.28479,1765
36465,272451,DFFF17B7FE30E79B8AABBB5CE171272F,39183,17,19,2,109.55542,18.28208,1715
36466,272452,DFFF17B7FE30E79B8AABBB5CE171272F,30854,20,21,1,109.56889,18.27076,1763
36467,272453,0874ECC8591FCEC6749163A25CC3B800,39091,16,18,2,109.50097,18.25222,1510
36468,272454,0874ECC8591FCEC6749163A25CC3B800,31471,22,23,1,109.34583,18.29563,917
36473,272496,31B5749A66C854438247EB4202810257,31781,11,13,2,109.19847,18.2975,367
36474,272497,31B5749A66C854438247EB4202810257,60054,15,16,1,109.3016,18.31229,770
36475,272498,31B5749A66C854438247EB4202810257,30361,18,19,1,109.50347,18.24,1508
36480,272533,EC4B90EDBF35256FDB4D4F8B87DB8A04,30854,0,6,6,109.56889,18.27076,1763
36481,272534,EC4B90EDBF35256FDB4D4F8B87DB8A04,31071,9,13,4,109.58257,18.28458,1815
36482,272590,0D69669D4DBC1CEB06269A084D86E853,60631,0,8,8,109.57778,18.27583,1814
36483,272591,0D69669D4DBC1CEB06269A084D86E853,30854,8,9,1,109.56889,18.27076,1763
36484,272592,0D69669D4DBC1CEB06269A084D86E853,31571,13,15,2,109.61563,18.23326,1957
36485,272595,F41EE3B813183A9F30BD8332EE4C4650,60054,12,14,2,109.3016,18.31229,770
36486,272596,F41EE3B813183A9F30BD8332EE4C4650,30181,18,20,2,109.51597,18.23313,1557
36487,272597,F41EE3B813183A9F30BD8332EE4C4650,30191,21,23,2,109.50361,18.22701,1506
36494,272649,67CDBD95CEB6CBFC8E0EE012353E074B,31071,14,15,1,109.58257,18.28458,1815
36495,272650,67CDBD95CEB6CBFC8E0EE012353E074B,30854,18,20,2,109.56889,18.27076,1763
36496,272652,C6579823835B85A254880E72927E82BB,33354,8,10,2,109.67465,18.44583,2192
36497,272653,C6579823835B85A254880E72927E82BB,33051,12,14,2,109.6475,18.46618,2096
36498,272654,C6579823835B85A254880E72927E82BB,30854,17,18,1,109.56889,18.27076,1763
36499,272655,C6579823835B85A254880E72927E82BB,39321,19,21,2,109.529,18.2167,1604
36500,272686,2C7DB696A14A5E061C2912E5376233C9,31945,14,16,2,109.58021,18.29403,1817
36501,272687,2C7DB696A14A5E061C2912E5376233C9,31071,21,23,2,109.58257,18.28458,1815
36502,272692,A5E7142EDB2C00D2F56F81D099876FCF,31951,11,14,3,109.52174,18.30299,1568
36506,272792,870387A96F6C285C25ED9B74BEB3EF82,38283,0,10,10,109.62229,18.22618,1956
36507,272793,870387A96F6C285C25ED9B74BEB3EF82,30711,13,17,4,109.50271,18.25347,1510
36508,272794,870387A96F6C285C25ED9B74BEB3EF82,38283,19,23,4,109.62229,18.22618,1956
36512,272801,7F220C28A0C617E581A7723B6384F4CD,31471,17,19,2,109.34583,18.29563,917
36513,272802,7F220C28A0C617E581A7723B6384F4CD,38094,21,23,2,109.45403,18.28778,1316
36514,272808,AF125EFCC483E24833CBDDBC7248BDF1,30511,0,7,7,109.51069,18.24208,1558
36515,272809,AF125EFCC483E24833CBDDBC7248BDF1,38973,8,9,1,109.51097,18.25389,1560
36516,272810,AF125EFCC483E24833CBDDBC7248BDF1,31781,11,13,2,109.19847,18.2975,367
36517,272811,AF125EFCC483E24833CBDDBC7248BDF1,60121,14,15,1,109.74507,18.37472,2430
36518,272812,AF125EFCC483E24833CBDDBC7248BDF1,30271,16,23,7,109.49132,18.23153,1456
36523,272856,C0C46420E86FE7104EAC83C027355F32,31071,14,16,2,109.58257,18.28458,1815
36524,272857,C0C46420E86FE7104EAC83C027355F32,38336,20,23,3,109.61111,18.21806,1904
36525,272876,269D3761ED337530C37A42787A175B92,31304,0,7,7,109.15903,18.32854,223
36526,272877,269D3761ED337530C37A42787A175B92,31031,9,12,3,109.49979,18.25382,1510
36527,272878,269D3761ED337530C37A42787A175B92,31031,14,16,2,109.49979,18.25382,1510
36528,272879,269D3761ED337530C37A42787A175B92,31304,18,23,5,109.15903,18.32854,223
36529,272902,1D8B814EC83D52D7C5F3FED99C129EE0,30854,3,8,5,109.56889,18.27076,1763
36530,272903,1D8B814EC83D52D7C5F3FED99C129EE0,38271,11,17,6,109.62632,18.23049,1956
36531,272904,1D8B814EC83D52D7C5F3FED99C129EE0,39151,19,21,2,109.49875,18.25097,1510
36532,272909,0CBDBB0FD86E41225B8F6BD8B7F216EA,38541,0,9,9,109.73715,18.34875,2426
36533,272910,0CBDBB0FD86E41225B8F6BD8B7F216EA,38315,11,14,3,109.48979,18.29764,1467
36534,272977,80D5971B84EF3A2477C3F057B855AF63,31071,0,16,16,109.58257,18.28458,1815
36535,272978,80D5971B84EF3A2477C3F057B855AF63,30854,21,22,1,109.56889,18.27076,1763
36536,273005,D6AECE3F7AEF17FDDE30DB3B3A230B91,38315,12,13,1,109.48979,18.29764,1467
36537,273030,FCA0E154B092D503D8EAECB44B44540F,31081,0,6,6,109.44639,18.30181,1318
36538,273048,6BF671BC76B2463D72102139E4EB1018,31931,11,12,1,109.54771,18.29403,1667
36539,273049,6BF671BC76B2463D72102139E4EB1018,38241,13,15,2,109.54111,18.30542,1669
36540,273050,6BF671BC76B2463D72102139E4EB1018,60371,18,19,1,109.53063,18.30056,1618
36541,273051,6BF671BC76B2463D72102139E4EB1018,30071,21,23,2,109.52819,18.30472,1619
36542,273086,850F414E89CB3AC3E862CBFA17778006,30581,15,16,1,109.62257,18.24951,1959
36543,273087,850F414E89CB3AC3E862CBFA17778006,30271,17,20,3,109.49132,18.23153,1456
36544,273116,AB43182259122294244C13D6FC66D4A1,30851,19,21,2,109.5616,18.27396,1713
36545,273117,AB43182259122294244C13D6FC66D4A1,60631,21,22,1,109.57778,18.27583,1814
36546,273136,5BC86F424BAF4B877A98262DEDE87053,39154,14,15,1,109.50201,18.25681,1511
36547,273137,5BC86F424BAF4B877A98262DEDE87053,38251,17,20,3,109.49618,18.25493,1510
36548,273138,5BC86F424BAF4B877A98262DEDE87053,30421,21,22,1,109.50021,18.25861,1511
36549,273160,DE91F768E6CCDB78867FF54F078574C9,31761,1,3,2,109.60521,18.27965,1914
36550,273161,DE91F768E6CCDB78867FF54F078574C9,30854,4,18,14,109.56889,18.27076,1763
36551,273162,DE91F768E6CCDB78867FF54F078574C9,60381,21,22,1,109.5241,18.22458,1605
36552,273163,DE91F768E6CCDB78867FF54F078574C9,30854,22,23,1,109.56889,18.27076,1763
36553,273165,5EE25A6E7DD554FFDA0C9C1A504114B7,30221,0,18,18,109.57833,18.20222,1802
36554,273166,5EE25A6E7DD554FFDA0C9C1A504114B7,60291,21,23,2,109.50826,18.24639,1509
36555,273172,676172DB52801CBBE1ACD798ACBB4F3C,60541,0,7,7,109.4084,18.29208,1167
36556,273173,676172DB52801CBBE1ACD798ACBB4F3C,31301,10,13,3,109.14493,18.31222,170
36557,273174,676172DB52801CBBE1ACD798ACBB4F3C,31471,14,16,2,109.34583,18.29563,917
36558,273175,676172DB52801CBBE1ACD798ACBB4F3C,60541,19,20,1,109.4084,18.29208,1167
36559,273202,81626C5D93A3C503283ABF8594E54615,31521,10,12,2,109.51458,18.22542,1555
36560,273203,81626C5D93A3C503283ABF8594E54615,60381,13,14,1,109.5241,18.22458,1605
36561,273204,81626C5D93A3C503283ABF8594E54615,39321,14,16,2,109.529,18.2167,1604
36562,273205,81626C5D93A3C503283ABF8594E54615,31521,16,21,5,109.51458,18.22542,1555
36563,273240,728159D623DE360E7CBC8AEEC345E2FF,60381,19,21,2,109.5241,18.22458,1605
36564,273241,728159D623DE360E7CBC8AEEC345E2FF,60661,21,23,2,109.548,18.2377,1657
36565,273252,217CC2642DC5F459F756E8E9CAA9A63A,31071,11,13,2,109.58257,18.28458,1815
36566,273253,217CC2642DC5F459F756E8E9CAA9A63A,30854,18,19,1,109.56889,18.27076,1763
36567,273254,217CC2642DC5F459F756E8E9CAA9A63A,60631,20,22,2,109.57778,18.27583,1814
36571,273343,D17842D1E850E617B4B15889C460D1C5,30921,17,18,1,109.53903,18.29451,1667
36572,273344,D17842D1E850E617B4B15889C460D1C5,31931,20,23,3,109.54771,18.29403,1667
36577,273386,6C0260646767B781577B5B8CE2471E51,31521,15,16,1,109.51458,18.22542,1555
36578,273387,6C0260646767B781577B5B8CE2471E51,30711,19,21,2,109.50271,18.25347,1510
36579,273391,52626520133C58C019E9712FB19D3224,38171,0,8,8,109.50799,18.28139,1515
36580,273392,52626520133C58C019E9712FB19D3224,38376,9,10,1,109.50924,18.24,1558
36581,273393,52626520133C58C019E9712FB19D3224,30711,11,13,2,109.50271,18.25347,1510
36582,273394,52626520133C58C019E9712FB19D3224,60201,15,17,2,109.5041,18.2509,1510
36583,273395,52626520133C58C019E9712FB19D3224,30271,19,20,1,109.49132,18.23153,1456
36584,273396,52626520133C58C019E9712FB19D3224,38171,21,22,1,109.50799,18.28139,1515
36591,273491,EF7DCA5602FCDF14AF156D676A8ED902,31561,0,13,13,109.56792,18.28479,1765
36592,273492,EF7DCA5602FCDF14AF156D676A8ED902,31931,14,17,3,109.54771,18.29403,1667
36596,273531,8AABF5FDF2B06EB445749240A3894969,31561,1,9,8,109.56792,18.28479,1765
36597,273532,8AABF5FDF2B06EB445749240A3894969,30854,11,18,7,109.56889,18.27076,1763
36598,273583,7B832C4EEA998F0828995CEC1FF24330,30854,0,9,9,109.56889,18.27076,1763
36599,273584,7B832C4EEA998F0828995CEC1FF24330,31071,12,15,3,109.58257,18.28458,1815
36600,273591,CC674AAAC7C027C8C72DEA73AA338EF1,38094,0,8,8,109.45403,18.28778,1316
36601,273592,CC674AAAC7C027C8C72DEA73AA338EF1,30111,8,10,2,109.47583,18.30542,1419
36602,273593,CC674AAAC7C027C8C72DEA73AA338EF1,30151,11,13,2,109.50986,18.25083,1560
36603,273594,CC674AAAC7C027C8C72DEA73AA338EF1,30111,17,23,6,109.47583,18.30542,1419
36604,273641,30CE72A519D49881F23B8123486E3A02,60411,0,7,7,109.32514,18.30854,869
36605,273642,30CE72A519D49881F23B8123486E3A02,31471,8,19,11,109.34583,18.29563,917
36606,273658,64FF3E93355E6DCA29977E04D316EABA,30151,0,2,2,109.50986,18.25083,1560
36607,273659,64FF3E93355E6DCA29977E04D316EABA,38973,2,7,5,109.51097,18.25389,1560
36608,273660,64FF3E93355E6DCA29977E04D316EABA,31781,8,10,2,109.19847,18.2975,367
36609,273661,64FF3E93355E6DCA29977E04D316EABA,60551,12,13,1,109.42722,18.30111,1218
36610,273662,64FF3E93355E6DCA29977E04D316EABA,31461,18,21,3,109.5091,18.25389,1510
36611,273663,64FF3E93355E6DCA29977E04D316EABA,30771,21,23,2,109.49938,18.26042,1511
36612,273690,F48ACD2CDFF9D1E4C0B8EBCB12428C64,30531,0,11,11,109.53271,18.21472,1604
36613,273691,F48ACD2CDFF9D1E4C0B8EBCB12428C64,38283,15,23,8,109.62229,18.22618,1956
36614,273709,798BF3B08F72A16A6DEAAA235F1899BB,61011,8,11,3,109.60653,18.19076,1900
36615,273711,798BF3B08F72A16A6DEAAA235F1899BB,61011,18,23,5,109.60653,18.19076,1900
36616,273735,43A422D32148E3FF9BC0EC7D857AA8BB,31521,3,13,10,109.51458,18.22542,1555
36617,273736,43A422D32148E3FF9BC0EC7D857AA8BB,38071,14,15,1,109.40722,18.30938,1169
36618,273806,E4C7AB656E412C7E33554D18277C9478,60201,13,14,1,109.5041,18.2509,1510
36619,273807,E4C7AB656E412C7E33554D18277C9478,30151,14,15,1,109.50986,18.25083,1560
36620,273808,E4C7AB656E412C7E33554D18277C9478,60201,19,20,1,109.5041,18.2509,1510
36621,273824,2BE6133C5E44424C388243054653B4C5,60631,15,16,1,109.57778,18.27583,1814
36625,273923,AA76F8E942B052AF1B0A5FE357B32C6F,30711,11,13,2,109.50271,18.25347,1510
36626,273924,AA76F8E942B052AF1B0A5FE357B32C6F,31145,14,17,3,109.20431,18.30479,369
36627,273939,3BB24F8BCA3E0C99C850EC3AEEBC46A9,38251,12,22,10,109.49618,18.25493,1510
36628,273945,DC9885AE38AE7598214BC46FD2D819A5,30071,0,7,7,109.52819,18.30472,1619
36629,273946,DC9885AE38AE7598214BC46FD2D819A5,30911,12,13,1,109.50493,18.26181,1511
36630,273947,DC9885AE38AE7598214BC46FD2D819A5,60171,15,17,2,109.51292,18.30694,1569
36631,273948,DC9885AE38AE7598214BC46FD2D819A5,60501,18,20,2,109.48701,18.29021,1466
36632,273962,59F29435D748531F416A4F1636997ECF,60631,20,21,1,109.57778,18.27583,1814
36633,273963,59F29435D748531F416A4F1636997ECF,30854,21,22,1,109.56889,18.27076,1763
36634,273964,68DBE0B52FD0AB95F1DD47068FD7847F,38891,3,7,4,109.51486,18.24118,1558
36635,273965,68DBE0B52FD0AB95F1DD47068FD7847F,30181,7,17,10,109.51597,18.23313,1557
36636,274018,22CF7007721E0F1D863F25E4633BE1AD,38291,13,15,2,109.51618,18.24313,1558
36637,274019,22CF7007721E0F1D863F25E4633BE1AD,30771,16,17,1,109.49938,18.26042,1511
36638,274020,22CF7007721E0F1D863F25E4633BE1AD,60311,21,23,2,109.52097,18.24319,1558
36639,274026,BCBE041A7FC025F9D2DFD86A6CB75E1D,60011,5,7,2,109.48965,18.30222,1468
36640,274027,BCBE041A7FC025F9D2DFD86A6CB75E1D,30821,9,20,11,109.43681,18.33639,1274
36641,274039,369C26B411BBFC36DC6FE3529EBBC042,30854,0,7,7,109.56889,18.27076,1763
36642,274040,369C26B411BBFC36DC6FE3529EBBC042,39371,9,11,2,109.56627,18.2646,1762
36643,274046,D26D846AA198D3C0B38C165F40258F61,30381,13,15,2,109.52521,18.24507,1609
36644,274047,D26D846AA198D3C0B38C165F40258F61,30351,19,21,2,109.41701,18.29292,1217
36645,274054,7F377D9BD4A6752A92F213BA9B3E59E5,30421,3,5,2,109.50021,18.25861,1511
36646,274055,7F377D9BD4A6752A92F213BA9B3E59E5,30421,9,10,1,109.50021,18.25861,1511
36647,274056,7F377D9BD4A6752A92F213BA9B3E59E5,30421,12,13,1,109.50021,18.25861,1511
36648,274057,7F377D9BD4A6752A92F213BA9B3E59E5,31271,18,19,1,109.48958,18.26257,1462
36649,274058,7F377D9BD4A6752A92F213BA9B3E59E5,30421,22,23,1,109.50021,18.25861,1511
36650,274066,CCC8AB814E8164924F705C45AD546C57,31101,15,16,1,109.65389,18.23403,2057
36651,274067,CCC8AB814E8164924F705C45AD546C57,60221,19,20,1,109.52569,18.29188,1616
36652,274068,CCC8AB814E8164924F705C45AD546C57,60381,22,23,1,109.5241,18.22458,1605
36653,274115,66928E2A4C22C07B7C91AA14FCE9B6E4,31071,0,8,8,109.58257,18.28458,1815
36654,274116,66928E2A4C22C07B7C91AA14FCE9B6E4,30854,12,16,4,109.56889,18.27076,1763
36655,274124,14BFE46EEAB2E234698393270A62605D,30661,14,16,2,109.37028,18.24361,1008
36656,274125,14BFE46EEAB2E234698393270A62605D,60411,19,21,2,109.32514,18.30854,869
36657,274145,2CF83F5125C6075E2ACA9C17C2979C64,31945,1,6,5,109.58021,18.29403,1817
36658,274146,2CF83F5125C6075E2ACA9C17C2979C64,31071,8,10,2,109.58257,18.28458,1815
36659,274147,2CF83F5125C6075E2ACA9C17C2979C64,30854,12,13,1,109.56889,18.27076,1763
36660,274148,2CF83F5125C6075E2ACA9C17C2979C64,31071,13,14,1,109.58257,18.28458,1815
36661,274149,2CF83F5125C6075E2ACA9C17C2979C64,31945,18,20,2,109.58021,18.29403,1817
36662,274150,2CF83F5125C6075E2ACA9C17C2979C64,30854,21,23,2,109.56889,18.27076,1763
36663,274171,222E0B6922623CE9FBB280F81068D40E,60381,15,17,2,109.5241,18.22458,1605
36664,274172,222E0B6922623CE9FBB280F81068D40E,31521,20,21,1,109.51458,18.22542,1555
36665,274173,EFEDECB139A304BF1949D208B2A10BCC,31521,1,9,8,109.51458,18.22542,1555
36666,274174,EFEDECB139A304BF1949D208B2A10BCC,30731,14,16,2,109.50944,18.22306,1555
36667,274175,EFEDECB139A304BF1949D208B2A10BCC,31521,18,19,1,109.51458,18.22542,1555
36668,274176,EFEDECB139A304BF1949D208B2A10BCC,31031,20,21,1,109.49979,18.25382,1510
36669,274177,EFEDECB139A304BF1949D208B2A10BCC,31521,21,22,1,109.51458,18.22542,1555
36670,274198,656B9E927798C6351C23CE193C829143,30681,9,11,2,109.48493,18.26917,1463
36675,274213,DF0D684B9CE420DB70643C05E5C6EDD7,38141,0,2,2,109.39479,18.2916,1116
36676,274214,DF0D684B9CE420DB70643C05E5C6EDD7,31671,3,5,2,109.38965,18.29813,1068
36677,274215,DF0D684B9CE420DB70643C05E5C6EDD7,38141,6,8,2,109.39479,18.2916,1116
36678,274216,DF0D684B9CE420DB70643C05E5C6EDD7,30661,11,13,2,109.37028,18.24361,1008
36679,274217,DF0D684B9CE420DB70643C05E5C6EDD7,31471,14,16,2,109.34583,18.29563,917
36680,274218,DF0D684B9CE420DB70643C05E5C6EDD7,38141,19,23,4,109.39479,18.2916,1116
36685,274244,B19D039FEBAFACB75FE183A18A8FD559,60631,2,7,5,109.57778,18.27583,1814
36686,274246,B19D039FEBAFACB75FE183A18A8FD559,38071,15,17,2,109.40722,18.30938,1169
36690,274305,7171A8398911756415ECFCDCF96F249B,30121,0,6,6,109.52861,18.27222,1613
36691,274306,7171A8398911756415ECFCDCF96F249B,39371,8,23,15,109.56627,18.2646,1762
36692,274315,7F6E66BC10419161F6457A6D79258EDB,31361,6,8,2,109.47417,18.28292,1415
36693,274316,7F6E66BC10419161F6457A6D79258EDB,60401,8,9,1,109.47444,18.27583,1414
36694,274317,7F6E66BC10419161F6457A6D79258EDB,30341,14,16,2,109.3625,18.29167,966
36695,274318,7F6E66BC10419161F6457A6D79258EDB,60621,19,23,4,109.48354,18.27451,1464
36699,274345,ADF0A7CED2B8DFD757D8FCA8B507C37E,38283,10,12,2,109.62229,18.22618,1956
36700,274346,ADF0A7CED2B8DFD757D8FCA8B507C37E,38283,17,18,1,109.62229,18.22618,1956
36701,274355,372A5433078073EAD18922D679CE0A73,30661,0,1,1,109.37028,18.24361,1008
36702,274356,372A5433078073EAD18922D679CE0A73,60054,2,11,9,109.3016,18.31229,770
36703,274357,372A5433078073EAD18922D679CE0A73,30661,11,13,2,109.37028,18.24361,1008
36704,274358,372A5433078073EAD18922D679CE0A73,60411,16,17,1,109.32514,18.30854,869
36705,274378,54A73DB0CD99440F50C2E61FD5693272,30671,0,16,16,109.43611,18.30139,1268
36706,274379,54A73DB0CD99440F50C2E61FD5693272,31251,20,22,2,109.18528,18.2975,317
36707,274435,F568EAB7DFDD5D41E19A6F375B979656,38185,0,2,2,109.51333,18.27347,1563
36708,274436,F568EAB7DFDD5D41E19A6F375B979656,60361,2,23,21,109.51938,18.29681,1567
36709,274451,65AD296DD65C9EEA3C22EA02904A768E,30854,10,17,7,109.56889,18.27076,1763
36710,274452,65AD296DD65C9EEA3C22EA02904A768E,30851,18,19,1,109.5616,18.27396,1713
36711,274529,D4EE8E1A4C04A1FF0596E4221D0B8B42,31071,0,7,7,109.58257,18.28458,1815
36712,274530,D4EE8E1A4C04A1FF0596E4221D0B8B42,30854,11,13,2,109.56889,18.27076,1763
36713,274547,434E56E5CA4457C35C4648BD6B964CEF,30671,14,15,1,109.43611,18.30139,1268
36714,274548,434E56E5CA4457C35C4648BD6B964CEF,39101,18,20,2,109.50132,18.24931,1509
36715,274549,434E56E5CA4457C35C4648BD6B964CEF,30671,22,23,1,109.43611,18.30139,1268
36716,274610,A06676889CF0381DA44072B2A711F6A7,60274,0,1,1,109.514,18.2933,1567
36717,274611,A06676889CF0381DA44072B2A711F6A7,31561,2,23,21,109.56792,18.28479,1765
36721,274665,1DA88ED70B6ADE8EAE3D8F549B029C10,30511,0,6,6,109.51069,18.24208,1558
36722,274666,1DA88ED70B6ADE8EAE3D8F549B029C10,31781,9,13,4,109.19847,18.2975,367
36723,274667,1DA88ED70B6ADE8EAE3D8F549B029C10,30511,15,17,2,109.51069,18.24208,1558
36724,274668,1DA88ED70B6ADE8EAE3D8F549B029C10,60381,17,20,3,109.5241,18.22458,1605
36728,274693,9B389AE8E9B004176803CCEAFF69104A,39371,5,6,1,109.56627,18.2646,1762
36729,274694,9B389AE8E9B004176803CCEAFF69104A,60631,6,17,11,109.57778,18.27583,1814
36730,274733,196A4F506A1293E0132E9D4959EE8DDA,30821,12,15,3,109.43681,18.33639,1274
36731,274734,196A4F506A1293E0132E9D4959EE8DDA,30671,19,23,4,109.43611,18.30139,1268
36732,274753,C17F2EF1DEA79C8C951E3013EE071B2C,31071,0,17,17,109.58257,18.28458,1815
36733,274754,C17F2EF1DEA79C8C951E3013EE071B2C,39371,20,22,2,109.56627,18.2646,1762
36734,274790,1319E1E416A553CAED80375F3946B3EF,60381,0,6,6,109.5241,18.22458,1605
36735,274791,1319E1E416A553CAED80375F3946B3EF,31521,7,8,1,109.51458,18.22542,1555
36736,274792,1319E1E416A553CAED80375F3946B3EF,31471,10,11,1,109.34583,18.29563,917
36737,274793,1319E1E416A553CAED80375F3946B3EF,31521,13,16,3,109.51458,18.22542,1555
36738,274794,1319E1E416A553CAED80375F3946B3EF,30361,18,19,1,109.50347,18.24,1508
36739,274795,1319E1E416A553CAED80375F3946B3EF,31521,20,22,2,109.51458,18.22542,1555
36740,274842,7112BF910BB8852FB892FD72D6683B89,31091,20,22,2,109.41201,18.31222,1170
36741,274923,A7003B7BCC0077E98CD8FD4D16862BCA,30201,0,9,9,109.4909,18.26465,1462
36742,274924,A7003B7BCC0077E98CD8FD4D16862BCA,31071,10,15,5,109.58257,18.28458,1815
36743,274925,A7003B7BCC0077E98CD8FD4D16862BCA,30201,18,23,5,109.4909,18.26465,1462
36744,274970,3E0CC1F431A959DE24ABB41EC7702F6D,31471,14,15,1,109.34583,18.29563,917
36745,274971,3E0CC1F431A959DE24ABB41EC7702F6D,31521,18,20,2,109.51458,18.22542,1555
36746,275002,5664C5FF6B352F96C7620F94430DAC4F,31391,11,13,2,109.50382,18.24285,1508
36747,275003,5664C5FF6B352F96C7620F94430DAC4F,31521,15,19,4,109.51458,18.22542,1555
36748,275004,5664C5FF6B352F96C7620F94430DAC4F,31521,20,22,2,109.51458,18.22542,1555
36749,275060,B25DCC57060B670315CBEB42D31F75A6,30101,0,1,1,109.57299,18.33333,1773
36750,275061,B25DCC57060B670315CBEB42D31F75A6,30941,2,6,4,109.5559,18.33938,1724
36751,275062,B25DCC57060B670315CBEB42D31F75A6,30851,8,13,5,109.5616,18.27396,1713
36752,275063,B25DCC57060B670315CBEB42D31F75A6,31561,13,14,1,109.56792,18.28479,1765
36753,275115,D91408AC1D7CF3270D9A315854454897,30171,0,8,8,109.48458,18.27139,1463
36754,275116,D91408AC1D7CF3270D9A315854454897,60621,12,14,2,109.48354,18.27451,1464
36755,275117,D91408AC1D7CF3270D9A315854454897,38754,14,16,2,109.74667,18.37382,2430
36756,275118,D91408AC1D7CF3270D9A315854454897,30171,18,23,5,109.48458,18.27139,1463
36761,275154,4E8A1FFC680701A862F9A60D8BF0780C,38162,0,9,9,109.43944,18.28889,1266
36762,275155,4E8A1FFC680701A862F9A60D8BF0780C,38162,10,13,3,109.43944,18.28889,1266
36763,275156,4E8A1FFC680701A862F9A60D8BF0780C,30661,13,15,2,109.37028,18.24361,1008
36764,275157,4E8A1FFC680701A862F9A60D8BF0780C,31701,15,17,2,109.44132,18.28833,1266
36765,275158,4E8A1FFC680701A862F9A60D8BF0780C,31701,19,21,2,109.44132,18.28833,1266
36769,275177,108C7DFE87D071FCC11145A73F0120F3,30771,19,20,1,109.49938,18.26042,1511
36770,275186,CD3BCBAB8571FB81953C842A434E5DB8,31071,6,18,12,109.58257,18.28458,1815
36771,275187,CD3BCBAB8571FB81953C842A434E5DB8,30854,18,19,1,109.56889,18.27076,1763
36772,275212,BAAEF1F815128F9C42A2F609EF6E43D2,60121,17,18,1,109.74507,18.37472,2430
36773,275213,BAAEF1F815128F9C42A2F609EF6E43D2,30351,20,21,1,109.41701,18.29292,1217
36774,275214,BAAEF1F815128F9C42A2F609EF6E43D2,31231,21,22,1,109.42597,18.29292,1217
36781,275263,DE758B2869DD8ACD01DE8EB0E9588F18,30181,18,19,1,109.51597,18.23313,1557
36782,275264,DE758B2869DD8ACD01DE8EB0E9588F18,38951,20,21,1,109.48097,18.28868,1416
36783,275298,74A8DA1A239BA74C3424A36505B6E3A6,31561,13,15,2,109.56792,18.28479,1765
36784,275299,74A8DA1A239BA74C3424A36505B6E3A6,31071,16,19,3,109.58257,18.28458,1815
36785,275305,A4DA5512552D5BFC3EBB019661465C3B,31145,11,13,2,109.20431,18.30479,369
36786,275306,A4DA5512552D5BFC3EBB019661465C3B,30354,18,19,1,109.42813,18.29076,1216
36794,275388,0402BD114B7D5E20705E302B756CD062,30854,13,14,1,109.56889,18.27076,1763
36795,275389,0402BD114B7D5E20705E302B756CD062,31071,15,17,2,109.58257,18.28458,1815
36796,275390,0402BD114B7D5E20705E302B756CD062,30854,17,21,4,109.56889,18.27076,1763
36797,275391,6ACF4B90082C2CC5A9221AB0B898A561,60594,0,1,1,109.62694,18.22799,1956
36798,275392,6ACF4B90082C2CC5A9221AB0B898A561,38205,1,6,5,109.62743,18.23139,1956
36799,275393,6ACF4B90082C2CC5A9221AB0B898A561,38331,6,11,5,109.62465,18.22736,1956
36800,275394,6ACF4B90082C2CC5A9221AB0B898A561,60594,14,16,2,109.62694,18.22799,1956
36801,275395,6ACF4B90082C2CC5A9221AB0B898A561,38052,18,21,3,109.62618,18.23042,1956
36802,275400,ACDEAAF45B65DE48CF80A48DBD3C775E,31071,3,7,4,109.58257,18.28458,1815
36803,275401,ACDEAAF45B65DE48CF80A48DBD3C775E,30854,9,23,14,109.56889,18.27076,1763
36804,275417,5EBEA276FCB4A19AC5C987F5C7CC8908,60621,0,6,6,109.48354,18.27451,1464
36805,275418,5EBEA276FCB4A19AC5C987F5C7CC8908,60401,7,9,2,109.47444,18.27583,1414
36806,275419,5EBEA276FCB4A19AC5C987F5C7CC8908,31091,11,12,1,109.41201,18.31222,1170
36807,275420,5EBEA276FCB4A19AC5C987F5C7CC8908,60621,13,14,1,109.48354,18.27451,1464
36808,275421,5EBEA276FCB4A19AC5C987F5C7CC8908,60552,16,19,3,109.41729,18.30014,1218
36809,275422,5EBEA276FCB4A19AC5C987F5C7CC8908,60621,21,23,2,109.48354,18.27451,1464
36813,275441,6B6A1D2EB88367239FCB3C8A121F0BB1,38185,11,17,6,109.51333,18.27347,1563
36814,275448,B032E534C72FB8134F1588648D944A44,30854,6,8,2,109.56889,18.27076,1763
36815,275449,B032E534C72FB8134F1588648D944A44,31321,9,15,6,109.63799,18.23201,2007
36816,275450,B032E534C72FB8134F1588648D944A44,30854,17,23,6,109.56889,18.27076,1763
36817,275451,DB4DF566D4757FF3BB488F82DE126248,30851,17,18,1,109.5616,18.27396,1713
36818,275452,DB4DF566D4757FF3BB488F82DE126248,31561,19,21,2,109.56792,18.28479,1765
36819,275471,16E640D9FA5593E85AD54BDFBAF952D8,60354,1,4,3,109.58701,18.28521,1815
36820,275472,16E640D9FA5593E85AD54BDFBAF952D8,31071,8,18,10,109.58257,18.28458,1815
36821,275473,8F7FB30507503E99C612B652ADC863DC,60381,0,17,17,109.5241,18.22458,1605
36822,275474,8F7FB30507503E99C612B652ADC863DC,60381,19,23,4,109.5241,18.22458,1605
36832,275572,78DAB4F1681085A74E87373143D04310,60491,0,8,8,109.43354,18.30847,1269
36833,275574,78DAB4F1681085A74E87373143D04310,31351,17,23,6,109.4959,18.28417,1465
36834,275587,B8B750E35107FC4FAA74320964E3617F,38105,12,23,11,109.40299,18.29229,1117
36835,275629,82D48250E89BCA3C721CD59BD44DB6FA,60524,5,7,2,109.42951,18.28993,1216
36840,275684,96CDECCC89D571C0B9B785DBB89FDE47,60631,17,18,1,109.57778,18.27583,1814
36841,275685,96CDECCC89D571C0B9B785DBB89FDE47,31071,19,20,1,109.58257,18.28458,1815
36842,275686,96CDECCC89D571C0B9B785DBB89FDE47,30854,20,22,2,109.56889,18.27076,1763
36843,275690,0C8D15C0488D521680F0DE3A28CFE111,30701,8,9,1,109.59313,18.32007,1871
36844,275691,0C8D15C0488D521680F0DE3A28CFE111,31811,9,14,5,109.54201,18.31806,1671
36845,275692,0C8D15C0488D521680F0DE3A28CFE111,30701,14,15,1,109.59313,18.32007,1871
36846,275693,0C8D15C0488D521680F0DE3A28CFE111,31811,19,21,2,109.54201,18.31806,1671
36847,275694,0C8D15C0488D521680F0DE3A28CFE111,30701,21,23,2,109.59313,18.32007,1871
36854,275743,F621296F333E8058687ACD884B135C6E,30504,11,17,6,109.705,18.35368,2277
36855,275744,F621296F333E8058687ACD884B135C6E,31161,18,20,2,109.70229,18.31361,2270
36856,275745,F621296F333E8058687ACD884B135C6E,30504,21,22,1,109.705,18.35368,2277
36857,275773,5A7A3D5F722F0EB2695C45BF16BBC483,38157,19,21,2,109.51483,18.26958,1563
36858,275774,5A7A3D5F722F0EB2695C45BF16BBC483,30181,21,23,2,109.51597,18.23313,1557
36859,275794,895CD60412795FD53135C10CDBA0A9C7,38154,16,23,7,109.5266,18.28278,1615
36860,275824,E292D83051830D054E89D209EEABA4B9,31071,0,11,11,109.58257,18.28458,1815
36861,275825,E292D83051830D054E89D209EEABA4B9,31561,12,20,8,109.56792,18.28479,1765
36862,275826,E292D83051830D054E89D209EEABA4B9,39091,22,23,1,109.50097,18.25222,1510
36863,275830,011859AA130B61CD7FFEFC39AEF2B9BF,31421,0,5,5,109.55382,18.22347,1705
36864,275831,011859AA130B61CD7FFEFC39AEF2B9BF,30821,10,17,7,109.43681,18.33639,1274
36865,275832,011859AA130B61CD7FFEFC39AEF2B9BF,31061,19,22,3,109.53333,18.23257,1607
36866,275844,B4188FCF77E77B10794A61864ECCAF69,60054,13,15,2,109.3016,18.31229,770
36867,275845,B4188FCF77E77B10794A61864ECCAF69,31521,17,20,3,109.51458,18.22542,1555
36868,275850,ABA7F4B04F636C640FBA0888724FEB64,30821,19,20,1,109.43681,18.33639,1274
36869,275851,ABA7F4B04F636C640FBA0888724FEB64,38951,21,23,2,109.48097,18.28868,1416
36874,275867,2627BF82AC8AFCB4B1C5F45FC89B9CF3,39321,0,8,8,109.529,18.2167,1604
36875,275868,2627BF82AC8AFCB4B1C5F45FC89B9CF3,31521,11,12,1,109.51458,18.22542,1555
36876,275869,2627BF82AC8AFCB4B1C5F45FC89B9CF3,39321,12,16,4,109.529,18.2167,1604
36877,275870,2627BF82AC8AFCB4B1C5F45FC89B9CF3,31521,17,19,2,109.51458,18.22542,1555
36878,275871,2627BF82AC8AFCB4B1C5F45FC89B9CF3,60281,20,21,1,109.51743,18.25924,1561
36890,275928,DED64374A4602648AE7C998119F6E01F,60661,0,7,7,109.548,18.2377,1657
36891,275929,DED64374A4602648AE7C998119F6E01F,31421,9,10,1,109.55382,18.22347,1705
36892,275930,DED64374A4602648AE7C998119F6E01F,30921,13,15,2,109.53903,18.29451,1667
36893,275931,DED64374A4602648AE7C998119F6E01F,38261,15,18,3,109.50361,18.28153,1515
36894,275932,DED64374A4602648AE7C998119F6E01F,30771,19,21,2,109.49938,18.26042,1511
36895,275933,DED64374A4602648AE7C998119F6E01F,60661,22,23,1,109.548,18.2377,1657
36906,276031,57CE263B40E830BB46C9423096076F75,30921,0,6,6,109.53903,18.29451,1667
36907,276032,57CE263B40E830BB46C9423096076F75,31931,8,18,10,109.54771,18.29403,1667
36908,276078,070A398F07C013242CC3447B66DFACBF,39183,0,7,7,109.55542,18.28208,1715
36909,276079,070A398F07C013242CC3447B66DFACBF,31931,11,12,1,109.54771,18.29403,1667
36910,276080,070A398F07C013242CC3447B66DFACBF,39183,12,14,2,109.55542,18.28208,1715
36911,276081,070A398F07C013242CC3447B66DFACBF,31931,14,16,2,109.54771,18.29403,1667
36912,276082,070A398F07C013242CC3447B66DFACBF,39183,16,22,6,109.55542,18.28208,1715
36916,276129,C61008F347B09908A052E575D01A92B1,31021,0,7,7,109.49021,18.27,1463
36917,276130,C61008F347B09908A052E575D01A92B1,31471,9,18,9,109.34583,18.29563,917
36918,276131,C61008F347B09908A052E575D01A92B1,31021,20,22,2,109.49021,18.27,1463
36926,276192,451E2BF48CD7B253EB0892324E679BCC,38891,1,2,1,109.51486,18.24118,1558
36927,276193,451E2BF48CD7B253EB0892324E679BCC,38297,3,5,2,109.52576,18.24965,1609
36928,276194,451E2BF48CD7B253EB0892324E679BCC,38291,5,7,2,109.51618,18.24313,1558
36929,276195,451E2BF48CD7B253EB0892324E679BCC,60281,7,12,5,109.51743,18.25924,1561
36930,276196,451E2BF48CD7B253EB0892324E679BCC,38291,13,18,5,109.51618,18.24313,1558
36931,276197,451E2BF48CD7B253EB0892324E679BCC,38297,19,21,2,109.52576,18.24965,1609
36938,276293,89DAB7335E14B8123BE562C22277A7ED,38105,18,20,2,109.40299,18.29229,1117
36939,276294,89DAB7335E14B8123BE562C22277A7ED,60541,21,23,2,109.4084,18.29208,1167
36940,276301,EB86D6046E376669621AB1CCFD0E07BA,31231,0,7,7,109.42597,18.29292,1217
36941,276302,EB86D6046E376669621AB1CCFD0E07BA,60551,9,12,3,109.42722,18.30111,1218
36942,276305,529A14F498129B0238F7B12A9FC7F6F7,31671,0,13,13,109.38965,18.29813,1068
36943,276306,529A14F498129B0238F7B12A9FC7F6F7,30161,15,16,1,109.50042,18.24389,1508
36944,276307,529A14F498129B0238F7B12A9FC7F6F7,31671,17,20,3,109.38965,18.29813,1068
36945,276324,1116E7823ED9EE27945BC1DB58CB088D,31431,0,9,9,109.44639,18.29042,1316
36946,276325,1116E7823ED9EE27945BC1DB58CB088D,33521,10,14,4,109.66313,18.45174,2143
36947,276326,1116E7823ED9EE27945BC1DB58CB088D,31431,18,23,5,109.44639,18.29042,1316
36951,276351,866460FA5062A635337B6369BB2AADDA,38054,14,18,4,109.63479,18.23097,2006
36952,276352,866460FA5062A635337B6369BB2AADDA,30854,19,21,2,109.56889,18.27076,1763
36953,276368,F6A1EBB84FE583E84185C423218578F5,31561,0,5,5,109.56792,18.28479,1765
36954,276369,F6A1EBB84FE583E84185C423218578F5,30854,6,8,2,109.56889,18.27076,1763
36955,276370,F6A1EBB84FE583E84185C423218578F5,39181,9,11,2,109.55153,18.28035,1715
36956,276371,F6A1EBB84FE583E84185C423218578F5,31561,12,13,1,109.56792,18.28479,1765
36957,276372,F6A1EBB84FE583E84185C423218578F5,39183,15,16,1,109.55542,18.28208,1715
36958,276373,F6A1EBB84FE583E84185C423218578F5,30851,19,20,1,109.5616,18.27396,1713
36959,276401,14B1099067687D5FF258F75FE5CF0917,39091,17,18,1,109.50097,18.25222,1510
36960,276402,14B1099067687D5FF258F75FE5CF0917,30771,19,20,1,109.49938,18.26042,1511
36961,276403,14B1099067687D5FF258F75FE5CF0917,31531,21,23,2,109.49583,18.25972,1461
36962,276406,5202825DF51CA068C8B204422480230F,31071,1,17,16,109.58257,18.28458,1815
36963,276407,5202825DF51CA068C8B204422480230F,30854,19,21,2,109.56889,18.27076,1763
36964,276421,B5D5F035B558647FF9F44A76F16A1183,30741,0,13,13,109.49833,18.28681,1516
36965,276422,B5D5F035B558647FF9F44A76F16A1183,39111,17,19,2,109.5191,18.22597,1555
36966,276423,B5D5F035B558647FF9F44A76F16A1183,30151,19,20,1,109.50986,18.25083,1560
36967,276424,B5D5F035B558647FF9F44A76F16A1183,31521,21,23,2,109.51458,18.22542,1555
36968,276427,6A8C883D29A8AF90E102449F92489A64,30854,0,17,17,109.56889,18.27076,1763
36969,276428,6A8C883D29A8AF90E102449F92489A64,60463,19,20,1,109.52507,18.22438,1605
36970,276510,40C57F24FE0409ABB752B2031C349577,30271,0,2,2,109.49132,18.23153,1456
36971,276511,40C57F24FE0409ABB752B2031C349577,38951,4,17,13,109.48097,18.28868,1416
36972,276512,40C57F24FE0409ABB752B2031C349577,60463,20,21,1,109.52507,18.22438,1605
36973,276534,970D6BC437EA1378FAE0DFD7B07AAE0B,30171,13,17,4,109.48458,18.27139,1463
36974,276535,970D6BC437EA1378FAE0DFD7B07AAE0B,30711,20,23,3,109.50271,18.25347,1510
36975,276546,CF90889F587C2BB558DFC8DC65DE1B88,60381,0,2,2,109.5241,18.22458,1605
36976,276547,CF90889F587C2BB558DFC8DC65DE1B88,39331,3,4,1,109.62125,18.22708,1956
36977,276548,CF90889F587C2BB558DFC8DC65DE1B88,31571,4,12,8,109.61563,18.23326,1957
36978,276549,CF90889F587C2BB558DFC8DC65DE1B88,38826,18,19,1,109.50326,18.25514,1510
36979,276550,CF90889F587C2BB558DFC8DC65DE1B88,31461,20,22,2,109.5091,18.25389,1510
36980,276551,CFF5BE3C5C109C874F96B9E9841D39B0,30171,0,18,18,109.48458,18.27139,1463
36981,276552,CFF5BE3C5C109C874F96B9E9841D39B0,30171,20,23,3,109.48458,18.27139,1463
36982,276581,34AB502A442AA8EA4A7FB30471B204DB,38325,0,7,7,109.39792,18.2909,1116
36983,276582,34AB502A442AA8EA4A7FB30471B204DB,38094,10,11,1,109.45403,18.28778,1316
36984,276583,34AB502A442AA8EA4A7FB30471B204DB,38251,12,13,1,109.49618,18.25493,1510
36985,276584,34AB502A442AA8EA4A7FB30471B204DB,30341,14,16,2,109.3625,18.29167,966
36986,276606,4BCFB9B7DA47F954D069C9FF9050BF88,31071,1,2,1,109.58257,18.28458,1815
36987,276607,4BCFB9B7DA47F954D069C9FF9050BF88,60354,3,4,1,109.58701,18.28521,1815
36988,276608,4BCFB9B7DA47F954D069C9FF9050BF88,31071,5,9,4,109.58257,18.28458,1815
36989,276609,4BCFB9B7DA47F954D069C9FF9050BF88,31071,13,14,1,109.58257,18.28458,1815
36990,276610,4BCFB9B7DA47F954D069C9FF9050BF88,31071,15,16,1,109.58257,18.28458,1815
36991,276611,4BCFB9B7DA47F954D069C9FF9050BF88,31071,19,20,1,109.58257,18.28458,1815
36992,276612,6FDD8510FC3FD17D36965B0963BD7329,31561,6,12,6,109.56792,18.28479,1765
36993,276613,6FDD8510FC3FD17D36965B0963BD7329,30854,14,22,8,109.56889,18.27076,1763
36994,276663,B712327B6033C61F37801CFD6DAC08AD,38484,8,11,3,109.53028,18.31528,1620
36995,276664,B712327B6033C61F37801CFD6DAC08AD,38484,14,23,9,109.53028,18.31528,1620
36996,276669,498749BB2BA481D5A422CC677A8DD529,38013,0,8,8,109.49514,18.21951,1454
36997,276670,498749BB2BA481D5A422CC677A8DD529,31301,10,13,3,109.14493,18.31222,170
36998,276671,498749BB2BA481D5A422CC677A8DD529,31471,14,16,2,109.34583,18.29563,917
36999,276672,498749BB2BA481D5A422CC677A8DD529,38013,19,23,4,109.49514,18.21951,1454
37007,276699,8F99FBAD46040867B6C8F52DEFB54488,60541,13,16,3,109.4084,18.29208,1167
37008,276700,8F99FBAD46040867B6C8F52DEFB54488,60621,21,23,2,109.48354,18.27451,1464
37009,276730,6C66825FD2EB35405A0E811EC12F35C8,31101,15,16,1,109.65389,18.23403,2057
37010,276731,6C66825FD2EB35405A0E811EC12F35C8,60221,18,21,3,109.52569,18.29188,1616
37011,276732,6C66825FD2EB35405A0E811EC12F35C8,60381,21,23,2,109.5241,18.22458,1605
37012,276754,06A941D50D485A4C433548955BEB89BA,31071,0,11,11,109.58257,18.28458,1815
37013,276755,06A941D50D485A4C433548955BEB89BA,30854,11,13,2,109.56889,18.27076,1763
37014,276818,40D7A05F2EBEDCC87229F660CD52781C,30201,7,8,1,109.4909,18.26465,1462
37015,276917,B0E2159906E2F066EA26580E9E3FC6C5,39061,1,2,1,109.38222,18.28958,1066
37016,276918,B0E2159906E2F066EA26580E9E3FC6C5,39281,4,5,1,109.21333,18.30271,418
37017,276919,B0E2159906E2F066EA26580E9E3FC6C5,31231,6,8,2,109.42597,18.29292,1217
37018,276920,B0E2159906E2F066EA26580E9E3FC6C5,60054,14,15,1,109.3016,18.31229,770
37019,276921,B0E2159906E2F066EA26580E9E3FC6C5,31231,19,23,4,109.42597,18.29292,1217
37020,276958,30F5D42A1A8F1CF26F5C9617FCB06C4F,31561,14,15,1,109.56792,18.28479,1765
37021,276989,557A975BF2F1D3135462224F08758153,38154,0,5,5,109.5266,18.28278,1615
37022,276990,557A975BF2F1D3135462224F08758153,60221,6,9,3,109.52569,18.29188,1616
37023,276998,501EBB127F6BDBDEA4AD124F9BAA4BCF,31021,19,20,1,109.49021,18.27,1463
37024,276999,501EBB127F6BDBDEA4AD124F9BAA4BCF,30761,21,23,2,109.45201,18.3,1318
37025,277010,F9384ADFDEF6D5E0D88A916FD456608E,60087,2,10,8,109.50688,18.22299,1505
37026,277011,F9384ADFDEF6D5E0D88A916FD456608E,31561,13,14,1,109.56792,18.28479,1765
37027,277012,F9384ADFDEF6D5E0D88A916FD456608E,30341,17,18,1,109.3625,18.29167,966
37028,277013,F9384ADFDEF6D5E0D88A916FD456608E,31091,20,21,1,109.41201,18.31222,1170
37035,277065,42158B50A96F4BB50162AD5AAF8D7E2D,60331,13,15,2,109.505,18.26507,1512
37036,277066,42158B50A96F4BB50162AD5AAF8D7E2D,31521,15,18,3,109.51458,18.22542,1555
37037,277067,42158B50A96F4BB50162AD5AAF8D7E2D,38154,18,21,3,109.5266,18.28278,1615
37038,277068,42158B50A96F4BB50162AD5AAF8D7E2D,31201,21,23,2,109.51042,18.23819,1558
37042,277129,14DC797BA214017EE45D7C82C4CE6C66,60131,16,18,2,109.49819,18.24778,1509
37043,277130,14DC797BA214017EE45D7C82C4CE6C66,38251,18,19,1,109.49618,18.25493,1510
37044,277131,14DC797BA214017EE45D7C82C4CE6C66,60201,20,22,2,109.5041,18.2509,1510
37045,277141,B8D9C92BE7FD5822ED6E8DACDA16E988,38541,10,18,8,109.73715,18.34875,2426
37046,277144,A749E400BFD3B5908671E939EC104DEE,31071,18,19,1,109.58257,18.28458,1815
37047,277145,A749E400BFD3B5908671E939EC104DEE,30854,19,21,2,109.56889,18.27076,1763
37048,277146,4341EB42DEED1649C5A69E1740E9E46C,31841,1,10,9,109.73201,18.33382,2373
37049,277147,4341EB42DEED1649C5A69E1740E9E46C,60381,12,13,1,109.5241,18.22458,1605
37050,277148,4341EB42DEED1649C5A69E1740E9E46C,31471,15,17,2,109.34583,18.29563,917
37051,277149,4341EB42DEED1649C5A69E1740E9E46C,30711,17,19,2,109.50271,18.25347,1510
37052,277150,4341EB42DEED1649C5A69E1740E9E46C,31841,20,23,3,109.73201,18.33382,2373
37053,277151,E4B522EF4348156010E5C578EC13D60F,30854,0,21,21,109.56889,18.27076,1763
37054,277152,E4B522EF4348156010E5C578EC13D60F,30234,22,23,1,109.60681,18.29979,1918
37055,277156,F25102D4BE48A66B8AE50787215C5331,31181,0,8,8,109.50382,18.24813,1509
37056,277157,F25102D4BE48A66B8AE50787215C5331,60291,9,10,1,109.50826,18.24639,1509
37057,277158,F25102D4BE48A66B8AE50787215C5331,31231,14,18,4,109.42597,18.29292,1217
37058,277159,560794A44CA17A43FA34D0FA6C339747,38361,11,13,2,109.43667,18.29201,1267
37059,277160,560794A44CA17A43FA34D0FA6C339747,30651,15,20,5,109.42611,18.385,1232
37060,277161,560794A44CA17A43FA34D0FA6C339747,30821,21,22,1,109.43681,18.33639,1274
37061,277167,E1DB781A629B25793891F8EFD0B2C10F,30661,14,16,2,109.37028,18.24361,1008
37062,277168,E1DB781A629B25793891F8EFD0B2C10F,60411,19,20,1,109.32514,18.30854,869
37070,277184,608A55C14BAB2A5B627ACC1F39B89FB6,31945,0,7,7,109.58021,18.29403,1817
37071,277185,608A55C14BAB2A5B627ACC1F39B89FB6,30854,7,11,4,109.56889,18.27076,1763
37072,277186,608A55C14BAB2A5B627ACC1F39B89FB6,31945,11,13,2,109.58021,18.29403,1817
37073,277187,608A55C14BAB2A5B627ACC1F39B89FB6,30854,18,19,1,109.56889,18.27076,1763
37074,277188,608A55C14BAB2A5B627ACC1F39B89FB6,31945,20,23,3,109.58021,18.29403,1817
37075,277249,10EBF762D28520B09848288F7052CFDE,30854,0,4,4,109.56889,18.27076,1763
37076,277250,10EBF762D28520B09848288F7052CFDE,31181,6,8,2,109.50382,18.24813,1509
37077,277251,10EBF762D28520B09848288F7052CFDE,30161,9,11,2,109.50042,18.24389,1508
37078,277252,10EBF762D28520B09848288F7052CFDE,39101,12,14,2,109.50132,18.24931,1509
37079,277253,10EBF762D28520B09848288F7052CFDE,30161,14,17,3,109.50042,18.24389,1508
37080,277254,10EBF762D28520B09848288F7052CFDE,30854,19,21,2,109.56889,18.27076,1763
37084,277293,938D171E5EAE820A5CCCE591D1AFF213,30791,0,7,7,109.72333,18.40889,2386
37085,277294,938D171E5EAE820A5CCCE591D1AFF213,38325,10,13,3,109.39792,18.2909,1116
37086,277295,938D171E5EAE820A5CCCE591D1AFF213,30681,14,17,3,109.48493,18.26917,1463
37087,277303,0581E9E739979A5820C2704457E52AEA,39321,0,8,8,109.529,18.2167,1604
37088,277304,0581E9E739979A5820C2704457E52AEA,31471,11,13,2,109.34583,18.29563,917
37089,277305,0581E9E739979A5820C2704457E52AEA,60221,15,17,2,109.52569,18.29188,1616
37090,277306,0581E9E739979A5820C2704457E52AEA,30791,21,23,2,109.72333,18.40889,2386
37091,277314,B09F6CB43F7BB3E6391589239BFB1120,38951,0,17,17,109.48097,18.28868,1416
37092,277315,B09F6CB43F7BB3E6391589239BFB1120,30561,20,23,3,109.52778,18.31938,1621
37093,277362,EAA65A180AE9F8A17F71F7EDB51A872E,31431,0,10,10,109.44639,18.29042,1316
37094,277363,EAA65A180AE9F8A17F71F7EDB51A872E,60401,11,12,1,109.47444,18.27583,1414
37095,277364,EAA65A180AE9F8A17F71F7EDB51A872E,31431,13,14,1,109.44639,18.29042,1316
37096,277365,EAA65A180AE9F8A17F71F7EDB51A872E,60621,15,17,2,109.48354,18.27451,1464
37097,277366,EAA65A180AE9F8A17F71F7EDB51A872E,60401,17,23,6,109.47444,18.27583,1414
37098,277378,322BABD023220585A08D0E8C40E27D14,31061,0,5,5,109.53333,18.23257,1607
37099,277379,322BABD023220585A08D0E8C40E27D14,31781,10,13,3,109.19847,18.2975,367
37100,277380,322BABD023220585A08D0E8C40E27D14,30861,18,19,1,109.52722,18.22743,1606
37101,277383,D947329382FD9474122243533197BA56,39154,0,6,6,109.50201,18.25681,1511
37102,277385,B621E9075674E792CCB217233825F9D1,30854,6,8,2,109.56889,18.27076,1763
37103,277386,B621E9075674E792CCB217233825F9D1,31071,11,15,4,109.58257,18.28458,1815
37104,277387,B621E9075674E792CCB217233825F9D1,30854,18,19,1,109.56889,18.27076,1763
37105,277388,B621E9075674E792CCB217233825F9D1,60631,22,23,1,109.57778,18.27583,1814
37106,277455,77F5A37783010C53E376197FE3F1043D,30071,11,12,1,109.52819,18.30472,1619
37107,277456,77F5A37783010C53E376197FE3F1043D,60371,12,13,1,109.53063,18.30056,1618
37108,277458,77F5A37783010C53E376197FE3F1043D,60371,21,22,1,109.53063,18.30056,1618
37115,277489,0F558B6653C655C7F0BAEA9D66B33F57,31071,1,6,5,109.58257,18.28458,1815
37116,277490,0F558B6653C655C7F0BAEA9D66B33F57,30854,7,16,9,109.56889,18.27076,1763
37117,277491,1026894DC5FF9A7FAF3A2EE28B95E239,30232,1,5,4,109.6191,18.31701,1971
37118,277492,1026894DC5FF9A7FAF3A2EE28B95E239,30854,8,16,8,109.56889,18.27076,1763
37119,277493,1026894DC5FF9A7FAF3A2EE28B95E239,60631,20,21,1,109.57778,18.27583,1814
37120,277494,1026894DC5FF9A7FAF3A2EE28B95E239,30854,21,23,2,109.56889,18.27076,1763
37121,277499,43F5AB52A0AF3FEB5880C6DCD16BBA02,60011,0,7,7,109.48965,18.30222,1468
37122,277500,43F5AB52A0AF3FEB5880C6DCD16BBA02,31391,11,14,3,109.50382,18.24285,1508
37123,277501,43F5AB52A0AF3FEB5880C6DCD16BBA02,30191,18,20,2,109.50361,18.22701,1506
37124,277502,43F5AB52A0AF3FEB5880C6DCD16BBA02,60011,21,23,2,109.48965,18.30222,1468
37125,277513,7421066246AAD1C230E7E2A7ADF06E9D,60631,4,7,3,109.57778,18.27583,1814
37126,277514,7421066246AAD1C230E7E2A7ADF06E9D,31071,10,12,2,109.58257,18.28458,1815
37127,277515,7421066246AAD1C230E7E2A7ADF06E9D,60631,12,13,1,109.57778,18.27583,1814
37128,277516,7421066246AAD1C230E7E2A7ADF06E9D,30854,13,19,6,109.56889,18.27076,1763
37129,277517,7421066246AAD1C230E7E2A7ADF06E9D,60631,20,22,2,109.57778,18.27583,1814
37130,277530,A273393D96A2B92B5EC32D0B9DC69E7D,30201,0,7,7,109.4909,18.26465,1462
37131,277531,A273393D96A2B92B5EC32D0B9DC69E7D,30711,7,9,2,109.50271,18.25347,1510
37132,277532,A273393D96A2B92B5EC32D0B9DC69E7D,30711,10,12,2,109.50271,18.25347,1510
37133,277533,A273393D96A2B92B5EC32D0B9DC69E7D,31021,18,19,1,109.49021,18.27,1463
37134,277534,A273393D96A2B92B5EC32D0B9DC69E7D,30084,20,22,2,109.50118,18.26972,1513
37135,277535,A01B4012B619D942E7CC3AC9B78722B4,31561,8,14,6,109.56792,18.28479,1765
37136,277536,A01B4012B619D942E7CC3AC9B78722B4,30854,17,19,2,109.56889,18.27076,1763
37137,277537,A01B4012B619D942E7CC3AC9B78722B4,31561,20,23,3,109.56792,18.28479,1765
37141,277546,C8F6473891EA64CAF71114269800F90A,31521,16,18,2,109.51458,18.22542,1555
37142,277547,C8F6473891EA64CAF71114269800F90A,60381,18,19,1,109.5241,18.22458,1605
37143,277548,C8F6473891EA64CAF71114269800F90A,31521,20,23,3,109.51458,18.22542,1555
37144,277549,417408FFDA93B177641D270D3A5C4B2D,31071,0,15,15,109.58257,18.28458,1815
37145,277550,417408FFDA93B177641D270D3A5C4B2D,30854,16,21,5,109.56889,18.27076,1763
37146,277554,A01E2FD84FFE4D782E40311D1ABC1ECB,39053,0,18,18,109.511,18.2771,1564
37147,277555,A01E2FD84FFE4D782E40311D1ABC1ECB,30741,21,23,2,109.49833,18.28681,1516
37148,277564,B1BCC89C2F3E15CBE4070B0B890371C7,30854,10,15,5,109.56889,18.27076,1763
37149,277565,B1BCC89C2F3E15CBE4070B0B890371C7,31071,19,20,1,109.58257,18.28458,1815
37150,277579,FF2A17822091567D06C9AA731D1A1F17,30901,11,13,2,109.27597,18.3134,670
37151,277580,FF2A17822091567D06C9AA731D1A1F17,30181,16,18,2,109.51597,18.23313,1557
37152,277581,FF2A17822091567D06C9AA731D1A1F17,30361,19,20,1,109.50347,18.24,1508
37153,277582,FF2A17822091567D06C9AA731D1A1F17,30181,22,23,1,109.51597,18.23313,1557
37154,277587,6DA8429267883939CEB3C36824DAAEC3,60524,19,21,2,109.42951,18.28993,1216
37155,277629,F2ED05732C96A4909AC5A9978A02AFD1,38391,0,9,9,109.44111,18.29083,1266
37156,277630,F2ED05732C96A4909AC5A9978A02AFD1,38094,11,12,1,109.45403,18.28778,1316
37157,277631,F2ED05732C96A4909AC5A9978A02AFD1,30361,12,15,3,109.50347,18.24,1508
37158,277632,F2ED05732C96A4909AC5A9978A02AFD1,38361,16,23,7,109.43667,18.29201,1267
37159,277635,A4743972EC2FC58546DD11935BDC0E1A,30711,0,13,13,109.50271,18.25347,1510
37160,277636,A4743972EC2FC58546DD11935BDC0E1A,30771,16,19,3,109.49938,18.26042,1511
37161,277637,A4743972EC2FC58546DD11935BDC0E1A,31091,21,22,1,109.41201,18.31222,1170
37162,277650,B552B11A0B5086873EE9310B7F4CC01D,38361,0,6,6,109.43667,18.29201,1267
37163,277654,B552B11A0B5086873EE9310B7F4CC01D,38361,17,22,5,109.43667,18.29201,1267
37164,277695,393DB76B88CE45729A6014A0A645DD99,31031,18,20,2,109.49979,18.25382,1510
37165,277696,393DB76B88CE45729A6014A0A645DD99,38105,21,22,1,109.40299,18.29229,1117
37166,277724,F4797B2E8271E2F8A6DC8862F6C4C6E7,60087,0,13,13,109.50688,18.22299,1505
37170,277759,BD4652414D5C17466BA36FD4BD943A94,39183,10,11,1,109.55542,18.28208,1715
37171,277760,BD4652414D5C17466BA36FD4BD943A94,31931,11,12,1,109.54771,18.29403,1667
37172,277761,BD4652414D5C17466BA36FD4BD943A94,39183,13,14,1,109.55542,18.28208,1715
37176,277773,59F2738320001FD950F433CB128A2616,30101,0,1,1,109.57299,18.33333,1773
37177,277774,59F2738320001FD950F433CB128A2616,30931,2,5,3,109.55653,18.32722,1722
37178,277775,59F2738320001FD950F433CB128A2616,30809,7,9,2,109.4891,18.28229,1465
37179,277776,59F2738320001FD950F433CB128A2616,38061,10,13,3,109.50597,18.23118,1506
37180,277777,59F2738320001FD950F433CB128A2616,30101,15,17,2,109.57299,18.33333,1773
37181,277778,59F2738320001FD950F433CB128A2616,38251,19,20,1,109.49618,18.25493,1510
37182,277779,59F2738320001FD950F433CB128A2616,30941,22,23,1,109.5559,18.33938,1724
37183,277795,D6B14C7387647D8C883334DAFB518257,30854,17,18,1,109.56889,18.27076,1763
37184,277796,D6B14C7387647D8C883334DAFB518257,31071,19,22,3,109.58257,18.28458,1815
37191,277915,D6CC1FC0E328F94E96D4D1F260DF9F7F,31071,0,2,2,109.58257,18.28458,1815
37192,277916,D6CC1FC0E328F94E96D4D1F260DF9F7F,31071,2,13,11,109.58257,18.28458,1815
37193,277917,D6CC1FC0E328F94E96D4D1F260DF9F7F,31071,13,15,2,109.58257,18.28458,1815
37194,277918,D6CC1FC0E328F94E96D4D1F260DF9F7F,30854,19,20,1,109.56889,18.27076,1763
37195,277919,D6CC1FC0E328F94E96D4D1F260DF9F7F,31071,21,23,2,109.58257,18.28458,1815
37196,277952,410D55EA73A3884577B7B9B7E86B067E,39081,15,17,2,109.19382,18.29111,366
37197,277953,410D55EA73A3884577B7B9B7E86B067E,30084,20,23,3,109.50118,18.26972,1513
37198,277967,D758DCB0CB2E5EA2CADCED24F521A533,31071,0,13,13,109.58257,18.28458,1815
37199,277968,D758DCB0CB2E5EA2CADCED24F521A533,30854,16,18,2,109.56889,18.27076,1763
37200,277999,928DF0385E8541CFD2F5858501C04155,60631,8,9,1,109.57778,18.27583,1814
37201,278000,928DF0385E8541CFD2F5858501C04155,30854,9,11,2,109.56889,18.27076,1763
37208,278071,E16204D131FCD957D5ADB9592C1DD0ED,31071,0,8,8,109.58257,18.28458,1815
37209,278072,E16204D131FCD957D5ADB9592C1DD0ED,30854,11,13,2,109.56889,18.27076,1763
37210,278073,E16204D131FCD957D5ADB9592C1DD0ED,30151,18,20,2,109.50986,18.25083,1560
37211,278074,E16204D131FCD957D5ADB9592C1DD0ED,30211,20,23,3,109.49882,18.23931,1508
37212,278086,95F6D81D9D517084554E43C715595D83,31471,0,19,19,109.34583,18.29563,917
37213,278087,95F6D81D9D517084554E43C715595D83,60411,20,22,2,109.32514,18.30854,869
37214,278088,005F3AEFE6DBF371ED1FD57736434098,31071,0,7,7,109.58257,18.28458,1815
37215,278089,005F3AEFE6DBF371ED1FD57736434098,30854,8,10,2,109.56889,18.27076,1763
37216,278090,005F3AEFE6DBF371ED1FD57736434098,31071,12,14,2,109.58257,18.28458,1815
37217,278091,005F3AEFE6DBF371ED1FD57736434098,30854,14,16,2,109.56889,18.27076,1763
37218,278092,005F3AEFE6DBF371ED1FD57736434098,31071,17,22,5,109.58257,18.28458,1815
37219,278111,FC93BC6360F492734DE9BAEAEC043E73,30661,10,11,1,109.37028,18.24361,1008
37220,278112,FC93BC6360F492734DE9BAEAEC043E73,31145,13,15,2,109.20431,18.30479,369
37221,278113,FC93BC6360F492734DE9BAEAEC043E73,31471,16,18,2,109.34583,18.29563,917
37222,278114,FC93BC6360F492734DE9BAEAEC043E73,38951,21,23,2,109.48097,18.28868,1416
37226,278144,ECCCA5770AD6AA7162B63EC395B55856,39371,9,13,4,109.56627,18.2646,1762
37227,278145,ECCCA5770AD6AA7162B63EC395B55856,30951,13,16,3,109.56208,18.25667,1761
37228,278146,ECCCA5770AD6AA7162B63EC395B55856,60631,18,23,5,109.57778,18.27583,1814
37229,278203,5E97A4561E11AAC4FBC53FD068EAA52B,30854,0,7,7,109.56889,18.27076,1763
37230,278204,5E97A4561E11AAC4FBC53FD068EAA52B,30531,11,19,8,109.53271,18.21472,1604
37231,278205,857151F1A6D20CD5D8628AB5ADDDD79D,38251,19,21,2,109.49618,18.25493,1510
37232,278206,857151F1A6D20CD5D8628AB5ADDDD79D,60401,21,23,2,109.47444,18.27583,1414
37236,278272,B643AC77F8D8498A9694D45BA8B0F75F,60631,0,17,17,109.57778,18.27583,1814
37237,278273,B643AC77F8D8498A9694D45BA8B0F75F,31561,20,21,1,109.56792,18.28479,1765
37238,278281,C7496056C1A6845D1B832CA26FCE640B,31521,0,9,9,109.51458,18.22542,1555
37239,278282,C7496056C1A6845D1B832CA26FCE640B,31471,13,14,1,109.34583,18.29563,917
37240,278283,C7496056C1A6845D1B832CA26FCE640B,31031,19,21,2,109.49979,18.25382,1510
37241,278284,C7496056C1A6845D1B832CA26FCE640B,31521,21,23,2,109.51458,18.22542,1555
37245,278339,E5839D12AB65C96EAE301BA701F1E2D0,48601,0,1,1,109.51694,18.22514,1555
37246,278340,E5839D12AB65C96EAE301BA701F1E2D0,60291,2,7,5,109.50826,18.24639,1509
37247,278341,E5839D12AB65C96EAE301BA701F1E2D0,31521,8,10,2,109.51458,18.22542,1555
37248,278342,E5839D12AB65C96EAE301BA701F1E2D0,31521,11,14,3,109.51458,18.22542,1555
37249,278343,E5839D12AB65C96EAE301BA701F1E2D0,39321,15,16,1,109.529,18.2167,1604
37250,278344,E5839D12AB65C96EAE301BA701F1E2D0,31521,18,19,1,109.51458,18.22542,1555
37251,278345,E5839D12AB65C96EAE301BA701F1E2D0,60291,21,23,2,109.50826,18.24639,1509
37252,278352,9EDC789413D54BDC00C69BCE3615AF7F,60291,14,15,1,109.50826,18.24639,1509
37253,278353,9EDC789413D54BDC00C69BCE3615AF7F,60621,17,23,6,109.48354,18.27451,1464
37257,278414,4995463B780282C9C030A19D9F49AEAC,31071,2,7,5,109.58257,18.28458,1815
37258,278415,4995463B780282C9C030A19D9F49AEAC,30854,7,11,4,109.56889,18.27076,1763
37259,278427,4E94ADAE7ABEB20EEFAF67519DFCC1BE,31081,0,9,9,109.44639,18.30181,1318
37260,278428,4E94ADAE7ABEB20EEFAF67519DFCC1BE,31031,9,22,13,109.49979,18.25382,1510
37261,278491,BD85969D888F94131C562624432FF75B,31071,0,6,6,109.58257,18.28458,1815
37262,278492,BD85969D888F94131C562624432FF75B,30681,8,15,7,109.48493,18.26917,1463
37263,278505,6FBDDF7419820F8908B8A8CE3C81E7C3,60621,0,7,7,109.48354,18.27451,1464
37264,278506,6FBDDF7419820F8908B8A8CE3C81E7C3,31031,9,11,2,109.49979,18.25382,1510
37265,278507,6FBDDF7419820F8908B8A8CE3C81E7C3,30711,12,13,1,109.50271,18.25347,1510
37266,278508,6FBDDF7419820F8908B8A8CE3C81E7C3,60621,14,15,1,109.48354,18.27451,1464
37267,278509,6FBDDF7419820F8908B8A8CE3C81E7C3,60401,16,18,2,109.47444,18.27583,1414
37268,278510,6FBDDF7419820F8908B8A8CE3C81E7C3,60621,21,22,1,109.48354,18.27451,1464
37269,278516,F94EBB0B32E924A93A488CBC5BF180F4,38105,8,9,1,109.40299,18.29229,1117
37270,278517,F94EBB0B32E924A93A488CBC5BF180F4,31781,11,15,4,109.19847,18.2975,367
37271,278518,F94EBB0B32E924A93A488CBC5BF180F4,31471,17,18,1,109.34583,18.29563,917
37272,278519,F94EBB0B32E924A93A488CBC5BF180F4,38105,19,23,4,109.40299,18.29229,1117
37273,278536,F198CAA1F49ACA5D003FD8F8473B3798,31071,17,18,1,109.58257,18.28458,1815
37274,278537,F198CAA1F49ACA5D003FD8F8473B3798,30581,20,22,2,109.62257,18.24951,1959
37279,278609,BB341BA09AFD6F1A65DDB2B3AF49B6CA,30321,14,15,1,109.49563,18.29611,1467
37280,278613,DAB08D254D49BF150533311BD904D49C,38154,11,18,7,109.5266,18.28278,1615
37281,278614,DAB08D254D49BF150533311BD904D49C,30861,21,23,2,109.52722,18.22743,1606
37282,278615,7334BFE245C0E1675EC3C07645407CF3,60411,0,2,2,109.32514,18.30854,869
37283,278616,7334BFE245C0E1675EC3C07645407CF3,30781,2,3,1,109.3275,18.37847,881
37284,278617,7334BFE245C0E1675EC3C07645407CF3,60054,7,16,9,109.3016,18.31229,770
37285,278618,7334BFE245C0E1675EC3C07645407CF3,31121,18,21,3,109.16292,18.37063,230
37286,278619,7334BFE245C0E1675EC3C07645407CF3,31541,22,23,1,109.1809,18.36722,329
37287,278634,1D2F8DB1F8B6A2081E1A43DDF558491D,60361,1,3,2,109.51938,18.29681,1567
37288,278635,1D2F8DB1F8B6A2081E1A43DDF558491D,31951,5,7,2,109.52174,18.30299,1568
37289,278636,1D2F8DB1F8B6A2081E1A43DDF558491D,38484,7,11,4,109.53028,18.31528,1620
37290,278637,1D2F8DB1F8B6A2081E1A43DDF558491D,31951,12,14,2,109.52174,18.30299,1568
37291,278638,1D2F8DB1F8B6A2081E1A43DDF558491D,38484,14,16,2,109.53028,18.31528,1620
37292,278639,1D2F8DB1F8B6A2081E1A43DDF558491D,31951,18,19,1,109.52174,18.30299,1568
37293,278640,1D2F8DB1F8B6A2081E1A43DDF558491D,30561,19,21,2,109.52778,18.31938,1621
37294,278641,1D2F8DB1F8B6A2081E1A43DDF558491D,31951,21,23,2,109.52174,18.30299,1568
37295,278642,8C5A16299A6D294198C90C34C25C5949,31561,16,21,5,109.56792,18.28479,1765
37296,278643,8C5A16299A6D294198C90C34C25C5949,39183,22,23,1,109.55542,18.28208,1715
37297,278651,0526FBDD03CECB7E3925506B4441EC17,30511,0,7,7,109.51069,18.24208,1558
37298,278652,0526FBDD03CECB7E3925506B4441EC17,31443,8,23,15,109.5116,18.24438,1559
37299,278724,0E0D6E55BB1995EBF85F6B7AA8765E55,60631,1,7,6,109.57778,18.27583,1814
37300,278725,0E0D6E55BB1995EBF85F6B7AA8765E55,30854,11,12,1,109.56889,18.27076,1763
37301,278726,0E0D6E55BB1995EBF85F6B7AA8765E55,38271,15,23,8,109.62632,18.23049,1956
37302,278750,C711EA8F4B039EAC279F7CFC24309A8A,60671,10,14,4,109.52979,18.31757,1621
37303,278751,C711EA8F4B039EAC279F7CFC24309A8A,38484,17,20,3,109.53028,18.31528,1620
37311,278832,A1BBC37DD6A282EE85E85B258D490CE4,39111,0,5,5,109.5191,18.22597,1555
37312,278835,A1BBC37DD6A282EE85E85B258D490CE4,31521,17,22,5,109.51458,18.22542,1555
37313,278851,60F8D9AEE01A24B0FD311FB00FA225A2,31521,0,7,7,109.51458,18.22542,1555
37314,278852,60F8D9AEE01A24B0FD311FB00FA225A2,31781,10,13,3,109.19847,18.2975,367
37315,278853,60F8D9AEE01A24B0FD311FB00FA225A2,31471,14,17,3,109.34583,18.29563,917
37316,278854,60F8D9AEE01A24B0FD311FB00FA225A2,38356,19,23,4,109.50201,18.21486,1504
37317,278888,4587E26C00C36D3FE7633B1B02F6A233,31021,9,10,1,109.49021,18.27,1463
37318,278889,4587E26C00C36D3FE7633B1B02F6A233,60121,14,15,1,109.74507,18.37472,2430
37319,278900,C01D7F4C525517694A04D5EAA5AD2420,31931,9,11,2,109.54771,18.29403,1667
37320,278901,C01D7F4C525517694A04D5EAA5AD2420,31071,12,14,2,109.58257,18.28458,1815
37321,278902,C01D7F4C525517694A04D5EAA5AD2420,60291,15,17,2,109.50826,18.24639,1509
37325,278956,49EACD487E1313208F8A679985381860,31554,0,7,7,109.55521,18.2459,1709
37326,278957,49EACD487E1313208F8A679985381860,31471,9,11,2,109.34583,18.29563,917
37327,278958,49EACD487E1313208F8A679985381860,60054,14,16,2,109.3016,18.31229,770
37328,278959,49EACD487E1313208F8A679985381860,30361,17,19,2,109.50347,18.24,1508
37329,278960,49EACD487E1313208F8A679985381860,31554,22,23,1,109.55521,18.2459,1709
37334,278971,8AD9F37216B2D3FCE05CA77434307672,30741,0,8,8,109.49833,18.28681,1516
37335,278972,8AD9F37216B2D3FCE05CA77434307672,31851,11,13,2,109.71736,18.29007,2316
37336,278973,8AD9F37216B2D3FCE05CA77434307672,31201,16,17,1,109.51042,18.23819,1558
37337,278987,D935A999C0CFBD64CC711BE744C4EC5B,30851,0,6,6,109.5616,18.27396,1713
37338,278988,D935A999C0CFBD64CC711BE744C4EC5B,31561,7,8,1,109.56792,18.28479,1765
37339,278989,D935A999C0CFBD64CC711BE744C4EC5B,30854,9,11,2,109.56889,18.27076,1763
37340,278990,D935A999C0CFBD64CC711BE744C4EC5B,31561,12,13,1,109.56792,18.28479,1765
37341,278991,D935A999C0CFBD64CC711BE744C4EC5B,30854,16,23,7,109.56889,18.27076,1763
37345,279023,6E51F1617F5FF00896EFF6196F8A8F96,30854,14,16,2,109.56889,18.27076,1763
37346,279024,6E51F1617F5FF00896EFF6196F8A8F96,39111,19,20,1,109.5191,18.22597,1555
37347,279029,F4D649C785503C88909B23FA300C31B8,38251,0,8,8,109.49618,18.25493,1510
37348,279030,F4D649C785503C88909B23FA300C31B8,30421,8,10,2,109.50021,18.25861,1511
37349,279031,F4D649C785503C88909B23FA300C31B8,31471,12,15,3,109.34583,18.29563,917
37350,279032,F4D649C785503C88909B23FA300C31B8,31471,15,16,1,109.34583,18.29563,917
37351,279033,F4D649C785503C88909B23FA300C31B8,38251,18,23,5,109.49618,18.25493,1510
37355,279055,CFCFA94681CDD57855D6405C244168DD,31171,2,6,4,109.50938,18.24917,1559
37356,279056,CFCFA94681CDD57855D6405C244168DD,38291,7,9,2,109.51618,18.24313,1558
37357,279057,CFCFA94681CDD57855D6405C244168DD,31821,10,11,1,109.51181,18.24924,1559
37358,279058,CFCFA94681CDD57855D6405C244168DD,38891,12,13,1,109.51486,18.24118,1558
37359,279059,CFCFA94681CDD57855D6405C244168DD,31821,14,15,1,109.51181,18.24924,1559
37364,279219,D334753E33AD01D79142036B3D85543F,31561,0,5,5,109.56792,18.28479,1765
37365,279220,D334753E33AD01D79142036B3D85543F,39183,5,11,6,109.55542,18.28208,1715
37366,279221,D334753E33AD01D79142036B3D85543F,39181,11,13,2,109.55153,18.28035,1715
37367,279222,D334753E33AD01D79142036B3D85543F,31931,15,16,1,109.54771,18.29403,1667
37368,279223,D334753E33AD01D79142036B3D85543F,31561,18,20,2,109.56792,18.28479,1765
37369,279291,B6DD27E1160E459E8CDB23CF1876B6FF,31521,0,9,9,109.51458,18.22542,1555
37370,279292,B6DD27E1160E459E8CDB23CF1876B6FF,31145,12,15,3,109.20431,18.30479,369
37371,279293,B6DD27E1160E459E8CDB23CF1876B6FF,31471,16,17,1,109.34583,18.29563,917
37372,279294,B6DD27E1160E459E8CDB23CF1876B6FF,31521,18,23,5,109.51458,18.22542,1555
37373,279301,AAD8B0E06D1E8C325CD7644E091AFB91,38951,0,1,1,109.48097,18.28868,1416
37374,279302,AAD8B0E06D1E8C325CD7644E091AFB91,60614,1,2,1,109.48799,18.29521,1467
37375,279303,AAD8B0E06D1E8C325CD7644E091AFB91,60501,3,4,1,109.48701,18.29021,1466
37376,279304,AAD8B0E06D1E8C325CD7644E091AFB91,60614,5,6,1,109.48799,18.29521,1467
37377,279305,AAD8B0E06D1E8C325CD7644E091AFB91,31471,15,17,2,109.34583,18.29563,917
37378,279306,AAD8B0E06D1E8C325CD7644E091AFB91,38951,18,19,1,109.48097,18.28868,1416
37379,279307,AAD8B0E06D1E8C325CD7644E091AFB91,60614,19,22,3,109.48799,18.29521,1467
37380,279320,A9FCE0049DB44FE004EAFBF5B783F4A5,31071,16,17,1,109.58257,18.28458,1815
37381,279321,A9FCE0049DB44FE004EAFBF5B783F4A5,30854,20,21,1,109.56889,18.27076,1763
37382,279343,DB14C9E7FB70D7116D1FEE61561A3142,60631,15,17,2,109.57778,18.27583,1814
37383,279344,DB14C9E7FB70D7116D1FEE61561A3142,30854,19,20,1,109.56889,18.27076,1763
37384,279345,DB14C9E7FB70D7116D1FEE61561A3142,60354,20,21,1,109.58701,18.28521,1815
37385,279379,84DF4A7C208235D171EF56473BCCF210,31561,3,7,4,109.56792,18.28479,1765
37386,279380,84DF4A7C208235D171EF56473BCCF210,60631,7,9,2,109.57778,18.27583,1814
37387,279381,84DF4A7C208235D171EF56473BCCF210,30854,9,11,2,109.56889,18.27076,1763
37388,279382,84DF4A7C208235D171EF56473BCCF210,60631,12,18,6,109.57778,18.27583,1814
37389,279383,84DF4A7C208235D171EF56473BCCF210,30851,19,20,1,109.5616,18.27396,1713
37390,279384,84DF4A7C208235D171EF56473BCCF210,31561,20,21,1,109.56792,18.28479,1765
37391,279392,3B7F4B71C655A8575FEAE798DEE249A5,39111,0,9,9,109.5191,18.22597,1555
37392,279395,4DBE6D3EE4B80975CED7345951A18A8D,30854,11,15,4,109.56889,18.27076,1763
37393,279396,4DBE6D3EE4B80975CED7345951A18A8D,31071,15,17,2,109.58257,18.28458,1815
37394,279397,4DBE6D3EE4B80975CED7345951A18A8D,30854,17,19,2,109.56889,18.27076,1763
37395,279414,E4D199FCE009427481C9D06B9609AB1E,31931,0,8,8,109.54771,18.29403,1667
37396,279415,E4D199FCE009427481C9D06B9609AB1E,38071,11,12,1,109.40722,18.30938,1169
37397,279497,F6B0C4B9BFBC5C0F5D704098C64B8B01,30711,8,11,3,109.50271,18.25347,1510
37398,279499,15C58AA4098F7C3C06247EBC0EBAF235,39321,0,5,5,109.529,18.2167,1604
37399,279500,15C58AA4098F7C3C06247EBC0EBAF235,31521,6,8,2,109.51458,18.22542,1555
37400,279501,15C58AA4098F7C3C06247EBC0EBAF235,33521,11,12,1,109.66313,18.45174,2143
37401,279502,15C58AA4098F7C3C06247EBC0EBAF235,33051,13,16,3,109.6475,18.46618,2096
37402,279503,15C58AA4098F7C3C06247EBC0EBAF235,60381,21,23,2,109.5241,18.22458,1605
37403,279511,567BF1868FBA42FA9B3B29F2CA13F65D,30921,17,18,1,109.53903,18.29451,1667
37404,279512,567BF1868FBA42FA9B3B29F2CA13F65D,31071,18,20,2,109.58257,18.28458,1815
37405,279524,C686C13CC75583538BBABD5B7A2CA987,39371,10,11,1,109.56627,18.2646,1762
37406,279525,C686C13CC75583538BBABD5B7A2CA987,31071,11,23,12,109.58257,18.28458,1815
37407,279537,FCE452D1ADC1B5F3882EFE5D0EEFA0EE,31181,11,13,2,109.50382,18.24813,1509
37408,279538,FCE452D1ADC1B5F3882EFE5D0EEFA0EE,31145,15,17,2,109.20431,18.30479,369
37409,279539,FCE452D1ADC1B5F3882EFE5D0EEFA0EE,31421,19,20,1,109.55382,18.22347,1705
37410,279545,934029FB5F97BCE114EDCE88F0393A63,39371,0,6,6,109.56627,18.2646,1762
37411,279546,934029FB5F97BCE114EDCE88F0393A63,30854,7,10,3,109.56889,18.27076,1763
37412,279556,335A7B1DE8538918FDA774EE3E402A76,30191,0,7,7,109.50361,18.22701,1506
37413,279557,335A7B1DE8538918FDA774EE3E402A76,60381,8,10,2,109.5241,18.22458,1605
37414,279558,335A7B1DE8538918FDA774EE3E402A76,33481,12,14,2,109.67278,18.41278,2187
37415,279559,335A7B1DE8538918FDA774EE3E402A76,33521,15,17,2,109.66313,18.45174,2143
37416,279560,335A7B1DE8538918FDA774EE3E402A76,30191,19,23,4,109.50361,18.22701,1506
37423,279608,AA17C9279A63248D7DCDF49F93EB8817,31071,1,6,5,109.58257,18.28458,1815
37424,279609,AA17C9279A63248D7DCDF49F93EB8817,38275,8,17,9,109.62875,18.22938,2006
37428,279644,B93185B4820D7E0DEE74EBEA00941D15,38291,0,1,1,109.51618,18.24313,1558
37429,279645,B93185B4820D7E0DEE74EBEA00941D15,60201,3,4,1,109.5041,18.2509,1510
37430,279646,B93185B4820D7E0DEE74EBEA00941D15,30911,4,14,10,109.50493,18.26181,1511
37431,279647,B93185B4820D7E0DEE74EBEA00941D15,60201,15,18,3,109.5041,18.2509,1510
37432,279648,B93185B4820D7E0DEE74EBEA00941D15,38291,20,23,3,109.51618,18.24313,1558
37433,279680,53490AD77ACCA93C3ED0F3DE79CA488B,31071,8,16,8,109.58257,18.28458,1815
37434,279681,53490AD77ACCA93C3ED0F3DE79CA488B,30854,20,21,1,109.56889,18.27076,1763
37435,279688,6E2021B014C4D0B652A2E4FE8D2CF038,30854,0,1,1,109.56889,18.27076,1763
37436,279689,6E2021B014C4D0B652A2E4FE8D2CF038,31071,1,7,6,109.58257,18.28458,1815
37437,279690,6E2021B014C4D0B652A2E4FE8D2CF038,30854,9,10,1,109.56889,18.27076,1763
37438,279691,6E2021B014C4D0B652A2E4FE8D2CF038,31071,12,14,2,109.58257,18.28458,1815
37439,279692,6E2021B014C4D0B652A2E4FE8D2CF038,30854,17,19,2,109.56889,18.27076,1763
37440,279693,C173E680DFAEC165B5B7AE7346539D93,31391,16,17,1,109.50382,18.24285,1508
37441,279694,C173E680DFAEC165B5B7AE7346539D93,38891,18,23,5,109.51486,18.24118,1558
37454,279809,7B9D64657CE26DF907B4C2AC87C9F431,38241,8,9,1,109.54111,18.30542,1669
37455,279810,7B9D64657CE26DF907B4C2AC87C9F431,60371,10,11,1,109.53063,18.30056,1618
37456,279811,7B9D64657CE26DF907B4C2AC87C9F431,38241,14,16,2,109.54111,18.30542,1669
37457,279853,C82725A09C032EE9BFF2088FCCC60D1D,30854,6,8,2,109.56889,18.27076,1763
37458,279854,C82725A09C032EE9BFF2088FCCC60D1D,31521,8,9,1,109.51458,18.22542,1555
37459,279855,C82725A09C032EE9BFF2088FCCC60D1D,30854,11,14,3,109.56889,18.27076,1763
37460,279868,DBB710D279E76C79F1E4B0766F579F8A,30854,9,10,1,109.56889,18.27076,1763
37461,279869,DBB710D279E76C79F1E4B0766F579F8A,31071,13,23,10,109.58257,18.28458,1815
37462,279872,B80D4B4CDBD08237A9C4254F8883AEF4,39151,0,7,7,109.49875,18.25097,1510
37463,279873,B80D4B4CDBD08237A9C4254F8883AEF4,31181,7,11,4,109.50382,18.24813,1509
37464,279874,B80D4B4CDBD08237A9C4254F8883AEF4,30711,12,14,2,109.50271,18.25347,1510
37465,279875,B80D4B4CDBD08237A9C4254F8883AEF4,60201,15,16,1,109.5041,18.2509,1510
37466,279876,B80D4B4CDBD08237A9C4254F8883AEF4,39091,18,23,5,109.50097,18.25222,1510
37467,279877,38AA3DA5E97F70E8689E8DE10EE9EB59,30854,7,12,5,109.56889,18.27076,1763
37468,279878,38AA3DA5E97F70E8689E8DE10EE9EB59,31945,14,17,3,109.58021,18.29403,1817
37469,279879,38AA3DA5E97F70E8689E8DE10EE9EB59,30854,20,23,3,109.56889,18.27076,1763
37470,279911,D95857AB08B8205E4E31CF5D3302E306,30271,3,7,4,109.49132,18.23153,1456
37471,279912,D95857AB08B8205E4E31CF5D3302E306,60084,8,9,1,109.4984,18.2334,1507
37472,279913,D95857AB08B8205E4E31CF5D3302E306,38251,10,12,2,109.49618,18.25493,1510
37473,279914,D95857AB08B8205E4E31CF5D3302E306,60071,15,19,4,109.75674,18.31583,2470
37477,279939,78DA7A4E680FDAB27461B8DE1108145A,30854,0,21,21,109.56889,18.27076,1763
37478,279940,78DA7A4E680FDAB27461B8DE1108145A,31071,21,23,2,109.58257,18.28458,1815
37479,279948,99CBAA6A65A50998F0A10B72B36210E4,60231,7,9,2,109.49903,18.21972,1504
37480,279949,99CBAA6A65A50998F0A10B72B36210E4,30341,10,11,1,109.3625,18.29167,966
37481,279950,99CBAA6A65A50998F0A10B72B36210E4,60041,14,17,3,109.39889,18.31944,1121
37482,279951,99CBAA6A65A50998F0A10B72B36210E4,60201,18,22,4,109.5041,18.2509,1510
37483,279967,0BABF9C6516F437130A3DD3C99553A57,30191,0,1,1,109.50361,18.22701,1506
37484,279968,0BABF9C6516F437130A3DD3C99553A57,39191,3,6,3,109.51493,18.23472,1557
37485,279969,0BABF9C6516F437130A3DD3C99553A57,31851,7,11,4,109.71736,18.29007,2316
37486,279970,0BABF9C6516F437130A3DD3C99553A57,30191,15,17,2,109.50361,18.22701,1506
37487,279971,0BABF9C6516F437130A3DD3C99553A57,31206,19,20,1,109.50819,18.23549,1507
37488,279972,0BABF9C6516F437130A3DD3C99553A57,30191,21,22,1,109.50361,18.22701,1506
37489,279979,6D59153C60FD30D1B86A6E3DE6A2B731,30211,2,6,4,109.49882,18.23931,1508
37490,279980,6D59153C60FD30D1B86A6E3DE6A2B731,60087,8,9,1,109.50688,18.22299,1505
37491,279981,6D59153C60FD30D1B86A6E3DE6A2B731,31561,13,14,1,109.56792,18.28479,1765
37492,279982,7EBC20D0E5F0FBA046CA1D08E7FF47C1,31071,0,6,6,109.58257,18.28458,1815
37493,279983,7EBC20D0E5F0FBA046CA1D08E7FF47C1,30854,6,9,3,109.56889,18.27076,1763
37494,279984,7EBC20D0E5F0FBA046CA1D08E7FF47C1,31071,12,14,2,109.58257,18.28458,1815
37495,279985,7EBC20D0E5F0FBA046CA1D08E7FF47C1,30581,16,17,1,109.62257,18.24951,1959
37496,279986,7EBC20D0E5F0FBA046CA1D08E7FF47C1,30854,19,21,2,109.56889,18.27076,1763
37497,280018,37D38EF0062E64D55C94EB554B76F9EE,31071,0,8,8,109.58257,18.28458,1815
37498,280019,37D38EF0062E64D55C94EB554B76F9EE,30854,8,23,15,109.56889,18.27076,1763
37502,280166,11B810B77549CA863BF41D81AAB3E82B,60401,0,8,8,109.47444,18.27583,1414
37503,280188,A8E9C7BB918ADAD29A3EA7ACDDCD32D7,38951,0,2,2,109.48097,18.28868,1416
37504,280189,A8E9C7BB918ADAD29A3EA7ACDDCD32D7,38951,3,18,15,109.48097,18.28868,1416
37505,280190,A8E9C7BB918ADAD29A3EA7ACDDCD32D7,30861,19,20,1,109.52722,18.22743,1606
37506,280198,B94CAA0ECFBC84DF79E5B155C990F760,31271,0,9,9,109.48958,18.26257,1462
37507,280199,B94CAA0ECFBC84DF79E5B155C990F760,31471,13,15,2,109.34583,18.29563,917
37508,280200,B94CAA0ECFBC84DF79E5B155C990F760,31303,17,23,6,109.15826,18.29549,217
37509,280224,E30A5D65C08FB9F85452AA0B30BB2A1B,31021,19,20,1,109.49021,18.27,1463
37510,280230,1980C8D409DE9551539224B3D393CDAA,38991,1,5,4,109.52681,18.30368,1618
37511,280231,1980C8D409DE9551539224B3D393CDAA,30071,5,22,17,109.52819,18.30472,1619
37512,280275,BEE3A0C9BB09D7F210E3490BED90A1BE,30071,0,4,4,109.52819,18.30472,1619
37513,280276,BEE3A0C9BB09D7F210E3490BED90A1BE,30071,6,8,2,109.52819,18.30472,1619
37514,280277,BEE3A0C9BB09D7F210E3490BED90A1BE,30071,9,11,2,109.52819,18.30472,1619
37515,280278,BEE3A0C9BB09D7F210E3490BED90A1BE,30071,14,18,4,109.52819,18.30472,1619
37516,280279,BEE3A0C9BB09D7F210E3490BED90A1BE,60371,19,23,4,109.53063,18.30056,1618
37517,280280,D9AE11CD16B231308C3F0FB3F53BC3E9,30854,0,8,8,109.56889,18.27076,1763
37518,280281,D9AE11CD16B231308C3F0FB3F53BC3E9,31071,9,17,8,109.58257,18.28458,1815
37519,280332,D61883A9E0C7F2103C981F95E51C66DA,31931,0,6,6,109.54771,18.29403,1667
37520,280333,D61883A9E0C7F2103C981F95E51C66DA,60361,10,11,1,109.51938,18.29681,1567
37521,280334,D61883A9E0C7F2103C981F95E51C66DA,39111,15,16,1,109.5191,18.22597,1555
37522,280373,F71722F47AD55D7027753836DB5E58AA,38361,0,10,10,109.43667,18.29201,1267
37523,280374,F71722F47AD55D7027753836DB5E58AA,31471,13,15,2,109.34583,18.29563,917
37524,280375,F71722F47AD55D7027753836DB5E58AA,60054,16,17,1,109.3016,18.31229,770
37525,280376,F71722F47AD55D7027753836DB5E58AA,38541,18,23,5,109.73715,18.34875,2426
37530,280474,DC9973204E62AA99FA79F0696CF6C0F6,30854,0,2,2,109.56889,18.27076,1763
37531,280475,DC9973204E62AA99FA79F0696CF6C0F6,31945,5,13,8,109.58021,18.29403,1817
37532,280478,C983E73D646629A775690ECA8920EB29,30101,0,12,12,109.57299,18.33333,1773
37533,280479,C983E73D646629A775690ECA8920EB29,31631,16,17,1,109.59542,18.36826,1879
37534,280492,6ABF30CD5F14455AA21662324DAC8186,30854,12,14,2,109.56889,18.27076,1763
37535,280493,6ABF30CD5F14455AA21662324DAC8186,31561,14,20,6,109.56792,18.28479,1765
37536,280524,3EAE2CCEF780CC2E20C47963EA2CF3C6,30854,4,11,7,109.56889,18.27076,1763
37537,280525,3EAE2CCEF780CC2E20C47963EA2CF3C6,31561,13,23,10,109.56792,18.28479,1765
37538,280538,8FE97C1052D63DE830211C405D8F5442,39371,0,6,6,109.56627,18.2646,1762
37539,280539,8FE97C1052D63DE830211C405D8F5442,31811,9,10,1,109.54201,18.31806,1671
37540,280540,8FE97C1052D63DE830211C405D8F5442,30854,13,18,5,109.56889,18.27076,1763
37541,280541,8FE97C1052D63DE830211C405D8F5442,39371,21,23,2,109.56627,18.2646,1762
37542,280585,862ABFF94AA90A202FB7D5A132150A1A,31071,0,7,7,109.58257,18.28458,1815
37543,280586,862ABFF94AA90A202FB7D5A132150A1A,30854,8,19,11,109.56889,18.27076,1763
37547,280616,9AA959ED87D1ECC3053DED17290EFCBD,30854,8,9,1,109.56889,18.27076,1763
37548,280617,9AA959ED87D1ECC3053DED17290EFCBD,31561,10,21,11,109.56792,18.28479,1765
37549,280622,FA724E83D7D22E41E07D0D2550D22166,30854,17,19,2,109.56889,18.27076,1763
37550,280623,FA724E83D7D22E41E07D0D2550D22166,31071,19,23,4,109.58257,18.28458,1815
37551,280648,D96E01B8E0F0DE9C160C9FEAFDCFDB6D,31071,0,7,7,109.58257,18.28458,1815
37552,280649,D96E01B8E0F0DE9C160C9FEAFDCFDB6D,30854,11,19,8,109.56889,18.27076,1763
37553,280660,CAC8A9D21C7176251B3072CE71D74BA9,30271,0,5,5,109.49132,18.23153,1456
37554,280661,CAC8A9D21C7176251B3072CE71D74BA9,60131,7,8,1,109.49819,18.24778,1509
37555,280662,CAC8A9D21C7176251B3072CE71D74BA9,60431,12,13,1,109.46139,18.32861,1373
37559,280676,9810DB6C60BA19785429412C731D49C0,30854,0,19,19,109.56889,18.27076,1763
37560,280677,9810DB6C60BA19785429412C731D49C0,31071,21,22,1,109.58257,18.28458,1815
37565,280755,40285EE8CCE25C38988EC087545664EC,31071,0,7,7,109.58257,18.28458,1815
37566,280756,40285EE8CCE25C38988EC087545664EC,30854,7,9,2,109.56889,18.27076,1763
37567,280757,40285EE8CCE25C38988EC087545664EC,31071,9,10,1,109.58257,18.28458,1815
37568,280758,40285EE8CCE25C38988EC087545664EC,30854,10,15,5,109.56889,18.27076,1763
37569,280759,40285EE8CCE25C38988EC087545664EC,31071,15,16,1,109.58257,18.28458,1815
37570,280760,40285EE8CCE25C38988EC087545664EC,30854,18,21,3,109.56889,18.27076,1763
37571,280794,249377E34AC170BF7177181444C7805B,60341,0,8,8,109.70597,18.31778,2271
37572,280795,249377E34AC170BF7177181444C7805B,60054,9,12,3,109.3016,18.31229,770
37573,280796,249377E34AC170BF7177181444C7805B,30901,12,13,1,109.27597,18.3134,670
37577,280855,84599FEEE94509A3E8D44F4C45C7CC01,31671,0,15,15,109.38965,18.29813,1068
37578,280856,84599FEEE94509A3E8D44F4C45C7CC01,60541,20,22,2,109.4084,18.29208,1167
37579,280885,124E60C0315346A1F7A9CD897F13605E,31521,17,18,1,109.51458,18.22542,1555
37580,280886,124E60C0315346A1F7A9CD897F13605E,31521,21,23,2,109.51458,18.22542,1555
37584,280898,2B60907F04C29DE058B3E64B1D3B4100,31561,0,9,9,109.56792,18.28479,1765
37585,280899,2B60907F04C29DE058B3E64B1D3B4100,39371,13,15,2,109.56627,18.2646,1762
37586,280900,2B60907F04C29DE058B3E64B1D3B4100,38283,17,18,1,109.62229,18.22618,1956
37587,280901,2B60907F04C29DE058B3E64B1D3B4100,31561,19,20,1,109.56792,18.28479,1765
37588,280902,2B60907F04C29DE058B3E64B1D3B4100,30854,20,23,3,109.56889,18.27076,1763
37589,280924,51DF765CB634D9549D20AD1F2C37BA18,31561,1,14,13,109.56792,18.28479,1765
37590,280925,51DF765CB634D9549D20AD1F2C37BA18,30854,18,19,1,109.56889,18.27076,1763
37598,281010,31C925B9876FE9FFC3F673B5040150FB,31521,0,8,8,109.51458,18.22542,1555
37599,281011,31C925B9876FE9FFC3F673B5040150FB,31471,13,14,1,109.34583,18.29563,917
37600,281012,31C925B9876FE9FFC3F673B5040150FB,31521,16,22,6,109.51458,18.22542,1555
37608,281052,79FD298D94ED606250C160861575CD8F,31554,7,15,8,109.55521,18.2459,1709
37609,281053,79FD298D94ED606250C160861575CD8F,31551,18,19,1,109.55868,18.24222,1708
37614,281090,E75CF54BA14775FEDD26504F9F6B7365,31945,0,5,5,109.58021,18.29403,1817
37615,281091,E75CF54BA14775FEDD26504F9F6B7365,31561,6,14,8,109.56792,18.28479,1765
37623,281128,606A622509E00F87640F50B01432E04D,31521,9,10,1,109.51458,18.22542,1555
37624,281129,606A622509E00F87640F50B01432E04D,30361,13,14,1,109.50347,18.24,1508
37625,281130,606A622509E00F87640F50B01432E04D,31521,15,16,1,109.51458,18.22542,1555
37626,281131,606A622509E00F87640F50B01432E04D,60381,17,18,1,109.5241,18.22458,1605
37627,281132,606A622509E00F87640F50B01432E04D,31521,18,20,2,109.51458,18.22542,1555
37631,281206,2AE38FAF341950B0B91404FFCE5A0F3E,30921,11,17,6,109.53903,18.29451,1667
37632,281207,2AE38FAF341950B0B91404FFCE5A0F3E,31931,21,23,2,109.54771,18.29403,1667
37633,281218,39F25FE146A03325C93C111F2A943B6C,31945,2,7,5,109.58021,18.29403,1817
37634,281219,39F25FE146A03325C93C111F2A943B6C,30854,11,19,8,109.56889,18.27076,1763
37635,281241,D8917A2A43EA8070EEC2FA46A7C72FE1,31491,12,13,1,109.73042,18.38771,2382
37636,281242,D8917A2A43EA8070EEC2FA46A7C72FE1,30711,15,18,3,109.50271,18.25347,1510
37637,281243,D8917A2A43EA8070EEC2FA46A7C72FE1,30504,20,23,3,109.705,18.35368,2277
37638,281292,4E5E7B62F697D24D87C90994BD547EC8,38271,0,1,1,109.62632,18.23049,1956
37639,281293,4E5E7B62F697D24D87C90994BD547EC8,30281,2,9,7,109.50597,18.27583,1514
37640,281294,4E5E7B62F697D24D87C90994BD547EC8,38171,9,14,5,109.50799,18.28139,1515
37641,281295,4E5E7B62F697D24D87C90994BD547EC8,31321,15,18,3,109.63799,18.23201,2007
37642,281296,4E5E7B62F697D24D87C90994BD547EC8,60114,19,21,2,109.73028,18.33847,2374
37643,281300,CFA6DB42B4EA79576A8AEA8F93765E81,38157,15,17,2,109.51483,18.26958,1563
37644,281301,CFA6DB42B4EA79576A8AEA8F93765E81,60087,21,23,2,109.50688,18.22299,1505
37649,281308,0874ECC8591FCEC6749163A25CC3B800,60411,2,5,3,109.32514,18.30854,869
37650,281309,0874ECC8591FCEC6749163A25CC3B800,31471,5,7,2,109.34583,18.29563,917
37651,281310,0874ECC8591FCEC6749163A25CC3B800,60411,7,9,2,109.32514,18.30854,869
37652,281311,0874ECC8591FCEC6749163A25CC3B800,31421,12,13,1,109.55382,18.22347,1705
37660,281340,B8B175F9D4B3A6BE919C03568EC254A7,31723,0,6,6,109.68563,18.23701,2207
37661,281341,B8B175F9D4B3A6BE919C03568EC254A7,30851,8,10,2,109.5616,18.27396,1713
37662,281342,B8B175F9D4B3A6BE919C03568EC254A7,31723,11,22,11,109.68563,18.23701,2207
37663,281354,BA78AAC2FD072EDBC38E967C688E8581,60411,19,21,2,109.32514,18.30854,869
37664,281355,BA78AAC2FD072EDBC38E967C688E8581,30661,22,23,1,109.37028,18.24361,1008
37665,281356,DA2F61DF800F83BE374E7E95B728C1BC,30351,15,16,1,109.41701,18.29292,1217
37666,281357,DA2F61DF800F83BE374E7E95B728C1BC,38094,17,18,1,109.45403,18.28778,1316
37667,281358,DA2F61DF800F83BE374E7E95B728C1BC,30711,18,20,2,109.50271,18.25347,1510
37668,281359,DA2F61DF800F83BE374E7E95B728C1BC,38094,21,23,2,109.45403,18.28778,1316
37669,281426,B61EF3A2FA8CFF664D5D7045557B11B7,31701,15,16,1,109.44132,18.28833,1266
37670,281427,B61EF3A2FA8CFF664D5D7045557B11B7,30671,17,18,1,109.43611,18.30139,1268
37671,281428,B61EF3A2FA8CFF664D5D7045557B11B7,31701,22,23,1,109.44132,18.28833,1266
37672,281489,67CDBD95CEB6CBFC8E0EE012353E074B,30854,9,15,6,109.56889,18.27076,1763
37673,281490,67CDBD95CEB6CBFC8E0EE012353E074B,30851,16,17,1,109.5616,18.27396,1713
37674,281491,67CDBD95CEB6CBFC8E0EE012353E074B,31071,19,21,2,109.58257,18.28458,1815
37678,281503,1D60D001EBDC67D77E1C6037DB507422,31561,0,8,8,109.56792,18.28479,1765
37679,281504,1D60D001EBDC67D77E1C6037DB507422,30854,8,22,14,109.56889,18.27076,1763
37680,281521,2C7DB696A14A5E061C2912E5376233C9,31071,12,16,4,109.58257,18.28458,1815
37681,281522,2C7DB696A14A5E061C2912E5376233C9,31071,16,19,3,109.58257,18.28458,1815
37682,281527,A5E7142EDB2C00D2F56F81D099876FCF,31851,7,8,1,109.71736,18.29007,2316
37683,281528,A5E7142EDB2C00D2F56F81D099876FCF,38754,12,13,1,109.74667,18.37382,2430
37687,281625,7F220C28A0C617E581A7723B6384F4CD,38275,13,14,1,109.62875,18.22938,2006
37688,281626,7F220C28A0C617E581A7723B6384F4CD,31101,18,23,5,109.65389,18.23403,2057
37689,281764,1D8B814EC83D52D7C5F3FED99C129EE0,30854,2,5,3,109.56889,18.27076,1763
37690,281765,1D8B814EC83D52D7C5F3FED99C129EE0,38271,7,8,1,109.62632,18.23049,1956
37691,281766,1D8B814EC83D52D7C5F3FED99C129EE0,30661,10,14,4,109.37028,18.24361,1008
37692,281767,1D8B814EC83D52D7C5F3FED99C129EE0,38271,18,21,3,109.62632,18.23049,1956
37693,281794,50569AD2BBECFEBD2DC5B08708122D64,30051,1,2,1,109.48917,18.21215,1453
37694,281795,50569AD2BBECFEBD2DC5B08708122D64,38361,3,6,3,109.43667,18.29201,1267
37695,281796,50569AD2BBECFEBD2DC5B08708122D64,30111,7,8,1,109.47583,18.30542,1419
37696,281797,50569AD2BBECFEBD2DC5B08708122D64,38361,9,13,4,109.43667,18.29201,1267
37697,281798,50569AD2BBECFEBD2DC5B08708122D64,60054,17,18,1,109.3016,18.31229,770
37698,281799,50569AD2BBECFEBD2DC5B08708122D64,31701,19,20,1,109.44132,18.28833,1266
37699,281800,50569AD2BBECFEBD2DC5B08708122D64,38361,21,23,2,109.43667,18.29201,1267
37700,281856,9904F3A575E4CB183711FA946C79D33B,30861,21,23,2,109.52722,18.22743,1606
37701,281859,4BBF03B1E44EBA34E823E74DAE311295,31521,0,7,7,109.51458,18.22542,1555
37702,281860,4BBF03B1E44EBA34E823E74DAE311295,31145,11,13,2,109.20431,18.30479,369
37703,281861,4BBF03B1E44EBA34E823E74DAE311295,31471,15,17,2,109.34583,18.29563,917
37704,281862,4BBF03B1E44EBA34E823E74DAE311295,31521,18,23,5,109.51458,18.22542,1555
37705,281872,79CCA269D4D1544F735C077DABC1670F,31521,16,20,4,109.51458,18.22542,1555
37706,281873,79CCA269D4D1544F735C077DABC1670F,30731,21,22,1,109.50944,18.22306,1555
37713,281924,1CF6ABA1FBB2C53764058DE6E2005DB0,60631,0,1,1,109.57778,18.27583,1814
37714,281925,1CF6ABA1FBB2C53764058DE6E2005DB0,30854,1,5,4,109.56889,18.27076,1763
37715,281926,1CF6ABA1FBB2C53764058DE6E2005DB0,60631,5,7,2,109.57778,18.27583,1814
37716,281927,1CF6ABA1FBB2C53764058DE6E2005DB0,30854,8,9,1,109.56889,18.27076,1763
37717,281928,1CF6ABA1FBB2C53764058DE6E2005DB0,31471,12,14,2,109.34583,18.29563,917
37718,281938,74A69A57C15238734EC4A759D6D8AD27,31261,0,7,7,109.51174,18.2466,1559
37719,281939,74A69A57C15238734EC4A759D6D8AD27,31471,11,14,3,109.34583,18.29563,917
37720,282005,850F414E89CB3AC3E862CBFA17778006,60121,13,15,2,109.74507,18.37472,2430
37721,282006,850F414E89CB3AC3E862CBFA17778006,38271,19,22,3,109.62632,18.23049,1956
37722,282027,65EB0CD383E33AFBA938FFEE6D8A6EDD,38251,13,15,2,109.49618,18.25493,1510
37723,282028,65EB0CD383E33AFBA938FFEE6D8A6EDD,30201,17,19,2,109.4909,18.26465,1462
37724,282029,65EB0CD383E33AFBA938FFEE6D8A6EDD,31681,20,22,2,109.40396,18.29979,1168
37725,282032,AB43182259122294244C13D6FC66D4A1,30891,2,3,1,109.59431,18.28389,1865
37726,282033,AB43182259122294244C13D6FC66D4A1,60631,3,6,3,109.57778,18.27583,1814
37727,282034,AB43182259122294244C13D6FC66D4A1,31561,8,9,1,109.56792,18.28479,1765
37728,282035,AB43182259122294244C13D6FC66D4A1,30851,15,16,1,109.5616,18.27396,1713
37729,282036,AB43182259122294244C13D6FC66D4A1,60631,20,23,3,109.57778,18.27583,1814
37730,282053,5BC86F424BAF4B877A98262DEDE87053,31041,2,13,11,109.50278,18.23701,1507
37731,282073,F8D799D9161B0143E0D71C40472A357E,38991,0,7,7,109.52681,18.30368,1618
37732,282074,F8D799D9161B0143E0D71C40472A357E,30071,8,12,4,109.52819,18.30472,1619
37733,282075,F8D799D9161B0143E0D71C40472A357E,30071,13,15,2,109.52819,18.30472,1619
37734,282076,F8D799D9161B0143E0D71C40472A357E,38484,15,17,2,109.53028,18.31528,1620
37735,282077,F8D799D9161B0143E0D71C40472A357E,30071,17,21,4,109.52819,18.30472,1619
37736,282078,F8D799D9161B0143E0D71C40472A357E,30071,21,23,2,109.52819,18.30472,1619
37740,282116,7BF65E5054DA81A230AB5423620158E1,60631,0,7,7,109.57778,18.27583,1814
37741,282117,7BF65E5054DA81A230AB5423620158E1,30854,11,21,10,109.56889,18.27076,1763
37742,282162,C58D0182BFC61ED113EE3B09763C30B2,38185,0,6,6,109.51333,18.27347,1563
37743,282163,C58D0182BFC61ED113EE3B09763C30B2,38127,11,12,1,109.50833,18.27222,1513
37744,282164,C58D0182BFC61ED113EE3B09763C30B2,38721,12,13,1,109.50368,18.27542,1514
37745,282165,C58D0182BFC61ED113EE3B09763C30B2,39181,15,17,2,109.55153,18.28035,1715
37746,282166,C58D0182BFC61ED113EE3B09763C30B2,38185,20,23,3,109.51333,18.27347,1563
37747,282199,9352766CE000C006A9C46226806783DB,31951,0,1,1,109.52174,18.30299,1568
37748,282200,9352766CE000C006A9C46226806783DB,30071,1,3,2,109.52819,18.30472,1619
37749,282201,9352766CE000C006A9C46226806783DB,31951,3,4,1,109.52174,18.30299,1568
37750,282202,9352766CE000C006A9C46226806783DB,30071,5,6,1,109.52819,18.30472,1619
37751,282203,9352766CE000C006A9C46226806783DB,31561,10,16,6,109.56792,18.28479,1765
37755,282349,8F6EA1C108FADA76A214A7ED71ECE3D1,30232,1,2,1,109.6191,18.31701,1971
37756,282350,8F6EA1C108FADA76A214A7ED71ECE3D1,30891,6,7,1,109.59431,18.28389,1865
37757,282351,8F6EA1C108FADA76A214A7ED71ECE3D1,30854,8,21,13,109.56889,18.27076,1763
37758,282364,4929D2853AC72A86C75CA19B6A840CCB,38132,17,18,1,109.64632,18.23417,2057
37759,282365,4929D2853AC72A86C75CA19B6A840CCB,30271,20,23,3,109.49132,18.23153,1456
37760,282366,C1C69C0EAD4ABEFD1467543102429D9B,31561,2,7,5,109.56792,18.28479,1765
37761,282367,C1C69C0EAD4ABEFD1467543102429D9B,39183,8,21,13,109.55542,18.28208,1715
37762,282368,63B5E489F3503F8EC6E40A38F9D2117C,31951,8,12,4,109.52174,18.30299,1568
37763,282369,63B5E489F3503F8EC6E40A38F9D2117C,60171,13,23,10,109.51292,18.30694,1569
37764,282427,65E65867D0469EB97C9CAA5984F87E13,60621,0,16,16,109.48354,18.27451,1464
37765,282428,65E65867D0469EB97C9CAA5984F87E13,60121,18,21,3,109.74507,18.37472,2430
37766,282429,EF7DCA5602FCDF14AF156D676A8ED902,30851,1,6,5,109.5616,18.27396,1713
37767,282430,EF7DCA5602FCDF14AF156D676A8ED902,31561,11,21,10,109.56792,18.28479,1765
37768,282447,852BB5540E2D1D044093F0A403D4011D,30581,15,16,1,109.62257,18.24951,1959
37769,282448,852BB5540E2D1D044093F0A403D4011D,31321,19,20,1,109.63799,18.23201,2007
37770,282449,852BB5540E2D1D044093F0A403D4011D,30581,22,23,1,109.62257,18.24951,1959
37771,282495,162C9DF38B34BB5029840E39407B0BD5,31201,3,4,1,109.51042,18.23819,1558
37772,282496,162C9DF38B34BB5029840E39407B0BD5,30181,5,7,2,109.51597,18.23313,1557
37773,282497,162C9DF38B34BB5029840E39407B0BD5,31041,7,11,4,109.50278,18.23701,1507
37774,282498,162C9DF38B34BB5029840E39407B0BD5,38094,14,15,1,109.45403,18.28778,1316
37775,282499,162C9DF38B34BB5029840E39407B0BD5,31041,18,20,2,109.50278,18.23701,1507
37779,282508,FE95B3A32EFBC2838F293DF38F55FDD1,39183,0,5,5,109.55542,18.28208,1715
37780,282509,FE95B3A32EFBC2838F293DF38F55FDD1,30071,7,8,1,109.52819,18.30472,1619
37781,282510,FE95B3A32EFBC2838F293DF38F55FDD1,31931,8,10,2,109.54771,18.29403,1667
37782,282511,FE95B3A32EFBC2838F293DF38F55FDD1,39183,12,13,1,109.55542,18.28208,1715
37783,282512,FE95B3A32EFBC2838F293DF38F55FDD1,31931,16,17,1,109.54771,18.29403,1667
37784,282513,FE95B3A32EFBC2838F293DF38F55FDD1,30854,20,22,2,109.56889,18.27076,1763
37785,282532,80510334A1C80EA4AE907E88FED9D4F9,30771,19,21,2,109.49938,18.26042,1511
37786,282547,5A6C2C4A9B4DF43C379FCADC2CCFC5BC,30201,0,8,8,109.4909,18.26465,1462
37787,282548,5A6C2C4A9B4DF43C379FCADC2CCFC5BC,38171,12,13,1,109.50799,18.28139,1515
37788,282549,5A6C2C4A9B4DF43C379FCADC2CCFC5BC,38283,15,18,3,109.62229,18.22618,1956
37789,282550,5A6C2C4A9B4DF43C379FCADC2CCFC5BC,30201,21,23,2,109.4909,18.26465,1462
37790,282581,E8BAAF476E8FE57075BAB1A8D4FF1780,30232,1,4,3,109.6191,18.31701,1971
37791,282582,E8BAAF476E8FE57075BAB1A8D4FF1780,39371,5,6,1,109.56627,18.2646,1762
37792,282583,E8BAAF476E8FE57075BAB1A8D4FF1780,30181,11,12,1,109.51597,18.23313,1557
37793,282584,E8BAAF476E8FE57075BAB1A8D4FF1780,39371,15,21,6,109.56627,18.2646,1762
37794,282585,E8BAAF476E8FE57075BAB1A8D4FF1780,30232,21,23,2,109.6191,18.31701,1971
37798,282632,82FFBAA5929CD368E9B5AC0A4DEDBC26,30051,0,6,6,109.48917,18.21215,1453
37799,282633,82FFBAA5929CD368E9B5AC0A4DEDBC26,31931,11,13,2,109.54771,18.29403,1667
37800,282634,82FFBAA5929CD368E9B5AC0A4DEDBC26,30921,15,17,2,109.53903,18.29451,1667
37801,282635,82FFBAA5929CD368E9B5AC0A4DEDBC26,30051,19,22,3,109.48917,18.21215,1453
37802,282639,9A1D1AA5EE2CD156CC396C667ED8C5B9,30854,0,17,17,109.56889,18.27076,1763
37803,282640,9A1D1AA5EE2CD156CC396C667ED8C5B9,31071,21,23,2,109.58257,18.28458,1815
37804,282656,C6A8E1B5CB65D13AF625A1F15BC5FC3D,31071,7,12,5,109.58257,18.28458,1815
37805,282657,C6A8E1B5CB65D13AF625A1F15BC5FC3D,30854,15,16,1,109.56889,18.27076,1763
37806,282658,AE15DCAE42DF0D3349548C07BEAC73FD,38951,0,4,4,109.48097,18.28868,1416
37807,282659,AE15DCAE42DF0D3349548C07BEAC73FD,60401,5,6,1,109.47444,18.27583,1414
37808,282660,AE15DCAE42DF0D3349548C07BEAC73FD,38951,6,8,2,109.48097,18.28868,1416
37809,282661,AE15DCAE42DF0D3349548C07BEAC73FD,38951,8,13,5,109.48097,18.28868,1416
37810,282662,AE15DCAE42DF0D3349548C07BEAC73FD,38951,14,17,3,109.48097,18.28868,1416
37811,282663,AE15DCAE42DF0D3349548C07BEAC73FD,60221,19,21,2,109.52569,18.29188,1616
37812,282664,AE15DCAE42DF0D3349548C07BEAC73FD,38951,21,22,1,109.48097,18.28868,1416
37813,282683,798BF3B08F72A16A6DEAAA235F1899BB,61011,5,10,5,109.60653,18.19076,1900
37814,282685,798BF3B08F72A16A6DEAAA235F1899BB,61011,13,16,3,109.60653,18.19076,1900
37815,282698,10FC24C9531FD1E7AB2542E578A0BE0B,30191,0,13,13,109.50361,18.22701,1506
37816,282719,20A2925E2D87348010A2913B8AC052B3,30854,12,15,3,109.56889,18.27076,1763
37817,282720,20A2925E2D87348010A2913B8AC052B3,31071,19,21,2,109.58257,18.28458,1815
37818,282721,20A2925E2D87348010A2913B8AC052B3,30854,21,23,2,109.56889,18.27076,1763
37819,282728,5DFEA14186E5F9BAEF52ACA19AAFC596,31101,0,8,8,109.65389,18.23403,2057
37820,282729,5DFEA14186E5F9BAEF52ACA19AAFC596,31521,12,17,5,109.51458,18.22542,1555
37821,282730,5DFEA14186E5F9BAEF52ACA19AAFC596,30161,18,20,2,109.50042,18.24389,1508
37822,282731,5DFEA14186E5F9BAEF52ACA19AAFC596,30221,22,23,1,109.57833,18.20222,1802
37823,282742,3E9BF2870165485B459CAEC9B77D2C77,30771,20,21,1,109.49938,18.26042,1511
37824,282743,3E9BF2870165485B459CAEC9B77D2C77,30761,21,23,2,109.45201,18.3,1318
37825,282755,843C5064DB5191DFA919592D1A4ECAC4,38321,0,7,7,109.39854,18.29132,1116
37826,282756,843C5064DB5191DFA919592D1A4ECAC4,38105,7,11,4,109.40299,18.29229,1117
37827,282757,843C5064DB5191DFA919592D1A4ECAC4,30341,12,13,1,109.3625,18.29167,966
37828,282758,843C5064DB5191DFA919592D1A4ECAC4,31471,14,16,2,109.34583,18.29563,917
37829,282759,843C5064DB5191DFA919592D1A4ECAC4,38321,18,23,5,109.39854,18.29132,1116
37830,282821,2BE6133C5E44424C388243054653B4C5,60631,15,23,8,109.57778,18.27583,1814
37834,282877,1CBC9AD5FFEDEF1A61B032FAD2F85D56,60084,0,7,7,109.4984,18.2334,1507
37835,282878,1CBC9AD5FFEDEF1A61B032FAD2F85D56,31471,10,12,2,109.34583,18.29563,917
37836,282879,1CBC9AD5FFEDEF1A61B032FAD2F85D56,30661,12,13,1,109.37028,18.24361,1008
37837,282880,1CBC9AD5FFEDEF1A61B032FAD2F85D56,60084,18,23,5,109.4984,18.2334,1507
37838,282881,7F632B4875B2736225CD6D350CD25670,31071,8,10,2,109.58257,18.28458,1815
37839,282882,7F632B4875B2736225CD6D350CD25670,30854,13,22,9,109.56889,18.27076,1763
37844,282920,0DCED9DD7A37F5E957C48EBF5FA9FAEE,31031,0,16,16,109.49979,18.25382,1510
37849,282964,59F29435D748531F416A4F1636997ECF,39371,1,6,5,109.56627,18.2646,1762
37850,282965,59F29435D748531F416A4F1636997ECF,30854,8,23,15,109.56889,18.27076,1763
37854,282970,3518F5AE52D5A3181625A6C97E738310,38094,12,14,2,109.45403,18.28778,1316
37855,282971,3518F5AE52D5A3181625A6C97E738310,31145,16,17,1,109.20431,18.30479,369
37856,282972,3518F5AE52D5A3181625A6C97E738310,38094,19,20,1,109.45403,18.28778,1316
37857,282973,3518F5AE52D5A3181625A6C97E738310,30201,20,22,2,109.4909,18.26465,1462
37858,283008,C6F78220AAD296FE3F26258AAA364F5E,31164,1,8,7,109.69993,18.27215,2263
37859,283009,C6F78220AAD296FE3F26258AAA364F5E,31671,10,11,1,109.38965,18.29813,1068
37860,283010,C6F78220AAD296FE3F26258AAA364F5E,30281,16,18,2,109.50597,18.27583,1514
37861,283011,C6F78220AAD296FE3F26258AAA364F5E,39151,18,20,2,109.49875,18.25097,1510
37862,283012,C6F78220AAD296FE3F26258AAA364F5E,31521,21,23,2,109.51458,18.22542,1555
37863,283024,A2F734AA2F32C81D03014F0CEDF1D528,30351,0,1,1,109.41701,18.29292,1217
37864,283025,A2F734AA2F32C81D03014F0CEDF1D528,60524,2,8,6,109.42951,18.28993,1216
37865,283026,A2F734AA2F32C81D03014F0CEDF1D528,30661,11,14,3,109.37028,18.24361,1008
37866,283027,A2F734AA2F32C81D03014F0CEDF1D528,30351,19,23,4,109.41701,18.29292,1217
37867,283060,7F377D9BD4A6752A92F213BA9B3E59E5,30771,0,5,5,109.49938,18.26042,1511
37868,283061,7F377D9BD4A6752A92F213BA9B3E59E5,38251,6,9,3,109.49618,18.25493,1510
37869,283062,7F377D9BD4A6752A92F213BA9B3E59E5,30421,10,13,3,109.50021,18.25861,1511
37870,283063,7F377D9BD4A6752A92F213BA9B3E59E5,31031,15,17,2,109.49979,18.25382,1510
37871,283064,7F377D9BD4A6752A92F213BA9B3E59E5,31271,18,20,2,109.48958,18.26257,1462
37872,283065,7F377D9BD4A6752A92F213BA9B3E59E5,38251,20,21,1,109.49618,18.25493,1510
37873,283066,7F377D9BD4A6752A92F213BA9B3E59E5,30771,22,23,1,109.49938,18.26042,1511
37874,283095,522E8CB42AF22D75F3E9D0FD1FDCEEA6,30854,0,1,1,109.56889,18.27076,1763
37875,283096,522E8CB42AF22D75F3E9D0FD1FDCEEA6,39371,1,7,6,109.56627,18.2646,1762
37876,283097,522E8CB42AF22D75F3E9D0FD1FDCEEA6,30854,7,13,6,109.56889,18.27076,1763
37877,283098,522E8CB42AF22D75F3E9D0FD1FDCEEA6,60354,16,18,2,109.58701,18.28521,1815
37878,283099,522E8CB42AF22D75F3E9D0FD1FDCEEA6,31071,19,20,1,109.58257,18.28458,1815
37882,283129,24C0932BD5754CA1476755EEBD27CEBD,31811,0,19,19,109.54201,18.31806,1671
37883,283130,24C0932BD5754CA1476755EEBD27CEBD,30941,19,22,3,109.5559,18.33938,1724
37884,283143,F104684B0D453E1772CF3FC2E8F8DFBE,60401,17,19,2,109.47444,18.27583,1414
37885,283144,F104684B0D453E1772CF3FC2E8F8DFBE,60161,21,22,1,109.49174,18.26181,1461
37886,283162,14BFE46EEAB2E234698393270A62605D,60411,1,5,4,109.32514,18.30854,869
37887,283163,14BFE46EEAB2E234698393270A62605D,30661,5,7,2,109.37028,18.24361,1008
37888,283164,14BFE46EEAB2E234698393270A62605D,60411,8,23,15,109.32514,18.30854,869
37889,283183,2CF83F5125C6075E2ACA9C17C2979C64,31071,7,8,1,109.58257,18.28458,1815
37890,283184,2CF83F5125C6075E2ACA9C17C2979C64,30854,9,13,4,109.56889,18.27076,1763
37891,283185,2CF83F5125C6075E2ACA9C17C2979C64,31071,15,18,3,109.58257,18.28458,1815
37892,283186,2CF83F5125C6075E2ACA9C17C2979C64,30854,19,21,2,109.56889,18.27076,1763
37897,283210,EFEDECB139A304BF1949D208B2A10BCC,31521,16,18,2,109.51458,18.22542,1555
37898,283211,EFEDECB139A304BF1949D208B2A10BCC,38071,19,21,2,109.40722,18.30938,1169
37899,283212,2D8DD824BBF69AD8F67DA5D5B6F17323,38336,0,11,11,109.61111,18.21806,1904
37900,283213,2D8DD824BBF69AD8F67DA5D5B6F17323,30711,11,13,2,109.50271,18.25347,1510
37901,283214,2D8DD824BBF69AD8F67DA5D5B6F17323,30151,14,15,1,109.50986,18.25083,1560
37902,283215,2D8DD824BBF69AD8F67DA5D5B6F17323,30511,18,19,1,109.51069,18.24208,1558
37903,283216,2D8DD824BBF69AD8F67DA5D5B6F17323,30151,20,23,3,109.50986,18.25083,1560
37904,283289,7C68E1F4B8B2F3CBBD5427BF66BF9C2E,30854,2,5,3,109.56889,18.27076,1763
37905,283290,7C68E1F4B8B2F3CBBD5427BF66BF9C2E,60591,10,12,2,109.61118,18.21715,1904
37906,283295,9BD095517798346F169AD6D898CA1A42,60361,19,20,1,109.51938,18.29681,1567
37907,283296,9BD095517798346F169AD6D898CA1A42,60274,21,22,1,109.514,18.2933,1567
37908,283303,299AC9422F298CCC4ED16594B565B2CA,60341,0,6,6,109.70597,18.31778,2271
37909,283307,299AC9422F298CCC4ED16594B565B2CA,60341,21,23,2,109.70597,18.31778,2271
37910,283308,C0C1EE89F1AC35B762053FC3AB41A7AA,60361,0,8,8,109.51938,18.29681,1567
37911,283309,C0C1EE89F1AC35B762053FC3AB41A7AA,31781,11,14,3,109.19847,18.2975,367
37915,283348,7F6E66BC10419161F6457A6D79258EDB,31361,0,7,7,109.47417,18.28292,1415
37916,283349,7F6E66BC10419161F6457A6D79258EDB,60401,8,9,1,109.47444,18.27583,1414
37917,283350,7F6E66BC10419161F6457A6D79258EDB,38094,11,13,2,109.45403,18.28778,1316
37918,283351,7F6E66BC10419161F6457A6D79258EDB,38251,13,14,1,109.49618,18.25493,1510
37919,283352,7F6E66BC10419161F6457A6D79258EDB,30171,18,19,1,109.48458,18.27139,1463
37920,283360,25B68A5424AF12317AF7FF917D58087B,38871,0,4,4,109.44681,18.28625,1316
37921,283361,25B68A5424AF12317AF7FF917D58087B,38391,4,5,1,109.44111,18.29083,1266
37922,283378,372A5433078073EAD18922D679CE0A73,60054,0,2,2,109.3016,18.31229,770
37923,283379,372A5433078073EAD18922D679CE0A73,30661,4,6,2,109.37028,18.24361,1008
37924,283380,372A5433078073EAD18922D679CE0A73,60411,11,12,1,109.32514,18.30854,869
37925,283381,372A5433078073EAD18922D679CE0A73,60054,12,14,2,109.3016,18.31229,770
37926,283400,50F6E2D553B36EAFE6AA22613C3D5EDD,60401,14,16,2,109.47444,18.27583,1414
37927,283401,50F6E2D553B36EAFE6AA22613C3D5EDD,30711,16,19,3,109.50271,18.25347,1510
37928,283402,50F6E2D553B36EAFE6AA22613C3D5EDD,30181,20,21,1,109.51597,18.23313,1557
37929,283468,65AD296DD65C9EEA3C22EA02904A768E,31561,4,6,2,109.56792,18.28479,1765
37930,283469,65AD296DD65C9EEA3C22EA02904A768E,30854,9,16,7,109.56889,18.27076,1763
37931,283499,4A6E6277F47F7550E2618B9C1ADC3166,30361,13,15,2,109.50347,18.24,1508
37932,283500,4A6E6277F47F7550E2618B9C1ADC3166,31391,18,23,5,109.50382,18.24285,1508
37937,283688,1DA88ED70B6ADE8EAE3D8F549B029C10,60131,15,18,3,109.49819,18.24778,1509
37938,283689,1DA88ED70B6ADE8EAE3D8F549B029C10,31031,20,21,1,109.49979,18.25382,1510
37939,283690,1DA88ED70B6ADE8EAE3D8F549B029C10,60131,22,23,1,109.49819,18.24778,1509
37943,283705,81BB8442D113627FA1326BEB8BF192ED,60631,0,3,3,109.57778,18.27583,1814
37944,283706,81BB8442D113627FA1326BEB8BF192ED,30854,7,9,2,109.56889,18.27076,1763
37945,283707,81BB8442D113627FA1326BEB8BF192ED,30731,12,15,3,109.50944,18.22306,1555
37946,283708,81BB8442D113627FA1326BEB8BF192ED,31421,16,17,1,109.55382,18.22347,1705
37947,283710,9B389AE8E9B004176803CCEAFF69104A,60631,6,8,2,109.57778,18.27583,1814
37948,283711,9B389AE8E9B004176803CCEAFF69104A,39371,8,10,2,109.56627,18.2646,1762
37949,283712,9B389AE8E9B004176803CCEAFF69104A,60631,12,16,4,109.57778,18.27583,1814
37950,283738,E5E7A1E4B2B3DFFE76B1825814C207C0,30081,0,7,7,109.50243,18.26632,1512
37951,283739,E5E7A1E4B2B3DFFE76B1825814C207C0,31561,10,11,1,109.56792,18.28479,1765
37952,283740,E5E7A1E4B2B3DFFE76B1825814C207C0,30851,12,13,1,109.5616,18.27396,1713
37953,283741,E5E7A1E4B2B3DFFE76B1825814C207C0,31561,14,18,4,109.56792,18.28479,1765
37954,283742,E5E7A1E4B2B3DFFE76B1825814C207C0,30081,19,23,4,109.50243,18.26632,1512
37955,283745,D02ECCADCE37C9BB090B5733D16771A3,31931,14,16,2,109.54771,18.29403,1667
37956,283755,B039FD787BBA07BD32246202CEEDE945,30051,0,17,17,109.48917,18.21215,1453
37957,283756,B039FD787BBA07BD32246202CEEDE945,39151,20,21,1,109.49875,18.25097,1510
37958,283782,C17F2EF1DEA79C8C951E3013EE071B2C,31071,0,17,17,109.58257,18.28458,1815
37959,283783,C17F2EF1DEA79C8C951E3013EE071B2C,60381,18,20,2,109.5241,18.22458,1605
37960,283784,C17F2EF1DEA79C8C951E3013EE071B2C,38061,21,22,1,109.50597,18.23118,1506
37961,283812,70DCD7BB3675E3BE2BD25F86910CADB1,31071,2,7,5,109.58257,18.28458,1815
37962,283813,70DCD7BB3675E3BE2BD25F86910CADB1,30854,8,9,1,109.56889,18.27076,1763
37963,283814,70DCD7BB3675E3BE2BD25F86910CADB1,30731,10,15,5,109.50944,18.22306,1555
37964,283881,D619F26FD3DE3212F61D98B7FC43EEC1,31521,18,21,3,109.51458,18.22542,1555
37965,283882,D619F26FD3DE3212F61D98B7FC43EEC1,30211,22,23,1,109.49882,18.23931,1508
37972,283937,8621CFDF1B89A83351494618C53D033F,31071,4,6,2,109.58257,18.28458,1815
37973,283938,8621CFDF1B89A83351494618C53D033F,30711,9,11,2,109.50271,18.25347,1510
37974,283939,8621CFDF1B89A83351494618C53D033F,39181,12,20,8,109.55153,18.28035,1715
37975,283940,8621CFDF1B89A83351494618C53D033F,31071,21,23,2,109.58257,18.28458,1815
37976,283944,7B280C2AC3C9F2B40941094B166E2863,38903,0,7,7,109.39229,18.29243,1117
37977,283945,7B280C2AC3C9F2B40941094B166E2863,30661,9,13,4,109.37028,18.24361,1008
37978,283946,7B280C2AC3C9F2B40941094B166E2863,31471,15,16,1,109.34583,18.29563,917
37979,283960,3E0CC1F431A959DE24ABB41EC7702F6D,30661,13,14,1,109.37028,18.24361,1008
37980,283961,3E0CC1F431A959DE24ABB41EC7702F6D,30351,19,20,1,109.41701,18.29292,1217
37981,283962,3E0CC1F431A959DE24ABB41EC7702F6D,31231,21,22,1,109.42597,18.29292,1217
37982,283963,3E0CC1F431A959DE24ABB41EC7702F6D,60552,22,23,1,109.41729,18.30014,1218
37983,283991,5664C5FF6B352F96C7620F94430DAC4F,31391,4,6,2,109.50382,18.24285,1508
37984,283992,5664C5FF6B352F96C7620F94430DAC4F,31521,6,8,2,109.51458,18.22542,1555
37985,283993,5664C5FF6B352F96C7620F94430DAC4F,31391,8,10,2,109.50382,18.24285,1508
37986,283994,5664C5FF6B352F96C7620F94430DAC4F,31521,11,18,7,109.51458,18.22542,1555
37987,283995,5664C5FF6B352F96C7620F94430DAC4F,31521,18,22,4,109.51458,18.22542,1555
37991,284026,4AA92C2276692190731459431C798101,31945,0,6,6,109.58021,18.29403,1817
37992,284027,4AA92C2276692190731459431C798101,31561,8,9,1,109.56792,18.28479,1765
37993,284028,4AA92C2276692190731459431C798101,31945,9,12,3,109.58021,18.29403,1817
37994,284029,4AA92C2276692190731459431C798101,30711,13,15,2,109.50271,18.25347,1510
37995,284030,4AA92C2276692190731459431C798101,31945,18,22,4,109.58021,18.29403,1817
38000,284055,1AEA44F051EC107D454C59951DC8E3E5,60311,0,8,8,109.52097,18.24319,1558
38001,284056,1AEA44F051EC107D454C59951DC8E3E5,30711,10,11,1,109.50271,18.25347,1510
38002,284057,1AEA44F051EC107D454C59951DC8E3E5,60311,12,13,1,109.52097,18.24319,1558
38003,284058,1AEA44F051EC107D454C59951DC8E3E5,60371,15,17,2,109.53063,18.30056,1618
38004,284059,1AEA44F051EC107D454C59951DC8E3E5,60311,19,22,3,109.52097,18.24319,1558
38005,284148,EB316856896788EC8FD871E122E95728,60361,0,3,3,109.51938,18.29681,1567
38006,284149,EB316856896788EC8FD871E122E95728,30701,4,5,1,109.59313,18.32007,1871
38007,284150,EB316856896788EC8FD871E122E95728,31811,8,10,2,109.54201,18.31806,1671
38008,284151,EB316856896788EC8FD871E122E95728,60361,14,16,2,109.51938,18.29681,1567
38009,284152,EB316856896788EC8FD871E122E95728,30701,18,21,3,109.59313,18.32007,1871
38010,284153,EB316856896788EC8FD871E122E95728,30931,21,22,1,109.55653,18.32722,1722
38011,284174,4E8A1FFC680701A862F9A60D8BF0780C,38162,15,18,3,109.43944,18.28889,1266
38012,284175,4E8A1FFC680701A862F9A60D8BF0780C,38162,19,22,3,109.43944,18.28889,1266
38013,284204,CD3BCBAB8571FB81953C842A434E5DB8,31071,7,8,1,109.58257,18.28458,1815
38014,284205,CD3BCBAB8571FB81953C842A434E5DB8,30854,8,11,3,109.56889,18.27076,1763
38015,284206,CD3BCBAB8571FB81953C842A434E5DB8,31071,13,16,3,109.58257,18.28458,1815
38016,284255,0505C716BCB35B5DD4016F98C220D0C2,31864,14,18,4,109.49014,18.28333,1465
38017,284256,0505C716BCB35B5DD4016F98C220D0C2,60291,19,21,2,109.50826,18.24639,1509
38018,284257,0505C716BCB35B5DD4016F98C220D0C2,39091,22,23,1,109.50097,18.25222,1510
38019,284262,58DE8A719D3ADBEDAE163213845B460A,31071,1,14,13,109.58257,18.28458,1815
38020,284263,58DE8A719D3ADBEDAE163213845B460A,30854,16,17,1,109.56889,18.27076,1763
38021,284266,9DE8C13901CC7D63E2F1A6CC92603604,30854,3,16,13,109.56889,18.27076,1763
38022,284267,9DE8C13901CC7D63E2F1A6CC92603604,60371,19,21,2,109.53063,18.30056,1618
38023,284271,281A1935FADAFCA0937BB2D463A4CFAF,31471,1,4,3,109.34583,18.29563,917
38024,284272,281A1935FADAFCA0937BB2D463A4CFAF,30661,4,5,1,109.37028,18.24361,1008
38025,284273,281A1935FADAFCA0937BB2D463A4CFAF,60411,6,7,1,109.32514,18.30854,869
38026,284274,281A1935FADAFCA0937BB2D463A4CFAF,30661,12,14,2,109.37028,18.24361,1008
38027,284275,281A1935FADAFCA0937BB2D463A4CFAF,31251,14,15,1,109.18528,18.2975,317
38028,284276,281A1935FADAFCA0937BB2D463A4CFAF,31471,17,18,1,109.34583,18.29563,917
38029,284293,2DDF3A993BD69F79020EB97CF3A71819,38171,0,7,7,109.50799,18.28139,1515
38030,284294,2DDF3A993BD69F79020EB97CF3A71819,30161,8,19,11,109.50042,18.24389,1508
38035,284319,C3D97A298AB6EB8497D0CC432E6DD8A2,30421,10,13,3,109.50021,18.25861,1511
38036,284320,C3D97A298AB6EB8497D0CC432E6DD8A2,31851,14,15,1,109.71736,18.29007,2316
38037,284337,EBD16061EA20EE33D9344D33735E5205,38291,0,7,7,109.51618,18.24313,1558
38038,284338,EBD16061EA20EE33D9344D33735E5205,31261,7,9,2,109.51174,18.2466,1559
38039,284339,EBD16061EA20EE33D9344D33735E5205,38291,9,11,2,109.51618,18.24313,1558
38040,284340,EBD16061EA20EE33D9344D33735E5205,31261,13,14,1,109.51174,18.2466,1559
38041,284341,EBD16061EA20EE33D9344D33735E5205,38891,17,23,6,109.51486,18.24118,1558
38042,284363,F8D81869027CCFD6139762C81772F076,31271,0,7,7,109.48958,18.26257,1462
38043,284364,F8D81869027CCFD6139762C81772F076,31031,8,9,1,109.49979,18.25382,1510
38044,284365,F8D81869027CCFD6139762C81772F076,39321,10,18,8,109.529,18.2167,1604
38045,284366,F8D81869027CCFD6139762C81772F076,60381,19,20,1,109.5241,18.22458,1605
38046,284367,F8D81869027CCFD6139762C81772F076,31271,21,23,2,109.48958,18.26257,1462
38047,284414,3A044DC50877A7C3021BEAE1D2D64C9E,38754,19,20,1,109.74667,18.37382,2430
38048,284415,3A044DC50877A7C3021BEAE1D2D64C9E,30961,20,21,1,109.74042,18.37903,2431
38049,284425,AE6DC7ACB81DB5F351E45AC25E5F5A3B,31201,0,3,3,109.51042,18.23819,1558
38050,284426,AE6DC7ACB81DB5F351E45AC25E5F5A3B,60311,6,7,1,109.52097,18.24319,1558
38051,284427,AE6DC7ACB81DB5F351E45AC25E5F5A3B,60281,8,15,7,109.51743,18.25924,1561
38052,284428,AE6DC7ACB81DB5F351E45AC25E5F5A3B,60311,17,18,1,109.52097,18.24319,1558
38053,284429,AE6DC7ACB81DB5F351E45AC25E5F5A3B,38297,21,23,2,109.52576,18.24965,1609
38054,284443,7DE5FC03BA99B22E41C5D0A9D25E3D68,30234,2,7,5,109.60681,18.29979,1918
38055,284444,7DE5FC03BA99B22E41C5D0A9D25E3D68,31031,12,23,11,109.49979,18.25382,1510
38056,284451,2F440A235E684ECEDD042B3100A4AE95,31071,0,7,7,109.58257,18.28458,1815
38057,284452,2F440A235E684ECEDD042B3100A4AE95,30854,7,10,3,109.56889,18.27076,1763
38058,284453,2F440A235E684ECEDD042B3100A4AE95,31561,11,12,1,109.56792,18.28479,1765
38059,284454,2F440A235E684ECEDD042B3100A4AE95,30854,13,15,2,109.56889,18.27076,1763
38060,284455,2F440A235E684ECEDD042B3100A4AE95,31561,16,18,2,109.56792,18.28479,1765
38061,284456,2F440A235E684ECEDD042B3100A4AE95,31071,20,23,3,109.58257,18.28458,1815
38062,284462,54B883645487D188D3AAF2ECE345CCC6,31864,0,8,8,109.49014,18.28333,1465
38063,284463,54B883645487D188D3AAF2ECE345CCC6,31781,9,12,3,109.19847,18.2975,367
38064,284464,54B883645487D188D3AAF2ECE345CCC6,31471,13,15,2,109.34583,18.29563,917
38065,284465,54B883645487D188D3AAF2ECE345CCC6,48574,16,18,2,109.48931,18.28458,1465
38066,284466,54B883645487D188D3AAF2ECE345CCC6,60501,19,20,1,109.48701,18.29021,1466
38067,284467,54B883645487D188D3AAF2ECE345CCC6,31864,20,23,3,109.49014,18.28333,1465
38075,284495,ACDEAAF45B65DE48CF80A48DBD3C775E,30854,1,17,16,109.56889,18.27076,1763
38076,284496,ACDEAAF45B65DE48CF80A48DBD3C775E,31071,18,19,1,109.58257,18.28458,1815
38077,284499,5C71CBC5C1D47FC32EDE45570D296228,30861,0,8,8,109.52722,18.22743,1606
38078,284500,5C71CBC5C1D47FC32EDE45570D296228,60552,9,10,1,109.41729,18.30014,1218
38079,284501,5C71CBC5C1D47FC32EDE45570D296228,31781,12,14,2,109.19847,18.2975,367
38080,284502,5C71CBC5C1D47FC32EDE45570D296228,31471,14,17,3,109.34583,18.29563,917
38081,284503,5C71CBC5C1D47FC32EDE45570D296228,30861,19,23,4,109.52722,18.22743,1606
38082,284504,5EBEA276FCB4A19AC5C987F5C7CC8908,60621,0,8,8,109.48354,18.27451,1464
38083,284505,5EBEA276FCB4A19AC5C987F5C7CC8908,60401,10,12,2,109.47444,18.27583,1414
38084,284506,5EBEA276FCB4A19AC5C987F5C7CC8908,60552,14,16,2,109.41729,18.30014,1218
38085,284507,5EBEA276FCB4A19AC5C987F5C7CC8908,38361,18,19,1,109.43667,18.29201,1267
38086,284508,5EBEA276FCB4A19AC5C987F5C7CC8908,31701,20,22,2,109.44132,18.28833,1266
38087,284534,A5678EE319F8EC08843C9F20545373D3,31205,0,1,1,109.51111,18.23736,1557
38088,284535,A5678EE319F8EC08843C9F20545373D3,60524,1,7,6,109.42951,18.28993,1216
38089,284536,A5678EE319F8EC08843C9F20545373D3,31561,9,12,3,109.56792,18.28479,1765
38090,284537,A5678EE319F8EC08843C9F20545373D3,31021,14,15,1,109.49021,18.27,1463
38091,284538,A5678EE319F8EC08843C9F20545373D3,30971,16,23,7,109.48708,18.29319,1467
38092,284539,7B1A07C39637E996C01DF0A3D287D3C6,31071,17,18,1,109.58257,18.28458,1815
38093,284540,7B1A07C39637E996C01DF0A3D287D3C6,39371,19,20,1,109.56627,18.2646,1762
38094,284552,B032E534C72FB8134F1588648D944A44,30854,0,17,17,109.56889,18.27076,1763
38095,284553,B032E534C72FB8134F1588648D944A44,30371,18,20,2,109.51,18.24771,1559
38106,284570,76E12A118C330D9C1C9FA24D20FBD536,31091,1,2,1,109.41201,18.31222,1170
38107,284571,76E12A118C330D9C1C9FA24D20FBD536,31181,3,7,4,109.50382,18.24813,1509
38108,284572,76E12A118C330D9C1C9FA24D20FBD536,60291,7,8,1,109.50826,18.24639,1509
38109,284573,76E12A118C330D9C1C9FA24D20FBD536,30201,16,20,4,109.4909,18.26465,1462
38110,284574,76E12A118C330D9C1C9FA24D20FBD536,31181,21,23,2,109.50382,18.24813,1509
38115,284646,CEF8E35C6588939BE87D1C80A6394F29,30854,11,13,2,109.56889,18.27076,1763
38116,284653,1A1509AC6E667B603EE3773D1273B7B0,39053,20,21,1,109.511,18.2771,1564
38117,284654,1A1509AC6E667B603EE3773D1273B7B0,31091,22,23,1,109.41201,18.31222,1170
38118,284666,C8BEDF243DDC440B45960DDE87D3E361,39111,0,8,8,109.5191,18.22597,1555
38119,284667,C8BEDF243DDC440B45960DDE87D3E361,38315,12,13,1,109.48979,18.29764,1467
38120,284673,C8CF6BADFF24FAF32D041216BE4EE29D,31271,0,7,7,109.48958,18.26257,1462
38121,284674,C8CF6BADFF24FAF32D041216BE4EE29D,31781,9,11,2,109.19847,18.2975,367
38122,284675,C8CF6BADFF24FAF32D041216BE4EE29D,31471,12,14,2,109.34583,18.29563,917
38123,284676,C8CF6BADFF24FAF32D041216BE4EE29D,60221,18,21,3,109.52569,18.29188,1616
38124,284738,3DBDFAB6744EB8339A2A3FDED5B3F996,30391,19,21,2,109.4975,18.27118,1513
38125,284739,3DBDFAB6744EB8339A2A3FDED5B3F996,30711,21,22,1,109.50271,18.25347,1510
38126,284740,A21C21E7D793AC3E70E23C48F1F3CC85,31431,0,9,9,109.44639,18.29042,1316
38127,284741,A21C21E7D793AC3E70E23C48F1F3CC85,31471,12,15,3,109.34583,18.29563,917
38128,284742,A21C21E7D793AC3E70E23C48F1F3CC85,30901,15,17,2,109.27597,18.3134,670
38129,284743,A21C21E7D793AC3E70E23C48F1F3CC85,31431,20,23,3,109.44639,18.29042,1316
38133,284784,B7A2800FDF738E1064EAD2A5E58F7A3C,61011,0,11,11,109.60653,18.19076,1900
38134,284786,B7A2800FDF738E1064EAD2A5E58F7A3C,61011,18,23,5,109.60653,18.19076,1900
38135,284789,8265A029C672FE0377EF574CC3ADF2A8,39183,7,11,4,109.55542,18.28208,1715
38136,284790,8265A029C672FE0377EF574CC3ADF2A8,31561,12,16,4,109.56792,18.28479,1765
38137,284791,8265A029C672FE0377EF574CC3ADF2A8,30854,20,22,2,109.56889,18.27076,1763
38138,284792,8265A029C672FE0377EF574CC3ADF2A8,31561,22,23,1,109.56792,18.28479,1765
38139,284804,0C8D15C0488D521680F0DE3A28CFE111,30701,0,22,22,109.59313,18.32007,1871
38140,284805,0C8D15C0488D521680F0DE3A28CFE111,31811,22,23,1,109.54201,18.31806,1671
38141,284806,DFF0D1C3CF34075FCA7723BF68E63B2F,60401,16,18,2,109.47444,18.27583,1414
38142,284807,DFF0D1C3CF34075FCA7723BF68E63B2F,60381,20,22,2,109.5241,18.22458,1605
38143,284819,8EBC663D9C4AAC509442DB949D2DF64F,30421,11,18,7,109.50021,18.25861,1511
38144,284820,8EBC663D9C4AAC509442DB949D2DF64F,30084,19,23,4,109.50118,18.26972,1513
38151,284857,F621296F333E8058687ACD884B135C6E,60114,12,14,2,109.73028,18.33847,2374
38152,284858,F621296F333E8058687ACD884B135C6E,30504,15,17,2,109.705,18.35368,2277
38153,284859,F621296F333E8058687ACD884B135C6E,30191,20,23,3,109.50361,18.22701,1506
38154,284936,3CC3D7175C2BD0F4CB1AB4C68F59FE01,60381,0,10,10,109.5241,18.22458,1605
38155,284937,3CC3D7175C2BD0F4CB1AB4C68F59FE01,38251,14,17,3,109.49618,18.25493,1510
38156,285039,BD36B617B5735ECF01B192DD8C734880,60661,0,6,6,109.548,18.2377,1657
38157,285040,BD36B617B5735ECF01B192DD8C734880,31061,6,11,5,109.53333,18.23257,1607
38158,285041,BD36B617B5735ECF01B192DD8C734880,31421,12,14,2,109.55382,18.22347,1705
38159,285042,BD36B617B5735ECF01B192DD8C734880,60381,17,20,3,109.5241,18.22458,1605
38160,285043,BD36B617B5735ECF01B192DD8C734880,31421,20,21,1,109.55382,18.22347,1705
38161,285044,BD36B617B5735ECF01B192DD8C734880,60661,22,23,1,109.548,18.2377,1657
38162,285063,934C74BA3183C31F0ADBA8662BD90297,31321,0,8,8,109.63799,18.23201,2007
38163,285064,934C74BA3183C31F0ADBA8662BD90297,38025,9,11,2,109.36903,18.29167,1016
38164,285065,934C74BA3183C31F0ADBA8662BD90297,31321,16,23,7,109.63799,18.23201,2007
38165,285094,DCF02478AC5ACC5C3190CEB09210F280,31351,0,9,9,109.4959,18.28417,1465
38166,285101,2B8C748A18FA7D08D4335AD7C9DEF01B,31761,0,5,5,109.60521,18.27965,1914
38167,285102,2B8C748A18FA7D08D4335AD7C9DEF01B,30951,9,11,2,109.56208,18.25667,1761
38168,285103,2B8C748A18FA7D08D4335AD7C9DEF01B,31551,11,14,3,109.55868,18.24222,1708
38169,285104,2B8C748A18FA7D08D4335AD7C9DEF01B,31761,19,23,4,109.60521,18.27965,1914
38170,285149,EFDE35289FEC1E13D6F34EFEE66A8AD2,30854,14,16,2,109.56889,18.27076,1763
38171,285150,EFDE35289FEC1E13D6F34EFEE66A8AD2,60631,18,21,3,109.57778,18.27583,1814
38172,285186,3977578BE56276DA0700B04B81DC1356,31561,0,8,8,109.56792,18.28479,1765
38173,285187,3977578BE56276DA0700B04B81DC1356,31061,9,11,2,109.53333,18.23257,1607
38174,285188,3977578BE56276DA0700B04B81DC1356,30851,15,19,4,109.5616,18.27396,1713
38175,285237,070A398F07C013242CC3447B66DFACBF,39183,0,6,6,109.55542,18.28208,1715
38176,285238,070A398F07C013242CC3447B66DFACBF,31931,8,9,1,109.54771,18.29403,1667
38177,285239,070A398F07C013242CC3447B66DFACBF,39183,12,13,1,109.55542,18.28208,1715
38178,285240,070A398F07C013242CC3447B66DFACBF,31931,14,19,5,109.54771,18.29403,1667
38179,285241,070A398F07C013242CC3447B66DFACBF,39183,19,23,4,109.55542,18.28208,1715
38180,285244,D64758992893CFDE3F3459903D21B5EA,30761,1,5,4,109.45201,18.3,1318
38181,285245,D64758992893CFDE3F3459903D21B5EA,30671,5,6,1,109.43611,18.30139,1268
38182,285246,D64758992893CFDE3F3459903D21B5EA,31701,8,10,2,109.44132,18.28833,1266
38183,285247,D64758992893CFDE3F3459903D21B5EA,31781,11,13,2,109.19847,18.2975,367
38184,285295,C61008F347B09908A052E575D01A92B1,31021,0,13,13,109.49021,18.27,1463
38185,285296,C61008F347B09908A052E575D01A92B1,31471,15,17,2,109.34583,18.29563,917
38186,285302,0E129C09250C0D46273B4BD7E5225556,30151,0,6,6,109.50986,18.25083,1560
38187,285303,0E129C09250C0D46273B4BD7E5225556,30421,6,9,3,109.50021,18.25861,1511
38188,285304,0E129C09250C0D46273B4BD7E5225556,60441,14,15,1,109.46792,18.28604,1366
38192,285366,451E2BF48CD7B253EB0892324E679BCC,60281,6,16,10,109.51743,18.25924,1561
38193,285367,451E2BF48CD7B253EB0892324E679BCC,31461,16,18,2,109.5091,18.25389,1510
38194,285368,451E2BF48CD7B253EB0892324E679BCC,38297,19,22,3,109.52576,18.24965,1609
38195,285369,451E2BF48CD7B253EB0892324E679BCC,38291,22,23,1,109.51618,18.24313,1558
38196,285385,3160CBE2F0CDCB610575CDC881D9968C,38297,12,14,2,109.52576,18.24965,1609
38197,285386,3160CBE2F0CDCB610575CDC881D9968C,30281,15,16,1,109.50597,18.27583,1514
38198,285387,3160CBE2F0CDCB610575CDC881D9968C,60381,18,20,2,109.5241,18.22458,1605
38199,285388,3160CBE2F0CDCB610575CDC881D9968C,38291,21,23,2,109.51618,18.24313,1558
38203,285419,5ABFF3E8EB470884C270C0C936A89A00,31561,14,16,2,109.56792,18.28479,1765
38204,285463,0E5593A90D661690BE3DAAA17AD936E2,38127,2,8,6,109.50833,18.27222,1513
38205,285464,0E5593A90D661690BE3DAAA17AD936E2,60641,9,10,1,109.53854,18.2359,1657
38206,285465,0E5593A90D661690BE3DAAA17AD936E2,38073,13,15,2,109.40813,18.30958,1169
38211,285476,40667E55EDAC334B8D18CEA71CBD34F4,30671,5,6,1,109.43611,18.30139,1268
38212,285477,40667E55EDAC334B8D18CEA71CBD34F4,30111,7,13,6,109.47583,18.30542,1419
38213,285478,40667E55EDAC334B8D18CEA71CBD34F4,30711,15,17,2,109.50271,18.25347,1510
38214,285479,40667E55EDAC334B8D18CEA71CBD34F4,31081,18,20,2,109.44639,18.30181,1318
38218,285505,5E8FF49D1CCDA711846608608C7FAE0D,31071,0,13,13,109.58257,18.28458,1815
38219,285506,5E8FF49D1CCDA711846608608C7FAE0D,30854,15,16,1,109.56889,18.27076,1763
38223,285534,28116E081E8AAFD89F4929BB4937EC6F,31471,16,17,1,109.34583,18.29563,917
38224,285535,28116E081E8AAFD89F4929BB4937EC6F,60084,18,20,2,109.4984,18.2334,1507
38228,285588,B5D5F035B558647FF9F44A76F16A1183,31521,1,3,2,109.51458,18.22542,1555
38229,285589,B5D5F035B558647FF9F44A76F16A1183,38291,4,9,5,109.51618,18.24313,1558
38230,285590,B5D5F035B558647FF9F44A76F16A1183,38754,12,13,1,109.74667,18.37382,2430
38231,285591,B5D5F035B558647FF9F44A76F16A1183,30741,18,23,5,109.49833,18.28681,1516
38232,285595,6A8C883D29A8AF90E102449F92489A64,31071,0,7,7,109.58257,18.28458,1815
38233,285596,6A8C883D29A8AF90E102449F92489A64,30854,8,23,15,109.56889,18.27076,1763
38234,285626,C3EC43179E51E2CA8AF203A259981D18,31071,1,2,1,109.58257,18.28458,1815
38235,285627,C3EC43179E51E2CA8AF203A259981D18,30854,3,4,1,109.56889,18.27076,1763
38236,285628,C3EC43179E51E2CA8AF203A259981D18,31071,4,7,3,109.58257,18.28458,1815
38237,285629,C3EC43179E51E2CA8AF203A259981D18,30854,13,14,1,109.56889,18.27076,1763
38238,285630,C3EC43179E51E2CA8AF203A259981D18,39091,15,17,2,109.50097,18.25222,1510
38239,285631,C3EC43179E51E2CA8AF203A259981D18,30854,19,20,1,109.56889,18.27076,1763
38240,285635,C83989AE2DFF8530CB3DF7DC45038FE9,60501,1,3,2,109.48701,18.29021,1466
38241,285636,C83989AE2DFF8530CB3DF7DC45038FE9,60401,3,4,1,109.47444,18.27583,1414
38242,285637,C83989AE2DFF8530CB3DF7DC45038FE9,60501,5,6,1,109.48701,18.29021,1466
38243,285638,C83989AE2DFF8530CB3DF7DC45038FE9,60381,9,12,3,109.5241,18.22458,1605
38244,285639,C83989AE2DFF8530CB3DF7DC45038FE9,38094,17,20,3,109.45403,18.28778,1316
38245,285640,D42D82F7F77C55013F0EAB7E35E2211F,31071,3,12,9,109.58257,18.28458,1815
38246,285641,D42D82F7F77C55013F0EAB7E35E2211F,30531,14,22,8,109.53271,18.21472,1604
38250,285662,D39D64452E6BBEF7B3056CA239E1B86E,30854,5,6,1,109.56889,18.27076,1763
38251,285663,D39D64452E6BBEF7B3056CA239E1B86E,31561,6,11,5,109.56792,18.28479,1765
38252,285664,D39D64452E6BBEF7B3056CA239E1B86E,30854,12,14,2,109.56889,18.27076,1763
38253,285665,D39D64452E6BBEF7B3056CA239E1B86E,31561,14,16,2,109.56792,18.28479,1765
38254,285666,D39D64452E6BBEF7B3056CA239E1B86E,30854,20,21,1,109.56889,18.27076,1763
38255,285674,DB798956536E34BEF89E44767CA861D4,38707,14,21,7,109.73778,18.35368,2427
38256,285675,DB798956536E34BEF89E44767CA861D4,38707,22,23,1,109.73778,18.35368,2427
38257,285683,6AB767DCB04AF3E40F2C84ECB27A5395,30421,0,6,6,109.50021,18.25861,1511
38258,285684,6AB767DCB04AF3E40F2C84ECB27A5395,30611,6,7,1,109.74958,18.40188,2485
38259,285709,CF90889F587C2BB558DFC8DC65DE1B88,31471,15,16,1,109.34583,18.29563,917
38260,285710,CF90889F587C2BB558DFC8DC65DE1B88,38071,18,20,2,109.40722,18.30938,1169
38261,285735,8B3BFB924B3B7EA2496E534FC9BE57E6,31461,0,7,7,109.5091,18.25389,1510
38262,285736,8B3BFB924B3B7EA2496E534FC9BE57E6,30281,8,9,1,109.50597,18.27583,1514
38263,285740,34AB502A442AA8EA4A7FB30471B204DB,39061,1,2,1,109.38222,18.28958,1066
38264,285741,34AB502A442AA8EA4A7FB30471B204DB,60621,2,7,5,109.48354,18.27451,1464
38265,285742,34AB502A442AA8EA4A7FB30471B204DB,60401,8,11,3,109.47444,18.27583,1414
38266,285743,34AB502A442AA8EA4A7FB30471B204DB,60621,15,17,2,109.48354,18.27451,1464
38267,285744,34AB502A442AA8EA4A7FB30471B204DB,60401,19,20,1,109.47444,18.27583,1414
38268,285745,34AB502A442AA8EA4A7FB30471B204DB,60621,21,23,2,109.48354,18.27451,1464
38269,285772,8BE0A55E9934E22BDB38595AA5D1AD74,30531,3,7,4,109.53271,18.21472,1604
38270,285777,6FDD8510FC3FD17D36965B0963BD7329,30854,0,5,5,109.56889,18.27076,1763
38271,285778,6FDD8510FC3FD17D36965B0963BD7329,31561,6,7,1,109.56792,18.28479,1765
38272,285779,6FDD8510FC3FD17D36965B0963BD7329,30854,8,11,3,109.56889,18.27076,1763
38273,285780,6FDD8510FC3FD17D36965B0963BD7329,31561,12,16,4,109.56792,18.28479,1765
38274,285781,6FDD8510FC3FD17D36965B0963BD7329,30854,20,22,2,109.56889,18.27076,1763
38275,285782,6FDD8510FC3FD17D36965B0963BD7329,39371,22,23,1,109.56627,18.2646,1762
38276,285783,4BCFB9B7DA47F954D069C9FF9050BF88,31071,7,9,2,109.58257,18.28458,1815
38277,285784,4BCFB9B7DA47F954D069C9FF9050BF88,30854,11,12,1,109.56889,18.27076,1763
38278,285785,4BCFB9B7DA47F954D069C9FF9050BF88,31071,13,15,2,109.58257,18.28458,1815
38279,285829,EA0A0AF0068B5147927AE92739E130DD,38951,0,8,8,109.48097,18.28868,1416
38280,285830,EA0A0AF0068B5147927AE92739E130DD,60614,10,11,1,109.48799,18.29521,1467
38281,285831,EA0A0AF0068B5147927AE92739E130DD,30581,12,14,2,109.62257,18.24951,1959
38282,285832,EA0A0AF0068B5147927AE92739E130DD,38951,18,23,5,109.48097,18.28868,1416
38283,285833,F8270512EC6061AB32BEF04D77D542E3,31531,0,11,11,109.49583,18.25972,1461
38284,285834,F8270512EC6061AB32BEF04D77D542E3,60054,13,14,1,109.3016,18.31229,770
38285,285835,F8270512EC6061AB32BEF04D77D542E3,31531,17,23,6,109.49583,18.25972,1461
38292,285863,498749BB2BA481D5A422CC677A8DD529,38013,16,17,1,109.49514,18.21951,1454
38293,285864,498749BB2BA481D5A422CC677A8DD529,60201,17,22,5,109.5041,18.2509,1510
38297,285908,351B393D9DF8729A4AFCF776A3D974C6,60054,17,18,1,109.3016,18.31229,770
38298,285909,351B393D9DF8729A4AFCF776A3D974C6,30661,19,23,4,109.37028,18.24361,1008
38299,285912,DF296B63A64E364FCDA4C38B0935EEEE,30511,0,15,15,109.51069,18.24208,1558
38300,285913,DF296B63A64E364FCDA4C38B0935EEEE,30511,17,23,6,109.51069,18.24208,1558
38301,285919,8F99FBAD46040867B6C8F52DEFB54488,60621,0,8,8,109.48354,18.27451,1464
38302,285920,8F99FBAD46040867B6C8F52DEFB54488,31681,10,14,4,109.40396,18.29979,1168
38303,285921,8F99FBAD46040867B6C8F52DEFB54488,60541,14,16,2,109.4084,18.29208,1167
38311,285982,06A941D50D485A4C433548955BEB89BA,30854,12,17,5,109.56889,18.27076,1763
38312,285983,06A941D50D485A4C433548955BEB89BA,31071,22,23,1,109.58257,18.28458,1815
38313,285986,E75FA91D1B3B8DD834D1B7D77ECFF056,39321,0,7,7,109.529,18.2167,1604
38314,285987,E75FA91D1B3B8DD834D1B7D77ECFF056,31521,8,10,2,109.51458,18.22542,1555
38315,285988,E75FA91D1B3B8DD834D1B7D77ECFF056,30661,11,15,4,109.37028,18.24361,1008
38316,285989,E75FA91D1B3B8DD834D1B7D77ECFF056,30361,19,20,1,109.50347,18.24,1508
38317,286008,3577995E8CD33652301277CD38C2DCFC,60551,18,20,2,109.42722,18.30111,1218
38318,286009,3577995E8CD33652301277CD38C2DCFC,31061,21,23,2,109.53333,18.23257,1607
38319,286010,4E42F3C8BFACF58FB6187931BEBBDF23,30711,19,20,1,109.50271,18.25347,1510
38320,286011,4E42F3C8BFACF58FB6187931BEBBDF23,38484,22,23,1,109.53028,18.31528,1620
38325,286147,B0E2159906E2F066EA26580E9E3FC6C5,31031,15,17,2,109.49979,18.25382,1510
38326,286148,B0E2159906E2F066EA26580E9E3FC6C5,30341,18,20,2,109.3625,18.29167,966
38327,286149,B0E2159906E2F066EA26580E9E3FC6C5,39061,21,23,2,109.38222,18.28958,1066
38328,286161,5291560AC3CA28497E4CB7832DDE2A8C,38754,14,16,2,109.74667,18.37382,2430
38329,286165,CC6A63734928B4CD8F414AAB01241B9F,31311,14,23,9,109.72299,18.27438,2364
38330,286191,EF5798057F15484DEF72C8FF2C7F52C1,30111,0,7,7,109.47583,18.30542,1419
38331,286192,EF5798057F15484DEF72C8FF2C7F52C1,38361,7,8,1,109.43667,18.29201,1267
38332,286193,EF5798057F15484DEF72C8FF2C7F52C1,31781,13,15,2,109.19847,18.2975,367
38333,286194,EF5798057F15484DEF72C8FF2C7F52C1,30421,18,20,2,109.50021,18.25861,1511
38334,286195,EF5798057F15484DEF72C8FF2C7F52C1,38361,21,22,1,109.43667,18.29201,1267
38335,286224,B409DEC5C276D0BBD1EAC5AE6529019E,31101,0,8,8,109.65389,18.23403,2057
38336,286225,B409DEC5C276D0BBD1EAC5AE6529019E,31471,11,13,2,109.34583,18.29563,917
38337,286226,B409DEC5C276D0BBD1EAC5AE6529019E,30421,16,18,2,109.50021,18.25861,1511
38338,286227,B409DEC5C276D0BBD1EAC5AE6529019E,31101,19,23,4,109.65389,18.23403,2057
38339,286273,423E2A7AD06C927EE0BD23EE3AB605E3,30854,0,11,11,109.56889,18.27076,1763
38340,286274,423E2A7AD06C927EE0BD23EE3AB605E3,30681,12,22,10,109.48493,18.26917,1463
38348,286373,A749E400BFD3B5908671E939EC104DEE,30854,0,1,1,109.56889,18.27076,1763
38349,286374,A749E400BFD3B5908671E939EC104DEE,31071,1,5,4,109.58257,18.28458,1815
38350,286375,A749E400BFD3B5908671E939EC104DEE,30854,6,8,2,109.56889,18.27076,1763
38351,286376,A749E400BFD3B5908671E939EC104DEE,31071,11,13,2,109.58257,18.28458,1815
38352,286377,A749E400BFD3B5908671E939EC104DEE,30854,13,23,10,109.56889,18.27076,1763
38356,286381,8ED1BCC2D2A319298B3669D3F81BDCBA,30071,13,15,2,109.52819,18.30472,1619
38357,286382,8ED1BCC2D2A319298B3669D3F81BDCBA,60361,15,16,1,109.51938,18.29681,1567
38358,286383,8ED1BCC2D2A319298B3669D3F81BDCBA,60241,20,23,3,109.53319,18.28667,1616
38359,286384,F25102D4BE48A66B8AE50787215C5331,31231,13,14,1,109.42597,18.29292,1217
38360,286385,F25102D4BE48A66B8AE50787215C5331,31231,15,18,3,109.42597,18.29292,1217
38364,286434,608A55C14BAB2A5B627ACC1F39B89FB6,31945,0,7,7,109.58021,18.29403,1817
38365,286435,608A55C14BAB2A5B627ACC1F39B89FB6,30854,8,12,4,109.56889,18.27076,1763
38366,286436,608A55C14BAB2A5B627ACC1F39B89FB6,60291,15,16,1,109.50826,18.24639,1509
38367,286437,608A55C14BAB2A5B627ACC1F39B89FB6,31945,21,23,2,109.58021,18.29403,1817
38368,286453,DF7D05791F495697561E86BE7F56BDEA,48574,0,5,5,109.48931,18.28458,1465
38369,286454,DF7D05791F495697561E86BE7F56BDEA,31864,7,8,1,109.49014,18.28333,1465
38370,286455,DF7D05791F495697561E86BE7F56BDEA,31145,13,14,1,109.20431,18.30479,369
38371,286502,10EBF762D28520B09848288F7052CFDE,30854,1,6,5,109.56889,18.27076,1763
38372,286503,10EBF762D28520B09848288F7052CFDE,39101,7,15,8,109.50132,18.24931,1509
38373,286504,10EBF762D28520B09848288F7052CFDE,30161,15,17,2,109.50042,18.24389,1508
38374,286505,10EBF762D28520B09848288F7052CFDE,30854,17,20,3,109.56889,18.27076,1763
38375,286518,6E6193514D8E876D83956A94AD4F3FB1,31931,11,13,2,109.54771,18.29403,1667
38376,286519,6E6193514D8E876D83956A94AD4F3FB1,30921,14,16,2,109.53903,18.29451,1667
38377,286520,6E6193514D8E876D83956A94AD4F3FB1,31931,17,22,5,109.54771,18.29403,1667
38378,286524,F96F24B681A63D2B4D1EB8E140BFDADD,60291,0,1,1,109.50826,18.24639,1509
38379,286525,F96F24B681A63D2B4D1EB8E140BFDADD,60371,2,13,11,109.53063,18.30056,1618
38380,286526,F96F24B681A63D2B4D1EB8E140BFDADD,30764,16,18,2,109.45806,18.29486,1367
38381,286527,F96F24B681A63D2B4D1EB8E140BFDADD,30391,21,23,2,109.4975,18.27118,1513
38382,286619,B621E9075674E792CCB217233825F9D1,60591,16,17,1,109.61118,18.21715,1904
38383,286620,B621E9075674E792CCB217233825F9D1,30854,20,21,1,109.56889,18.27076,1763
38384,286621,0B1C0030B7865DFAE9344BEBBB9387DA,31701,20,22,2,109.44132,18.28833,1266
38385,286622,0B1C0030B7865DFAE9344BEBBB9387DA,38871,22,23,1,109.44681,18.28625,1316
38386,286652,4FF898565DD7944316E0D48964B03B74,60631,0,7,7,109.57778,18.27583,1814
38387,286653,4FF898565DD7944316E0D48964B03B74,38754,11,13,2,109.74667,18.37382,2430
38388,286661,87F903487927969F9F9804112E5F8E6C,31551,12,13,1,109.55868,18.24222,1708
38389,286662,87F903487927969F9F9804112E5F8E6C,31554,13,15,2,109.55521,18.2459,1709
38390,286663,87F903487927969F9F9804112E5F8E6C,31551,15,23,8,109.55868,18.24222,1708
38391,286672,FD383D619F571E97F6F509FAB965E5A5,31945,12,13,1,109.58021,18.29403,1817
38392,286673,FD383D619F571E97F6F509FAB965E5A5,60571,14,15,1,109.50722,18.25056,1510
38393,286674,FD383D619F571E97F6F509FAB965E5A5,30711,18,19,1,109.50271,18.25347,1510
38394,286675,FD383D619F571E97F6F509FAB965E5A5,60571,20,23,3,109.50722,18.25056,1510
38399,286685,7AF4921BC4D1712A961904D0ECC91550,30071,19,20,1,109.52819,18.30472,1619
38400,286686,7AF4921BC4D1712A961904D0ECC91550,60251,21,23,2,109.51229,18.325,1572
38401,286687,0F558B6653C655C7F0BAEA9D66B33F57,31071,2,5,3,109.58257,18.28458,1815
38402,286688,0F558B6653C655C7F0BAEA9D66B33F57,30854,10,14,4,109.56889,18.27076,1763
38403,286689,1026894DC5FF9A7FAF3A2EE28B95E239,39183,0,7,7,109.55542,18.28208,1715
38404,286690,1026894DC5FF9A7FAF3A2EE28B95E239,30854,12,22,10,109.56889,18.27076,1763
38405,286691,F9F2694056D54C70B8E94D439CF649C0,38331,0,10,10,109.62465,18.22736,1956
38406,286692,F9F2694056D54C70B8E94D439CF649C0,30961,12,13,1,109.74042,18.37903,2431
38407,286693,F9F2694056D54C70B8E94D439CF649C0,38331,15,17,2,109.62465,18.22736,1956
38408,286694,F9F2694056D54C70B8E94D439CF649C0,30421,20,21,1,109.50021,18.25861,1511
38409,286706,7421066246AAD1C230E7E2A7ADF06E9D,30854,13,17,4,109.56889,18.27076,1763
38410,286707,7421066246AAD1C230E7E2A7ADF06E9D,60631,19,23,4,109.57778,18.27583,1814
38411,286721,038CFE3BAB72C52C0044D8CB5F2DC114,31271,0,7,7,109.48958,18.26257,1462
38412,286722,038CFE3BAB72C52C0044D8CB5F2DC114,31781,9,11,2,109.19847,18.2975,367
38413,286723,038CFE3BAB72C52C0044D8CB5F2DC114,31471,13,15,2,109.34583,18.29563,917
38414,286732,76BE31A5F3F086E80A8D63C4F3D6881F,38241,12,23,11,109.54111,18.30542,1669
38415,286737,A01B4012B619D942E7CC3AC9B78722B4,31561,0,1,1,109.56792,18.28479,1765
38416,286738,A01B4012B619D942E7CC3AC9B78722B4,30854,1,2,1,109.56889,18.27076,1763
38417,286739,A01B4012B619D942E7CC3AC9B78722B4,39181,5,7,2,109.55153,18.28035,1715
38418,286740,A01B4012B619D942E7CC3AC9B78722B4,39183,7,8,1,109.55542,18.28208,1715
38419,286741,A01B4012B619D942E7CC3AC9B78722B4,31561,11,12,1,109.56792,18.28479,1765
38420,286742,A01B4012B619D942E7CC3AC9B78722B4,31931,13,16,3,109.54771,18.29403,1667
38421,286743,A01B4012B619D942E7CC3AC9B78722B4,31561,19,23,4,109.56792,18.28479,1765
38422,286762,417408FFDA93B177641D270D3A5C4B2D,30854,6,9,3,109.56889,18.27076,1763
38423,286763,417408FFDA93B177641D270D3A5C4B2D,31071,12,23,11,109.58257,18.28458,1815
38424,286768,A01E2FD84FFE4D782E40311D1ABC1ECB,39053,0,15,15,109.511,18.2771,1564
38425,286769,A01E2FD84FFE4D782E40311D1ABC1ECB,60171,16,17,1,109.51292,18.30694,1569
38426,286773,9B2F541E3AA85490CB47FF66EE68B366,60621,0,7,7,109.48354,18.27451,1464
38427,286774,9B2F541E3AA85490CB47FF66EE68B366,30661,10,12,2,109.37028,18.24361,1008
38428,286775,9B2F541E3AA85490CB47FF66EE68B366,60054,12,14,2,109.3016,18.31229,770
38429,286829,657A4EA3E74EF96B5CC254B1107F90DF,31461,10,21,11,109.5091,18.25389,1510
38430,286830,657A4EA3E74EF96B5CC254B1107F90DF,30721,21,22,1,109.51597,18.28257,1565
38431,286831,A4743972EC2FC58546DD11935BDC0E1A,31091,0,1,1,109.41201,18.31222,1170
38432,286832,A4743972EC2FC58546DD11935BDC0E1A,39091,2,5,3,109.50097,18.25222,1510
38433,286833,A4743972EC2FC58546DD11935BDC0E1A,39091,9,19,10,109.50097,18.25222,1510
38438,286920,D4448A1349B0563C78F16B479359A95F,30854,14,19,5,109.56889,18.27076,1763
38439,286921,D4448A1349B0563C78F16B479359A95F,31945,22,23,1,109.58021,18.29403,1817
38440,286932,D2A5F87218CF25385163A2F3C4229CB8,30851,0,4,4,109.5616,18.27396,1713
38441,286933,D2A5F87218CF25385163A2F3C4229CB8,31561,5,14,9,109.56792,18.28479,1765
38442,286944,DF49F834C08C7E8FA6D78272EE1FB651,60361,0,7,7,109.51938,18.29681,1567
38443,286945,DF49F834C08C7E8FA6D78272EE1FB651,30951,8,14,6,109.56208,18.25667,1761
38444,286946,DF49F834C08C7E8FA6D78272EE1FB651,60221,18,20,2,109.52569,18.29188,1616
38445,286947,DF49F834C08C7E8FA6D78272EE1FB651,60361,21,23,2,109.51938,18.29681,1567
38446,286948,8438CC455C7563000E5EA4C29E329C92,38105,0,1,1,109.40299,18.29229,1117
38447,286949,8438CC455C7563000E5EA4C29E329C92,30661,1,4,3,109.37028,18.24361,1008
38448,286950,8438CC455C7563000E5EA4C29E329C92,60301,9,10,1,109.60715,18.30993,1919
38449,286951,8438CC455C7563000E5EA4C29E329C92,31031,13,14,1,109.49979,18.25382,1510
38450,286952,8438CC455C7563000E5EA4C29E329C92,60541,15,18,3,109.4084,18.29208,1167
38455,286972,5D568A6526CDB002A506317E6EBEA84B,39091,12,13,1,109.50097,18.25222,1510
38456,286973,5D568A6526CDB002A506317E6EBEA84B,31101,16,18,2,109.65389,18.23403,2057
38457,286974,5D568A6526CDB002A506317E6EBEA84B,38094,22,23,1,109.45403,18.28778,1316
38458,286986,BD4652414D5C17466BA36FD4BD943A94,30721,1,5,4,109.51597,18.28257,1565
38459,286987,BD4652414D5C17466BA36FD4BD943A94,60221,5,7,2,109.52569,18.29188,1616
38460,286988,BD4652414D5C17466BA36FD4BD943A94,31931,9,15,6,109.54771,18.29403,1667
38461,286989,BD4652414D5C17466BA36FD4BD943A94,39183,17,18,1,109.55542,18.28208,1715
38462,286990,BD4652414D5C17466BA36FD4BD943A94,30421,20,22,2,109.50021,18.25861,1511
38466,287030,F6B4440E38BBCA4B2FC80E6C91E4573A,60381,18,19,1,109.5241,18.22458,1605
38467,287031,F6B4440E38BBCA4B2FC80E6C91E4573A,38111,20,22,2,109.52007,18.22403,1555
38468,287039,D517610C2076C41FED0ED80CB6FFB44C,31561,0,4,4,109.56792,18.28479,1765
38469,287040,D517610C2076C41FED0ED80CB6FFB44C,30851,4,20,16,109.5616,18.27396,1713
38470,287071,528F99F7FD8CA49B85B45B64A5D784BA,39183,0,1,1,109.55542,18.28208,1715
38471,287072,528F99F7FD8CA49B85B45B64A5D784BA,30851,1,6,5,109.5616,18.27396,1713
38472,287073,528F99F7FD8CA49B85B45B64A5D784BA,39183,6,9,3,109.55542,18.28208,1715
38473,287074,528F99F7FD8CA49B85B45B64A5D784BA,30851,12,18,6,109.5616,18.27396,1713
38474,287075,528F99F7FD8CA49B85B45B64A5D784BA,39183,20,22,2,109.55542,18.28208,1715
38475,287080,6128117B6C62D97BBF6E959D2F3E0A2E,39181,0,5,5,109.55153,18.28035,1715
38476,287081,6128117B6C62D97BBF6E959D2F3E0A2E,39183,7,8,1,109.55542,18.28208,1715
38477,287082,6128117B6C62D97BBF6E959D2F3E0A2E,39181,10,13,3,109.55153,18.28035,1715
38478,287083,6128117B6C62D97BBF6E959D2F3E0A2E,39181,14,16,2,109.55153,18.28035,1715
38479,287084,6128117B6C62D97BBF6E959D2F3E0A2E,39181,17,23,6,109.55153,18.28035,1715
38486,287168,324899445F811D5785FB336DE18DAC0E,38251,0,5,5,109.49618,18.25493,1510
38487,287173,B3F4E43DA3C4E855A3ED684A6CB97F36,31101,11,13,2,109.65389,18.23403,2057
38488,287174,B3F4E43DA3C4E855A3ED684A6CB97F36,31931,16,18,2,109.54771,18.29403,1667
38489,287175,B3F4E43DA3C4E855A3ED684A6CB97F36,30921,18,20,2,109.53903,18.29451,1667
38490,287176,7B2AEE2086698683607EDDDB4B678234,60241,0,6,6,109.53319,18.28667,1616
38491,287177,7B2AEE2086698683607EDDDB4B678234,38154,11,21,10,109.5266,18.28278,1615
38496,287219,2A6BA0678DDF16AF08BAC9E3FA3C9391,30854,0,1,1,109.56889,18.27076,1763
38497,287220,2A6BA0678DDF16AF08BAC9E3FA3C9391,31561,2,6,4,109.56792,18.28479,1765
38498,287221,2A6BA0678DDF16AF08BAC9E3FA3C9391,30854,8,10,2,109.56889,18.27076,1763
38499,287222,2A6BA0678DDF16AF08BAC9E3FA3C9391,60631,13,15,2,109.57778,18.27583,1814
38500,287223,2A6BA0678DDF16AF08BAC9E3FA3C9391,30854,19,21,2,109.56889,18.27076,1763
38501,287224,2A6BA0678DDF16AF08BAC9E3FA3C9391,31561,22,23,1,109.56792,18.28479,1765
38502,287238,CD5E350ACE5E316FFBEE8002214CC92F,38951,0,2,2,109.48097,18.28868,1416
38503,287239,CD5E350ACE5E316FFBEE8002214CC92F,60614,2,3,1,109.48799,18.29521,1467
38504,287240,CD5E350ACE5E316FFBEE8002214CC92F,38951,4,7,3,109.48097,18.28868,1416
38505,287241,CD5E350ACE5E316FFBEE8002214CC92F,33051,11,13,2,109.6475,18.46618,2096
38506,287279,75817DB682187A07461734D66E1E6492,60631,16,17,1,109.57778,18.27583,1814
38507,287280,75817DB682187A07461734D66E1E6492,31061,19,21,2,109.53333,18.23257,1607
38508,287281,75817DB682187A07461734D66E1E6492,60631,22,23,1,109.57778,18.27583,1814
38509,287288,66E3180E5EB7A1180EBED2610556A747,30854,9,13,4,109.56889,18.27076,1763
38510,287289,66E3180E5EB7A1180EBED2610556A747,38071,15,16,1,109.40722,18.30938,1169
38511,287307,005F3AEFE6DBF371ED1FD57736434098,31071,0,7,7,109.58257,18.28458,1815
38512,287308,005F3AEFE6DBF371ED1FD57736434098,30854,7,16,9,109.56889,18.27076,1763
38513,287309,005F3AEFE6DBF371ED1FD57736434098,31461,18,20,2,109.5091,18.25389,1510
38514,287331,23F112CDAD42EDA0343C8378CD8AF33B,30071,15,19,4,109.52819,18.30472,1619
38515,287332,23F112CDAD42EDA0343C8378CD8AF33B,30761,20,23,3,109.45201,18.3,1318
38516,287347,05DA91756164E5EE566D718E5FCD0EDE,31021,6,8,2,109.49021,18.27,1463
38517,287348,05DA91756164E5EE566D718E5FCD0EDE,30921,11,12,1,109.53903,18.29451,1667
38518,287349,05DA91756164E5EE566D718E5FCD0EDE,31931,16,22,6,109.54771,18.29403,1667
38519,287364,28CEE342E171AF6D7A347D19C045375D,31031,12,13,1,109.49979,18.25382,1510
38520,287365,28CEE342E171AF6D7A347D19C045375D,60131,14,16,2,109.49819,18.24778,1509
38521,287366,28CEE342E171AF6D7A347D19C045375D,38251,17,19,2,109.49618,18.25493,1510
38522,287367,28CEE342E171AF6D7A347D19C045375D,60131,19,22,3,109.49819,18.24778,1509
38523,287381,8D8AA41210FC9E2D5DD4D81CF4DB18D7,31261,18,20,2,109.51174,18.2466,1559
38524,287382,8D8AA41210FC9E2D5DD4D81CF4DB18D7,60371,21,23,2,109.53063,18.30056,1618
38525,287383,2C55471E74B61CE990E34C5B57C44227,30661,12,14,2,109.37028,18.24361,1008
38526,287384,2C55471E74B61CE990E34C5B57C44227,31471,17,18,1,109.34583,18.29563,917
38527,287385,2C55471E74B61CE990E34C5B57C44227,31531,21,23,2,109.49583,18.25972,1461
38531,287393,5E97A4561E11AAC4FBC53FD068EAA52B,30854,0,7,7,109.56889,18.27076,1763
38532,287394,5E97A4561E11AAC4FBC53FD068EAA52B,30531,11,18,7,109.53271,18.21472,1604
38533,287395,5E97A4561E11AAC4FBC53FD068EAA52B,30854,21,23,2,109.56889,18.27076,1763
38537,287419,E6541B4F346982101D887BAAF0315541,30854,0,7,7,109.56889,18.27076,1763
38538,287420,E6541B4F346982101D887BAAF0315541,31561,11,17,6,109.56792,18.28479,1765
38539,287463,B643AC77F8D8498A9694D45BA8B0F75F,60631,6,16,10,109.57778,18.27583,1814
38540,287464,B643AC77F8D8498A9694D45BA8B0F75F,31561,20,21,1,109.56792,18.28479,1765
38541,287473,46D654A74218E904EECC2C762753A449,30721,0,7,7,109.51597,18.28257,1565
38542,287474,46D654A74218E904EECC2C762753A449,31471,8,20,12,109.34583,18.29563,917
38543,287475,46D654A74218E904EECC2C762753A449,31471,20,23,3,109.34583,18.29563,917
38544,287476,7252A0F90E29EC78621699C082578EF7,60504,17,18,1,109.47917,18.28903,1416
38545,287477,7252A0F90E29EC78621699C082578EF7,30711,21,23,2,109.50271,18.25347,1510
38546,287487,CE70D3AAC3EF6B01DB8A5F34BD94E77D,30821,0,5,5,109.43681,18.33639,1274
38547,287488,CE70D3AAC3EF6B01DB8A5F34BD94E77D,30651,6,9,3,109.42611,18.385,1232
38552,287521,40DABE6BE6CCF789940333375D2A2151,31101,14,15,1,109.65389,18.23403,2057
38553,287522,40DABE6BE6CCF789940333375D2A2151,31431,16,18,2,109.44639,18.29042,1316
38554,287523,40DABE6BE6CCF789940333375D2A2151,38871,19,23,4,109.44681,18.28625,1316
38555,287533,373156888A7658CC58BA3E147DEF7EF4,30361,0,5,5,109.50347,18.24,1508
38556,287534,373156888A7658CC58BA3E147DEF7EF4,31201,6,11,5,109.51042,18.23819,1558
38557,287535,373156888A7658CC58BA3E147DEF7EF4,30361,11,13,2,109.50347,18.24,1508
38558,287536,373156888A7658CC58BA3E147DEF7EF4,31201,13,17,4,109.51042,18.23819,1558
38559,287537,373156888A7658CC58BA3E147DEF7EF4,31391,19,23,4,109.50382,18.24285,1508
38560,287549,27BCEF3137923B84211F08830816C810,31561,20,21,1,109.56792,18.28479,1765
38561,287598,4995463B780282C9C030A19D9F49AEAC,31071,0,7,7,109.58257,18.28458,1815
38562,287599,4995463B780282C9C030A19D9F49AEAC,30854,7,13,6,109.56889,18.27076,1763
38563,287600,3B291F57EEFD567A00FF0922580412BD,60054,13,14,1,109.3016,18.31229,770
38564,287601,3B291F57EEFD567A00FF0922580412BD,31431,17,19,2,109.44639,18.29042,1316
38565,287602,3B291F57EEFD567A00FF0922580412BD,31061,21,23,2,109.53333,18.23257,1607
38566,287615,4E94ADAE7ABEB20EEFAF67519DFCC1BE,31081,0,8,8,109.44639,18.30181,1318
38567,287616,4E94ADAE7ABEB20EEFAF67519DFCC1BE,31031,9,22,13,109.49979,18.25382,1510
38568,287620,3A5B976B6C5A145A5BAEFCC99C78F339,30071,3,9,6,109.52819,18.30472,1619
38569,287621,3A5B976B6C5A145A5BAEFCC99C78F339,31931,11,22,11,109.54771,18.29403,1667
38573,287674,6FBDDF7419820F8908B8A8CE3C81E7C3,60401,16,21,5,109.47444,18.27583,1414
38574,287675,6FBDDF7419820F8908B8A8CE3C81E7C3,30171,21,23,2,109.48458,18.27139,1463
38575,287706,F198CAA1F49ACA5D003FD8F8473B3798,31071,18,19,1,109.58257,18.28458,1815
38576,287707,F198CAA1F49ACA5D003FD8F8473B3798,30854,19,21,2,109.56889,18.27076,1763
38577,287710,F746BB1DA8AF798983E08F7CB247A82F,38251,18,21,3,109.49618,18.25493,1510
38578,287711,F746BB1DA8AF798983E08F7CB247A82F,60131,21,23,2,109.49819,18.24778,1509
38579,287738,C860767955774E3494068CF38C009FB6,60391,0,9,9,109.47667,18.28757,1416
38580,287739,C860767955774E3494068CF38C009FB6,31061,9,16,7,109.53333,18.23257,1607
38581,287740,C860767955774E3494068CF38C009FB6,60391,17,18,1,109.47667,18.28757,1416
38582,287741,C860767955774E3494068CF38C009FB6,31864,18,20,2,109.49014,18.28333,1465
38583,287761,DAB08D254D49BF150533311BD904D49C,31521,0,8,8,109.51458,18.22542,1555
38584,287762,DAB08D254D49BF150533311BD904D49C,30771,9,10,1,109.49938,18.26042,1511
38585,287763,DAB08D254D49BF150533311BD904D49C,60381,13,16,3,109.5241,18.22458,1605
38586,287764,DAB08D254D49BF150533311BD904D49C,38185,19,20,1,109.51333,18.27347,1563
38587,287765,DAB08D254D49BF150533311BD904D49C,60381,22,23,1,109.5241,18.22458,1605
38595,287798,941A5C38F4BF0495FDCAE8C1D6E4B8DA,30854,12,15,3,109.56889,18.27076,1763
38596,287799,941A5C38F4BF0495FDCAE8C1D6E4B8DA,39371,19,23,4,109.56627,18.2646,1762
38597,287800,35C6EDC8AAC6B5ABA770190223528BA2,60381,16,18,2,109.5241,18.22458,1605
38598,287801,35C6EDC8AAC6B5ABA770190223528BA2,31091,19,21,2,109.41201,18.31222,1170
38599,287816,46EBA833B325DCE5EE258C5988AE07F0,31461,19,20,1,109.5091,18.25389,1510
38600,287817,46EBA833B325DCE5EE258C5988AE07F0,31231,20,23,3,109.42597,18.29292,1217
38601,287818,5CF385399776EC46A3F5DCDA63D16AEB,31701,16,18,2,109.44132,18.28833,1266
38602,287819,5CF385399776EC46A3F5DCDA63D16AEB,31031,20,21,1,109.49979,18.25382,1510
38603,287857,C42D2C8010DF16606218846412B7033D,31471,13,14,1,109.34583,18.29563,917
38604,287858,C42D2C8010DF16606218846412B7033D,38903,17,23,6,109.39229,18.29243,1117
38605,287889,77E0479537D8350123531CE1FA2E6649,60631,1,7,6,109.57778,18.27583,1814
38606,287890,77E0479537D8350123531CE1FA2E6649,60591,10,13,3,109.61118,18.21715,1904
38607,287899,FB69127E95B4D9EC5AF61282F8D7EEB7,31071,2,7,5,109.58257,18.28458,1815
38608,287900,FB69127E95B4D9EC5AF61282F8D7EEB7,30854,7,22,15,109.56889,18.27076,1763
38612,287905,0E0D6E55BB1995EBF85F6B7AA8765E55,30854,2,15,13,109.56889,18.27076,1763
38613,287906,0E0D6E55BB1995EBF85F6B7AA8765E55,38271,15,22,7,109.62632,18.23049,1956
38617,287925,C711EA8F4B039EAC279F7CFC24309A8A,30071,18,23,5,109.52819,18.30472,1619
38628,288014,241E5A09B6952F478B1503601C11534A,30361,8,9,1,109.50347,18.24,1508
38629,288015,241E5A09B6952F478B1503601C11534A,31471,14,15,1,109.34583,18.29563,917
38630,288016,241E5A09B6952F478B1503601C11534A,31411,19,20,1,109.5016,18.23576,1507
38631,288017,241E5A09B6952F478B1503601C11534A,30361,20,22,2,109.50347,18.24,1508
38635,288030,47D232A92516FC961C7881B5391F911A,30711,16,18,2,109.50271,18.25347,1510
38636,288031,47D232A92516FC961C7881B5391F911A,30861,18,20,2,109.52722,18.22743,1606
38637,288047,999622F1021C0E47F73CE0E79CF81156,60381,19,23,4,109.5241,18.22458,1605
38642,288121,E34C10F1C8BC04C7EF99531DA4E2FBE8,30211,0,7,7,109.49882,18.23931,1508
38647,288168,94C4D5691F7DFC1AB38806AFFAC1389E,31931,0,18,18,109.54771,18.29403,1667
38648,288169,94C4D5691F7DFC1AB38806AFFAC1389E,30921,19,20,1,109.53903,18.29451,1667
38649,288176,C3EF49B0098C6C3C4B26CC8869DE86AF,30854,0,6,6,109.56889,18.27076,1763
38650,288177,C3EF49B0098C6C3C4B26CC8869DE86AF,38271,8,15,7,109.62632,18.23049,1956
38651,288178,C3EF49B0098C6C3C4B26CC8869DE86AF,30854,18,23,5,109.56889,18.27076,1763
38652,288200,8AD9F37216B2D3FCE05CA77434307672,30741,0,8,8,109.49833,18.28681,1516
38653,288201,8AD9F37216B2D3FCE05CA77434307672,31181,9,11,2,109.50382,18.24813,1509
38654,288202,8AD9F37216B2D3FCE05CA77434307672,30361,11,12,1,109.50347,18.24,1508
38655,288203,8AD9F37216B2D3FCE05CA77434307672,30281,15,19,4,109.50597,18.27583,1514
38656,288204,8AD9F37216B2D3FCE05CA77434307672,30741,19,23,4,109.49833,18.28681,1516
38666,288245,E8D51F8B53F290BFD73338AD2AD8C728,31561,4,5,1,109.56792,18.28479,1765
38667,288246,E8D51F8B53F290BFD73338AD2AD8C728,39181,9,10,1,109.55153,18.28035,1715
38668,288247,E8D51F8B53F290BFD73338AD2AD8C728,31561,12,13,1,109.56792,18.28479,1765
38669,288248,E8D51F8B53F290BFD73338AD2AD8C728,39183,13,14,1,109.55542,18.28208,1715
38670,288249,E8D51F8B53F290BFD73338AD2AD8C728,31931,17,18,1,109.54771,18.29403,1667
38671,288250,E8D51F8B53F290BFD73338AD2AD8C728,31561,21,23,2,109.56792,18.28479,1765
38672,288257,0D7276B6F8E1595E83AAC767A2E9D621,30201,19,20,1,109.4909,18.26465,1462
38673,288258,0D7276B6F8E1595E83AAC767A2E9D621,31551,22,23,1,109.55868,18.24222,1708
38677,288290,7D6FE1595F0739472239550151E87F8D,30341,15,16,1,109.3625,18.29167,966
38678,288291,7D6FE1595F0739472239550151E87F8D,38951,17,22,5,109.48097,18.28868,1416
38679,288314,50D00009FA050A5EC6C0853EBA6A0BB9,60524,0,9,9,109.42951,18.28993,1216
38680,288315,50D00009FA050A5EC6C0853EBA6A0BB9,31181,14,15,1,109.50382,18.24813,1509
38681,288316,50D00009FA050A5EC6C0853EBA6A0BB9,30361,16,18,2,109.50347,18.24,1508
38682,288317,50D00009FA050A5EC6C0853EBA6A0BB9,30361,21,23,2,109.50347,18.24,1508
38686,288396,AFB3BB55A37370BD0197A84C243C3B80,31071,0,1,1,109.58257,18.28458,1815
38687,288397,AFB3BB55A37370BD0197A84C243C3B80,31071,1,4,3,109.58257,18.28458,1815
38688,288398,AFB3BB55A37370BD0197A84C243C3B80,39371,7,8,1,109.56627,18.2646,1762
38689,288399,AFB3BB55A37370BD0197A84C243C3B80,30731,10,16,6,109.50944,18.22306,1555
38690,288403,60ACD2B6657BEEA3D1B558DE71329F84,30241,13,14,1,109.26174,18.3275,622
38691,288404,60ACD2B6657BEEA3D1B558DE71329F84,39151,16,21,5,109.49875,18.25097,1510
38692,288451,4D0A59E05A72D6291604A4664BF78794,31181,18,20,2,109.50382,18.24813,1509
38693,288452,4D0A59E05A72D6291604A4664BF78794,60381,20,21,1,109.5241,18.22458,1605
38694,288464,85113926FD58DF2481DE297BC312E23D,30361,18,23,5,109.50347,18.24,1508
38698,288482,D334753E33AD01D79142036B3D85543F,31561,0,5,5,109.56792,18.28479,1765
38699,288483,D334753E33AD01D79142036B3D85543F,39183,6,13,7,109.55542,18.28208,1715
38700,288484,9F2B58AC0AA55800793A0AA2A29F8826,39181,10,15,5,109.55153,18.28035,1715
38701,288485,9F2B58AC0AA55800793A0AA2A29F8826,30851,17,22,5,109.5616,18.27396,1713
38702,288542,85D2E0E28FB58C7F8A0D7BC94160D3DD,30854,5,16,11,109.56889,18.27076,1763
38703,288543,85D2E0E28FB58C7F8A0D7BC94160D3DD,31561,19,20,1,109.56792,18.28479,1765
38707,288587,A9FCE0049DB44FE004EAFBF5B783F4A5,31945,0,7,7,109.58021,18.29403,1817
38708,288588,A9FCE0049DB44FE004EAFBF5B783F4A5,30854,9,16,7,109.56889,18.27076,1763
38709,288589,A9FCE0049DB44FE004EAFBF5B783F4A5,31521,19,20,1,109.51458,18.22542,1555
38710,288603,E21BDA79D452CC6D5F26BA60A43939EC,31261,0,1,1,109.51174,18.2466,1559
38711,288604,E21BDA79D452CC6D5F26BA60A43939EC,38911,3,11,8,109.51674,18.24965,1559
38712,288605,E21BDA79D452CC6D5F26BA60A43939EC,60311,12,18,6,109.52097,18.24319,1558
38713,288606,E21BDA79D452CC6D5F26BA60A43939EC,38291,19,20,1,109.51618,18.24313,1558
38714,288607,E21BDA79D452CC6D5F26BA60A43939EC,31261,22,23,1,109.51174,18.2466,1559
38719,288649,201045A9C980BD8E53B16B9129DFE596,31071,0,5,5,109.58257,18.28458,1815
38720,288650,201045A9C980BD8E53B16B9129DFE596,31561,5,7,2,109.56792,18.28479,1765
38721,288651,201045A9C980BD8E53B16B9129DFE596,31071,9,12,3,109.58257,18.28458,1815
38722,288652,201045A9C980BD8E53B16B9129DFE596,30854,15,17,2,109.56889,18.27076,1763
38723,288653,201045A9C980BD8E53B16B9129DFE596,31071,21,23,2,109.58257,18.28458,1815
38724,288686,EC721F8259E3B17F432086B3F60AECE1,31554,3,5,2,109.55521,18.2459,1709
38725,288687,EC721F8259E3B17F432086B3F60AECE1,30051,6,18,12,109.48917,18.21215,1453
38726,288688,EC721F8259E3B17F432086B3F60AECE1,31554,19,23,4,109.55521,18.2459,1709
38731,288702,7024F3A14F6F554DC6E80063E30315F0,31561,0,2,2,109.56792,18.28479,1765
38732,288703,7024F3A14F6F554DC6E80063E30315F0,39183,7,22,15,109.55542,18.28208,1715
38733,288712,17E33F98086F9D71B1BE47BE6FC58756,60291,0,1,1,109.50826,18.24639,1509
38734,288713,17E33F98086F9D71B1BE47BE6FC58756,39371,4,7,3,109.56627,18.2646,1762
38735,288714,17E33F98086F9D71B1BE47BE6FC58756,30711,10,11,1,109.50271,18.25347,1510
38736,288715,17E33F98086F9D71B1BE47BE6FC58756,60221,13,14,1,109.52569,18.29188,1616
38737,288716,17E33F98086F9D71B1BE47BE6FC58756,39101,17,21,4,109.50132,18.24931,1509
38742,288768,40D62DAB923B148A7A4FFB3BCA6C7343,38153,16,18,2,109.51819,18.25736,1561
38743,288769,40D62DAB923B148A7A4FFB3BCA6C7343,31351,21,23,2,109.4959,18.28417,1465
38744,288778,88BC97AED786D1D1055FFA17099BBDF8,30809,0,6,6,109.4891,18.28229,1465
38745,288779,88BC97AED786D1D1055FFA17099BBDF8,31781,10,11,1,109.19847,18.2975,367
38746,288780,88BC97AED786D1D1055FFA17099BBDF8,31471,14,17,3,109.34583,18.29563,917
38747,288781,8B167331F8E78254A4CBA6A89A1236BC,60524,0,14,14,109.42951,18.28993,1216
38748,288782,8B167331F8E78254A4CBA6A89A1236BC,60084,15,19,4,109.4984,18.2334,1507
38749,288783,0D00E0CA974DDA00224ACCD00B993468,31561,12,14,2,109.56792,18.28479,1765
38750,288784,0D00E0CA974DDA00224ACCD00B993468,30854,17,18,1,109.56889,18.27076,1763
38751,288785,0D00E0CA974DDA00224ACCD00B993468,30851,19,21,2,109.5616,18.27396,1713
38752,288791,567BF1868FBA42FA9B3B29F2CA13F65D,30921,1,19,18,109.53903,18.29451,1667
38753,288792,567BF1868FBA42FA9B3B29F2CA13F65D,31931,19,22,3,109.54771,18.29403,1667
38757,288847,E76E426053D594D364E17507E09780BF,30441,0,11,11,109.64021,18.25424,2010
38762,288922,A10AD66CE81CDFBC974C36FAC5FE4CAA,30721,15,16,1,109.51597,18.28257,1565
38763,288923,A10AD66CE81CDFBC974C36FAC5FE4CAA,30854,20,21,1,109.56889,18.27076,1763
38764,288937,316EB27B7555943C1D6557CD7E5A08F6,30741,11,12,1,109.49833,18.28681,1516
38768,288963,6E2021B014C4D0B652A2E4FE8D2CF038,30854,14,15,1,109.56889,18.27076,1763
38769,288964,6E2021B014C4D0B652A2E4FE8D2CF038,31071,16,17,1,109.58257,18.28458,1815
38773,289030,7617AF5A0F29AC2D4F5DA44D6B34A94D,60121,0,9,9,109.74507,18.37472,2430
38774,289031,7617AF5A0F29AC2D4F5DA44D6B34A94D,30961,9,10,1,109.74042,18.37903,2431
38775,289032,7617AF5A0F29AC2D4F5DA44D6B34A94D,60121,11,12,1,109.74507,18.37472,2430
38776,289033,7617AF5A0F29AC2D4F5DA44D6B34A94D,30711,13,17,4,109.50271,18.25347,1510
38777,289034,7617AF5A0F29AC2D4F5DA44D6B34A94D,30961,18,20,2,109.74042,18.37903,2431
38778,289035,7617AF5A0F29AC2D4F5DA44D6B34A94D,31841,20,22,2,109.73201,18.33382,2373
38779,289036,CD77A45360FB53F816FCE62F008EEE28,31931,1,6,5,109.54771,18.29403,1667
38780,289037,CD77A45360FB53F816FCE62F008EEE28,30071,6,7,1,109.52819,18.30472,1619
38781,289038,CD77A45360FB53F816FCE62F008EEE28,31931,10,11,1,109.54771,18.29403,1667
38782,289039,CD77A45360FB53F816FCE62F008EEE28,31461,12,13,1,109.5091,18.25389,1510
38783,289040,CD77A45360FB53F816FCE62F008EEE28,60241,16,17,1,109.53319,18.28667,1616
38784,289041,CD77A45360FB53F816FCE62F008EEE28,31931,19,20,1,109.54771,18.29403,1667
38792,289133,C162E20472DBB598395501A28AA53C86,31671,0,7,7,109.38965,18.29813,1068
38793,289134,C162E20472DBB598395501A28AA53C86,31861,8,10,2,109.49042,18.27549,1464
38794,289135,C162E20472DBB598395501A28AA53C86,38185,12,15,3,109.51333,18.27347,1563
38795,289136,C162E20472DBB598395501A28AA53C86,30151,16,18,2,109.50986,18.25083,1560
38796,289137,C162E20472DBB598395501A28AA53C86,31671,20,23,3,109.38965,18.29813,1068
38797,289140,F3C7582DC0625CD0C0C3F1B9C08AEFC7,60041,0,13,13,109.39889,18.31944,1121
38798,289141,F3C7582DC0625CD0C0C3F1B9C08AEFC7,31521,14,15,1,109.51458,18.22542,1555
38799,289142,F3C7582DC0625CD0C0C3F1B9C08AEFC7,30361,15,16,1,109.50347,18.24,1508
38800,289143,F3C7582DC0625CD0C0C3F1B9C08AEFC7,38754,19,21,2,109.74667,18.37382,2430
38801,289144,9C607748C1355BBFA505845B03897CBC,60281,16,17,1,109.51743,18.25924,1561
38802,289145,9C607748C1355BBFA505845B03897CBC,30371,18,19,1,109.51,18.24771,1559
38803,289146,9C607748C1355BBFA505845B03897CBC,38911,22,23,1,109.51674,18.24965,1559
38815,289212,B80D4B4CDBD08237A9C4254F8883AEF4,39091,0,7,7,109.50097,18.25222,1510
38816,289213,B80D4B4CDBD08237A9C4254F8883AEF4,31181,8,11,3,109.50382,18.24813,1509
38817,289214,B80D4B4CDBD08237A9C4254F8883AEF4,31181,15,16,1,109.50382,18.24813,1509
38818,289215,B80D4B4CDBD08237A9C4254F8883AEF4,60381,18,19,1,109.5241,18.22458,1605
38819,289216,B80D4B4CDBD08237A9C4254F8883AEF4,39091,20,23,3,109.50097,18.25222,1510
38823,289262,013993AB3B116DEE53D03FD91E423B5B,60411,20,21,1,109.32514,18.30854,869
38824,289263,013993AB3B116DEE53D03FD91E423B5B,30661,22,23,1,109.37028,18.24361,1008
38828,289306,66A68DF7322984DDFD4069A80816FA0D,38052,13,15,2,109.62618,18.23042,1956
38829,289307,66A68DF7322984DDFD4069A80816FA0D,60594,18,20,2,109.62694,18.22799,1956
38830,289308,66A68DF7322984DDFD4069A80816FA0D,39331,21,22,1,109.62125,18.22708,1956
38831,289316,0BABF9C6516F437130A3DD3C99553A57,30211,0,4,4,109.49882,18.23931,1508
38832,289317,0BABF9C6516F437130A3DD3C99553A57,31041,5,6,1,109.50278,18.23701,1507
38833,289318,0BABF9C6516F437130A3DD3C99553A57,30854,7,8,1,109.56889,18.27076,1763
38834,289319,0BABF9C6516F437130A3DD3C99553A57,31851,8,10,2,109.71736,18.29007,2316
38835,289320,0BABF9C6516F437130A3DD3C99553A57,30181,11,12,1,109.51597,18.23313,1557
38836,289321,0BABF9C6516F437130A3DD3C99553A57,60641,15,16,1,109.53854,18.2359,1657
38837,289322,0BABF9C6516F437130A3DD3C99553A57,31201,18,23,5,109.51042,18.23819,1558
38838,289331,000584B3023702F3E9DDF521B1C35B1A,31071,1,3,2,109.58257,18.28458,1815
38839,289332,000584B3023702F3E9DDF521B1C35B1A,31945,4,6,2,109.58021,18.29403,1817
38840,289333,000584B3023702F3E9DDF521B1C35B1A,31071,10,12,2,109.58257,18.28458,1815
38841,289334,000584B3023702F3E9DDF521B1C35B1A,31945,12,13,1,109.58021,18.29403,1817
38842,289335,000584B3023702F3E9DDF521B1C35B1A,30854,14,20,6,109.56889,18.27076,1763
38843,289336,000584B3023702F3E9DDF521B1C35B1A,31945,21,22,1,109.58021,18.29403,1817
38844,289340,7EBC20D0E5F0FBA046CA1D08E7FF47C1,31071,2,6,4,109.58257,18.28458,1815
38845,289341,7EBC20D0E5F0FBA046CA1D08E7FF47C1,30854,11,12,1,109.56889,18.27076,1763
38846,289352,D1300109B338AA3BEF146D962603C6CB,38484,0,6,6,109.53028,18.31528,1620
38847,289353,D1300109B338AA3BEF146D962603C6CB,30071,10,11,1,109.52819,18.30472,1619
38848,289354,D1300109B338AA3BEF146D962603C6CB,30711,12,13,1,109.50271,18.25347,1510
38849,289355,D1300109B338AA3BEF146D962603C6CB,30421,14,17,3,109.50021,18.25861,1511
38850,289356,D1300109B338AA3BEF146D962603C6CB,38484,17,18,1,109.53028,18.31528,1620
38851,289378,8A321B0FBD5A72C39F28CA2535195507,60041,0,10,10,109.39889,18.31944,1121
38852,289379,8A321B0FBD5A72C39F28CA2535195507,60114,15,18,3,109.73028,18.33847,2374
38853,289380,8A321B0FBD5A72C39F28CA2535195507,31841,21,22,1,109.73201,18.33382,2373
38854,289401,DF1914B7230B32BA806E8A8749CAD846,31181,15,16,1,109.50382,18.24813,1509
38855,289402,DF1914B7230B32BA806E8A8749CAD846,60421,20,23,3,109.46333,18.31743,1371
38856,289407,8E9CBB949C0DB377807711755B310583,30361,12,13,1,109.50347,18.24,1508
38857,289408,8E9CBB949C0DB377807711755B310583,38094,15,23,8,109.45403,18.28778,1316
38861,289472,020753EF78F0A0C39658113A3377EA1E,31561,12,13,1,109.56792,18.28479,1765
38862,289473,020753EF78F0A0C39658113A3377EA1E,39183,14,15,1,109.55542,18.28208,1715
38863,289474,020753EF78F0A0C39658113A3377EA1E,31561,18,21,3,109.56792,18.28479,1765
38868,289488,744908594665C830F5D7DD2D0AC61E3F,60081,0,4,4,109.51097,18.22639,1556
38869,289489,744908594665C830F5D7DD2D0AC61E3F,60087,5,6,1,109.50688,18.22299,1505
38870,289560,3721DD20DEF8CEDB5BD6EB56E9685A22,60301,0,3,3,109.60715,18.30993,1919
38871,289561,3721DD20DEF8CEDB5BD6EB56E9685A22,60581,3,6,3,109.59785,18.29931,1868
38872,289562,3721DD20DEF8CEDB5BD6EB56E9685A22,30234,7,8,1,109.60681,18.29979,1918
38873,289563,3721DD20DEF8CEDB5BD6EB56E9685A22,31471,10,11,1,109.34583,18.29563,917
38874,289580,56F818D0924E7BDB02CCC04065747626,38205,0,19,19,109.62743,18.23139,1956
38875,289581,56F818D0924E7BDB02CCC04065747626,31041,22,23,1,109.50278,18.23701,1507
38879,289605,689BCB46A0E58D79BF82594240942679,60371,0,3,3,109.53063,18.30056,1618
38880,289606,689BCB46A0E58D79BF82594240942679,30071,4,8,4,109.52819,18.30472,1619
38881,289607,689BCB46A0E58D79BF82594240942679,31781,11,13,2,109.19847,18.2975,367
38882,289608,689BCB46A0E58D79BF82594240942679,39081,14,15,1,109.19382,18.29111,366
38883,289609,689BCB46A0E58D79BF82594240942679,31421,18,20,2,109.55382,18.22347,1705
38884,289622,1980C8D409DE9551539224B3D393CDAA,31951,1,2,1,109.52174,18.30299,1568
38885,289623,1980C8D409DE9551539224B3D393CDAA,38991,2,6,4,109.52681,18.30368,1618
38886,289624,1980C8D409DE9551539224B3D393CDAA,31951,6,8,2,109.52174,18.30299,1568
38887,289625,1980C8D409DE9551539224B3D393CDAA,30071,8,11,3,109.52819,18.30472,1619
38888,289626,1980C8D409DE9551539224B3D393CDAA,30071,13,21,8,109.52819,18.30472,1619
38896,289697,8AFD060E1E9DC727605442142067AD03,31861,15,17,2,109.49042,18.27549,1464
38897,289698,8AFD060E1E9DC727605442142067AD03,30861,20,23,3,109.52722,18.22743,1606
38898,289711,8B9A9BFD1ACAD480EB101A91DBF2024D,38291,0,10,10,109.51618,18.24313,1558
38899,289712,8B9A9BFD1ACAD480EB101A91DBF2024D,30371,12,23,11,109.51,18.24771,1559
38900,289724,43E035AE85036EBD9891453E9567CB81,60504,12,14,2,109.47917,18.28903,1416
38901,289725,43E035AE85036EBD9891453E9567CB81,30151,16,19,3,109.50986,18.25083,1560
38902,289726,43E035AE85036EBD9891453E9567CB81,30151,21,23,2,109.50986,18.25083,1560
38903,289783,8752BC71725B50257436D50C6598F252,30854,18,19,1,109.56889,18.27076,1763
38904,289784,8752BC71725B50257436D50C6598F252,60631,20,22,2,109.57778,18.27583,1814
38905,289793,032D95980CE2A85CFBC6D1472CD793A8,39091,0,8,8,109.50097,18.25222,1510
38906,289794,032D95980CE2A85CFBC6D1472CD793A8,38754,12,14,2,109.74667,18.37382,2430
38907,289795,032D95980CE2A85CFBC6D1472CD793A8,39091,15,17,2,109.50097,18.25222,1510
38908,289796,032D95980CE2A85CFBC6D1472CD793A8,60031,19,20,1,109.49694,18.31632,1521
38909,289797,032D95980CE2A85CFBC6D1472CD793A8,39091,21,23,2,109.50097,18.25222,1510
38910,289833,DC9973204E62AA99FA79F0696CF6C0F6,31945,0,1,1,109.58021,18.29403,1817
38911,289834,DC9973204E62AA99FA79F0696CF6C0F6,30854,1,21,20,109.56889,18.27076,1763
38918,289928,0C36A00B9010612DF553A128A21F45E8,31531,0,10,10,109.49583,18.25972,1461
38922,289949,6422CB87ACC55DDEF6EBE8946593C808,31351,0,7,7,109.4959,18.28417,1465
38923,289950,6422CB87ACC55DDEF6EBE8946593C808,60231,8,9,1,109.49903,18.21972,1504
38924,289951,6422CB87ACC55DDEF6EBE8946593C808,39053,9,10,1,109.511,18.2771,1564
38925,289952,6422CB87ACC55DDEF6EBE8946593C808,60231,12,19,7,109.49903,18.21972,1504
38930,289980,664AAF94F095BCD14233E5648F0324F0,60491,7,8,1,109.43354,18.30847,1269
38935,290018,FA724E83D7D22E41E07D0D2550D22166,30854,15,20,5,109.56889,18.27076,1763
38936,290019,FA724E83D7D22E41E07D0D2550D22166,31071,22,23,1,109.58257,18.28458,1815
38937,290089,2261FA59C58CA1DB4ED476451BEA0AD4,60501,0,3,3,109.48701,18.29021,1466
38938,290125,DF189E83BAB7254002D11C89D4F2D51F,31124,19,23,4,109.17069,18.35,276
38939,290135,40285EE8CCE25C38988EC087545664EC,31071,1,10,9,109.58257,18.28458,1815
38940,290136,40285EE8CCE25C38988EC087545664EC,30854,14,23,9,109.56889,18.27076,1763
38941,290195,C8922FAF66F21ECAECB6B717FCD5A53B,60391,9,11,2,109.47667,18.28757,1416
38942,290196,C8922FAF66F21ECAECB6B717FCD5A53B,60614,11,23,12,109.48799,18.29521,1467
38943,290212,7D1ED6067ECBD941EFC43CE0A6ADAE71,30854,0,11,11,109.56889,18.27076,1763
38944,290213,7D1ED6067ECBD941EFC43CE0A6ADAE71,31071,13,20,7,109.58257,18.28458,1815
38945,290220,9E8746086915F9D4A063A74CF0B5B7AB,31561,12,15,3,109.56792,18.28479,1765
38946,290221,9E8746086915F9D4A063A74CF0B5B7AB,39183,16,18,2,109.55542,18.28208,1715
38947,290236,FB2AC3F748B104193BBB6BA243B43247,60491,0,2,2,109.43354,18.30847,1269
38948,290237,FB2AC3F748B104193BBB6BA243B43247,31081,4,8,4,109.44639,18.30181,1318
38949,290239,FB2AC3F748B104193BBB6BA243B43247,30854,20,22,2,109.56889,18.27076,1763
38957,290278,51DF765CB634D9549D20AD1F2C37BA18,30854,4,5,1,109.56889,18.27076,1763
38958,290279,51DF765CB634D9549D20AD1F2C37BA18,31561,7,21,14,109.56792,18.28479,1765
38959,290280,8F7C571040232DE08ED6F6470F3AFD5D,31671,19,20,1,109.38965,18.29813,1068
38960,290281,8F7C571040232DE08ED6F6470F3AFD5D,38301,20,23,3,109.38632,18.29104,1066
38961,290282,7B453A5E432292BF0A91271A2EAD7AAF,60221,0,7,7,109.52569,18.29188,1616
38962,290283,7B453A5E432292BF0A91271A2EAD7AAF,30711,8,10,2,109.50271,18.25347,1510
38963,290284,7B453A5E432292BF0A91271A2EAD7AAF,60221,11,13,2,109.52569,18.29188,1616
38964,290285,7B453A5E432292BF0A91271A2EAD7AAF,30324,15,17,2,109.50326,18.29257,1517
38965,290286,7B453A5E432292BF0A91271A2EAD7AAF,60221,20,23,3,109.52569,18.29188,1616
38966,290328,E9E473F09C342630187345312F4A31D8,39181,0,8,8,109.55153,18.28035,1715
38967,290329,E9E473F09C342630187345312F4A31D8,39181,10,14,4,109.55153,18.28035,1715
38968,290330,E9E473F09C342630187345312F4A31D8,39181,15,17,2,109.55153,18.28035,1715
38969,290331,E9E473F09C342630187345312F4A31D8,39181,17,19,2,109.55153,18.28035,1715
38970,290332,E9E473F09C342630187345312F4A31D8,39181,20,23,3,109.55153,18.28035,1715
38971,290377,9337A90C199FC39903F500644FD0D1C4,39111,0,9,9,109.5191,18.22597,1555
38972,290378,9337A90C199FC39903F500644FD0D1C4,60381,9,11,2,109.5241,18.22458,1605
38973,290379,9337A90C199FC39903F500644FD0D1C4,31521,11,12,1,109.51458,18.22542,1555
38974,290380,9337A90C199FC39903F500644FD0D1C4,30201,13,14,1,109.4909,18.26465,1462
38975,290381,9337A90C199FC39903F500644FD0D1C4,31031,18,20,2,109.49979,18.25382,1510
38976,290385,E75CF54BA14775FEDD26504F9F6B7365,31945,1,5,4,109.58021,18.29403,1817
38977,290386,E75CF54BA14775FEDD26504F9F6B7365,31561,7,15,8,109.56792,18.28479,1765
38978,290387,E75CF54BA14775FEDD26504F9F6B7365,30854,16,18,2,109.56889,18.27076,1763
38979,290388,E75CF54BA14775FEDD26504F9F6B7365,31071,19,20,1,109.58257,18.28458,1815
38980,290389,E75CF54BA14775FEDD26504F9F6B7365,31945,21,22,1,109.58021,18.29403,1817
38981,290392,00FC332040A284DA251A8D0705989FE9,31071,1,10,9,109.58257,18.28458,1815
38982,290393,00FC332040A284DA251A8D0705989FE9,30854,14,17,3,109.56889,18.27076,1763
38983,290394,00FC332040A284DA251A8D0705989FE9,39181,18,19,1,109.55153,18.28035,1715
38984,290395,00FC332040A284DA251A8D0705989FE9,30421,20,22,2,109.50021,18.25861,1511
38988,290448,D46DE9169E4BACF1D272EA5E0FDEF68F,39183,6,8,2,109.55542,18.28208,1715
38989,290449,D46DE9169E4BACF1D272EA5E0FDEF68F,30851,8,10,2,109.5616,18.27396,1713
38990,290450,D46DE9169E4BACF1D272EA5E0FDEF68F,39183,15,17,2,109.55542,18.28208,1715
38991,290451,D46DE9169E4BACF1D272EA5E0FDEF68F,31561,21,23,2,109.56792,18.28479,1765
38992,290468,2AE38FAF341950B0B91404FFCE5A0F3E,31931,0,5,5,109.54771,18.29403,1667
38993,290469,2AE38FAF341950B0B91404FFCE5A0F3E,30921,6,18,12,109.53903,18.29451,1667
38994,290481,B227D80C8626361D434850FE0C17533E,38951,0,9,9,109.48097,18.28868,1416
38995,290482,B227D80C8626361D434850FE0C17533E,33051,10,13,3,109.6475,18.46618,2096
38996,290544,DFFF17B7FE30E79B8AABBB5CE171272F,31561,1,6,5,109.56792,18.28479,1765
38997,290545,DFFF17B7FE30E79B8AABBB5CE171272F,39183,10,11,1,109.55542,18.28208,1715
38998,290546,0874ECC8591FCEC6749163A25CC3B800,60411,3,18,15,109.32514,18.30854,869
38999,290547,0874ECC8591FCEC6749163A25CC3B800,31471,20,23,3,109.34583,18.29563,917
39007,290589,2C9F9127F2AECFBA8069624790D23C60,31351,13,14,1,109.4959,18.28417,1465
39008,290596,443D183C692C6C6B0CFC9BE76827D81A,31521,0,10,10,109.51458,18.22542,1555
39009,290597,443D183C692C6C6B0CFC9BE76827D81A,31521,13,23,10,109.51458,18.22542,1555
39010,290614,8CA86ECF9044327BBFC4911E767E554E,30851,18,20,2,109.5616,18.27396,1713
39011,290615,8CA86ECF9044327BBFC4911E767E554E,31071,20,23,3,109.58257,18.28458,1815
39012,290619,EC4B90EDBF35256FDB4D4F8B87DB8A04,30854,15,16,1,109.56889,18.27076,1763
39013,290620,EC4B90EDBF35256FDB4D4F8B87DB8A04,31071,20,21,1,109.58257,18.28458,1815
39014,290621,EC4B90EDBF35256FDB4D4F8B87DB8A04,30854,21,22,1,109.56889,18.27076,1763
39019,290658,96CD0832BDF051FA07C4E27EBADBF179,31461,12,13,1,109.5091,18.25389,1510
39020,290659,96CD0832BDF051FA07C4E27EBADBF179,30084,14,16,2,109.50118,18.26972,1513
39021,290752,5232A1F9DD43FADD1ACE9CE9BD82FED1,31461,12,13,1,109.5091,18.25389,1510
39022,290753,5232A1F9DD43FADD1ACE9CE9BD82FED1,33521,14,23,9,109.66313,18.45174,2143
39023,290764,755FAFC0C0B49C8477B5398A1968636A,60161,15,17,2,109.49174,18.26181,1461
39024,290765,755FAFC0C0B49C8477B5398A1968636A,30361,17,20,3,109.50347,18.24,1508
39032,290828,38CF8AD578A393476F29705A4599B8B1,31201,19,20,1,109.51042,18.23819,1558
39033,290829,38CF8AD578A393476F29705A4599B8B1,30201,22,23,1,109.4909,18.26465,1462
39034,290897,325037F612F05AEC9AA9B5DCFCF0B4A0,38102,15,17,2,109.40875,18.29111,1166
39035,290898,325037F612F05AEC9AA9B5DCFCF0B4A0,60401,20,21,1,109.47444,18.27583,1414
39036,290921,41DAE981BCED4EBAFEC24CC26F862E41,31071,0,11,11,109.58257,18.28458,1815
39037,290922,41DAE981BCED4EBAFEC24CC26F862E41,30854,13,18,5,109.56889,18.27076,1763
39038,290923,41DAE981BCED4EBAFEC24CC26F862E41,38271,19,20,1,109.62632,18.23049,1956
39039,290924,41DAE981BCED4EBAFEC24CC26F862E41,30854,21,22,1,109.56889,18.27076,1763
39044,290982,028F3FB3C0C3F25357AA07CE73FBA035,31431,1,9,8,109.44639,18.29042,1316
39045,291003,1D8B814EC83D52D7C5F3FED99C129EE0,30854,0,1,1,109.56889,18.27076,1763
39046,291004,1D8B814EC83D52D7C5F3FED99C129EE0,30851,2,6,4,109.5616,18.27396,1713
39047,291005,1D8B814EC83D52D7C5F3FED99C129EE0,38271,8,21,13,109.62632,18.23049,1956
39048,291016,05E654A012214456FD658205782885D2,30581,17,18,1,109.62257,18.24951,1959
39049,291017,05E654A012214456FD658205782885D2,38951,21,23,2,109.48097,18.28868,1416
39060,291188,BCC6D1A50E04898FABDF906024A98CE5,30891,18,19,1,109.59431,18.28389,1865
39061,291189,BCC6D1A50E04898FABDF906024A98CE5,31761,21,23,2,109.60521,18.27965,1914
39062,291195,E2EEED9C318F2CFEB610045809877842,31261,3,10,7,109.51174,18.2466,1559
39063,291196,E2EEED9C318F2CFEB610045809877842,30611,12,14,2,109.74958,18.40188,2485
39064,291197,E2EEED9C318F2CFEB610045809877842,30371,14,23,9,109.51,18.24771,1559
39065,291205,452F0FF6BC36839041DCBEF2292D6E55,30101,17,18,1,109.57299,18.33333,1773
39066,291206,452F0FF6BC36839041DCBEF2292D6E55,60381,19,23,4,109.5241,18.22458,1605
39067,291216,0E54E51B728435921FF462A3D9A68B3D,31231,0,7,7,109.42597,18.29292,1217
39068,291217,0E54E51B728435921FF462A3D9A68B3D,30854,9,23,14,109.56889,18.27076,1763
39075,291284,7BF65E5054DA81A230AB5423620158E1,60631,0,7,7,109.57778,18.27583,1814
39076,291285,7BF65E5054DA81A230AB5423620158E1,30854,8,21,13,109.56889,18.27076,1763
39077,291306,C58D0182BFC61ED113EE3B09763C30B2,31931,15,16,1,109.54771,18.29403,1667
39078,291307,C58D0182BFC61ED113EE3B09763C30B2,38127,17,18,1,109.50833,18.27222,1513
39079,291308,C58D0182BFC61ED113EE3B09763C30B2,38185,19,23,4,109.51333,18.27347,1563
39080,291318,728159D623DE360E7CBC8AEEC345E2FF,60661,0,7,7,109.548,18.2377,1657
39081,291319,728159D623DE360E7CBC8AEEC345E2FF,31311,9,14,5,109.72299,18.27438,2364
39082,291320,728159D623DE360E7CBC8AEEC345E2FF,60121,15,16,1,109.74507,18.37472,2430
39083,291321,728159D623DE360E7CBC8AEEC345E2FF,30181,18,19,1,109.51597,18.23313,1557
39084,291322,728159D623DE360E7CBC8AEEC345E2FF,60661,21,23,2,109.548,18.2377,1657
39085,291359,DAF24E4EE5B080B65CEC42C4A439EACF,31071,0,7,7,109.58257,18.28458,1815
39086,291360,DAF24E4EE5B080B65CEC42C4A439EACF,39091,11,14,3,109.50097,18.25222,1510
39087,291361,DAF24E4EE5B080B65CEC42C4A439EACF,30854,14,16,2,109.56889,18.27076,1763
39088,291362,DAF24E4EE5B080B65CEC42C4A439EACF,31071,20,22,2,109.58257,18.28458,1815
39089,291427,D6887056BF9A72A0D40AFDC23854E7DB,60411,1,9,8,109.32514,18.30854,869
39090,291428,D6887056BF9A72A0D40AFDC23854E7DB,39281,10,13,3,109.21333,18.30271,418
39091,291429,D6887056BF9A72A0D40AFDC23854E7DB,30341,14,17,3,109.3625,18.29167,966
39100,291487,20C15B76A1E0DF79D86EDEAC7BC3D7B7,31031,14,15,1,109.49979,18.25382,1510
39101,291488,20C15B76A1E0DF79D86EDEAC7BC3D7B7,31071,19,20,1,109.58257,18.28458,1815
39102,291489,20C15B76A1E0DF79D86EDEAC7BC3D7B7,30854,20,23,3,109.56889,18.27076,1763
39103,291490,FC68C93DF477EC8988713D0985F4BE82,31561,0,8,8,109.56792,18.28479,1765
39104,291491,FC68C93DF477EC8988713D0985F4BE82,30854,8,16,8,109.56889,18.27076,1763
39105,291492,FC68C93DF477EC8988713D0985F4BE82,60381,19,20,1,109.5241,18.22458,1605
39106,291511,8F6EA1C108FADA76A214A7ED71ECE3D1,60117,11,17,6,109.73604,18.35681,2427
39107,291512,8F6EA1C108FADA76A214A7ED71ECE3D1,30891,22,23,1,109.59431,18.28389,1865
39108,291591,A59893CF63A9A48BE0D9E2ED611A9BB2,31801,11,13,2,109.20417,18.32118,371
39109,291627,672DD0F66F8A942C0026E65C93DBF0ED,60211,12,14,2,109.63549,18.26049,2011
39110,291628,672DD0F66F8A942C0026E65C93DBF0ED,38754,16,17,1,109.74667,18.37382,2430
39111,291629,672DD0F66F8A942C0026E65C93DBF0ED,60211,21,23,2,109.63549,18.26049,2011
39112,291689,B2035C0684FF9CA861B7EB217CE5A160,60041,0,1,1,109.39889,18.31944,1121
39113,291690,B2035C0684FF9CA861B7EB217CE5A160,60524,4,5,1,109.42951,18.28993,1216
39114,291691,B2035C0684FF9CA861B7EB217CE5A160,31231,6,8,2,109.42597,18.29292,1217
39115,291692,B2035C0684FF9CA861B7EB217CE5A160,30351,10,19,9,109.41701,18.29292,1217
39116,291693,B2035C0684FF9CA861B7EB217CE5A160,60552,19,21,2,109.41729,18.30014,1218
39117,291694,B2035C0684FF9CA861B7EB217CE5A160,60041,21,23,2,109.39889,18.31944,1121
39118,291695,FD8E83DD7FF39A687AC2462EEEA479A1,30711,16,20,4,109.50271,18.25347,1510
39119,291696,FD8E83DD7FF39A687AC2462EEEA479A1,31761,21,23,2,109.60521,18.27965,1914
39120,291705,FE95B3A32EFBC2838F293DF38F55FDD1,30854,0,5,5,109.56889,18.27076,1763
39121,291706,FE95B3A32EFBC2838F293DF38F55FDD1,39183,7,18,11,109.55542,18.28208,1715
39122,291707,653A27B06104891651DF7B1A27B6CC51,31531,19,20,1,109.49583,18.25972,1461
39123,291708,653A27B06104891651DF7B1A27B6CC51,31521,20,23,3,109.51458,18.22542,1555
39124,291709,7B832C4EEA998F0828995CEC1FF24330,31945,0,6,6,109.58021,18.29403,1817
39125,291710,7B832C4EEA998F0828995CEC1FF24330,30854,8,11,3,109.56889,18.27076,1763
39126,291711,7B832C4EEA998F0828995CEC1FF24330,60211,13,14,1,109.63549,18.26049,2011
39127,291712,7B832C4EEA998F0828995CEC1FF24330,30441,15,16,1,109.64021,18.25424,2010
39128,291713,7B832C4EEA998F0828995CEC1FF24330,31945,20,23,3,109.58021,18.29403,1817
39129,291725,80510334A1C80EA4AE907E88FED9D4F9,60011,0,6,6,109.48965,18.30222,1468
39130,291726,80510334A1C80EA4AE907E88FED9D4F9,30761,6,8,2,109.45201,18.3,1318
39131,291727,80510334A1C80EA4AE907E88FED9D4F9,31781,9,11,2,109.19847,18.2975,367
39132,291728,80510334A1C80EA4AE907E88FED9D4F9,30661,13,14,1,109.37028,18.24361,1008
39140,291847,82FFBAA5929CD368E9B5AC0A4DEDBC26,30051,0,7,7,109.48917,18.21215,1453
39141,291848,82FFBAA5929CD368E9B5AC0A4DEDBC26,31931,7,16,9,109.54771,18.29403,1667
39142,291849,82FFBAA5929CD368E9B5AC0A4DEDBC26,30051,19,23,4,109.48917,18.21215,1453
39143,291852,9A1D1AA5EE2CD156CC396C667ED8C5B9,31071,0,8,8,109.58257,18.28458,1815
39144,291853,9A1D1AA5EE2CD156CC396C667ED8C5B9,60631,9,11,2,109.57778,18.27583,1814
39145,291854,9A1D1AA5EE2CD156CC396C667ED8C5B9,30854,11,12,1,109.56889,18.27076,1763
39146,291855,9A1D1AA5EE2CD156CC396C667ED8C5B9,31071,13,14,1,109.58257,18.28458,1815
39147,291856,9A1D1AA5EE2CD156CC396C667ED8C5B9,30854,15,16,1,109.56889,18.27076,1763
39148,291857,9A1D1AA5EE2CD156CC396C667ED8C5B9,60354,19,20,1,109.58701,18.28521,1815
39149,291858,9A1D1AA5EE2CD156CC396C667ED8C5B9,30854,20,23,3,109.56889,18.27076,1763
39150,291877,AB61D00E5DA3B96E08D6A2F49438046E,60054,12,13,1,109.3016,18.31229,770
39151,291898,B9C5276261A22B75469FB2D15656E67A,31781,13,15,2,109.19847,18.2975,367
39152,291899,B9C5276261A22B75469FB2D15656E67A,31861,20,23,3,109.49042,18.27549,1464
39153,291903,F7035E4742EE25797FD00CAEBC81D218,31251,0,3,3,109.18528,18.2975,317
39154,291904,F7035E4742EE25797FD00CAEBC81D218,30441,4,5,1,109.64021,18.25424,2010
39155,291905,F7035E4742EE25797FD00CAEBC81D218,31251,6,20,14,109.18528,18.2975,317
39156,291906,F7035E4742EE25797FD00CAEBC81D218,30441,22,23,1,109.64021,18.25424,2010
39160,291929,306C6C6EB560D035853CD87DDFB51F50,31071,0,5,5,109.58257,18.28458,1815
39161,291930,306C6C6EB560D035853CD87DDFB51F50,30681,7,9,2,109.48493,18.26917,1463
39162,291931,306C6C6EB560D035853CD87DDFB51F50,31271,13,15,2,109.48958,18.26257,1462
39163,291932,306C6C6EB560D035853CD87DDFB51F50,31071,20,21,1,109.58257,18.28458,1815
39167,291978,CEB7EA5D037E7DFD2A157DEECC6ACC53,38291,0,1,1,109.51618,18.24313,1558
39168,291979,CEB7EA5D037E7DFD2A157DEECC6ACC53,30371,2,7,5,109.51,18.24771,1559
39169,291980,CEB7EA5D037E7DFD2A157DEECC6ACC53,31021,10,14,4,109.49021,18.27,1463
39170,291981,CEB7EA5D037E7DFD2A157DEECC6ACC53,38251,15,17,2,109.49618,18.25493,1510
39171,291982,CEB7EA5D037E7DFD2A157DEECC6ACC53,31121,20,23,3,109.16292,18.37063,230
39172,291983,3E2666314F611E0AC08D1A2388C8030A,31145,9,12,3,109.20431,18.30479,369
39173,291984,3E2666314F611E0AC08D1A2388C8030A,31471,13,17,4,109.34583,18.29563,917
39174,291985,3E2666314F611E0AC08D1A2388C8030A,31521,18,23,5,109.51458,18.22542,1555
39175,292039,66E09649FC3AF1CDA80FFE7B203B7004,31071,0,5,5,109.58257,18.28458,1815
39176,292040,66E09649FC3AF1CDA80FFE7B203B7004,31931,8,10,2,109.54771,18.29403,1667
39177,292041,66E09649FC3AF1CDA80FFE7B203B7004,60371,10,11,1,109.53063,18.30056,1618
39178,292042,66E09649FC3AF1CDA80FFE7B203B7004,31071,12,14,2,109.58257,18.28458,1815
39179,292043,66E09649FC3AF1CDA80FFE7B203B7004,31931,15,17,2,109.54771,18.29403,1667
39180,292044,66E09649FC3AF1CDA80FFE7B203B7004,31071,18,23,5,109.58257,18.28458,1815
39181,292068,99FF1530B139D386F8C2FFCE4C803DD4,30661,14,15,1,109.37028,18.24361,1008
39182,292069,99FF1530B139D386F8C2FFCE4C803DD4,31471,17,18,1,109.34583,18.29563,917
39183,292070,99FF1530B139D386F8C2FFCE4C803DD4,30661,20,21,1,109.37028,18.24361,1008
39184,292080,21AAB354EDCC66ADEEAE4A93BDCB3306,31031,0,9,9,109.49979,18.25382,1510
39185,292081,21AAB354EDCC66ADEEAE4A93BDCB3306,30711,10,12,2,109.50271,18.25347,1510
39186,292082,21AAB354EDCC66ADEEAE4A93BDCB3306,30421,13,14,1,109.50021,18.25861,1511
39187,292083,21AAB354EDCC66ADEEAE4A93BDCB3306,39321,15,17,2,109.529,18.2167,1604
39188,292084,21AAB354EDCC66ADEEAE4A93BDCB3306,31521,17,20,3,109.51458,18.22542,1555
39189,292085,21AAB354EDCC66ADEEAE4A93BDCB3306,30421,20,22,2,109.50021,18.25861,1511
39190,292117,6751CEC3CF9B2AE78246C7287443D2B4,30854,0,1,1,109.56889,18.27076,1763
39191,292118,6751CEC3CF9B2AE78246C7287443D2B4,31071,6,7,1,109.58257,18.28458,1815
39192,292154,2D7C2B0308FF40B49F9D8D3F0878C284,39111,3,4,1,109.5191,18.22597,1555
39193,292155,2D7C2B0308FF40B49F9D8D3F0878C284,31521,5,7,2,109.51458,18.22542,1555
39194,292156,2D7C2B0308FF40B49F9D8D3F0878C284,39321,7,8,1,109.529,18.2167,1604
39195,292157,2D7C2B0308FF40B49F9D8D3F0878C284,31781,12,13,1,109.19847,18.2975,367
39199,292174,59F29435D748531F416A4F1636997ECF,31071,12,13,1,109.58257,18.28458,1815
39200,292175,59F29435D748531F416A4F1636997ECF,30854,14,17,3,109.56889,18.27076,1763
39201,292176,59F29435D748531F416A4F1636997ECF,31071,19,20,1,109.58257,18.28458,1815
39205,292226,22CF7007721E0F1D863F25E4633BE1AD,60311,4,7,3,109.52097,18.24319,1558
39206,292227,22CF7007721E0F1D863F25E4633BE1AD,60501,8,9,1,109.48701,18.29021,1466
39207,292228,22CF7007721E0F1D863F25E4633BE1AD,31881,12,14,2,109.7441,18.40785,2436
39208,292229,22CF7007721E0F1D863F25E4633BE1AD,30084,19,21,2,109.50118,18.26972,1513
39209,292230,A2F734AA2F32C81D03014F0CEDF1D528,60552,0,1,1,109.41729,18.30014,1218
39210,292231,A2F734AA2F32C81D03014F0CEDF1D528,60524,2,8,6,109.42951,18.28993,1216
39211,292232,A2F734AA2F32C81D03014F0CEDF1D528,30351,11,15,4,109.41701,18.29292,1217
39212,292233,A2F734AA2F32C81D03014F0CEDF1D528,60552,16,17,1,109.41729,18.30014,1218
39213,292234,A2F734AA2F32C81D03014F0CEDF1D528,30361,21,22,1,109.50347,18.24,1508
39214,292252,369C26B411BBFC36DC6FE3529EBBC042,31071,0,5,5,109.58257,18.28458,1815
39215,292253,369C26B411BBFC36DC6FE3529EBBC042,31781,9,12,3,109.19847,18.2975,367
39216,292254,369C26B411BBFC36DC6FE3529EBBC042,30854,13,15,2,109.56889,18.27076,1763
39217,292265,18F9E44609F85394688E1F961680A135,31421,0,2,2,109.55382,18.22347,1705
39218,292266,18F9E44609F85394688E1F961680A135,60381,2,6,4,109.5241,18.22458,1605
39219,292267,18F9E44609F85394688E1F961680A135,60551,10,11,1,109.42722,18.30111,1218
39220,292282,522E8CB42AF22D75F3E9D0FD1FDCEEA6,30854,0,1,1,109.56889,18.27076,1763
39221,292283,522E8CB42AF22D75F3E9D0FD1FDCEEA6,39371,2,7,5,109.56627,18.2646,1762
39222,292284,522E8CB42AF22D75F3E9D0FD1FDCEEA6,30854,7,10,3,109.56889,18.27076,1763
39223,292285,522E8CB42AF22D75F3E9D0FD1FDCEEA6,39371,12,13,1,109.56627,18.2646,1762
39224,292286,522E8CB42AF22D75F3E9D0FD1FDCEEA6,30854,16,22,6,109.56889,18.27076,1763
39225,292304,2B9007AC1CBDC651833FDA7CC1A6B306,39321,19,21,2,109.529,18.2167,1604
39226,292305,2B9007AC1CBDC651833FDA7CC1A6B306,30211,21,23,2,109.49882,18.23931,1508
39227,292311,F104684B0D453E1772CF3FC2E8F8DFBE,60231,11,12,1,109.49903,18.21972,1504
39228,292312,F104684B0D453E1772CF3FC2E8F8DFBE,30051,12,14,2,109.48917,18.21215,1453
39229,292313,F104684B0D453E1772CF3FC2E8F8DFBE,30271,15,16,1,109.49132,18.23153,1456
39230,292314,F104684B0D453E1772CF3FC2E8F8DFBE,60201,18,20,2,109.5041,18.2509,1510
39231,292315,F104684B0D453E1772CF3FC2E8F8DFBE,60084,20,22,2,109.4984,18.2334,1507
39232,292337,14BFE46EEAB2E234698393270A62605D,30661,11,12,1,109.37028,18.24361,1008
39233,292338,14BFE46EEAB2E234698393270A62605D,60411,13,14,1,109.32514,18.30854,869
39234,292339,14BFE46EEAB2E234698393270A62605D,30661,15,17,2,109.37028,18.24361,1008
39235,292340,14BFE46EEAB2E234698393270A62605D,60411,22,23,1,109.32514,18.30854,869
39236,292398,FF0D8F0BC597142978F09C4BE01381AF,60291,0,3,3,109.50826,18.24639,1509
39237,292399,FF0D8F0BC597142978F09C4BE01381AF,30511,3,5,2,109.51069,18.24208,1558
39238,292400,FF0D8F0BC597142978F09C4BE01381AF,30281,5,7,2,109.50597,18.27583,1514
39239,292401,FF0D8F0BC597142978F09C4BE01381AF,30511,7,18,11,109.51069,18.24208,1558
39240,292402,FF0D8F0BC597142978F09C4BE01381AF,60381,18,20,2,109.5241,18.22458,1605
39244,292430,7C68E1F4B8B2F3CBBD5427BF66BF9C2E,30891,0,4,4,109.59431,18.28389,1865
39245,292431,7C68E1F4B8B2F3CBBD5427BF66BF9C2E,30854,6,11,5,109.56889,18.27076,1763
39246,292468,30CCDA3A282DA68630C9C45738B256B1,31821,19,20,1,109.51181,18.24924,1559
39247,292469,30CCDA3A282DA68630C9C45738B256B1,30854,21,23,2,109.56889,18.27076,1763
39248,292470,AAD6CC23C5CDBF026C42805D3EA95680,60552,0,1,1,109.41729,18.30014,1218
39249,292471,AAD6CC23C5CDBF026C42805D3EA95680,30351,2,4,2,109.41701,18.29292,1217
39250,292472,AAD6CC23C5CDBF026C42805D3EA95680,39041,4,5,1,109.40021,18.29278,1117
39251,292473,AAD6CC23C5CDBF026C42805D3EA95680,60552,7,11,4,109.41729,18.30014,1218
39252,292474,AAD6CC23C5CDBF026C42805D3EA95680,39041,13,14,1,109.40021,18.29278,1117
39253,292475,AAD6CC23C5CDBF026C42805D3EA95680,60552,15,21,6,109.41729,18.30014,1218
39258,292494,372A5433078073EAD18922D679CE0A73,30661,2,4,2,109.37028,18.24361,1008
39259,292495,372A5433078073EAD18922D679CE0A73,60411,4,5,1,109.32514,18.30854,869
39260,292496,372A5433078073EAD18922D679CE0A73,60054,5,12,7,109.3016,18.31229,770
39261,292497,372A5433078073EAD18922D679CE0A73,60411,14,18,4,109.32514,18.30854,869
39266,292528,50F6E2D553B36EAFE6AA22613C3D5EDD,31521,18,19,1,109.51458,18.22542,1555
39267,292529,50F6E2D553B36EAFE6AA22613C3D5EDD,30191,21,22,1,109.50361,18.22701,1506
39268,292573,B28B7AC1F3FE640DB97CA0FE887F5331,31431,17,18,1,109.44639,18.29042,1316
39269,292574,B28B7AC1F3FE640DB97CA0FE887F5331,60401,20,23,3,109.47444,18.27583,1414
39273,292626,7787090BDC7F8BDD60446754BDF84D74,30711,18,22,4,109.50271,18.25347,1510
39274,292627,4A6E6277F47F7550E2618B9C1ADC3166,31391,13,14,1,109.50382,18.24285,1508
39275,292628,4A6E6277F47F7550E2618B9C1ADC3166,30361,19,23,4,109.50347,18.24,1508
39279,292659,D4EE8E1A4C04A1FF0596E4221D0B8B42,31071,12,14,2,109.58257,18.28458,1815
39280,292660,D4EE8E1A4C04A1FF0596E4221D0B8B42,30854,14,15,1,109.56889,18.27076,1763
39281,292661,D4EE8E1A4C04A1FF0596E4221D0B8B42,31071,19,20,1,109.58257,18.28458,1815
39282,292662,D4EE8E1A4C04A1FF0596E4221D0B8B42,30854,20,23,3,109.56889,18.27076,1763
39283,292670,C6A8E88AF4FAB8E3B900B709C1644500,30051,11,13,2,109.48917,18.21215,1453
39284,292671,C6A8E88AF4FAB8E3B900B709C1644500,38831,13,16,3,109.4916,18.20938,1453
39285,292765,1DA88ED70B6ADE8EAE3D8F549B029C10,31031,19,21,2,109.49979,18.25382,1510
39286,292766,1DA88ED70B6ADE8EAE3D8F549B029C10,30511,22,23,1,109.51069,18.24208,1558
39290,292781,7A214C2AB4CE0E87DF8DB230B9F95561,30101,0,6,6,109.57299,18.33333,1773
39291,292782,7A214C2AB4CE0E87DF8DB230B9F95561,31631,8,10,2,109.59542,18.36826,1879
39292,292783,7A214C2AB4CE0E87DF8DB230B9F95561,30101,11,14,3,109.57299,18.33333,1773
39293,292784,7A214C2AB4CE0E87DF8DB230B9F95561,31631,14,15,1,109.59542,18.36826,1879
39294,292785,7A214C2AB4CE0E87DF8DB230B9F95561,30101,16,22,6,109.57299,18.33333,1773
39295,292820,E5E7A1E4B2B3DFFE76B1825814C207C0,30201,0,2,2,109.4909,18.26465,1462
39296,292821,E5E7A1E4B2B3DFFE76B1825814C207C0,30081,3,7,4,109.50243,18.26632,1512
39297,292822,E5E7A1E4B2B3DFFE76B1825814C207C0,31561,8,15,7,109.56792,18.28479,1765
39298,292823,E5E7A1E4B2B3DFFE76B1825814C207C0,30851,15,16,1,109.5616,18.27396,1713
39299,292824,E5E7A1E4B2B3DFFE76B1825814C207C0,30081,18,23,5,109.50243,18.26632,1512
39300,292841,C95F1B819829970A07CEDAA21DBD2FD7,60381,16,18,2,109.5241,18.22458,1605
39301,292842,C95F1B819829970A07CEDAA21DBD2FD7,31461,18,20,2,109.5091,18.25389,1510
39302,292845,C17F2EF1DEA79C8C951E3013EE071B2C,31071,0,8,8,109.58257,18.28458,1815
39306,292893,FC9AD8EA090AECE5560DCF6C767B74D1,38706,0,8,8,109.74625,18.37097,2430
39307,292894,FC9AD8EA090AECE5560DCF6C767B74D1,60117,9,10,1,109.73604,18.35681,2427
39308,292895,FC9AD8EA090AECE5560DCF6C767B74D1,30581,12,22,10,109.62257,18.24951,1959
39309,292900,C358285726113434A30FBBA8DED710E7,60371,0,6,6,109.53063,18.30056,1618
39310,292901,C358285726113434A30FBBA8DED710E7,30921,6,8,2,109.53903,18.29451,1667
39311,292902,C358285726113434A30FBBA8DED710E7,60371,8,10,2,109.53063,18.30056,1618
39312,292903,C358285726113434A30FBBA8DED710E7,60171,15,16,1,109.51292,18.30694,1569
39313,292904,C358285726113434A30FBBA8DED710E7,31621,20,22,2,109.51035,18.29826,1568
39314,292907,8D3B10FD4DBC46DB93DA60040668F697,31561,16,17,1,109.56792,18.28479,1765
39315,292908,8D3B10FD4DBC46DB93DA60040668F697,30854,18,22,4,109.56889,18.27076,1763
39316,292911,19BFA3B1A13A0460E074AEFDAEDA87E2,30361,19,20,1,109.50347,18.24,1508
39317,292912,19BFA3B1A13A0460E074AEFDAEDA87E2,31231,21,23,2,109.42597,18.29292,1217
39322,292948,8621CFDF1B89A83351494618C53D033F,39181,11,16,5,109.55153,18.28035,1715
39323,292949,8621CFDF1B89A83351494618C53D033F,31071,16,17,1,109.58257,18.28458,1815
39324,292950,8621CFDF1B89A83351494618C53D033F,39181,17,23,6,109.55153,18.28035,1715
39325,292955,3E0CC1F431A959DE24ABB41EC7702F6D,30351,0,1,1,109.41701,18.29292,1217
39326,292956,3E0CC1F431A959DE24ABB41EC7702F6D,60524,2,8,6,109.42951,18.28993,1216
39327,292957,3E0CC1F431A959DE24ABB41EC7702F6D,30351,8,15,7,109.41701,18.29292,1217
39328,292958,3E0CC1F431A959DE24ABB41EC7702F6D,60552,16,17,1,109.41729,18.30014,1218
39329,292959,3E0CC1F431A959DE24ABB41EC7702F6D,30361,20,22,2,109.50347,18.24,1508
39341,293094,C3A14EA60E889BD61EB20D6BC5B6F46F,39321,1,5,4,109.529,18.2167,1604
39342,293095,C3A14EA60E889BD61EB20D6BC5B6F46F,31521,6,7,1,109.51458,18.22542,1555
39343,293097,C3A14EA60E889BD61EB20D6BC5B6F46F,60221,19,20,1,109.52569,18.29188,1616
39344,293125,CD3BCBAB8571FB81953C842A434E5DB8,30854,7,10,3,109.56889,18.27076,1763
39345,293126,CD3BCBAB8571FB81953C842A434E5DB8,31071,12,17,5,109.58257,18.28458,1815
39346,293156,BAAEF1F815128F9C42A2F609EF6E43D2,31231,0,7,7,109.42597,18.29292,1217
39347,293157,BAAEF1F815128F9C42A2F609EF6E43D2,31311,8,15,7,109.72299,18.27438,2364
39348,293175,CB693B0353784C5EB4126F1C3868BEF8,33051,12,14,2,109.6475,18.46618,2096
39349,293177,CB693B0353784C5EB4126F1C3868BEF8,30201,19,20,1,109.4909,18.26465,1462
39350,293178,CB693B0353784C5EB4126F1C3868BEF8,31521,21,23,2,109.51458,18.22542,1555
39354,293182,9DE8C13901CC7D63E2F1A6CC92603604,30851,0,1,1,109.5616,18.27396,1713
39355,293183,9DE8C13901CC7D63E2F1A6CC92603604,30854,1,15,14,109.56889,18.27076,1763
39356,293197,2DDF3A993BD69F79020EB97CF3A71819,38171,0,8,8,109.50799,18.28139,1515
39357,293198,2DDF3A993BD69F79020EB97CF3A71819,30161,12,13,1,109.50042,18.24389,1508
39358,293199,2DDF3A993BD69F79020EB97CF3A71819,39091,14,16,2,109.50097,18.25222,1510
39359,293200,2DDF3A993BD69F79020EB97CF3A71819,30161,18,20,2,109.50042,18.24389,1508
39360,293201,2DDF3A993BD69F79020EB97CF3A71819,38171,21,22,1,109.50799,18.28139,1515
39361,293209,706B8E0F0F5D1C9FC2F8EBB2574EE89F,31461,0,10,10,109.5091,18.25389,1510
39362,293210,706B8E0F0F5D1C9FC2F8EBB2574EE89F,30711,10,11,1,109.50271,18.25347,1510
39363,293211,706B8E0F0F5D1C9FC2F8EBB2574EE89F,60201,12,14,2,109.5041,18.2509,1510
39364,293212,706B8E0F0F5D1C9FC2F8EBB2574EE89F,31461,14,16,2,109.5091,18.25389,1510
39365,293213,706B8E0F0F5D1C9FC2F8EBB2574EE89F,60201,17,20,3,109.5041,18.2509,1510
39366,293214,706B8E0F0F5D1C9FC2F8EBB2574EE89F,30711,21,23,2,109.50271,18.25347,1510
39367,293239,3C6B416FA80A7A03E14FC0317D60CB00,30854,7,8,1,109.56889,18.27076,1763
39368,293240,3C6B416FA80A7A03E14FC0317D60CB00,31071,11,12,1,109.58257,18.28458,1815
39369,293241,3C6B416FA80A7A03E14FC0317D60CB00,30854,13,18,5,109.56889,18.27076,1763
39370,293258,12C98BDC1142E557FD566FD430E0D786,60131,1,7,6,109.49819,18.24778,1509
39371,293304,DF85579B74AF19DE64EEDB1BF221CB5F,30191,0,10,10,109.50361,18.22701,1506
39372,293307,0402BD114B7D5E20705E302B756CD062,31071,0,6,6,109.58257,18.28458,1815
39373,293308,0402BD114B7D5E20705E302B756CD062,30854,7,8,1,109.56889,18.27076,1763
39374,293309,0402BD114B7D5E20705E302B756CD062,60631,13,14,1,109.57778,18.27583,1814
39375,293310,0402BD114B7D5E20705E302B756CD062,31071,15,16,1,109.58257,18.28458,1815
39376,293311,0402BD114B7D5E20705E302B756CD062,30854,18,19,1,109.56889,18.27076,1763
39377,293320,ACDEAAF45B65DE48CF80A48DBD3C775E,31071,3,17,14,109.58257,18.28458,1815
39378,293321,ACDEAAF45B65DE48CF80A48DBD3C775E,30854,18,20,2,109.56889,18.27076,1763
39379,293327,5EBEA276FCB4A19AC5C987F5C7CC8908,60621,0,7,7,109.48354,18.27451,1464
39380,293328,5EBEA276FCB4A19AC5C987F5C7CC8908,38361,10,12,2,109.43667,18.29201,1267
39381,293329,5EBEA276FCB4A19AC5C987F5C7CC8908,60401,12,13,1,109.47444,18.27583,1414
39382,293330,5EBEA276FCB4A19AC5C987F5C7CC8908,60524,15,18,3,109.42951,18.28993,1216
39383,293331,5EBEA276FCB4A19AC5C987F5C7CC8908,38391,20,21,1,109.44111,18.29083,1266
39384,293332,5EBEA276FCB4A19AC5C987F5C7CC8908,60524,22,23,1,109.42951,18.28993,1216
39388,293347,171A294CD4CE2D2C4D692BA99F9AA8C8,38134,0,9,9,109.63931,18.23451,2007
39389,293348,171A294CD4CE2D2C4D692BA99F9AA8C8,31471,13,15,2,109.34583,18.29563,917
39390,293349,171A294CD4CE2D2C4D692BA99F9AA8C8,31701,16,21,5,109.44132,18.28833,1266
39391,293357,A5678EE319F8EC08843C9F20545373D3,60524,0,7,7,109.42951,18.28993,1216
39392,293358,A5678EE319F8EC08843C9F20545373D3,31145,9,13,4,109.20431,18.30479,369
39393,293359,A5678EE319F8EC08843C9F20545373D3,60524,18,21,3,109.42951,18.28993,1216
39397,293381,B55959B64746A18ECF5077B5F7359221,31561,11,12,1,109.56792,18.28479,1765
39398,293382,B55959B64746A18ECF5077B5F7359221,39183,17,18,1,109.55542,18.28208,1715
39399,293383,B55959B64746A18ECF5077B5F7359221,30741,21,22,1,109.49833,18.28681,1516
39403,293461,C8135D3E403B7CC96352A41CBCD291A7,38241,0,22,22,109.54111,18.30542,1669
39404,293462,C8135D3E403B7CC96352A41CBCD291A7,31931,22,23,1,109.54771,18.29403,1667
39408,293496,A0D7B7417A5826131879207628D9C43A,38157,15,16,1,109.51483,18.26958,1563
39409,293497,A0D7B7417A5826131879207628D9C43A,30171,21,23,2,109.48458,18.27139,1463
39410,293498,78DAB4F1681085A74E87373143D04310,30151,2,4,2,109.50986,18.25083,1560
39411,293499,78DAB4F1681085A74E87373143D04310,30421,4,6,2,109.50021,18.25861,1511
39412,293500,78DAB4F1681085A74E87373143D04310,31145,8,9,1,109.20431,18.30479,369
39413,293501,78DAB4F1681085A74E87373143D04310,30421,14,16,2,109.50021,18.25861,1511
39414,293502,78DAB4F1681085A74E87373143D04310,30151,20,23,3,109.50986,18.25083,1560
39415,293520,5C77DC326C703C809C6D0E34E93F8F91,39371,11,14,3,109.56627,18.2646,1762
39416,293526,7EB4F76900011DECC835981CBE847D5E,31561,3,11,8,109.56792,18.28479,1765
39417,293527,7EB4F76900011DECC835981CBE847D5E,30281,14,17,3,109.50597,18.27583,1514
39421,293603,6B806948BC9187A91D033B4096721B00,31071,7,15,8,109.58257,18.28458,1815
39422,293604,6B806948BC9187A91D033B4096721B00,30854,18,20,2,109.56889,18.27076,1763
39423,293605,DE5024DB59D5BF6AE5857A85EB7680EA,60631,16,17,1,109.57778,18.27583,1814
39424,293606,DE5024DB59D5BF6AE5857A85EB7680EA,30181,20,21,1,109.51597,18.23313,1557
39425,293612,9A78A2403CB27ECF6A4CA8077813C798,39151,9,16,7,109.49875,18.25097,1510
39430,293755,C93386A9D86FE22A1FD4E5116045DD8D,30854,20,21,1,109.56889,18.27076,1763
39431,293756,C93386A9D86FE22A1FD4E5116045DD8D,31561,21,23,2,109.56792,18.28479,1765
39432,293766,2B8C748A18FA7D08D4335AD7C9DEF01B,31761,0,5,5,109.60521,18.27965,1914
39433,293767,2B8C748A18FA7D08D4335AD7C9DEF01B,30851,8,10,2,109.5616,18.27396,1713
39434,293768,2B8C748A18FA7D08D4335AD7C9DEF01B,31551,12,16,4,109.55868,18.24222,1708
39435,293769,2B8C748A18FA7D08D4335AD7C9DEF01B,31761,18,22,4,109.60521,18.27965,1914
39436,293811,F254D46EBC62915475CCD82A2F213AB7,60131,19,20,1,109.49819,18.24778,1509
39437,293812,F254D46EBC62915475CCD82A2F213AB7,38251,22,23,1,109.49618,18.25493,1510
39438,293816,BCF7902B3144684D44567B20BDAA780E,48647,0,12,12,109.48701,18.29042,1466
39439,293819,37A308BBFD680DBD57B76B7C99CCD184,31931,5,6,1,109.54771,18.29403,1667
39440,293820,37A308BBFD680DBD57B76B7C99CCD184,39101,10,15,5,109.50132,18.24931,1509
39441,293821,37A308BBFD680DBD57B76B7C99CCD184,60221,18,23,5,109.52569,18.29188,1616
39448,293847,5205655EC583F6392BC68C8BB9865108,30854,15,16,1,109.56889,18.27076,1763
39449,293848,5205655EC583F6392BC68C8BB9865108,31171,19,21,2,109.50938,18.24917,1559
39450,293849,5205655EC583F6392BC68C8BB9865108,30854,21,23,2,109.56889,18.27076,1763
39451,293877,B7E330D15F4B46614A332696B5F7027D,31071,15,16,1,109.58257,18.28458,1815
39452,293878,B7E330D15F4B46614A332696B5F7027D,30854,17,18,1,109.56889,18.27076,1763
39453,293879,B7E330D15F4B46614A332696B5F7027D,31931,18,23,5,109.54771,18.29403,1667
39458,293916,13BA40EE4EE70A720415FEDCD3CD7B5F,31101,15,17,2,109.65389,18.23403,2057
39459,293917,13BA40EE4EE70A720415FEDCD3CD7B5F,38361,21,22,1,109.43667,18.29201,1267
39460,293932,0E129C09250C0D46273B4BD7E5225556,30151,0,6,6,109.50986,18.25083,1560
39461,293933,0E129C09250C0D46273B4BD7E5225556,60201,6,10,4,109.5041,18.2509,1510
39462,293934,0E129C09250C0D46273B4BD7E5225556,31251,11,13,2,109.18528,18.2975,317
39466,293968,7EDB058C3EF2698839110C1DCC8B63DD,31311,0,9,9,109.72299,18.27438,2364
39467,293971,7EDB058C3EF2698839110C1DCC8B63DD,60661,22,23,1,109.548,18.2377,1657
39468,293972,56C8C781972E8BFAF8A768A19AD7F590,30281,0,7,7,109.50597,18.27583,1514
39472,294010,FA14B010F60C7FB3B13194FAA13740E8,31561,0,4,4,109.56792,18.28479,1765
39473,294011,FA14B010F60C7FB3B13194FAA13740E8,39183,9,13,4,109.55542,18.28208,1715
39474,294012,FA14B010F60C7FB3B13194FAA13740E8,31561,14,15,1,109.56792,18.28479,1765
39475,294013,FA14B010F60C7FB3B13194FAA13740E8,39183,16,17,1,109.55542,18.28208,1715
39476,294014,FA14B010F60C7FB3B13194FAA13740E8,31561,21,23,2,109.56792,18.28479,1765
39477,294015,451E2BF48CD7B253EB0892324E679BCC,31461,3,6,3,109.5091,18.25389,1510
39478,294016,451E2BF48CD7B253EB0892324E679BCC,38291,6,12,6,109.51618,18.24313,1558
39479,294017,451E2BF48CD7B253EB0892324E679BCC,60281,13,18,5,109.51743,18.25924,1561
39480,294018,451E2BF48CD7B253EB0892324E679BCC,38291,18,21,3,109.51618,18.24313,1558
39481,294019,451E2BF48CD7B253EB0892324E679BCC,38297,21,23,2,109.52576,18.24965,1609
39482,294051,8883DF5E66B5FC284A8EF97DE8EAAAB3,31041,0,1,1,109.50278,18.23701,1507
39483,294052,8883DF5E66B5FC284A8EF97DE8EAAAB3,30854,2,6,4,109.56889,18.27076,1763
39484,294053,8883DF5E66B5FC284A8EF97DE8EAAAB3,31571,10,12,2,109.61563,18.23326,1957
39495,294108,9D6320D3B3867D2B81B39F405CFAA76C,60054,12,14,2,109.3016,18.31229,770
39496,294109,9D6320D3B3867D2B81B39F405CFAA76C,31781,15,16,1,109.19847,18.2975,367
39497,294110,9D6320D3B3867D2B81B39F405CFAA76C,60281,18,20,2,109.51743,18.25924,1561
39498,294125,2C3BD53A8702A47FB82F05FB4993B683,31561,0,5,5,109.56792,18.28479,1765
39499,294126,2C3BD53A8702A47FB82F05FB4993B683,39183,6,16,10,109.55542,18.28208,1715
39500,294134,807F73DE76DFE56E472FA61396F0887C,30361,16,17,1,109.50347,18.24,1508
39501,294137,BA14385880EBEC70B287EA16B1B82E42,30854,13,21,8,109.56889,18.27076,1763
39502,294138,BA14385880EBEC70B287EA16B1B82E42,31071,22,23,1,109.58257,18.28458,1815
39507,294160,453A1B8CFD05945A8AE39F2B7AC01B79,30741,0,6,6,109.49833,18.28681,1516
39508,294161,453A1B8CFD05945A8AE39F2B7AC01B79,39183,7,10,3,109.55542,18.28208,1715
39509,294162,453A1B8CFD05945A8AE39F2B7AC01B79,30241,11,23,12,109.26174,18.3275,622
39510,294163,866460FA5062A635337B6369BB2AADDA,60214,10,11,1,109.63104,18.24493,2009
39511,294164,866460FA5062A635337B6369BB2AADDA,39183,14,16,2,109.55542,18.28208,1715
39512,294165,866460FA5062A635337B6369BB2AADDA,30854,16,18,2,109.56889,18.27076,1763
39513,294178,B7993F7A715835C0A2F82CB1FFA89538,38111,0,15,15,109.52007,18.22403,1555
39514,294179,B7993F7A715835C0A2F82CB1FFA89538,38111,18,22,4,109.52007,18.22403,1555
39515,294180,860D8FD1FD466E2189F245D42B766A0C,30271,0,10,10,109.49132,18.23153,1456
39516,294181,860D8FD1FD466E2189F245D42B766A0C,31521,12,13,1,109.51458,18.22542,1555
39517,294182,860D8FD1FD466E2189F245D42B766A0C,31851,17,18,1,109.71736,18.29007,2316
39518,294183,860D8FD1FD466E2189F245D42B766A0C,38261,19,22,3,109.50361,18.28153,1515
39523,294229,6A8C883D29A8AF90E102449F92489A64,31041,16,19,3,109.50278,18.23701,1507
39524,294230,6A8C883D29A8AF90E102449F92489A64,30854,20,21,1,109.56889,18.27076,1763
39525,294243,C3EC43179E51E2CA8AF203A259981D18,38754,14,16,2,109.74667,18.37382,2430
39526,294244,C3EC43179E51E2CA8AF203A259981D18,30854,18,23,5,109.56889,18.27076,1763
39530,294326,B0C6DED232762D9BAF78468BD2731104,60491,0,9,9,109.43354,18.30847,1269
39531,294327,B0C6DED232762D9BAF78468BD2731104,30771,13,14,1,109.49938,18.26042,1511
39532,294328,B0C6DED232762D9BAF78468BD2731104,60041,15,17,2,109.39889,18.31944,1121
39533,294329,B0C6DED232762D9BAF78468BD2731104,30771,18,22,4,109.49938,18.26042,1511
39534,294345,CD576F1C1CDFB89E6A99A20E65927346,31561,4,6,2,109.56792,18.28479,1765
39535,294346,CD576F1C1CDFB89E6A99A20E65927346,30854,7,19,12,109.56889,18.27076,1763
39539,294375,B712327B6033C61F37801CFD6DAC08AD,38484,0,5,5,109.53028,18.31528,1620
39540,294376,B712327B6033C61F37801CFD6DAC08AD,30561,7,8,1,109.52778,18.31938,1621
39541,294377,B712327B6033C61F37801CFD6DAC08AD,60361,8,13,5,109.51938,18.29681,1567
39542,294378,B712327B6033C61F37801CFD6DAC08AD,38484,14,17,3,109.53028,18.31528,1620
39543,294379,B712327B6033C61F37801CFD6DAC08AD,30561,20,22,2,109.52778,18.31938,1621
39544,294384,30AB292EA71BCCA29EAC6C791311F4E2,30741,20,23,3,109.49833,18.28681,1516
39545,294394,A7B3BDD8DC79485BA41EC7F220A41345,31071,2,3,1,109.58257,18.28458,1815
39546,294395,A7B3BDD8DC79485BA41EC7F220A41345,30854,4,5,1,109.56889,18.27076,1763
39554,294461,E755AD63601CF016CD8E32C53EBB1378,48574,0,12,12,109.48931,18.28458,1465
39555,294462,E755AD63601CF016CD8E32C53EBB1378,30711,14,16,2,109.50271,18.25347,1510
39556,294463,708F1BFEBD1E1B2DD48C4FB4053D14BA,30201,0,7,7,109.4909,18.26465,1462
39557,294464,708F1BFEBD1E1B2DD48C4FB4053D14BA,30201,10,15,5,109.4909,18.26465,1462
39558,294488,E75FA91D1B3B8DD834D1B7D77ECFF056,60381,0,4,4,109.5241,18.22458,1605
39559,294489,E75FA91D1B3B8DD834D1B7D77ECFF056,31521,8,9,1,109.51458,18.22542,1555
39560,294490,E75FA91D1B3B8DD834D1B7D77ECFF056,31781,11,13,2,109.19847,18.2975,367
39561,294491,E75FA91D1B3B8DD834D1B7D77ECFF056,31781,13,16,3,109.19847,18.2975,367
39562,294492,E75FA91D1B3B8DD834D1B7D77ECFF056,30731,17,19,2,109.50944,18.22306,1555
39563,294493,E75FA91D1B3B8DD834D1B7D77ECFF056,31521,19,21,2,109.51458,18.22542,1555
39564,294494,E75FA91D1B3B8DD834D1B7D77ECFF056,30731,21,23,2,109.50944,18.22306,1555
39568,294652,C7052F3AD02E1F932680BEEA2AF77A5C,60381,19,22,3,109.5241,18.22458,1605
39569,294653,C7052F3AD02E1F932680BEEA2AF77A5C,30711,22,23,1,109.50271,18.25347,1510
39570,294662,C53B1AD12AB7ABCAA2CAFBE9EF3A2B34,31851,14,15,1,109.71736,18.29007,2316
39571,294676,557A975BF2F1D3135462224F08758153,60221,0,6,6,109.52569,18.29188,1616
39572,294677,557A975BF2F1D3135462224F08758153,30071,9,11,2,109.52819,18.30472,1619
39573,294678,557A975BF2F1D3135462224F08758153,60221,12,14,2,109.52569,18.29188,1616
39574,294679,557A975BF2F1D3135462224F08758153,38154,14,15,1,109.5266,18.28278,1615
39575,294680,557A975BF2F1D3135462224F08758153,31951,18,22,4,109.52174,18.30299,1568
39576,294707,491A112CD81B9085F752897809919691,30151,6,7,1,109.50986,18.25083,1560
39577,294708,491A112CD81B9085F752897809919691,30181,7,9,2,109.51597,18.23313,1557
39578,294709,491A112CD81B9085F752897809919691,31201,11,13,2,109.51042,18.23819,1558
39579,294710,491A112CD81B9085F752897809919691,31201,14,16,2,109.51042,18.23819,1558
39580,294711,491A112CD81B9085F752897809919691,31521,18,19,1,109.51458,18.22542,1555
39587,294760,BAA9EFC72165A51675527E0DFEFC767F,30421,0,8,8,109.50021,18.25861,1511
39588,294764,14DC797BA214017EE45D7C82C4CE6C66,60201,0,7,7,109.5041,18.2509,1510
39589,294765,14DC797BA214017EE45D7C82C4CE6C66,60291,7,8,1,109.50826,18.24639,1509
39590,294766,14DC797BA214017EE45D7C82C4CE6C66,38251,12,13,1,109.49618,18.25493,1510
39591,294767,14DC797BA214017EE45D7C82C4CE6C66,38094,13,17,4,109.45403,18.28778,1316
39592,294768,14DC797BA214017EE45D7C82C4CE6C66,60131,17,20,3,109.49819,18.24778,1509
39593,294783,E4B522EF4348156010E5C578EC13D60F,30234,0,7,7,109.60681,18.29979,1918
39594,294784,E4B522EF4348156010E5C578EC13D60F,30281,12,13,1,109.50597,18.27583,1514
39595,294785,C5B2C146A715B405C4C002F4F3423FFB,30071,19,21,2,109.52819,18.30472,1619
39596,294786,C5B2C146A715B405C4C002F4F3423FFB,31931,21,23,2,109.54771,18.29403,1667
39600,294855,10EBF762D28520B09848288F7052CFDE,30854,0,6,6,109.56889,18.27076,1763
39601,294856,10EBF762D28520B09848288F7052CFDE,39101,7,17,10,109.50132,18.24931,1509
39602,294881,963B5F4C98446446023B8ED177B869B3,60361,0,7,7,109.51938,18.29681,1567
39603,294882,963B5F4C98446446023B8ED177B869B3,31561,7,8,1,109.56792,18.28479,1765
39604,294883,963B5F4C98446446023B8ED177B869B3,39181,11,12,1,109.55153,18.28035,1715
39605,294884,963B5F4C98446446023B8ED177B869B3,39183,15,16,1,109.55542,18.28208,1715
39606,294885,963B5F4C98446446023B8ED177B869B3,60361,19,23,4,109.51938,18.29681,1567
39607,294950,DF5348A8E25901EBB63BBF3F6126BB02,31071,6,9,3,109.58257,18.28458,1815
39608,294951,DF5348A8E25901EBB63BBF3F6126BB02,30854,13,22,9,109.56889,18.27076,1763
39609,294952,DF5348A8E25901EBB63BBF3F6126BB02,31071,22,23,1,109.58257,18.28458,1815
39613,294976,3BD938E13C8C03EC810FA672D0264137,31851,7,8,1,109.71736,18.29007,2316
39614,294977,3BD938E13C8C03EC810FA672D0264137,38754,9,11,2,109.74667,18.37382,2430
39615,294978,3BD938E13C8C03EC810FA672D0264137,31851,13,14,1,109.71736,18.29007,2316
39616,294979,3BD938E13C8C03EC810FA672D0264137,30731,17,18,1,109.50944,18.22306,1555
39617,294980,3BD938E13C8C03EC810FA672D0264137,60041,21,22,1,109.39889,18.31944,1121
39618,294985,998285CC628D14C76697C580F37BFCB3,30854,9,18,9,109.56889,18.27076,1763
39622,295018,7AF4921BC4D1712A961904D0ECC91550,60251,0,5,5,109.51229,18.325,1572
39623,295019,7AF4921BC4D1712A961904D0ECC91550,30071,8,22,14,109.52819,18.30472,1619
39627,295024,1026894DC5FF9A7FAF3A2EE28B95E239,30854,0,10,10,109.56889,18.27076,1763
39628,295025,1026894DC5FF9A7FAF3A2EE28B95E239,30232,12,16,4,109.6191,18.31701,1971
39629,295026,1026894DC5FF9A7FAF3A2EE28B95E239,30854,19,23,4,109.56889,18.27076,1763
39630,295037,FB78BA035409FF816D7E7985C2AAAB1F,60571,0,7,7,109.50722,18.25056,1510
39634,295063,D70D11871FB47AB4743A9AB8A25E5AA8,60241,16,18,2,109.53319,18.28667,1616
39635,295064,D70D11871FB47AB4743A9AB8A25E5AA8,38241,19,23,4,109.54111,18.30542,1669
39642,295166,F866B6E34CEF853A6497211DD74A607E,31781,12,14,2,109.19847,18.2975,367
39643,295167,F866B6E34CEF853A6497211DD74A607E,31221,19,20,1,109.61333,18.26833,1913
39644,295168,F866B6E34CEF853A6497211DD74A607E,30581,20,21,1,109.62257,18.24951,1959
39645,295194,D4448A1349B0563C78F16B479359A95F,31071,2,6,4,109.58257,18.28458,1815
39646,295195,D4448A1349B0563C78F16B479359A95F,30854,10,14,4,109.56889,18.27076,1763
39647,295220,977B047FDC414AF497F7474C1B57AB53,31301,10,13,3,109.14493,18.31222,170
39648,295221,977B047FDC414AF497F7474C1B57AB53,31471,14,16,2,109.34583,18.29563,917
39659,295328,BC2EDF4DF9C7FAD55BDEABA03DFA7284,39181,11,12,1,109.55153,18.28035,1715
39660,295329,BC2EDF4DF9C7FAD55BDEABA03DFA7284,39183,16,17,1,109.55542,18.28208,1715
39661,295330,BC2EDF4DF9C7FAD55BDEABA03DFA7284,31561,19,20,1,109.56792,18.28479,1765
39662,295389,B3F4E43DA3C4E855A3ED684A6CB97F36,31931,7,9,2,109.54771,18.29403,1667
39663,295390,B3F4E43DA3C4E855A3ED684A6CB97F36,31781,11,15,4,109.19847,18.2975,367
39667,295409,238275AB416C5FADC48DECC442F08D48,30861,19,21,2,109.52722,18.22743,1606
39668,295410,238275AB416C5FADC48DECC442F08D48,31521,21,22,1,109.51458,18.22542,1555
39672,295455,4ADA61D538F345B0D3199AFC58D5D8E2,31351,0,10,10,109.4959,18.28417,1465
39673,295456,4ADA61D538F345B0D3199AFC58D5D8E2,31471,14,16,2,109.34583,18.29563,917
39674,295457,4ADA61D538F345B0D3199AFC58D5D8E2,31351,18,23,5,109.4959,18.28417,1465
39675,295465,799220958664C2795E31D21DB72AB004,30071,0,20,20,109.52819,18.30472,1619
39676,295466,799220958664C2795E31D21DB72AB004,60371,20,23,3,109.53063,18.30056,1618
39677,295467,005F3AEFE6DBF371ED1FD57736434098,31071,0,5,5,109.58257,18.28458,1815
39678,295468,005F3AEFE6DBF371ED1FD57736434098,30854,8,10,2,109.56889,18.27076,1763
39679,295469,005F3AEFE6DBF371ED1FD57736434098,31071,13,14,1,109.58257,18.28458,1815
39680,295470,005F3AEFE6DBF371ED1FD57736434098,30854,19,20,1,109.56889,18.27076,1763
39681,295471,005F3AEFE6DBF371ED1FD57736434098,31071,21,23,2,109.58257,18.28458,1815
39685,295505,8C2C88A2570BC7163EE5C8FCDA6504D2,31201,15,16,1,109.51042,18.23819,1558
39686,295506,8C2C88A2570BC7163EE5C8FCDA6504D2,30181,16,18,2,109.51597,18.23313,1557
39687,295507,8C2C88A2570BC7163EE5C8FCDA6504D2,30181,21,23,2,109.51597,18.23313,1557
39688,295536,F5679723FB4AA5B56D261497814C1AB4,60401,0,6,6,109.47444,18.27583,1414
39689,295537,F5679723FB4AA5B56D261497814C1AB4,60621,7,8,1,109.48354,18.27451,1464
39690,295538,F5679723FB4AA5B56D261497814C1AB4,31471,11,15,4,109.34583,18.29563,917
39691,295539,ABCD0851CC1C78BCD7AF6DBDF2F5DE49,60401,6,7,1,109.47444,18.27583,1414
39692,295540,ABCD0851CC1C78BCD7AF6DBDF2F5DE49,60552,9,10,1,109.41729,18.30014,1218
39693,295541,ABCD0851CC1C78BCD7AF6DBDF2F5DE49,60524,11,12,1,109.42951,18.28993,1216
39694,295542,ABCD0851CC1C78BCD7AF6DBDF2F5DE49,60552,12,19,7,109.41729,18.30014,1218
39695,295548,5E97A4561E11AAC4FBC53FD068EAA52B,30531,13,21,8,109.53271,18.21472,1604
39696,295549,5E97A4561E11AAC4FBC53FD068EAA52B,30854,21,23,2,109.56889,18.27076,1763
39707,295607,7252A0F90E29EC78621699C082578EF7,30711,0,1,1,109.50271,18.25347,1510
39708,295608,7252A0F90E29EC78621699C082578EF7,30911,1,7,6,109.50493,18.26181,1511
39709,295609,7252A0F90E29EC78621699C082578EF7,60504,9,16,7,109.47917,18.28903,1416
39710,295610,7252A0F90E29EC78621699C082578EF7,31431,20,23,3,109.44639,18.29042,1316
39714,295654,614FF11A716656363443555E30C1ED90,38754,14,15,1,109.74667,18.37382,2430
39715,295655,614FF11A716656363443555E30C1ED90,30361,19,23,4,109.50347,18.24,1508
39719,295703,C6FC3BC8F39125E5FB7F384B2CB5A668,33051,11,13,2,109.6475,18.46618,2096
39720,295704,C6FC3BC8F39125E5FB7F384B2CB5A668,30854,17,18,1,109.56889,18.27076,1763
39721,295705,C6FC3BC8F39125E5FB7F384B2CB5A668,60221,19,20,1,109.52569,18.29188,1616
39722,295708,4E94ADAE7ABEB20EEFAF67519DFCC1BE,31081,0,8,8,109.44639,18.30181,1318
39723,295709,4E94ADAE7ABEB20EEFAF67519DFCC1BE,31031,9,21,12,109.49979,18.25382,1510
39724,295725,89FBAD5ECA927DDE2F269DE418286B71,30791,12,18,6,109.72333,18.40889,2386
39725,295726,89FBAD5ECA927DDE2F269DE418286B71,31091,19,20,1,109.41201,18.31222,1170
39726,295767,6FBDDF7419820F8908B8A8CE3C81E7C3,30171,0,5,5,109.48458,18.27139,1463
39727,295768,6FBDDF7419820F8908B8A8CE3C81E7C3,60621,7,11,4,109.48354,18.27451,1464
39728,295769,6FBDDF7419820F8908B8A8CE3C81E7C3,60401,13,15,2,109.47444,18.27583,1414
39729,295770,6FBDDF7419820F8908B8A8CE3C81E7C3,30171,16,17,1,109.48458,18.27139,1463
39730,295771,6FBDDF7419820F8908B8A8CE3C81E7C3,60401,22,23,1,109.47444,18.27583,1414
39731,295802,7A6FA68DEF3DC3D7B02A26590A74E0F0,31071,6,7,1,109.58257,18.28458,1815
39732,295803,7A6FA68DEF3DC3D7B02A26590A74E0F0,31031,10,11,1,109.49979,18.25382,1510
39733,295804,7A6FA68DEF3DC3D7B02A26590A74E0F0,30854,16,17,1,109.56889,18.27076,1763
39741,295831,5793648B72B1A755037A2568E7D7481F,38105,0,7,7,109.40299,18.29229,1117
39742,295832,5793648B72B1A755037A2568E7D7481F,31681,8,10,2,109.40396,18.29979,1168
39743,295833,5793648B72B1A755037A2568E7D7481F,31145,12,14,2,109.20431,18.30479,369
39744,295834,5793648B72B1A755037A2568E7D7481F,38105,16,18,2,109.40299,18.29229,1117
39753,295865,662D882A6A10D0E6C3566690F0A40636,31071,1,6,5,109.58257,18.28458,1815
39754,295866,662D882A6A10D0E6C3566690F0A40636,30854,9,18,9,109.56889,18.27076,1763
39755,295867,662D882A6A10D0E6C3566690F0A40636,60381,18,21,3,109.5241,18.22458,1605
39756,295872,35C6EDC8AAC6B5ABA770190223528BA2,60381,0,6,6,109.5241,18.22458,1605
39757,295873,35C6EDC8AAC6B5ABA770190223528BA2,31521,11,12,1,109.51458,18.22542,1555
39758,295874,35C6EDC8AAC6B5ABA770190223528BA2,60041,14,15,1,109.39889,18.31944,1121
39759,295879,0526FBDD03CECB7E3925506B4441EC17,31443,0,9,9,109.5116,18.24438,1559
39760,295880,0526FBDD03CECB7E3925506B4441EC17,30511,10,20,10,109.51069,18.24208,1558
39761,295940,6ECDAC78F6AC4B567D95A309E3788C97,60371,16,17,1,109.53063,18.30056,1618
39762,295941,6ECDAC78F6AC4B567D95A309E3788C97,60361,18,22,4,109.51938,18.29681,1567
39763,295975,770A00BDAFE9BCA8C9E9FA68066EED7D,31071,0,6,6,109.58257,18.28458,1815
39764,295976,770A00BDAFE9BCA8C9E9FA68066EED7D,31561,8,21,13,109.56792,18.28479,1765
39765,296027,DC0EB400EA24BEE9EB39D315B0E6AEF0,60041,0,7,7,109.39889,18.31944,1121
39766,296028,DC0EB400EA24BEE9EB39D315B0E6AEF0,31701,10,14,4,109.44132,18.28833,1266
39767,296033,FFFC0994E5C15BDB165344716912442C,30854,1,4,3,109.56889,18.27076,1763
39768,296034,FFFC0994E5C15BDB165344716912442C,39371,5,6,1,109.56627,18.2646,1762
39769,296035,FFFC0994E5C15BDB165344716912442C,31554,7,17,10,109.55521,18.2459,1709
39770,296036,FFFC0994E5C15BDB165344716912442C,31551,19,20,1,109.55868,18.24222,1708
39771,296037,FFFC0994E5C15BDB165344716912442C,30854,21,23,2,109.56889,18.27076,1763
39772,296043,79B3727B5613EF3F60EFCD1531AA56DA,38961,9,12,3,109.50847,18.23514,1507
39773,296044,79B3727B5613EF3F60EFCD1531AA56DA,31206,12,14,2,109.50819,18.23549,1507
39774,296045,79B3727B5613EF3F60EFCD1531AA56DA,30181,14,16,2,109.51597,18.23313,1557
39775,296046,79B3727B5613EF3F60EFCD1531AA56DA,30181,17,18,1,109.51597,18.23313,1557
39776,296047,79B3727B5613EF3F60EFCD1531AA56DA,38961,19,21,2,109.50847,18.23514,1507
39777,296048,79B3727B5613EF3F60EFCD1531AA56DA,30181,22,23,1,109.51597,18.23313,1557
39781,296115,0125189CAB0CF2CF2538FA07CD6C9B13,30861,12,13,1,109.52722,18.22743,1606
39782,296116,0125189CAB0CF2CF2538FA07CD6C9B13,60381,14,17,3,109.5241,18.22458,1605
39783,296117,0125189CAB0CF2CF2538FA07CD6C9B13,31421,19,22,3,109.55382,18.22347,1705
39784,296128,8AD9F37216B2D3FCE05CA77434307672,30741,0,8,8,109.49833,18.28681,1516
39785,296129,8AD9F37216B2D3FCE05CA77434307672,30324,13,14,1,109.50326,18.29257,1517
39786,296130,8AD9F37216B2D3FCE05CA77434307672,31041,15,17,2,109.50278,18.23701,1507
39787,296131,8AD9F37216B2D3FCE05CA77434307672,31461,18,19,1,109.5091,18.25389,1510
39788,296132,8AD9F37216B2D3FCE05CA77434307672,30361,21,22,1,109.50347,18.24,1508
39789,296144,E191BF114A3C2277CB7C3323BAA13F43,31561,1,6,5,109.56792,18.28479,1765
39790,296145,E191BF114A3C2277CB7C3323BAA13F43,30854,8,11,3,109.56889,18.27076,1763
39791,296146,E191BF114A3C2277CB7C3323BAA13F43,31561,12,13,1,109.56792,18.28479,1765
39792,296147,E191BF114A3C2277CB7C3323BAA13F43,30854,13,18,5,109.56889,18.27076,1763
39793,296148,E191BF114A3C2277CB7C3323BAA13F43,31561,18,20,2,109.56792,18.28479,1765
39794,296156,B81DEDE33B0853E35D97557F334A4861,60361,0,6,6,109.51938,18.29681,1567
39795,296157,B81DEDE33B0853E35D97557F334A4861,31931,6,10,4,109.54771,18.29403,1667
39796,296158,B81DEDE33B0853E35D97557F334A4861,60371,10,11,1,109.53063,18.30056,1618
39797,296159,B81DEDE33B0853E35D97557F334A4861,31931,13,15,2,109.54771,18.29403,1667
39798,296160,B81DEDE33B0853E35D97557F334A4861,60371,15,16,1,109.53063,18.30056,1618
39799,296161,B81DEDE33B0853E35D97557F334A4861,60361,18,23,5,109.51938,18.29681,1567
39803,296176,A68637AA89BD62624E677D9E66C32FAD,30361,14,18,4,109.50347,18.24,1508
39804,296177,A68637AA89BD62624E677D9E66C32FAD,30151,18,20,2,109.50986,18.25083,1560
39805,296178,A68637AA89BD62624E677D9E66C32FAD,30361,21,23,2,109.50347,18.24,1508
39806,296200,E8D51F8B53F290BFD73338AD2AD8C728,31561,3,6,3,109.56792,18.28479,1765
39807,296201,E8D51F8B53F290BFD73338AD2AD8C728,30851,6,7,1,109.5616,18.27396,1713
39808,296202,E8D51F8B53F290BFD73338AD2AD8C728,39183,8,15,7,109.55542,18.28208,1715
39809,296203,E8D51F8B53F290BFD73338AD2AD8C728,30851,15,16,1,109.5616,18.27396,1713
39810,296204,E8D51F8B53F290BFD73338AD2AD8C728,31561,21,22,1,109.56792,18.28479,1765
39811,296205,5181D36DA7C2B30D8787EFAFB9BDA0A6,30201,13,18,5,109.4909,18.26465,1462
39812,296206,5181D36DA7C2B30D8787EFAFB9BDA0A6,31271,20,23,3,109.48958,18.26257,1462
39813,296214,D77A5C2E97A74D805A87772560CE2BFF,31421,0,2,2,109.55382,18.22347,1705
39814,296215,D77A5C2E97A74D805A87772560CE2BFF,60661,3,4,1,109.548,18.2377,1657
39815,296216,D77A5C2E97A74D805A87772560CE2BFF,31421,9,13,4,109.55382,18.22347,1705
39816,296217,D77A5C2E97A74D805A87772560CE2BFF,60661,15,17,2,109.548,18.2377,1657
39817,296218,D77A5C2E97A74D805A87772560CE2BFF,31421,21,23,2,109.55382,18.22347,1705
39818,296228,5F8201E6B61274044E839FD7CFD93F63,39151,4,6,2,109.49875,18.25097,1510
39819,296229,5F8201E6B61274044E839FD7CFD93F63,60201,7,9,2,109.5041,18.2509,1510
39820,296230,5F8201E6B61274044E839FD7CFD93F63,30581,14,15,1,109.62257,18.24951,1959
39821,296231,5F8201E6B61274044E839FD7CFD93F63,60381,17,20,3,109.5241,18.22458,1605
39822,296251,3389A095460231D31BA622B7185D6321,31231,0,6,6,109.42597,18.29292,1217
39823,296252,3389A095460231D31BA622B7185D6321,60541,6,8,2,109.4084,18.29208,1167
39824,296253,3389A095460231D31BA622B7185D6321,31681,8,15,7,109.40396,18.29979,1168
39825,296254,3389A095460231D31BA622B7185D6321,60541,15,17,2,109.4084,18.29208,1167
39826,296255,3389A095460231D31BA622B7185D6321,31231,20,22,2,109.42597,18.29292,1217
39830,296289,4FE38A259CD9CA4D16D21E385E254E6B,31521,0,9,9,109.51458,18.22542,1555
39831,296290,4FE38A259CD9CA4D16D21E385E254E6B,60054,12,13,1,109.3016,18.31229,770
39832,296291,4FE38A259CD9CA4D16D21E385E254E6B,31521,18,22,4,109.51458,18.22542,1555
39833,296299,EE1DC3D3663945EFC02BAB5EE6A065E9,31071,0,6,6,109.58257,18.28458,1815
39834,296300,EE1DC3D3663945EFC02BAB5EE6A065E9,30854,7,10,3,109.56889,18.27076,1763
39835,296301,EE1DC3D3663945EFC02BAB5EE6A065E9,31071,13,14,1,109.58257,18.28458,1815
39836,296302,EE1DC3D3663945EFC02BAB5EE6A065E9,31945,14,15,1,109.58021,18.29403,1817
39837,296303,EE1DC3D3663945EFC02BAB5EE6A065E9,30854,16,18,2,109.56889,18.27076,1763
39838,296304,EE1DC3D3663945EFC02BAB5EE6A065E9,31071,20,21,1,109.58257,18.28458,1815
39839,296346,72177A73AAAB20F72EF042BBE6E3BE32,60221,10,18,8,109.52569,18.29188,1616
39840,296347,72177A73AAAB20F72EF042BBE6E3BE32,31411,19,20,1,109.5016,18.23576,1507
39848,296402,77A180FA90A8F66A03EF34FAA544F484,31471,13,15,2,109.34583,18.29563,917
39849,296403,77A180FA90A8F66A03EF34FAA544F484,30661,18,20,2,109.37028,18.24361,1008
39850,296404,77A180FA90A8F66A03EF34FAA544F484,60411,21,23,2,109.32514,18.30854,869
39851,296429,A9FCE0049DB44FE004EAFBF5B783F4A5,31945,1,19,18,109.58021,18.29403,1817
39852,296430,A9FCE0049DB44FE004EAFBF5B783F4A5,31071,20,22,2,109.58257,18.28458,1815
39853,296455,0270DAEF3EF6B3B2DABFFC55A64C6B34,31471,13,14,1,109.34583,18.29563,917
39854,296456,0270DAEF3EF6B3B2DABFFC55A64C6B34,30171,17,21,4,109.48458,18.27139,1463
39859,296497,01ECC36953381CE72C016208317495FE,30771,0,7,7,109.49938,18.26042,1511
39860,296498,01ECC36953381CE72C016208317495FE,31145,8,10,2,109.20431,18.30479,369
39861,296499,01ECC36953381CE72C016208317495FE,60321,13,15,2,109.63611,18.24306,2008
39862,296501,EC721F8259E3B17F432086B3F60AECE1,31554,0,3,3,109.55521,18.2459,1709
39863,296502,EC721F8259E3B17F432086B3F60AECE1,31551,3,5,2,109.55868,18.24222,1708
39864,296503,EC721F8259E3B17F432086B3F60AECE1,30051,6,10,4,109.48917,18.21215,1453
39865,296504,EC721F8259E3B17F432086B3F60AECE1,30051,11,15,4,109.48917,18.21215,1453
39866,296505,A94F66C88B84FF0658441320CD9F667C,60631,3,4,1,109.57778,18.27583,1814
39867,296506,A94F66C88B84FF0658441320CD9F667C,30854,8,13,5,109.56889,18.27076,1763
39871,296533,C14D1B427B7E4D81EF61B9A5CEA7D7AC,38023,0,7,7,109.37132,18.28993,1016
39872,296538,215105BD5DABC32D5AB3BF02FEF380FF,31521,0,13,13,109.51458,18.22542,1555
39873,296539,215105BD5DABC32D5AB3BF02FEF380FF,31781,15,16,1,109.19847,18.2975,367
39874,296578,8B167331F8E78254A4CBA6A89A1236BC,60161,14,16,2,109.49174,18.26181,1461
39875,296579,8B167331F8E78254A4CBA6A89A1236BC,60084,16,18,2,109.4984,18.2334,1507
39876,296580,8B167331F8E78254A4CBA6A89A1236BC,60524,21,22,1,109.42951,18.28993,1216
39877,296606,F00821368F615DCDAF214035D8EC4A44,30854,14,18,4,109.56889,18.27076,1763
39878,296607,F00821368F615DCDAF214035D8EC4A44,31071,19,20,1,109.58257,18.28458,1815
39879,296608,F00821368F615DCDAF214035D8EC4A44,30854,21,22,1,109.56889,18.27076,1763
39880,296609,8C0E6B51FAFE21C31FB9AE08C36DF0A2,30071,0,18,18,109.52819,18.30472,1619
39881,296610,8C0E6B51FAFE21C31FB9AE08C36DF0A2,31931,18,20,2,109.54771,18.29403,1667
39882,296631,770049901BD1590EBE86EED8F56910D2,31391,20,21,1,109.50382,18.24285,1508
39883,296714,409F5E8F01172D32BBE91132149C037E,38371,0,7,7,109.50972,18.23924,1558
39884,296715,409F5E8F01172D32BBE91132149C037E,30511,11,12,1,109.51069,18.24208,1558
39885,296718,53490AD77ACCA93C3ED0F3DE79CA488B,31071,11,12,1,109.58257,18.28458,1815
39886,296719,53490AD77ACCA93C3ED0F3DE79CA488B,30854,14,20,6,109.56889,18.27076,1763
39887,296739,3963776B8D4E0FE3D76B833D367A499E,31231,0,17,17,109.42597,18.29292,1217
39888,296740,3963776B8D4E0FE3D76B833D367A499E,60551,18,22,4,109.42722,18.30111,1218
39889,296770,46CE0B466E804E1721D4C7FB123D7148,30741,0,6,6,109.49833,18.28681,1516
39890,296773,46CE0B466E804E1721D4C7FB123D7148,30741,19,23,4,109.49833,18.28681,1516
39891,296777,CA270603E07BFD84E81CD1B62EEBFEDA,31781,15,16,1,109.19847,18.2975,367
39892,296778,CA270603E07BFD84E81CD1B62EEBFEDA,38754,19,21,2,109.74667,18.37382,2430
39896,296786,83865250E5CCE3477CF5EC458983B28B,39091,0,19,19,109.50097,18.25222,1510
39897,296787,83865250E5CCE3477CF5EC458983B28B,60081,21,23,2,109.51097,18.22639,1556
39898,296806,3156215AB6E0ED7C8AC4A32B10F06A65,60524,2,9,7,109.42951,18.28993,1216
39899,296807,3156215AB6E0ED7C8AC4A32B10F06A65,31031,13,14,1,109.49979,18.25382,1510
39908,296847,38AA3DA5E97F70E8689E8DE10EE9EB59,30854,0,8,8,109.56889,18.27076,1763
39909,296849,38AA3DA5E97F70E8689E8DE10EE9EB59,30854,13,14,1,109.56889,18.27076,1763
39910,296850,3A484AED43EBFC77572B117C1C49420B,31081,0,6,6,109.44639,18.30181,1318
39911,296851,3A484AED43EBFC77572B117C1C49420B,31471,7,9,2,109.34583,18.29563,917
39912,296852,3A484AED43EBFC77572B117C1C49420B,31471,10,12,2,109.34583,18.29563,917
39913,296853,3A484AED43EBFC77572B117C1C49420B,60054,12,14,2,109.3016,18.31229,770
39914,296854,3A484AED43EBFC77572B117C1C49420B,31471,14,17,3,109.34583,18.29563,917
39915,296855,3A484AED43EBFC77572B117C1C49420B,30761,20,22,2,109.45201,18.3,1318
39919,296872,8799356B7181F28146A203E5F86C52F0,60381,18,21,3,109.5241,18.22458,1605
39920,296873,8799356B7181F28146A203E5F86C52F0,30741,21,23,2,109.49833,18.28681,1516
39921,296900,3DF04EEBD52CECF1C5996BD8607451EE,30351,0,10,10,109.41701,18.29292,1217
39925,296923,FEA371B99B04FC8CCEB8F07D4D5C7BA2,60281,18,19,1,109.51743,18.25924,1561
39926,296924,FEA371B99B04FC8CCEB8F07D4D5C7BA2,38127,19,23,4,109.50833,18.27222,1513
39927,296933,7EBC20D0E5F0FBA046CA1D08E7FF47C1,31071,5,6,1,109.58257,18.28458,1815
39928,296934,7EBC20D0E5F0FBA046CA1D08E7FF47C1,30854,10,18,8,109.56889,18.27076,1763
39929,296948,D1300109B338AA3BEF146D962603C6CB,60671,0,6,6,109.52979,18.31757,1621
39930,296949,D1300109B338AA3BEF146D962603C6CB,30071,9,11,2,109.52819,18.30472,1619
39931,296950,D1300109B338AA3BEF146D962603C6CB,60291,13,14,1,109.50826,18.24639,1509
39947,297050,744908594665C830F5D7DD2D0AC61E3F,60524,0,2,2,109.42951,18.28993,1216
39948,297051,744908594665C830F5D7DD2D0AC61E3F,39151,3,6,3,109.49875,18.25097,1510
39949,297053,744908594665C830F5D7DD2D0AC61E3F,60381,15,17,2,109.5241,18.22458,1605
39950,297054,744908594665C830F5D7DD2D0AC61E3F,30191,19,23,4,109.50361,18.22701,1506
39951,297080,E2EFA8BC0580FFAF96EC3E9753740AD9,38094,8,9,1,109.45403,18.28778,1316
39952,297081,E2EFA8BC0580FFAF96EC3E9753740AD9,30421,9,12,3,109.50021,18.25861,1511
39953,297082,E2EFA8BC0580FFAF96EC3E9753740AD9,38251,13,14,1,109.49618,18.25493,1510
39954,297084,C36A64D4A6D72B66303543285987394A,31461,11,13,2,109.5091,18.25389,1510
39955,297085,C36A64D4A6D72B66303543285987394A,31864,14,20,6,109.49014,18.28333,1465
39956,297086,C36A64D4A6D72B66303543285987394A,60501,21,23,2,109.48701,18.29021,1466
39957,297095,8C1099DEED57B63CAF4C9A1B76A91E98,30511,13,15,2,109.51069,18.24208,1558
39958,297125,012ABD06F231728C214A4BA917E75B1C,30851,4,5,1,109.5616,18.27396,1713
39959,297126,012ABD06F231728C214A4BA917E75B1C,31561,6,23,17,109.56792,18.28479,1765
39963,297197,BEE3A0C9BB09D7F210E3490BED90A1BE,60371,0,7,7,109.53063,18.30056,1618
39964,297198,BEE3A0C9BB09D7F210E3490BED90A1BE,30071,7,11,4,109.52819,18.30472,1619
39965,297199,BEE3A0C9BB09D7F210E3490BED90A1BE,60371,12,17,5,109.53063,18.30056,1618
39966,297200,BEE3A0C9BB09D7F210E3490BED90A1BE,30071,18,19,1,109.52819,18.30472,1619
39967,297201,BEE3A0C9BB09D7F210E3490BED90A1BE,60371,19,23,4,109.53063,18.30056,1618
39968,297253,D61883A9E0C7F2103C981F95E51C66DA,31931,0,6,6,109.54771,18.29403,1667
39969,297254,D61883A9E0C7F2103C981F95E51C66DA,39321,10,14,4,109.529,18.2167,1604
39970,297255,D61883A9E0C7F2103C981F95E51C66DA,30861,14,17,3,109.52722,18.22743,1606
39971,297256,D61883A9E0C7F2103C981F95E51C66DA,39321,19,21,2,109.529,18.2167,1604
39972,297262,99002E6383DE5A5B6F8A2B2BF47C2DE1,31061,0,7,7,109.53333,18.23257,1607
39973,297263,99002E6383DE5A5B6F8A2B2BF47C2DE1,60301,10,11,1,109.60715,18.30993,1919
39974,297264,99002E6383DE5A5B6F8A2B2BF47C2DE1,60381,14,18,4,109.5241,18.22458,1605
39975,297265,99002E6383DE5A5B6F8A2B2BF47C2DE1,31061,19,20,1,109.53333,18.23257,1607
39976,297266,99002E6383DE5A5B6F8A2B2BF47C2DE1,38071,21,22,1,109.40722,18.30938,1169
39981,297295,6ADBEFDC21CA46F051933BF984A8E255,30854,2,8,6,109.56889,18.27076,1763
39982,297296,6ADBEFDC21CA46F051933BF984A8E255,31071,9,22,13,109.58257,18.28458,1815
39983,297326,E60ED1E1BF063E0844329EA0E7251BDC,30661,0,6,6,109.37028,18.24361,1008
39984,297327,E60ED1E1BF063E0844329EA0E7251BDC,60411,7,9,2,109.32514,18.30854,869
39985,297328,E60ED1E1BF063E0844329EA0E7251BDC,31471,9,15,6,109.34583,18.29563,917
39992,297413,377B71D252968E1BF1EC3B7B3FD9F9AC,31521,15,17,2,109.51458,18.22542,1555
39993,297414,377B71D252968E1BF1EC3B7B3FD9F9AC,31521,19,23,4,109.51458,18.22542,1555
39994,297438,7198AE5D28E6EEC6FA2A3E21485072AD,30051,0,13,13,109.48917,18.21215,1453
39995,297439,7198AE5D28E6EEC6FA2A3E21485072AD,60401,14,16,2,109.47444,18.27583,1414
39996,297440,7198AE5D28E6EEC6FA2A3E21485072AD,30051,20,23,3,109.48917,18.21215,1453
39997,297441,6422CB87ACC55DDEF6EBE8946593C808,31351,0,7,7,109.4959,18.28417,1465
39998,297442,6422CB87ACC55DDEF6EBE8946593C808,60231,8,9,1,109.49903,18.21972,1504
39999,297443,6422CB87ACC55DDEF6EBE8946593C808,60211,11,13,2,109.63549,18.26049,2011
40000,297444,6422CB87ACC55DDEF6EBE8946593C808,30051,14,15,1,109.48917,18.21215,1453
40001,297445,6422CB87ACC55DDEF6EBE8946593C808,31201,15,17,2,109.51042,18.23819,1558
40002,297446,6422CB87ACC55DDEF6EBE8946593C808,30391,21,23,2,109.4975,18.27118,1513
40003,297458,1412BA3B65BC1A2354CCBE297098A0E1,30281,12,13,1,109.50597,18.27583,1514
40004,297459,1412BA3B65BC1A2354CCBE297098A0E1,30854,14,16,2,109.56889,18.27076,1763
40005,297479,53453D8B736810206EC5A6632D159BE6,31931,0,7,7,109.54771,18.29403,1667
40006,297480,53453D8B736810206EC5A6632D159BE6,39101,9,12,3,109.50132,18.24931,1509
40007,297481,53453D8B736810206EC5A6632D159BE6,31931,14,23,9,109.54771,18.29403,1667
40008,297490,FA724E83D7D22E41E07D0D2550D22166,31071,12,17,5,109.58257,18.28458,1815
40009,297491,FA724E83D7D22E41E07D0D2550D22166,30854,18,20,2,109.56889,18.27076,1763
40010,297492,FA724E83D7D22E41E07D0D2550D22166,31071,21,23,2,109.58257,18.28458,1815
40011,297493,9EBFE19AEC38C3A6F47AE2D903294BAE,60211,15,18,3,109.63549,18.26049,2011
40012,297494,9EBFE19AEC38C3A6F47AE2D903294BAE,31071,19,20,1,109.58257,18.28458,1815
40013,297513,D96E01B8E0F0DE9C160C9FEAFDCFDB6D,31071,1,7,6,109.58257,18.28458,1815
40014,297514,D96E01B8E0F0DE9C160C9FEAFDCFDB6D,30854,8,18,10,109.56889,18.27076,1763
40015,297539,27EF636E06F07DE3B49333ADB4121040,31351,2,9,7,109.4959,18.28417,1465
40016,297540,27EF636E06F07DE3B49333ADB4121040,60121,12,13,1,109.74507,18.37472,2430
40017,297541,27EF636E06F07DE3B49333ADB4121040,60381,15,16,1,109.5241,18.22458,1605
40018,297542,27EF636E06F07DE3B49333ADB4121040,60261,21,22,1,109.44326,18.3075,1319
40019,297548,E450E9940D87A0177BBD06EB4A11C623,31321,0,8,8,109.63799,18.23201,2007
40020,297549,E450E9940D87A0177BBD06EB4A11C623,38754,10,13,3,109.74667,18.37382,2430
40021,297550,E450E9940D87A0177BBD06EB4A11C623,31031,15,17,2,109.49979,18.25382,1510
40022,297559,5B5FB16F9BE2A1826D497C2695908410,31561,2,9,7,109.56792,18.28479,1765
40023,297560,5B5FB16F9BE2A1826D497C2695908410,30854,10,11,1,109.56889,18.27076,1763
40028,297595,34EC12898EF350285E14A0DA28399618,30854,0,19,19,109.56889,18.27076,1763
40029,297596,34EC12898EF350285E14A0DA28399618,31561,20,21,1,109.56792,18.28479,1765
40030,297601,468231DFF07583BA8A222D360B2FDB3A,60501,0,8,8,109.48701,18.29021,1466
40031,297602,468231DFF07583BA8A222D360B2FDB3A,30084,9,17,8,109.50118,18.26972,1513
40032,297627,C8922FAF66F21ECAECB6B717FCD5A53B,60504,1,5,4,109.47917,18.28903,1416
40033,297628,C8922FAF66F21ECAECB6B717FCD5A53B,60614,6,22,16,109.48799,18.29521,1467
40034,297642,9E8746086915F9D4A063A74CF0B5B7AB,39183,16,18,2,109.55542,18.28208,1715
40035,297643,9E8746086915F9D4A063A74CF0B5B7AB,31561,20,21,1,109.56792,18.28479,1765
40036,297644,601485EE1975CD21F8AEB362220395E5,31231,0,4,4,109.42597,18.29292,1217
40037,297645,601485EE1975CD21F8AEB362220395E5,38102,4,6,2,109.40875,18.29111,1166
40038,297646,601485EE1975CD21F8AEB362220395E5,31231,7,11,4,109.42597,18.29292,1217
40039,297647,601485EE1975CD21F8AEB362220395E5,30711,13,16,3,109.50271,18.25347,1510
40040,297648,601485EE1975CD21F8AEB362220395E5,31041,19,20,1,109.50278,18.23701,1507
40041,297649,601485EE1975CD21F8AEB362220395E5,31231,21,23,2,109.42597,18.29292,1217
40042,297653,2B60907F04C29DE058B3E64B1D3B4100,30854,0,6,6,109.56889,18.27076,1763
40043,297654,2B60907F04C29DE058B3E64B1D3B4100,31561,7,8,1,109.56792,18.28479,1765
40044,297669,51DF765CB634D9549D20AD1F2C37BA18,31561,3,9,6,109.56792,18.28479,1765
40045,297670,51DF765CB634D9549D20AD1F2C37BA18,31931,14,15,1,109.54771,18.29403,1667
40050,297719,E9E473F09C342630187345312F4A31D8,39181,0,16,16,109.55153,18.28035,1715
40051,297720,E9E473F09C342630187345312F4A31D8,39181,20,23,3,109.55153,18.28035,1715
40052,297748,08A066736557478B1013C0CF834491DF,31931,1,17,16,109.54771,18.29403,1667
40053,297749,08A066736557478B1013C0CF834491DF,30921,18,19,1,109.53903,18.29451,1667
40054,297785,00FC332040A284DA251A8D0705989FE9,31071,0,9,9,109.58257,18.28458,1815
40055,297786,00FC332040A284DA251A8D0705989FE9,30854,14,23,9,109.56889,18.27076,1763
40056,297823,5169AE4C4AE9067320D7FAAA8A39A4BE,31511,0,5,5,109.26326,18.40521,635
40057,297825,5169AE4C4AE9067320D7FAAA8A39A4BE,31511,17,22,5,109.26326,18.40521,635
40064,297913,996108A86471458B319C4287B4728CCB,38891,0,6,6,109.51486,18.24118,1558
40065,297914,996108A86471458B319C4287B4728CCB,31521,6,10,4,109.51458,18.22542,1555
40066,297915,996108A86471458B319C4287B4728CCB,31521,11,13,2,109.51458,18.22542,1555
40067,297916,996108A86471458B319C4287B4728CCB,31521,14,15,1,109.51458,18.22542,1555
40068,297917,996108A86471458B319C4287B4728CCB,38891,19,20,1,109.51486,18.24118,1558
40069,297918,996108A86471458B319C4287B4728CCB,31521,21,23,2,109.51458,18.22542,1555
40070,297931,B34415F599F0ED7D1A073EE314A60B9B,31671,1,17,16,109.38965,18.29813,1068
40071,297932,B34415F599F0ED7D1A073EE314A60B9B,60041,19,23,4,109.39889,18.31944,1121
40075,297958,248CE0B148D688C343222BB27AEE2380,31071,0,5,5,109.58257,18.28458,1815
40076,297959,248CE0B148D688C343222BB27AEE2380,30854,7,8,1,109.56889,18.27076,1763
40077,297960,248CE0B148D688C343222BB27AEE2380,60631,12,13,1,109.57778,18.27583,1814
40078,297961,248CE0B148D688C343222BB27AEE2380,30854,14,15,1,109.56889,18.27076,1763
40079,297962,248CE0B148D688C343222BB27AEE2380,30181,19,21,2,109.51597,18.23313,1557
40084,298081,8624CC6420981EE53672D566FC963FD7,60411,0,1,1,109.32514,18.30854,869
40085,298082,8624CC6420981EE53672D566FC963FD7,30661,5,14,9,109.37028,18.24361,1008
40086,298083,8624CC6420981EE53672D566FC963FD7,60411,14,16,2,109.32514,18.30854,869
40087,298084,8624CC6420981EE53672D566FC963FD7,30661,16,23,7,109.37028,18.24361,1008
40095,298254,1D8B814EC83D52D7C5F3FED99C129EE0,30854,3,5,2,109.56889,18.27076,1763
40096,298255,1D8B814EC83D52D7C5F3FED99C129EE0,60631,5,8,3,109.57778,18.27583,1814
40097,298256,1D8B814EC83D52D7C5F3FED99C129EE0,38271,9,10,1,109.62632,18.23049,1956
40102,298284,7C5883A3068E88CA8565279A1905B1B6,30201,19,21,2,109.4909,18.26465,1462
40103,298285,7C5883A3068E88CA8565279A1905B1B6,39321,21,23,2,109.529,18.2167,1604
40104,298291,A3F1517845C5D84C612625B9AE2F7500,30854,20,21,1,109.56889,18.27076,1763
40105,298292,A3F1517845C5D84C612625B9AE2F7500,31071,22,23,1,109.58257,18.28458,1815
40106,298300,79CCA269D4D1544F735C077DABC1670F,30731,0,5,5,109.50944,18.22306,1555
40107,298301,79CCA269D4D1544F735C077DABC1670F,31521,6,7,1,109.51458,18.22542,1555
40108,298302,79CCA269D4D1544F735C077DABC1670F,33051,10,13,3,109.6475,18.46618,2096
40109,298303,4F1F2C63B1D8098AD9ABA50013979078,31461,0,9,9,109.5091,18.25389,1510
40114,298416,036DFEF8CA623F9034F928149FE2468D,30651,1,2,1,109.42611,18.385,1232
40115,298417,036DFEF8CA623F9034F928149FE2468D,30821,3,11,8,109.43681,18.33639,1274
40116,298418,036DFEF8CA623F9034F928149FE2468D,30711,13,18,5,109.50271,18.25347,1510
40117,298419,036DFEF8CA623F9034F928149FE2468D,30821,20,23,3,109.43681,18.33639,1274
40124,298530,DAF24E4EE5B080B65CEC42C4A439EACF,31071,2,7,5,109.58257,18.28458,1815
40125,298531,DAF24E4EE5B080B65CEC42C4A439EACF,30854,12,14,2,109.56889,18.27076,1763
40126,298532,DAF24E4EE5B080B65CEC42C4A439EACF,39154,18,21,3,109.50201,18.25681,1511
40127,298533,DAF24E4EE5B080B65CEC42C4A439EACF,30081,21,23,2,109.50243,18.26632,1512
40128,298594,3871846CD20CC7E3D76BFB165D15B326,30854,0,7,7,109.56889,18.27076,1763
40129,298595,3871846CD20CC7E3D76BFB165D15B326,38271,8,10,2,109.62632,18.23049,1956
40130,298596,3871846CD20CC7E3D76BFB165D15B326,30854,12,23,11,109.56889,18.27076,1763
40131,298618,6C0260646767B781577B5B8CE2471E51,38484,2,17,15,109.53028,18.31528,1620
40132,298619,6C0260646767B781577B5B8CE2471E51,30071,20,21,1,109.52819,18.30472,1619
40136,298664,63B5E489F3503F8EC6E40A38F9D2117C,31951,10,12,2,109.52174,18.30299,1568
40137,298665,63B5E489F3503F8EC6E40A38F9D2117C,60361,13,17,4,109.51938,18.29681,1567
40138,298666,63B5E489F3503F8EC6E40A38F9D2117C,31951,17,19,2,109.52174,18.30299,1568
40149,298773,A4D782DD7C0CB1B25E56BFC209FED42C,60241,0,2,2,109.53319,18.28667,1616
40150,298774,A4D782DD7C0CB1B25E56BFC209FED42C,30921,3,5,2,109.53903,18.29451,1667
40151,298775,A4D782DD7C0CB1B25E56BFC209FED42C,31931,7,8,1,109.54771,18.29403,1667
40152,298776,A4D782DD7C0CB1B25E56BFC209FED42C,60241,8,9,1,109.53319,18.28667,1616
40153,298777,A4D782DD7C0CB1B25E56BFC209FED42C,30921,12,13,1,109.53903,18.29451,1667
40154,298778,A4D782DD7C0CB1B25E56BFC209FED42C,31931,13,15,2,109.54771,18.29403,1667
40155,298779,A4D782DD7C0CB1B25E56BFC209FED42C,30921,19,21,2,109.53903,18.29451,1667
40156,298780,A4D782DD7C0CB1B25E56BFC209FED42C,60241,22,23,1,109.53319,18.28667,1616
40157,298802,FD9120CA3F85D3F015CEFB66B9BF2F3D,30721,0,7,7,109.51597,18.28257,1565
40158,298803,FD9120CA3F85D3F015CEFB66B9BF2F3D,60301,8,10,2,109.60715,18.30993,1919
40159,298804,FD9120CA3F85D3F015CEFB66B9BF2F3D,30181,10,12,2,109.51597,18.23313,1557
40160,298812,FC8552628F8A5A5219C1C30314657039,30271,12,15,3,109.49132,18.23153,1456
40161,298813,FC8552628F8A5A5219C1C30314657039,60661,19,23,4,109.548,18.2377,1657
40162,298820,5A6C2C4A9B4DF43C379FCADC2CCFC5BC,30201,0,7,7,109.4909,18.26465,1462
40163,298821,5A6C2C4A9B4DF43C379FCADC2CCFC5BC,31151,9,11,2,109.75549,18.4191,2488
40164,298822,5A6C2C4A9B4DF43C379FCADC2CCFC5BC,60161,12,13,1,109.49174,18.26181,1461
40165,298827,E8BAAF476E8FE57075BAB1A8D4FF1780,30232,2,5,3,109.6191,18.31701,1971
40166,298828,E8BAAF476E8FE57075BAB1A8D4FF1780,39371,7,8,1,109.56627,18.2646,1762
40167,298829,E8BAAF476E8FE57075BAB1A8D4FF1780,30232,9,11,2,109.6191,18.31701,1971
40168,298830,E8BAAF476E8FE57075BAB1A8D4FF1780,39371,15,16,1,109.56627,18.2646,1762
40169,298831,E8BAAF476E8FE57075BAB1A8D4FF1780,30232,21,22,1,109.6191,18.31701,1971
40170,298855,11C531682FCE295EEF5C9BA53600ACF3,38017,3,10,7,109.49729,18.21424,1504
40171,298856,11C531682FCE295EEF5C9BA53600ACF3,31471,13,16,3,109.34583,18.29563,917
40172,298857,11C531682FCE295EEF5C9BA53600ACF3,38017,18,23,5,109.49729,18.21424,1504
40176,298878,324F7B0754DBA5A78AE17544C944B985,31031,16,18,2,109.49979,18.25382,1510
40177,298879,324F7B0754DBA5A78AE17544C944B985,30271,19,20,1,109.49132,18.23153,1456
40181,298892,408C4FED868686E7B96333835F4C4205,30854,0,4,4,109.56889,18.27076,1763
40182,298893,408C4FED868686E7B96333835F4C4205,31071,7,15,8,109.58257,18.28458,1815
40183,298906,798BF3B08F72A16A6DEAAA235F1899BB,61011,0,5,5,109.60653,18.19076,1900
40184,298908,798BF3B08F72A16A6DEAAA235F1899BB,61011,9,22,13,109.60653,18.19076,1900
40188,298937,3CFD22273F071C6F856BEA34279CB804,31471,15,16,1,109.34583,18.29563,917
40189,298938,3CFD22273F071C6F856BEA34279CB804,38951,21,23,2,109.48097,18.28868,1416
40190,298987,89C2F48F3C187B81197D45E0E1289EA8,31041,0,1,1,109.50278,18.23701,1507
40191,298988,89C2F48F3C187B81197D45E0E1289EA8,30851,2,6,4,109.5616,18.27396,1713
40192,298989,89C2F48F3C187B81197D45E0E1289EA8,30581,7,12,5,109.62257,18.24951,1959
40193,299066,7F632B4875B2736225CD6D350CD25670,30854,7,14,7,109.56889,18.27076,1763
40194,299067,7F632B4875B2736225CD6D350CD25670,31071,15,16,1,109.58257,18.28458,1815
