,Unnamed: 0,id,grid,start_hour,end_hour,duration,lon,lat,gps2id
14,81,68DBE0B52FD0AB95F1DD47068FD7847F,39111,0,6,6,109.5191,18.22597,1555
15,82,68DBE0B52FD0AB95F1DD47068FD7847F,30181,6,12,6,109.51597,18.23313,1557
16,83,68DBE0B52FD0AB95F1DD47068FD7847F,30381,14,16,2,109.52521,18.24507,1609
17,84,68DBE0B52FD0AB95F1DD47068FD7847F,38291,21,22,1,109.51618,18.24313,1558
22,124,22CF7007721E0F1D863F25E4633BE1AD,60311,0,7,7,109.52097,18.24319,1558
23,125,22CF7007721E0F1D863F25E4633BE1AD,31521,12,13,1,109.51458,18.22542,1555
24,126,22CF7007721E0F1D863F25E4633BE1AD,31864,14,15,1,109.49014,18.28333,1465
29,241,222E0B6922623CE9FBB280F81068D40E,38291,1,2,1,109.51618,18.24313,1558
30,242,222E0B6922623CE9FBB280F81068D40E,30571,4,6,2,109.50243,18.21861,1504
31,243,222E0B6922623CE9FBB280F81068D40E,39321,10,23,13,109.529,18.2167,1604
39,304,9BD095517798346F169AD6D898CA1A42,60361,0,12,12,109.51938,18.29681,1567
40,305,9BD095517798346F169AD6D898CA1A42,38154,14,15,1,109.5266,18.28278,1615
41,306,9BD095517798346F169AD6D898CA1A42,60361,18,23,5,109.51938,18.29681,1567
58,553,13104A6A71A054F852B52BB76993ADB2,30851,0,17,17,109.5616,18.27396,1713
59,554,13104A6A71A054F852B52BB76993ADB2,30951,19,20,1,109.56208,18.25667,1761
60,555,13104A6A71A054F852B52BB76993ADB2,30854,21,23,2,109.56889,18.27076,1763
63,578,7803AECF4FFC2BF233E3B7ACD0D2E9F8,39181,0,13,13,109.55153,18.28035,1715
64,579,7803AECF4FFC2BF233E3B7ACD0D2E9F8,39183,15,16,1,109.55542,18.28208,1715
65,580,7803AECF4FFC2BF233E3B7ACD0D2E9F8,39181,18,22,4,109.55153,18.28035,1715
70,795,3D8ADE80304FD3207128013D43F1118A,31861,0,12,12,109.49042,18.27549,1464
71,796,3D8ADE80304FD3207128013D43F1118A,30111,14,16,2,109.47583,18.30542,1419
72,797,3D8ADE80304FD3207128013D43F1118A,60472,17,18,1,109.46625,18.29542,1367
81,916,36BCA39777B9D1E703C1404CDA6A45E7,30511,0,12,12,109.51069,18.24208,1558
82,917,36BCA39777B9D1E703C1404CDA6A45E7,30511,12,14,2,109.51069,18.24208,1558
83,918,36BCA39777B9D1E703C1404CDA6A45E7,30511,16,18,2,109.51069,18.24208,1558
84,919,36BCA39777B9D1E703C1404CDA6A45E7,60081,21,23,2,109.51097,18.22639,1556
85,995,8621CFDF1B89A83351494618C53D033F,31071,0,11,11,109.58257,18.28458,1815
86,996,8621CFDF1B89A83351494618C53D033F,39181,11,14,3,109.55153,18.28035,1715
87,997,8621CFDF1B89A83351494618C53D033F,39181,16,21,5,109.55153,18.28035,1715
88,1059,B76381FBDC68F2B2041DDEC63195F0A7,39181,0,3,3,109.55153,18.28035,1715
89,1060,B76381FBDC68F2B2041DDEC63195F0A7,31931,5,15,10,109.54771,18.29403,1667
90,1061,B76381FBDC68F2B2041DDEC63195F0A7,39181,17,22,5,109.55153,18.28035,1715
91,1092,4D190727D19452A2A511EC780EEEE090,31931,0,1,1,109.54771,18.29403,1667
92,1093,4D190727D19452A2A511EC780EEEE090,30921,1,11,10,109.53903,18.29451,1667
93,1094,4D190727D19452A2A511EC780EEEE090,31931,11,12,1,109.54771,18.29403,1667
94,1131,2191B2AD5C915B8862D4C345F0A13CFB,60351,0,1,1,109.58403,18.28958,1816
95,1132,2191B2AD5C915B8862D4C345F0A13CFB,31071,2,12,10,109.58257,18.28458,1815
96,1133,2191B2AD5C915B8862D4C345F0A13CFB,60351,15,18,3,109.58403,18.28958,1816
97,1199,B95895328C22197B47AD92C8267A3C6A,60371,3,5,2,109.53063,18.30056,1618
98,1200,B95895328C22197B47AD92C8267A3C6A,30921,5,7,2,109.53903,18.29451,1667
99,1201,B95895328C22197B47AD92C8267A3C6A,60171,11,17,6,109.51292,18.30694,1569
100,1202,B95895328C22197B47AD92C8267A3C6A,31931,21,23,2,109.54771,18.29403,1667
115,1390,706B8E0F0F5D1C9FC2F8EBB2574EE89F,30151,0,1,1,109.50986,18.25083,1560
116,1391,706B8E0F0F5D1C9FC2F8EBB2574EE89F,60201,2,6,4,109.5041,18.2509,1510
117,1392,706B8E0F0F5D1C9FC2F8EBB2574EE89F,30711,7,15,8,109.50271,18.25347,1510
118,1393,706B8E0F0F5D1C9FC2F8EBB2574EE89F,30711,18,23,5,109.50271,18.25347,1510
122,1401,C8A5539982743C3D86E28F8FF2DA3472,30951,0,7,7,109.56208,18.25667,1761
123,1402,C8A5539982743C3D86E28F8FF2DA3472,31421,7,9,2,109.55382,18.22347,1705
124,1403,C8A5539982743C3D86E28F8FF2DA3472,30951,10,15,5,109.56208,18.25667,1761
125,1404,C8A5539982743C3D86E28F8FF2DA3472,31421,18,22,4,109.55382,18.22347,1705
131,1443,DFD0F9616A7053955CDD5FA57FDB4A55,30291,0,7,7,109.50403,18.27028,1513
132,1444,DFD0F9616A7053955CDD5FA57FDB4A55,31931,8,11,3,109.54771,18.29403,1667
133,1445,DFD0F9616A7053955CDD5FA57FDB4A55,30271,14,15,1,109.49132,18.23153,1456
134,1446,DFD0F9616A7053955CDD5FA57FDB4A55,30291,19,23,4,109.50403,18.27028,1513
135,1477,ADAB51A6D99BADC8222FC392D72ADA01,60281,0,15,15,109.51743,18.25924,1561
136,1478,ADAB51A6D99BADC8222FC392D72ADA01,30251,16,19,3,109.50611,18.26653,1512
137,1479,ADAB51A6D99BADC8222FC392D72ADA01,60281,19,23,4,109.51743,18.25924,1561
138,1482,2F440A235E684ECEDD042B3100A4AE95,31071,0,7,7,109.58257,18.28458,1815
139,1483,2F440A235E684ECEDD042B3100A4AE95,30854,7,18,11,109.56889,18.27076,1763
140,1484,2F440A235E684ECEDD042B3100A4AE95,31071,18,23,5,109.58257,18.28458,1815
158,1602,B55959B64746A18ECF5077B5F7359221,31561,0,13,13,109.56792,18.28479,1765
159,1603,B55959B64746A18ECF5077B5F7359221,39183,15,16,1,109.55542,18.28208,1715
160,1604,B55959B64746A18ECF5077B5F7359221,31561,19,23,4,109.56792,18.28479,1765
161,1676,7B2CDE963911F93596D04C9325284620,38154,0,5,5,109.5266,18.28278,1615
162,1677,7B2CDE963911F93596D04C9325284620,60221,5,8,3,109.52569,18.29188,1616
163,1678,7B2CDE963911F93596D04C9325284620,38154,9,11,2,109.5266,18.28278,1615
164,1679,7B2CDE963911F93596D04C9325284620,31811,14,17,3,109.54201,18.31806,1671
170,1754,41D4EB5552A7A416EEB26FAA30F55A4B,39183,0,15,15,109.55542,18.28208,1715
171,1755,41D4EB5552A7A416EEB26FAA30F55A4B,39181,18,20,2,109.55153,18.28035,1715
172,1756,41D4EB5552A7A416EEB26FAA30F55A4B,39183,21,23,2,109.55542,18.28208,1715
193,2083,4824E5A5A5B573D071F1BB5C48030BEE,30181,0,12,12,109.51597,18.23313,1557
194,2084,4824E5A5A5B573D071F1BB5C48030BEE,31521,14,15,1,109.51458,18.22542,1555
195,2085,4824E5A5A5B573D071F1BB5C48030BEE,31521,16,18,2,109.51458,18.22542,1555
220,2387,173CD7A2B7B334BC53A50A1D248FBCFE,31071,0,6,6,109.58257,18.28458,1815
221,2388,173CD7A2B7B334BC53A50A1D248FBCFE,30854,8,11,3,109.56889,18.27076,1763
222,2389,173CD7A2B7B334BC53A50A1D248FBCFE,31071,11,13,2,109.58257,18.28458,1815
223,2390,173CD7A2B7B334BC53A50A1D248FBCFE,30854,15,16,1,109.56889,18.27076,1763
243,2572,283001ED673D8EDBEF7EEB00BDB31533,30571,1,3,2,109.50243,18.21861,1504
244,2573,283001ED673D8EDBEF7EEB00BDB31533,38017,3,4,1,109.49729,18.21424,1504
245,2574,283001ED673D8EDBEF7EEB00BDB31533,31181,9,16,7,109.50382,18.24813,1509
246,2575,283001ED673D8EDBEF7EEB00BDB31533,60131,17,18,1,109.49819,18.24778,1509
269,2893,63FBAC0202144B00077561285E6A7F87,30821,3,14,11,109.43681,18.33639,1274
270,2894,63FBAC0202144B00077561285E6A7F87,30651,16,17,1,109.42611,18.385,1232
271,2895,63FBAC0202144B00077561285E6A7F87,30821,21,23,2,109.43681,18.33639,1274
272,2901,070984703178D21DC5287E457C03691A,39181,0,6,6,109.55153,18.28035,1715
273,2902,070984703178D21DC5287E457C03691A,39181,10,16,6,109.55153,18.28035,1715
274,2903,070984703178D21DC5287E457C03691A,31561,18,19,1,109.56792,18.28479,1765
275,2904,070984703178D21DC5287E457C03691A,39181,20,22,2,109.55153,18.28035,1715
295,3035,B78E7295CB13532B4E2C30EF158E297F,31931,1,8,7,109.54771,18.29403,1667
296,3036,B78E7295CB13532B4E2C30EF158E297F,39183,10,16,6,109.55542,18.28208,1715
297,3037,B78E7295CB13532B4E2C30EF158E297F,30854,21,22,1,109.56889,18.27076,1763
301,3059,F47C4E1E39056C43B0AD32AC994AB7C0,31931,0,8,8,109.54771,18.29403,1667
302,3060,F47C4E1E39056C43B0AD32AC994AB7C0,60361,12,16,4,109.51938,18.29681,1567
303,3061,F47C4E1E39056C43B0AD32AC994AB7C0,31931,18,21,3,109.54771,18.29403,1667
309,3220,42158B50A96F4BB50162AD5AAF8D7E2D,31201,0,8,8,109.51042,18.23819,1558
310,3221,42158B50A96F4BB50162AD5AAF8D7E2D,30741,12,13,1,109.49833,18.28681,1516
311,3222,42158B50A96F4BB50162AD5AAF8D7E2D,31181,17,21,4,109.50382,18.24813,1509
312,3223,42158B50A96F4BB50162AD5AAF8D7E2D,38911,21,23,2,109.51674,18.24965,1559
318,3266,560794A44CA17A43FA34D0FA6C339747,30854,0,15,15,109.56889,18.27076,1763
319,3267,560794A44CA17A43FA34D0FA6C339747,31071,17,18,1,109.58257,18.28458,1815
320,3268,560794A44CA17A43FA34D0FA6C339747,30854,20,23,3,109.56889,18.27076,1763
321,3288,608A55C14BAB2A5B627ACC1F39B89FB6,31945,0,7,7,109.58021,18.29403,1817
322,3289,608A55C14BAB2A5B627ACC1F39B89FB6,30854,8,20,12,109.56889,18.27076,1763
323,3290,608A55C14BAB2A5B627ACC1F39B89FB6,31945,20,23,3,109.58021,18.29403,1817
326,3380,10EBF762D28520B09848288F7052CFDE,30854,0,6,6,109.56889,18.27076,1763
327,3381,10EBF762D28520B09848288F7052CFDE,39101,8,18,10,109.50132,18.24931,1509
328,3382,10EBF762D28520B09848288F7052CFDE,30854,19,21,2,109.56889,18.27076,1763
329,3394,6E6193514D8E876D83956A94AD4F3FB1,31931,0,6,6,109.54771,18.29403,1667
330,3395,6E6193514D8E876D83956A94AD4F3FB1,31951,9,10,1,109.52174,18.30299,1568
331,3396,6E6193514D8E876D83956A94AD4F3FB1,31931,11,13,2,109.54771,18.29403,1667
332,3397,6E6193514D8E876D83956A94AD4F3FB1,30071,14,15,1,109.52819,18.30472,1619
336,3532,E605B26D53F08A0D3360A4541E09F4E2,38283,0,14,14,109.62229,18.22618,1956
337,3533,E605B26D53F08A0D3360A4541E09F4E2,38283,17,18,1,109.62229,18.22618,1956
338,3534,E605B26D53F08A0D3360A4541E09F4E2,38283,20,23,3,109.62229,18.22618,1956
352,3695,A01B4012B619D942E7CC3AC9B78722B4,30854,0,2,2,109.56889,18.27076,1763
353,3696,A01B4012B619D942E7CC3AC9B78722B4,31561,5,10,5,109.56792,18.28479,1765
354,3697,A01B4012B619D942E7CC3AC9B78722B4,39183,14,16,2,109.55542,18.28208,1715
355,3698,A01B4012B619D942E7CC3AC9B78722B4,31561,16,22,6,109.56792,18.28479,1765
358,3721,417408FFDA93B177641D270D3A5C4B2D,31071,0,5,5,109.58257,18.28458,1815
359,3722,417408FFDA93B177641D270D3A5C4B2D,30854,6,13,7,109.56889,18.27076,1763
360,3723,417408FFDA93B177641D270D3A5C4B2D,60631,15,16,1,109.57778,18.27583,1814
361,3724,417408FFDA93B177641D270D3A5C4B2D,31071,19,23,4,109.58257,18.28458,1815
363,3851,99EAB49EE8968B052E448932BFC0D516,38052,0,11,11,109.62618,18.23042,1956
364,3852,99EAB49EE8968B052E448932BFC0D516,60594,12,15,3,109.62694,18.22799,1956
365,3853,99EAB49EE8968B052E448932BFC0D516,38052,15,16,1,109.62618,18.23042,1956
366,3854,99EAB49EE8968B052E448932BFC0D516,38052,19,20,1,109.62618,18.23042,1956
367,3888,D2A5F87218CF25385163A2F3C4229CB8,31561,0,5,5,109.56792,18.28479,1765
368,3889,D2A5F87218CF25385163A2F3C4229CB8,30851,5,9,4,109.5616,18.27396,1713
369,3890,D2A5F87218CF25385163A2F3C4229CB8,31561,10,20,10,109.56792,18.28479,1765
375,3926,BD4652414D5C17466BA36FD4BD943A94,30721,1,6,5,109.51597,18.28257,1565
376,3927,BD4652414D5C17466BA36FD4BD943A94,39183,11,12,1,109.55542,18.28208,1715
377,3928,BD4652414D5C17466BA36FD4BD943A94,31931,13,16,3,109.54771,18.29403,1667
378,3929,BD4652414D5C17466BA36FD4BD943A94,38291,20,21,1,109.51618,18.24313,1558
379,3973,598A5BC9BEA86E74379689160E91B24E,30854,0,12,12,109.56889,18.27076,1763
380,3974,598A5BC9BEA86E74379689160E91B24E,31071,15,16,1,109.58257,18.28458,1815
381,3975,598A5BC9BEA86E74379689160E91B24E,30854,18,19,1,109.56889,18.27076,1763
394,4207,2A6BA0678DDF16AF08BAC9E3FA3C9391,31561,0,8,8,109.56792,18.28479,1765
395,4208,2A6BA0678DDF16AF08BAC9E3FA3C9391,30854,9,12,3,109.56889,18.27076,1763
396,4209,2A6BA0678DDF16AF08BAC9E3FA3C9391,31561,13,14,1,109.56792,18.28479,1765
397,4210,2A6BA0678DDF16AF08BAC9E3FA3C9391,30854,15,19,4,109.56889,18.27076,1763
407,4302,1952B2BB316D2BB82BFA729C9CE4CADA,31431,0,5,5,109.44639,18.29042,1316
408,4303,1952B2BB316D2BB82BFA729C9CE4CADA,31431,7,17,10,109.44639,18.29042,1316
409,4304,1952B2BB316D2BB82BFA729C9CE4CADA,30201,20,21,1,109.4909,18.26465,1462
428,4372,ABCD0851CC1C78BCD7AF6DBDF2F5DE49,60524,0,5,5,109.42951,18.28993,1216
429,4373,ABCD0851CC1C78BCD7AF6DBDF2F5DE49,60552,7,11,4,109.41729,18.30014,1218
430,4374,ABCD0851CC1C78BCD7AF6DBDF2F5DE49,60524,11,12,1,109.42951,18.28993,1216
431,4375,ABCD0851CC1C78BCD7AF6DBDF2F5DE49,60401,14,16,2,109.47444,18.27583,1414
440,4409,E6541B4F346982101D887BAAF0315541,31931,0,6,6,109.54771,18.29403,1667
441,4410,E6541B4F346982101D887BAAF0315541,30854,6,13,7,109.56889,18.27076,1763
442,4411,E6541B4F346982101D887BAAF0315541,30851,15,16,1,109.5616,18.27396,1713
443,4412,E6541B4F346982101D887BAAF0315541,30854,18,23,5,109.56889,18.27076,1763
444,4465,B643AC77F8D8498A9694D45BA8B0F75F,60631,0,16,16,109.57778,18.27583,1814
445,4466,B643AC77F8D8498A9694D45BA8B0F75F,30851,17,18,1,109.5616,18.27396,1713
446,4467,B643AC77F8D8498A9694D45BA8B0F75F,31561,19,21,2,109.56792,18.28479,1765
462,4621,4D944399BAAD1AD37CC1D68A51FA53FD,30161,0,7,7,109.50042,18.24389,1508
463,4622,4D944399BAAD1AD37CC1D68A51FA53FD,31021,8,10,2,109.49021,18.27,1463
464,4623,4D944399BAAD1AD37CC1D68A51FA53FD,30161,12,13,1,109.50042,18.24389,1508
465,4640,4995463B780282C9C030A19D9F49AEAC,31071,3,7,4,109.58257,18.28458,1815
466,4641,4995463B780282C9C030A19D9F49AEAC,30854,10,17,7,109.56889,18.27076,1763
467,4642,4995463B780282C9C030A19D9F49AEAC,31071,22,23,1,109.58257,18.28458,1815
475,4725,00FD2268DE6E83934D2916174E81532F,60472,3,4,1,109.46625,18.29542,1367
476,4726,00FD2268DE6E83934D2916174E81532F,30111,7,18,11,109.47583,18.30542,1419
477,4727,00FD2268DE6E83934D2916174E81532F,30761,21,23,2,109.45201,18.3,1318
503,4893,662D882A6A10D0E6C3566690F0A40636,30854,0,17,17,109.56889,18.27076,1763
504,4894,662D882A6A10D0E6C3566690F0A40636,31071,20,21,1,109.58257,18.28458,1815
505,4895,662D882A6A10D0E6C3566690F0A40636,30854,22,23,1,109.56889,18.27076,1763
506,4972,64160F75E74E2B48DE6EBBED499A7424,31431,0,7,7,109.44639,18.29042,1316
507,4973,64160F75E74E2B48DE6EBBED499A7424,38361,9,14,5,109.43667,18.29201,1267
508,4974,64160F75E74E2B48DE6EBBED499A7424,30771,17,19,2,109.49938,18.26042,1511
509,4975,64160F75E74E2B48DE6EBBED499A7424,31431,20,21,1,109.44639,18.29042,1316
517,5050,C1F9914EF577AE2A8300B1A3945A50FF,31561,1,18,17,109.56792,18.28479,1765
518,5051,C1F9914EF577AE2A8300B1A3945A50FF,31071,20,21,1,109.58257,18.28458,1815
519,5052,C1F9914EF577AE2A8300B1A3945A50FF,30851,22,23,1,109.5616,18.27396,1713
520,5188,EC3508E6C408281EA2938EED62E1A6CB,31071,3,5,2,109.58257,18.28458,1815
521,5189,EC3508E6C408281EA2938EED62E1A6CB,30951,8,18,10,109.56208,18.25667,1761
522,5190,EC3508E6C408281EA2938EED62E1A6CB,30232,20,23,3,109.6191,18.31701,1971
532,5298,A68637AA89BD62624E677D9E66C32FAD,39101,0,5,5,109.50132,18.24931,1509
533,5299,A68637AA89BD62624E677D9E66C32FAD,30161,5,10,5,109.50042,18.24389,1508
534,5300,A68637AA89BD62624E677D9E66C32FAD,30361,10,11,1,109.50347,18.24,1508
535,5301,A68637AA89BD62624E677D9E66C32FAD,30161,12,15,3,109.50042,18.24389,1508
536,5352,A8CC84F6441C04DAF82A74609E587ED2,30561,0,7,7,109.52778,18.31938,1621
537,5353,A8CC84F6441C04DAF82A74609E587ED2,39181,7,8,1,109.55153,18.28035,1715
538,5354,A8CC84F6441C04DAF82A74609E587ED2,30561,12,13,1,109.52778,18.31938,1621
539,5355,A8CC84F6441C04DAF82A74609E587ED2,39181,14,15,1,109.55153,18.28035,1715
540,5396,2576A40187A845D7B849E820F16B3DB1,30854,1,6,5,109.56889,18.27076,1763
541,5397,2576A40187A845D7B849E820F16B3DB1,31071,6,8,2,109.58257,18.28458,1815
542,5398,2576A40187A845D7B849E820F16B3DB1,30854,10,11,1,109.56889,18.27076,1763
549,5477,122D07F80E4FAC68FAE7EDBB2DF1AFA3,31071,0,8,8,109.58257,18.28458,1815
550,5478,122D07F80E4FAC68FAE7EDBB2DF1AFA3,30854,10,11,1,109.56889,18.27076,1763
551,5479,122D07F80E4FAC68FAE7EDBB2DF1AFA3,31071,13,14,1,109.58257,18.28458,1815
552,5480,122D07F80E4FAC68FAE7EDBB2DF1AFA3,30854,16,17,1,109.56889,18.27076,1763
553,5508,B3EF0679F09F3DEC127B54C54EEBFAA7,31071,3,4,1,109.58257,18.28458,1815
554,5509,B3EF0679F09F3DEC127B54C54EEBFAA7,30854,7,9,2,109.56889,18.27076,1763
555,5510,B3EF0679F09F3DEC127B54C54EEBFAA7,31071,12,13,1,109.58257,18.28458,1815
556,5511,B3EF0679F09F3DEC127B54C54EEBFAA7,30854,13,23,10,109.56889,18.27076,1763
564,5607,B663EE883B81AEB709AC84DCCEC3D38E,31945,0,7,7,109.58021,18.29403,1817
565,5608,B663EE883B81AEB709AC84DCCEC3D38E,30854,9,11,2,109.56889,18.27076,1763
566,5609,B663EE883B81AEB709AC84DCCEC3D38E,31945,13,14,1,109.58021,18.29403,1817
567,5610,B663EE883B81AEB709AC84DCCEC3D38E,30854,15,23,8,109.56889,18.27076,1763
568,5635,A64494D6F3A0AF8BF93D9FAA1169011A,31521,0,7,7,109.51458,18.22542,1555
569,5636,A64494D6F3A0AF8BF93D9FAA1169011A,38811,8,16,8,109.50875,18.2175,1504
570,5637,A64494D6F3A0AF8BF93D9FAA1169011A,39111,18,20,2,109.5191,18.22597,1555
571,5638,A64494D6F3A0AF8BF93D9FAA1169011A,60381,20,22,2,109.5241,18.22458,1605
572,5673,84DF4A7C208235D171EF56473BCCF210,30851,0,3,3,109.5616,18.27396,1713
573,5674,84DF4A7C208235D171EF56473BCCF210,30361,7,9,2,109.50347,18.24,1508
574,5675,84DF4A7C208235D171EF56473BCCF210,60631,9,18,9,109.57778,18.27583,1814
590,5716,83F8DEFB45E9970F803B6E01CF53475C,31021,0,13,13,109.49021,18.27,1463
591,5717,83F8DEFB45E9970F803B6E01CF53475C,31206,18,20,2,109.50819,18.23549,1507
592,5718,83F8DEFB45E9970F803B6E01CF53475C,30421,20,22,2,109.50021,18.25861,1511
597,5836,F00821368F615DCDAF214035D8EC4A44,31945,1,2,1,109.58021,18.29403,1817
598,5837,F00821368F615DCDAF214035D8EC4A44,31071,5,13,8,109.58257,18.28458,1815
599,5838,F00821368F615DCDAF214035D8EC4A44,30854,13,22,9,109.56889,18.27076,1763
608,5897,96F98526707B06BE1263CCD4F72E07A1,31071,2,9,7,109.58257,18.28458,1815
609,5898,96F98526707B06BE1263CCD4F72E07A1,31945,13,17,4,109.58021,18.29403,1817
610,5899,96F98526707B06BE1263CCD4F72E07A1,30854,22,23,1,109.56889,18.27076,1763
620,6007,53490AD77ACCA93C3ED0F3DE79CA488B,31071,4,6,2,109.58257,18.28458,1815
621,6008,53490AD77ACCA93C3ED0F3DE79CA488B,30854,10,11,1,109.56889,18.27076,1763
622,6009,53490AD77ACCA93C3ED0F3DE79CA488B,31071,15,16,1,109.58257,18.28458,1815
623,6010,53490AD77ACCA93C3ED0F3DE79CA488B,30854,17,19,2,109.56889,18.27076,1763
624,6013,6E2021B014C4D0B652A2E4FE8D2CF038,31071,0,7,7,109.58257,18.28458,1815
625,6014,6E2021B014C4D0B652A2E4FE8D2CF038,30854,10,11,1,109.56889,18.27076,1763
626,6015,6E2021B014C4D0B652A2E4FE8D2CF038,31071,13,14,1,109.58257,18.28458,1815
627,6016,6E2021B014C4D0B652A2E4FE8D2CF038,30854,17,18,1,109.56889,18.27076,1763
651,6227,CCCD2290FB632A48009771412BE68ADD,31561,0,6,6,109.56792,18.28479,1765
652,6228,CCCD2290FB632A48009771412BE68ADD,39183,9,11,2,109.55542,18.28208,1715
653,6229,CCCD2290FB632A48009771412BE68ADD,31561,14,21,7,109.56792,18.28479,1765
657,6259,DCAA44BA6595CC23E827221393F8A6D6,31521,0,8,8,109.51458,18.22542,1555
658,6260,DCAA44BA6595CC23E827221393F8A6D6,30361,12,14,2,109.50347,18.24,1508
659,6261,DCAA44BA6595CC23E827221393F8A6D6,60381,16,18,2,109.5241,18.22458,1605
660,6262,DCAA44BA6595CC23E827221393F8A6D6,31521,18,23,5,109.51458,18.22542,1555
661,6266,0BABF9C6516F437130A3DD3C99553A57,31206,0,1,1,109.50819,18.23549,1507
662,6267,0BABF9C6516F437130A3DD3C99553A57,39191,1,13,12,109.51493,18.23472,1557
663,6268,0BABF9C6516F437130A3DD3C99553A57,31861,15,17,2,109.49042,18.27549,1464
664,6269,0BABF9C6516F437130A3DD3C99553A57,60291,19,22,3,109.50826,18.24639,1509
676,6477,3FD52FC00A20F224738DE2A9BE8088FD,38911,0,8,8,109.51674,18.24965,1559
677,6478,3FD52FC00A20F224738DE2A9BE8088FD,30151,10,12,2,109.50986,18.25083,1560
678,6479,3FD52FC00A20F224738DE2A9BE8088FD,60281,14,16,2,109.51743,18.25924,1561
684,6566,317835A2F11D93D7A28D8E4620886D95,31071,1,2,1,109.58257,18.28458,1815
685,6567,317835A2F11D93D7A28D8E4620886D95,30854,3,10,7,109.56889,18.27076,1763
686,6568,317835A2F11D93D7A28D8E4620886D95,31071,10,16,6,109.58257,18.28458,1815
687,6569,317835A2F11D93D7A28D8E4620886D95,30854,16,17,1,109.56889,18.27076,1763
688,6572,F3652FF504BC297E68234A33C1877043,30854,1,10,9,109.56889,18.27076,1763
689,6573,F3652FF504BC297E68234A33C1877043,31945,12,14,2,109.58021,18.29403,1817
690,6574,F3652FF504BC297E68234A33C1877043,31071,15,16,1,109.58257,18.28458,1815
696,6629,89401E44267DEEF27DB3B95FF5F81B3E,30951,2,7,5,109.56208,18.25667,1761
697,6630,89401E44267DEEF27DB3B95FF5F81B3E,31421,10,14,4,109.55382,18.22347,1705
698,6631,89401E44267DEEF27DB3B95FF5F81B3E,30951,15,20,5,109.56208,18.25667,1761
711,6805,12D8E06C2EC8C969710FB791DF137B2B,31071,0,13,13,109.58257,18.28458,1815
712,6806,12D8E06C2EC8C969710FB791DF137B2B,30854,14,16,2,109.56889,18.27076,1763
713,6807,12D8E06C2EC8C969710FB791DF137B2B,31071,18,20,2,109.58257,18.28458,1815
714,6808,12D8E06C2EC8C969710FB791DF137B2B,30854,21,23,2,109.56889,18.27076,1763
721,6860,4EE3541571833D45849F06D38E34641F,30854,2,13,11,109.56889,18.27076,1763
722,6861,4EE3541571833D45849F06D38E34641F,39091,14,15,1,109.50097,18.25222,1510
723,6862,4EE3541571833D45849F06D38E34641F,38251,16,19,3,109.49618,18.25493,1510
731,6902,3EAE2CCEF780CC2E20C47963EA2CF3C6,30854,2,11,9,109.56889,18.27076,1763
732,6903,3EAE2CCEF780CC2E20C47963EA2CF3C6,38251,14,15,1,109.49618,18.25493,1510
733,6904,3EAE2CCEF780CC2E20C47963EA2CF3C6,30854,16,18,2,109.56889,18.27076,1763
736,6912,8FE97C1052D63DE830211C405D8F5442,60631,0,6,6,109.57778,18.27583,1814
737,6913,8FE97C1052D63DE830211C405D8F5442,30854,6,8,2,109.56889,18.27076,1763
738,6914,8FE97C1052D63DE830211C405D8F5442,60631,12,13,1,109.57778,18.27583,1814
739,6915,8FE97C1052D63DE830211C405D8F5442,30854,13,22,9,109.56889,18.27076,1763
749,7011,1412BA3B65BC1A2354CCBE297098A0E1,31071,0,14,14,109.58257,18.28458,1815
750,7012,1412BA3B65BC1A2354CCBE297098A0E1,30854,15,19,4,109.56889,18.27076,1763
751,7013,1412BA3B65BC1A2354CCBE297098A0E1,31071,19,21,2,109.58257,18.28458,1815
758,7091,D96E01B8E0F0DE9C160C9FEAFDCFDB6D,31071,0,9,9,109.58257,18.28458,1815
759,7092,D96E01B8E0F0DE9C160C9FEAFDCFDB6D,30854,9,19,10,109.56889,18.27076,1763
760,7093,D96E01B8E0F0DE9C160C9FEAFDCFDB6D,31071,20,21,1,109.58257,18.28458,1815
771,7236,C8922FAF66F21ECAECB6B717FCD5A53B,60614,0,13,13,109.48799,18.29521,1467
772,7237,C8922FAF66F21ECAECB6B717FCD5A53B,60391,16,17,1,109.47667,18.28757,1416
773,7238,C8922FAF66F21ECAECB6B717FCD5A53B,60614,18,23,5,109.48799,18.29521,1467
779,7295,A503639E15A0B5D04B0130D882921438,30711,0,13,13,109.50271,18.25347,1510
780,7296,A503639E15A0B5D04B0130D882921438,31031,14,19,5,109.49979,18.25382,1510
781,7297,A503639E15A0B5D04B0130D882921438,31031,19,23,4,109.49979,18.25382,1510
788,7352,8B67CA01C44A0A9FF0492771727FF584,30854,1,13,12,109.56889,18.27076,1763
789,7353,8B67CA01C44A0A9FF0492771727FF584,38241,14,17,3,109.54111,18.30542,1669
790,7354,8B67CA01C44A0A9FF0492771727FF584,31621,18,19,1,109.51035,18.29826,1568
791,7355,8B67CA01C44A0A9FF0492771727FF584,30854,22,23,1,109.56889,18.27076,1763
802,7399,E9E473F09C342630187345312F4A31D8,39181,0,17,17,109.55153,18.28035,1715
803,7400,E9E473F09C342630187345312F4A31D8,31931,17,18,1,109.54771,18.29403,1667
804,7401,E9E473F09C342630187345312F4A31D8,39181,19,23,4,109.55153,18.28035,1715
807,7455,00FC332040A284DA251A8D0705989FE9,31071,0,7,7,109.58257,18.28458,1815
808,7456,00FC332040A284DA251A8D0705989FE9,30854,9,11,2,109.56889,18.27076,1763
809,7457,00FC332040A284DA251A8D0705989FE9,31071,12,15,3,109.58257,18.28458,1815
810,7458,00FC332040A284DA251A8D0705989FE9,30854,19,20,1,109.56889,18.27076,1763
818,7546,39F25FE146A03325C93C111F2A943B6C,31945,0,7,7,109.58021,18.29403,1817
819,7547,39F25FE146A03325C93C111F2A943B6C,31071,10,12,2,109.58257,18.28458,1815
820,7548,39F25FE146A03325C93C111F2A943B6C,31945,12,13,1,109.58021,18.29403,1817
821,7549,39F25FE146A03325C93C111F2A943B6C,30854,13,23,10,109.56889,18.27076,1763
827,7629,14AE6C820CE45F96077630992CABD33D,30951,0,12,12,109.56208,18.25667,1761
828,7630,14AE6C820CE45F96077630992CABD33D,31551,12,14,2,109.55868,18.24222,1708
829,7631,14AE6C820CE45F96077630992CABD33D,30951,14,23,9,109.56208,18.25667,1761
835,7724,EC4B90EDBF35256FDB4D4F8B87DB8A04,31071,0,8,8,109.58257,18.28458,1815
836,7725,EC4B90EDBF35256FDB4D4F8B87DB8A04,30854,10,11,1,109.56889,18.27076,1763
837,7726,EC4B90EDBF35256FDB4D4F8B87DB8A04,31071,12,16,4,109.58257,18.28458,1815
838,7727,EC4B90EDBF35256FDB4D4F8B87DB8A04,30721,18,20,2,109.51597,18.28257,1565
841,7742,E0A24740E2C54F3B77DB561A91D2BED7,31821,0,8,8,109.51181,18.24924,1559
842,7743,E0A24740E2C54F3B77DB561A91D2BED7,30251,8,17,9,109.50611,18.26653,1512
843,7744,E0A24740E2C54F3B77DB561A91D2BED7,30371,18,22,4,109.51,18.24771,1559
850,7831,90AC20E6CC0B4ABA3A4EAC5C3086C030,30201,0,8,8,109.4909,18.26465,1462
851,7832,90AC20E6CC0B4ABA3A4EAC5C3086C030,31031,12,15,3,109.49979,18.25382,1510
852,7833,90AC20E6CC0B4ABA3A4EAC5C3086C030,30171,16,17,1,109.48458,18.27139,1463
862,8046,E218C587552A5DADC05C4E69685FE374,30854,0,11,11,109.56889,18.27076,1763
863,8047,E218C587552A5DADC05C4E69685FE374,31561,15,16,1,109.56792,18.28479,1765
864,8048,E218C587552A5DADC05C4E69685FE374,30854,20,22,2,109.56889,18.27076,1763
867,8064,45A05D92AE671B83CC23996132794DAB,30854,1,6,5,109.56889,18.27076,1763
868,8065,45A05D92AE671B83CC23996132794DAB,31071,8,9,1,109.58257,18.28458,1815
869,8066,45A05D92AE671B83CC23996132794DAB,30854,11,15,4,109.56889,18.27076,1763
870,8067,45A05D92AE671B83CC23996132794DAB,31071,16,21,5,109.58257,18.28458,1815
886,8384,72839B8F6256E6FF641405D4832BF569,31071,0,14,14,109.58257,18.28458,1815
887,8385,72839B8F6256E6FF641405D4832BF569,30854,14,18,4,109.56889,18.27076,1763
888,8386,72839B8F6256E6FF641405D4832BF569,31561,18,20,2,109.56792,18.28479,1765
911,8610,6C0260646767B781577B5B8CE2471E51,38484,0,2,2,109.53028,18.31528,1620
912,8611,6C0260646767B781577B5B8CE2471E51,30561,6,12,6,109.52778,18.31938,1621
913,8612,6C0260646767B781577B5B8CE2471E51,38484,12,22,10,109.53028,18.31528,1620
920,8633,39D4F14340B4650E084697607335F122,30161,0,1,1,109.50042,18.24389,1508
921,8634,39D4F14340B4650E084697607335F122,39101,1,6,5,109.50132,18.24931,1509
922,8635,39D4F14340B4650E084697607335F122,31031,9,10,1,109.49979,18.25382,1510
965,8929,134447BAF73045598D228AAEE014B4B8,30854,1,15,14,109.56889,18.27076,1763
966,8930,134447BAF73045598D228AAEE014B4B8,60221,16,20,4,109.52569,18.29188,1616
967,8931,134447BAF73045598D228AAEE014B4B8,30854,21,23,2,109.56889,18.27076,1763
981,9082,B8E910702A81A5AB2DDCDCC354E4FC08,38162,0,9,9,109.43944,18.28889,1266
982,9083,B8E910702A81A5AB2DDCDCC354E4FC08,31701,9,11,2,109.44132,18.28833,1266
983,9084,B8E910702A81A5AB2DDCDCC354E4FC08,38361,13,22,9,109.43667,18.29201,1267
1000,9232,A8ABE4987042D12DD458C81CFD9663F5,38127,0,7,7,109.50833,18.27222,1513
1001,9233,A8ABE4987042D12DD458C81CFD9663F5,30771,9,10,1,109.49938,18.26042,1511
1002,9234,A8ABE4987042D12DD458C81CFD9663F5,30421,12,14,2,109.50021,18.25861,1511
1003,9235,A8ABE4987042D12DD458C81CFD9663F5,30771,16,23,7,109.49938,18.26042,1511
1014,9412,F8D86007BFB39D8467310AC174395069,30721,0,10,10,109.51597,18.28257,1565
1015,9413,F8D86007BFB39D8467310AC174395069,30854,13,15,2,109.56889,18.27076,1763
1016,9414,F8D86007BFB39D8467310AC174395069,30721,19,21,2,109.51597,18.28257,1565
1040,9741,AB9A3BD8E440D93680572376579E34E6,38154,0,6,6,109.5266,18.28278,1615
1041,9742,AB9A3BD8E440D93680572376579E34E6,31201,10,15,5,109.51042,18.23819,1558
1042,9743,AB9A3BD8E440D93680572376579E34E6,38154,18,22,4,109.5266,18.28278,1615
1050,9784,875F4B80762D0E664890361D764F907D,60081,0,7,7,109.51097,18.22639,1556
1051,9785,875F4B80762D0E664890361D764F907D,30571,8,18,10,109.50243,18.21861,1504
1052,9786,875F4B80762D0E664890361D764F907D,60081,20,23,3,109.51097,18.22639,1556
1065,10063,AECF79630BEEC0EA88FD59B92FCAE378,30854,2,4,2,109.56889,18.27076,1763
1066,10064,AECF79630BEEC0EA88FD59B92FCAE378,30891,4,5,1,109.59431,18.28389,1865
1067,10065,AECF79630BEEC0EA88FD59B92FCAE378,30854,6,7,1,109.56889,18.27076,1763
1074,10079,36BCA39777B9D1E703C1404CDA6A45E7,30511,1,8,7,109.51069,18.24208,1558
1075,10080,36BCA39777B9D1E703C1404CDA6A45E7,30511,9,15,6,109.51069,18.24208,1558
1076,10081,36BCA39777B9D1E703C1404CDA6A45E7,38153,15,18,3,109.51819,18.25736,1561
1077,10082,36BCA39777B9D1E703C1404CDA6A45E7,30511,19,21,2,109.51069,18.24208,1558
1097,10397,EB316856896788EC8FD871E122E95728,30931,0,6,6,109.55653,18.32722,1722
1098,10398,EB316856896788EC8FD871E122E95728,31811,9,16,7,109.54201,18.31806,1671
1099,10399,EB316856896788EC8FD871E122E95728,30701,16,23,7,109.59313,18.32007,1871
1104,10537,38F4BE4A665B515DC81C1A78A906BDC2,60371,2,11,9,109.53063,18.30056,1618
1105,10538,38F4BE4A665B515DC81C1A78A906BDC2,31931,12,19,7,109.54771,18.29403,1667
1106,10539,38F4BE4A665B515DC81C1A78A906BDC2,60371,21,23,2,109.53063,18.30056,1618
1125,10634,D00EAD9144E7A4027F84D32EB5112DB4,31931,2,16,14,109.54771,18.29403,1667
1126,10635,D00EAD9144E7A4027F84D32EB5112DB4,30921,17,18,1,109.53903,18.29451,1667
1127,10636,D00EAD9144E7A4027F84D32EB5112DB4,31931,19,22,3,109.54771,18.29403,1667
1140,10716,D9AB4DDFD70E0B215B409CCDE9543997,31101,0,3,3,109.65389,18.23403,2057
1141,10717,D9AB4DDFD70E0B215B409CCDE9543997,38052,3,11,8,109.62618,18.23042,1956
1142,10718,D9AB4DDFD70E0B215B409CCDE9543997,60594,15,17,2,109.62694,18.22799,1956
1178,11071,64F4CDF664AA04E7B79DE93C57128CF6,31931,0,8,8,109.54771,18.29403,1667
1179,11072,64F4CDF664AA04E7B79DE93C57128CF6,39181,8,18,10,109.55153,18.28035,1715
1180,11073,64F4CDF664AA04E7B79DE93C57128CF6,31931,19,20,1,109.54771,18.29403,1667
1182,11079,45CCFCD3EBDF941E1C92B70ED06E8B5E,30854,1,10,9,109.56889,18.27076,1763
1183,11080,45CCFCD3EBDF941E1C92B70ED06E8B5E,31071,12,13,1,109.58257,18.28458,1815
1184,11081,45CCFCD3EBDF941E1C92B70ED06E8B5E,30854,15,16,1,109.56889,18.27076,1763
1185,11114,6B806948BC9187A91D033B4096721B00,31561,0,1,1,109.56792,18.28479,1765
1186,11115,6B806948BC9187A91D033B4096721B00,31071,5,15,10,109.58257,18.28458,1815
1187,11116,6B806948BC9187A91D033B4096721B00,31561,19,21,2,109.56792,18.28479,1765
1192,11268,D0258183D3EC0F3CFFD9389BCF92CEA0,31261,0,1,1,109.51174,18.2466,1559
1193,11269,D0258183D3EC0F3CFFD9389BCF92CEA0,60381,1,14,13,109.5241,18.22458,1605
1194,11270,D0258183D3EC0F3CFFD9389BCF92CEA0,31521,14,19,5,109.51458,18.22542,1555
1195,11271,D0258183D3EC0F3CFFD9389BCF92CEA0,60281,19,21,2,109.51743,18.25924,1561
1208,11517,44A75810FF8F9221047E9675BDBF60A2,30854,0,10,10,109.56889,18.27076,1763
1209,11518,44A75810FF8F9221047E9675BDBF60A2,31071,10,18,8,109.58257,18.28458,1815
1210,11519,44A75810FF8F9221047E9675BDBF60A2,31561,20,23,3,109.56792,18.28479,1765
1217,11638,C709D01469E0800AF998DFAF42105CDC,60631,0,5,5,109.57778,18.27583,1814
1218,11639,C709D01469E0800AF998DFAF42105CDC,31561,7,14,7,109.56792,18.28479,1765
1219,11640,C709D01469E0800AF998DFAF42105CDC,30854,15,20,5,109.56889,18.27076,1763
1220,11641,C709D01469E0800AF998DFAF42105CDC,60631,22,23,1,109.57778,18.27583,1814
1221,11664,451E2BF48CD7B253EB0892324E679BCC,38297,0,6,6,109.52576,18.24965,1609
1222,11665,451E2BF48CD7B253EB0892324E679BCC,60281,7,17,10,109.51743,18.25924,1561
1223,11666,451E2BF48CD7B253EB0892324E679BCC,38291,18,21,3,109.51618,18.24313,1558
1248,11799,866460FA5062A635337B6369BB2AADDA,30854,3,10,7,109.56889,18.27076,1763
1249,11800,866460FA5062A635337B6369BB2AADDA,30581,14,16,2,109.62257,18.24951,1959
1250,11801,866460FA5062A635337B6369BB2AADDA,60631,20,22,2,109.57778,18.27583,1814
1277,12053,1FE2866848043A2C10AD87212485FE15,31071,3,7,4,109.58257,18.28458,1815
1278,12054,1FE2866848043A2C10AD87212485FE15,30854,7,11,4,109.56889,18.27076,1763
1279,12055,1FE2866848043A2C10AD87212485FE15,31071,11,23,12,109.58257,18.28458,1815
1280,12058,34AB502A442AA8EA4A7FB30471B204DB,38325,4,6,2,109.39792,18.2909,1116
1281,12059,34AB502A442AA8EA4A7FB30471B204DB,31431,7,9,2,109.44639,18.29042,1316
1282,12060,34AB502A442AA8EA4A7FB30471B204DB,60441,13,14,1,109.46792,18.28604,1366
1283,12061,34AB502A442AA8EA4A7FB30471B204DB,30341,17,19,2,109.3625,18.29167,966
1286,12100,0FD4C9952BC5BC89BEB28CD193C21322,30081,0,8,8,109.50243,18.26632,1512
1287,12101,0FD4C9952BC5BC89BEB28CD193C21322,39154,12,13,1,109.50201,18.25681,1511
1288,12102,0FD4C9952BC5BC89BEB28CD193C21322,30081,16,19,3,109.50243,18.26632,1512
1296,12172,87ADC98470D754E65D1F229228B379D5,30851,0,3,3,109.5616,18.27396,1713
1297,12173,87ADC98470D754E65D1F229228B379D5,30854,4,5,1,109.56889,18.27076,1763
1298,12174,87ADC98470D754E65D1F229228B379D5,30201,10,12,2,109.4909,18.26465,1462
1299,12202,00FB7756B5203374969A661782D36967,30071,0,18,18,109.52819,18.30472,1619
1300,12203,00FB7756B5203374969A661782D36967,30561,18,19,1,109.52778,18.31938,1621
1301,12204,00FB7756B5203374969A661782D36967,30071,21,23,2,109.52819,18.30472,1619
1319,12480,31BAA46A2F25AC63D78E0ACA44BF0FE9,39181,0,8,8,109.55153,18.28035,1715
1320,12481,31BAA46A2F25AC63D78E0ACA44BF0FE9,31931,8,10,2,109.54771,18.29403,1667
1321,12482,31BAA46A2F25AC63D78E0ACA44BF0FE9,39181,11,20,9,109.55153,18.28035,1715
1322,12501,A6AC80D1B196B7846A22B3CFEA4051A4,60661,0,7,7,109.548,18.2377,1657
1323,12503,A6AC80D1B196B7846A22B3CFEA4051A4,38061,16,18,2,109.50597,18.23118,1506
1324,12504,A6AC80D1B196B7846A22B3CFEA4051A4,60661,19,21,2,109.548,18.2377,1657
1333,12611,CC4662D0AB761935A19DD4261E4FE213,31561,1,5,4,109.56792,18.28479,1765
1334,12612,CC4662D0AB761935A19DD4261E4FE213,30851,8,9,1,109.5616,18.27396,1713
1335,12613,CC4662D0AB761935A19DD4261E4FE213,31561,10,22,12,109.56792,18.28479,1765
1357,12884,6DF7485545B790F22810B0EDD8F1B356,31945,0,7,7,109.58021,18.29403,1817
1358,12885,6DF7485545B790F22810B0EDD8F1B356,30854,7,12,5,109.56889,18.27076,1763
1359,12886,6DF7485545B790F22810B0EDD8F1B356,31071,12,15,3,109.58257,18.28458,1815
1360,12887,6DF7485545B790F22810B0EDD8F1B356,31945,20,22,2,109.58021,18.29403,1817
1385,13114,F84877D6657D72CDECA7D4A68D33C8CE,31071,0,6,6,109.58257,18.28458,1815
1386,13115,F84877D6657D72CDECA7D4A68D33C8CE,30854,9,22,13,109.56889,18.27076,1763
1387,13116,F84877D6657D72CDECA7D4A68D33C8CE,31071,22,23,1,109.58257,18.28458,1815
1390,13214,C1602FB5A20BD98313F7CC13F431D061,30271,0,7,7,109.49132,18.23153,1456
1391,13215,C1602FB5A20BD98313F7CC13F431D061,30421,11,14,3,109.50021,18.25861,1511
1392,13216,C1602FB5A20BD98313F7CC13F431D061,38127,18,19,1,109.50833,18.27222,1513
1393,13217,C1602FB5A20BD98313F7CC13F431D061,30361,21,23,2,109.50347,18.24,1508
1397,13237,BD4652414D5C17466BA36FD4BD943A94,30721,2,8,6,109.51597,18.28257,1565
1398,13238,BD4652414D5C17466BA36FD4BD943A94,39183,11,12,1,109.55542,18.28208,1715
1399,13239,BD4652414D5C17466BA36FD4BD943A94,31931,12,14,2,109.54771,18.29403,1667
1400,13240,BD4652414D5C17466BA36FD4BD943A94,39183,14,16,2,109.55542,18.28208,1715
1411,13411,EDD211647BCC1D3CABF473CB2801C791,31041,1,10,9,109.50278,18.23701,1507
1412,13412,EDD211647BCC1D3CABF473CB2801C791,30161,11,12,1,109.50042,18.24389,1508
1413,13413,EDD211647BCC1D3CABF473CB2801C791,31181,12,13,1,109.50382,18.24813,1509
1414,13414,EDD211647BCC1D3CABF473CB2801C791,30161,14,23,9,109.50042,18.24389,1508
1434,13582,E5B7DF0BD5F9C6028960F1174FAA2027,30271,1,6,5,109.49132,18.23153,1456
1435,13583,E5B7DF0BD5F9C6028960F1174FAA2027,60084,7,8,1,109.4984,18.2334,1507
1436,13584,E5B7DF0BD5F9C6028960F1174FAA2027,30211,11,15,4,109.49882,18.23931,1508
1437,13618,005F3AEFE6DBF371ED1FD57736434098,30721,0,1,1,109.51597,18.28257,1565
1438,13619,005F3AEFE6DBF371ED1FD57736434098,31071,2,7,5,109.58257,18.28458,1815
1439,13620,005F3AEFE6DBF371ED1FD57736434098,30854,7,19,12,109.56889,18.27076,1763
1441,13650,ECCCA5770AD6AA7162B63EC395B55856,60631,0,7,7,109.57778,18.27583,1814
1442,13651,ECCCA5770AD6AA7162B63EC395B55856,30951,9,15,6,109.56208,18.25667,1761
1443,13652,ECCCA5770AD6AA7162B63EC395B55856,31945,19,20,1,109.58021,18.29403,1817
1456,13725,A952750F25C558E5C17B3EB7DD935431,31931,1,2,1,109.54771,18.29403,1667
1457,13726,A952750F25C558E5C17B3EB7DD935431,60371,2,11,9,109.53063,18.30056,1618
1458,13727,A952750F25C558E5C17B3EB7DD935431,31931,15,17,2,109.54771,18.29403,1667
1483,13882,DF5EBFA9D0614A60E8475DE83F0E910D,30151,0,7,7,109.50986,18.25083,1560
1484,13883,DF5EBFA9D0614A60E8475DE83F0E910D,60201,8,9,1,109.5041,18.2509,1510
1485,13884,DF5EBFA9D0614A60E8475DE83F0E910D,30711,12,15,3,109.50271,18.25347,1510
1486,13935,6F25B46DE233F84CBE88187DB2427FA9,30201,0,11,11,109.4909,18.26465,1462
1487,13936,6F25B46DE233F84CBE88187DB2427FA9,60131,14,15,1,109.49819,18.24778,1509
1488,13937,6F25B46DE233F84CBE88187DB2427FA9,31021,15,17,2,109.49021,18.27,1463
1489,13938,6F25B46DE233F84CBE88187DB2427FA9,30201,18,23,5,109.4909,18.26465,1462
1510,14054,937F0B31443CC6355891AA9D2DB0C670,31561,0,18,18,109.56792,18.28479,1765
1511,14055,937F0B31443CC6355891AA9D2DB0C670,30854,19,20,1,109.56889,18.27076,1763
1512,14056,937F0B31443CC6355891AA9D2DB0C670,31561,21,22,1,109.56792,18.28479,1765
1529,14151,F198CAA1F49ACA5D003FD8F8473B3798,30854,0,6,6,109.56889,18.27076,1763
1530,14152,F198CAA1F49ACA5D003FD8F8473B3798,31071,7,8,1,109.58257,18.28458,1815
1531,14153,F198CAA1F49ACA5D003FD8F8473B3798,30854,8,20,12,109.56889,18.27076,1763
1532,14154,F198CAA1F49ACA5D003FD8F8473B3798,60371,22,23,1,109.53063,18.30056,1618
1543,14240,662D882A6A10D0E6C3566690F0A40636,30854,0,17,17,109.56889,18.27076,1763
1544,14241,662D882A6A10D0E6C3566690F0A40636,31071,19,20,1,109.58257,18.28458,1815
1545,14242,662D882A6A10D0E6C3566690F0A40636,30921,21,23,2,109.53903,18.29451,1667
1560,14352,FB69127E95B4D9EC5AF61282F8D7EEB7,30854,0,1,1,109.56889,18.27076,1763
1561,14353,FB69127E95B4D9EC5AF61282F8D7EEB7,31071,5,6,1,109.58257,18.28458,1815
1562,14354,FB69127E95B4D9EC5AF61282F8D7EEB7,30854,11,23,12,109.56889,18.27076,1763
1565,14388,7C4555390A772AFC617B693DE91FE9EE,60371,0,7,7,109.53063,18.30056,1618
1566,14389,7C4555390A772AFC617B693DE91FE9EE,39181,8,11,3,109.55153,18.28035,1715
1567,14390,7C4555390A772AFC617B693DE91FE9EE,60371,11,12,1,109.53063,18.30056,1618
1571,14496,02506B144784C40A5C40BFE18DC84DB8,31561,2,17,15,109.56792,18.28479,1765
1572,14497,02506B144784C40A5C40BFE18DC84DB8,30854,17,18,1,109.56889,18.27076,1763
1573,14498,02506B144784C40A5C40BFE18DC84DB8,31561,19,21,2,109.56792,18.28479,1765
1574,14534,89A3D380798A385AE8DF1304AC1B4E0B,31931,0,16,16,109.54771,18.29403,1667
1575,14535,89A3D380798A385AE8DF1304AC1B4E0B,38171,20,21,1,109.50799,18.28139,1515
1576,14536,89A3D380798A385AE8DF1304AC1B4E0B,31931,21,23,2,109.54771,18.29403,1667
1592,14675,9FC721E86703223349C05C95FE4BBB6F,60081,0,2,2,109.51097,18.22639,1556
1593,14676,9FC721E86703223349C05C95FE4BBB6F,31521,4,20,16,109.51458,18.22542,1555
1594,14677,9FC721E86703223349C05C95FE4BBB6F,60087,20,23,3,109.50688,18.22299,1505
1648,15092,84DF4A7C208235D171EF56473BCCF210,30851,0,1,1,109.5616,18.27396,1713
1649,15093,84DF4A7C208235D171EF56473BCCF210,31561,4,8,4,109.56792,18.28479,1765
1650,15094,84DF4A7C208235D171EF56473BCCF210,60631,9,18,9,109.57778,18.27583,1814
1654,15117,015CDEB9169BCE5537ABAE49B6A63F2B,31071,1,5,4,109.58257,18.28458,1815
1655,15118,015CDEB9169BCE5537ABAE49B6A63F2B,30854,5,18,13,109.56889,18.27076,1763
1656,15119,015CDEB9169BCE5537ABAE49B6A63F2B,31071,19,20,1,109.58257,18.28458,1815
1657,15120,015CDEB9169BCE5537ABAE49B6A63F2B,60631,21,22,1,109.57778,18.27583,1814
1658,15152,9905C3E423D151CCE1280F3A1732CE90,30854,0,6,6,109.56889,18.27076,1763
1659,15153,9905C3E423D151CCE1280F3A1732CE90,30851,8,17,9,109.5616,18.27396,1713
1660,15154,9905C3E423D151CCE1280F3A1732CE90,30854,20,23,3,109.56889,18.27076,1763
1661,15158,E5A3ABAC97D4B4693E578C38076A1DC3,39321,1,3,2,109.529,18.2167,1604
1662,15159,E5A3ABAC97D4B4693E578C38076A1DC3,30731,5,7,2,109.50944,18.22306,1555
1663,15160,E5A3ABAC97D4B4693E578C38076A1DC3,31521,7,9,2,109.51458,18.22542,1555
1664,15162,E5A3ABAC97D4B4693E578C38076A1DC3,31521,18,23,5,109.51458,18.22542,1555
1669,15226,74E7349CD1421F64667681F5A2E38EAE,30421,0,8,8,109.50021,18.25861,1511
1670,15227,74E7349CD1421F64667681F5A2E38EAE,30741,12,16,4,109.49833,18.28681,1516
1671,15228,74E7349CD1421F64667681F5A2E38EAE,31031,17,18,1,109.49979,18.25382,1510
1672,15229,74E7349CD1421F64667681F5A2E38EAE,30421,19,23,4,109.50021,18.25861,1511
1692,15312,335A7B1DE8538918FDA774EE3E402A76,30191,0,7,7,109.50361,18.22701,1506
1693,15313,335A7B1DE8538918FDA774EE3E402A76,60381,7,11,4,109.5241,18.22458,1605
1694,15314,335A7B1DE8538918FDA774EE3E402A76,31521,15,16,1,109.51458,18.22542,1555
1695,15315,335A7B1DE8538918FDA774EE3E402A76,30191,16,23,7,109.50361,18.22701,1506
1701,15341,24B9CD23EC5587BA3102D06F602ACE38,60171,5,11,6,109.51292,18.30694,1569
1702,15342,24B9CD23EC5587BA3102D06F602ACE38,60501,14,15,1,109.48701,18.29021,1466
1703,15343,24B9CD23EC5587BA3102D06F602ACE38,60171,18,22,4,109.51292,18.30694,1569
1718,15448,7D4B1DE20B00A786CE6215B7EF74F331,31561,0,7,7,109.56792,18.28479,1765
1719,15449,7D4B1DE20B00A786CE6215B7EF74F331,30854,12,14,2,109.56889,18.27076,1763
1720,15450,7D4B1DE20B00A786CE6215B7EF74F331,31561,15,23,8,109.56792,18.28479,1765
1751,15704,41F3C3B484933318A782EA0B7EF5AC36,31071,0,8,8,109.58257,18.28458,1815
1752,15705,41F3C3B484933318A782EA0B7EF5AC36,30854,8,10,2,109.56889,18.27076,1763
1753,15706,41F3C3B484933318A782EA0B7EF5AC36,31071,11,14,3,109.58257,18.28458,1815
1756,15755,0BABF9C6516F437130A3DD3C99553A57,31206,0,4,4,109.50819,18.23549,1507
1757,15756,0BABF9C6516F437130A3DD3C99553A57,31205,5,13,8,109.51111,18.23736,1557
1758,15757,0BABF9C6516F437130A3DD3C99553A57,38157,14,15,1,109.51483,18.26958,1563
1759,15766,000584B3023702F3E9DDF521B1C35B1A,31071,1,13,12,109.58257,18.28458,1815
1760,15767,000584B3023702F3E9DDF521B1C35B1A,30232,17,19,2,109.6191,18.31701,1971
1761,15768,000584B3023702F3E9DDF521B1C35B1A,31945,21,23,2,109.58021,18.29403,1817
1765,15812,E00EF22F493557E868E52C93194870CF,60631,0,7,7,109.57778,18.27583,1814
1766,15813,E00EF22F493557E868E52C93194870CF,30854,8,12,4,109.56889,18.27076,1763
1767,15814,E00EF22F493557E868E52C93194870CF,31071,16,17,1,109.58257,18.28458,1815
1768,15815,3C5AEA306E8A69C707195C4150E77D90,31931,0,10,10,109.54771,18.29403,1667
1769,15816,3C5AEA306E8A69C707195C4150E77D90,30071,10,12,2,109.52819,18.30472,1619
1770,15817,3C5AEA306E8A69C707195C4150E77D90,31931,14,18,4,109.54771,18.29403,1667
1787,16018,51061B3DE820AF1C1C713EF684728003,31071,1,6,5,109.58257,18.28458,1815
1788,16019,51061B3DE820AF1C1C713EF684728003,30854,7,11,4,109.56889,18.27076,1763
1789,16020,51061B3DE820AF1C1C713EF684728003,31071,11,13,2,109.58257,18.28458,1815
1790,16021,51061B3DE820AF1C1C713EF684728003,30854,14,20,6,109.56889,18.27076,1763
1791,16074,1980C8D409DE9551539224B3D393CDAA,31951,3,8,5,109.52174,18.30299,1568
1792,16075,1980C8D409DE9551539224B3D393CDAA,30071,12,15,3,109.52819,18.30472,1619
1793,16076,1980C8D409DE9551539224B3D393CDAA,30071,15,23,8,109.52819,18.30472,1619
1796,16100,635914FBAF9BDB855B8CB450E2AE782A,30571,1,3,2,109.50243,18.21861,1504
1797,16101,635914FBAF9BDB855B8CB450E2AE782A,30051,7,11,4,109.48917,18.21215,1453
1798,16102,635914FBAF9BDB855B8CB450E2AE782A,38834,12,14,2,109.47639,18.21146,1403
1799,16103,635914FBAF9BDB855B8CB450E2AE782A,30051,14,18,4,109.48917,18.21215,1453
1800,16108,D9AE11CD16B231308C3F0FB3F53BC3E9,31071,0,7,7,109.58257,18.28458,1815
1801,16109,D9AE11CD16B231308C3F0FB3F53BC3E9,30854,9,10,1,109.56889,18.27076,1763
1802,16110,D9AE11CD16B231308C3F0FB3F53BC3E9,31071,12,13,1,109.58257,18.28458,1815
1803,16111,D9AE11CD16B231308C3F0FB3F53BC3E9,30854,16,17,1,109.56889,18.27076,1763
1843,16453,9AA959ED87D1ECC3053DED17290EFCBD,30854,0,1,1,109.56889,18.27076,1763
1844,16454,9AA959ED87D1ECC3053DED17290EFCBD,31561,1,5,4,109.56792,18.28479,1765
1845,16455,9AA959ED87D1ECC3053DED17290EFCBD,39183,9,18,9,109.55542,18.28208,1715
1846,16456,9AA959ED87D1ECC3053DED17290EFCBD,31561,18,23,5,109.56792,18.28479,1765
1857,16546,F9999B4E962B5C7572ECDB36029BBDC9,30854,2,3,1,109.56889,18.27076,1763
1858,16547,F9999B4E962B5C7572ECDB36029BBDC9,31071,6,8,2,109.58257,18.28458,1815
1859,16548,F9999B4E962B5C7572ECDB36029BBDC9,30854,12,15,3,109.56889,18.27076,1763
1888,16838,1419F2503130508E06D5FA0D4A5CF329,30711,0,8,8,109.50271,18.25347,1510
1889,16839,1419F2503130508E06D5FA0D4A5CF329,31261,11,13,2,109.51174,18.2466,1559
1890,16840,1419F2503130508E06D5FA0D4A5CF329,31031,16,23,7,109.49979,18.25382,1510
1892,16855,E9E473F09C342630187345312F4A31D8,39181,0,8,8,109.55153,18.28035,1715
1893,16856,E9E473F09C342630187345312F4A31D8,39181,10,17,7,109.55153,18.28035,1715
1894,16857,E9E473F09C342630187345312F4A31D8,39181,17,23,6,109.55153,18.28035,1715
1900,16915,00FC332040A284DA251A8D0705989FE9,31071,0,7,7,109.58257,18.28458,1815
1901,16916,00FC332040A284DA251A8D0705989FE9,30854,8,10,2,109.56889,18.27076,1763
1902,16917,00FC332040A284DA251A8D0705989FE9,31071,12,16,4,109.58257,18.28458,1815
1903,16918,00FC332040A284DA251A8D0705989FE9,30854,19,21,2,109.56889,18.27076,1763
1915,16994,39F25FE146A03325C93C111F2A943B6C,31945,0,13,13,109.58021,18.29403,1817
1916,16995,39F25FE146A03325C93C111F2A943B6C,30854,13,14,1,109.56889,18.27076,1763
1917,16996,39F25FE146A03325C93C111F2A943B6C,31071,16,20,4,109.58257,18.28458,1815
1918,16997,39F25FE146A03325C93C111F2A943B6C,31945,21,23,2,109.58021,18.29403,1817
1922,17049,C41922360615B6B6DBE9569122B980B9,30291,0,7,7,109.50403,18.27028,1513
1923,17050,C41922360615B6B6DBE9569122B980B9,38291,11,12,1,109.51618,18.24313,1558
1924,17051,C41922360615B6B6DBE9569122B980B9,30084,12,23,11,109.50118,18.26972,1513
1939,17168,E0A24740E2C54F3B77DB561A91D2BED7,30151,0,7,7,109.50986,18.25083,1560
1940,17169,E0A24740E2C54F3B77DB561A91D2BED7,30251,8,11,3,109.50611,18.26653,1512
1941,17170,E0A24740E2C54F3B77DB561A91D2BED7,30251,12,18,6,109.50611,18.26653,1512
1942,17171,E0A24740E2C54F3B77DB561A91D2BED7,30371,18,23,5,109.51,18.24771,1559
1952,17248,79552C9BA7D6D0482C348613B3829C6B,31181,0,18,18,109.50382,18.24813,1509
1953,17249,79552C9BA7D6D0482C348613B3829C6B,60131,18,19,1,109.49819,18.24778,1509
1954,17250,79552C9BA7D6D0482C348613B3829C6B,39151,19,23,4,109.49875,18.25097,1510
1958,17333,EA446444DFE25212830F95291C13D19D,31931,0,8,8,109.54771,18.29403,1667
1959,17334,EA446444DFE25212830F95291C13D19D,39181,10,12,2,109.55153,18.28035,1715
1960,17335,EA446444DFE25212830F95291C13D19D,31931,13,23,10,109.54771,18.29403,1667
1965,17374,967E548F53382C36FB0D7FF12F6A99E7,30201,0,8,8,109.4909,18.26465,1462
1966,17375,967E548F53382C36FB0D7FF12F6A99E7,60131,13,14,1,109.49819,18.24778,1509
1967,17376,967E548F53382C36FB0D7FF12F6A99E7,60331,17,18,1,109.505,18.26507,1512
1968,17377,967E548F53382C36FB0D7FF12F6A99E7,31531,19,23,4,109.49583,18.25972,1461
1973,17419,14F1CC63CDA098F9694EAC8584B9C7A5,31071,0,2,2,109.58257,18.28458,1815
1974,17420,14F1CC63CDA098F9694EAC8584B9C7A5,31561,5,14,9,109.56792,18.28479,1765
1975,17421,14F1CC63CDA098F9694EAC8584B9C7A5,60221,15,17,2,109.52569,18.29188,1616
1983,17632,1B3E8931F1FF667205B6505EE53C6E2C,31071,1,7,6,109.58257,18.28458,1815
1984,17633,1B3E8931F1FF667205B6505EE53C6E2C,30854,9,11,2,109.56889,18.27076,1763
1985,17634,1B3E8931F1FF667205B6505EE53C6E2C,31071,14,18,4,109.58257,18.28458,1815
2003,17808,F8D799D9161B0143E0D71C40472A357E,38991,0,3,3,109.52681,18.30368,1618
2004,17809,F8D799D9161B0143E0D71C40472A357E,31951,3,5,2,109.52174,18.30299,1568
2005,17810,F8D799D9161B0143E0D71C40472A357E,30071,6,15,9,109.52819,18.30472,1619
2006,17811,F8D799D9161B0143E0D71C40472A357E,30071,17,21,4,109.52819,18.30472,1619
2007,17831,7BF65E5054DA81A230AB5423620158E1,31071,3,4,1,109.58257,18.28458,1815
2008,17832,7BF65E5054DA81A230AB5423620158E1,30854,7,16,9,109.56889,18.27076,1763
2009,17833,7BF65E5054DA81A230AB5423620158E1,31071,16,17,1,109.58257,18.28458,1815
2010,17834,7BF65E5054DA81A230AB5423620158E1,30854,19,23,4,109.56889,18.27076,1763
2022,18002,E5DF04F59E5D9E111B652A8582821044,38911,0,1,1,109.51674,18.24965,1559
2023,18003,E5DF04F59E5D9E111B652A8582821044,38291,1,3,2,109.51618,18.24313,1558
2024,18004,E5DF04F59E5D9E111B652A8582821044,38911,3,5,2,109.51674,18.24965,1559
2025,18005,E5DF04F59E5D9E111B652A8582821044,60281,6,9,3,109.51743,18.25924,1561
2028,18023,B84B247FA61A8C12DFCCCF3C2D72006D,31071,3,4,1,109.58257,18.28458,1815
2029,18024,B84B247FA61A8C12DFCCCF3C2D72006D,31945,5,6,1,109.58021,18.29403,1817
2030,18025,B84B247FA61A8C12DFCCCF3C2D72006D,30854,8,9,1,109.56889,18.27076,1763
2031,18026,B84B247FA61A8C12DFCCCF3C2D72006D,31071,9,11,2,109.58257,18.28458,1815
2036,18107,C1C69C0EAD4ABEFD1467543102429D9B,31861,0,1,1,109.49042,18.27549,1464
2037,18108,C1C69C0EAD4ABEFD1467543102429D9B,39183,2,6,4,109.55542,18.28208,1715
2038,18109,C1C69C0EAD4ABEFD1467543102429D9B,31561,7,8,1,109.56792,18.28479,1765
2046,18165,6CBD210FE212796CEDBD8FF4BC0A58A4,30854,1,3,2,109.56889,18.27076,1763
2047,18166,6CBD210FE212796CEDBD8FF4BC0A58A4,39183,4,5,1,109.55542,18.28208,1715
2048,18167,6CBD210FE212796CEDBD8FF4BC0A58A4,31931,6,8,2,109.54771,18.29403,1667
2049,18168,6CBD210FE212796CEDBD8FF4BC0A58A4,39183,11,20,9,109.55542,18.28208,1715
2055,18239,1EC959553638CEC3C2D1606E92235CDE,60631,0,3,3,109.57778,18.27583,1814
2056,18240,1EC959553638CEC3C2D1606E92235CDE,31071,4,6,2,109.58257,18.28458,1815
2057,18241,1EC959553638CEC3C2D1606E92235CDE,30854,7,15,8,109.56889,18.27076,1763
2072,18342,30CE72A519D49881F23B8123486E3A02,60054,3,9,6,109.3016,18.31229,770
2073,18343,30CE72A519D49881F23B8123486E3A02,60411,11,14,3,109.32514,18.30854,869
2074,18344,30CE72A519D49881F23B8123486E3A02,31471,15,16,1,109.34583,18.29563,917
2075,18345,30CE72A519D49881F23B8123486E3A02,60411,18,20,2,109.32514,18.30854,869
2127,18794,0EA31DC24D5B7028E03AA286B0DB11EF,31071,3,7,4,109.58257,18.28458,1815
2128,18795,0EA31DC24D5B7028E03AA286B0DB11EF,30854,8,9,1,109.56889,18.27076,1763
2129,18796,0EA31DC24D5B7028E03AA286B0DB11EF,31071,12,23,11,109.58257,18.28458,1815
2156,18925,19F803FB996471824A8A9928BBFAB433,39181,0,2,2,109.55153,18.28035,1715
2157,18926,19F803FB996471824A8A9928BBFAB433,39181,3,5,2,109.55153,18.28035,1715
2158,18927,19F803FB996471824A8A9928BBFAB433,31931,6,17,11,109.54771,18.29403,1667
2159,18928,19F803FB996471824A8A9928BBFAB433,39181,21,23,2,109.55153,18.28035,1715
2162,18994,C925EDC1C2C39BAEC75090090BF059D6,30741,0,8,8,109.49833,18.28681,1516
2163,18995,C925EDC1C2C39BAEC75090090BF059D6,31621,9,11,2,109.51035,18.29826,1568
2164,18996,C925EDC1C2C39BAEC75090090BF059D6,31031,12,13,1,109.49979,18.25382,1510
2165,19002,13104A6A71A054F852B52BB76993ADB2,30854,2,4,2,109.56889,18.27076,1763
2166,19003,13104A6A71A054F852B52BB76993ADB2,30851,6,17,11,109.5616,18.27396,1713
2167,19004,13104A6A71A054F852B52BB76993ADB2,30854,18,22,4,109.56889,18.27076,1763
2171,19026,7BDC7962058E5B3507F7C37155585188,30121,0,5,5,109.52861,18.27222,1613
2172,19027,7BDC7962058E5B3507F7C37155585188,38157,5,10,5,109.51483,18.26958,1563
2173,19028,7BDC7962058E5B3507F7C37155585188,30121,11,12,1,109.52861,18.27222,1613
2201,19239,1C67859AC074D33800F75471EB5E573E,31071,0,4,4,109.58257,18.28458,1815
2202,19240,1C67859AC074D33800F75471EB5E573E,60631,4,6,2,109.57778,18.27583,1814
2203,19241,1C67859AC074D33800F75471EB5E573E,30854,6,7,1,109.56889,18.27076,1763
2204,19242,1C67859AC074D33800F75471EB5E573E,60631,10,12,2,109.57778,18.27583,1814
2211,19365,4AA92C2276692190731459431C798101,31945,0,7,7,109.58021,18.29403,1817
2212,19366,4AA92C2276692190731459431C798101,31071,9,12,3,109.58257,18.28458,1815
2213,19367,4AA92C2276692190731459431C798101,31945,12,15,3,109.58021,18.29403,1817
2221,19540,FB16AA24AD94D8CC7E1110E44BD68910,31945,0,7,7,109.58021,18.29403,1817
2222,19541,FB16AA24AD94D8CC7E1110E44BD68910,30854,9,11,2,109.56889,18.27076,1763
2223,19542,FB16AA24AD94D8CC7E1110E44BD68910,31945,12,14,2,109.58021,18.29403,1817
2224,19543,FB16AA24AD94D8CC7E1110E44BD68910,30854,14,19,5,109.56889,18.27076,1763
2225,19554,D3004C26B73D96A247072F770E084D3C,31021,2,5,3,109.49021,18.27,1463
2226,19555,D3004C26B73D96A247072F770E084D3C,31061,6,7,1,109.53333,18.23257,1607
2227,19556,D3004C26B73D96A247072F770E084D3C,31021,9,23,14,109.49021,18.27,1463
2228,19569,706B8E0F0F5D1C9FC2F8EBB2574EE89F,30711,0,9,9,109.50271,18.25347,1510
2229,19570,706B8E0F0F5D1C9FC2F8EBB2574EE89F,31461,11,14,3,109.5091,18.25389,1510
2230,19571,706B8E0F0F5D1C9FC2F8EBB2574EE89F,60201,14,22,8,109.5041,18.2509,1510
2249,19694,F3EA7BB85A440E2BE2D597787EA5279B,60235,0,3,3,109.49269,18.2253,1455
2250,19695,F3EA7BB85A440E2BE2D597787EA5279B,30051,4,11,7,109.48917,18.21215,1453
2251,19696,F3EA7BB85A440E2BE2D597787EA5279B,38834,12,14,2,109.47639,18.21146,1403
2252,19697,F3EA7BB85A440E2BE2D597787EA5279B,30051,14,22,8,109.48917,18.21215,1453
2259,19758,B55959B64746A18ECF5077B5F7359221,31561,0,18,18,109.56792,18.28479,1765
2260,19759,B55959B64746A18ECF5077B5F7359221,30851,20,21,1,109.5616,18.27396,1713
2261,19760,B55959B64746A18ECF5077B5F7359221,31561,21,23,2,109.56792,18.28479,1765
2271,19844,DEF4648D3893FF8E920C5B6471338CA5,38111,0,7,7,109.52007,18.22403,1555
2272,19845,DEF4648D3893FF8E920C5B6471338CA5,38111,7,15,8,109.52007,18.22403,1555
2273,19846,DEF4648D3893FF8E920C5B6471338CA5,30361,18,20,2,109.50347,18.24,1508
2281,19964,818E265DAAF91F82D1A6FBD8988FB914,38271,0,12,12,109.62632,18.23049,1956
2282,19965,818E265DAAF91F82D1A6FBD8988FB914,31521,14,16,2,109.51458,18.22542,1555
2283,19966,818E265DAAF91F82D1A6FBD8988FB914,60381,16,18,2,109.5241,18.22458,1605
2284,19967,818E265DAAF91F82D1A6FBD8988FB914,31521,19,22,3,109.51458,18.22542,1555
2296,20091,249541951E1FA75CAD2B8C3DC95305E9,31181,0,13,13,109.50382,18.24813,1509
2297,20092,249541951E1FA75CAD2B8C3DC95305E9,60381,17,18,1,109.5241,18.22458,1605
2298,20093,249541951E1FA75CAD2B8C3DC95305E9,31521,21,22,1,109.51458,18.22542,1555
2308,20174,44A75810FF8F9221047E9675BDBF60A2,31561,0,10,10,109.56792,18.28479,1765
2309,20175,44A75810FF8F9221047E9675BDBF60A2,30854,11,13,2,109.56889,18.27076,1763
2310,20176,44A75810FF8F9221047E9675BDBF60A2,31071,13,16,3,109.58257,18.28458,1815
2311,20177,44A75810FF8F9221047E9675BDBF60A2,30854,16,19,3,109.56889,18.27076,1763
2312,20188,24892DF473AC6ED4692FBD552CF21D37,60381,0,13,13,109.5241,18.22458,1605
2313,20189,24892DF473AC6ED4692FBD552CF21D37,38291,14,16,2,109.51618,18.24313,1558
2314,20190,24892DF473AC6ED4692FBD552CF21D37,60381,17,23,6,109.5241,18.22458,1605
2324,20271,451E2BF48CD7B253EB0892324E679BCC,38297,1,5,4,109.52576,18.24965,1609
2325,20272,451E2BF48CD7B253EB0892324E679BCC,38291,10,18,8,109.51618,18.24313,1558
2326,20273,451E2BF48CD7B253EB0892324E679BCC,31461,18,20,2,109.5091,18.25389,1510
2327,20274,451E2BF48CD7B253EB0892324E679BCC,38297,21,22,1,109.52576,18.24965,1609
2357,20398,283001ED673D8EDBEF7EEB00BDB31533,38017,2,3,1,109.49729,18.21424,1504
2358,20399,283001ED673D8EDBEF7EEB00BDB31533,31181,7,12,5,109.50382,18.24813,1509
2359,20400,283001ED673D8EDBEF7EEB00BDB31533,60201,13,18,5,109.5041,18.2509,1510
2360,20401,283001ED673D8EDBEF7EEB00BDB31533,30571,20,22,2,109.50243,18.21861,1504
2366,20440,202870BA524F8D7E9C1B66336BF1F034,38991,0,5,5,109.52681,18.30368,1618
2367,20441,202870BA524F8D7E9C1B66336BF1F034,30854,6,17,11,109.56889,18.27076,1763
2368,20442,202870BA524F8D7E9C1B66336BF1F034,31951,18,20,2,109.52174,18.30299,1568
2372,20545,34AB502A442AA8EA4A7FB30471B204DB,60621,0,7,7,109.48354,18.27451,1464
2373,20546,34AB502A442AA8EA4A7FB30471B204DB,31431,8,10,2,109.44639,18.29042,1316
2374,20547,34AB502A442AA8EA4A7FB30471B204DB,38094,11,14,3,109.45403,18.28778,1316
2375,20548,34AB502A442AA8EA4A7FB30471B204DB,31431,14,21,7,109.44639,18.29042,1316
2376,20564,A97645679390087E090050CF3F130352,31931,0,15,15,109.54771,18.29403,1667
2377,20565,A97645679390087E090050CF3F130352,60361,19,21,2,109.51938,18.29681,1567
2378,20566,A97645679390087E090050CF3F130352,31931,21,23,2,109.54771,18.29403,1667
2393,20718,E32F04C32D00AF60E04FA89AD4525A3E,39111,0,7,7,109.5191,18.22597,1555
2394,20719,E32F04C32D00AF60E04FA89AD4525A3E,31521,8,17,9,109.51458,18.22542,1555
2395,20720,E32F04C32D00AF60E04FA89AD4525A3E,30361,17,20,3,109.50347,18.24,1508
2396,20721,E32F04C32D00AF60E04FA89AD4525A3E,60381,21,22,1,109.5241,18.22458,1605
2415,20874,31BAA46A2F25AC63D78E0ACA44BF0FE9,39181,0,7,7,109.55153,18.28035,1715
2416,20875,31BAA46A2F25AC63D78E0ACA44BF0FE9,31931,10,11,1,109.54771,18.29403,1667
2417,20876,31BAA46A2F25AC63D78E0ACA44BF0FE9,39181,12,23,11,109.55153,18.28035,1715
2418,20885,876477FD9DD46FF97674E612DA6296D8,38251,0,1,1,109.49618,18.25493,1510
2419,20886,876477FD9DD46FF97674E612DA6296D8,30051,2,9,7,109.48917,18.21215,1453
2420,20887,876477FD9DD46FF97674E612DA6296D8,30211,10,11,1,109.49882,18.23931,1508
2421,20888,876477FD9DD46FF97674E612DA6296D8,31531,11,23,12,109.49583,18.25972,1461
2423,20939,D080330F46FFE140C3D67F6850CA9E9D,38251,1,2,1,109.49618,18.25493,1510
2424,20940,D080330F46FFE140C3D67F6850CA9E9D,31531,3,11,8,109.49583,18.25972,1461
2425,20941,D080330F46FFE140C3D67F6850CA9E9D,38251,12,13,1,109.49618,18.25493,1510
2426,20942,D080330F46FFE140C3D67F6850CA9E9D,31531,16,23,7,109.49583,18.25972,1461
2427,20943,8586C09CC5E6256A8D795F3F0A4D8307,31071,0,12,12,109.58257,18.28458,1815
2428,20944,8586C09CC5E6256A8D795F3F0A4D8307,31761,13,14,1,109.60521,18.27965,1914
2429,20945,8586C09CC5E6256A8D795F3F0A4D8307,31931,15,20,5,109.54771,18.29403,1667
2432,20957,70A62761FE79F922D082380DA7747243,30854,0,6,6,109.56889,18.27076,1763
2433,20958,70A62761FE79F922D082380DA7747243,31071,6,7,1,109.58257,18.28458,1815
2434,20959,70A62761FE79F922D082380DA7747243,30854,9,21,12,109.56889,18.27076,1763
2446,21077,6E6193514D8E876D83956A94AD4F3FB1,31931,0,17,17,109.54771,18.29403,1667
2447,21078,6E6193514D8E876D83956A94AD4F3FB1,30071,17,19,2,109.52819,18.30472,1619
2448,21079,6E6193514D8E876D83956A94AD4F3FB1,31931,20,21,1,109.54771,18.29403,1667
2454,21106,AAB3DCB18BAF89954DC0C8A658A6D766,60161,0,5,5,109.49174,18.26181,1461
2455,21107,AAB3DCB18BAF89954DC0C8A658A6D766,30051,7,9,2,109.48917,18.21215,1453
2456,21108,AAB3DCB18BAF89954DC0C8A658A6D766,38251,11,12,1,109.49618,18.25493,1510
2457,21109,AAB3DCB18BAF89954DC0C8A658A6D766,30051,16,17,1,109.48917,18.21215,1453
2472,21174,15A2A8790389D1537721C21B141A7A31,61011,1,5,4,109.60653,18.19076,1900
2473,21175,15A2A8790389D1537721C21B141A7A31,60591,7,14,7,109.61118,18.21715,1904
2474,21176,15A2A8790389D1537721C21B141A7A31,61011,19,23,4,109.60653,18.19076,1900
2475,21187,238F3B85BB94B3797E72C402C6567588,38017,0,11,11,109.49729,18.21424,1504
2476,21188,238F3B85BB94B3797E72C402C6567588,31521,13,15,2,109.51458,18.22542,1555
2477,21189,238F3B85BB94B3797E72C402C6567588,38017,17,21,4,109.49729,18.21424,1504
2478,21190,238F3B85BB94B3797E72C402C6567588,30571,21,22,1,109.50243,18.21861,1504
2479,21215,1026894DC5FF9A7FAF3A2EE28B95E239,30854,0,7,7,109.56889,18.27076,1763
2480,21216,1026894DC5FF9A7FAF3A2EE28B95E239,30891,12,14,2,109.59431,18.28389,1865
2481,21217,1026894DC5FF9A7FAF3A2EE28B95E239,30854,15,23,8,109.56889,18.27076,1763
2486,21266,417408FFDA93B177641D270D3A5C4B2D,31071,0,14,14,109.58257,18.28458,1815
2487,21267,417408FFDA93B177641D270D3A5C4B2D,60631,15,17,2,109.57778,18.27583,1814
2488,21268,417408FFDA93B177641D270D3A5C4B2D,30854,18,19,1,109.56889,18.27076,1763
2489,21269,417408FFDA93B177641D270D3A5C4B2D,31071,20,23,3,109.58257,18.28458,1815
2534,21631,005F3AEFE6DBF371ED1FD57736434098,31761,1,6,5,109.60521,18.27965,1914
2535,21632,005F3AEFE6DBF371ED1FD57736434098,30854,7,12,5,109.56889,18.27076,1763
2536,21633,005F3AEFE6DBF371ED1FD57736434098,31071,12,13,1,109.58257,18.28458,1815
2537,21634,005F3AEFE6DBF371ED1FD57736434098,30854,14,15,1,109.56889,18.27076,1763
2538,21658,34F3D64B41C252481F72E5CF931AC833,30854,0,9,9,109.56889,18.27076,1763
2539,21659,34F3D64B41C252481F72E5CF931AC833,30851,14,18,4,109.5616,18.27396,1713
2540,21660,34F3D64B41C252481F72E5CF931AC833,31071,22,23,1,109.58257,18.28458,1815
2547,21826,EF727BDF3D7B6D877CF0038228740019,30161,0,6,6,109.50042,18.24389,1508
2548,21827,EF727BDF3D7B6D877CF0038228740019,38251,8,15,7,109.49618,18.25493,1510
2549,21828,EF727BDF3D7B6D877CF0038228740019,60161,17,19,2,109.49174,18.26181,1461
2567,21864,5EAEAB611440D169B1CE8706AE16111E,31521,1,3,2,109.51458,18.22542,1555
2568,21865,5EAEAB611440D169B1CE8706AE16111E,30511,6,8,2,109.51069,18.24208,1558
2569,21866,5EAEAB611440D169B1CE8706AE16111E,30511,10,13,3,109.51069,18.24208,1558
2580,22039,B340EDEF4A878E8DF5CBEC25E465EACE,30854,0,10,10,109.56889,18.27076,1763
2581,22040,B340EDEF4A878E8DF5CBEC25E465EACE,31071,12,13,1,109.58257,18.28458,1815
2582,22041,B340EDEF4A878E8DF5CBEC25E465EACE,30854,14,20,6,109.56889,18.27076,1763
2583,22042,9FD9B533440DEDA093A3D6D9A5E4AA42,60361,0,14,14,109.51938,18.29681,1567
2584,22043,9FD9B533440DEDA093A3D6D9A5E4AA42,30854,15,17,2,109.56889,18.27076,1763
2585,22044,9FD9B533440DEDA093A3D6D9A5E4AA42,31071,18,23,5,109.58257,18.28458,1815
2590,22059,D646833EE14E86C476A372E72E00A3F6,31561,0,7,7,109.56792,18.28479,1765
2591,22060,D646833EE14E86C476A372E72E00A3F6,31071,8,19,11,109.58257,18.28458,1815
2592,22061,D646833EE14E86C476A372E72E00A3F6,31561,22,23,1,109.56792,18.28479,1765
2599,22167,8CBDC50DA35EAA1BF96B888A29A6656F,60552,0,11,11,109.41729,18.30014,1218
2600,22168,8CBDC50DA35EAA1BF96B888A29A6656F,60551,11,12,1,109.42722,18.30111,1218
2601,22169,8CBDC50DA35EAA1BF96B888A29A6656F,30351,13,14,1,109.41701,18.29292,1217
2602,22170,8CBDC50DA35EAA1BF96B888A29A6656F,31236,15,16,1,109.42965,18.29111,1216
2605,22181,7C4555390A772AFC617B693DE91FE9EE,60371,0,6,6,109.53063,18.30056,1618
2606,22182,7C4555390A772AFC617B693DE91FE9EE,31931,9,15,6,109.54771,18.29403,1667
2607,22183,7C4555390A772AFC617B693DE91FE9EE,60371,17,18,1,109.53063,18.30056,1618
2608,22184,7C4555390A772AFC617B693DE91FE9EE,31931,22,23,1,109.54771,18.29403,1667
2614,22197,B90183D15168F89346BBFB7C18178548,31201,0,6,6,109.51042,18.23819,1558
2615,22198,B90183D15168F89346BBFB7C18178548,30281,7,9,2,109.50597,18.27583,1514
2616,22199,B90183D15168F89346BBFB7C18178548,30191,12,13,1,109.50361,18.22701,1506
2617,22223,AC608530E4648D24FD5F9C3D1465376C,30854,0,1,1,109.56889,18.27076,1763
2618,22224,AC608530E4648D24FD5F9C3D1465376C,31945,6,8,2,109.58021,18.29403,1817
2619,22225,AC608530E4648D24FD5F9C3D1465376C,30854,11,18,7,109.56889,18.27076,1763
2640,22407,3C7B93BB0A27C1CE56C61B7C28661B4D,30151,2,4,2,109.50986,18.25083,1560
2641,22408,3C7B93BB0A27C1CE56C61B7C28661B4D,31521,5,19,14,109.51458,18.22542,1555
2642,22409,3C7B93BB0A27C1CE56C61B7C28661B4D,31171,20,22,2,109.50938,18.24917,1559
2671,22696,19A604DB8FB3E88699C325DC4D336D53,30121,0,10,10,109.52861,18.27222,1613
2672,22697,19A604DB8FB3E88699C325DC4D336D53,31821,11,15,4,109.51181,18.24924,1559
2673,22698,19A604DB8FB3E88699C325DC4D336D53,30121,16,19,3,109.52861,18.27222,1613
2678,22719,68D17CEA0DFC47DDDEC25D4A4CC5A3DB,31181,0,1,1,109.50382,18.24813,1509
2679,22720,68D17CEA0DFC47DDDEC25D4A4CC5A3DB,30151,1,11,10,109.50986,18.25083,1560
2680,22721,68D17CEA0DFC47DDDEC25D4A4CC5A3DB,31261,11,13,2,109.51174,18.2466,1559
2681,22754,0D00E0CA974DDA00224ACCD00B993468,30851,0,6,6,109.5616,18.27396,1713
2682,22755,0D00E0CA974DDA00224ACCD00B993468,30854,9,17,8,109.56889,18.27076,1763
2683,22756,0D00E0CA974DDA00224ACCD00B993468,31071,19,22,3,109.58257,18.28458,1815
2699,22865,B93185B4820D7E0DEE74EBEA00941D15,30371,0,13,13,109.51,18.24771,1559
2700,22866,B93185B4820D7E0DEE74EBEA00941D15,60201,13,15,2,109.5041,18.2509,1510
2701,22867,B93185B4820D7E0DEE74EBEA00941D15,60331,15,17,2,109.505,18.26507,1512
2702,22868,B93185B4820D7E0DEE74EBEA00941D15,60201,17,23,6,109.5041,18.2509,1510
2723,23077,BE1BF0E0C00568838DBD1FF7CA7ADE1C,31561,0,7,7,109.56792,18.28479,1765
2724,23078,BE1BF0E0C00568838DBD1FF7CA7ADE1C,31071,7,11,4,109.58257,18.28458,1815
2725,23079,BE1BF0E0C00568838DBD1FF7CA7ADE1C,30854,12,21,9,109.56889,18.27076,1763
2772,23442,2FCE41507104FDFA70291772784A7A89,31201,0,9,9,109.51042,18.23819,1558
2773,23443,2FCE41507104FDFA70291772784A7A89,31521,11,14,3,109.51458,18.22542,1555
2774,23444,2FCE41507104FDFA70291772784A7A89,60241,14,16,2,109.53319,18.28667,1616
2775,23445,2FCE41507104FDFA70291772784A7A89,31041,19,20,1,109.50278,18.23701,1507
2780,23508,7BBB2DDEDB0AE43F8CE7FBD1FCB52741,30854,0,2,2,109.56889,18.27076,1763
2781,23509,7BBB2DDEDB0AE43F8CE7FBD1FCB52741,31071,3,5,2,109.58257,18.28458,1815
2782,23510,7BBB2DDEDB0AE43F8CE7FBD1FCB52741,30854,10,12,2,109.56889,18.27076,1763
2783,23511,7BBB2DDEDB0AE43F8CE7FBD1FCB52741,31071,15,22,7,109.58257,18.28458,1815
2784,23536,D4AA3869830031578B573FD0033C24A8,31931,0,1,1,109.54771,18.29403,1667
2785,23537,D4AA3869830031578B573FD0033C24A8,60371,1,7,6,109.53063,18.30056,1618
2786,23538,D4AA3869830031578B573FD0033C24A8,31931,7,15,8,109.54771,18.29403,1667
2799,23742,4CC3058F56A42FB99DF66B1D4EA3395F,30771,0,8,8,109.49938,18.26042,1511
2800,23743,4CC3058F56A42FB99DF66B1D4EA3395F,60641,8,9,1,109.53854,18.2359,1657
2801,23744,4CC3058F56A42FB99DF66B1D4EA3395F,30771,11,14,3,109.49938,18.26042,1511
2802,23745,4CC3058F56A42FB99DF66B1D4EA3395F,30771,17,21,4,109.49938,18.26042,1511
2816,23856,C8922FAF66F21ECAECB6B717FCD5A53B,60614,0,6,6,109.48799,18.29521,1467
2817,23857,C8922FAF66F21ECAECB6B717FCD5A53B,60391,9,10,1,109.47667,18.28757,1416
2818,23858,C8922FAF66F21ECAECB6B717FCD5A53B,60614,10,23,13,109.48799,18.29521,1467
2836,24074,7C53E1516813111F7584C70DC82C3E1E,31031,0,14,14,109.49979,18.25382,1510
2837,24075,7C53E1516813111F7584C70DC82C3E1E,30711,17,20,3,109.50271,18.25347,1510
2838,24076,7C53E1516813111F7584C70DC82C3E1E,30191,20,22,2,109.50361,18.22701,1506
2841,24090,8DA877D3A30401F86E81FB7BC1CA2A00,30854,0,3,3,109.56889,18.27076,1763
2842,24091,8DA877D3A30401F86E81FB7BC1CA2A00,31071,4,20,16,109.58257,18.28458,1815
2843,24092,8DA877D3A30401F86E81FB7BC1CA2A00,30854,22,23,1,109.56889,18.27076,1763
2849,24135,9F5F8E6110AC554161BA0F6410145CFE,60441,0,7,7,109.46792,18.28604,1366
2850,24136,9F5F8E6110AC554161BA0F6410145CFE,30764,7,10,3,109.45806,18.29486,1367
2851,24137,9F5F8E6110AC554161BA0F6410145CFE,31231,14,15,1,109.42597,18.29292,1217
2852,24138,9F5F8E6110AC554161BA0F6410145CFE,60441,18,23,5,109.46792,18.28604,1366
2860,24214,E0A24740E2C54F3B77DB561A91D2BED7,31821,0,6,6,109.51181,18.24924,1559
2861,24215,E0A24740E2C54F3B77DB561A91D2BED7,30251,8,18,10,109.50611,18.26653,1512
2862,24216,E0A24740E2C54F3B77DB561A91D2BED7,30151,18,23,5,109.50986,18.25083,1560
2894,24423,E218C587552A5DADC05C4E69685FE374,39183,5,18,13,109.55542,18.28208,1715
2895,24424,E218C587552A5DADC05C4E69685FE374,30854,18,20,2,109.56889,18.27076,1763
2896,24425,E218C587552A5DADC05C4E69685FE374,39183,20,23,3,109.55542,18.28208,1715
2928,24693,8BDE8C6966F9C7122ABA59EA6C195945,31081,0,6,6,109.44639,18.30181,1318
2929,24694,8BDE8C6966F9C7122ABA59EA6C195945,60552,9,10,1,109.41729,18.30014,1218
2930,24695,8BDE8C6966F9C7122ABA59EA6C195945,31081,10,13,3,109.44639,18.30181,1318
2942,24813,A46BA306DAEA889FAC7ACE9E5FD6A1FF,39154,1,7,6,109.50201,18.25681,1511
2943,24814,A46BA306DAEA889FAC7ACE9E5FD6A1FF,30911,7,18,11,109.50493,18.26181,1511
2944,24815,A46BA306DAEA889FAC7ACE9E5FD6A1FF,30511,21,22,1,109.51069,18.24208,1558
2947,24888,8F6EA1C108FADA76A214A7ED71ECE3D1,30891,1,3,2,109.59431,18.28389,1865
2948,24889,8F6EA1C108FADA76A214A7ED71ECE3D1,39183,6,7,1,109.55542,18.28208,1715
2949,24890,8F6EA1C108FADA76A214A7ED71ECE3D1,30854,12,20,8,109.56889,18.27076,1763
2974,25158,7C16827D646BDC874DE2BD7EE32189C5,30891,0,6,6,109.59431,18.28389,1865
2975,25159,7C16827D646BDC874DE2BD7EE32189C5,30854,10,15,5,109.56889,18.27076,1763
2976,25160,7C16827D646BDC874DE2BD7EE32189C5,60631,18,20,2,109.57778,18.27583,1814
2977,25161,7C16827D646BDC874DE2BD7EE32189C5,30854,21,22,1,109.56889,18.27076,1763
2989,25297,2F1CD98DD5F5A4A3E6D47AB706E19DF1,38154,3,5,2,109.5266,18.28278,1615
2990,25298,2F1CD98DD5F5A4A3E6D47AB706E19DF1,38094,6,7,1,109.45403,18.28778,1316
2991,25299,2F1CD98DD5F5A4A3E6D47AB706E19DF1,30151,10,17,7,109.50986,18.25083,1560
2992,25300,2F1CD98DD5F5A4A3E6D47AB706E19DF1,31821,18,22,4,109.51181,18.24924,1559
2999,25336,59F29435D748531F416A4F1636997ECF,31071,1,7,6,109.58257,18.28458,1815
3000,25337,59F29435D748531F416A4F1636997ECF,30854,9,14,5,109.56889,18.27076,1763
3001,25338,59F29435D748531F416A4F1636997ECF,60631,18,21,3,109.57778,18.27583,1814
3002,25339,59F29435D748531F416A4F1636997ECF,30854,21,23,2,109.56889,18.27076,1763
3007,25378,EF301AE8623EA991A7DABB108C1B6E04,30854,0,11,11,109.56889,18.27076,1763
3008,25379,EF301AE8623EA991A7DABB108C1B6E04,30891,12,13,1,109.59431,18.28389,1865
3009,25380,EF301AE8623EA991A7DABB108C1B6E04,30854,14,16,2,109.56889,18.27076,1763
3037,25732,875F4B80762D0E664890361D764F907D,60081,0,7,7,109.51097,18.22639,1556
3038,25733,875F4B80762D0E664890361D764F907D,30571,7,20,13,109.50243,18.21861,1504
3039,25734,875F4B80762D0E664890361D764F907D,60081,21,23,2,109.51097,18.22639,1556
3061,26011,8621CFDF1B89A83351494618C53D033F,31071,0,6,6,109.58257,18.28458,1815
3062,26012,8621CFDF1B89A83351494618C53D033F,39181,7,17,10,109.55153,18.28035,1715
3063,26013,8621CFDF1B89A83351494618C53D033F,31071,18,20,2,109.58257,18.28458,1815
3064,26014,8621CFDF1B89A83351494618C53D033F,39181,20,23,3,109.55153,18.28035,1715
3068,26071,BE7763F8096EB5A037146E1CC4190538,30451,0,1,1,109.1791,18.36229,278
3069,26072,BE7763F8096EB5A037146E1CC4190538,31541,2,3,1,109.1809,18.36722,329
3070,26073,BE7763F8096EB5A037146E1CC4190538,30451,4,6,2,109.1791,18.36229,278
3071,26074,BE7763F8096EB5A037146E1CC4190538,31124,7,11,4,109.17069,18.35,276
3072,26077,5A1C4533F331B639AE5D3D6E2930E30B,31945,0,13,13,109.58021,18.29403,1817
3073,26078,5A1C4533F331B639AE5D3D6E2930E30B,30854,18,19,1,109.56889,18.27076,1763
3074,26079,5A1C4533F331B639AE5D3D6E2930E30B,31071,19,20,1,109.58257,18.28458,1815
3075,26080,5A1C4533F331B639AE5D3D6E2930E30B,31945,20,22,2,109.58021,18.29403,1817
3076,26083,6DEC2B406A61120AE250440814CD16C2,30441,5,7,2,109.64021,18.25424,2010
3077,26084,6DEC2B406A61120AE250440814CD16C2,30854,10,11,1,109.56889,18.27076,1763
3078,26085,6DEC2B406A61120AE250440814CD16C2,31071,13,23,10,109.58257,18.28458,1815
3112,26444,A4132C7C24D4F6CFBC6C091695995585,30631,0,18,18,109.34382,18.32778,922
3113,26445,A4132C7C24D4F6CFBC6C091695995585,31691,18,19,1,109.36604,18.3075,1019
3114,26446,A4132C7C24D4F6CFBC6C091695995585,30631,19,23,4,109.34382,18.32778,922
3115,26447,DB4DF566D4757FF3BB488F82DE126248,60351,0,6,6,109.58403,18.28958,1816
3116,26448,DB4DF566D4757FF3BB488F82DE126248,31561,11,18,7,109.56792,18.28479,1765
3117,26449,DB4DF566D4757FF3BB488F82DE126248,38121,19,20,1,109.51361,18.27813,1564
3118,26450,DB4DF566D4757FF3BB488F82DE126248,31561,22,23,1,109.56792,18.28479,1765
3119,26468,0312B43ACF9ED1D8304E325E851AEE29,39183,0,6,6,109.55542,18.28208,1715
3120,26469,0312B43ACF9ED1D8304E325E851AEE29,30851,6,11,5,109.5616,18.27396,1713
3121,26470,0312B43ACF9ED1D8304E325E851AEE29,39183,13,14,1,109.55542,18.28208,1715
3127,26494,C834EF1A38F263607CE4942426932ED6,38171,0,1,1,109.50799,18.28139,1515
3128,26495,C834EF1A38F263607CE4942426932ED6,30081,2,12,10,109.50243,18.26632,1512
3129,26496,C834EF1A38F263607CE4942426932ED6,60291,16,17,1,109.50826,18.24639,1509
3130,26497,C834EF1A38F263607CE4942426932ED6,31041,19,21,2,109.50278,18.23701,1507
3181,26948,56C8C781972E8BFAF8A768A19AD7F590,38261,0,11,11,109.50361,18.28153,1515
3182,26949,56C8C781972E8BFAF8A768A19AD7F590,38157,12,13,1,109.51483,18.26958,1563
3183,26950,56C8C781972E8BFAF8A768A19AD7F590,38261,15,23,8,109.50361,18.28153,1515
3190,26981,C709D01469E0800AF998DFAF42105CDC,60631,0,6,6,109.57778,18.27583,1814
3191,26982,C709D01469E0800AF998DFAF42105CDC,31561,6,17,11,109.56792,18.28479,1765
3192,26983,C709D01469E0800AF998DFAF42105CDC,30854,19,21,2,109.56889,18.27076,1763
3203,27039,0E5593A90D661690BE3DAAA17AD936E2,38127,0,6,6,109.50833,18.27222,1513
3204,27041,0E5593A90D661690BE3DAAA17AD936E2,31021,14,15,1,109.49021,18.27,1463
3205,27042,0E5593A90D661690BE3DAAA17AD936E2,38127,15,23,8,109.50833,18.27222,1513
3210,27099,2C3BD53A8702A47FB82F05FB4993B683,30851,2,3,1,109.5616,18.27396,1713
3211,27100,2C3BD53A8702A47FB82F05FB4993B683,31561,3,6,3,109.56792,18.28479,1765
3212,27101,2C3BD53A8702A47FB82F05FB4993B683,39183,6,8,2,109.55542,18.28208,1715
3213,27102,2C3BD53A8702A47FB82F05FB4993B683,31561,12,23,11,109.56792,18.28479,1765
3220,27166,0E1B3CFC64EBB658DA96D0DCA834701E,61011,0,2,2,109.60653,18.19076,1900
3221,27168,0E1B3CFC64EBB658DA96D0DCA834701E,61011,3,8,5,109.60653,18.19076,1900
3222,27170,0E1B3CFC64EBB658DA96D0DCA834701E,61011,15,23,8,109.60653,18.19076,1900
3234,27237,40C57F24FE0409ABB752B2031C349577,38951,0,18,18,109.48097,18.28868,1416
3235,27238,40C57F24FE0409ABB752B2031C349577,31461,20,21,1,109.5091,18.25389,1510
3236,27239,40C57F24FE0409ABB752B2031C349577,39154,22,23,1,109.50201,18.25681,1511
3256,27388,AEBBFCD9EF38894E25854AE43E8486E8,31431,0,14,14,109.44639,18.29042,1316
3257,27389,AEBBFCD9EF38894E25854AE43E8486E8,31431,18,21,3,109.44639,18.29042,1316
3258,27390,AEBBFCD9EF38894E25854AE43E8486E8,31431,21,23,2,109.44639,18.29042,1316
3262,27420,5533066D8871087CCD481B88DD73EF7D,31361,0,7,7,109.47417,18.28292,1415
3263,27421,5533066D8871087CCD481B88DD73EF7D,38094,8,10,2,109.45403,18.28778,1316
3264,27422,5533066D8871087CCD481B88DD73EF7D,60401,10,16,6,109.47444,18.27583,1414
3265,27423,5533066D8871087CCD481B88DD73EF7D,31361,21,23,2,109.47417,18.28292,1415
3274,27535,14F4ACAD1B4C4B8CE52F7EFB2E582792,31031,0,10,10,109.49979,18.25382,1510
3275,27536,14F4ACAD1B4C4B8CE52F7EFB2E582792,31031,11,20,9,109.49979,18.25382,1510
3276,27537,14F4ACAD1B4C4B8CE52F7EFB2E582792,31031,22,23,1,109.49979,18.25382,1510
3278,27612,54CB15055EFF66319A7EAB3FC49E46B1,30911,1,10,9,109.50493,18.26181,1511
3279,27613,54CB15055EFF66319A7EAB3FC49E46B1,30281,10,15,5,109.50597,18.27583,1514
3280,27614,54CB15055EFF66319A7EAB3FC49E46B1,38127,17,20,3,109.50833,18.27222,1513
3281,27615,54CB15055EFF66319A7EAB3FC49E46B1,30421,21,23,2,109.50021,18.25861,1511
3307,27696,608A55C14BAB2A5B627ACC1F39B89FB6,31945,0,7,7,109.58021,18.29403,1817
3308,27697,608A55C14BAB2A5B627ACC1F39B89FB6,30854,9,12,3,109.56889,18.27076,1763
3309,27698,608A55C14BAB2A5B627ACC1F39B89FB6,31945,12,22,10,109.58021,18.29403,1817
3321,27764,10EBF762D28520B09848288F7052CFDE,30854,1,2,1,109.56889,18.27076,1763
3322,27765,10EBF762D28520B09848288F7052CFDE,39101,6,18,12,109.50132,18.24931,1509
3323,27766,10EBF762D28520B09848288F7052CFDE,31561,18,19,1,109.56792,18.28479,1765
3324,27767,10EBF762D28520B09848288F7052CFDE,30854,21,23,2,109.56889,18.27076,1763
3375,28128,4B0AADB3989E3C45AA834D87FDC75667,31181,0,12,12,109.50382,18.24813,1509
3376,28129,4B0AADB3989E3C45AA834D87FDC75667,30711,12,14,2,109.50271,18.25347,1510
3377,28130,4B0AADB3989E3C45AA834D87FDC75667,31181,19,20,1,109.50382,18.24813,1509
3378,28131,4B0AADB3989E3C45AA834D87FDC75667,31521,21,22,1,109.51458,18.22542,1555
3379,28157,C85D0B931BEF54F05B9ABBBB03212DB7,30854,0,6,6,109.56889,18.27076,1763
3380,28158,C85D0B931BEF54F05B9ABBBB03212DB7,31561,8,17,9,109.56792,18.28479,1765
3381,28159,C85D0B931BEF54F05B9ABBBB03212DB7,30854,19,23,4,109.56889,18.27076,1763
3382,28199,A64F0864B99B42C4602C17C645042912,30921,0,9,9,109.53903,18.29451,1667
3383,28200,A64F0864B99B42C4602C17C645042912,31931,10,16,6,109.54771,18.29403,1667
3384,28201,A64F0864B99B42C4602C17C645042912,30921,18,23,5,109.53903,18.29451,1667
3385,28229,7B2AEE2086698683607EDDDB4B678234,38154,2,6,4,109.5266,18.28278,1615
3386,28230,7B2AEE2086698683607EDDDB4B678234,60221,7,9,2,109.52569,18.29188,1616
3387,28231,7B2AEE2086698683607EDDDB4B678234,60201,11,17,6,109.5041,18.2509,1510
3388,28232,7B2AEE2086698683607EDDDB4B678234,38154,20,23,3,109.5266,18.28278,1615
3389,28236,72A9161A6BA570E7D89DA2361688C0AC,60081,0,1,1,109.51097,18.22639,1556
3390,28237,72A9161A6BA570E7D89DA2361688C0AC,30271,2,7,5,109.49132,18.23153,1456
3391,28238,72A9161A6BA570E7D89DA2361688C0AC,30051,9,10,1,109.48917,18.21215,1453
3394,28277,2A6BA0678DDF16AF08BAC9E3FA3C9391,30854,0,4,4,109.56889,18.27076,1763
3395,28278,2A6BA0678DDF16AF08BAC9E3FA3C9391,31561,4,8,4,109.56792,18.28479,1765
3396,28279,2A6BA0678DDF16AF08BAC9E3FA3C9391,30854,8,20,12,109.56889,18.27076,1763
3397,28280,2A6BA0678DDF16AF08BAC9E3FA3C9391,31561,21,23,2,109.56792,18.28479,1765
3405,28314,75817DB682187A07461734D66E1E6492,60631,0,4,4,109.57778,18.27583,1814
3406,28315,75817DB682187A07461734D66E1E6492,30854,7,17,10,109.56889,18.27076,1763
3407,28316,75817DB682187A07461734D66E1E6492,60631,22,23,1,109.57778,18.27583,1814
3446,28603,4995463B780282C9C030A19D9F49AEAC,31071,0,6,6,109.58257,18.28458,1815
3447,28604,4995463B780282C9C030A19D9F49AEAC,30854,9,12,3,109.56889,18.27076,1763
3448,28605,4995463B780282C9C030A19D9F49AEAC,31071,13,16,3,109.58257,18.28458,1815
3451,28648,4668E301B162346AD4FA0011F3180AB0,60235,0,5,5,109.49269,18.2253,1455
3452,28649,4668E301B162346AD4FA0011F3180AB0,30571,5,17,12,109.50243,18.21861,1504
3453,28650,4668E301B162346AD4FA0011F3180AB0,60231,20,21,1,109.49903,18.21972,1504
3460,28779,8C5A16299A6D294198C90C34C25C5949,31561,0,1,1,109.56792,18.28479,1765
3461,28780,8C5A16299A6D294198C90C34C25C5949,30854,3,17,14,109.56889,18.27076,1763
3462,28781,8C5A16299A6D294198C90C34C25C5949,31561,19,21,2,109.56792,18.28479,1765
3463,28782,662D882A6A10D0E6C3566690F0A40636,30854,1,14,13,109.56889,18.27076,1763
3464,28783,662D882A6A10D0E6C3566690F0A40636,31071,17,21,4,109.58257,18.28458,1815
3465,28784,662D882A6A10D0E6C3566690F0A40636,30854,21,22,1,109.56889,18.27076,1763
3466,28790,552B98A65A23DB4CD390E78F3246E9C5,30921,0,7,7,109.53903,18.29451,1667
3467,28791,552B98A65A23DB4CD390E78F3246E9C5,60251,9,10,1,109.51229,18.325,1572
3468,28792,552B98A65A23DB4CD390E78F3246E9C5,31931,11,12,1,109.54771,18.29403,1667
3469,28793,552B98A65A23DB4CD390E78F3246E9C5,30921,13,18,5,109.53903,18.29451,1667
3494,28999,89A3D380798A385AE8DF1304AC1B4E0B,31931,0,15,15,109.54771,18.29403,1667
3495,29000,89A3D380798A385AE8DF1304AC1B4E0B,39183,16,17,1,109.55542,18.28208,1715
3496,29001,89A3D380798A385AE8DF1304AC1B4E0B,31931,17,23,6,109.54771,18.29403,1667
3511,29195,05F9648883BF713D4E846B58647DFC7D,60524,0,7,7,109.42951,18.28993,1216
3512,29196,05F9648883BF713D4E846B58647DFC7D,60552,7,9,2,109.41729,18.30014,1218
3513,29197,05F9648883BF713D4E846B58647DFC7D,31091,13,15,2,109.41201,18.31222,1170
3514,29198,05F9648883BF713D4E846B58647DFC7D,60552,18,23,5,109.41729,18.30014,1218
3520,29248,0D3DA8126B134D203BB35373EAFFB116,31071,1,7,6,109.58257,18.28458,1815
3521,29249,0D3DA8126B134D203BB35373EAFFB116,30854,10,13,3,109.56889,18.27076,1763
3522,29250,0D3DA8126B134D203BB35373EAFFB116,31071,16,23,7,109.58257,18.28458,1815
3539,29394,84DF4A7C208235D171EF56473BCCF210,30851,0,2,2,109.5616,18.27396,1713
3540,29395,84DF4A7C208235D171EF56473BCCF210,31561,4,7,3,109.56792,18.28479,1765
3541,29396,84DF4A7C208235D171EF56473BCCF210,60631,7,18,11,109.57778,18.27583,1814
3544,29442,BCE29A3A46F5A479B3F0FA50B11216DE,31071,2,8,6,109.58257,18.28458,1815
3545,29443,BCE29A3A46F5A479B3F0FA50B11216DE,60631,11,12,1,109.57778,18.27583,1814
3546,29444,BCE29A3A46F5A479B3F0FA50B11216DE,31071,16,20,4,109.58257,18.28458,1815
3555,29562,40D62DAB923B148A7A4FFB3BCA6C7343,60501,1,12,11,109.48701,18.29021,1466
3556,29563,40D62DAB923B148A7A4FFB3BCA6C7343,31351,16,18,2,109.4959,18.28417,1465
3557,29564,40D62DAB923B148A7A4FFB3BCA6C7343,60501,21,22,1,109.48701,18.29021,1466
3566,29609,934029FB5F97BCE114EDCE88F0393A63,30854,0,9,9,109.56889,18.27076,1763
3567,29610,934029FB5F97BCE114EDCE88F0393A63,30421,14,18,4,109.50021,18.25861,1511
3568,29611,934029FB5F97BCE114EDCE88F0393A63,31031,18,20,2,109.49979,18.25382,1510
3569,29612,934029FB5F97BCE114EDCE88F0393A63,30854,21,23,2,109.56889,18.27076,1763
3579,29644,335A7B1DE8538918FDA774EE3E402A76,30191,0,7,7,109.50361,18.22701,1506
3580,29645,335A7B1DE8538918FDA774EE3E402A76,31521,8,11,3,109.51458,18.22542,1555
3581,29646,335A7B1DE8538918FDA774EE3E402A76,30191,12,23,11,109.50361,18.22701,1506
3587,29665,D2062F9F4167AD0C830A785B4B823E0C,38801,0,6,6,109.51472,18.2584,1561
3588,29666,D2062F9F4167AD0C830A785B4B823E0C,38801,7,14,7,109.51472,18.2584,1561
3589,29667,D2062F9F4167AD0C830A785B4B823E0C,60381,18,19,1,109.5241,18.22458,1605
3590,29668,D2062F9F4167AD0C830A785B4B823E0C,38801,19,23,4,109.51472,18.2584,1561
3599,29752,55F576946F2DD2E74BBCE8583E769B71,30581,0,6,6,109.62257,18.24951,1959
3600,29753,55F576946F2DD2E74BBCE8583E769B71,31221,6,14,8,109.61333,18.26833,1913
3601,29754,55F576946F2DD2E74BBCE8583E769B71,30854,17,18,1,109.56889,18.27076,1763
3602,29771,9C1407835BC54BEBDB541F52E1DA1820,61011,0,1,1,109.60653,18.19076,1900
3603,29773,9C1407835BC54BEBDB541F52E1DA1820,61011,6,12,6,109.60653,18.19076,1900
3604,29775,9C1407835BC54BEBDB541F52E1DA1820,61011,16,18,2,109.60653,18.19076,1900
3605,29796,3520FED22A4D572CBFE1B08BD2743E22,31461,1,12,11,109.5091,18.25389,1510
3606,29797,3520FED22A4D572CBFE1B08BD2743E22,31041,14,15,1,109.50278,18.23701,1507
3607,29798,3520FED22A4D572CBFE1B08BD2743E22,38316,17,19,2,109.48542,18.27424,1464
3608,29799,3520FED22A4D572CBFE1B08BD2743E22,30511,20,22,2,109.51069,18.24208,1558
3619,29890,41F3C3B484933318A782EA0B7EF5AC36,31071,0,9,9,109.58257,18.28458,1815
3620,29891,41F3C3B484933318A782EA0B7EF5AC36,30854,9,12,3,109.56889,18.27076,1763
3621,29892,41F3C3B484933318A782EA0B7EF5AC36,31071,13,23,10,109.58257,18.28458,1815
3622,29923,0BABF9C6516F437130A3DD3C99553A57,31261,0,1,1,109.51174,18.2466,1559
3623,29924,0BABF9C6516F437130A3DD3C99553A57,31206,2,7,5,109.50819,18.23549,1507
3624,29925,0BABF9C6516F437130A3DD3C99553A57,39191,8,17,9,109.51493,18.23472,1557
3625,29944,37D38EF0062E64D55C94EB554B76F9EE,31945,0,8,8,109.58021,18.29403,1817
3626,29945,37D38EF0062E64D55C94EB554B76F9EE,60361,10,11,1,109.51938,18.29681,1567
3627,29946,37D38EF0062E64D55C94EB554B76F9EE,30854,16,17,1,109.56889,18.27076,1763
3628,29947,37D38EF0062E64D55C94EB554B76F9EE,38171,18,19,1,109.50799,18.28139,1515
3648,30073,4B4DB8C4ECEDAFF99158AB3CD1CD626F,31031,0,5,5,109.49979,18.25382,1510
3649,30074,4B4DB8C4ECEDAFF99158AB3CD1CD626F,31031,6,7,1,109.49979,18.25382,1510
3650,30076,4B4DB8C4ECEDAFF99158AB3CD1CD626F,31031,17,23,6,109.49979,18.25382,1510
3664,30163,F3652FF504BC297E68234A33C1877043,31945,0,7,7,109.58021,18.29403,1817
3665,30164,F3652FF504BC297E68234A33C1877043,30854,8,10,2,109.56889,18.27076,1763
3666,30165,F3652FF504BC297E68234A33C1877043,31945,13,14,1,109.58021,18.29403,1817
3672,30213,635914FBAF9BDB855B8CB450E2AE782A,38834,1,2,1,109.47639,18.21146,1403
3673,30214,635914FBAF9BDB855B8CB450E2AE782A,30051,6,13,7,109.48917,18.21215,1453
3674,30215,635914FBAF9BDB855B8CB450E2AE782A,30711,14,15,1,109.50271,18.25347,1510
3675,30227,D9AE11CD16B231308C3F0FB3F53BC3E9,31071,1,8,7,109.58257,18.28458,1815
3676,30228,D9AE11CD16B231308C3F0FB3F53BC3E9,30854,9,11,2,109.56889,18.27076,1763
3677,30229,D9AE11CD16B231308C3F0FB3F53BC3E9,31071,12,13,1,109.58257,18.28458,1815
3678,30230,D9AE11CD16B231308C3F0FB3F53BC3E9,30854,14,23,9,109.56889,18.27076,1763
3689,30279,43E035AE85036EBD9891453E9567CB81,30151,0,8,8,109.50986,18.25083,1560
3690,30280,43E035AE85036EBD9891453E9567CB81,30321,10,11,1,109.49563,18.29611,1467
3691,30281,43E035AE85036EBD9891453E9567CB81,60291,12,13,1,109.50826,18.24639,1509
3692,30282,43E035AE85036EBD9891453E9567CB81,30151,15,23,8,109.50986,18.25083,1560
3702,30360,12D8E06C2EC8C969710FB791DF137B2B,31071,1,7,6,109.58257,18.28458,1815
3703,30361,12D8E06C2EC8C969710FB791DF137B2B,30854,9,11,2,109.56889,18.27076,1763
3704,30362,12D8E06C2EC8C969710FB791DF137B2B,31071,15,16,1,109.58257,18.28458,1815
3705,30363,12D8E06C2EC8C969710FB791DF137B2B,30854,20,22,2,109.56889,18.27076,1763
3713,30515,9AA959ED87D1ECC3053DED17290EFCBD,31561,1,4,3,109.56792,18.28479,1765
3714,30516,9AA959ED87D1ECC3053DED17290EFCBD,39183,7,9,2,109.55542,18.28208,1715
3715,30517,9AA959ED87D1ECC3053DED17290EFCBD,31561,10,21,11,109.56792,18.28479,1765
3716,30518,9AA959ED87D1ECC3053DED17290EFCBD,30854,22,23,1,109.56889,18.27076,1763
3723,30576,5B5FB16F9BE2A1826D497C2695908410,31561,1,5,4,109.56792,18.28479,1765
3724,30577,5B5FB16F9BE2A1826D497C2695908410,31071,5,6,1,109.58257,18.28458,1815
3725,30578,5B5FB16F9BE2A1826D497C2695908410,31561,8,16,8,109.56792,18.28479,1765
3743,30732,B4D280332D4864EE44777CDB8551463D,31461,1,8,7,109.5091,18.25389,1510
3744,30733,B4D280332D4864EE44777CDB8551463D,38154,9,10,1,109.5266,18.28278,1615
3745,30734,B4D280332D4864EE44777CDB8551463D,31461,12,23,11,109.5091,18.25389,1510
3773,30855,2AE38FAF341950B0B91404FFCE5A0F3E,31931,0,6,6,109.54771,18.29403,1667
3774,30856,2AE38FAF341950B0B91404FFCE5A0F3E,30921,6,17,11,109.53903,18.29451,1667
3775,30857,2AE38FAF341950B0B91404FFCE5A0F3E,31931,22,23,1,109.54771,18.29403,1667
3789,30991,EC4B90EDBF35256FDB4D4F8B87DB8A04,31071,0,7,7,109.58257,18.28458,1815
3790,30992,EC4B90EDBF35256FDB4D4F8B87DB8A04,30854,8,12,4,109.56889,18.27076,1763
3791,30993,EC4B90EDBF35256FDB4D4F8B87DB8A04,31071,13,16,3,109.58257,18.28458,1815
3792,30994,EC4B90EDBF35256FDB4D4F8B87DB8A04,30854,16,17,1,109.56889,18.27076,1763
3814,31108,622234A65D292D040A9E438A2770674C,30851,0,15,15,109.5616,18.27396,1713
3815,31109,622234A65D292D040A9E438A2770674C,31561,16,17,1,109.56792,18.28479,1765
3816,31110,622234A65D292D040A9E438A2770674C,30851,18,23,5,109.5616,18.27396,1713
3841,31389,75844BC188A37949D63EE7DEE6219ABA,60594,1,6,5,109.62694,18.22799,1956
3842,31390,75844BC188A37949D63EE7DEE6219ABA,38052,6,10,4,109.62618,18.23042,1956
3843,31391,75844BC188A37949D63EE7DEE6219ABA,60594,14,23,9,109.62694,18.22799,1956
3880,31658,6C0260646767B781577B5B8CE2471E51,38991,0,2,2,109.52681,18.30368,1618
3881,31659,6C0260646767B781577B5B8CE2471E51,38484,2,12,10,109.53028,18.31528,1620
3882,31660,6C0260646767B781577B5B8CE2471E51,38484,16,17,1,109.53028,18.31528,1620
3883,31661,6C0260646767B781577B5B8CE2471E51,38484,19,23,4,109.53028,18.31528,1620
3902,31797,FE95B3A32EFBC2838F293DF38F55FDD1,39183,0,1,1,109.55542,18.28208,1715
3903,31798,FE95B3A32EFBC2838F293DF38F55FDD1,31931,2,5,3,109.54771,18.29403,1667
3904,31799,FE95B3A32EFBC2838F293DF38F55FDD1,31561,6,17,11,109.56792,18.28479,1765
3905,31800,FE95B3A32EFBC2838F293DF38F55FDD1,31931,20,21,1,109.54771,18.29403,1667
3906,31811,0C12679B52C25C8A094B9B69D277B0C8,31071,0,6,6,109.58257,18.28458,1815
3907,31812,0C12679B52C25C8A094B9B69D277B0C8,30854,9,10,1,109.56889,18.27076,1763
3908,31813,0C12679B52C25C8A094B9B69D277B0C8,31071,11,23,12,109.58257,18.28458,1815
3954,32255,4D4289AE0DFBF4B5C79A47559DC2EBDD,30854,2,7,5,109.56889,18.27076,1763
3955,32256,4D4289AE0DFBF4B5C79A47559DC2EBDD,31071,7,8,1,109.58257,18.28458,1815
3956,32257,4D4289AE0DFBF4B5C79A47559DC2EBDD,30854,11,13,2,109.56889,18.27076,1763
3969,32334,0B67294FA9DBD53325D63EA36C1B8784,30271,0,14,14,109.49132,18.23153,1456
3970,32335,0B67294FA9DBD53325D63EA36C1B8784,30771,15,17,2,109.49938,18.26042,1511
3971,32336,0B67294FA9DBD53325D63EA36C1B8784,31411,19,20,1,109.5016,18.23576,1507
3990,32504,5D5B29A994BBA3635D38463A75BE58F6,31021,0,9,9,109.49021,18.27,1463
3991,32505,5D5B29A994BBA3635D38463A75BE58F6,60131,10,11,1,109.49819,18.24778,1509
3992,32506,5D5B29A994BBA3635D38463A75BE58F6,30201,15,17,2,109.4909,18.26465,1462
3993,32507,5D5B29A994BBA3635D38463A75BE58F6,31021,20,22,2,109.49021,18.27,1463
3994,32519,CDB953050813C58D32D89D5658BB96B4,30071,0,6,6,109.52819,18.30472,1619
3995,32520,CDB953050813C58D32D89D5658BB96B4,31561,8,10,2,109.56792,18.28479,1765
3996,32521,CDB953050813C58D32D89D5658BB96B4,30071,12,13,1,109.52819,18.30472,1619
3997,32522,CDB953050813C58D32D89D5658BB96B4,30921,15,17,2,109.53903,18.29451,1667
4024,32802,104D50A9C0319F25E132948E6191A1E5,30271,1,4,3,109.49132,18.23153,1456
4025,32803,104D50A9C0319F25E132948E6191A1E5,60161,6,11,5,109.49174,18.26181,1461
4026,32804,104D50A9C0319F25E132948E6191A1E5,30271,14,17,3,109.49132,18.23153,1456
4027,32805,104D50A9C0319F25E132948E6191A1E5,60161,19,23,4,109.49174,18.26181,1461
4042,32989,C925EDC1C2C39BAEC75090090BF059D6,30741,0,10,10,109.49833,18.28681,1516
4043,32990,C925EDC1C2C39BAEC75090090BF059D6,30721,10,12,2,109.51597,18.28257,1565
4044,32991,C925EDC1C2C39BAEC75090090BF059D6,30741,12,14,2,109.49833,18.28681,1516
4045,32992,C925EDC1C2C39BAEC75090090BF059D6,30111,18,20,2,109.47583,18.30542,1419
4054,33096,D4EE8E1A4C04A1FF0596E4221D0B8B42,31071,3,6,3,109.58257,18.28458,1815
4055,33097,D4EE8E1A4C04A1FF0596E4221D0B8B42,30854,6,9,3,109.56889,18.27076,1763
4056,33098,D4EE8E1A4C04A1FF0596E4221D0B8B42,31071,10,13,3,109.58257,18.28458,1815
4057,33118,32F65A20D32806FF353EB969C069139F,31031,0,7,7,109.49979,18.25382,1510
4058,33121,32F65A20D32806FF353EB969C069139F,31031,16,21,5,109.49979,18.25382,1510
4059,33122,32F65A20D32806FF353EB969C069139F,31031,21,23,2,109.49979,18.25382,1510
4060,33161,875F4B80762D0E664890361D764F907D,60081,0,7,7,109.51097,18.22639,1556
4061,33162,875F4B80762D0E664890361D764F907D,30571,7,18,11,109.50243,18.21861,1504
4062,33163,875F4B80762D0E664890361D764F907D,60081,19,22,3,109.51097,18.22639,1556
4065,33202,1FD05A9E99D3A8B48E9543287CC9F67A,31101,0,5,5,109.65389,18.23403,2057
4066,33203,1FD05A9E99D3A8B48E9543287CC9F67A,30581,8,9,1,109.62257,18.24951,1959
4067,33204,1FD05A9E99D3A8B48E9543287CC9F67A,60211,11,13,2,109.63549,18.26049,2011
4068,33205,386F7E2A07BE399DCB2707EFFCEA6EF0,31221,0,2,2,109.61333,18.26833,1913
4069,33206,386F7E2A07BE399DCB2707EFFCEA6EF0,38331,3,10,7,109.62465,18.22736,1956
4070,33207,386F7E2A07BE399DCB2707EFFCEA6EF0,30441,15,16,1,109.64021,18.25424,2010
4071,33208,386F7E2A07BE399DCB2707EFFCEA6EF0,60594,16,18,2,109.62694,18.22799,1956
4072,33240,C53359D886B7B5AFF68C8D065C0B3F4F,31041,0,10,10,109.50278,18.23701,1507
4073,33241,C53359D886B7B5AFF68C8D065C0B3F4F,60381,12,13,1,109.5241,18.22458,1605
4074,33242,C53359D886B7B5AFF68C8D065C0B3F4F,31041,16,21,5,109.50278,18.23701,1507
4075,33257,578D6C2F8B353A0A6B51E609EBAAB9E1,31071,0,11,11,109.58257,18.28458,1815
4076,33258,578D6C2F8B353A0A6B51E609EBAAB9E1,30854,11,18,7,109.56889,18.27076,1763
4077,33259,578D6C2F8B353A0A6B51E609EBAAB9E1,60631,21,22,1,109.57778,18.27583,1814
4082,33377,C17F2EF1DEA79C8C951E3013EE071B2C,30741,0,2,2,109.49833,18.28681,1516
4083,33378,C17F2EF1DEA79C8C951E3013EE071B2C,31071,2,14,12,109.58257,18.28458,1815
4084,33379,C17F2EF1DEA79C8C951E3013EE071B2C,31391,16,17,1,109.50382,18.24285,1508
4100,33468,4B5715B52BEE7053A5D5FB0753903282,31864,0,3,3,109.49014,18.28333,1465
4101,33469,4B5715B52BEE7053A5D5FB0753903282,31351,4,6,2,109.4959,18.28417,1465
4102,33470,4B5715B52BEE7053A5D5FB0753903282,60401,9,11,2,109.47444,18.27583,1414
4103,33516,1C67859AC074D33800F75471EB5E573E,30854,0,7,7,109.56889,18.27076,1763
4104,33517,1C67859AC074D33800F75471EB5E573E,31071,10,11,1,109.58257,18.28458,1815
4105,33518,1C67859AC074D33800F75471EB5E573E,30854,12,21,9,109.56889,18.27076,1763
4106,33519,1C67859AC074D33800F75471EB5E573E,60631,22,23,1,109.57778,18.27583,1814
4126,33572,2593966F0C8425B380675DCEA23788BE,39181,0,8,8,109.55153,18.28035,1715
4127,33573,2593966F0C8425B380675DCEA23788BE,39181,8,9,1,109.55153,18.28035,1715
4128,33574,2593966F0C8425B380675DCEA23788BE,39181,10,23,13,109.55153,18.28035,1715
4148,33735,BE7763F8096EB5A037146E1CC4190538,30854,0,10,10,109.56889,18.27076,1763
4149,33736,BE7763F8096EB5A037146E1CC4190538,31561,11,12,1,109.56792,18.28479,1765
4150,33737,BE7763F8096EB5A037146E1CC4190538,30854,13,14,1,109.56889,18.27076,1763
4193,34108,2DDF3A993BD69F79020EB97CF3A71819,38171,0,7,7,109.50799,18.28139,1515
4194,34109,2DDF3A993BD69F79020EB97CF3A71819,30161,8,14,6,109.50042,18.24389,1508
4195,34110,2DDF3A993BD69F79020EB97CF3A71819,30161,16,20,4,109.50042,18.24389,1508
4207,34234,ECA37B99D2E4FEE602303DB4AB25AB77,30721,0,11,11,109.51597,18.28257,1565
4208,34235,ECA37B99D2E4FEE602303DB4AB25AB77,31231,15,16,1,109.42597,18.29292,1217
4209,34236,ECA37B99D2E4FEE602303DB4AB25AB77,30721,17,23,6,109.51597,18.28257,1565
4217,34270,B12433B5B11FA73A44C6D6FB9BE61089,31531,0,9,9,109.49583,18.25972,1461
4218,34271,B12433B5B11FA73A44C6D6FB9BE61089,31181,10,17,7,109.50382,18.24813,1509
4219,34272,B12433B5B11FA73A44C6D6FB9BE61089,60161,19,21,2,109.49174,18.26181,1461
4220,34273,B12433B5B11FA73A44C6D6FB9BE61089,31531,22,23,1,109.49583,18.25972,1461
4221,34277,ADAB51A6D99BADC8222FC392D72ADA01,60281,0,12,12,109.51743,18.25924,1561
4222,34278,ADAB51A6D99BADC8222FC392D72ADA01,30251,12,13,1,109.50611,18.26653,1512
4223,34279,ADAB51A6D99BADC8222FC392D72ADA01,60281,15,23,8,109.51743,18.25924,1561
4250,34430,B55959B64746A18ECF5077B5F7359221,31561,0,13,13,109.56792,18.28479,1765
4251,34431,B55959B64746A18ECF5077B5F7359221,39183,14,15,1,109.55542,18.28208,1715
4252,34432,B55959B64746A18ECF5077B5F7359221,31561,17,18,1,109.56792,18.28479,1765
4281,34690,0C8D15C0488D521680F0DE3A28CFE111,31811,2,3,1,109.54201,18.31806,1671
4282,34691,0C8D15C0488D521680F0DE3A28CFE111,30701,4,16,12,109.59313,18.32007,1871
4283,34692,0C8D15C0488D521680F0DE3A28CFE111,31811,18,20,2,109.54201,18.31806,1671
4284,34693,0C8D15C0488D521680F0DE3A28CFE111,30701,20,23,3,109.59313,18.32007,1871
4297,34719,64F4CDF664AA04E7B79DE93C57128CF6,31931,0,5,5,109.54771,18.29403,1667
4298,34720,64F4CDF664AA04E7B79DE93C57128CF6,39183,8,10,2,109.55542,18.28208,1715
4299,34721,64F4CDF664AA04E7B79DE93C57128CF6,39181,12,18,6,109.55153,18.28035,1715
4300,34722,64F4CDF664AA04E7B79DE93C57128CF6,31931,20,21,1,109.54771,18.29403,1667
4301,34732,45CCFCD3EBDF941E1C92B70ED06E8B5E,31561,1,4,3,109.56792,18.28479,1765
4302,34733,45CCFCD3EBDF941E1C92B70ED06E8B5E,30854,5,6,1,109.56889,18.27076,1763
4303,34734,45CCFCD3EBDF941E1C92B70ED06E8B5E,31945,9,10,1,109.58021,18.29403,1817
4304,34735,45CCFCD3EBDF941E1C92B70ED06E8B5E,30854,12,23,11,109.56889,18.27076,1763
4358,35215,EFDE35289FEC1E13D6F34EFEE66A8AD2,60631,0,15,15,109.57778,18.27583,1814
4359,35216,EFDE35289FEC1E13D6F34EFEE66A8AD2,30854,17,19,2,109.56889,18.27076,1763
4360,35217,EFDE35289FEC1E13D6F34EFEE66A8AD2,31071,21,23,2,109.58257,18.28458,1815
4366,35256,8E1FB7AD92E84F40BA2A70D5520A3AD6,30731,0,7,7,109.50944,18.22306,1555
4367,35257,8E1FB7AD92E84F40BA2A70D5520A3AD6,39091,11,13,2,109.50097,18.25222,1510
4368,35258,8E1FB7AD92E84F40BA2A70D5520A3AD6,39321,13,22,9,109.529,18.2167,1604
4372,35305,77EBC7C5936E724AFF90D84A07AD90DB,30721,1,16,15,109.51597,18.28257,1565
4373,35306,77EBC7C5936E724AFF90D84A07AD90DB,30201,19,20,1,109.4909,18.26465,1462
4374,35307,77EBC7C5936E724AFF90D84A07AD90DB,39091,21,22,1,109.50097,18.25222,1510
4380,35346,F3CCA2DC8A3A6438A9717D695C077F67,30731,1,8,7,109.50944,18.22306,1555
4381,35348,F3CCA2DC8A3A6438A9717D695C077F67,60381,18,20,2,109.5241,18.22458,1605
4382,35349,F3CCA2DC8A3A6438A9717D695C077F67,30731,21,23,2,109.50944,18.22306,1555
4397,35441,0133DDFFB5CECBB261CEDEF10A82D50B,30854,0,1,1,109.56889,18.27076,1763
4398,35442,0133DDFFB5CECBB261CEDEF10A82D50B,31561,1,7,6,109.56792,18.28479,1765
4399,35444,0133DDFFB5CECBB261CEDEF10A82D50B,30854,15,16,1,109.56889,18.27076,1763
4421,35597,173CD7A2B7B334BC53A50A1D248FBCFE,31071,2,8,6,109.58257,18.28458,1815
4422,35598,173CD7A2B7B334BC53A50A1D248FBCFE,30854,8,21,13,109.56889,18.27076,1763
4423,35599,173CD7A2B7B334BC53A50A1D248FBCFE,31071,21,23,2,109.58257,18.28458,1815
4424,35607,451E2BF48CD7B253EB0892324E679BCC,31461,4,5,1,109.5091,18.25389,1510
4425,35608,451E2BF48CD7B253EB0892324E679BCC,60281,7,18,11,109.51743,18.25924,1561
4426,35609,451E2BF48CD7B253EB0892324E679BCC,38291,19,22,3,109.51618,18.24313,1558
4427,35610,451E2BF48CD7B253EB0892324E679BCC,38297,22,23,1,109.52576,18.24965,1609
4435,35655,B0EA82CA44F2A5DBEC337F9E5C778FEC,39183,0,5,5,109.55542,18.28208,1715
4436,35656,B0EA82CA44F2A5DBEC337F9E5C778FEC,39181,9,16,7,109.55153,18.28035,1715
4437,35657,B0EA82CA44F2A5DBEC337F9E5C778FEC,39183,18,19,1,109.55542,18.28208,1715
4440,35672,5EB9946C32427EC9667421AF45A45A41,38951,0,7,7,109.48097,18.28868,1416
4441,35673,5EB9946C32427EC9667421AF45A45A41,38951,8,10,2,109.48097,18.28868,1416
4442,35674,5EB9946C32427EC9667421AF45A45A41,38951,12,14,2,109.48097,18.28868,1416
4443,35675,5EB9946C32427EC9667421AF45A45A41,38951,14,22,8,109.48097,18.28868,1416
4446,35694,78D44725626E719FF0C0FCBC8763A33E,60361,0,2,2,109.51938,18.29681,1567
4447,35695,78D44725626E719FF0C0FCBC8763A33E,31951,2,4,2,109.52174,18.30299,1568
4448,35696,78D44725626E719FF0C0FCBC8763A33E,31561,7,17,10,109.56792,18.28479,1765
4494,35896,283001ED673D8EDBEF7EEB00BDB31533,30571,0,6,6,109.50243,18.21861,1504
4495,35897,283001ED673D8EDBEF7EEB00BDB31533,31181,7,18,11,109.50382,18.24813,1509
4496,35898,283001ED673D8EDBEF7EEB00BDB31533,30571,21,23,2,109.50243,18.21861,1504
4501,35948,0E1B3CFC64EBB658DA96D0DCA834701E,61011,0,4,4,109.60653,18.19076,1900
4502,35950,0E1B3CFC64EBB658DA96D0DCA834701E,61011,6,12,6,109.60653,18.19076,1900
4503,35952,0E1B3CFC64EBB658DA96D0DCA834701E,61011,18,23,5,109.60653,18.19076,1900
4508,36002,202870BA524F8D7E9C1B66336BF1F034,31951,0,5,5,109.52174,18.30299,1568
4509,36003,202870BA524F8D7E9C1B66336BF1F034,60631,7,16,9,109.57778,18.27583,1814
4510,36004,202870BA524F8D7E9C1B66336BF1F034,30854,16,18,2,109.56889,18.27076,1763
4511,36005,202870BA524F8D7E9C1B66336BF1F034,30071,20,22,2,109.52819,18.30472,1619
4516,36069,D6B54C643B88B86782DC30A38AD291FD,31561,3,6,3,109.56792,18.28479,1765
4517,36070,D6B54C643B88B86782DC30A38AD291FD,30854,9,10,1,109.56889,18.27076,1763
4518,36071,D6B54C643B88B86782DC30A38AD291FD,31561,12,13,1,109.56792,18.28479,1765
4519,36072,D6B54C643B88B86782DC30A38AD291FD,60504,15,18,3,109.47917,18.28903,1416
4543,36222,CD576F1C1CDFB89E6A99A20E65927346,30854,0,1,1,109.56889,18.27076,1763
4544,36223,CD576F1C1CDFB89E6A99A20E65927346,31071,4,6,2,109.58257,18.28458,1815
4545,36224,CD576F1C1CDFB89E6A99A20E65927346,30854,7,20,13,109.56889,18.27076,1763
4551,36256,0695D4E7B3E726CA09D841B87798B560,31561,0,1,1,109.56792,18.28479,1765
4552,36257,0695D4E7B3E726CA09D841B87798B560,30854,1,2,1,109.56889,18.27076,1763
4553,36258,0695D4E7B3E726CA09D841B87798B560,31071,4,5,1,109.58257,18.28458,1815
4564,36347,225EDE82328108AFB3E7EE610CA3F074,31931,0,9,9,109.54771,18.29403,1667
4565,36348,225EDE82328108AFB3E7EE610CA3F074,60371,10,11,1,109.53063,18.30056,1618
4566,36349,225EDE82328108AFB3E7EE610CA3F074,31931,13,23,10,109.54771,18.29403,1667
4589,36519,B78E7295CB13532B4E2C30EF158E297F,30854,2,6,4,109.56889,18.27076,1763
4590,36520,B78E7295CB13532B4E2C30EF158E297F,31931,7,9,2,109.54771,18.29403,1667
4591,36521,B78E7295CB13532B4E2C30EF158E297F,39183,10,11,1,109.55542,18.28208,1715
4593,36546,F47C4E1E39056C43B0AD32AC994AB7C0,31931,1,16,15,109.54771,18.29403,1667
4594,36547,F47C4E1E39056C43B0AD32AC994AB7C0,60361,16,19,3,109.51938,18.29681,1567
4595,36548,F47C4E1E39056C43B0AD32AC994AB7C0,31931,22,23,1,109.54771,18.29403,1667
4609,36689,31BAA46A2F25AC63D78E0ACA44BF0FE9,39181,0,9,9,109.55153,18.28035,1715
4610,36690,31BAA46A2F25AC63D78E0ACA44BF0FE9,31931,14,15,1,109.54771,18.29403,1667
4611,36691,31BAA46A2F25AC63D78E0ACA44BF0FE9,39181,19,23,4,109.55153,18.28035,1715
4639,36880,560794A44CA17A43FA34D0FA6C339747,30854,1,7,6,109.56889,18.27076,1763
4640,36881,560794A44CA17A43FA34D0FA6C339747,60361,12,15,3,109.51938,18.29681,1567
4641,36882,560794A44CA17A43FA34D0FA6C339747,30854,18,23,5,109.56889,18.27076,1763
4645,36958,5E6BED6B24013599647F8A86A362B027,30671,0,6,6,109.43611,18.30139,1268
4646,36959,5E6BED6B24013599647F8A86A362B027,30281,10,11,1,109.50597,18.27583,1514
4647,36960,5E6BED6B24013599647F8A86A362B027,38261,13,14,1,109.50361,18.28153,1515
4699,37301,5DC8F62831D42C28A31B401E39C2405E,30171,0,8,8,109.48458,18.27139,1463
4700,37302,5DC8F62831D42C28A31B401E39C2405E,38881,10,12,2,109.51618,18.26431,1562
4701,37303,5DC8F62831D42C28A31B401E39C2405E,30171,13,16,3,109.48458,18.27139,1463
4702,37304,5DC8F62831D42C28A31B401E39C2405E,39151,18,21,3,109.49875,18.25097,1510
4721,37437,0F558B6653C655C7F0BAEA9D66B33F57,31761,2,4,2,109.60521,18.27965,1914
4722,37438,0F558B6653C655C7F0BAEA9D66B33F57,31071,4,7,3,109.58257,18.28458,1815
4723,37439,0F558B6653C655C7F0BAEA9D66B33F57,30854,10,22,12,109.56889,18.27076,1763
4758,37617,B1BCC89C2F3E15CBE4070B0B890371C7,30854,1,2,1,109.56889,18.27076,1763
4759,37618,B1BCC89C2F3E15CBE4070B0B890371C7,60631,4,6,2,109.57778,18.27583,1814
4760,37619,B1BCC89C2F3E15CBE4070B0B890371C7,30854,8,14,6,109.56889,18.27076,1763
4820,38044,108BEC70F7DB0D9C00EBA021AFD47ACE,31031,0,8,8,109.49979,18.25382,1510
4821,38045,108BEC70F7DB0D9C00EBA021AFD47ACE,38251,13,14,1,109.49618,18.25493,1510
4822,38046,108BEC70F7DB0D9C00EBA021AFD47ACE,38315,15,16,1,109.48979,18.29764,1467
4824,38064,EDD211647BCC1D3CABF473CB2801C791,30161,0,2,2,109.50042,18.24389,1508
4825,38065,EDD211647BCC1D3CABF473CB2801C791,31041,2,10,8,109.50278,18.23701,1507
4826,38066,EDD211647BCC1D3CABF473CB2801C791,30161,11,23,12,109.50042,18.24389,1508
4866,38331,21C679D1B9FF307EA1AC2A89744209FE,38291,0,12,12,109.51618,18.24313,1558
4867,38332,21C679D1B9FF307EA1AC2A89744209FE,60281,12,13,1,109.51743,18.25924,1561
4868,38333,21C679D1B9FF307EA1AC2A89744209FE,38291,14,23,9,109.51618,18.24313,1558
4892,38530,B643AC77F8D8498A9694D45BA8B0F75F,30854,0,12,12,109.56889,18.27076,1763
4893,38531,B643AC77F8D8498A9694D45BA8B0F75F,60631,13,16,3,109.57778,18.27583,1814
4894,38532,B643AC77F8D8498A9694D45BA8B0F75F,30851,17,18,1,109.5616,18.27396,1713
4895,38533,B643AC77F8D8498A9694D45BA8B0F75F,31561,18,23,5,109.56792,18.28479,1765
4896,38537,8C84F1CB6E49AC2736E89C4CFE87B2BD,31391,0,7,7,109.50382,18.24285,1508
4897,38538,8C84F1CB6E49AC2736E89C4CFE87B2BD,60381,12,15,3,109.5241,18.22458,1605
4898,38539,8C84F1CB6E49AC2736E89C4CFE87B2BD,30711,16,17,1,109.50271,18.25347,1510
4899,38540,8C84F1CB6E49AC2736E89C4CFE87B2BD,31391,17,23,6,109.50382,18.24285,1508
4920,38694,6F25B46DE233F84CBE88187DB2427FA9,30201,0,9,9,109.4909,18.26465,1462
4921,38695,6F25B46DE233F84CBE88187DB2427FA9,31021,9,12,3,109.49021,18.27,1463
4922,38696,6F25B46DE233F84CBE88187DB2427FA9,30201,12,18,6,109.4909,18.26465,1462
4923,38697,6F25B46DE233F84CBE88187DB2427FA9,30201,19,23,4,109.4909,18.26465,1462
4973,39113,662D882A6A10D0E6C3566690F0A40636,30854,0,8,8,109.56889,18.27076,1763
4974,39114,662D882A6A10D0E6C3566690F0A40636,31071,10,11,1,109.58257,18.28458,1815
4975,39115,662D882A6A10D0E6C3566690F0A40636,30854,16,17,1,109.56889,18.27076,1763
4999,39470,9FEA4B85EAE4FAEE1CAF0EABFF2FAEA1,31561,3,5,2,109.56792,18.28479,1765
5000,39471,9FEA4B85EAE4FAEE1CAF0EABFF2FAEA1,39183,7,9,2,109.55542,18.28208,1715
5001,39472,9FEA4B85EAE4FAEE1CAF0EABFF2FAEA1,31561,14,23,9,109.56792,18.28479,1765
5004,39499,89A3D380798A385AE8DF1304AC1B4E0B,31931,0,13,13,109.54771,18.29403,1667
5005,39500,89A3D380798A385AE8DF1304AC1B4E0B,39181,14,15,1,109.55153,18.28035,1715
5006,39501,89A3D380798A385AE8DF1304AC1B4E0B,31931,18,22,4,109.54771,18.29403,1667
5038,39835,90B0A60855A43B2DB99A0964CE51D3AF,31071,1,6,5,109.58257,18.28458,1815
5039,39836,90B0A60855A43B2DB99A0964CE51D3AF,30854,8,10,2,109.56889,18.27076,1763
5040,39837,90B0A60855A43B2DB99A0964CE51D3AF,31071,14,21,7,109.58257,18.28458,1815
5047,39921,39997DEFFD87AA0C9D18E1194544E438,30854,0,8,8,109.56889,18.27076,1763
5048,39922,39997DEFFD87AA0C9D18E1194544E438,30891,8,10,2,109.59431,18.28389,1865
5049,39923,39997DEFFD87AA0C9D18E1194544E438,30854,11,16,5,109.56889,18.27076,1763
5050,39924,39997DEFFD87AA0C9D18E1194544E438,30891,16,20,4,109.59431,18.28389,1865
5058,39992,B23FC02C429984B68CAAC5B6CFEA2906,60281,0,16,16,109.51743,18.25924,1561
5059,39993,B23FC02C429984B68CAAC5B6CFEA2906,38316,17,19,2,109.48542,18.27424,1464
5060,39994,B23FC02C429984B68CAAC5B6CFEA2906,38881,20,23,3,109.51618,18.26431,1562
5063,40008,B094ED54FC7E5FCBA88708259A919ECC,31421,0,10,10,109.55382,18.22347,1705
5064,40009,B094ED54FC7E5FCBA88708259A919ECC,38251,15,17,2,109.49618,18.25493,1510
5065,40010,B094ED54FC7E5FCBA88708259A919ECC,31421,18,23,5,109.55382,18.22347,1705
5070,40125,A9FCE0049DB44FE004EAFBF5B783F4A5,31351,0,1,1,109.4959,18.28417,1465
5071,40126,A9FCE0049DB44FE004EAFBF5B783F4A5,31945,2,7,5,109.58021,18.29403,1817
5072,40127,A9FCE0049DB44FE004EAFBF5B783F4A5,30854,8,11,3,109.56889,18.27076,1763
5073,40128,A9FCE0049DB44FE004EAFBF5B783F4A5,31945,12,23,11,109.58021,18.29403,1817
5081,40214,12A0D13AED64522A8A0ABBA021E92F4C,60361,0,10,10,109.51938,18.29681,1567
5082,40215,12A0D13AED64522A8A0ABBA021E92F4C,60501,14,15,1,109.48701,18.29021,1466
5083,40216,12A0D13AED64522A8A0ABBA021E92F4C,60361,20,21,1,109.51938,18.29681,1567
5092,40261,83F8DEFB45E9970F803B6E01CF53475C,31201,0,3,3,109.51042,18.23819,1558
5093,40262,83F8DEFB45E9970F803B6E01CF53475C,31021,3,11,8,109.49021,18.27,1463
5094,40263,83F8DEFB45E9970F803B6E01CF53475C,31206,12,15,3,109.50819,18.23549,1507
5095,40264,83F8DEFB45E9970F803B6E01CF53475C,31021,17,22,5,109.49021,18.27,1463
5096,40296,A0C1D054F6EAC4F4EEE507DF1D074BC1,30854,0,17,17,109.56889,18.27076,1763
5097,40297,A0C1D054F6EAC4F4EEE507DF1D074BC1,30421,18,19,1,109.50021,18.25861,1511
5098,40298,A0C1D054F6EAC4F4EEE507DF1D074BC1,30854,20,23,3,109.56889,18.27076,1763
5099,40303,A94F66C88B84FF0658441320CD9F667C,30854,0,5,5,109.56889,18.27076,1763
5100,40304,A94F66C88B84FF0658441320CD9F667C,31071,9,11,2,109.58257,18.28458,1815
5101,40305,A94F66C88B84FF0658441320CD9F667C,30854,12,13,1,109.56889,18.27076,1763
5102,40318,BE586ACB441383CC10D7CF3923850B73,60371,0,4,4,109.53063,18.30056,1618
5103,40319,BE586ACB441383CC10D7CF3923850B73,39183,8,9,1,109.55542,18.28208,1715
5104,40320,BE586ACB441383CC10D7CF3923850B73,31931,13,19,6,109.54771,18.29403,1667
5121,40373,833001CDF394BB3F6E4F040C2A70AC27,30854,0,7,7,109.56889,18.27076,1763
5122,40374,833001CDF394BB3F6E4F040C2A70AC27,31071,8,12,4,109.58257,18.28458,1815
5123,40375,833001CDF394BB3F6E4F040C2A70AC27,30854,12,13,1,109.56889,18.27076,1763
5124,40376,833001CDF394BB3F6E4F040C2A70AC27,31071,14,19,5,109.58257,18.28458,1815
5166,40565,335A7B1DE8538918FDA774EE3E402A76,30191,0,7,7,109.50361,18.22701,1506
5167,40566,335A7B1DE8538918FDA774EE3E402A76,60381,9,12,3,109.5241,18.22458,1605
5168,40567,335A7B1DE8538918FDA774EE3E402A76,30191,13,23,10,109.50361,18.22701,1506
5175,40683,A14C813C3E3A7182759DA822342505B5,39183,0,16,16,109.55542,18.28208,1715
5176,40684,A14C813C3E3A7182759DA822342505B5,39181,17,18,1,109.55153,18.28035,1715
5177,40685,A14C813C3E3A7182759DA822342505B5,39183,19,21,2,109.55542,18.28208,1715
5182,40698,409F5E8F01172D32BBE91132149C037E,38371,0,13,13,109.50972,18.23924,1558
5183,40699,409F5E8F01172D32BBE91132149C037E,30421,15,17,2,109.50021,18.25861,1511
5184,40700,409F5E8F01172D32BBE91132149C037E,38371,19,23,4,109.50972,18.23924,1558
5208,40898,6E2021B014C4D0B652A2E4FE8D2CF038,31071,0,14,14,109.58257,18.28458,1815
5209,40899,6E2021B014C4D0B652A2E4FE8D2CF038,30854,14,16,2,109.56889,18.27076,1763
5210,40900,6E2021B014C4D0B652A2E4FE8D2CF038,31071,20,22,2,109.58257,18.28458,1815
5212,40971,DBB710D279E76C79F1E4B0766F579F8A,31071,0,7,7,109.58257,18.28458,1815
5213,40972,DBB710D279E76C79F1E4B0766F579F8A,30854,8,9,1,109.56889,18.27076,1763
5214,40973,DBB710D279E76C79F1E4B0766F579F8A,31071,10,17,7,109.58257,18.28458,1815
5228,41121,37D38EF0062E64D55C94EB554B76F9EE,31945,0,3,3,109.58021,18.29403,1817
5229,41122,37D38EF0062E64D55C94EB554B76F9EE,31071,3,7,4,109.58257,18.28458,1815
5230,41123,37D38EF0062E64D55C94EB554B76F9EE,31945,8,9,1,109.58021,18.29403,1817
5231,41124,37D38EF0062E64D55C94EB554B76F9EE,30854,10,17,7,109.56889,18.27076,1763
5242,41183,2986E42C864F9C3503A05721F57A75DB,31931,0,12,12,109.54771,18.29403,1667
5243,41184,2986E42C864F9C3503A05721F57A75DB,60171,14,16,2,109.51292,18.30694,1569
5244,41185,2986E42C864F9C3503A05721F57A75DB,31931,17,21,4,109.54771,18.29403,1667
5249,41292,76F6A54588C8DF7DDADFC50CAA11D44C,31561,1,4,3,109.56792,18.28479,1765
5250,41293,76F6A54588C8DF7DDADFC50CAA11D44C,30854,5,6,1,109.56889,18.27076,1763
5251,41294,76F6A54588C8DF7DDADFC50CAA11D44C,31561,7,9,2,109.56792,18.28479,1765
5261,41463,8468419E5C597B7D73CBDE87F8FF8BC8,38171,0,10,10,109.50799,18.28139,1515
5262,41464,8468419E5C597B7D73CBDE87F8FF8BC8,30721,15,17,2,109.51597,18.28257,1565
5263,41465,8468419E5C597B7D73CBDE87F8FF8BC8,38171,20,23,3,109.50799,18.28139,1515
5264,41470,1980C8D409DE9551539224B3D393CDAA,38991,1,3,2,109.52681,18.30368,1618
5265,41471,1980C8D409DE9551539224B3D393CDAA,30071,6,20,14,109.52819,18.30472,1619
5266,41472,1980C8D409DE9551539224B3D393CDAA,31951,22,23,1,109.52174,18.30299,1568
5270,41506,635914FBAF9BDB855B8CB450E2AE782A,30571,0,1,1,109.50243,18.21861,1504
5271,41507,635914FBAF9BDB855B8CB450E2AE782A,30051,3,16,13,109.48917,18.21215,1453
5272,41508,635914FBAF9BDB855B8CB450E2AE782A,30571,16,17,1,109.50243,18.21861,1504
5273,41509,635914FBAF9BDB855B8CB450E2AE782A,30051,18,21,3,109.48917,18.21215,1453
5274,41521,D9AE11CD16B231308C3F0FB3F53BC3E9,31071,1,6,5,109.58257,18.28458,1815
5275,41522,D9AE11CD16B231308C3F0FB3F53BC3E9,30854,6,12,6,109.56889,18.27076,1763
5276,41523,D9AE11CD16B231308C3F0FB3F53BC3E9,31071,14,18,4,109.58257,18.28458,1815
5277,41524,D9AE11CD16B231308C3F0FB3F53BC3E9,30854,18,19,1,109.56889,18.27076,1763
5305,41799,08077B5D5F0A9938A81D328635D03C8B,30854,1,6,5,109.56889,18.27076,1763
5306,41800,08077B5D5F0A9938A81D328635D03C8B,31071,10,11,1,109.58257,18.28458,1815
5307,41801,08077B5D5F0A9938A81D328635D03C8B,30854,13,22,9,109.56889,18.27076,1763
5308,41804,189633BA4D39EBA8A203BC9E364D4B1F,30381,1,8,7,109.52521,18.24507,1609
5309,41805,189633BA4D39EBA8A203BC9E364D4B1F,30051,12,14,2,109.48917,18.21215,1453
5310,41806,189633BA4D39EBA8A203BC9E364D4B1F,38291,14,16,2,109.51618,18.24313,1558
5311,41816,7BBB2DDEDB0AE43F8CE7FBD1FCB52741,31071,1,7,6,109.58257,18.28458,1815
5312,41817,7BBB2DDEDB0AE43F8CE7FBD1FCB52741,30854,7,8,1,109.56889,18.27076,1763
5313,41818,7BBB2DDEDB0AE43F8CE7FBD1FCB52741,31071,9,20,11,109.58257,18.28458,1815
5384,42270,D7691351C1D270A735CC5E329CBD1B0D,38961,0,1,1,109.50847,18.23514,1507
5385,42271,D7691351C1D270A735CC5E329CBD1B0D,38971,2,14,12,109.50743,18.25125,1510
5386,42272,D7691351C1D270A735CC5E329CBD1B0D,60401,19,21,2,109.47444,18.27583,1414
5387,42273,D7691351C1D270A735CC5E329CBD1B0D,60201,21,23,2,109.5041,18.2509,1510
5424,42565,E9E473F09C342630187345312F4A31D8,39181,0,9,9,109.55153,18.28035,1715
5425,42566,E9E473F09C342630187345312F4A31D8,39181,10,18,8,109.55153,18.28035,1715
5426,42567,E9E473F09C342630187345312F4A31D8,60361,19,20,1,109.51938,18.29681,1567
5427,42568,E9E473F09C342630187345312F4A31D8,39181,21,23,2,109.55153,18.28035,1715
5451,42670,56DFEAF03DB999C001DE943D9823E4CB,31531,0,2,2,109.49583,18.25972,1461
5452,42671,56DFEAF03DB999C001DE943D9823E4CB,60401,5,8,3,109.47444,18.27583,1414
5453,42672,56DFEAF03DB999C001DE943D9823E4CB,31531,11,16,5,109.49583,18.25972,1461
5454,42673,56DFEAF03DB999C001DE943D9823E4CB,31031,17,19,2,109.49979,18.25382,1510
5476,42747,8DA877D3A30401F86E81FB7BC1CA2A00,30854,0,7,7,109.56889,18.27076,1763
5477,42748,8DA877D3A30401F86E81FB7BC1CA2A00,60361,12,15,3,109.51938,18.29681,1567
5478,42749,8DA877D3A30401F86E81FB7BC1CA2A00,31071,19,21,2,109.58257,18.28458,1815
5479,42760,2AE38FAF341950B0B91404FFCE5A0F3E,39183,0,6,6,109.55542,18.28208,1715
5480,42761,2AE38FAF341950B0B91404FFCE5A0F3E,30921,7,12,5,109.53903,18.29451,1667
5481,42762,2AE38FAF341950B0B91404FFCE5A0F3E,31931,13,14,1,109.54771,18.29403,1667
5485,42855,14AE6C820CE45F96077630992CABD33D,31551,1,14,13,109.55868,18.24222,1708
5486,42856,14AE6C820CE45F96077630992CABD33D,30851,15,16,1,109.5616,18.27396,1713
5487,42857,14AE6C820CE45F96077630992CABD33D,31551,17,18,1,109.55868,18.24222,1708
5493,42927,3D1C26E17AD3339BBD6A6505EC18047F,31201,0,9,9,109.51042,18.23819,1558
5494,42928,3D1C26E17AD3339BBD6A6505EC18047F,38291,10,13,3,109.51618,18.24313,1558
5495,42929,3D1C26E17AD3339BBD6A6505EC18047F,31201,13,17,4,109.51042,18.23819,1558
5496,42930,3D1C26E17AD3339BBD6A6505EC18047F,60311,19,21,2,109.52097,18.24319,1558
5499,42969,8CD15CF6B5FB4821940FF9AFE6D6CB84,39181,0,6,6,109.55153,18.28035,1715
5500,42970,8CD15CF6B5FB4821940FF9AFE6D6CB84,31931,7,10,3,109.54771,18.29403,1667
5501,42971,8CD15CF6B5FB4821940FF9AFE6D6CB84,39181,10,21,11,109.55153,18.28035,1715
5502,42974,E0A24740E2C54F3B77DB561A91D2BED7,31821,3,4,1,109.51181,18.24924,1559
5503,42975,E0A24740E2C54F3B77DB561A91D2BED7,30251,8,17,9,109.50611,18.26653,1512
5504,42976,E0A24740E2C54F3B77DB561A91D2BED7,30711,18,20,2,109.50271,18.25347,1510
5505,42977,E0A24740E2C54F3B77DB561A91D2BED7,30151,21,22,1,109.50986,18.25083,1560
5533,43220,622234A65D292D040A9E438A2770674C,30851,0,7,7,109.5616,18.27396,1713
5534,43221,622234A65D292D040A9E438A2770674C,31561,10,11,1,109.56792,18.28479,1765
5535,43222,622234A65D292D040A9E438A2770674C,30851,12,23,11,109.5616,18.27396,1713
5556,43566,3340DD955EDB97C88115D8B367138332,60391,0,11,11,109.47667,18.28757,1416
5557,43567,3340DD955EDB97C88115D8B367138332,60391,13,16,3,109.47667,18.28757,1416
5558,43568,3340DD955EDB97C88115D8B367138332,48645,20,22,2,109.48597,18.29299,1467
5559,43629,08DA3CFA22819D4D1B43402F03528A0D,31521,0,1,1,109.51458,18.22542,1555
5560,43630,08DA3CFA22819D4D1B43402F03528A0D,30861,2,13,11,109.52722,18.22743,1606
5561,43631,08DA3CFA22819D4D1B43402F03528A0D,39111,14,16,2,109.5191,18.22597,1555
5608,43858,599AFAF71D30C85AA4E0085C43FF5E03,30051,2,9,7,109.48917,18.21215,1453
5609,43859,599AFAF71D30C85AA4E0085C43FF5E03,60235,11,12,1,109.49269,18.2253,1455
5610,43860,599AFAF71D30C85AA4E0085C43FF5E03,31421,16,17,1,109.55382,18.22347,1705
5620,43906,7BF65E5054DA81A230AB5423620158E1,60631,0,7,7,109.57778,18.27583,1814
5621,43907,7BF65E5054DA81A230AB5423620158E1,30854,9,12,3,109.56889,18.27076,1763
5622,43908,7BF65E5054DA81A230AB5423620158E1,31071,17,18,1,109.58257,18.28458,1815
5623,43909,7BF65E5054DA81A230AB5423620158E1,30854,20,22,2,109.56889,18.27076,1763
5626,43923,FCF69C4EB20A61D7801C0D8953A36537,31071,0,13,13,109.58257,18.28458,1815
5627,43924,FCF69C4EB20A61D7801C0D8953A36537,30851,15,16,1,109.5616,18.27396,1713
5628,43925,FCF69C4EB20A61D7801C0D8953A36537,31071,19,23,4,109.58257,18.28458,1815
5638,43976,4CB912B6F8396332BBD4A470BCE42007,60221,0,6,6,109.52569,18.29188,1616
5639,43977,4CB912B6F8396332BBD4A470BCE42007,30421,6,10,4,109.50021,18.25861,1511
5640,43978,4CB912B6F8396332BBD4A470BCE42007,60221,11,20,9,109.52569,18.29188,1616
5641,43979,4CB912B6F8396332BBD4A470BCE42007,31534,21,23,2,109.49368,18.25806,1461
5667,44104,A46BA306DAEA889FAC7ACE9E5FD6A1FF,60331,0,1,1,109.505,18.26507,1512
5668,44105,A46BA306DAEA889FAC7ACE9E5FD6A1FF,30081,3,10,7,109.50243,18.26632,1512
5669,44106,A46BA306DAEA889FAC7ACE9E5FD6A1FF,30911,11,23,12,109.50493,18.26181,1511
5683,44169,14F21534C21254001A38352AD4BB0EF6,31071,0,7,7,109.58257,18.28458,1815
5684,44170,14F21534C21254001A38352AD4BB0EF6,30854,8,12,4,109.56889,18.27076,1763
5685,44171,14F21534C21254001A38352AD4BB0EF6,31071,13,16,3,109.58257,18.28458,1815
5691,44228,3FAC9FAFB3ECDCE59F92B59DE0495304,60291,0,9,9,109.50826,18.24639,1509
5692,44229,3FAC9FAFB3ECDCE59F92B59DE0495304,60131,13,14,1,109.49819,18.24778,1509
5693,44230,3FAC9FAFB3ECDCE59F92B59DE0495304,39111,15,17,2,109.5191,18.22597,1555
5694,44231,3FAC9FAFB3ECDCE59F92B59DE0495304,31521,20,21,1,109.51458,18.22542,1555
5698,44264,8F6EA1C108FADA76A214A7ED71ECE3D1,30891,0,2,2,109.59431,18.28389,1865
5699,44265,8F6EA1C108FADA76A214A7ED71ECE3D1,39183,5,6,1,109.55542,18.28208,1715
5700,44266,8F6EA1C108FADA76A214A7ED71ECE3D1,30854,9,17,8,109.56889,18.27076,1763
5701,44275,20C15B76A1E0DF79D86EDEAC7BC3D7B7,31071,1,7,6,109.58257,18.28458,1815
5702,44276,20C15B76A1E0DF79D86EDEAC7BC3D7B7,31945,8,13,5,109.58021,18.29403,1817
5703,44277,20C15B76A1E0DF79D86EDEAC7BC3D7B7,30854,18,21,3,109.56889,18.27076,1763
5704,44278,20C15B76A1E0DF79D86EDEAC7BC3D7B7,30441,21,22,1,109.64021,18.25424,2010
5710,44360,F199F86E80566351E28B88A26F39C674,31351,0,7,7,109.4959,18.28417,1465
5711,44361,F199F86E80566351E28B88A26F39C674,30281,8,9,1,109.50597,18.27583,1514
5712,44362,F199F86E80566351E28B88A26F39C674,38261,10,11,1,109.50361,18.28153,1515
5713,44378,CFFDD1BF3134B9FDD71614F40E1DE0FD,30854,3,5,2,109.56889,18.27076,1763
5714,44379,CFFDD1BF3134B9FDD71614F40E1DE0FD,31071,6,14,8,109.58257,18.28458,1815
5715,44380,CFFDD1BF3134B9FDD71614F40E1DE0FD,39091,16,18,2,109.50097,18.25222,1510
5733,44485,FE95B3A32EFBC2838F293DF38F55FDD1,31931,0,1,1,109.54771,18.29403,1667
5734,44486,FE95B3A32EFBC2838F293DF38F55FDD1,39183,6,11,5,109.55542,18.28208,1715
5735,44487,FE95B3A32EFBC2838F293DF38F55FDD1,31931,14,16,2,109.54771,18.29403,1667
5736,44488,FE95B3A32EFBC2838F293DF38F55FDD1,30854,21,23,2,109.56889,18.27076,1763
5739,44505,0C12679B52C25C8A094B9B69D277B0C8,31071,0,6,6,109.58257,18.28458,1815
5740,44506,0C12679B52C25C8A094B9B69D277B0C8,30854,7,8,1,109.56889,18.27076,1763
5741,44507,0C12679B52C25C8A094B9B69D277B0C8,31071,12,23,11,109.58257,18.28458,1815
5742,44544,EC8642AA937DB73541C5437DE9D9374B,31181,0,6,6,109.50382,18.24813,1509
5743,44545,EC8642AA937DB73541C5437DE9D9374B,38017,8,11,3,109.49729,18.21424,1504
5744,44546,EC8642AA937DB73541C5437DE9D9374B,60401,15,19,4,109.47444,18.27583,1414
5745,44547,EC8642AA937DB73541C5437DE9D9374B,31181,20,23,3,109.50382,18.24813,1509
5752,44570,E8BAAF476E8FE57075BAB1A8D4FF1780,30891,3,5,2,109.59431,18.28389,1865
5753,44571,E8BAAF476E8FE57075BAB1A8D4FF1780,30854,7,8,1,109.56889,18.27076,1763
5754,44572,E8BAAF476E8FE57075BAB1A8D4FF1780,30232,11,23,12,109.6191,18.31701,1971
5793,44950,7F632B4875B2736225CD6D350CD25670,31071,1,7,6,109.58257,18.28458,1815
5794,44951,7F632B4875B2736225CD6D350CD25670,30854,9,11,2,109.56889,18.27076,1763
5795,44952,7F632B4875B2736225CD6D350CD25670,31071,12,13,1,109.58257,18.28458,1815
5796,44953,7F632B4875B2736225CD6D350CD25670,30854,14,21,7,109.56889,18.27076,1763
5800,44991,1B6EBBFF3B9D8A3E18753343B6A29EAE,31071,0,7,7,109.58257,18.28458,1815
5801,44992,1B6EBBFF3B9D8A3E18753343B6A29EAE,31561,7,9,2,109.56792,18.28479,1765
5802,44993,1B6EBBFF3B9D8A3E18753343B6A29EAE,31071,12,23,11,109.58257,18.28458,1815
5814,45099,68DBE0B52FD0AB95F1DD47068FD7847F,60311,0,7,7,109.52097,18.24319,1558
5815,45100,68DBE0B52FD0AB95F1DD47068FD7847F,30181,7,19,12,109.51597,18.23313,1557
5816,45101,68DBE0B52FD0AB95F1DD47068FD7847F,60311,19,23,4,109.52097,18.24319,1558
5817,45132,D88AE248BE01D22E4DE2A4B556E71166,38951,0,8,8,109.48097,18.28868,1416
5818,45133,D88AE248BE01D22E4DE2A4B556E71166,30971,9,12,3,109.48708,18.29319,1467
5819,45134,D88AE248BE01D22E4DE2A4B556E71166,38951,12,17,5,109.48097,18.28868,1416
5840,45371,222E0B6922623CE9FBB280F81068D40E,31061,0,7,7,109.53333,18.23257,1607
5841,45372,222E0B6922623CE9FBB280F81068D40E,30851,9,11,2,109.5616,18.27396,1713
5842,45373,222E0B6922623CE9FBB280F81068D40E,39321,12,17,5,109.529,18.2167,1604
5843,45374,222E0B6922623CE9FBB280F81068D40E,31061,17,19,2,109.53333,18.23257,1607
5844,45375,AD2FF3511C546F92347A76D5BDCE6CA1,30571,0,7,7,109.50243,18.21861,1504
5845,45376,AD2FF3511C546F92347A76D5BDCE6CA1,38347,7,8,1,109.4934,18.21444,1454
5846,45377,AD2FF3511C546F92347A76D5BDCE6CA1,38017,10,12,2,109.49729,18.21424,1504
5847,45378,AD2FF3511C546F92347A76D5BDCE6CA1,30571,12,17,5,109.50243,18.21861,1504
5852,45493,9BD095517798346F169AD6D898CA1A42,60361,0,6,6,109.51938,18.29681,1567
5853,45494,9BD095517798346F169AD6D898CA1A42,60221,8,16,8,109.52569,18.29188,1616
5854,45495,9BD095517798346F169AD6D898CA1A42,60361,21,23,2,109.51938,18.29681,1567
5857,45508,3720DDB8E91BF73FF05637BA50F0661B,31521,0,11,11,109.51458,18.22542,1555
5858,45509,3720DDB8E91BF73FF05637BA50F0661B,30361,12,13,1,109.50347,18.24,1508
5859,45510,3720DDB8E91BF73FF05637BA50F0661B,31521,14,23,9,109.51458,18.22542,1555
5864,45553,080247CC19405F981D4BEFE1A1E9D339,31931,0,1,1,109.54771,18.29403,1667
5865,45554,080247CC19405F981D4BEFE1A1E9D339,39181,1,10,9,109.55153,18.28035,1715
5866,45555,080247CC19405F981D4BEFE1A1E9D339,31931,11,12,1,109.54771,18.29403,1667
5867,45556,080247CC19405F981D4BEFE1A1E9D339,39181,15,17,2,109.55153,18.28035,1715
5874,45611,E904D23B3C819F061EFB1AF0F13A2364,38951,0,8,8,109.48097,18.28868,1416
5875,45612,E904D23B3C819F061EFB1AF0F13A2364,30971,9,12,3,109.48708,18.29319,1467
5876,45613,E904D23B3C819F061EFB1AF0F13A2364,38951,12,23,11,109.48097,18.28868,1416
5914,45923,875F4B80762D0E664890361D764F907D,60081,0,7,7,109.51097,18.22639,1556
5915,45924,875F4B80762D0E664890361D764F907D,30571,7,11,4,109.50243,18.21861,1504
5916,45925,875F4B80762D0E664890361D764F907D,60231,11,18,7,109.49903,18.21972,1504
5917,45926,875F4B80762D0E664890361D764F907D,60081,19,22,3,109.51097,18.22639,1556
5928,46013,0F924F37F5D3D17A952F4CCE171DD879,31561,0,3,3,109.56792,18.28479,1765
5929,46014,0F924F37F5D3D17A952F4CCE171DD879,39183,6,7,1,109.55542,18.28208,1715
5930,46015,0F924F37F5D3D17A952F4CCE171DD879,30854,7,10,3,109.56889,18.27076,1763
5931,46016,0F924F37F5D3D17A952F4CCE171DD879,39183,14,22,8,109.55542,18.28208,1715
5951,46178,B80D6AB96D3D5CEE71A70ED25275F830,38951,0,9,9,109.48097,18.28868,1416
5952,46179,B80D6AB96D3D5CEE71A70ED25275F830,38951,11,12,1,109.48097,18.28868,1416
5953,46180,B80D6AB96D3D5CEE71A70ED25275F830,31531,14,17,3,109.49583,18.25972,1461
5954,46181,B80D6AB96D3D5CEE71A70ED25275F830,38951,19,23,4,109.48097,18.28868,1416
5967,46297,36BCA39777B9D1E703C1404CDA6A45E7,30511,0,9,9,109.51069,18.24208,1558
5968,46299,36BCA39777B9D1E703C1404CDA6A45E7,60221,16,18,2,109.52569,18.29188,1616
5969,46300,36BCA39777B9D1E703C1404CDA6A45E7,31031,19,20,1,109.49979,18.25382,1510
5970,46301,36BCA39777B9D1E703C1404CDA6A45E7,60291,22,23,1,109.50826,18.24639,1509
5982,46447,8621CFDF1B89A83351494618C53D033F,31071,2,4,2,109.58257,18.28458,1815
5983,46448,8621CFDF1B89A83351494618C53D033F,39181,4,7,3,109.55153,18.28035,1715
5984,46449,8621CFDF1B89A83351494618C53D033F,31071,7,16,9,109.58257,18.28458,1815
5985,46450,8621CFDF1B89A83351494618C53D033F,39181,18,20,2,109.55153,18.28035,1715
5986,46504,BE7763F8096EB5A037146E1CC4190538,30854,0,15,15,109.56889,18.27076,1763
5987,46505,BE7763F8096EB5A037146E1CC4190538,31561,16,19,3,109.56792,18.28479,1765
5988,46506,BE7763F8096EB5A037146E1CC4190538,30854,20,21,1,109.56889,18.27076,1763
5993,46515,5A1C4533F331B639AE5D3D6E2930E30B,31945,0,2,2,109.58021,18.29403,1817
5994,46516,5A1C4533F331B639AE5D3D6E2930E30B,31071,3,7,4,109.58257,18.28458,1815
5995,46517,5A1C4533F331B639AE5D3D6E2930E30B,30854,7,9,2,109.56889,18.27076,1763
5996,46518,5A1C4533F331B639AE5D3D6E2930E30B,31071,9,11,2,109.58257,18.28458,1815
6008,46639,2191B2AD5C915B8862D4C345F0A13CFB,30851,2,12,10,109.5616,18.27396,1713
6009,46640,2191B2AD5C915B8862D4C345F0A13CFB,60351,13,16,3,109.58403,18.28958,1816
6010,46641,2191B2AD5C915B8862D4C345F0A13CFB,30851,17,19,2,109.5616,18.27396,1713
6011,46642,2191B2AD5C915B8862D4C345F0A13CFB,31071,21,22,1,109.58257,18.28458,1815
6012,46692,EDC17F917D3B692B137ACF040E1D7AE4,30421,0,7,7,109.50021,18.25861,1511
6013,46693,EDC17F917D3B692B137ACF040E1D7AE4,31561,10,11,1,109.56792,18.28479,1765
6014,46694,EDC17F917D3B692B137ACF040E1D7AE4,30421,12,14,2,109.50021,18.25861,1511
6015,46729,B95895328C22197B47AD92C8267A3C6A,30921,3,4,1,109.53903,18.29451,1667
6016,46730,B95895328C22197B47AD92C8267A3C6A,60371,5,6,1,109.53063,18.30056,1618
6017,46731,B95895328C22197B47AD92C8267A3C6A,60171,10,18,8,109.51292,18.30694,1569
6027,46792,41F47B8A3E7EDA8FCE88001CED656BDF,39183,2,3,1,109.55542,18.28208,1715
6028,46793,41F47B8A3E7EDA8FCE88001CED656BDF,30854,7,15,8,109.56889,18.27076,1763
6029,46794,41F47B8A3E7EDA8FCE88001CED656BDF,39183,18,19,1,109.55542,18.28208,1715
6030,46795,41F47B8A3E7EDA8FCE88001CED656BDF,31071,19,21,2,109.58257,18.28458,1815
6033,46812,971FAC974FC919EB70A5D4943C3307C0,60594,0,7,7,109.62694,18.22799,1956
6034,46813,971FAC974FC919EB70A5D4943C3307C0,38052,8,9,1,109.62618,18.23042,1956
6035,46814,971FAC974FC919EB70A5D4943C3307C0,60594,14,19,5,109.62694,18.22799,1956
6036,46823,CD3BCBAB8571FB81953C842A434E5DB8,31071,0,6,6,109.58257,18.28458,1815
6037,46824,CD3BCBAB8571FB81953C842A434E5DB8,30854,6,18,12,109.56889,18.27076,1763
6038,46825,CD3BCBAB8571FB81953C842A434E5DB8,31071,21,23,2,109.58257,18.28458,1815
6039,46923,FB16AA24AD94D8CC7E1110E44BD68910,60631,0,7,7,109.57778,18.27583,1814
6040,46924,FB16AA24AD94D8CC7E1110E44BD68910,30854,8,19,11,109.56889,18.27076,1763
6041,46925,FB16AA24AD94D8CC7E1110E44BD68910,31945,21,23,2,109.58021,18.29403,1817
6044,46989,2DDF3A993BD69F79020EB97CF3A71819,38261,0,7,7,109.50361,18.28153,1515
6045,46990,2DDF3A993BD69F79020EB97CF3A71819,30161,11,21,10,109.50042,18.24389,1508
6046,46991,2DDF3A993BD69F79020EB97CF3A71819,38171,22,23,1,109.50799,18.28139,1515
6051,47013,D00EAD9144E7A4027F84D32EB5112DB4,30921,0,1,1,109.53903,18.29451,1667
6052,47014,D00EAD9144E7A4027F84D32EB5112DB4,31931,1,2,1,109.54771,18.29403,1667
6053,47015,D00EAD9144E7A4027F84D32EB5112DB4,30921,3,5,2,109.53903,18.29451,1667
6054,47016,D00EAD9144E7A4027F84D32EB5112DB4,31931,7,20,13,109.54771,18.29403,1667
6073,47096,AE6DC7ACB81DB5F351E45AC25E5F5A3B,38297,0,13,13,109.52576,18.24965,1609
6074,47097,AE6DC7ACB81DB5F351E45AC25E5F5A3B,31031,14,16,2,109.49979,18.25382,1510
6075,47098,AE6DC7ACB81DB5F351E45AC25E5F5A3B,30381,20,23,3,109.52521,18.24507,1609
6078,47113,ADAB51A6D99BADC8222FC392D72ADA01,60281,0,6,6,109.51743,18.25924,1561
6079,47114,ADAB51A6D99BADC8222FC392D72ADA01,30251,7,8,1,109.50611,18.26653,1512
6080,47115,ADAB51A6D99BADC8222FC392D72ADA01,60281,8,23,15,109.51743,18.25924,1561
6081,47139,0547C7536E43628EF24935F0C2BF5E2C,30921,0,5,5,109.53903,18.29451,1667
6082,47140,0547C7536E43628EF24935F0C2BF5E2C,31931,6,16,10,109.54771,18.29403,1667
6083,47141,0547C7536E43628EF24935F0C2BF5E2C,30921,16,17,1,109.53903,18.29451,1667
6084,47142,0547C7536E43628EF24935F0C2BF5E2C,60241,21,22,1,109.53319,18.28667,1616
6090,47174,5EBEA276FCB4A19AC5C987F5C7CC8908,60504,1,2,1,109.47917,18.28903,1416
6091,47175,5EBEA276FCB4A19AC5C987F5C7CC8908,60011,3,6,3,109.48965,18.30222,1468
6092,47176,5EBEA276FCB4A19AC5C987F5C7CC8908,38361,10,14,4,109.43667,18.29201,1267
6093,47177,5EBEA276FCB4A19AC5C987F5C7CC8908,60504,14,17,3,109.47917,18.28903,1416
6099,47222,CB44FE843228066922623C4A2B161A4C,60504,0,10,10,109.47917,18.28903,1416
6100,47223,CB44FE843228066922623C4A2B161A4C,30081,12,16,4,109.50243,18.26632,1512
6101,47224,CB44FE843228066922623C4A2B161A4C,60504,21,23,2,109.47917,18.28903,1416
6123,47388,C8135D3E403B7CC96352A41CBCD291A7,38241,0,7,7,109.54111,18.30542,1669
6124,47389,C8135D3E403B7CC96352A41CBCD291A7,31931,11,15,4,109.54771,18.29403,1667
6125,47390,C8135D3E403B7CC96352A41CBCD291A7,38241,16,18,2,109.54111,18.30542,1669
6126,47391,C8135D3E403B7CC96352A41CBCD291A7,30921,20,23,3,109.53903,18.29451,1667
6127,47423,E0223036572082E83876AFB7D72B2DD2,30921,0,1,1,109.53903,18.29451,1667
6128,47424,E0223036572082E83876AFB7D72B2DD2,31931,4,5,1,109.54771,18.29403,1667
6129,47425,E0223036572082E83876AFB7D72B2DD2,30921,6,7,1,109.53903,18.29451,1667
6130,47435,BCF86295AA2D4858A2FA047D814B97DE,39183,3,7,4,109.55542,18.28208,1715
6131,47436,BCF86295AA2D4858A2FA047D814B97DE,31071,11,17,6,109.58257,18.28458,1815
6132,47437,BCF86295AA2D4858A2FA047D814B97DE,30854,18,23,5,109.56889,18.27076,1763
6141,47560,0C8D15C0488D521680F0DE3A28CFE111,31811,0,6,6,109.54201,18.31806,1671
6142,47561,0C8D15C0488D521680F0DE3A28CFE111,30701,6,21,15,109.59313,18.32007,1871
6143,47562,0C8D15C0488D521680F0DE3A28CFE111,31811,22,23,1,109.54201,18.31806,1671
6144,47585,B91A19B1FD9FC6BA8C6D18C2634BCD94,38052,0,19,19,109.62618,18.23042,1956
6145,47586,B91A19B1FD9FC6BA8C6D18C2634BCD94,30581,19,21,2,109.62257,18.24951,1959
6146,47587,B91A19B1FD9FC6BA8C6D18C2634BCD94,60594,21,23,2,109.62694,18.22799,1956
6147,47597,CA3896FB33E9BC68E91955EDFF5D709B,60631,1,7,6,109.57778,18.27583,1814
6148,47598,CA3896FB33E9BC68E91955EDFF5D709B,31945,9,10,1,109.58021,18.29403,1817
6149,47599,CA3896FB33E9BC68E91955EDFF5D709B,30854,10,13,3,109.56889,18.27076,1763
6150,47612,64F4CDF664AA04E7B79DE93C57128CF6,31931,0,7,7,109.54771,18.29403,1667
6151,47613,64F4CDF664AA04E7B79DE93C57128CF6,39181,9,17,8,109.55153,18.28035,1715
6152,47614,64F4CDF664AA04E7B79DE93C57128CF6,31931,22,23,1,109.54771,18.29403,1667
6168,47773,73D13478BB2B18F309F322A91E52830F,31081,0,7,7,109.44639,18.30181,1318
6169,47774,73D13478BB2B18F309F322A91E52830F,31471,12,14,2,109.34583,18.29563,917
6170,47775,73D13478BB2B18F309F322A91E52830F,60551,19,20,1,109.42722,18.30111,1218
6183,47940,676BED5E3C1811E8B533688BEDCC91B7,31021,0,8,8,109.49021,18.27,1463
6184,47941,676BED5E3C1811E8B533688BEDCC91B7,60441,11,15,4,109.46792,18.28604,1366
6185,47942,676BED5E3C1811E8B533688BEDCC91B7,31021,16,18,2,109.49021,18.27,1463
6219,48276,0133DDFFB5CECBB261CEDEF10A82D50B,30854,1,8,7,109.56889,18.27076,1763
6220,48277,0133DDFFB5CECBB261CEDEF10A82D50B,31561,10,12,2,109.56792,18.28479,1765
6221,48278,0133DDFFB5CECBB261CEDEF10A82D50B,31071,12,13,1,109.58257,18.28458,1815
6222,48279,0133DDFFB5CECBB261CEDEF10A82D50B,31561,15,16,1,109.56792,18.28479,1765
6223,48282,24892DF473AC6ED4692FBD552CF21D37,60381,2,10,8,109.5241,18.22458,1605
6224,48283,24892DF473AC6ED4692FBD552CF21D37,39321,10,13,3,109.529,18.2167,1604
6225,48284,24892DF473AC6ED4692FBD552CF21D37,60381,13,23,10,109.5241,18.22458,1605
6236,48344,E3AA3CC18802E5190B3AA5A477107D6A,31071,1,7,6,109.58257,18.28458,1815
6237,48345,E3AA3CC18802E5190B3AA5A477107D6A,30854,7,11,4,109.56889,18.27076,1763
6238,48346,E3AA3CC18802E5190B3AA5A477107D6A,31071,13,23,10,109.58257,18.28458,1815
6241,48359,0E129C09250C0D46273B4BD7E5225556,30151,0,5,5,109.50986,18.25083,1560
6242,48360,0E129C09250C0D46273B4BD7E5225556,60201,6,8,2,109.5041,18.2509,1510
6243,48361,0E129C09250C0D46273B4BD7E5225556,38251,10,11,1,109.49618,18.25493,1510
6250,48467,173CD7A2B7B334BC53A50A1D248FBCFE,31071,3,4,1,109.58257,18.28458,1815
6251,48468,173CD7A2B7B334BC53A50A1D248FBCFE,30854,7,17,10,109.56889,18.27076,1763
6252,48469,173CD7A2B7B334BC53A50A1D248FBCFE,31071,20,21,1,109.58257,18.28458,1815
6253,48475,451E2BF48CD7B253EB0892324E679BCC,38297,0,7,7,109.52576,18.24965,1609
6254,48476,451E2BF48CD7B253EB0892324E679BCC,60281,7,17,10,109.51743,18.25924,1561
6255,48477,451E2BF48CD7B253EB0892324E679BCC,31461,17,18,1,109.5091,18.25389,1510
6256,48478,451E2BF48CD7B253EB0892324E679BCC,38291,18,21,3,109.51618,18.24313,1558
6266,48596,DDE77D3A656666992FC3458B84010D43,39183,0,6,6,109.55542,18.28208,1715
6267,48597,DDE77D3A656666992FC3458B84010D43,31561,6,7,1,109.56792,18.28479,1765
6268,48598,DDE77D3A656666992FC3458B84010D43,39183,11,20,9,109.55542,18.28208,1715
6269,48645,38A8595594DC26AD8BE733FC85DB4CA6,31631,0,16,16,109.59542,18.36826,1879
6270,48646,38A8595594DC26AD8BE733FC85DB4CA6,30101,16,18,2,109.57299,18.33333,1773
6271,48647,38A8595594DC26AD8BE733FC85DB4CA6,31631,21,23,2,109.59542,18.36826,1879
6289,48733,283001ED673D8EDBEF7EEB00BDB31533,30571,0,6,6,109.50243,18.21861,1504
6290,48734,283001ED673D8EDBEF7EEB00BDB31533,31181,6,18,12,109.50382,18.24813,1509
6291,48735,283001ED673D8EDBEF7EEB00BDB31533,30571,19,22,3,109.50243,18.21861,1504
6313,48872,D39D64452E6BBEF7B3056CA239E1B86E,30854,0,14,14,109.56889,18.27076,1763
6314,48873,D39D64452E6BBEF7B3056CA239E1B86E,31561,14,15,1,109.56792,18.28479,1765
6315,48874,D39D64452E6BBEF7B3056CA239E1B86E,30854,17,23,6,109.56889,18.27076,1763
6316,48902,A3E72DA264E597E8FEA49E7837CC250A,31521,0,9,9,109.51458,18.22542,1555
6317,48903,A3E72DA264E597E8FEA49E7837CC250A,31521,14,19,5,109.51458,18.22542,1555
6318,48904,A3E72DA264E597E8FEA49E7837CC250A,30361,21,22,1,109.50347,18.24,1508
6325,49020,5EB757C8918F704B5295B0BDE01D6841,31351,0,3,3,109.4959,18.28417,1465
6326,49021,5EB757C8918F704B5295B0BDE01D6841,31701,4,8,4,109.44132,18.28833,1266
6327,49022,5EB757C8918F704B5295B0BDE01D6841,38162,9,10,1,109.43944,18.28889,1266
6331,49097,0D61EA75C03A93303AE1706E6D1B22F4,30201,0,8,8,109.4909,18.26465,1462
6332,49098,0D61EA75C03A93303AE1706E6D1B22F4,60281,9,11,2,109.51743,18.25924,1561
6333,49099,0D61EA75C03A93303AE1706E6D1B22F4,30201,11,13,2,109.4909,18.26465,1462
6334,49100,0D61EA75C03A93303AE1706E6D1B22F4,60311,16,21,5,109.52097,18.24319,1558
6338,49144,63FBAC0202144B00077561285E6A7F87,30821,0,13,13,109.43681,18.33639,1274
6339,49145,63FBAC0202144B00077561285E6A7F87,30651,14,15,1,109.42611,18.385,1232
6340,49146,63FBAC0202144B00077561285E6A7F87,30821,15,23,8,109.43681,18.33639,1274
6341,49173,070984703178D21DC5287E457C03691A,39181,0,5,5,109.55153,18.28035,1715
6342,49174,070984703178D21DC5287E457C03691A,31931,7,9,2,109.54771,18.29403,1667
6343,49175,070984703178D21DC5287E457C03691A,39181,9,12,3,109.55153,18.28035,1715
6344,49192,87ADC98470D754E65D1F229228B379D5,30851,0,6,6,109.5616,18.27396,1713
6345,49193,87ADC98470D754E65D1F229228B379D5,30201,7,9,2,109.4909,18.26465,1462
6346,49194,87ADC98470D754E65D1F229228B379D5,30851,12,23,11,109.5616,18.27396,1713
6352,49389,B47BACC30D9A35D35F1E9FB0E5DF7D48,31071,2,6,4,109.58257,18.28458,1815
6353,49390,B47BACC30D9A35D35F1E9FB0E5DF7D48,30854,11,12,1,109.56889,18.27076,1763
6354,49391,B47BACC30D9A35D35F1E9FB0E5DF7D48,31071,14,19,5,109.58257,18.28458,1815
6355,49392,B47BACC30D9A35D35F1E9FB0E5DF7D48,30854,22,23,1,109.56889,18.27076,1763
6356,49429,64EA917EAAD3EB55DA2ABB227203C131,60631,0,6,6,109.57778,18.27583,1814
6357,49430,64EA917EAAD3EB55DA2ABB227203C131,30851,9,10,1,109.5616,18.27396,1713
6358,49431,64EA917EAAD3EB55DA2ABB227203C131,31071,13,17,4,109.58257,18.28458,1815
6361,49454,60085C98EDC64770922E20845B09F807,31931,0,17,17,109.54771,18.29403,1667
6362,49455,60085C98EDC64770922E20845B09F807,39181,17,19,2,109.55153,18.28035,1715
6363,49456,60085C98EDC64770922E20845B09F807,31931,19,23,4,109.54771,18.29403,1667
6378,49526,31BAA46A2F25AC63D78E0ACA44BF0FE9,39181,0,7,7,109.55153,18.28035,1715
6379,49527,31BAA46A2F25AC63D78E0ACA44BF0FE9,31931,8,15,7,109.54771,18.29403,1667
6380,49528,31BAA46A2F25AC63D78E0ACA44BF0FE9,39181,15,23,8,109.55153,18.28035,1715
6388,49676,CC4662D0AB761935A19DD4261E4FE213,31561,0,6,6,109.56792,18.28479,1765
6389,49677,CC4662D0AB761935A19DD4261E4FE213,30851,9,10,1,109.5616,18.27396,1713
6390,49678,CC4662D0AB761935A19DD4261E4FE213,31561,15,23,8,109.56792,18.28479,1765
6399,49726,7168F7EAD82B76A2A520C85DAB769D72,39183,1,9,8,109.55542,18.28208,1715
6400,49727,7168F7EAD82B76A2A520C85DAB769D72,31561,14,16,2,109.56792,18.28479,1765
6401,49728,7168F7EAD82B76A2A520C85DAB769D72,30854,18,20,2,109.56889,18.27076,1763
6403,49761,9AA539837E311390E257930DE90B7B56,38391,0,1,1,109.44111,18.29083,1266
6404,49762,9AA539837E311390E257930DE90B7B56,31701,2,8,6,109.44132,18.28833,1266
6405,49763,9AA539837E311390E257930DE90B7B56,38315,12,14,2,109.48979,18.29764,1467
6429,49924,EF189AF224755104A3EF0837AE0BC2BB,30711,0,1,1,109.50271,18.25347,1510
6430,49925,EF189AF224755104A3EF0837AE0BC2BB,60281,2,14,12,109.51743,18.25924,1561
6431,49926,EF189AF224755104A3EF0837AE0BC2BB,31461,17,18,1,109.5091,18.25389,1510
6432,49934,B2B62201EF4A108EDC8EB73A48BE86EA,30111,0,1,1,109.47583,18.30542,1419
6433,49935,B2B62201EF4A108EDC8EB73A48BE86EA,38871,2,9,7,109.44681,18.28625,1316
6434,49936,B2B62201EF4A108EDC8EB73A48BE86EA,31431,10,12,2,109.44639,18.29042,1316
6435,49937,B2B62201EF4A108EDC8EB73A48BE86EA,31431,13,17,4,109.44639,18.29042,1316
6459,50083,B61666307486DD531F980787F0F8A7B7,60631,2,3,1,109.57778,18.27583,1814
6460,50084,B61666307486DD531F980787F0F8A7B7,30854,4,5,1,109.56889,18.27076,1763
6461,50085,B61666307486DD531F980787F0F8A7B7,60631,5,17,12,109.57778,18.27583,1814
6462,50086,B61666307486DD531F980787F0F8A7B7,30854,17,19,2,109.56889,18.27076,1763
6480,50202,820C7A160D6A8FFF0CCE914B15E69B50,30721,0,8,8,109.51597,18.28257,1565
6481,50203,820C7A160D6A8FFF0CCE914B15E69B50,39154,9,12,3,109.50201,18.25681,1511
6482,50204,820C7A160D6A8FFF0CCE914B15E69B50,30721,13,23,10,109.51597,18.28257,1565
6490,50247,C48911F2501F3C5309DA39E0641B7D38,31071,1,3,2,109.58257,18.28458,1815
6491,50248,C48911F2501F3C5309DA39E0641B7D38,30854,7,9,2,109.56889,18.27076,1763
6492,50249,C48911F2501F3C5309DA39E0641B7D38,31071,9,19,10,109.58257,18.28458,1815
6493,50250,C48911F2501F3C5309DA39E0641B7D38,30854,19,22,3,109.56889,18.27076,1763
6494,50264,96994AD87756271E307B81F41E5136D2,30854,0,10,10,109.56889,18.27076,1763
6495,50265,96994AD87756271E307B81F41E5136D2,31031,15,20,5,109.49979,18.25382,1510
6496,50266,96994AD87756271E307B81F41E5136D2,39151,22,23,1,109.49875,18.25097,1510
6500,50319,7421066246AAD1C230E7E2A7ADF06E9D,60631,5,7,2,109.57778,18.27583,1814
6501,50320,7421066246AAD1C230E7E2A7ADF06E9D,30854,7,18,11,109.56889,18.27076,1763
6502,50321,7421066246AAD1C230E7E2A7ADF06E9D,30421,19,21,2,109.50021,18.25861,1511
6503,50345,A01B4012B619D942E7CC3AC9B78722B4,31561,0,1,1,109.56792,18.28479,1765
6504,50346,A01B4012B619D942E7CC3AC9B78722B4,30851,2,7,5,109.5616,18.27396,1713
6505,50347,A01B4012B619D942E7CC3AC9B78722B4,31561,11,22,11,109.56792,18.28479,1765
6508,50374,417408FFDA93B177641D270D3A5C4B2D,30891,0,4,4,109.59431,18.28389,1865
6509,50375,417408FFDA93B177641D270D3A5C4B2D,60631,8,17,9,109.57778,18.27583,1814
6510,50376,417408FFDA93B177641D270D3A5C4B2D,31071,20,23,3,109.58257,18.28458,1815
6513,50401,B66AAE657FB7958F5827047B5F8024B6,60631,2,6,4,109.57778,18.27583,1814
6514,50402,B66AAE657FB7958F5827047B5F8024B6,31561,11,12,1,109.56792,18.28479,1765
6515,50403,B66AAE657FB7958F5827047B5F8024B6,30851,13,14,1,109.5616,18.27396,1713
6516,50404,B66AAE657FB7958F5827047B5F8024B6,30854,18,20,2,109.56889,18.27076,1763
6517,50412,2A3E5205AC8230AFA039AD71C1DA60B8,38185,1,2,1,109.51333,18.27347,1563
6518,50413,2A3E5205AC8230AFA039AD71C1DA60B8,38157,5,7,2,109.51483,18.26958,1563
6519,50414,2A3E5205AC8230AFA039AD71C1DA60B8,30211,8,10,2,109.49882,18.23931,1508
6520,50415,2A3E5205AC8230AFA039AD71C1DA60B8,31554,11,22,11,109.55521,18.2459,1709
6540,50572,D2A5F87218CF25385163A2F3C4229CB8,31561,0,7,7,109.56792,18.28479,1765
6541,50573,D2A5F87218CF25385163A2F3C4229CB8,30851,10,12,2,109.5616,18.27396,1713
6542,50574,D2A5F87218CF25385163A2F3C4229CB8,31561,13,19,6,109.56792,18.28479,1765
6550,50603,C1602FB5A20BD98313F7CC13F431D061,30271,0,15,15,109.49132,18.23153,1456
6551,50604,C1602FB5A20BD98313F7CC13F431D061,31031,15,17,2,109.49979,18.25382,1510
6552,50605,C1602FB5A20BD98313F7CC13F431D061,30271,21,23,2,109.49132,18.23153,1456
6578,50740,BFDE1CB7ED71CA9593AFA77408B12977,39183,0,1,1,109.55542,18.28208,1715
6579,50741,BFDE1CB7ED71CA9593AFA77408B12977,30854,1,11,10,109.56889,18.27076,1763
6580,50742,BFDE1CB7ED71CA9593AFA77408B12977,39183,14,21,7,109.55542,18.28208,1715
6588,50799,B37777551ADDE84A1FDFE1FF465C24DC,30921,1,6,5,109.53903,18.29451,1667
6589,50800,B37777551ADDE84A1FDFE1FF465C24DC,60301,10,11,1,109.60715,18.30993,1919
6590,50801,B37777551ADDE84A1FDFE1FF465C24DC,31931,11,15,4,109.54771,18.29403,1667
6591,50802,B37777551ADDE84A1FDFE1FF465C24DC,30921,19,20,1,109.53903,18.29451,1667
6604,50921,EBF906C5498076BCFA3E97DF6001B4F3,30854,0,2,2,109.56889,18.27076,1763
6605,50922,EBF906C5498076BCFA3E97DF6001B4F3,60631,3,7,4,109.57778,18.27583,1814
6606,50923,EBF906C5498076BCFA3E97DF6001B4F3,30854,11,23,12,109.56889,18.27076,1763
6607,50947,2A6BA0678DDF16AF08BAC9E3FA3C9391,31561,1,7,6,109.56792,18.28479,1765
6608,50948,2A6BA0678DDF16AF08BAC9E3FA3C9391,30854,8,11,3,109.56889,18.27076,1763
6609,50949,2A6BA0678DDF16AF08BAC9E3FA3C9391,31561,12,14,2,109.56792,18.28479,1765
6610,50950,2A6BA0678DDF16AF08BAC9E3FA3C9391,30854,17,20,3,109.56889,18.27076,1763
6614,51015,75817DB682187A07461734D66E1E6492,60631,0,4,4,109.57778,18.27583,1814
6615,51016,75817DB682187A07461734D66E1E6492,30854,6,16,10,109.56889,18.27076,1763
6616,51017,75817DB682187A07461734D66E1E6492,30851,17,20,3,109.5616,18.27396,1713
6617,51018,75817DB682187A07461734D66E1E6492,60631,21,23,2,109.57778,18.27583,1814
6618,51023,28AD4F4A057EAD61FC013015642C4D8F,31521,1,9,8,109.51458,18.22542,1555
6619,51024,28AD4F4A057EAD61FC013015642C4D8F,60081,12,15,3,109.51097,18.22639,1556
6620,51025,28AD4F4A057EAD61FC013015642C4D8F,30191,16,17,1,109.50361,18.22701,1506
6621,51026,28AD4F4A057EAD61FC013015642C4D8F,30051,17,20,3,109.48917,18.21215,1453
6624,51122,5CCD9DE75DF89B316E1B16CD295DB4E3,60361,0,7,7,109.51938,18.29681,1567
6625,51123,5CCD9DE75DF89B316E1B16CD295DB4E3,31561,12,16,4,109.56792,18.28479,1765
6626,51124,5CCD9DE75DF89B316E1B16CD295DB4E3,30854,16,18,2,109.56889,18.27076,1763
6627,51125,5CCD9DE75DF89B316E1B16CD295DB4E3,60361,19,23,4,109.51938,18.29681,1567
6661,51264,C19430CE8DF26BDEF43903E57E682236,31561,0,7,7,109.56792,18.28479,1765
6662,51265,C19430CE8DF26BDEF43903E57E682236,31071,8,9,1,109.58257,18.28458,1815
6663,51266,C19430CE8DF26BDEF43903E57E682236,31561,11,22,11,109.56792,18.28479,1765
6678,51493,27BCEF3137923B84211F08830816C810,30851,0,1,1,109.5616,18.27396,1713
6679,51494,27BCEF3137923B84211F08830816C810,31561,2,4,2,109.56792,18.28479,1765
6680,51495,27BCEF3137923B84211F08830816C810,30071,8,15,7,109.52819,18.30472,1619
6681,51496,27BCEF3137923B84211F08830816C810,30851,16,17,1,109.5616,18.27396,1713
6722,51785,F198CAA1F49ACA5D003FD8F8473B3798,31071,1,7,6,109.58257,18.28458,1815
6723,51786,F198CAA1F49ACA5D003FD8F8473B3798,30854,7,9,2,109.56889,18.27076,1763
6724,51787,F198CAA1F49ACA5D003FD8F8473B3798,31071,13,15,2,109.58257,18.28458,1815
6725,51788,F198CAA1F49ACA5D003FD8F8473B3798,30854,17,18,1,109.56889,18.27076,1763
6726,51818,A2FA5E7511F31EDC8642A1453F736A76,38951,0,6,6,109.48097,18.28868,1416
6727,51819,A2FA5E7511F31EDC8642A1453F736A76,30971,8,12,4,109.48708,18.29319,1467
6728,51820,A2FA5E7511F31EDC8642A1453F736A76,38951,13,23,10,109.48097,18.28868,1416
6738,51880,8C5A16299A6D294198C90C34C25C5949,30854,1,2,1,109.56889,18.27076,1763
6739,51881,8C5A16299A6D294198C90C34C25C5949,39183,2,4,2,109.55542,18.28208,1715
6740,51882,8C5A16299A6D294198C90C34C25C5949,30854,4,5,1,109.56889,18.27076,1763
6755,51952,B32D2CE6FAE9B9E7FD3C32948AAABD42,30181,0,10,10,109.51597,18.23313,1557
6756,51953,B32D2CE6FAE9B9E7FD3C32948AAABD42,30191,15,16,1,109.50361,18.22701,1506
6757,51954,B32D2CE6FAE9B9E7FD3C32948AAABD42,30361,18,19,1,109.50347,18.24,1508
6758,51955,B32D2CE6FAE9B9E7FD3C32948AAABD42,30181,20,21,1,109.51597,18.23313,1557
6797,52280,C01D7F4C525517694A04D5EAA5AD2420,31071,4,15,11,109.58257,18.28458,1815
6798,52281,C01D7F4C525517694A04D5EAA5AD2420,30071,17,18,1,109.52819,18.30472,1619
6799,52282,C01D7F4C525517694A04D5EAA5AD2420,31945,20,21,1,109.58021,18.29403,1817
6800,52283,C01D7F4C525517694A04D5EAA5AD2420,31071,21,22,1,109.58257,18.28458,1815
6820,52493,B5290624DD7244A223762FE2F75BD41F,38951,0,7,7,109.48097,18.28868,1416
6821,52494,B5290624DD7244A223762FE2F75BD41F,30971,8,11,3,109.48708,18.29319,1467
6822,52495,B5290624DD7244A223762FE2F75BD41F,30201,12,22,10,109.4909,18.26465,1462
6825,52589,B17D654C0C5F0BF2FDFE2DB8B9C0B83F,31041,1,2,1,109.50278,18.23701,1507
6826,52590,B17D654C0C5F0BF2FDFE2DB8B9C0B83F,30771,5,16,11,109.49938,18.26042,1511
6827,52591,B17D654C0C5F0BF2FDFE2DB8B9C0B83F,60291,16,19,3,109.50826,18.24639,1509
6828,52592,B17D654C0C5F0BF2FDFE2DB8B9C0B83F,30771,20,23,3,109.49938,18.26042,1511
6842,52678,60ACD2B6657BEEA3D1B558DE71329F84,60084,0,6,6,109.4984,18.2334,1507
6843,52679,60ACD2B6657BEEA3D1B558DE71329F84,30051,9,10,1,109.48917,18.21215,1453
6844,52680,60ACD2B6657BEEA3D1B558DE71329F84,38251,15,16,1,109.49618,18.25493,1510
6845,52681,60ACD2B6657BEEA3D1B558DE71329F84,30771,17,19,2,109.49938,18.26042,1511
6857,52845,6BCE0DED3EAD20A4FC692537465B6332,31071,0,1,1,109.58257,18.28458,1815
6858,52846,6BCE0DED3EAD20A4FC692537465B6332,39183,1,6,5,109.55542,18.28208,1715
6859,52847,6BCE0DED3EAD20A4FC692537465B6332,30854,8,13,5,109.56889,18.27076,1763
6860,52848,6BCE0DED3EAD20A4FC692537465B6332,39183,13,22,9,109.55542,18.28208,1715
6861,52872,4641AF7FC76419FEB068E4DB4580E39B,31521,0,3,3,109.51458,18.22542,1555
6862,52873,4641AF7FC76419FEB068E4DB4580E39B,31521,4,18,14,109.51458,18.22542,1555
6863,52874,4641AF7FC76419FEB068E4DB4580E39B,60381,20,21,1,109.5241,18.22458,1605
6870,52965,5097B43636B9B42C01AD4143B912CF81,31841,0,1,1,109.73201,18.33382,2373
6871,52966,5097B43636B9B42C01AD4143B912CF81,30501,3,8,5,109.72,18.34951,2326
6872,52967,5097B43636B9B42C01AD4143B912CF81,31841,9,10,1,109.73201,18.33382,2373
6873,53005,B663EE883B81AEB709AC84DCCEC3D38E,31945,0,7,7,109.58021,18.29403,1817
6874,53006,B663EE883B81AEB709AC84DCCEC3D38E,31071,12,20,8,109.58257,18.28458,1815
6875,53007,B663EE883B81AEB709AC84DCCEC3D38E,31945,21,23,2,109.58021,18.29403,1817
6882,53083,84DF4A7C208235D171EF56473BCCF210,30851,0,1,1,109.5616,18.27396,1713
6883,53084,84DF4A7C208235D171EF56473BCCF210,31561,4,6,2,109.56792,18.28479,1765
6884,53085,84DF4A7C208235D171EF56473BCCF210,60631,7,17,10,109.57778,18.27583,1814
6891,53135,A94F66C88B84FF0658441320CD9F667C,30854,0,5,5,109.56889,18.27076,1763
6892,53136,A94F66C88B84FF0658441320CD9F667C,31071,8,10,2,109.58257,18.28458,1815
6893,53137,A94F66C88B84FF0658441320CD9F667C,30854,12,21,9,109.56889,18.27076,1763
6894,53153,9905C3E423D151CCE1280F3A1732CE90,30854,0,6,6,109.56889,18.27076,1763
6895,53154,9905C3E423D151CCE1280F3A1732CE90,30851,7,9,2,109.5616,18.27396,1713
6896,53155,9905C3E423D151CCE1280F3A1732CE90,31071,14,18,4,109.58257,18.28458,1815
6897,53156,9905C3E423D151CCE1280F3A1732CE90,30854,20,23,3,109.56889,18.27076,1763
6900,53172,C316CE65034FB3C77BE459147CBF943A,60291,0,8,8,109.50826,18.24639,1509
6901,53173,C316CE65034FB3C77BE459147CBF943A,30161,12,14,2,109.50042,18.24389,1508
6902,53174,C316CE65034FB3C77BE459147CBF943A,30161,15,19,4,109.50042,18.24389,1508
6903,53175,C316CE65034FB3C77BE459147CBF943A,60291,20,22,2,109.50826,18.24639,1509
6915,53256,11136C83CACE9221E59CD40325571723,30891,0,7,7,109.59431,18.28389,1865
6916,53257,11136C83CACE9221E59CD40325571723,30854,7,11,4,109.56889,18.27076,1763
6917,53258,11136C83CACE9221E59CD40325571723,31071,13,22,9,109.58257,18.28458,1815
6918,53259,C50EC98EBB3AD6F34D76F87C749DAC01,39181,0,10,10,109.55153,18.28035,1715
6919,53260,C50EC98EBB3AD6F34D76F87C749DAC01,31931,11,18,7,109.54771,18.29403,1667
6920,53261,C50EC98EBB3AD6F34D76F87C749DAC01,39181,19,23,4,109.55153,18.28035,1715
6923,53274,0D00E0CA974DDA00224ACCD00B993468,30851,0,6,6,109.5616,18.27396,1713
6924,53275,0D00E0CA974DDA00224ACCD00B993468,30854,10,11,1,109.56889,18.27076,1763
6925,53276,0D00E0CA974DDA00224ACCD00B993468,31561,12,13,1,109.56792,18.28479,1765
6930,53313,CF23CF6CFE18BB23E9BD394A1039CA8D,60621,0,5,5,109.48354,18.27451,1464
6931,53314,CF23CF6CFE18BB23E9BD394A1039CA8D,30391,5,7,2,109.4975,18.27118,1513
6932,53315,CF23CF6CFE18BB23E9BD394A1039CA8D,60552,8,9,1,109.41729,18.30014,1218
6933,53317,F00821368F615DCDAF214035D8EC4A44,60631,1,2,1,109.57778,18.27583,1814
6934,53318,F00821368F615DCDAF214035D8EC4A44,31071,3,10,7,109.58257,18.28458,1815
6935,53319,F00821368F615DCDAF214035D8EC4A44,31761,12,13,1,109.60521,18.27965,1914
6936,53320,F00821368F615DCDAF214035D8EC4A44,30854,15,18,3,109.56889,18.27076,1763
6940,53360,8D7B9451E0189947198D6AC9CE51CFEE,31091,0,8,8,109.41201,18.31222,1170
6941,53361,8D7B9451E0189947198D6AC9CE51CFEE,30761,8,10,2,109.45201,18.3,1318
6942,53362,8D7B9451E0189947198D6AC9CE51CFEE,31091,12,19,7,109.41201,18.31222,1170
6943,53363,8D7B9451E0189947198D6AC9CE51CFEE,30111,20,23,3,109.47583,18.30542,1419
6947,53410,356E75600A8901067E9EDB6E5BE4617A,38157,0,7,7,109.51483,18.26958,1563
6948,53411,356E75600A8901067E9EDB6E5BE4617A,60661,7,10,3,109.548,18.2377,1657
6949,53412,356E75600A8901067E9EDB6E5BE4617A,31531,12,13,1,109.49583,18.25972,1461
6950,53413,356E75600A8901067E9EDB6E5BE4617A,38157,14,16,2,109.51483,18.26958,1563
6951,53447,17AC4F8E6659EB7FBFD30E5467A1D200,30711,2,11,9,109.50271,18.25347,1510
6952,53448,17AC4F8E6659EB7FBFD30E5467A1D200,30711,14,17,3,109.50271,18.25347,1510
6953,53449,17AC4F8E6659EB7FBFD30E5467A1D200,31031,17,20,3,109.49979,18.25382,1510
6956,53475,B93185B4820D7E0DEE74EBEA00941D15,30371,0,14,14,109.51,18.24771,1559
6957,53476,B93185B4820D7E0DEE74EBEA00941D15,60201,14,19,5,109.5041,18.2509,1510
6958,53477,B93185B4820D7E0DEE74EBEA00941D15,38291,20,23,3,109.51618,18.24313,1558
6959,53505,A14C813C3E3A7182759DA822342505B5,30851,1,2,1,109.5616,18.27396,1713
6960,53506,A14C813C3E3A7182759DA822342505B5,39181,2,5,3,109.55153,18.28035,1715
6961,53507,A14C813C3E3A7182759DA822342505B5,30851,7,12,5,109.5616,18.27396,1713
6962,53515,F84D949DDCBF25D5530F771BC55E0B9D,61011,0,7,7,109.60653,18.19076,1900
6963,53517,F84D949DDCBF25D5530F771BC55E0B9D,61011,11,14,3,109.60653,18.19076,1900
6964,53519,F84D949DDCBF25D5530F771BC55E0B9D,61011,20,21,1,109.60653,18.19076,1900
6968,53534,409F5E8F01172D32BBE91132149C037E,38371,0,11,11,109.50972,18.23924,1558
6969,53535,409F5E8F01172D32BBE91132149C037E,31201,12,14,2,109.51042,18.23819,1558
6970,53536,409F5E8F01172D32BBE91132149C037E,38251,14,15,1,109.49618,18.25493,1510
6971,53537,409F5E8F01172D32BBE91132149C037E,31201,19,23,4,109.51042,18.23819,1558
6972,53552,6EF68F35CE79552C1164E70C67C72C02,30121,0,11,11,109.52861,18.27222,1613
6973,53553,6EF68F35CE79552C1164E70C67C72C02,31561,14,15,1,109.56792,18.28479,1765
6974,53554,6EF68F35CE79552C1164E70C67C72C02,30854,15,16,1,109.56889,18.27076,1763
6975,53555,6EF68F35CE79552C1164E70C67C72C02,30121,19,23,4,109.52861,18.27222,1613
7012,53932,99CBAA6A65A50998F0A10B72B36210E4,60231,2,4,2,109.49903,18.21972,1504
7013,53933,99CBAA6A65A50998F0A10B72B36210E4,38251,8,18,10,109.49618,18.25493,1510
7014,53934,99CBAA6A65A50998F0A10B72B36210E4,30571,20,23,3,109.50243,18.21861,1504
7051,54255,012ABD06F231728C214A4BA917E75B1C,30851,0,2,2,109.5616,18.27396,1713
7052,54256,012ABD06F231728C214A4BA917E75B1C,31561,2,12,10,109.56792,18.28479,1765
7053,54257,012ABD06F231728C214A4BA917E75B1C,30851,12,17,5,109.5616,18.27396,1713
7054,54258,012ABD06F231728C214A4BA917E75B1C,31561,18,22,4,109.56792,18.28479,1765
7063,54336,1980C8D409DE9551539224B3D393CDAA,31951,0,1,1,109.52174,18.30299,1568
7064,54337,1980C8D409DE9551539224B3D393CDAA,30071,5,13,8,109.52819,18.30472,1619
7065,54338,1980C8D409DE9551539224B3D393CDAA,31951,13,23,10,109.52174,18.30299,1568
7075,54453,9AC1B73A6A57A1A8B7B76A628C70874E,31071,0,8,8,109.58257,18.28458,1815
7076,54454,9AC1B73A6A57A1A8B7B76A628C70874E,30854,8,11,3,109.56889,18.27076,1763
7077,54455,9AC1B73A6A57A1A8B7B76A628C70874E,31071,12,23,11,109.58257,18.28458,1815
7080,54526,2371AF49C13083A9B56BAFD9F258B46A,60361,0,1,1,109.51938,18.29681,1567
7081,54527,2371AF49C13083A9B56BAFD9F258B46A,31261,3,5,2,109.51174,18.2466,1559
7082,54528,2371AF49C13083A9B56BAFD9F258B46A,30721,7,21,14,109.51597,18.28257,1565
7083,54529,2371AF49C13083A9B56BAFD9F258B46A,30071,21,23,2,109.52819,18.30472,1619
7099,54620,860BE848C8101F7690BF8A8F8889D18A,39091,0,8,8,109.50097,18.25222,1510
7100,54621,860BE848C8101F7690BF8A8F8889D18A,31031,12,16,4,109.49979,18.25382,1510
7101,54622,860BE848C8101F7690BF8A8F8889D18A,39091,20,23,3,109.50097,18.25222,1510
7114,54666,7BBB2DDEDB0AE43F8CE7FBD1FCB52741,31071,1,10,9,109.58257,18.28458,1815
7115,54667,7BBB2DDEDB0AE43F8CE7FBD1FCB52741,30854,10,11,1,109.56889,18.27076,1763
7116,54668,7BBB2DDEDB0AE43F8CE7FBD1FCB52741,31071,11,13,2,109.58257,18.28458,1815
7117,54669,7BBB2DDEDB0AE43F8CE7FBD1FCB52741,30854,17,19,2,109.56889,18.27076,1763
7123,54843,35ADE76574C90D3F668DA7E7FAC83625,31621,0,9,9,109.51035,18.29826,1568
7124,54844,35ADE76574C90D3F668DA7E7FAC83625,60281,10,11,1,109.51743,18.25924,1561
7125,54845,35ADE76574C90D3F668DA7E7FAC83625,31621,12,23,11,109.51035,18.29826,1568
7134,54906,7890099D98AA300C5BF12527E7372DB0,60631,0,7,7,109.57778,18.27583,1814
7135,54907,7890099D98AA300C5BF12527E7372DB0,30854,9,11,2,109.56889,18.27076,1763
7136,54908,7890099D98AA300C5BF12527E7372DB0,60631,12,23,11,109.57778,18.27583,1814
7145,54944,9AA959ED87D1ECC3053DED17290EFCBD,30854,0,4,4,109.56889,18.27076,1763
7146,54945,9AA959ED87D1ECC3053DED17290EFCBD,31561,5,6,1,109.56792,18.28479,1765
7147,54946,9AA959ED87D1ECC3053DED17290EFCBD,39183,8,10,2,109.55542,18.28208,1715
7148,54947,9AA959ED87D1ECC3053DED17290EFCBD,31561,10,18,8,109.56792,18.28479,1765
7171,55120,40285EE8CCE25C38988EC087545664EC,30854,0,1,1,109.56889,18.27076,1763
7172,55121,40285EE8CCE25C38988EC087545664EC,31071,2,7,5,109.58257,18.28458,1815
7173,55122,40285EE8CCE25C38988EC087545664EC,30854,7,14,7,109.56889,18.27076,1763
7174,55123,40285EE8CCE25C38988EC087545664EC,31071,15,17,2,109.58257,18.28458,1815
7175,55134,E5688750AFF137F525F6B57BF016E6A9,30441,0,1,1,109.64021,18.25424,2010
7176,55135,E5688750AFF137F525F6B57BF016E6A9,38275,3,20,17,109.62875,18.22938,2006
7177,55136,E5688750AFF137F525F6B57BF016E6A9,31071,21,23,2,109.58257,18.28458,1815
7180,55210,C8922FAF66F21ECAECB6B717FCD5A53B,60391,1,6,5,109.47667,18.28757,1416
7181,55211,C8922FAF66F21ECAECB6B717FCD5A53B,60614,6,14,8,109.48799,18.29521,1467
7182,55212,C8922FAF66F21ECAECB6B717FCD5A53B,60391,16,18,2,109.47667,18.28757,1416
7191,55284,A503639E15A0B5D04B0130D882921438,31031,0,18,18,109.49979,18.25382,1510
7192,55285,A503639E15A0B5D04B0130D882921438,30421,19,20,1,109.50021,18.25861,1511
7193,55286,A503639E15A0B5D04B0130D882921438,31031,20,23,3,109.49979,18.25382,1510
7215,55426,E9E473F09C342630187345312F4A31D8,39181,0,14,14,109.55153,18.28035,1715
7216,55427,E9E473F09C342630187345312F4A31D8,31031,18,20,2,109.49979,18.25382,1510
7217,55428,E9E473F09C342630187345312F4A31D8,39181,21,23,2,109.55153,18.28035,1715
7225,55506,E75CF54BA14775FEDD26504F9F6B7365,31945,0,6,6,109.58021,18.29403,1817
7226,55507,E75CF54BA14775FEDD26504F9F6B7365,31561,7,19,12,109.56792,18.28479,1765
7227,55508,E75CF54BA14775FEDD26504F9F6B7365,30234,20,22,2,109.60681,18.29979,1918
7250,55735,14AE6C820CE45F96077630992CABD33D,30951,1,7,6,109.56208,18.25667,1761
7251,55736,14AE6C820CE45F96077630992CABD33D,31551,8,18,10,109.55868,18.24222,1708
7252,55737,14AE6C820CE45F96077630992CABD33D,30951,20,22,2,109.56208,18.25667,1761
7255,55765,AC435D39B518EE36E9A2F7FB71463491,30721,0,6,6,109.51597,18.28257,1565
7256,55766,AC435D39B518EE36E9A2F7FB71463491,31561,8,12,4,109.56792,18.28479,1765
7257,55767,AC435D39B518EE36E9A2F7FB71463491,30721,13,23,10,109.51597,18.28257,1565
7260,55839,EC4B90EDBF35256FDB4D4F8B87DB8A04,31071,3,6,3,109.58257,18.28458,1815
7261,55840,EC4B90EDBF35256FDB4D4F8B87DB8A04,30854,8,10,2,109.56889,18.27076,1763
7262,55841,EC4B90EDBF35256FDB4D4F8B87DB8A04,31071,10,11,1,109.58257,18.28458,1815
7263,55842,EC4B90EDBF35256FDB4D4F8B87DB8A04,30854,13,23,10,109.56889,18.27076,1763
7266,55863,F113DDC78FC5471ED8A23532B5EF78E0,30181,0,2,2,109.51597,18.23313,1557
7267,55864,F113DDC78FC5471ED8A23532B5EF78E0,30181,3,6,3,109.51597,18.23313,1557
7268,55865,F113DDC78FC5471ED8A23532B5EF78E0,30181,7,13,6,109.51597,18.23313,1557
7290,56007,C9DE6AF5861DC39A611FCC9B2DCFD783,38951,0,8,8,109.48097,18.28868,1416
7291,56008,C9DE6AF5861DC39A611FCC9B2DCFD783,30971,8,10,2,109.48708,18.29319,1467
7292,56009,C9DE6AF5861DC39A611FCC9B2DCFD783,30971,11,13,2,109.48708,18.29319,1467
7310,56186,A4D22152627C5C24F4D207D0FDD787D4,60371,0,1,1,109.53063,18.30056,1618
7311,56187,A4D22152627C5C24F4D207D0FDD787D4,60241,3,8,5,109.53319,18.28667,1616
7312,56188,A4D22152627C5C24F4D207D0FDD787D4,60221,9,18,9,109.52569,18.29188,1616
7332,56379,2225A928A5F41EC3C7691341B4D74A48,38297,0,5,5,109.52576,18.24965,1609
7333,56380,2225A928A5F41EC3C7691341B4D74A48,60311,6,7,1,109.52097,18.24319,1558
7334,56381,2225A928A5F41EC3C7691341B4D74A48,38297,8,20,12,109.52576,18.24965,1609
7335,56471,08DA3CFA22819D4D1B43402F03528A0D,31521,3,5,2,109.51458,18.22542,1555
7336,56472,08DA3CFA22819D4D1B43402F03528A0D,31521,5,6,1,109.51458,18.22542,1555
7337,56473,08DA3CFA22819D4D1B43402F03528A0D,30861,7,17,10,109.52722,18.22743,1606
7338,56474,08DA3CFA22819D4D1B43402F03528A0D,60381,18,23,5,109.5241,18.22458,1605
7369,56656,AB43182259122294244C13D6FC66D4A1,30891,0,4,4,109.59431,18.28389,1865
7370,56657,AB43182259122294244C13D6FC66D4A1,30851,7,8,1,109.5616,18.27396,1713
7371,56658,AB43182259122294244C13D6FC66D4A1,31561,8,18,10,109.56792,18.28479,1765
7372,56659,AB43182259122294244C13D6FC66D4A1,60631,20,22,2,109.57778,18.27583,1814
7396,56742,F8D799D9161B0143E0D71C40472A357E,30071,0,8,8,109.52819,18.30472,1619
7397,56743,F8D799D9161B0143E0D71C40472A357E,30071,10,12,2,109.52819,18.30472,1619
7398,56744,F8D799D9161B0143E0D71C40472A357E,30071,13,16,3,109.52819,18.30472,1619
7399,56745,F8D799D9161B0143E0D71C40472A357E,30071,16,23,7,109.52819,18.30472,1619
7400,56746,FCFB14BA36BDB7CD6A39612B9AE933B2,38127,0,7,7,109.50833,18.27222,1513
7401,56747,FCFB14BA36BDB7CD6A39612B9AE933B2,39181,11,14,3,109.55153,18.28035,1715
7402,56748,FCFB14BA36BDB7CD6A39612B9AE933B2,39183,14,16,2,109.55542,18.28208,1715
7403,56749,FCFB14BA36BDB7CD6A39612B9AE933B2,38127,18,23,5,109.50833,18.27222,1513
7404,56757,C0CA4E58B15F58D7F48B8BEF10CEB35A,30854,2,6,4,109.56889,18.27076,1763
7405,56758,C0CA4E58B15F58D7F48B8BEF10CEB35A,60631,6,8,2,109.57778,18.27583,1814
7406,56759,C0CA4E58B15F58D7F48B8BEF10CEB35A,30854,9,10,1,109.56889,18.27076,1763
7407,56777,7BF65E5054DA81A230AB5423620158E1,60631,0,7,7,109.57778,18.27583,1814
7408,56778,7BF65E5054DA81A230AB5423620158E1,30854,8,19,11,109.56889,18.27076,1763
7409,56779,7BF65E5054DA81A230AB5423620158E1,60631,20,23,3,109.57778,18.27583,1814
7420,56835,53B443662130EB5C95A209BD2C82316A,31351,0,10,10,109.4959,18.28417,1465
7421,56836,53B443662130EB5C95A209BD2C82316A,31201,11,13,2,109.51042,18.23819,1558
7422,56837,53B443662130EB5C95A209BD2C82316A,30741,16,17,1,109.49833,18.28681,1516
7423,56838,53B443662130EB5C95A209BD2C82316A,31701,19,20,1,109.44132,18.28833,1266
7429,56857,A412B863FD18FF008395045517EEAEF4,30681,0,4,4,109.48493,18.26917,1463
7430,56858,A412B863FD18FF008395045517EEAEF4,30201,4,9,5,109.4909,18.26465,1462
7431,56859,A412B863FD18FF008395045517EEAEF4,30171,12,15,3,109.48458,18.27139,1463
7443,56941,6C20D2414CF9A0F17DA8E3BEC5FF1F39,38951,0,8,8,109.48097,18.28868,1416
7444,56942,6C20D2414CF9A0F17DA8E3BEC5FF1F39,30971,8,13,5,109.48708,18.29319,1467
7445,56943,6C20D2414CF9A0F17DA8E3BEC5FF1F39,38951,13,18,5,109.48097,18.28868,1416
7446,56964,2E5CD5354D68AAA8E89573B276E5DD63,38154,0,16,16,109.5266,18.28278,1615
7447,56965,2E5CD5354D68AAA8E89573B276E5DD63,60281,17,18,1,109.51743,18.25924,1561
7448,56966,2E5CD5354D68AAA8E89573B276E5DD63,38154,21,23,2,109.5266,18.28278,1615
7454,57005,2115670ECBCEFE4CA16C55F5204DF607,30854,1,2,1,109.56889,18.27076,1763
7455,57006,2115670ECBCEFE4CA16C55F5204DF607,31071,4,6,2,109.58257,18.28458,1815
7456,57007,2115670ECBCEFE4CA16C55F5204DF607,60631,6,7,1,109.57778,18.27583,1814
7523,57403,0C12679B52C25C8A094B9B69D277B0C8,31071,0,6,6,109.58257,18.28458,1815
7524,57404,0C12679B52C25C8A094B9B69D277B0C8,31561,8,9,1,109.56792,18.28479,1765
7525,57405,0C12679B52C25C8A094B9B69D277B0C8,31071,12,23,11,109.58257,18.28458,1815
7567,57726,B03EB6B394C6FA523E27D03BBB015313,30211,0,1,1,109.49882,18.23931,1508
7568,57727,B03EB6B394C6FA523E27D03BBB015313,39154,1,8,7,109.50201,18.25681,1511
7569,57728,B03EB6B394C6FA523E27D03BBB015313,31041,8,11,3,109.50278,18.23701,1507
7570,57729,B03EB6B394C6FA523E27D03BBB015313,39154,11,13,2,109.50201,18.25681,1511
7599,57941,F82B3BBB77C5FF41C0BBD473F847E370,30891,2,4,2,109.59431,18.28389,1865
7600,57942,F82B3BBB77C5FF41C0BBD473F847E370,30854,6,10,4,109.56889,18.27076,1763
7601,57943,F82B3BBB77C5FF41C0BBD473F847E370,39183,13,21,8,109.55542,18.28208,1715
7606,58008,1B6EBBFF3B9D8A3E18753343B6A29EAE,31071,0,13,13,109.58257,18.28458,1815
7607,58009,1B6EBBFF3B9D8A3E18753343B6A29EAE,30851,16,17,1,109.5616,18.27396,1713
7608,58010,1B6EBBFF3B9D8A3E18753343B6A29EAE,31071,20,23,3,109.58257,18.28458,1815
7620,58058,D88AE248BE01D22E4DE2A4B556E71166,38951,1,10,9,109.48097,18.28868,1416
7621,58059,D88AE248BE01D22E4DE2A4B556E71166,30971,11,12,1,109.48708,18.29319,1467
7622,58060,D88AE248BE01D22E4DE2A4B556E71166,38951,15,19,4,109.48097,18.28868,1416
7623,58061,D88AE248BE01D22E4DE2A4B556E71166,60524,19,20,1,109.42951,18.28993,1216
7644,58389,7171A8398911756415ECFCDCF96F249B,30121,0,6,6,109.52861,18.27222,1613
7645,58390,7171A8398911756415ECFCDCF96F249B,30951,9,10,1,109.56208,18.25667,1761
7646,58391,7171A8398911756415ECFCDCF96F249B,30851,11,23,12,109.5616,18.27396,1713
7653,58408,BD5D5103B08534F20AF53FB58E9A43CA,31931,0,6,6,109.54771,18.29403,1667
7654,58409,BD5D5103B08534F20AF53FB58E9A43CA,38241,6,8,2,109.54111,18.30542,1669
7655,58410,BD5D5103B08534F20AF53FB58E9A43CA,31931,8,15,7,109.54771,18.29403,1667
7673,58628,45FA8AF959A216E06C82392E21728E7F,31071,0,7,7,109.58257,18.28458,1815
7674,58629,45FA8AF959A216E06C82392E21728E7F,31561,8,12,4,109.56792,18.28479,1765
7675,58630,45FA8AF959A216E06C82392E21728E7F,31071,12,13,1,109.58257,18.28458,1815
7676,58633,13104A6A71A054F852B52BB76993ADB2,30851,0,3,3,109.5616,18.27396,1713
7677,58634,13104A6A71A054F852B52BB76993ADB2,30891,6,8,2,109.59431,18.28389,1865
7678,58635,13104A6A71A054F852B52BB76993ADB2,30851,8,19,11,109.5616,18.27396,1713
7679,58636,13104A6A71A054F852B52BB76993ADB2,30854,20,22,2,109.56889,18.27076,1763
7681,58660,D4EE8E1A4C04A1FF0596E4221D0B8B42,31071,0,7,7,109.58257,18.28458,1815
7682,58661,D4EE8E1A4C04A1FF0596E4221D0B8B42,30854,8,16,8,109.56889,18.27076,1763
7683,58662,D4EE8E1A4C04A1FF0596E4221D0B8B42,31071,19,20,1,109.58257,18.28458,1815
7684,58663,D4EE8E1A4C04A1FF0596E4221D0B8B42,30854,21,22,1,109.56889,18.27076,1763
7695,58719,3607565CF2EC562DCF715F1B17219F8A,38911,0,4,4,109.51674,18.24965,1559
7696,58720,3607565CF2EC562DCF715F1B17219F8A,38291,5,16,11,109.51618,18.24313,1558
7697,58721,3607565CF2EC562DCF715F1B17219F8A,60381,19,22,3,109.5241,18.22458,1605
7698,58732,875F4B80762D0E664890361D764F907D,60081,0,7,7,109.51097,18.22639,1556
7699,58733,875F4B80762D0E664890361D764F907D,30571,7,18,11,109.50243,18.21861,1504
7700,58734,875F4B80762D0E664890361D764F907D,60081,19,21,2,109.51097,18.22639,1556
7701,58735,875F4B80762D0E664890361D764F907D,30421,21,23,2,109.50021,18.25861,1511
7730,59166,A7B9481C677E747C5C2240237CB64DE4,60361,0,10,10,109.51938,18.29681,1567
7731,59167,A7B9481C677E747C5C2240237CB64DE4,31931,13,15,2,109.54771,18.29403,1667
7732,59168,A7B9481C677E747C5C2240237CB64DE4,60361,17,19,2,109.51938,18.29681,1567
7733,59177,BE7763F8096EB5A037146E1CC4190538,30854,0,11,11,109.56889,18.27076,1763
7734,59178,BE7763F8096EB5A037146E1CC4190538,31561,13,14,1,109.56792,18.28479,1765
7735,59179,BE7763F8096EB5A037146E1CC4190538,30854,14,22,8,109.56889,18.27076,1763
7736,59190,5A1C4533F331B639AE5D3D6E2930E30B,31945,0,7,7,109.58021,18.29403,1817
7737,59191,5A1C4533F331B639AE5D3D6E2930E30B,30854,8,10,2,109.56889,18.27076,1763
7738,59192,5A1C4533F331B639AE5D3D6E2930E30B,60631,13,14,1,109.57778,18.27583,1814
7763,59415,971FAC974FC919EB70A5D4943C3307C0,60594,0,7,7,109.62694,18.22799,1956
7764,59416,971FAC974FC919EB70A5D4943C3307C0,38052,8,10,2,109.62618,18.23042,1956
7765,59417,971FAC974FC919EB70A5D4943C3307C0,60594,11,12,1,109.62694,18.22799,1956
7766,59418,971FAC974FC919EB70A5D4943C3307C0,38052,16,19,3,109.62618,18.23042,1956
7769,59517,FB16AA24AD94D8CC7E1110E44BD68910,60631,0,14,14,109.57778,18.27583,1814
7770,59518,FB16AA24AD94D8CC7E1110E44BD68910,30854,16,19,3,109.56889,18.27076,1763
7771,59519,FB16AA24AD94D8CC7E1110E44BD68910,31945,19,21,2,109.58021,18.29403,1817
7774,59547,2DDF3A993BD69F79020EB97CF3A71819,38171,0,6,6,109.50799,18.28139,1515
7775,59548,2DDF3A993BD69F79020EB97CF3A71819,30161,7,8,1,109.50042,18.24389,1508
7776,59549,2DDF3A993BD69F79020EB97CF3A71819,30161,10,20,10,109.50042,18.24389,1508
7777,59550,2DDF3A993BD69F79020EB97CF3A71819,30161,21,23,2,109.50042,18.24389,1508
7783,59591,EBD16061EA20EE33D9344D33735E5205,38291,0,9,9,109.51618,18.24313,1558
7784,59592,EBD16061EA20EE33D9344D33735E5205,38291,10,11,1,109.51618,18.24313,1558
7785,59593,EBD16061EA20EE33D9344D33735E5205,31201,12,13,1,109.51042,18.23819,1558
7786,59594,EBD16061EA20EE33D9344D33735E5205,31261,14,16,2,109.51174,18.2466,1559
7804,59712,0547C7536E43628EF24935F0C2BF5E2C,30921,0,6,6,109.53903,18.29451,1667
7805,59713,0547C7536E43628EF24935F0C2BF5E2C,31931,8,11,3,109.54771,18.29403,1667
7806,59714,0547C7536E43628EF24935F0C2BF5E2C,30921,15,18,3,109.53903,18.29451,1667
7807,59715,0547C7536E43628EF24935F0C2BF5E2C,60241,20,21,1,109.53319,18.28667,1616
7808,59748,F3EA7BB85A440E2BE2D597787EA5279B,60235,0,2,2,109.49269,18.2253,1455
7809,59749,F3EA7BB85A440E2BE2D597787EA5279B,38834,5,7,2,109.47639,18.21146,1403
7810,59750,F3EA7BB85A440E2BE2D597787EA5279B,30051,7,23,16,109.48917,18.21215,1453
7820,59779,7B1A07C39637E996C01DF0A3D287D3C6,30854,0,6,6,109.56889,18.27076,1763
7821,59780,7B1A07C39637E996C01DF0A3D287D3C6,31561,7,8,1,109.56792,18.28479,1765
7822,59781,7B1A07C39637E996C01DF0A3D287D3C6,30854,9,15,6,109.56889,18.27076,1763
7823,59782,45086BC0869D90A8E8F669EDA6561CFA,31071,0,14,14,109.58257,18.28458,1815
7824,59783,45086BC0869D90A8E8F669EDA6561CFA,30581,15,16,1,109.62257,18.24951,1959
7825,59784,45086BC0869D90A8E8F669EDA6561CFA,30281,18,21,3,109.50597,18.27583,1514
7826,59785,45086BC0869D90A8E8F669EDA6561CFA,31071,22,23,1,109.58257,18.28458,1815
7834,59820,1FC5887E4053936D3ED4D738338DC172,30121,0,7,7,109.52861,18.27222,1613
7835,59821,1FC5887E4053936D3ED4D738338DC172,30951,10,16,6,109.56208,18.25667,1761
7836,59822,1FC5887E4053936D3ED4D738338DC172,30121,18,23,5,109.52861,18.27222,1613
7847,59933,C8135D3E403B7CC96352A41CBCD291A7,38241,0,6,6,109.54111,18.30542,1669
7848,59934,C8135D3E403B7CC96352A41CBCD291A7,31931,9,14,5,109.54771,18.29403,1667
7849,59935,C8135D3E403B7CC96352A41CBCD291A7,38241,17,19,2,109.54111,18.30542,1669
7850,59936,C8135D3E403B7CC96352A41CBCD291A7,31931,20,22,2,109.54771,18.29403,1667
7861,60082,0C8D15C0488D521680F0DE3A28CFE111,31811,0,6,6,109.54201,18.31806,1671
7862,60083,0C8D15C0488D521680F0DE3A28CFE111,30701,7,16,9,109.59313,18.32007,1871
7863,60084,0C8D15C0488D521680F0DE3A28CFE111,31811,17,18,1,109.54201,18.31806,1671
7866,60115,45CCFCD3EBDF941E1C92B70ED06E8B5E,30854,0,4,4,109.56889,18.27076,1763
7867,60116,45CCFCD3EBDF941E1C92B70ED06E8B5E,31945,8,9,1,109.58021,18.29403,1817
7868,60117,45CCFCD3EBDF941E1C92B70ED06E8B5E,30854,12,18,6,109.56889,18.27076,1763
7869,60118,45CCFCD3EBDF941E1C92B70ED06E8B5E,31561,19,21,2,109.56792,18.28479,1765
7888,60214,617D274C6203C3080475711DB0A2A53F,39321,0,4,4,109.529,18.2167,1604
7889,60215,617D274C6203C3080475711DB0A2A53F,31521,5,6,1,109.51458,18.22542,1555
7890,60218,617D274C6203C3080475711DB0A2A53F,31521,18,21,3,109.51458,18.22542,1555
7926,60596,CC26F9F071245CA0A7A9071D1AE3256E,31351,0,1,1,109.4959,18.28417,1465
7927,60597,CC26F9F071245CA0A7A9071D1AE3256E,31864,4,5,1,109.49014,18.28333,1465
7928,60598,CC26F9F071245CA0A7A9071D1AE3256E,31351,5,6,1,109.4959,18.28417,1465
7933,60633,44A75810FF8F9221047E9675BDBF60A2,31071,4,9,5,109.58257,18.28458,1815
7934,60634,44A75810FF8F9221047E9675BDBF60A2,30854,11,13,2,109.56889,18.27076,1763
7935,60635,44A75810FF8F9221047E9675BDBF60A2,31071,14,16,2,109.58257,18.28458,1815
7936,60636,44A75810FF8F9221047E9675BDBF60A2,30854,18,19,1,109.56889,18.27076,1763
7937,60658,C0DEC1A1A71755BE992575C088C9CC1E,60131,0,15,15,109.49819,18.24778,1509
7938,60659,C0DEC1A1A71755BE992575C088C9CC1E,31031,15,19,4,109.49979,18.25382,1510
7939,60660,C0DEC1A1A71755BE992575C088C9CC1E,60131,20,21,1,109.49819,18.24778,1509
7940,60661,C0DEC1A1A71755BE992575C088C9CC1E,31181,22,23,1,109.50382,18.24813,1509
7952,60722,E6312CBC8153A9C6DAB83670095D0D25,38951,0,2,2,109.48097,18.28868,1416
7953,60723,E6312CBC8153A9C6DAB83670095D0D25,60501,2,7,5,109.48701,18.29021,1466
7954,60724,E6312CBC8153A9C6DAB83670095D0D25,38951,11,14,3,109.48097,18.28868,1416
7956,60753,C709D01469E0800AF998DFAF42105CDC,30854,0,5,5,109.56889,18.27076,1763
7957,60754,C709D01469E0800AF998DFAF42105CDC,60631,7,8,1,109.57778,18.27583,1814
7958,60755,C709D01469E0800AF998DFAF42105CDC,30854,9,16,7,109.56889,18.27076,1763
7959,60778,173CD7A2B7B334BC53A50A1D248FBCFE,31071,0,6,6,109.58257,18.28458,1815
7960,60779,173CD7A2B7B334BC53A50A1D248FBCFE,30854,10,12,2,109.56889,18.27076,1763
7961,60780,173CD7A2B7B334BC53A50A1D248FBCFE,31071,14,21,7,109.58257,18.28458,1815
7962,60781,451E2BF48CD7B253EB0892324E679BCC,38297,0,6,6,109.52576,18.24965,1609
7963,60782,451E2BF48CD7B253EB0892324E679BCC,60281,6,15,9,109.51743,18.25924,1561
7964,60783,451E2BF48CD7B253EB0892324E679BCC,38291,16,22,6,109.51618,18.24313,1558
7965,60791,8A0382A2385C362EFE2664E8795F133E,31561,0,5,5,109.56792,18.28479,1765
7966,60792,8A0382A2385C362EFE2664E8795F133E,39183,7,18,11,109.55542,18.28208,1715
7967,60793,8A0382A2385C362EFE2664E8795F133E,31561,21,23,2,109.56792,18.28479,1765
7976,60863,4CE90E7F21A3960AF8727F22C7C2F7EA,31201,0,7,7,109.51042,18.23819,1558
7977,60864,4CE90E7F21A3960AF8727F22C7C2F7EA,60281,8,11,3,109.51743,18.25924,1561
7978,60865,4CE90E7F21A3960AF8727F22C7C2F7EA,31201,12,23,11,109.51042,18.23819,1558
7979,60876,38A8595594DC26AD8BE733FC85DB4CA6,31631,0,15,15,109.59542,18.36826,1879
7980,60877,38A8595594DC26AD8BE733FC85DB4CA6,30101,15,17,2,109.57299,18.33333,1773
7981,60878,38A8595594DC26AD8BE733FC85DB4CA6,31631,17,22,5,109.59542,18.36826,1879
7982,60905,8FAAC7EA21AE7BB6F52A4D0F285944CD,38721,0,8,8,109.50368,18.27542,1514
7983,60906,8FAAC7EA21AE7BB6F52A4D0F285944CD,30281,8,10,2,109.50597,18.27583,1514
7984,60907,8FAAC7EA21AE7BB6F52A4D0F285944CD,60201,10,12,2,109.5041,18.2509,1510
7994,60968,283001ED673D8EDBEF7EEB00BDB31533,30571,1,5,4,109.50243,18.21861,1504
7995,60969,283001ED673D8EDBEF7EEB00BDB31533,60331,7,9,2,109.505,18.26507,1512
7996,60970,283001ED673D8EDBEF7EEB00BDB31533,60201,9,18,9,109.5041,18.2509,1510
7997,60971,283001ED673D8EDBEF7EEB00BDB31533,30571,18,20,2,109.50243,18.21861,1504
8017,61269,63FBAC0202144B00077561285E6A7F87,30651,1,2,1,109.42611,18.385,1232
8018,61270,63FBAC0202144B00077561285E6A7F87,30821,3,13,10,109.43681,18.33639,1274
8019,61271,63FBAC0202144B00077561285E6A7F87,30651,14,16,2,109.42611,18.385,1232
8020,61272,63FBAC0202144B00077561285E6A7F87,30821,17,21,4,109.43681,18.33639,1274
8052,61493,F47C4E1E39056C43B0AD32AC994AB7C0,31931,0,15,15,109.54771,18.29403,1667
8053,61494,F47C4E1E39056C43B0AD32AC994AB7C0,30921,17,19,2,109.53903,18.29451,1667
8054,61495,F47C4E1E39056C43B0AD32AC994AB7C0,31931,21,22,1,109.54771,18.29403,1667
8062,61693,D8681498A4BDCBE5A54E7CD864E651F0,60371,0,1,1,109.53063,18.30056,1618
8063,61694,D8681498A4BDCBE5A54E7CD864E651F0,30071,2,5,3,109.52819,18.30472,1619
8064,61695,D8681498A4BDCBE5A54E7CD864E651F0,38315,5,6,1,109.48979,18.29764,1467
8088,61967,86EE5D68F9CFA1D4E3B7514A323B43C4,60361,0,8,8,109.51938,18.29681,1567
8089,61968,86EE5D68F9CFA1D4E3B7514A323B43C4,38484,8,10,2,109.53028,18.31528,1620
8090,61969,86EE5D68F9CFA1D4E3B7514A323B43C4,30071,11,21,10,109.52819,18.30472,1619
8120,62099,3628EDF55F9AE10864AAD56A403A43FA,30891,1,5,4,109.59431,18.28389,1865
8121,62100,3628EDF55F9AE10864AAD56A403A43FA,30854,5,6,1,109.56889,18.27076,1763
8122,62101,3628EDF55F9AE10864AAD56A403A43FA,30891,6,15,9,109.59431,18.28389,1865
8123,62102,3628EDF55F9AE10864AAD56A403A43FA,30854,19,22,3,109.56889,18.27076,1763
8135,62157,10026EC528DC65E6B062D4E8B47727C1,38157,1,6,5,109.51483,18.26958,1563
8136,62158,10026EC528DC65E6B062D4E8B47727C1,30171,8,11,3,109.48458,18.27139,1463
8137,62159,10026EC528DC65E6B062D4E8B47727C1,38127,12,23,11,109.50833,18.27222,1513
8156,62360,C1602FB5A20BD98313F7CC13F431D061,30271,0,7,7,109.49132,18.23153,1456
8157,62361,C1602FB5A20BD98313F7CC13F431D061,30771,9,15,6,109.49938,18.26042,1511
8158,62362,C1602FB5A20BD98313F7CC13F431D061,30771,16,18,2,109.49938,18.26042,1511
8159,62363,C1602FB5A20BD98313F7CC13F431D061,39151,19,21,2,109.49875,18.25097,1510
8160,62376,8DD23AA43C0F7967C45F7488D66F9159,30854,2,9,7,109.56889,18.27076,1763
8161,62377,8DD23AA43C0F7967C45F7488D66F9159,31945,13,14,1,109.58021,18.29403,1817
8162,62378,8DD23AA43C0F7967C45F7488D66F9159,30854,18,20,2,109.56889,18.27076,1763
8168,62450,D517610C2076C41FED0ED80CB6FFB44C,30851,0,14,14,109.5616,18.27396,1713
8169,62451,D517610C2076C41FED0ED80CB6FFB44C,31561,14,15,1,109.56792,18.28479,1765
8170,62452,D517610C2076C41FED0ED80CB6FFB44C,30851,17,22,5,109.5616,18.27396,1713
8180,62499,9BD0746EAD915C7FE62E448DC71186FA,30854,0,2,2,109.56889,18.27076,1763
8181,62500,9BD0746EAD915C7FE62E448DC71186FA,31071,2,10,8,109.58257,18.28458,1815
8182,62501,9BD0746EAD915C7FE62E448DC71186FA,30854,13,16,3,109.56889,18.27076,1763
8183,62508,C85D0B931BEF54F05B9ABBBB03212DB7,30854,0,6,6,109.56889,18.27076,1763
8184,62509,C85D0B931BEF54F05B9ABBBB03212DB7,31561,8,18,10,109.56792,18.28479,1765
8185,62510,C85D0B931BEF54F05B9ABBBB03212DB7,30854,19,20,1,109.56889,18.27076,1763
8190,62568,DB5DBB26A2C3C99D2F6E5594795E2B47,30151,0,7,7,109.50986,18.25083,1560
8191,62569,DB5DBB26A2C3C99D2F6E5594795E2B47,60401,9,12,3,109.47444,18.27583,1414
8192,62570,DB5DBB26A2C3C99D2F6E5594795E2B47,30171,14,15,1,109.48458,18.27139,1463
8209,62667,928DF0385E8541CFD2F5858501C04155,31071,0,2,2,109.58257,18.28458,1815
8210,62668,928DF0385E8541CFD2F5858501C04155,30234,5,6,1,109.60681,18.29979,1918
8211,62669,928DF0385E8541CFD2F5858501C04155,30854,11,20,9,109.56889,18.27076,1763
8215,62685,8E3A30A4D1E8F550E98C2EF7500D367D,30084,0,10,10,109.50118,18.26972,1513
8216,62686,8E3A30A4D1E8F550E98C2EF7500D367D,30081,14,15,1,109.50243,18.26632,1512
8217,62687,8E3A30A4D1E8F550E98C2EF7500D367D,30711,15,17,2,109.50271,18.25347,1510
8218,62688,8E3A30A4D1E8F550E98C2EF7500D367D,30081,19,23,4,109.50243,18.26632,1512
8219,62708,75817DB682187A07461734D66E1E6492,60631,0,4,4,109.57778,18.27583,1814
8220,62709,75817DB682187A07461734D66E1E6492,30854,5,18,13,109.56889,18.27076,1763
8221,62710,75817DB682187A07461734D66E1E6492,60631,21,23,2,109.57778,18.27583,1814
8227,62808,34F3D64B41C252481F72E5CF931AC833,30851,1,11,10,109.5616,18.27396,1713
8228,62809,34F3D64B41C252481F72E5CF931AC833,30854,12,13,1,109.56889,18.27076,1763
8229,62810,34F3D64B41C252481F72E5CF931AC833,31071,13,15,2,109.58257,18.28458,1815
8246,62926,E6541B4F346982101D887BAAF0315541,30854,1,7,6,109.56889,18.27076,1763
8247,62927,E6541B4F346982101D887BAAF0315541,31561,8,9,1,109.56792,18.28479,1765
8248,62928,E6541B4F346982101D887BAAF0315541,30854,13,14,1,109.56889,18.27076,1763
8269,63185,91EC74D2B208A10BECBB101C6735C578,31864,0,7,7,109.49014,18.28333,1465
8270,63186,91EC74D2B208A10BECBB101C6735C578,38261,9,10,1,109.50361,18.28153,1515
8271,63187,91EC74D2B208A10BECBB101C6735C578,30421,10,11,1,109.50021,18.25861,1511
8278,63206,5426296000364EE32711CD0E73D782C8,30854,0,1,1,109.56889,18.27076,1763
8279,63207,5426296000364EE32711CD0E73D782C8,31071,5,7,2,109.58257,18.28458,1815
8280,63208,5426296000364EE32711CD0E73D782C8,31561,9,15,6,109.56792,18.28479,1765
8288,63313,6F0540B756080DEA0630ADD22B34EFCA,31261,0,7,7,109.51174,18.2466,1559
8289,63314,6F0540B756080DEA0630ADD22B34EFCA,38801,7,18,11,109.51472,18.2584,1561
8290,63315,6F0540B756080DEA0630ADD22B34EFCA,31171,18,23,5,109.50938,18.24917,1559
8291,63327,996C0D9500BF90CC0E7F5A04C49A464B,30921,1,2,1,109.53903,18.29451,1667
8292,63328,996C0D9500BF90CC0E7F5A04C49A464B,39181,5,6,1,109.55153,18.28035,1715
8293,63329,996C0D9500BF90CC0E7F5A04C49A464B,31931,6,19,13,109.54771,18.29403,1667
8296,63338,DA7695571AF860EADFA185350D767F54,38141,0,15,15,109.39479,18.2916,1116
8297,63339,DA7695571AF860EADFA185350D767F54,31671,15,17,2,109.38965,18.29813,1068
8298,63340,DA7695571AF860EADFA185350D767F54,38071,18,21,3,109.40722,18.30938,1169
8317,63490,A6DE0B8C40477DEE9D4849FDF2121A4D,60504,0,5,5,109.47917,18.28903,1416
8318,63491,A6DE0B8C40477DEE9D4849FDF2121A4D,38951,6,7,1,109.48097,18.28868,1416
8319,63492,A6DE0B8C40477DEE9D4849FDF2121A4D,30971,8,11,3,109.48708,18.29319,1467
8320,63493,A6DE0B8C40477DEE9D4849FDF2121A4D,38951,12,23,11,109.48097,18.28868,1416
8330,63553,B2376BB99A8F8A7FC5A41C7F0EEFB359,31945,0,12,12,109.58021,18.29403,1817
8331,63554,B2376BB99A8F8A7FC5A41C7F0EEFB359,30851,15,17,2,109.5616,18.27396,1713
8332,63555,B2376BB99A8F8A7FC5A41C7F0EEFB359,31945,19,23,4,109.58021,18.29403,1817
8333,63582,0E0D6E55BB1995EBF85F6B7AA8765E55,60631,0,2,2,109.57778,18.27583,1814
8334,63583,0E0D6E55BB1995EBF85F6B7AA8765E55,30854,3,4,1,109.56889,18.27076,1763
8335,63584,0E0D6E55BB1995EBF85F6B7AA8765E55,60631,4,7,3,109.57778,18.27583,1814
8343,63610,C1F9914EF577AE2A8300B1A3945A50FF,31561,1,4,3,109.56792,18.28479,1765
8344,63611,C1F9914EF577AE2A8300B1A3945A50FF,30851,4,7,3,109.5616,18.27396,1713
8345,63612,C1F9914EF577AE2A8300B1A3945A50FF,31561,7,16,9,109.56792,18.28479,1765
8352,63635,B49997E558EBA6E6EDC3CFE777E3F80C,39181,0,7,7,109.55153,18.28035,1715
8353,63636,B49997E558EBA6E6EDC3CFE777E3F80C,39181,11,16,5,109.55153,18.28035,1715
8354,63637,B49997E558EBA6E6EDC3CFE777E3F80C,39181,19,23,4,109.55153,18.28035,1715
8357,63780,BE8220A49F1231C0A022F4AA2075503E,31071,0,4,4,109.58257,18.28458,1815
8358,63781,BE8220A49F1231C0A022F4AA2075503E,30854,8,11,3,109.56889,18.27076,1763
8359,63782,BE8220A49F1231C0A022F4AA2075503E,31945,12,15,3,109.58021,18.29403,1817
8361,63830,C9524866A6E9E0E3158261DBB1EE420F,38951,0,8,8,109.48097,18.28868,1416
8362,63831,C9524866A6E9E0E3158261DBB1EE420F,30971,8,10,2,109.48708,18.29319,1467
8363,63832,C9524866A6E9E0E3158261DBB1EE420F,38951,13,23,10,109.48097,18.28868,1416
8366,63847,9FC721E86703223349C05C95FE4BBB6F,60087,0,1,1,109.50688,18.22299,1505
8367,63848,9FC721E86703223349C05C95FE4BBB6F,60081,2,10,8,109.51097,18.22639,1556
8368,63849,9FC721E86703223349C05C95FE4BBB6F,60381,11,19,8,109.5241,18.22458,1605
8369,63850,9FC721E86703223349C05C95FE4BBB6F,60087,20,23,3,109.50688,18.22299,1505
8373,63855,3379F8CA3C60221B34F1581AF646427C,38951,0,11,11,109.48097,18.28868,1416
8374,63856,3379F8CA3C60221B34F1581AF646427C,30201,13,14,1,109.4909,18.26465,1462
8375,63857,3379F8CA3C60221B34F1581AF646427C,31351,14,15,1,109.4959,18.28417,1465
8376,63858,3379F8CA3C60221B34F1581AF646427C,30971,19,22,3,109.48708,18.29319,1467
8386,63935,A8CC84F6441C04DAF82A74609E587ED2,30561,4,5,1,109.52778,18.31938,1621
8387,63936,A8CC84F6441C04DAF82A74609E587ED2,31931,8,9,1,109.54771,18.29403,1667
8388,63937,A8CC84F6441C04DAF82A74609E587ED2,30561,12,13,1,109.52778,18.31938,1621
8389,63938,A8CC84F6441C04DAF82A74609E587ED2,31931,14,15,1,109.54771,18.29403,1667
8390,63971,8554F0A178316702A9146AC053A2336A,39154,0,6,6,109.50201,18.25681,1511
8391,63972,8554F0A178316702A9146AC053A2336A,60381,11,12,1,109.5241,18.22458,1605
8392,63973,8554F0A178316702A9146AC053A2336A,30421,13,14,1,109.50021,18.25861,1511
8393,63974,8554F0A178316702A9146AC053A2336A,30711,14,18,4,109.50271,18.25347,1510
8394,64058,39997DEFFD87AA0C9D18E1194544E438,30891,2,4,2,109.59431,18.28389,1865
8395,64059,39997DEFFD87AA0C9D18E1194544E438,30854,5,15,10,109.56889,18.27076,1763
8396,64060,39997DEFFD87AA0C9D18E1194544E438,30891,18,22,4,109.59431,18.28389,1865
8402,64105,10526BE112ADB237730F205D73F11651,31681,0,1,1,109.40396,18.29979,1168
8403,64106,10526BE112ADB237730F205D73F11651,38903,2,6,4,109.39229,18.29243,1117
8404,64107,10526BE112ADB237730F205D73F11651,60552,6,7,1,109.41729,18.30014,1218
8407,64172,240C7AE62CCCE19BA710707BB926A029,60371,0,3,3,109.53063,18.30056,1618
8408,64173,240C7AE62CCCE19BA710707BB926A029,30071,5,7,2,109.52819,18.30472,1619
8409,64174,240C7AE62CCCE19BA710707BB926A029,31621,8,9,1,109.51035,18.29826,1568
8428,64316,BCE29A3A46F5A479B3F0FA50B11216DE,60631,2,8,6,109.57778,18.27583,1814
8429,64317,BCE29A3A46F5A479B3F0FA50B11216DE,30854,9,10,1,109.56889,18.27076,1763
8430,64318,BCE29A3A46F5A479B3F0FA50B11216DE,31071,11,13,2,109.58257,18.28458,1815
8431,64319,1FA4B82215610E27D44D7E787BF2CCFC,38951,0,7,7,109.48097,18.28868,1416
8432,64320,1FA4B82215610E27D44D7E787BF2CCFC,30971,11,12,1,109.48708,18.29319,1467
8433,64321,1FA4B82215610E27D44D7E787BF2CCFC,38951,13,15,2,109.48097,18.28868,1416
8434,64322,1FA4B82215610E27D44D7E787BF2CCFC,38951,19,20,1,109.48097,18.28868,1416
8450,64467,0D00E0CA974DDA00224ACCD00B993468,30854,0,16,16,109.56889,18.27076,1763
8451,64468,0D00E0CA974DDA00224ACCD00B993468,31071,20,22,2,109.58257,18.28458,1815
8452,64469,0D00E0CA974DDA00224ACCD00B993468,30851,22,23,1,109.5616,18.27396,1713
8470,64524,934029FB5F97BCE114EDCE88F0393A63,30854,0,6,6,109.56889,18.27076,1763
8471,64525,934029FB5F97BCE114EDCE88F0393A63,30234,10,11,1,109.60681,18.29979,1918
8472,64526,934029FB5F97BCE114EDCE88F0393A63,30854,13,23,10,109.56889,18.27076,1763
8473,64527,8D7B9451E0189947198D6AC9CE51CFEE,60391,0,1,1,109.47667,18.28757,1416
8474,64528,8D7B9451E0189947198D6AC9CE51CFEE,30764,2,4,2,109.45806,18.29486,1367
8475,64529,8D7B9451E0189947198D6AC9CE51CFEE,31091,4,18,14,109.41201,18.31222,1170
8476,64530,8D7B9451E0189947198D6AC9CE51CFEE,60391,19,20,1,109.47667,18.28757,1416
8477,64554,96F98526707B06BE1263CCD4F72E07A1,31071,1,8,7,109.58257,18.28458,1815
8478,64555,96F98526707B06BE1263CCD4F72E07A1,31945,10,11,1,109.58021,18.29403,1817
8479,64556,96F98526707B06BE1263CCD4F72E07A1,31071,16,18,2,109.58257,18.28458,1815
8480,64557,96F98526707B06BE1263CCD4F72E07A1,30854,19,20,1,109.56889,18.27076,1763
8496,64659,53490AD77ACCA93C3ED0F3DE79CA488B,31071,0,4,4,109.58257,18.28458,1815
8497,64660,53490AD77ACCA93C3ED0F3DE79CA488B,30854,7,8,1,109.56889,18.27076,1763
8498,64661,53490AD77ACCA93C3ED0F3DE79CA488B,31071,10,12,2,109.58257,18.28458,1815
8499,64662,53490AD77ACCA93C3ED0F3DE79CA488B,30854,14,17,3,109.56889,18.27076,1763
8519,64837,DBB710D279E76C79F1E4B0766F579F8A,31071,1,14,13,109.58257,18.28458,1815
8520,64838,DBB710D279E76C79F1E4B0766F579F8A,30854,14,17,3,109.56889,18.27076,1763
8521,64839,DBB710D279E76C79F1E4B0766F579F8A,31071,21,22,1,109.58257,18.28458,1815
8548,65045,020753EF78F0A0C39658113A3377EA1E,31561,2,6,4,109.56792,18.28479,1765
8549,65046,020753EF78F0A0C39658113A3377EA1E,38153,8,10,2,109.51819,18.25736,1561
8550,65047,020753EF78F0A0C39658113A3377EA1E,31561,12,18,6,109.56792,18.28479,1765
8551,65052,05A57DE8DC0D94268B97E02566D1A0C9,60631,0,8,8,109.57778,18.27583,1814
8552,65053,05A57DE8DC0D94268B97E02566D1A0C9,60351,8,18,10,109.58403,18.28958,1816
8553,65054,05A57DE8DC0D94268B97E02566D1A0C9,60631,21,23,2,109.57778,18.27583,1814
8563,65190,51061B3DE820AF1C1C713EF684728003,31071,0,7,7,109.58257,18.28458,1815
8564,65191,51061B3DE820AF1C1C713EF684728003,30854,7,11,4,109.56889,18.27076,1763
8565,65192,51061B3DE820AF1C1C713EF684728003,31071,12,16,4,109.58257,18.28458,1815
8566,65193,51061B3DE820AF1C1C713EF684728003,30854,20,23,3,109.56889,18.27076,1763
8567,65194,012ABD06F231728C214A4BA917E75B1C,31561,0,4,4,109.56792,18.28479,1765
8568,65195,012ABD06F231728C214A4BA917E75B1C,30851,5,10,5,109.5616,18.27396,1713
8569,65196,012ABD06F231728C214A4BA917E75B1C,31561,11,17,6,109.56792,18.28479,1765
8572,65199,A8E9C7BB918ADAD29A3EA7ACDDCD32D7,38951,0,15,15,109.48097,18.28868,1416
8573,65200,A8E9C7BB918ADAD29A3EA7ACDDCD32D7,38951,16,20,4,109.48097,18.28868,1416
8574,65201,A8E9C7BB918ADAD29A3EA7ACDDCD32D7,38951,20,23,3,109.48097,18.28868,1416
8575,65206,AB25B62B696E140EFF56840EA509FBEC,30854,0,3,3,109.56889,18.27076,1763
8576,65207,AB25B62B696E140EFF56840EA509FBEC,31071,5,7,2,109.58257,18.28458,1815
8577,65208,AB25B62B696E140EFF56840EA509FBEC,30854,7,8,1,109.56889,18.27076,1763
8585,65246,1980C8D409DE9551539224B3D393CDAA,30071,0,10,10,109.52819,18.30472,1619
8586,65247,1980C8D409DE9551539224B3D393CDAA,30071,10,11,1,109.52819,18.30472,1619
8587,65248,1980C8D409DE9551539224B3D393CDAA,60371,11,13,2,109.53063,18.30056,1618
8588,65249,1980C8D409DE9551539224B3D393CDAA,30071,17,23,6,109.52819,18.30472,1619
8592,65274,635914FBAF9BDB855B8CB450E2AE782A,30051,0,1,1,109.48917,18.21215,1453
8593,65275,635914FBAF9BDB855B8CB450E2AE782A,38834,1,2,1,109.47639,18.21146,1403
8594,65276,635914FBAF9BDB855B8CB450E2AE782A,30051,4,22,18,109.48917,18.21215,1453
8595,65283,D9AE11CD16B231308C3F0FB3F53BC3E9,38241,0,7,7,109.54111,18.30542,1669
8596,65284,D9AE11CD16B231308C3F0FB3F53BC3E9,30854,8,13,5,109.56889,18.27076,1763
8597,65285,D9AE11CD16B231308C3F0FB3F53BC3E9,31071,13,15,2,109.58257,18.28458,1815
8600,65324,372B6FDE38B899AE3F54A72097165114,39183,0,14,14,109.55542,18.28208,1715
8601,65325,372B6FDE38B899AE3F54A72097165114,31561,14,16,2,109.56792,18.28479,1765
8602,65326,372B6FDE38B899AE3F54A72097165114,39183,17,23,6,109.55542,18.28208,1715
8608,65363,43E035AE85036EBD9891453E9567CB81,30151,0,7,7,109.50986,18.25083,1560
8609,65364,43E035AE85036EBD9891453E9567CB81,60361,12,15,3,109.51938,18.29681,1567
8610,65365,43E035AE85036EBD9891453E9567CB81,31041,18,20,2,109.50278,18.23701,1507
8611,65366,43E035AE85036EBD9891453E9567CB81,30151,21,23,2,109.50986,18.25083,1560
8638,65576,D4AA3869830031578B573FD0033C24A8,31931,0,8,8,109.54771,18.29403,1667
8639,65577,D4AA3869830031578B573FD0033C24A8,30921,9,10,1,109.53903,18.29451,1667
8640,65578,D4AA3869830031578B573FD0033C24A8,31931,10,23,13,109.54771,18.29403,1667
8657,65788,A3F1A757214C25A449688115E5C4321B,60371,0,12,12,109.53063,18.30056,1618
8658,65789,A3F1A757214C25A449688115E5C4321B,30071,16,18,2,109.52819,18.30472,1619
8659,65790,A3F1A757214C25A449688115E5C4321B,31931,22,23,1,109.54771,18.29403,1667
8664,65882,528DF0E8B4B73FA0C9FB75037E21B5BA,31931,0,13,13,109.54771,18.29403,1667
8665,65883,528DF0E8B4B73FA0C9FB75037E21B5BA,60241,17,18,1,109.53319,18.28667,1616
8666,65884,528DF0E8B4B73FA0C9FB75037E21B5BA,31931,22,23,1,109.54771,18.29403,1667
8674,65985,A503639E15A0B5D04B0130D882921438,31031,0,17,17,109.49979,18.25382,1510
8675,65986,A503639E15A0B5D04B0130D882921438,30421,17,20,3,109.50021,18.25861,1511
8676,65987,A503639E15A0B5D04B0130D882921438,31031,20,23,3,109.49979,18.25382,1510
8682,66062,AC0E940CA4876D60068799AC7DD06B30,31391,0,11,11,109.50382,18.24285,1508
8683,66063,AC0E940CA4876D60068799AC7DD06B30,30281,13,14,1,109.50597,18.27583,1514
8684,66064,AC0E940CA4876D60068799AC7DD06B30,39111,18,20,2,109.5191,18.22597,1555
8689,66131,00FC332040A284DA251A8D0705989FE9,31071,2,7,5,109.58257,18.28458,1815
8690,66132,00FC332040A284DA251A8D0705989FE9,30854,7,21,14,109.56889,18.27076,1763
8691,66133,00FC332040A284DA251A8D0705989FE9,31071,21,23,2,109.58257,18.28458,1815
8692,66134,96C474E5BFF92BC21432A4ADDD7A543D,30854,1,8,7,109.56889,18.27076,1763
8693,66135,96C474E5BFF92BC21432A4ADDD7A543D,31071,9,11,2,109.58257,18.28458,1815
8694,66136,96C474E5BFF92BC21432A4ADDD7A543D,30854,11,21,10,109.56889,18.27076,1763
8695,66137,96C474E5BFF92BC21432A4ADDD7A543D,31761,22,23,1,109.60521,18.27965,1914
8715,66350,4952E844CCE6B5C80C460AFAA592A5D2,60491,0,9,9,109.43354,18.30847,1269
8716,66351,4952E844CCE6B5C80C460AFAA592A5D2,60371,11,19,8,109.53063,18.30056,1618
8717,66352,4952E844CCE6B5C80C460AFAA592A5D2,30071,20,21,1,109.52819,18.30472,1619
8718,66356,B34415F599F0ED7D1A073EE314A60B9B,31671,0,10,10,109.38965,18.29813,1068
8719,66357,B34415F599F0ED7D1A073EE314A60B9B,60041,11,12,1,109.39889,18.31944,1121
8720,66358,B34415F599F0ED7D1A073EE314A60B9B,31671,14,23,9,109.38965,18.29813,1068
8723,66393,0CD3A9451B945A7EABB5A7155C5317AC,30711,1,9,8,109.50271,18.25347,1510
8724,66394,0CD3A9451B945A7EABB5A7155C5317AC,30711,12,13,1,109.50271,18.25347,1510
8725,66395,0CD3A9451B945A7EABB5A7155C5317AC,30711,14,18,4,109.50271,18.25347,1510
8726,66396,0CD3A9451B945A7EABB5A7155C5317AC,30421,18,20,2,109.50021,18.25861,1511
8729,66442,DFEFB1CD7965FB8E2BDF1B532ED92233,31931,0,8,8,109.54771,18.29403,1667
8730,66443,DFEFB1CD7965FB8E2BDF1B532ED92233,30921,9,12,3,109.53903,18.29451,1667
8731,66444,DFEFB1CD7965FB8E2BDF1B532ED92233,60631,14,17,3,109.57778,18.27583,1814
8732,66445,DFEFB1CD7965FB8E2BDF1B532ED92233,30921,21,23,2,109.53903,18.29451,1667
8756,66604,7094512B15E4EF60EF67A3E6DEAF677A,60594,0,8,8,109.62694,18.22799,1956
8757,66605,7094512B15E4EF60EF67A3E6DEAF677A,38052,8,12,4,109.62618,18.23042,1956
8758,66606,7094512B15E4EF60EF67A3E6DEAF677A,38052,12,16,4,109.62618,18.23042,1956
8759,66607,7094512B15E4EF60EF67A3E6DEAF677A,38052,17,19,2,109.62618,18.23042,1956
8760,66645,EA446444DFE25212830F95291C13D19D,31931,0,16,16,109.54771,18.29403,1667
8761,66646,EA446444DFE25212830F95291C13D19D,39181,17,18,1,109.55153,18.28035,1715
8762,66647,EA446444DFE25212830F95291C13D19D,31931,19,21,2,109.54771,18.29403,1667
8779,66845,2EE87E32F61D076A80AF4573D60352AD,60614,1,8,7,109.48799,18.29521,1467
8780,66846,2EE87E32F61D076A80AF4573D60352AD,38951,9,10,1,109.48097,18.28868,1416
8781,66847,2EE87E32F61D076A80AF4573D60352AD,38951,13,19,6,109.48097,18.28868,1416
8796,67105,FCFB14BA36BDB7CD6A39612B9AE933B2,38127,0,4,4,109.50833,18.27222,1513
8797,67106,FCFB14BA36BDB7CD6A39612B9AE933B2,31931,9,10,1,109.54771,18.29403,1667
8798,67107,FCFB14BA36BDB7CD6A39612B9AE933B2,39181,12,13,1,109.55153,18.28035,1715
8810,67172,D8757A808F606352AF3AC0BD9CD2C12A,30671,0,6,6,109.43611,18.30139,1268
8811,67173,D8757A808F606352AF3AC0BD9CD2C12A,60491,7,11,4,109.43354,18.30847,1269
8812,67174,D8757A808F606352AF3AC0BD9CD2C12A,30671,11,13,2,109.43611,18.30139,1268
8813,67182,53B443662130EB5C95A209BD2C82316A,30741,0,9,9,109.49833,18.28681,1516
8814,67183,53B443662130EB5C95A209BD2C82316A,60261,10,11,1,109.44326,18.3075,1319
8815,67184,53B443662130EB5C95A209BD2C82316A,30741,11,14,3,109.49833,18.28681,1516
8818,67231,079A114D194FE2EFB0C89059CA4EBC03,31251,0,1,1,109.18528,18.2975,317
8819,67233,079A114D194FE2EFB0C89059CA4EBC03,31251,11,13,2,109.18528,18.2975,317
8820,67235,079A114D194FE2EFB0C89059CA4EBC03,31251,17,18,1,109.18528,18.2975,317
8821,67237,079A114D194FE2EFB0C89059CA4EBC03,31251,22,23,1,109.18528,18.2975,317
8837,67356,C6C3BC01E542B810EF853FEEB6C81198,60361,0,6,6,109.51938,18.29681,1567
8838,67357,C6C3BC01E542B810EF853FEEB6C81198,60221,9,10,1,109.52569,18.29188,1616
8839,67358,C6C3BC01E542B810EF853FEEB6C81198,60361,11,18,7,109.51938,18.29681,1567
8842,67402,6C0260646767B781577B5B8CE2471E51,38484,0,1,1,109.53028,18.31528,1620
8843,67403,6C0260646767B781577B5B8CE2471E51,60614,2,3,1,109.48799,18.29521,1467
8844,67404,6C0260646767B781577B5B8CE2471E51,38241,7,9,2,109.54111,18.30542,1669
8845,67405,6C0260646767B781577B5B8CE2471E51,38484,11,22,11,109.53028,18.31528,1620
8846,67446,8F6EA1C108FADA76A214A7ED71ECE3D1,39183,1,4,3,109.55542,18.28208,1715
8847,67447,8F6EA1C108FADA76A214A7ED71ECE3D1,30854,7,18,11,109.56889,18.27076,1763
8848,67448,8F6EA1C108FADA76A214A7ED71ECE3D1,30891,22,23,1,109.59431,18.28389,1865
8861,67532,CFFDD1BF3134B9FDD71614F40E1DE0FD,31561,3,4,1,109.56792,18.28479,1765
8862,67533,CFFDD1BF3134B9FDD71614F40E1DE0FD,30854,6,7,1,109.56889,18.27076,1763
8863,67534,CFFDD1BF3134B9FDD71614F40E1DE0FD,31071,8,20,12,109.58257,18.28458,1815
8868,67619,FE95B3A32EFBC2838F293DF38F55FDD1,31931,0,5,5,109.54771,18.29403,1667
8869,67620,FE95B3A32EFBC2838F293DF38F55FDD1,39183,8,9,1,109.55542,18.28208,1715
8870,67621,FE95B3A32EFBC2838F293DF38F55FDD1,31931,9,10,1,109.54771,18.29403,1667
8871,67622,FE95B3A32EFBC2838F293DF38F55FDD1,39183,13,18,5,109.55542,18.28208,1715
8878,67690,FDA4F1BDCC2C826EAA49A048FC9F710C,38951,1,6,5,109.48097,18.28868,1416
8879,67691,FDA4F1BDCC2C826EAA49A048FC9F710C,30971,8,11,3,109.48708,18.29319,1467
8880,67692,FDA4F1BDCC2C826EAA49A048FC9F710C,38951,12,19,7,109.48097,18.28868,1416
8893,67796,7C16827D646BDC874DE2BD7EE32189C5,60631,1,7,6,109.57778,18.27583,1814
8894,67797,7C16827D646BDC874DE2BD7EE32189C5,30854,11,12,1,109.56889,18.27076,1763
8895,67798,7C16827D646BDC874DE2BD7EE32189C5,30891,12,13,1,109.59431,18.28389,1865
8896,67799,7C16827D646BDC874DE2BD7EE32189C5,30854,18,19,1,109.56889,18.27076,1763
8927,68099,45D6FEED987FF96C23D5532C0D645AC3,38127,0,7,7,109.50833,18.27222,1513
8928,68100,45D6FEED987FF96C23D5532C0D645AC3,30681,7,11,4,109.48493,18.26917,1463
8929,68101,45D6FEED987FF96C23D5532C0D645AC3,38127,12,23,11,109.50833,18.27222,1513
8932,68136,68DBE0B52FD0AB95F1DD47068FD7847F,60311,0,8,8,109.52097,18.24319,1558
8933,68137,68DBE0B52FD0AB95F1DD47068FD7847F,30181,8,11,3,109.51597,18.23313,1557
8934,68138,68DBE0B52FD0AB95F1DD47068FD7847F,60311,12,14,2,109.52097,18.24319,1558
8944,68310,BE846F126888513CE6D470563DFBDB18,31554,0,17,17,109.55521,18.2459,1709
8945,68311,BE846F126888513CE6D470563DFBDB18,31031,18,21,3,109.49979,18.25382,1510
8946,68312,BE846F126888513CE6D470563DFBDB18,31554,21,23,2,109.55521,18.2459,1709
8952,68381,467C8511E86D253BF99620140D63CB78,31143,0,8,8,109.19986,18.29875,368
8953,68382,467C8511E86D253BF99620140D63CB78,31145,8,10,2,109.20431,18.30479,369
8954,68383,467C8511E86D253BF99620140D63CB78,31781,10,11,1,109.19847,18.2975,367
8959,68421,8CA8213586CAC00347DCD29330308F27,30921,3,4,1,109.53903,18.29451,1667
8960,68422,8CA8213586CAC00347DCD29330308F27,31931,5,7,2,109.54771,18.29403,1667
8961,68423,8CA8213586CAC00347DCD29330308F27,30921,8,11,3,109.53903,18.29451,1667
8962,68424,8CA8213586CAC00347DCD29330308F27,31931,11,21,10,109.54771,18.29403,1667
8965,68438,90D91A493F9482486DCC3B27CF3F61EE,30854,0,7,7,109.56889,18.27076,1763
8966,68439,90D91A493F9482486DCC3B27CF3F61EE,31071,11,13,2,109.58257,18.28458,1815
8967,68440,90D91A493F9482486DCC3B27CF3F61EE,30854,15,16,1,109.56889,18.27076,1763
8970,68456,9BD095517798346F169AD6D898CA1A42,60361,0,18,18,109.51938,18.29681,1567
8971,68457,9BD095517798346F169AD6D898CA1A42,60221,19,21,2,109.52569,18.29188,1616
8972,68458,9BD095517798346F169AD6D898CA1A42,60361,21,23,2,109.51938,18.29681,1567
8989,68576,DD8DCE806AFFEAC5D779812E5F8F2B3D,31561,0,17,17,109.56792,18.28479,1765
8990,68577,DD8DCE806AFFEAC5D779812E5F8F2B3D,30854,18,20,2,109.56889,18.27076,1763
8991,68578,DD8DCE806AFFEAC5D779812E5F8F2B3D,31561,20,21,1,109.56792,18.28479,1765
8992,68602,104D50A9C0319F25E132948E6191A1E5,30271,0,8,8,109.49132,18.23153,1456
8993,68603,104D50A9C0319F25E132948E6191A1E5,60161,9,11,2,109.49174,18.26181,1461
8994,68604,104D50A9C0319F25E132948E6191A1E5,30271,12,13,1,109.49132,18.23153,1456
8995,68605,104D50A9C0319F25E132948E6191A1E5,30051,15,16,1,109.48917,18.21215,1453
9007,68713,13104A6A71A054F852B52BB76993ADB2,30854,0,6,6,109.56889,18.27076,1763
9008,68714,13104A6A71A054F852B52BB76993ADB2,30851,6,16,10,109.5616,18.27396,1713
9009,68715,13104A6A71A054F852B52BB76993ADB2,30854,19,23,4,109.56889,18.27076,1763
9017,68832,875F4B80762D0E664890361D764F907D,60081,0,7,7,109.51097,18.22639,1556
9018,68833,875F4B80762D0E664890361D764F907D,30571,7,18,11,109.50243,18.21861,1504
9019,68834,875F4B80762D0E664890361D764F907D,60081,19,23,4,109.51097,18.22639,1556
9022,69031,C17F2EF1DEA79C8C951E3013EE071B2C,31071,0,8,8,109.58257,18.28458,1815
9023,69032,C17F2EF1DEA79C8C951E3013EE071B2C,30854,12,18,6,109.56889,18.27076,1763
9024,69033,C17F2EF1DEA79C8C951E3013EE071B2C,31071,19,23,4,109.58257,18.28458,1815
9031,69154,DE841C2C767041F00D7DAF75FFC633F6,30771,2,5,3,109.49938,18.26042,1511
9032,69155,DE841C2C767041F00D7DAF75FFC633F6,30421,6,21,15,109.50021,18.25861,1511
9033,69156,DE841C2C767041F00D7DAF75FFC633F6,31561,22,23,1,109.56792,18.28479,1765
9036,69255,8621CFDF1B89A83351494618C53D033F,39181,2,4,2,109.55153,18.28035,1715
9037,69256,8621CFDF1B89A83351494618C53D033F,39181,5,6,1,109.55153,18.28035,1715
9038,69257,8621CFDF1B89A83351494618C53D033F,39183,11,12,1,109.55542,18.28208,1715
9039,69258,8621CFDF1B89A83351494618C53D033F,31071,12,23,11,109.58257,18.28458,1815
9043,69281,BE7763F8096EB5A037146E1CC4190538,30854,1,2,1,109.56889,18.27076,1763
9044,69282,BE7763F8096EB5A037146E1CC4190538,30851,4,5,1,109.5616,18.27396,1713
9045,69283,BE7763F8096EB5A037146E1CC4190538,30854,6,8,2,109.56889,18.27076,1763
9046,69284,BE7763F8096EB5A037146E1CC4190538,31561,8,22,14,109.56792,18.28479,1765
9047,69288,5A1C4533F331B639AE5D3D6E2930E30B,31945,0,2,2,109.58021,18.29403,1817
9048,69289,5A1C4533F331B639AE5D3D6E2930E30B,60631,5,6,1,109.57778,18.27583,1814
9049,69290,5A1C4533F331B639AE5D3D6E2930E30B,30854,7,11,4,109.56889,18.27076,1763
9050,69291,5A1C4533F331B639AE5D3D6E2930E30B,31945,11,23,12,109.58021,18.29403,1817
9074,69526,971FAC974FC919EB70A5D4943C3307C0,38275,0,5,5,109.62875,18.22938,2006
9075,69527,971FAC974FC919EB70A5D4943C3307C0,38052,6,7,1,109.62618,18.23042,1956
9076,69528,971FAC974FC919EB70A5D4943C3307C0,38052,9,11,2,109.62618,18.23042,1956
9079,69643,2DDF3A993BD69F79020EB97CF3A71819,38171,1,6,5,109.50799,18.28139,1515
9080,69644,2DDF3A993BD69F79020EB97CF3A71819,30161,7,16,9,109.50042,18.24389,1508
9081,69645,2DDF3A993BD69F79020EB97CF3A71819,30161,17,19,2,109.50042,18.24389,1508
9082,69646,2DDF3A993BD69F79020EB97CF3A71819,30161,22,23,1,109.50042,18.24389,1508
9083,69670,706B8E0F0F5D1C9FC2F8EBB2574EE89F,30711,0,11,11,109.50271,18.25347,1510
9084,69671,706B8E0F0F5D1C9FC2F8EBB2574EE89F,31461,11,13,2,109.5091,18.25389,1510
9085,69672,706B8E0F0F5D1C9FC2F8EBB2574EE89F,30711,14,19,5,109.50271,18.25347,1510
9086,69673,706B8E0F0F5D1C9FC2F8EBB2574EE89F,31461,19,23,4,109.5091,18.25389,1510
9091,69706,34A1BA5A97F90C4ABB34EDC7004774A9,30851,3,4,1,109.5616,18.27396,1713
9092,69707,34A1BA5A97F90C4ABB34EDC7004774A9,31071,7,16,9,109.58257,18.28458,1815
9093,69708,34A1BA5A97F90C4ABB34EDC7004774A9,30851,18,19,1,109.5616,18.27396,1713
9097,69737,580E03A111E839B85E7FD8688310DCFE,31071,0,5,5,109.58257,18.28458,1815
9098,69738,580E03A111E839B85E7FD8688310DCFE,30854,7,8,1,109.56889,18.27076,1763
9099,69739,580E03A111E839B85E7FD8688310DCFE,30851,8,9,1,109.5616,18.27396,1713
9100,69740,580E03A111E839B85E7FD8688310DCFE,30854,11,13,2,109.56889,18.27076,1763
9104,69768,ADAB51A6D99BADC8222FC392D72ADA01,60281,0,16,16,109.51743,18.25924,1561
9105,69769,ADAB51A6D99BADC8222FC392D72ADA01,38291,16,17,1,109.51618,18.24313,1558
9106,69770,ADAB51A6D99BADC8222FC392D72ADA01,60281,18,23,5,109.51743,18.25924,1561
9110,69792,0547C7536E43628EF24935F0C2BF5E2C,30921,0,6,6,109.53903,18.29451,1667
9111,69793,0547C7536E43628EF24935F0C2BF5E2C,31931,8,18,10,109.54771,18.29403,1667
9112,69794,0547C7536E43628EF24935F0C2BF5E2C,30921,19,23,4,109.53903,18.29451,1667
9115,69827,5EBEA276FCB4A19AC5C987F5C7CC8908,60552,0,1,1,109.41729,18.30014,1218
9116,69828,5EBEA276FCB4A19AC5C987F5C7CC8908,38361,3,10,7,109.43667,18.29201,1267
9117,69829,5EBEA276FCB4A19AC5C987F5C7CC8908,60552,14,16,2,109.41729,18.30014,1218
9118,69830,5EBEA276FCB4A19AC5C987F5C7CC8908,60401,19,21,2,109.47444,18.27583,1414
9119,69833,F3EA7BB85A440E2BE2D597787EA5279B,30051,0,2,2,109.48917,18.21215,1453
9120,69834,F3EA7BB85A440E2BE2D597787EA5279B,60235,2,3,1,109.49269,18.2253,1455
9121,69835,F3EA7BB85A440E2BE2D597787EA5279B,30051,4,22,18,109.48917,18.21215,1453
9122,69836,F3EA7BB85A440E2BE2D597787EA5279B,38834,22,23,1,109.47639,18.21146,1403
9125,69839,93EAC7B29C41BCCE26391CB550587732,31071,0,13,13,109.58257,18.28458,1815
9126,69840,93EAC7B29C41BCCE26391CB550587732,30854,15,16,1,109.56889,18.27076,1763
9127,69841,93EAC7B29C41BCCE26391CB550587732,31071,16,23,7,109.58257,18.28458,1815
9136,69881,A4132C7C24D4F6CFBC6C091695995585,30631,0,8,8,109.34382,18.32778,922
9137,69882,A4132C7C24D4F6CFBC6C091695995585,31691,8,10,2,109.36604,18.3075,1019
9138,69883,A4132C7C24D4F6CFBC6C091695995585,30631,11,23,12,109.34382,18.32778,922
9142,69919,0312B43ACF9ED1D8304E325E851AEE29,30851,0,9,9,109.5616,18.27396,1713
9143,69920,0312B43ACF9ED1D8304E325E851AEE29,31561,9,10,1,109.56792,18.28479,1765
9144,69921,0312B43ACF9ED1D8304E325E851AEE29,30851,11,23,12,109.5616,18.27396,1713
9145,69928,1FC5887E4053936D3ED4D738338DC172,30121,0,7,7,109.52861,18.27222,1613
9146,69929,1FC5887E4053936D3ED4D738338DC172,30951,8,20,12,109.56208,18.25667,1761
9147,69930,1FC5887E4053936D3ED4D738338DC172,30851,20,21,1,109.5616,18.27396,1713
9154,70187,0C8D15C0488D521680F0DE3A28CFE111,31811,0,5,5,109.54201,18.31806,1671
9155,70188,0C8D15C0488D521680F0DE3A28CFE111,30701,7,8,1,109.59313,18.32007,1871
9156,70189,0C8D15C0488D521680F0DE3A28CFE111,31811,9,10,1,109.54201,18.31806,1671
9157,70190,0C8D15C0488D521680F0DE3A28CFE111,30701,13,23,10,109.59313,18.32007,1871
9160,70207,9EDFD2B8D3582651294FE5EAE6936C28,31071,0,1,1,109.58257,18.28458,1815
9161,70208,9EDFD2B8D3582651294FE5EAE6936C28,30891,2,5,3,109.59431,18.28389,1865
9162,70209,9EDFD2B8D3582651294FE5EAE6936C28,30854,9,12,3,109.56889,18.27076,1763
9170,70248,6B806948BC9187A91D033B4096721B00,31561,1,5,4,109.56792,18.28479,1765
9171,70249,6B806948BC9187A91D033B4096721B00,30851,9,10,1,109.5616,18.27396,1713
9172,70250,6B806948BC9187A91D033B4096721B00,31071,11,19,8,109.58257,18.28458,1815
9173,70251,6B806948BC9187A91D033B4096721B00,31561,21,22,1,109.56792,18.28479,1765
9192,70493,14DC9638CB494ECD60B58F300BAA61B6,39181,0,8,8,109.55153,18.28035,1715
9193,70494,14DC9638CB494ECD60B58F300BAA61B6,39183,12,13,1,109.55542,18.28208,1715
9194,70495,14DC9638CB494ECD60B58F300BAA61B6,39181,15,23,8,109.55153,18.28035,1715
9206,70726,0133DDFFB5CECBB261CEDEF10A82D50B,31561,0,6,6,109.56792,18.28479,1765
9207,70727,0133DDFFB5CECBB261CEDEF10A82D50B,30854,10,11,1,109.56889,18.27076,1763
9208,70728,0133DDFFB5CECBB261CEDEF10A82D50B,31071,12,14,2,109.58257,18.28458,1815
9209,70729,0133DDFFB5CECBB261CEDEF10A82D50B,31561,15,22,7,109.56792,18.28479,1765
9236,70866,C709D01469E0800AF998DFAF42105CDC,30854,0,14,14,109.56889,18.27076,1763
9237,70867,C709D01469E0800AF998DFAF42105CDC,60631,14,15,1,109.57778,18.27583,1814
9238,70868,C709D01469E0800AF998DFAF42105CDC,30854,15,23,8,109.56889,18.27076,1763
9239,70884,3E8D95DB166242F89F212C4CA8890528,60241,0,6,6,109.53319,18.28667,1616
9240,70885,3E8D95DB166242F89F212C4CA8890528,38171,7,8,1,109.50799,18.28139,1515
9241,70886,3E8D95DB166242F89F212C4CA8890528,30281,9,12,3,109.50597,18.27583,1514
9242,70894,173CD7A2B7B334BC53A50A1D248FBCFE,30854,5,9,4,109.56889,18.27076,1763
9243,70895,173CD7A2B7B334BC53A50A1D248FBCFE,31071,9,10,1,109.58257,18.28458,1815
9244,70896,173CD7A2B7B334BC53A50A1D248FBCFE,30854,14,21,7,109.56889,18.27076,1763
9259,71042,2C3BD53A8702A47FB82F05FB4993B683,31561,0,14,14,109.56792,18.28479,1765
9260,71043,2C3BD53A8702A47FB82F05FB4993B683,30854,14,18,4,109.56889,18.27076,1763
9261,71044,2C3BD53A8702A47FB82F05FB4993B683,31561,20,23,3,109.56792,18.28479,1765
9276,71107,FA44C74EF9DE654EAA8C2322E5CCBD29,31071,0,1,1,109.58257,18.28458,1815
9277,71108,FA44C74EF9DE654EAA8C2322E5CCBD29,31761,3,4,1,109.60521,18.27965,1914
9278,71109,FA44C74EF9DE654EAA8C2322E5CCBD29,31071,5,23,18,109.58257,18.28458,1815
9316,71443,B712327B6033C61F37801CFD6DAC08AD,38484,1,3,2,109.53028,18.31528,1620
9317,71444,B712327B6033C61F37801CFD6DAC08AD,31951,4,5,1,109.52174,18.30299,1568
9318,71445,B712327B6033C61F37801CFD6DAC08AD,38484,6,14,8,109.53028,18.31528,1620
9342,71592,89362A3CA3AE6F5B75871F2110924F99,30851,0,7,7,109.5616,18.27396,1713
9343,71593,89362A3CA3AE6F5B75871F2110924F99,30951,8,17,9,109.56208,18.25667,1761
9344,71594,89362A3CA3AE6F5B75871F2110924F99,30851,19,23,4,109.5616,18.27396,1713
9348,71679,B78E7295CB13532B4E2C30EF158E297F,30854,0,7,7,109.56889,18.27076,1763
9349,71680,B78E7295CB13532B4E2C30EF158E297F,39183,10,11,1,109.55542,18.28208,1715
9350,71681,B78E7295CB13532B4E2C30EF158E297F,30854,13,23,10,109.56889,18.27076,1763
9380,71936,9770385BF52AD3BEBCA7962FCA51DE84,60231,0,6,6,109.49903,18.21972,1504
9381,71937,9770385BF52AD3BEBCA7962FCA51DE84,39301,7,17,10,109.48361,18.21153,1453
9382,71938,9770385BF52AD3BEBCA7962FCA51DE84,31271,22,23,1,109.48958,18.26257,1462
9383,71939,70A62761FE79F922D082380DA7747243,30854,0,4,4,109.56889,18.27076,1763
9384,71940,70A62761FE79F922D082380DA7747243,31071,4,7,3,109.58257,18.28458,1815
9385,71941,70A62761FE79F922D082380DA7747243,30854,8,21,13,109.56889,18.27076,1763
9386,71950,3BD44570DFFDF065C9FEF492B2F29442,31521,0,8,8,109.51458,18.22542,1555
9387,71952,3BD44570DFFDF065C9FEF492B2F29442,31521,16,18,2,109.51458,18.22542,1555
9388,71953,3BD44570DFFDF065C9FEF492B2F29442,31031,18,22,4,109.49979,18.25382,1510
9394,71998,9AF351B3CC27394DFED45513F0E32162,31071,0,7,7,109.58257,18.28458,1815
9395,71999,9AF351B3CC27394DFED45513F0E32162,30851,8,9,1,109.5616,18.27396,1713
9396,72000,9AF351B3CC27394DFED45513F0E32162,30951,13,16,3,109.56208,18.25667,1761
9397,72001,9AF351B3CC27394DFED45513F0E32162,31071,19,23,4,109.58257,18.28458,1815
9409,72043,608A55C14BAB2A5B627ACC1F39B89FB6,31945,0,7,7,109.58021,18.29403,1817
9410,72044,608A55C14BAB2A5B627ACC1F39B89FB6,30854,7,9,2,109.56889,18.27076,1763
9411,72045,608A55C14BAB2A5B627ACC1F39B89FB6,31945,12,13,1,109.58021,18.29403,1817
9412,72046,608A55C14BAB2A5B627ACC1F39B89FB6,30854,13,16,3,109.56889,18.27076,1763
9431,72220,6DF7485545B790F22810B0EDD8F1B356,31945,0,13,13,109.58021,18.29403,1817
9432,72221,6DF7485545B790F22810B0EDD8F1B356,30854,15,16,1,109.56889,18.27076,1763
9433,72222,6DF7485545B790F22810B0EDD8F1B356,31945,17,22,5,109.58021,18.29403,1817
9478,72566,60B11D9FE0CF3079F76776CA9C4D76C8,31071,2,19,17,109.58257,18.28458,1815
9479,72567,60B11D9FE0CF3079F76776CA9C4D76C8,30854,19,21,2,109.56889,18.27076,1763
9480,72568,60B11D9FE0CF3079F76776CA9C4D76C8,31071,21,23,2,109.58257,18.28458,1815
9481,72596,C1602FB5A20BD98313F7CC13F431D061,60084,1,7,6,109.4984,18.2334,1507
9482,72597,C1602FB5A20BD98313F7CC13F431D061,30771,9,16,7,109.49938,18.26042,1511
9483,72598,C1602FB5A20BD98313F7CC13F431D061,30771,17,19,2,109.49938,18.26042,1511
9484,72599,C1602FB5A20BD98313F7CC13F431D061,30271,21,23,2,109.49132,18.23153,1456
9503,72786,B37777551ADDE84A1FDFE1FF465C24DC,30921,2,5,3,109.53903,18.29451,1667
9504,72787,B37777551ADDE84A1FDFE1FF465C24DC,31931,9,19,10,109.54771,18.29403,1667
9505,72788,B37777551ADDE84A1FDFE1FF465C24DC,30921,19,21,2,109.53903,18.29451,1667
9506,72789,B37777551ADDE84A1FDFE1FF465C24DC,31931,22,23,1,109.54771,18.29403,1667
9512,72800,E5498B89122F0B814DF15FAF2B624D23,30234,0,10,10,109.60681,18.29979,1918
9513,72801,E5498B89122F0B814DF15FAF2B624D23,60091,12,14,2,109.59729,18.30431,1869
9514,72802,E5498B89122F0B814DF15FAF2B624D23,30234,17,21,4,109.60681,18.29979,1918
9515,72803,E5498B89122F0B814DF15FAF2B624D23,30854,21,23,2,109.56889,18.27076,1763
9518,72882,2A6BA0678DDF16AF08BAC9E3FA3C9391,31561,1,6,5,109.56792,18.28479,1765
9519,72883,2A6BA0678DDF16AF08BAC9E3FA3C9391,30854,9,19,10,109.56889,18.27076,1763
9520,72884,2A6BA0678DDF16AF08BAC9E3FA3C9391,31561,19,21,2,109.56792,18.28479,1765
9521,72912,25AEFF32B0667D26540E580A39012DE0,38141,0,6,6,109.39479,18.2916,1116
9522,72913,25AEFF32B0667D26540E580A39012DE0,31471,9,11,2,109.34583,18.29563,917
9523,72914,25AEFF32B0667D26540E580A39012DE0,38141,14,18,4,109.39479,18.2916,1116
9524,72915,25AEFF32B0667D26540E580A39012DE0,38141,22,23,1,109.39479,18.2916,1116
9549,73097,ABCD0851CC1C78BCD7AF6DBDF2F5DE49,60524,0,12,12,109.42951,18.28993,1216
9550,73098,ABCD0851CC1C78BCD7AF6DBDF2F5DE49,30671,14,15,1,109.43611,18.30139,1268
9551,73099,ABCD0851CC1C78BCD7AF6DBDF2F5DE49,60552,15,20,5,109.41729,18.30014,1218
9566,73195,95ED95A5BB76719BE5F5E1272F8C7771,60361,1,5,4,109.51938,18.29681,1567
9567,73196,95ED95A5BB76719BE5F5E1272F8C7771,30071,6,7,1,109.52819,18.30472,1619
9568,73197,95ED95A5BB76719BE5F5E1272F8C7771,60671,8,9,1,109.52979,18.31757,1621
9569,73198,95ED95A5BB76719BE5F5E1272F8C7771,30071,9,20,11,109.52819,18.30472,1619
9572,73240,EF727BDF3D7B6D877CF0038228740019,60401,4,6,2,109.47444,18.27583,1414
9573,73241,EF727BDF3D7B6D877CF0038228740019,30711,9,11,2,109.50271,18.25347,1510
9574,73242,EF727BDF3D7B6D877CF0038228740019,30711,14,23,9,109.50271,18.25347,1510
9581,73320,2361E8D6BAB0231B2E8E3C0F34517282,30081,0,15,15,109.50243,18.26632,1512
9582,73321,2361E8D6BAB0231B2E8E3C0F34517282,30291,15,16,1,109.50403,18.27028,1513
9583,73322,2361E8D6BAB0231B2E8E3C0F34517282,30081,19,23,4,109.50243,18.26632,1512
9589,73363,4995463B780282C9C030A19D9F49AEAC,31071,1,7,6,109.58257,18.28458,1815
9590,73364,4995463B780282C9C030A19D9F49AEAC,30854,7,9,2,109.56889,18.27076,1763
9591,73365,4995463B780282C9C030A19D9F49AEAC,31071,11,15,4,109.58257,18.28458,1815
9607,73480,B340EDEF4A878E8DF5CBEC25E465EACE,30854,0,12,12,109.56889,18.27076,1763
9608,73481,B340EDEF4A878E8DF5CBEC25E465EACE,60631,15,17,2,109.57778,18.27583,1814
9609,73482,B340EDEF4A878E8DF5CBEC25E465EACE,30084,21,22,1,109.50118,18.26972,1513
9621,73581,662D882A6A10D0E6C3566690F0A40636,30854,0,6,6,109.56889,18.27076,1763
9622,73582,662D882A6A10D0E6C3566690F0A40636,31071,8,10,2,109.58257,18.28458,1815
9623,73583,662D882A6A10D0E6C3566690F0A40636,30854,15,23,8,109.56889,18.27076,1763
9626,73617,E2CFBC4AD8BA700D32898ABFA9A0C849,60631,1,4,3,109.57778,18.27583,1814
9627,73618,E2CFBC4AD8BA700D32898ABFA9A0C849,38153,8,10,2,109.51819,18.25736,1561
9628,73619,E2CFBC4AD8BA700D32898ABFA9A0C849,30854,14,16,2,109.56889,18.27076,1763
9634,73666,D1EBD1A5A8A922DEF994C933F10DD8DB,31031,0,10,10,109.49979,18.25382,1510
9635,73667,D1EBD1A5A8A922DEF994C933F10DD8DB,60381,11,12,1,109.5241,18.22458,1605
9636,73668,D1EBD1A5A8A922DEF994C933F10DD8DB,60641,17,21,4,109.53854,18.2359,1657
9640,73706,0E0D6E55BB1995EBF85F6B7AA8765E55,60631,1,3,2,109.57778,18.27583,1814
9641,73707,0E0D6E55BB1995EBF85F6B7AA8765E55,30854,3,6,3,109.56889,18.27076,1763
9642,73708,0E0D6E55BB1995EBF85F6B7AA8765E55,60631,6,8,2,109.57778,18.27583,1814
9643,73709,0E0D6E55BB1995EBF85F6B7AA8765E55,30854,10,22,12,109.56889,18.27076,1763
9648,73735,2D39AE6120F2674000C6DBB8A6E572A0,31945,0,6,6,109.58021,18.29403,1817
9649,73736,2D39AE6120F2674000C6DBB8A6E572A0,30854,10,12,2,109.56889,18.27076,1763
9650,73737,2D39AE6120F2674000C6DBB8A6E572A0,31945,12,13,1,109.58021,18.29403,1817
9651,73738,2D39AE6120F2674000C6DBB8A6E572A0,30854,14,17,3,109.56889,18.27076,1763
9652,73769,68011FE052BBE12B354F2950875992AA,31231,0,8,8,109.42597,18.29292,1217
9653,73770,68011FE052BBE12B354F2950875992AA,31231,12,17,5,109.42597,18.29292,1217
9654,73771,68011FE052BBE12B354F2950875992AA,31431,17,18,1,109.44639,18.29042,1316
9655,73772,68011FE052BBE12B354F2950875992AA,31231,21,23,2,109.42597,18.29292,1217
9662,73850,DC0EB400EA24BEE9EB39D315B0E6AEF0,38871,0,8,8,109.44681,18.28625,1316
9663,73851,DC0EB400EA24BEE9EB39D315B0E6AEF0,31351,13,15,2,109.4959,18.28417,1465
9664,73852,DC0EB400EA24BEE9EB39D315B0E6AEF0,38871,17,22,5,109.44681,18.28625,1316
9668,73939,1E7B140C13C6B69278A768C40899DDB0,31091,0,4,4,109.41201,18.31222,1170
9669,73940,1E7B140C13C6B69278A768C40899DDB0,60551,6,8,2,109.42722,18.30111,1218
9670,73941,1E7B140C13C6B69278A768C40899DDB0,60054,11,12,1,109.3016,18.31229,770
9678,74058,E4199729A84482014747EE1ECF3FF7D9,31811,0,5,5,109.54201,18.31806,1671
9679,74059,E4199729A84482014747EE1ECF3FF7D9,30931,7,12,5,109.55653,18.32722,1722
9680,74060,E4199729A84482014747EE1ECF3FF7D9,30101,17,18,1,109.57299,18.33333,1773
9681,74135,1781C3B3F78A7405692A91AC60B38BEF,60041,0,5,5,109.39889,18.31944,1121
9682,74136,1781C3B3F78A7405692A91AC60B38BEF,30631,7,8,1,109.34382,18.32778,922
9683,74137,1781C3B3F78A7405692A91AC60B38BEF,31691,11,13,2,109.36604,18.3075,1019
9687,74148,8554F0A178316702A9146AC053A2336A,30711,0,10,10,109.50271,18.25347,1510
9688,74149,8554F0A178316702A9146AC053A2336A,30421,14,16,2,109.50021,18.25861,1511
9689,74150,8554F0A178316702A9146AC053A2336A,31031,16,18,2,109.49979,18.25382,1510
9692,74199,2576A40187A845D7B849E820F16B3DB1,30854,3,12,9,109.56889,18.27076,1763
9693,74200,2576A40187A845D7B849E820F16B3DB1,31181,14,15,1,109.50382,18.24813,1509
9694,74201,2576A40187A845D7B849E820F16B3DB1,30854,15,19,4,109.56889,18.27076,1763
9704,74340,10526BE112ADB237730F205D73F11651,38903,0,1,1,109.39229,18.29243,1117
9705,74341,10526BE112ADB237730F205D73F11651,38141,1,5,4,109.39479,18.2916,1116
9706,74342,10526BE112ADB237730F205D73F11651,38903,5,7,2,109.39229,18.29243,1117
9707,74343,10526BE112ADB237730F205D73F11651,60552,10,12,2,109.41729,18.30014,1218
9717,74425,994D400389C3C3395B80FB21D74A0E76,38961,0,7,7,109.50847,18.23514,1507
9718,74426,994D400389C3C3395B80FB21D74A0E76,60381,11,13,2,109.5241,18.22458,1605
9719,74427,994D400389C3C3395B80FB21D74A0E76,38961,13,14,1,109.50847,18.23514,1507
9720,74428,994D400389C3C3395B80FB21D74A0E76,31205,19,21,2,109.51111,18.23736,1557
9726,74482,A9FCE0049DB44FE004EAFBF5B783F4A5,31945,0,7,7,109.58021,18.29403,1817
9727,74483,A9FCE0049DB44FE004EAFBF5B783F4A5,30854,11,15,4,109.56889,18.27076,1763
9728,74484,A9FCE0049DB44FE004EAFBF5B783F4A5,31071,17,18,1,109.58257,18.28458,1815
9739,74526,CB9E93D60C42CE31FD30C2DAB592949A,31671,0,2,2,109.38965,18.29813,1068
9740,74527,CB9E93D60C42CE31FD30C2DAB592949A,60561,3,5,2,109.38229,18.29785,1067
9741,74528,CB9E93D60C42CE31FD30C2DAB592949A,31671,6,8,2,109.38965,18.29813,1068
9742,74540,EFFD4571117B023D4BFFAE2F1C9E1510,31201,0,11,11,109.51042,18.23819,1558
9743,74541,EFFD4571117B023D4BFFAE2F1C9E1510,30181,11,13,2,109.51597,18.23313,1557
9744,74542,EFFD4571117B023D4BFFAE2F1C9E1510,60081,13,14,1,109.51097,18.22639,1556
9745,74543,EFFD4571117B023D4BFFAE2F1C9E1510,38961,15,20,5,109.50847,18.23514,1507
9748,74580,84DF4A7C208235D171EF56473BCCF210,30851,0,4,4,109.5616,18.27396,1713
9749,74581,84DF4A7C208235D171EF56473BCCF210,31561,4,7,3,109.56792,18.28479,1765
9750,74582,84DF4A7C208235D171EF56473BCCF210,60631,7,18,11,109.57778,18.27583,1814
9772,74692,BE586ACB441383CC10D7CF3923850B73,60371,0,5,5,109.53063,18.30056,1618
9773,74693,BE586ACB441383CC10D7CF3923850B73,31931,6,7,1,109.54771,18.29403,1667
9774,74694,BE586ACB441383CC10D7CF3923850B73,30851,9,15,6,109.5616,18.27396,1713
9784,74748,D6A345956751BA2ACC5430EDF68A104F,39181,0,6,6,109.55153,18.28035,1715
9785,74749,D6A345956751BA2ACC5430EDF68A104F,31931,7,13,6,109.54771,18.29403,1667
9786,74750,D6A345956751BA2ACC5430EDF68A104F,39181,13,19,6,109.55153,18.28035,1715
9787,74751,D6A345956751BA2ACC5430EDF68A104F,39181,20,23,3,109.55153,18.28035,1715
9793,74792,87FB240A931190D7195CA3A485DD9E27,60351,0,7,7,109.58403,18.28958,1816
9794,74793,87FB240A931190D7195CA3A485DD9E27,30951,9,12,3,109.56208,18.25667,1761
9795,74794,87FB240A931190D7195CA3A485DD9E27,30851,14,19,5,109.5616,18.27396,1713
9796,74795,87FB240A931190D7195CA3A485DD9E27,60351,20,23,3,109.58403,18.28958,1816
9800,74841,6FE9D30AF9D5BAD1F717916B377146E9,31201,3,10,7,109.51042,18.23819,1558
9801,74842,6FE9D30AF9D5BAD1F717916B377146E9,31201,12,18,6,109.51042,18.23819,1558
9802,74843,6FE9D30AF9D5BAD1F717916B377146E9,38961,18,23,5,109.50847,18.23514,1507
9824,74974,F84D949DDCBF25D5530F771BC55E0B9D,61011,2,5,3,109.60653,18.19076,1900
9825,74976,F84D949DDCBF25D5530F771BC55E0B9D,31321,14,16,2,109.63799,18.23201,2007
9826,74977,F84D949DDCBF25D5530F771BC55E0B9D,61011,18,23,5,109.60653,18.19076,1900
9840,75072,121138E269BBF0B506FA8CE6CEB3BF52,31931,0,13,13,109.54771,18.29403,1667
9841,75073,121138E269BBF0B506FA8CE6CEB3BF52,39181,16,17,1,109.55153,18.28035,1715
9842,75074,121138E269BBF0B506FA8CE6CEB3BF52,31931,18,23,5,109.54771,18.29403,1667
9845,75085,9C1407835BC54BEBDB541F52E1DA1820,61011,0,2,2,109.60653,18.19076,1900
9846,75087,9C1407835BC54BEBDB541F52E1DA1820,61011,4,7,3,109.60653,18.19076,1900
9847,75089,9C1407835BC54BEBDB541F52E1DA1820,61011,15,16,1,109.60653,18.19076,1900
9848,75091,9C1407835BC54BEBDB541F52E1DA1820,61011,21,23,2,109.60653,18.19076,1900
9854,75350,55FA72F7A9567EE8C2569F2A3640F92B,60371,0,4,4,109.53063,18.30056,1618
9855,75351,55FA72F7A9567EE8C2569F2A3640F92B,31931,5,7,2,109.54771,18.29403,1667
9856,75352,55FA72F7A9567EE8C2569F2A3640F92B,60371,11,18,7,109.53063,18.30056,1618
9869,75478,1122041491C04B199A15F6E1E401D68F,60281,0,6,6,109.51743,18.25924,1561
9870,75479,1122041491C04B199A15F6E1E401D68F,30851,8,9,1,109.5616,18.27396,1713
9871,75480,1122041491C04B199A15F6E1E401D68F,30854,12,13,1,109.56889,18.27076,1763
9872,75481,1122041491C04B199A15F6E1E401D68F,30851,13,15,2,109.5616,18.27396,1713
9881,75586,012ABD06F231728C214A4BA917E75B1C,30851,0,10,10,109.5616,18.27396,1713
9882,75587,012ABD06F231728C214A4BA917E75B1C,31561,13,15,2,109.56792,18.28479,1765
9883,75588,012ABD06F231728C214A4BA917E75B1C,30851,16,17,1,109.5616,18.27396,1713
9884,75589,012ABD06F231728C214A4BA917E75B1C,31561,19,23,4,109.56792,18.28479,1765
9890,75599,51061B3DE820AF1C1C713EF684728003,31071,1,6,5,109.58257,18.28458,1815
9891,75600,51061B3DE820AF1C1C713EF684728003,30854,10,20,10,109.56889,18.27076,1763
9892,75601,51061B3DE820AF1C1C713EF684728003,31071,21,23,2,109.58257,18.28458,1815
9950,76140,7890099D98AA300C5BF12527E7372DB0,60631,0,14,14,109.57778,18.27583,1814
9951,76141,7890099D98AA300C5BF12527E7372DB0,30854,16,18,2,109.56889,18.27076,1763
9952,76142,7890099D98AA300C5BF12527E7372DB0,60631,20,21,1,109.57778,18.27583,1814
9979,76290,40285EE8CCE25C38988EC087545664EC,31071,2,7,5,109.58257,18.28458,1815
9980,76291,40285EE8CCE25C38988EC087545664EC,30854,7,11,4,109.56889,18.27076,1763
9981,76292,40285EE8CCE25C38988EC087545664EC,31071,11,12,1,109.58257,18.28458,1815
9993,76416,30D8A678A1441E4FFDF2E3F44AE24060,31071,0,9,9,109.58257,18.28458,1815
9994,76417,30D8A678A1441E4FFDF2E3F44AE24060,30854,9,11,2,109.56889,18.27076,1763
9995,76418,30D8A678A1441E4FFDF2E3F44AE24060,31071,14,16,2,109.58257,18.28458,1815
10019,76716,8DA877D3A30401F86E81FB7BC1CA2A00,30854,0,1,1,109.56889,18.27076,1763
10020,76717,8DA877D3A30401F86E81FB7BC1CA2A00,31071,2,5,3,109.58257,18.28458,1815
10021,76718,8DA877D3A30401F86E81FB7BC1CA2A00,30854,5,13,8,109.56889,18.27076,1763
10026,76726,58418A9EA4A7DC03127CB79C039A5185,30854,0,16,16,109.56889,18.27076,1763
10027,76727,58418A9EA4A7DC03127CB79C039A5185,31031,17,18,1,109.49979,18.25382,1510
10028,76728,58418A9EA4A7DC03127CB79C039A5185,60131,20,21,1,109.49819,18.24778,1509
10039,76875,0CD3A9451B945A7EABB5A7155C5317AC,38826,0,10,10,109.50326,18.25514,1510
10040,76876,0CD3A9451B945A7EABB5A7155C5317AC,38251,12,13,1,109.49618,18.25493,1510
10041,76877,0CD3A9451B945A7EABB5A7155C5317AC,31031,14,17,3,109.49979,18.25382,1510
10042,76917,E0A24740E2C54F3B77DB561A91D2BED7,31821,0,6,6,109.51181,18.24924,1559
10043,76918,E0A24740E2C54F3B77DB561A91D2BED7,60281,7,8,1,109.51743,18.25924,1561
10044,76919,E0A24740E2C54F3B77DB561A91D2BED7,30251,8,16,8,109.50611,18.26653,1512
10045,76920,E0A24740E2C54F3B77DB561A91D2BED7,30151,18,23,5,109.50986,18.25083,1560
10058,77213,967E548F53382C36FB0D7FF12F6A99E7,30771,0,8,8,109.49938,18.26042,1511
10059,77214,967E548F53382C36FB0D7FF12F6A99E7,31531,8,14,6,109.49583,18.25972,1461
10060,77215,967E548F53382C36FB0D7FF12F6A99E7,30201,17,23,6,109.4909,18.26465,1462
10067,77233,2F3BB5BE10811E7F8F8565DAA2126DE6,39181,0,5,5,109.55153,18.28035,1715
10068,77234,2F3BB5BE10811E7F8F8565DAA2126DE6,31931,5,14,9,109.54771,18.29403,1667
10069,77235,2F3BB5BE10811E7F8F8565DAA2126DE6,39181,18,23,5,109.55153,18.28035,1715
10085,77367,2225A928A5F41EC3C7691341B4D74A48,38297,1,7,6,109.52576,18.24965,1609
10086,77368,2225A928A5F41EC3C7691341B4D74A48,60281,9,10,1,109.51743,18.25924,1561
10087,77369,2225A928A5F41EC3C7691341B4D74A48,30084,12,14,2,109.50118,18.26972,1513
10088,77405,4370C9D6E8995C0B49B7BF1384E2954D,38951,0,10,10,109.48097,18.28868,1416
10089,77406,4370C9D6E8995C0B49B7BF1384E2954D,30971,12,13,1,109.48708,18.29319,1467
10090,77407,4370C9D6E8995C0B49B7BF1384E2954D,38951,15,18,3,109.48097,18.28868,1416
10091,77408,4370C9D6E8995C0B49B7BF1384E2954D,38951,21,23,2,109.48097,18.28868,1416
10102,77540,2F64FEF19C86AA0A8AA3E3FA37CC4F2D,30854,0,1,1,109.56889,18.27076,1763
10103,77541,2F64FEF19C86AA0A8AA3E3FA37CC4F2D,30851,1,7,6,109.5616,18.27396,1713
10104,77542,2F64FEF19C86AA0A8AA3E3FA37CC4F2D,60631,9,10,1,109.57778,18.27583,1814
10105,77543,2F64FEF19C86AA0A8AA3E3FA37CC4F2D,30854,10,19,9,109.56889,18.27076,1763
10122,77630,7BF65E5054DA81A230AB5423620158E1,60631,0,6,6,109.57778,18.27583,1814
10123,77631,7BF65E5054DA81A230AB5423620158E1,30854,7,9,2,109.56889,18.27076,1763
10124,77632,7BF65E5054DA81A230AB5423620158E1,60631,11,13,2,109.57778,18.27583,1814
10125,77633,7BF65E5054DA81A230AB5423620158E1,30854,13,17,4,109.56889,18.27076,1763
10126,77656,FCF69C4EB20A61D7801C0D8953A36537,31071,0,7,7,109.58257,18.28458,1815
10127,77657,FCF69C4EB20A61D7801C0D8953A36537,31561,7,8,1,109.56792,18.28479,1765
10128,77658,FCF69C4EB20A61D7801C0D8953A36537,31071,12,23,11,109.58257,18.28458,1815
10140,77798,52A7280BA3A0FD171DDC8618F647763C,31521,0,10,10,109.51458,18.22542,1555
10141,77799,52A7280BA3A0FD171DDC8618F647763C,30271,14,16,2,109.49132,18.23153,1456
10142,77800,52A7280BA3A0FD171DDC8618F647763C,38251,19,21,2,109.49618,18.25493,1510
10148,77829,A46BA306DAEA889FAC7ACE9E5FD6A1FF,60331,0,2,2,109.505,18.26507,1512
10149,77830,A46BA306DAEA889FAC7ACE9E5FD6A1FF,39154,5,6,1,109.50201,18.25681,1511
10150,77831,A46BA306DAEA889FAC7ACE9E5FD6A1FF,60331,6,8,2,109.505,18.26507,1512
10155,77849,B84B247FA61A8C12DFCCCF3C2D72006D,31945,1,4,3,109.58021,18.29403,1817
10156,77850,B84B247FA61A8C12DFCCCF3C2D72006D,31071,6,10,4,109.58257,18.28458,1815
10157,77851,B84B247FA61A8C12DFCCCF3C2D72006D,30854,10,11,1,109.56889,18.27076,1763
10158,77852,B84B247FA61A8C12DFCCCF3C2D72006D,31071,15,16,1,109.58257,18.28458,1815
10164,77920,8F6EA1C108FADA76A214A7ED71ECE3D1,30891,0,5,5,109.59431,18.28389,1865
10165,77921,8F6EA1C108FADA76A214A7ED71ECE3D1,30854,6,13,7,109.56889,18.27076,1763
10166,77922,8F6EA1C108FADA76A214A7ED71ECE3D1,30851,15,16,1,109.5616,18.27396,1713
10176,78025,6CBD210FE212796CEDBD8FF4BC0A58A4,39183,4,9,5,109.55542,18.28208,1715
10177,78026,6CBD210FE212796CEDBD8FF4BC0A58A4,31561,10,11,1,109.56792,18.28479,1765
10178,78027,6CBD210FE212796CEDBD8FF4BC0A58A4,39183,12,16,4,109.55542,18.28208,1715
10181,78062,A88B35A7108477CCC954BD53412ECC82,60171,0,7,7,109.51292,18.30694,1569
10182,78063,A88B35A7108477CCC954BD53412ECC82,31951,12,14,2,109.52174,18.30299,1568
10183,78064,A88B35A7108477CCC954BD53412ECC82,38991,15,17,2,109.52681,18.30368,1618
10186,78108,F2E4A1707C14AD7AF444AE9628A7C8BD,30081,2,4,2,109.50243,18.26632,1512
10187,78109,F2E4A1707C14AD7AF444AE9628A7C8BD,30081,5,6,1,109.50243,18.26632,1512
10188,78110,F2E4A1707C14AD7AF444AE9628A7C8BD,30081,7,19,12,109.50243,18.26632,1512
10189,78111,F2E4A1707C14AD7AF444AE9628A7C8BD,30421,19,21,2,109.50021,18.25861,1511
10190,78130,FE95B3A32EFBC2838F293DF38F55FDD1,30854,0,4,4,109.56889,18.27076,1763
10191,78131,FE95B3A32EFBC2838F293DF38F55FDD1,31931,7,9,2,109.54771,18.29403,1667
10192,78132,FE95B3A32EFBC2838F293DF38F55FDD1,39183,9,16,7,109.55542,18.28208,1715
10211,78190,51ED683608E55A4EDEADC423E7C7B6C3,60631,0,10,10,109.57778,18.27583,1814
10212,78191,51ED683608E55A4EDEADC423E7C7B6C3,30854,13,14,1,109.56889,18.27076,1763
10213,78192,51ED683608E55A4EDEADC423E7C7B6C3,60631,15,19,4,109.57778,18.27583,1814
10214,78193,51ED683608E55A4EDEADC423E7C7B6C3,30854,22,23,1,109.56889,18.27076,1763
10226,78286,408C4FED868686E7B96333835F4C4205,31071,0,6,6,109.58257,18.28458,1815
10227,78287,408C4FED868686E7B96333835F4C4205,60631,7,8,1,109.57778,18.27583,1814
10228,78288,408C4FED868686E7B96333835F4C4205,31071,8,11,3,109.58257,18.28458,1815
10229,78289,408C4FED868686E7B96333835F4C4205,30854,12,14,2,109.56889,18.27076,1763
10233,78346,36D79DC35161ADC015B71969A834709A,31391,0,7,7,109.50382,18.24285,1508
10234,78347,36D79DC35161ADC015B71969A834709A,60291,9,12,3,109.50826,18.24639,1509
10235,78348,36D79DC35161ADC015B71969A834709A,31521,12,20,8,109.51458,18.22542,1555
10240,78423,79C0E9CB0924537F3660125B77C46B0B,30321,0,7,7,109.49563,18.29611,1467
10241,78424,79C0E9CB0924537F3660125B77C46B0B,60171,8,12,4,109.51292,18.30694,1569
10242,78425,79C0E9CB0924537F3660125B77C46B0B,30321,12,13,1,109.49563,18.29611,1467
10265,78619,68DBE0B52FD0AB95F1DD47068FD7847F,60311,0,9,9,109.52097,18.24319,1558
10266,78620,68DBE0B52FD0AB95F1DD47068FD7847F,30181,10,13,3,109.51597,18.23313,1557
10267,78621,68DBE0B52FD0AB95F1DD47068FD7847F,60311,14,23,9,109.52097,18.24319,1558
10268,78622,D1437BB9EF0763F2FA311CE7BE9B7FBD,31091,3,4,1,109.41201,18.31222,1170
10269,78623,D1437BB9EF0763F2FA311CE7BE9B7FBD,30351,4,7,3,109.41701,18.29292,1217
10270,78624,D1437BB9EF0763F2FA311CE7BE9B7FBD,31091,7,9,2,109.41201,18.31222,1170
10276,78676,22CF7007721E0F1D863F25E4633BE1AD,60311,0,8,8,109.52097,18.24319,1558
10277,78677,22CF7007721E0F1D863F25E4633BE1AD,38291,12,15,3,109.51618,18.24313,1558
10278,78678,22CF7007721E0F1D863F25E4633BE1AD,30084,16,18,2,109.50118,18.26972,1513
10279,78679,22CF7007721E0F1D863F25E4633BE1AD,60311,20,23,3,109.52097,18.24319,1558
10280,78693,4E9700B026D20ABF45FFBA72DED9D886,38951,0,13,13,109.48097,18.28868,1416
10281,78694,4E9700B026D20ABF45FFBA72DED9D886,38951,14,20,6,109.48097,18.28868,1416
10282,78695,4E9700B026D20ABF45FFBA72DED9D886,31271,20,21,1,109.48958,18.26257,1462
10283,78696,4E9700B026D20ABF45FFBA72DED9D886,38951,22,23,1,109.48097,18.28868,1416
10284,78712,D97D787B9F35A785017D7FF8B4ABF0D7,60381,0,7,7,109.5241,18.22458,1605
10285,78713,D97D787B9F35A785017D7FF8B4ABF0D7,31061,7,8,1,109.53333,18.23257,1607
10286,78714,D97D787B9F35A785017D7FF8B4ABF0D7,60381,12,14,2,109.5241,18.22458,1605
10292,78725,55CDDB1A84A2F40D42C80C17393C28FB,60472,3,15,12,109.46625,18.29542,1367
10293,78726,55CDDB1A84A2F40D42C80C17393C28FB,38951,17,22,5,109.48097,18.28868,1416
10294,78727,55CDDB1A84A2F40D42C80C17393C28FB,38951,22,23,1,109.48097,18.28868,1416
10305,78836,222E0B6922623CE9FBB280F81068D40E,30571,2,11,9,109.50243,18.21861,1504
10306,78837,222E0B6922623CE9FBB280F81068D40E,39321,12,15,3,109.529,18.2167,1604
10307,78838,222E0B6922623CE9FBB280F81068D40E,30731,18,23,5,109.50944,18.22306,1555
10319,79006,19F803FB996471824A8A9928BBFAB433,39181,0,5,5,109.55153,18.28035,1715
10320,79007,19F803FB996471824A8A9928BBFAB433,31931,6,9,3,109.54771,18.29403,1667
10321,79008,19F803FB996471824A8A9928BBFAB433,39181,11,17,6,109.55153,18.28035,1715
10322,79014,104D50A9C0319F25E132948E6191A1E5,30271,0,6,6,109.49132,18.23153,1456
10323,79015,104D50A9C0319F25E132948E6191A1E5,60161,7,10,3,109.49174,18.26181,1461
10324,79016,104D50A9C0319F25E132948E6191A1E5,60084,10,12,2,109.4984,18.2334,1507
10325,79017,104D50A9C0319F25E132948E6191A1E5,30211,12,15,3,109.49882,18.23931,1508
10337,79222,D4EE8E1A4C04A1FF0596E4221D0B8B42,31071,0,6,6,109.58257,18.28458,1815
10338,79223,D4EE8E1A4C04A1FF0596E4221D0B8B42,30854,7,9,2,109.56889,18.27076,1763
10339,79224,D4EE8E1A4C04A1FF0596E4221D0B8B42,31071,11,12,1,109.58257,18.28458,1815
10340,79225,D4EE8E1A4C04A1FF0596E4221D0B8B42,30854,13,17,4,109.56889,18.27076,1763
10343,79244,5A888DC7A3AA300CC584D9862C5384A1,30721,1,6,5,109.51597,18.28257,1565
10344,79245,5A888DC7A3AA300CC584D9862C5384A1,30911,9,10,1,109.50493,18.26181,1511
10345,79246,5A888DC7A3AA300CC584D9862C5384A1,39183,14,16,2,109.55542,18.28208,1715
10346,79247,5A888DC7A3AA300CC584D9862C5384A1,38171,18,19,1,109.50799,18.28139,1515
10347,79277,875F4B80762D0E664890361D764F907D,60081,0,7,7,109.51097,18.22639,1556
10348,79278,875F4B80762D0E664890361D764F907D,30571,7,18,11,109.50243,18.21861,1504
10349,79279,875F4B80762D0E664890361D764F907D,60081,19,22,3,109.51097,18.22639,1556
10350,79351,28FD729A56A38491CC99ABB23711BC1C,39181,0,11,11,109.55153,18.28035,1715
10351,79352,28FD729A56A38491CC99ABB23711BC1C,31931,12,14,2,109.54771,18.29403,1667
10352,79353,28FD729A56A38491CC99ABB23711BC1C,39181,16,23,7,109.55153,18.28035,1715
10353,79360,EA88ED728918442D87692D43C7401C41,30191,0,9,9,109.50361,18.22701,1506
10354,79361,EA88ED728918442D87692D43C7401C41,30361,10,12,2,109.50347,18.24,1508
10355,79362,EA88ED728918442D87692D43C7401C41,30731,13,14,1,109.50944,18.22306,1555
10356,79363,EA88ED728918442D87692D43C7401C41,31521,15,20,5,109.51458,18.22542,1555
10365,79464,1A9D6D9AE0D6F5B000E0E24A10F5D2D5,60371,0,8,8,109.53063,18.30056,1618
10366,79465,1A9D6D9AE0D6F5B000E0E24A10F5D2D5,31931,13,15,2,109.54771,18.29403,1667
10367,79466,1A9D6D9AE0D6F5B000E0E24A10F5D2D5,60371,15,16,1,109.53063,18.30056,1618
10368,79470,8A64E05F17255A0E415C79E9E83BB775,30671,0,3,3,109.43611,18.30139,1268
10369,79471,8A64E05F17255A0E415C79E9E83BB775,31431,4,6,2,109.44639,18.29042,1316
10370,79472,8A64E05F17255A0E415C79E9E83BB775,30671,7,8,1,109.43611,18.30139,1268
10376,79516,8E244E94833DBF281BCBFE2F4A36E102,60641,0,7,7,109.53854,18.2359,1657
10377,79517,8E244E94833DBF281BCBFE2F4A36E102,31421,7,8,1,109.55382,18.22347,1705
10378,79518,8E244E94833DBF281BCBFE2F4A36E102,60641,11,23,12,109.53854,18.2359,1657
10382,79536,17D13F6A66037B54FAB5668CDC734401,30721,0,8,8,109.51597,18.28257,1565
10383,79537,17D13F6A66037B54FAB5668CDC734401,39181,9,11,2,109.55153,18.28035,1715
10384,79538,17D13F6A66037B54FAB5668CDC734401,31931,11,13,2,109.54771,18.29403,1667
10396,79728,8621CFDF1B89A83351494618C53D033F,31071,0,2,2,109.58257,18.28458,1815
10397,79729,8621CFDF1B89A83351494618C53D033F,39181,3,6,3,109.55153,18.28035,1715
10398,79730,8621CFDF1B89A83351494618C53D033F,31071,7,9,2,109.58257,18.28458,1815
10399,79731,8621CFDF1B89A83351494618C53D033F,39181,9,23,14,109.55153,18.28035,1715
10407,79822,37A40745578E15431BB880E6F6297E14,30081,2,8,6,109.50243,18.26632,1512
10408,79823,37A40745578E15431BB880E6F6297E14,30854,8,15,7,109.56889,18.27076,1763
10409,79824,37A40745578E15431BB880E6F6297E14,30081,16,23,7,109.50243,18.26632,1512
10419,79958,74A9CCA48CD6C2DA9FC7DFDB8817D50B,31945,0,6,6,109.58021,18.29403,1817
10420,79959,74A9CCA48CD6C2DA9FC7DFDB8817D50B,30854,11,12,1,109.56889,18.27076,1763
10421,79960,74A9CCA48CD6C2DA9FC7DFDB8817D50B,30851,12,14,2,109.5616,18.27396,1713
10457,80203,ADAB51A6D99BADC8222FC392D72ADA01,60281,0,8,8,109.51743,18.25924,1561
10458,80204,ADAB51A6D99BADC8222FC392D72ADA01,60311,9,10,1,109.52097,18.24319,1558
10459,80205,ADAB51A6D99BADC8222FC392D72ADA01,60281,10,20,10,109.51743,18.25924,1561
10462,80224,ACDEAAF45B65DE48CF80A48DBD3C775E,30854,0,6,6,109.56889,18.27076,1763
10463,80225,ACDEAAF45B65DE48CF80A48DBD3C775E,31071,7,20,13,109.58257,18.28458,1815
10464,80226,ACDEAAF45B65DE48CF80A48DBD3C775E,30854,20,22,2,109.56889,18.27076,1763
10476,80254,A1E318C80BE4457762B208DEDA1DAC8C,60201,0,1,1,109.5041,18.2509,1510
10477,80255,A1E318C80BE4457762B208DEDA1DAC8C,60281,2,7,5,109.51743,18.25924,1561
10478,80256,A1E318C80BE4457762B208DEDA1DAC8C,31461,8,9,1,109.5091,18.25389,1510
10496,80309,1FC5887E4053936D3ED4D738338DC172,30851,0,1,1,109.5616,18.27396,1713
10497,80310,1FC5887E4053936D3ED4D738338DC172,30951,5,15,10,109.56208,18.25667,1761
10498,80311,1FC5887E4053936D3ED4D738338DC172,30851,15,16,1,109.5616,18.27396,1713
10499,80312,1FC5887E4053936D3ED4D738338DC172,30121,18,23,5,109.52861,18.27222,1613
10500,80317,B55959B64746A18ECF5077B5F7359221,31561,0,9,9,109.56792,18.28479,1765
10501,80318,B55959B64746A18ECF5077B5F7359221,30854,11,12,1,109.56889,18.27076,1763
10502,80319,B55959B64746A18ECF5077B5F7359221,31561,12,17,5,109.56792,18.28479,1765
10503,80320,B55959B64746A18ECF5077B5F7359221,39183,20,22,2,109.55542,18.28208,1715
10550,80637,6B806948BC9187A91D033B4096721B00,30854,2,3,1,109.56889,18.27076,1763
10551,80638,6B806948BC9187A91D033B4096721B00,31561,6,7,1,109.56792,18.28479,1765
10552,80639,6B806948BC9187A91D033B4096721B00,31071,9,18,9,109.58257,18.28458,1815
10553,80640,6B806948BC9187A91D033B4096721B00,31561,20,22,2,109.56792,18.28479,1765
10558,80841,5101E60E066B711D5B58F6B6B67BA4EB,30851,0,9,9,109.5616,18.27396,1713
10559,80842,5101E60E066B711D5B58F6B6B67BA4EB,30854,13,17,4,109.56889,18.27076,1763
10560,80843,5101E60E066B711D5B58F6B6B67BA4EB,30851,20,22,2,109.5616,18.27396,1713
10567,81023,3977578BE56276DA0700B04B81DC1356,31561,0,1,1,109.56792,18.28479,1765
10568,81024,3977578BE56276DA0700B04B81DC1356,30851,2,10,8,109.5616,18.27396,1713
10569,81025,3977578BE56276DA0700B04B81DC1356,31561,10,23,13,109.56792,18.28479,1765
10570,81164,3F80F6C7ECC59E36D89C8EF1746C8724,38121,1,6,5,109.51361,18.27813,1564
10571,81165,3F80F6C7ECC59E36D89C8EF1746C8724,38157,8,9,1,109.51483,18.26958,1563
10572,81166,3F80F6C7ECC59E36D89C8EF1746C8724,38121,10,12,2,109.51361,18.27813,1564
10578,81206,451E2BF48CD7B253EB0892324E679BCC,38297,2,3,1,109.52576,18.24965,1609
10579,81207,451E2BF48CD7B253EB0892324E679BCC,60281,7,17,10,109.51743,18.25924,1561
10580,81208,451E2BF48CD7B253EB0892324E679BCC,38291,18,19,1,109.51618,18.24313,1558
10581,81209,451E2BF48CD7B253EB0892324E679BCC,38297,22,23,1,109.52576,18.24965,1609
10582,81249,8883DF5E66B5FC284A8EF97DE8EAAAB3,31071,0,2,2,109.58257,18.28458,1815
10583,81250,8883DF5E66B5FC284A8EF97DE8EAAAB3,39183,4,5,1,109.55542,18.28208,1715
10584,81251,8883DF5E66B5FC284A8EF97DE8EAAAB3,30854,5,16,11,109.56889,18.27076,1763
10585,81252,8883DF5E66B5FC284A8EF97DE8EAAAB3,39183,16,19,3,109.55542,18.28208,1715
10594,81325,2C3BD53A8702A47FB82F05FB4993B683,31561,0,6,6,109.56792,18.28479,1765
10595,81326,2C3BD53A8702A47FB82F05FB4993B683,31931,6,8,2,109.54771,18.29403,1667
10596,81327,2C3BD53A8702A47FB82F05FB4993B683,31561,12,20,8,109.56792,18.28479,1765
10606,81396,283001ED673D8EDBEF7EEB00BDB31533,30571,5,6,1,109.50243,18.21861,1504
10607,81397,283001ED673D8EDBEF7EEB00BDB31533,60201,7,10,3,109.5041,18.2509,1510
10608,81398,283001ED673D8EDBEF7EEB00BDB31533,31181,12,18,6,109.50382,18.24813,1509
10609,81399,283001ED673D8EDBEF7EEB00BDB31533,30571,20,21,1,109.50243,18.21861,1504
10619,81583,1A1B5C664F8D6460240C73AB76187420,30854,0,11,11,109.56889,18.27076,1763
10620,81584,1A1B5C664F8D6460240C73AB76187420,31071,11,13,2,109.58257,18.28458,1815
10621,81585,1A1B5C664F8D6460240C73AB76187420,30854,14,16,2,109.56889,18.27076,1763
10622,81586,1A1B5C664F8D6460240C73AB76187420,31071,20,21,1,109.58257,18.28458,1815
10641,81752,DE752C5E8A13F8A5D5BD49C4D2C8009D,38881,0,7,7,109.51618,18.26431,1562
10642,81753,DE752C5E8A13F8A5D5BD49C4D2C8009D,30681,8,10,2,109.48493,18.26917,1463
10643,81754,DE752C5E8A13F8A5D5BD49C4D2C8009D,38881,13,17,4,109.51618,18.26431,1562
10644,81755,DE752C5E8A13F8A5D5BD49C4D2C8009D,31031,20,21,1,109.49979,18.25382,1510
10652,81822,89362A3CA3AE6F5B75871F2110924F99,30851,0,7,7,109.5616,18.27396,1713
10653,81823,89362A3CA3AE6F5B75871F2110924F99,31551,10,11,1,109.55868,18.24222,1708
10654,81824,89362A3CA3AE6F5B75871F2110924F99,30951,11,16,5,109.56208,18.25667,1761
10655,81825,89362A3CA3AE6F5B75871F2110924F99,30851,18,22,4,109.5616,18.27396,1713
10662,81882,76E309834F99A617111BD6E6BAC7FFEC,60371,0,8,8,109.53063,18.30056,1618
10663,81883,76E309834F99A617111BD6E6BAC7FFEC,31931,12,16,4,109.54771,18.29403,1667
10664,81884,76E309834F99A617111BD6E6BAC7FFEC,60371,16,17,1,109.53063,18.30056,1618
10684,82049,999DEB7BFC175BF03EAE5DB1D4B2EFB6,60361,0,15,15,109.51938,18.29681,1567
10685,82050,999DEB7BFC175BF03EAE5DB1D4B2EFB6,31861,16,17,1,109.49042,18.27549,1464
10686,82051,999DEB7BFC175BF03EAE5DB1D4B2EFB6,31951,21,23,2,109.52174,18.30299,1568
10688,82138,80B72DFF870E58099F17893CA96A269C,31071,1,5,4,109.58257,18.28458,1815
10689,82139,80B72DFF870E58099F17893CA96A269C,30854,5,8,3,109.56889,18.27076,1763
10690,82140,80B72DFF870E58099F17893CA96A269C,31071,11,13,2,109.58257,18.28458,1815
10691,82163,DD056101D68CBFC24096E8F587CC747C,30071,0,5,5,109.52819,18.30472,1619
10692,82164,DD056101D68CBFC24096E8F587CC747C,31931,5,6,1,109.54771,18.29403,1667
10693,82165,DD056101D68CBFC24096E8F587CC747C,30071,10,11,1,109.52819,18.30472,1619
10694,82166,DD056101D68CBFC24096E8F587CC747C,31931,12,16,4,109.54771,18.29403,1667
10698,82264,3D5A468E02E58892BB875A2C29BFAFBA,38911,1,7,6,109.51674,18.24965,1559
10699,82265,3D5A468E02E58892BB875A2C29BFAFBA,31821,7,11,4,109.51181,18.24924,1559
10700,82266,3D5A468E02E58892BB875A2C29BFAFBA,31261,13,15,2,109.51174,18.2466,1559
10701,82267,3D5A468E02E58892BB875A2C29BFAFBA,30151,19,22,3,109.50986,18.25083,1560
10702,82268,560794A44CA17A43FA34D0FA6C339747,30854,0,6,6,109.56889,18.27076,1763
10703,82269,560794A44CA17A43FA34D0FA6C339747,31071,11,12,1,109.58257,18.28458,1815
10704,82270,560794A44CA17A43FA34D0FA6C339747,30854,16,22,6,109.56889,18.27076,1763
10705,82288,608A55C14BAB2A5B627ACC1F39B89FB6,31945,0,7,7,109.58021,18.29403,1817
10706,82289,608A55C14BAB2A5B627ACC1F39B89FB6,30854,8,17,9,109.56889,18.27076,1763
10707,82290,608A55C14BAB2A5B627ACC1F39B89FB6,31945,19,23,4,109.58021,18.29403,1817
10716,82357,85586D73EA48B4F4D520D899B0BE0554,30291,0,5,5,109.50403,18.27028,1513
10717,82358,85586D73EA48B4F4D520D899B0BE0554,39181,7,10,3,109.55153,18.28035,1715
10718,82359,85586D73EA48B4F4D520D899B0BE0554,39181,13,17,4,109.55153,18.28035,1715
10727,82409,AAB3DCB18BAF89954DC0C8A658A6D766,31951,0,14,14,109.52174,18.30299,1568
10728,82410,AAB3DCB18BAF89954DC0C8A658A6D766,38881,14,17,3,109.51618,18.26431,1562
10729,82411,AAB3DCB18BAF89954DC0C8A658A6D766,30071,18,20,2,109.52819,18.30472,1619
10730,82412,AAB3DCB18BAF89954DC0C8A658A6D766,31951,22,23,1,109.52174,18.30299,1568
10746,82588,0F558B6653C655C7F0BAEA9D66B33F57,31071,1,6,5,109.58257,18.28458,1815
10747,82589,0F558B6653C655C7F0BAEA9D66B33F57,30854,7,16,9,109.56889,18.27076,1763
10748,82590,0F558B6653C655C7F0BAEA9D66B33F57,31071,16,17,1,109.58257,18.28458,1815
10749,82591,0F558B6653C655C7F0BAEA9D66B33F57,30854,19,20,1,109.56889,18.27076,1763
10750,82592,1026894DC5FF9A7FAF3A2EE28B95E239,30854,0,10,10,109.56889,18.27076,1763
10751,82593,1026894DC5FF9A7FAF3A2EE28B95E239,30891,12,14,2,109.59431,18.28389,1865
10752,82594,1026894DC5FF9A7FAF3A2EE28B95E239,30854,14,20,6,109.56889,18.27076,1763
10759,82635,A01B4012B619D942E7CC3AC9B78722B4,31561,0,7,7,109.56792,18.28479,1765
10760,82636,A01B4012B619D942E7CC3AC9B78722B4,39183,9,11,2,109.55542,18.28208,1715
10761,82637,A01B4012B619D942E7CC3AC9B78722B4,31561,11,23,12,109.56792,18.28479,1765
10767,82650,417408FFDA93B177641D270D3A5C4B2D,31071,0,14,14,109.58257,18.28458,1815
10768,82651,417408FFDA93B177641D270D3A5C4B2D,30854,15,17,2,109.56889,18.27076,1763
10769,82652,417408FFDA93B177641D270D3A5C4B2D,31071,17,19,2,109.58257,18.28458,1815
10770,82653,417408FFDA93B177641D270D3A5C4B2D,31945,21,22,1,109.58021,18.29403,1817
10790,82847,8DD23AA43C0F7967C45F7488D66F9159,30854,0,1,1,109.56889,18.27076,1763
10791,82848,8DD23AA43C0F7967C45F7488D66F9159,31945,1,6,5,109.58021,18.29403,1817
10792,82849,8DD23AA43C0F7967C45F7488D66F9159,30854,8,17,9,109.56889,18.27076,1763
10803,82953,3940DDDB655239C16F43D83626AAB86A,38241,0,5,5,109.54111,18.30542,1669
10804,82954,3940DDDB655239C16F43D83626AAB86A,31931,5,16,11,109.54771,18.29403,1667
10805,82955,3940DDDB655239C16F43D83626AAB86A,38241,19,23,4,109.54111,18.30542,1669
10806,82973,C85D0B931BEF54F05B9ABBBB03212DB7,30854,0,6,6,109.56889,18.27076,1763
10807,82974,C85D0B931BEF54F05B9ABBBB03212DB7,31561,6,18,12,109.56792,18.28479,1765
10808,82975,C85D0B931BEF54F05B9ABBBB03212DB7,30854,19,22,3,109.56889,18.27076,1763
10809,82994,0E1DB444F47235AEDAD0A0404A7B75B4,31561,2,3,1,109.56792,18.28479,1765
10810,82995,0E1DB444F47235AEDAD0A0404A7B75B4,39183,7,13,6,109.55542,18.28208,1715
10811,82996,0E1DB444F47235AEDAD0A0404A7B75B4,31561,16,17,1,109.56792,18.28479,1765
10812,82997,0E1DB444F47235AEDAD0A0404A7B75B4,30891,19,20,1,109.59431,18.28389,1865
10822,83061,EDD211647BCC1D3CABF473CB2801C791,30361,0,10,10,109.50347,18.24,1508
10823,83062,EDD211647BCC1D3CABF473CB2801C791,30161,11,17,6,109.50042,18.24389,1508
10824,83063,EDD211647BCC1D3CABF473CB2801C791,31391,17,23,6,109.50382,18.24285,1508
10829,83090,D758DCB0CB2E5EA2CADCED24F521A533,30854,0,13,13,109.56889,18.27076,1763
10830,83091,D758DCB0CB2E5EA2CADCED24F521A533,31071,14,15,1,109.58257,18.28458,1815
10831,83092,D758DCB0CB2E5EA2CADCED24F521A533,30854,18,23,5,109.56889,18.27076,1763
10838,83156,25AEFF32B0667D26540E580A39012DE0,38141,0,4,4,109.39479,18.2916,1116
10839,83157,25AEFF32B0667D26540E580A39012DE0,38141,5,10,5,109.39479,18.2916,1116
10840,83158,25AEFF32B0667D26540E580A39012DE0,31671,11,13,2,109.38965,18.29813,1068
10841,83159,25AEFF32B0667D26540E580A39012DE0,38071,18,19,1,109.40722,18.30938,1169
10842,83170,75817DB682187A07461734D66E1E6492,60631,0,4,4,109.57778,18.27583,1814
10843,83171,75817DB682187A07461734D66E1E6492,30854,4,18,14,109.56889,18.27076,1763
10844,83172,75817DB682187A07461734D66E1E6492,60631,22,23,1,109.57778,18.27583,1814
10854,83322,A952750F25C558E5C17B3EB7DD935431,30071,0,4,4,109.52819,18.30472,1619
10855,83323,A952750F25C558E5C17B3EB7DD935431,31931,7,16,9,109.54771,18.29403,1667
10856,83324,A952750F25C558E5C17B3EB7DD935431,60371,17,23,6,109.53063,18.30056,1618
10857,83327,ABCD0851CC1C78BCD7AF6DBDF2F5DE49,60552,0,15,15,109.41729,18.30014,1218
10858,83328,ABCD0851CC1C78BCD7AF6DBDF2F5DE49,31091,19,20,1,109.41201,18.31222,1170
10859,83329,ABCD0851CC1C78BCD7AF6DBDF2F5DE49,60552,21,23,2,109.41729,18.30014,1218
10863,83340,C19430CE8DF26BDEF43903E57E682236,31561,0,8,8,109.56792,18.28479,1765
10864,83341,C19430CE8DF26BDEF43903E57E682236,30854,8,10,2,109.56889,18.27076,1763
10865,83342,C19430CE8DF26BDEF43903E57E682236,31561,12,13,1,109.56792,18.28479,1765
10866,83343,C19430CE8DF26BDEF43903E57E682236,30854,16,18,2,109.56889,18.27076,1763
10908,83870,BF77B653864ED8DD6CB6952D60F33BB5,30171,0,9,9,109.48458,18.27139,1463
10909,83871,BF77B653864ED8DD6CB6952D60F33BB5,60621,11,14,3,109.48354,18.27451,1464
10910,83872,BF77B653864ED8DD6CB6952D60F33BB5,30171,18,23,5,109.48458,18.27139,1463
10918,83978,F5FE23BF42FC224C310CD42E08B0B950,31431,0,6,6,109.44639,18.29042,1316
10919,83979,F5FE23BF42FC224C310CD42E08B0B950,38094,6,10,4,109.45403,18.28778,1316
10920,83980,F5FE23BF42FC224C310CD42E08B0B950,31431,10,13,3,109.44639,18.29042,1316
10921,83981,F5FE23BF42FC224C310CD42E08B0B950,38094,15,21,6,109.45403,18.28778,1316
10922,84014,FA6ABA68C8C4B512A2E858E0E08423D7,30291,0,8,8,109.50403,18.27028,1513
10923,84015,FA6ABA68C8C4B512A2E858E0E08423D7,31864,9,10,1,109.49014,18.28333,1465
10924,84016,FA6ABA68C8C4B512A2E858E0E08423D7,30291,11,14,3,109.50403,18.27028,1513
10925,84017,FA6ABA68C8C4B512A2E858E0E08423D7,30854,16,21,5,109.56889,18.27076,1763
10928,84031,9FEA4B85EAE4FAEE1CAF0EABFF2FAEA1,31561,1,15,14,109.56792,18.28479,1765
10929,84032,9FEA4B85EAE4FAEE1CAF0EABFF2FAEA1,39183,15,16,1,109.55542,18.28208,1715
10930,84033,9FEA4B85EAE4FAEE1CAF0EABFF2FAEA1,30854,20,21,1,109.56889,18.27076,1763
10944,84162,E191BF114A3C2277CB7C3323BAA13F43,30854,2,13,11,109.56889,18.27076,1763
10945,84163,E191BF114A3C2277CB7C3323BAA13F43,39101,17,20,3,109.50132,18.24931,1509
10946,84164,E191BF114A3C2277CB7C3323BAA13F43,30854,20,22,2,109.56889,18.27076,1763
10947,84176,9FC721E86703223349C05C95FE4BBB6F,60081,0,10,10,109.51097,18.22639,1556
10948,84177,9FC721E86703223349C05C95FE4BBB6F,60381,11,19,8,109.5241,18.22458,1605
10949,84178,9FC721E86703223349C05C95FE4BBB6F,60087,21,23,2,109.50688,18.22299,1505
10968,84473,47A18820FDA9856131F74091D44B6BCB,31071,0,6,6,109.58257,18.28458,1815
10969,84474,47A18820FDA9856131F74091D44B6BCB,31561,7,14,7,109.56792,18.28479,1765
10970,84475,47A18820FDA9856131F74091D44B6BCB,30851,15,17,2,109.5616,18.27396,1713
10971,84476,47A18820FDA9856131F74091D44B6BCB,31561,21,22,1,109.56792,18.28479,1765
10972,84477,5274FB91D917823AD6AE120EE7F21099,31931,5,7,2,109.54771,18.29403,1667
10973,84478,5274FB91D917823AD6AE120EE7F21099,30324,8,11,3,109.50326,18.29257,1517
10974,84479,5274FB91D917823AD6AE120EE7F21099,60361,14,16,2,109.51938,18.29681,1567
10975,84480,5274FB91D917823AD6AE120EE7F21099,31931,21,22,1,109.54771,18.29403,1667
10976,84528,A9FCE0049DB44FE004EAFBF5B783F4A5,31945,0,13,13,109.58021,18.29403,1817
10977,84529,A9FCE0049DB44FE004EAFBF5B783F4A5,31071,14,15,1,109.58257,18.28458,1815
10978,84530,A9FCE0049DB44FE004EAFBF5B783F4A5,30854,15,19,4,109.56889,18.27076,1763
10989,84618,84DF4A7C208235D171EF56473BCCF210,30851,1,2,1,109.5616,18.27396,1713
10990,84619,84DF4A7C208235D171EF56473BCCF210,31561,4,7,3,109.56792,18.28479,1765
10991,84620,84DF4A7C208235D171EF56473BCCF210,60631,8,18,10,109.57778,18.27583,1814
10992,84621,84DF4A7C208235D171EF56473BCCF210,30854,19,20,1,109.56889,18.27076,1763
10993,84685,7024F3A14F6F554DC6E80063E30315F0,31561,3,5,2,109.56792,18.28479,1765
10994,84686,7024F3A14F6F554DC6E80063E30315F0,39183,8,10,2,109.55542,18.28208,1715
10995,84687,7024F3A14F6F554DC6E80063E30315F0,31561,12,13,1,109.56792,18.28479,1765
10996,84753,D6A345956751BA2ACC5430EDF68A104F,39181,0,6,6,109.55153,18.28035,1715
10997,84754,D6A345956751BA2ACC5430EDF68A104F,31931,7,11,4,109.54771,18.29403,1667
10998,84755,D6A345956751BA2ACC5430EDF68A104F,39181,12,23,11,109.55153,18.28035,1715
11003,84790,0D00E0CA974DDA00224ACCD00B993468,30851,0,13,13,109.5616,18.27396,1713
11004,84791,0D00E0CA974DDA00224ACCD00B993468,30854,15,18,3,109.56889,18.27076,1763
11005,84792,0D00E0CA974DDA00224ACCD00B993468,31071,20,21,1,109.58257,18.28458,1815
11048,85087,3520FED22A4D572CBFE1B08BD2743E22,31041,0,1,1,109.50278,18.23701,1507
11049,85088,3520FED22A4D572CBFE1B08BD2743E22,30361,2,7,5,109.50347,18.24,1508
11050,85089,3520FED22A4D572CBFE1B08BD2743E22,31181,7,12,5,109.50382,18.24813,1509
11051,85090,3520FED22A4D572CBFE1B08BD2743E22,60381,13,14,1,109.5241,18.22458,1605
11055,85146,8C3D244B6DAAE8C73F174808255E03C6,60011,1,7,6,109.48965,18.30222,1468
11056,85147,8C3D244B6DAAE8C73F174808255E03C6,30764,8,10,2,109.45806,18.29486,1367
11057,85148,8C3D244B6DAAE8C73F174808255E03C6,30761,10,12,2,109.45201,18.3,1318
11058,85149,8C3D244B6DAAE8C73F174808255E03C6,60614,14,19,5,109.48799,18.29521,1467
11059,85169,0A987E09994A8BF75281CD6678876931,30571,0,6,6,109.50243,18.21861,1504
11060,85170,0A987E09994A8BF75281CD6678876931,30531,6,7,1,109.53271,18.21472,1604
11061,85171,0A987E09994A8BF75281CD6678876931,30571,10,12,2,109.50243,18.21861,1504
11062,85172,C054F0F1F6DF018C36D80DAC513476F7,30151,2,9,7,109.50986,18.25083,1560
11063,85173,C054F0F1F6DF018C36D80DAC513476F7,30151,10,13,3,109.50986,18.25083,1560
11064,85174,C054F0F1F6DF018C36D80DAC513476F7,30151,16,17,1,109.50986,18.25083,1560
11065,85175,C054F0F1F6DF018C36D80DAC513476F7,30151,21,22,1,109.50986,18.25083,1560
11080,85251,CCCD2290FB632A48009771412BE68ADD,31561,0,5,5,109.56792,18.28479,1765
11081,85252,CCCD2290FB632A48009771412BE68ADD,39183,6,7,1,109.55542,18.28208,1715
11082,85253,CCCD2290FB632A48009771412BE68ADD,31561,8,19,11,109.56792,18.28479,1765
11086,85257,DC29C676832347947F366933ECB88090,31561,0,6,6,109.56792,18.28479,1765
11087,85258,DC29C676832347947F366933ECB88090,39183,9,11,2,109.55542,18.28208,1715
11088,85259,DC29C676832347947F366933ECB88090,31561,13,15,2,109.56792,18.28479,1765
11111,85559,51061B3DE820AF1C1C713EF684728003,31071,0,6,6,109.58257,18.28458,1815
11112,85560,51061B3DE820AF1C1C713EF684728003,30854,8,10,2,109.56889,18.27076,1763
11113,85561,51061B3DE820AF1C1C713EF684728003,31071,12,14,2,109.58257,18.28458,1815
11114,85562,51061B3DE820AF1C1C713EF684728003,30854,16,23,7,109.56889,18.27076,1763
11135,85772,8752BC71725B50257436D50C6598F252,31071,0,7,7,109.58257,18.28458,1815
11136,85773,8752BC71725B50257436D50C6598F252,30854,8,9,1,109.56889,18.27076,1763
11137,85774,8752BC71725B50257436D50C6598F252,31071,12,13,1,109.58257,18.28458,1815
11138,85775,8752BC71725B50257436D50C6598F252,30854,15,21,6,109.56889,18.27076,1763
11139,85783,92E14A6094471B9C1A50CE8585136EC6,30191,0,2,2,109.50361,18.22701,1506
11140,85784,92E14A6094471B9C1A50CE8585136EC6,30151,3,4,1,109.50986,18.25083,1560
11141,85785,92E14A6094471B9C1A50CE8585136EC6,60087,4,16,12,109.50688,18.22299,1505
11142,85786,92E14A6094471B9C1A50CE8585136EC6,30731,19,22,3,109.50944,18.22306,1555
11147,85891,8FE97C1052D63DE830211C405D8F5442,60631,0,6,6,109.57778,18.27583,1814
11148,85892,8FE97C1052D63DE830211C405D8F5442,30851,7,9,2,109.5616,18.27396,1713
11149,85893,8FE97C1052D63DE830211C405D8F5442,30854,9,10,1,109.56889,18.27076,1763
11157,86006,53453D8B736810206EC5A6632D159BE6,31931,0,15,15,109.54771,18.29403,1667
11158,86007,53453D8B736810206EC5A6632D159BE6,30921,18,19,1,109.53903,18.29451,1667
11159,86008,53453D8B736810206EC5A6632D159BE6,31931,20,21,1,109.54771,18.29403,1667
11167,86054,C1F80FD61770F46AF18F3BEF2B67E7ED,31551,0,7,7,109.55868,18.24222,1708
11168,86055,C1F80FD61770F46AF18F3BEF2B67E7ED,31554,7,8,1,109.55521,18.2459,1709
11169,86056,C1F80FD61770F46AF18F3BEF2B67E7ED,30511,9,13,4,109.51069,18.24208,1558
11170,86057,C1F80FD61770F46AF18F3BEF2B67E7ED,31551,15,22,7,109.55868,18.24222,1708
11174,86156,A3F1A757214C25A449688115E5C4321B,60371,1,2,1,109.53063,18.30056,1618
11175,86157,A3F1A757214C25A449688115E5C4321B,60221,5,6,1,109.52569,18.29188,1616
11176,86158,A3F1A757214C25A449688115E5C4321B,31931,6,17,11,109.54771,18.29403,1667
11191,86283,C8922FAF66F21ECAECB6B717FCD5A53B,60614,0,16,16,109.48799,18.29521,1467
11192,86284,C8922FAF66F21ECAECB6B717FCD5A53B,60391,16,19,3,109.47667,18.28757,1416
11193,86285,C8922FAF66F21ECAECB6B717FCD5A53B,60614,20,21,1,109.48799,18.29521,1467
11197,86333,30D8A678A1441E4FFDF2E3F44AE24060,31071,0,6,6,109.58257,18.28458,1815
11198,86334,30D8A678A1441E4FFDF2E3F44AE24060,30854,9,10,1,109.56889,18.27076,1763
11199,86335,30D8A678A1441E4FFDF2E3F44AE24060,31071,14,17,3,109.58257,18.28458,1815
11200,86336,30D8A678A1441E4FFDF2E3F44AE24060,30854,20,22,2,109.56889,18.27076,1763
11205,86405,20912724FD370D4E1BCB1C3E870358AC,30051,0,16,16,109.48917,18.21215,1453
11206,86406,20912724FD370D4E1BCB1C3E870358AC,39191,17,20,3,109.51493,18.23472,1557
11207,86407,20912724FD370D4E1BCB1C3E870358AC,30051,22,23,1,109.48917,18.21215,1453
11216,86524,E75CF54BA14775FEDD26504F9F6B7365,31945,0,6,6,109.58021,18.29403,1817
11217,86525,E75CF54BA14775FEDD26504F9F6B7365,31561,6,18,12,109.56792,18.28479,1765
11218,86526,E75CF54BA14775FEDD26504F9F6B7365,30234,20,21,1,109.60681,18.29979,1918
11223,86600,39F25FE146A03325C93C111F2A943B6C,31945,1,13,12,109.58021,18.29403,1817
11224,86601,39F25FE146A03325C93C111F2A943B6C,31071,18,19,1,109.58257,18.28458,1815
11225,86602,39F25FE146A03325C93C111F2A943B6C,31945,21,23,2,109.58021,18.29403,1817
11234,86743,8CD15CF6B5FB4821940FF9AFE6D6CB84,39181,0,1,1,109.55153,18.28035,1715
11235,86744,8CD15CF6B5FB4821940FF9AFE6D6CB84,31931,1,4,3,109.54771,18.29403,1667
11236,86745,8CD15CF6B5FB4821940FF9AFE6D6CB84,39181,6,21,15,109.55153,18.28035,1715
11249,86961,967E548F53382C36FB0D7FF12F6A99E7,31531,0,6,6,109.49583,18.25972,1461
11250,86962,967E548F53382C36FB0D7FF12F6A99E7,30371,8,9,1,109.51,18.24771,1559
11251,86963,967E548F53382C36FB0D7FF12F6A99E7,30771,11,13,2,109.49938,18.26042,1511
11252,86964,967E548F53382C36FB0D7FF12F6A99E7,30771,14,23,9,109.49938,18.26042,1511
11290,87338,2F64FEF19C86AA0A8AA3E3FA37CC4F2D,30854,1,5,4,109.56889,18.27076,1763
11291,87339,2F64FEF19C86AA0A8AA3E3FA37CC4F2D,60631,8,10,2,109.57778,18.27583,1814
11292,87340,2F64FEF19C86AA0A8AA3E3FA37CC4F2D,30854,10,23,13,109.56889,18.27076,1763
11293,87349,AB43182259122294244C13D6FC66D4A1,30891,0,6,6,109.59431,18.28389,1865
11294,87350,AB43182259122294244C13D6FC66D4A1,31561,10,16,6,109.56792,18.28479,1765
11295,87351,AB43182259122294244C13D6FC66D4A1,60631,21,23,2,109.57778,18.27583,1814
11303,87412,F8D799D9161B0143E0D71C40472A357E,30071,0,15,15,109.52819,18.30472,1619
11304,87413,F8D799D9161B0143E0D71C40472A357E,60371,15,16,1,109.53063,18.30056,1618
11305,87414,F8D799D9161B0143E0D71C40472A357E,30071,17,23,6,109.52819,18.30472,1619
11337,87597,2D70A5EC3C783EDF55DB2CDF82B883C4,38052,1,9,8,109.62618,18.23042,1956
11338,87598,2D70A5EC3C783EDF55DB2CDF82B883C4,38052,11,15,4,109.62618,18.23042,1956
11339,87599,2D70A5EC3C783EDF55DB2CDF82B883C4,38275,20,23,3,109.62875,18.22938,2006
11345,87636,C6C3BC01E542B810EF853FEEB6C81198,60361,4,13,9,109.51938,18.29681,1567
11346,87637,C6C3BC01E542B810EF853FEEB6C81198,60221,13,14,1,109.52569,18.29188,1616
11347,87638,C6C3BC01E542B810EF853FEEB6C81198,60361,15,16,1,109.51938,18.29681,1567
11348,87639,C6C3BC01E542B810EF853FEEB6C81198,31561,19,22,3,109.56792,18.28479,1765
11368,87760,8DEBA8F3DD446F0F0680296AB7E73431,30764,1,2,1,109.45806,18.29486,1367
11369,87761,8DEBA8F3DD446F0F0680296AB7E73431,60472,6,8,2,109.46625,18.29542,1367
11370,87762,8DEBA8F3DD446F0F0680296AB7E73431,30111,9,11,2,109.47583,18.30542,1419
11371,87763,8DEBA8F3DD446F0F0680296AB7E73431,60472,15,17,2,109.46625,18.29542,1367
11377,87804,CFFDD1BF3134B9FDD71614F40E1DE0FD,31071,4,9,5,109.58257,18.28458,1815
11378,87805,CFFDD1BF3134B9FDD71614F40E1DE0FD,60631,12,14,2,109.57778,18.27583,1814
11379,87806,CFFDD1BF3134B9FDD71614F40E1DE0FD,31071,14,20,6,109.58257,18.28458,1815
11413,88121,E4C7AB656E412C7E33554D18277C9478,60291,0,15,15,109.50826,18.24639,1509
11414,88122,E4C7AB656E412C7E33554D18277C9478,30151,17,20,3,109.50986,18.25083,1560
11415,88123,E4C7AB656E412C7E33554D18277C9478,31461,21,22,1,109.5091,18.25389,1510
11429,88269,02C53C5746E38501957FE72E2C83CCA4,60231,0,1,1,109.49903,18.21972,1504
11430,88270,02C53C5746E38501957FE72E2C83CCA4,38251,3,4,1,109.49618,18.25493,1510
11431,88271,02C53C5746E38501957FE72E2C83CCA4,60231,9,21,12,109.49903,18.21972,1504
11432,88326,4D4289AE0DFBF4B5C79A47559DC2EBDD,30854,1,8,7,109.56889,18.27076,1763
11433,88327,4D4289AE0DFBF4B5C79A47559DC2EBDD,31071,8,9,1,109.58257,18.28458,1815
11434,88328,4D4289AE0DFBF4B5C79A47559DC2EBDD,30854,10,19,9,109.56889,18.27076,1763
11435,88340,59F29435D748531F416A4F1636997ECF,31945,0,2,2,109.58021,18.29403,1817
11436,88341,59F29435D748531F416A4F1636997ECF,31071,2,7,5,109.58257,18.28458,1815
11437,88342,59F29435D748531F416A4F1636997ECF,30854,7,8,1,109.56889,18.27076,1763
11438,88346,68DBE0B52FD0AB95F1DD47068FD7847F,60311,0,7,7,109.52097,18.24319,1558
11439,88347,68DBE0B52FD0AB95F1DD47068FD7847F,30181,10,11,1,109.51597,18.23313,1557
11440,88348,68DBE0B52FD0AB95F1DD47068FD7847F,31031,16,19,3,109.49979,18.25382,1510
11441,88349,68DBE0B52FD0AB95F1DD47068FD7847F,30181,19,23,4,109.51597,18.23313,1557
11442,88357,9955D8331F1866B4F8C7C7981EBD1A88,31206,1,14,13,109.50819,18.23549,1507
11443,88358,9955D8331F1866B4F8C7C7981EBD1A88,60381,15,16,1,109.5241,18.22458,1605
11444,88359,9955D8331F1866B4F8C7C7981EBD1A88,31206,17,22,5,109.50819,18.23549,1507
11453,88450,55CDDB1A84A2F40D42C80C17393C28FB,38951,0,2,2,109.48097,18.28868,1416
11454,88451,55CDDB1A84A2F40D42C80C17393C28FB,60472,4,14,10,109.46625,18.29542,1367
11455,88452,55CDDB1A84A2F40D42C80C17393C28FB,38951,18,23,5,109.48097,18.28868,1416
11507,88968,13104A6A71A054F852B52BB76993ADB2,30854,0,6,6,109.56889,18.27076,1763
11508,88969,13104A6A71A054F852B52BB76993ADB2,30851,6,9,3,109.5616,18.27396,1713
11509,88970,13104A6A71A054F852B52BB76993ADB2,30854,9,13,4,109.56889,18.27076,1763
11510,88971,13104A6A71A054F852B52BB76993ADB2,30851,13,17,4,109.5616,18.27396,1713
11524,89056,5A888DC7A3AA300CC584D9862C5384A1,60221,0,3,3,109.52569,18.29188,1616
11525,89057,5A888DC7A3AA300CC584D9862C5384A1,30721,3,5,2,109.51597,18.28257,1565
11526,89058,5A888DC7A3AA300CC584D9862C5384A1,31931,8,10,2,109.54771,18.29403,1667
11527,89059,5A888DC7A3AA300CC584D9862C5384A1,39183,12,13,1,109.55542,18.28208,1715
11528,89083,875F4B80762D0E664890361D764F907D,60081,0,7,7,109.51097,18.22639,1556
11529,89084,875F4B80762D0E664890361D764F907D,30571,7,18,11,109.50243,18.21861,1504
11530,89085,875F4B80762D0E664890361D764F907D,60081,19,23,4,109.51097,18.22639,1556
11531,89145,28FD729A56A38491CC99ABB23711BC1C,39181,0,4,4,109.55153,18.28035,1715
11532,89146,28FD729A56A38491CC99ABB23711BC1C,31931,7,8,1,109.54771,18.29403,1667
11533,89147,28FD729A56A38491CC99ABB23711BC1C,39181,10,13,3,109.55153,18.28035,1715
11537,89262,47DB633DCEAA585A5A9E2D686518C9D0,38171,0,7,7,109.50799,18.28139,1515
11538,89263,47DB633DCEAA585A5A9E2D686518C9D0,30851,9,12,3,109.5616,18.27396,1713
11539,89264,47DB633DCEAA585A5A9E2D686518C9D0,30854,14,23,9,109.56889,18.27076,1763
11540,89276,6D1A5174B0679D14F4183CE4A66812B9,31071,0,8,8,109.58257,18.28458,1815
11541,89277,6D1A5174B0679D14F4183CE4A66812B9,30854,11,12,1,109.56889,18.27076,1763
11542,89278,6D1A5174B0679D14F4183CE4A66812B9,31071,12,15,3,109.58257,18.28458,1815
11545,89313,8E244E94833DBF281BCBFE2F4A36E102,60641,0,9,9,109.53854,18.2359,1657
11546,89314,8E244E94833DBF281BCBFE2F4A36E102,30861,12,13,1,109.52722,18.22743,1606
11547,89315,8E244E94833DBF281BCBFE2F4A36E102,60641,14,23,9,109.53854,18.2359,1657
11586,89662,77EAFDBAF8DB65CFFFD8A9494D2F080D,30761,0,15,15,109.45201,18.3,1318
11587,89663,77EAFDBAF8DB65CFFFD8A9494D2F080D,31081,18,20,2,109.44639,18.30181,1318
11588,89664,77EAFDBAF8DB65CFFFD8A9494D2F080D,30761,21,23,2,109.45201,18.3,1318
11623,89889,E79FCCBA9F6300DF5C81A804945B477E,31945,1,2,1,109.58021,18.29403,1817
11624,89890,E79FCCBA9F6300DF5C81A804945B477E,31071,3,5,2,109.58257,18.28458,1815
11625,89891,E79FCCBA9F6300DF5C81A804945B477E,30854,6,23,17,109.56889,18.27076,1763
11631,89920,34A1BA5A97F90C4ABB34EDC7004774A9,30851,0,6,6,109.5616,18.27396,1713
11632,89921,34A1BA5A97F90C4ABB34EDC7004774A9,39183,10,11,1,109.55542,18.28208,1715
11633,89922,34A1BA5A97F90C4ABB34EDC7004774A9,31071,15,16,1,109.58257,18.28458,1815
11637,89988,ECA37B99D2E4FEE602303DB4AB25AB77,30721,0,7,7,109.51597,18.28257,1565
11638,89989,ECA37B99D2E4FEE602303DB4AB25AB77,60614,8,10,2,109.48799,18.29521,1467
11639,89990,ECA37B99D2E4FEE602303DB4AB25AB77,38157,12,14,2,109.51483,18.26958,1563
11648,90004,AE6DC7ACB81DB5F351E45AC25E5F5A3B,30721,0,2,2,109.51597,18.28257,1565
11649,90005,AE6DC7ACB81DB5F351E45AC25E5F5A3B,38297,4,6,2,109.52576,18.24965,1609
11650,90006,AE6DC7ACB81DB5F351E45AC25E5F5A3B,31031,8,15,7,109.49979,18.25382,1510
11653,90027,ADAB51A6D99BADC8222FC392D72ADA01,60281,0,6,6,109.51743,18.25924,1561
11654,90028,ADAB51A6D99BADC8222FC392D72ADA01,60311,7,8,1,109.52097,18.24319,1558
11655,90029,ADAB51A6D99BADC8222FC392D72ADA01,60281,8,23,15,109.51743,18.25924,1561
11661,90061,ACDEAAF45B65DE48CF80A48DBD3C775E,31071,1,2,1,109.58257,18.28458,1815
11662,90062,ACDEAAF45B65DE48CF80A48DBD3C775E,30854,2,5,3,109.56889,18.27076,1763
11663,90063,ACDEAAF45B65DE48CF80A48DBD3C775E,31071,5,6,1,109.58257,18.28458,1815
11664,90064,ACDEAAF45B65DE48CF80A48DBD3C775E,30854,7,9,2,109.56889,18.27076,1763
11675,90127,7B1A07C39637E996C01DF0A3D287D3C6,30854,0,15,15,109.56889,18.27076,1763
11676,90128,7B1A07C39637E996C01DF0A3D287D3C6,31071,17,20,3,109.58257,18.28458,1815
11677,90129,7B1A07C39637E996C01DF0A3D287D3C6,30854,20,23,3,109.56889,18.27076,1763
11690,90177,B55959B64746A18ECF5077B5F7359221,31561,3,11,8,109.56792,18.28479,1765
11691,90178,B55959B64746A18ECF5077B5F7359221,39183,14,15,1,109.55542,18.28208,1715
11692,90179,B55959B64746A18ECF5077B5F7359221,31561,20,23,3,109.56792,18.28479,1765
11707,90423,0C8D15C0488D521680F0DE3A28CFE111,31811,0,3,3,109.54201,18.31806,1671
11708,90424,0C8D15C0488D521680F0DE3A28CFE111,30701,5,15,10,109.59313,18.32007,1871
11709,90425,0C8D15C0488D521680F0DE3A28CFE111,31811,19,20,1,109.54201,18.31806,1671
11710,90426,0C8D15C0488D521680F0DE3A28CFE111,30701,20,22,2,109.59313,18.32007,1871
11713,90447,64F4CDF664AA04E7B79DE93C57128CF6,31931,0,6,6,109.54771,18.29403,1667
11714,90448,64F4CDF664AA04E7B79DE93C57128CF6,39181,7,18,11,109.55153,18.28035,1715
11715,90449,64F4CDF664AA04E7B79DE93C57128CF6,31931,18,19,1,109.54771,18.29403,1667
11726,90494,DE5024DB59D5BF6AE5857A85EB7680EA,31071,0,6,6,109.58257,18.28458,1815
11727,90495,DE5024DB59D5BF6AE5857A85EB7680EA,30854,7,16,9,109.56889,18.27076,1763
11728,90496,DE5024DB59D5BF6AE5857A85EB7680EA,60631,20,21,1,109.57778,18.27583,1814
11740,90612,E65658506C2BF9C993BA69EE6D38B3C6,60221,1,2,1,109.52569,18.29188,1616
11741,90613,E65658506C2BF9C993BA69EE6D38B3C6,31951,2,18,16,109.52174,18.30299,1568
11742,90614,E65658506C2BF9C993BA69EE6D38B3C6,31561,22,23,1,109.56792,18.28479,1765
11745,90629,996308BA516E2A4FD895EB11278D247D,30201,3,16,13,109.4909,18.26465,1462
11746,90630,996308BA516E2A4FD895EB11278D247D,31031,17,20,3,109.49979,18.25382,1510
11747,90631,996308BA516E2A4FD895EB11278D247D,30201,21,23,2,109.4909,18.26465,1462
11755,90737,C93386A9D86FE22A1FD4E5116045DD8D,31561,0,6,6,109.56792,18.28479,1765
11756,90738,C93386A9D86FE22A1FD4E5116045DD8D,39183,7,10,3,109.55542,18.28208,1715
11757,90739,C93386A9D86FE22A1FD4E5116045DD8D,31561,10,13,3,109.56792,18.28479,1765
11758,90740,C93386A9D86FE22A1FD4E5116045DD8D,39183,14,16,2,109.55542,18.28208,1715
11773,90866,4EAD72A154BE5264D13EEE1D06581476,60371,0,6,6,109.53063,18.30056,1618
11774,90867,4EAD72A154BE5264D13EEE1D06581476,31931,7,10,3,109.54771,18.29403,1667
11775,90868,4EAD72A154BE5264D13EEE1D06581476,60371,11,21,10,109.53063,18.30056,1618
11801,91095,537CA9C3FED012868AB5E4DF92AD232C,30861,0,8,8,109.52722,18.22743,1606
11802,91096,537CA9C3FED012868AB5E4DF92AD232C,30861,12,14,2,109.52722,18.22743,1606
11803,91097,537CA9C3FED012868AB5E4DF92AD232C,30861,17,20,3,109.52722,18.22743,1606
11804,91098,537CA9C3FED012868AB5E4DF92AD232C,30711,20,22,2,109.50271,18.25347,1510
11805,91109,3F80F6C7ECC59E36D89C8EF1746C8724,60281,0,1,1,109.51743,18.25924,1561
11806,91110,3F80F6C7ECC59E36D89C8EF1746C8724,30151,1,2,1,109.50986,18.25083,1560
11807,91111,3F80F6C7ECC59E36D89C8EF1746C8724,38121,3,11,8,109.51361,18.27813,1564
11808,91112,3F80F6C7ECC59E36D89C8EF1746C8724,60171,13,15,2,109.51292,18.30694,1569
11815,91177,451E2BF48CD7B253EB0892324E679BCC,31461,0,5,5,109.5091,18.25389,1510
11816,91178,451E2BF48CD7B253EB0892324E679BCC,60281,7,12,5,109.51743,18.25924,1561
11817,91179,451E2BF48CD7B253EB0892324E679BCC,38291,12,21,9,109.51618,18.24313,1558
11818,91180,451E2BF48CD7B253EB0892324E679BCC,38297,22,23,1,109.52576,18.24965,1609
11828,91266,DDE77D3A656666992FC3458B84010D43,39183,1,5,4,109.55542,18.28208,1715
11829,91267,DDE77D3A656666992FC3458B84010D43,31561,8,9,1,109.56792,18.28479,1765
11830,91268,DDE77D3A656666992FC3458B84010D43,39183,12,21,9,109.55542,18.28208,1715
11847,91412,283001ED673D8EDBEF7EEB00BDB31533,30571,4,6,2,109.50243,18.21861,1504
11848,91413,283001ED673D8EDBEF7EEB00BDB31533,60201,6,8,2,109.5041,18.2509,1510
11849,91414,283001ED673D8EDBEF7EEB00BDB31533,31181,8,18,10,109.50382,18.24813,1509
11850,91415,283001ED673D8EDBEF7EEB00BDB31533,30571,18,20,2,109.50243,18.21861,1504
11855,91443,B5D5F035B558647FF9F44A76F16A1183,31206,0,14,14,109.50819,18.23549,1507
11856,91444,B5D5F035B558647FF9F44A76F16A1183,38371,19,20,1,109.50972,18.23924,1558
11857,91445,B5D5F035B558647FF9F44A76F16A1183,31411,21,22,1,109.5016,18.23576,1507
11858,91489,202870BA524F8D7E9C1B66336BF1F034,31951,0,5,5,109.52174,18.30299,1568
11859,91490,202870BA524F8D7E9C1B66336BF1F034,60631,7,9,2,109.57778,18.27583,1814
11860,91491,202870BA524F8D7E9C1B66336BF1F034,30854,12,18,6,109.56889,18.27076,1763
11861,91492,202870BA524F8D7E9C1B66336BF1F034,38991,19,20,1,109.52681,18.30368,1618
11869,91577,D1B09D14086A317457A98E1E3E3BED6B,39181,0,5,5,109.55153,18.28035,1715
11870,91578,D1B09D14086A317457A98E1E3E3BED6B,31931,6,7,1,109.54771,18.29403,1667
11871,91579,D1B09D14086A317457A98E1E3E3BED6B,39181,7,23,16,109.55153,18.28035,1715
11872,91586,D6B54C643B88B86782DC30A38AD291FD,31561,2,7,5,109.56792,18.28479,1765
11873,91587,D6B54C643B88B86782DC30A38AD291FD,30854,7,9,2,109.56889,18.27076,1763
11874,91588,D6B54C643B88B86782DC30A38AD291FD,31561,13,17,4,109.56792,18.28479,1765
11875,91618,1FE2866848043A2C10AD87212485FE15,31071,0,7,7,109.58257,18.28458,1815
11876,91619,1FE2866848043A2C10AD87212485FE15,30854,7,13,6,109.56889,18.27076,1763
11877,91620,1FE2866848043A2C10AD87212485FE15,31071,14,17,3,109.58257,18.28458,1815
11878,91621,1FE2866848043A2C10AD87212485FE15,30854,17,21,4,109.56889,18.27076,1763
11879,91646,EE9ED89488CC5A6EB73A10F5D2E75FDB,38085,0,1,1,109.6291,18.23625,2007
11880,91647,EE9ED89488CC5A6EB73A10F5D2E75FDB,31571,2,4,2,109.61563,18.23326,1957
11881,91648,EE9ED89488CC5A6EB73A10F5D2E75FDB,38085,6,8,2,109.6291,18.23625,2007
11897,91749,A7B3BDD8DC79485BA41EC7F220A41345,60631,0,9,9,109.57778,18.27583,1814
11898,91750,A7B3BDD8DC79485BA41EC7F220A41345,30854,9,12,3,109.56889,18.27076,1763
11899,91751,A7B3BDD8DC79485BA41EC7F220A41345,60631,14,20,6,109.57778,18.27583,1814
11900,91752,A7B3BDD8DC79485BA41EC7F220A41345,30854,21,22,1,109.56889,18.27076,1763
11903,91763,070984703178D21DC5287E457C03691A,39181,0,6,6,109.55153,18.28035,1715
11904,91764,070984703178D21DC5287E457C03691A,39181,9,12,3,109.55153,18.28035,1715
11905,91765,070984703178D21DC5287E457C03691A,39181,16,23,7,109.55153,18.28035,1715
11911,91909,09605A95AE7BE30FC92DC699DB3FCBD0,31181,0,8,8,109.50382,18.24813,1509
11912,91910,09605A95AE7BE30FC92DC699DB3FCBD0,31461,9,12,3,109.5091,18.25389,1510
11913,91911,09605A95AE7BE30FC92DC699DB3FCBD0,31461,13,14,1,109.5091,18.25389,1510
11914,91912,09605A95AE7BE30FC92DC699DB3FCBD0,31201,18,20,2,109.51042,18.23819,1558
11915,91941,7FF3C6569A3990C03CAF6C52D3C8BC6C,60241,0,5,5,109.53319,18.28667,1616
11916,91942,7FF3C6569A3990C03CAF6C52D3C8BC6C,31931,7,8,1,109.54771,18.29403,1667
11917,91943,7FF3C6569A3990C03CAF6C52D3C8BC6C,60241,11,12,1,109.53319,18.28667,1616
11918,91965,E46795A590C643FCDE6B993B35621D2F,31931,1,6,5,109.54771,18.29403,1667
11919,91966,E46795A590C643FCDE6B993B35621D2F,30351,11,13,2,109.41701,18.29292,1217
11920,91967,E46795A590C643FCDE6B993B35621D2F,30921,18,19,1,109.53903,18.29451,1667
11930,92084,30F5D42A1A8F1CF26F5C9617FCB06C4F,31561,0,6,6,109.56792,18.28479,1765
11931,92085,30F5D42A1A8F1CF26F5C9617FCB06C4F,39183,8,9,1,109.55542,18.28208,1715
11932,92086,30F5D42A1A8F1CF26F5C9617FCB06C4F,31561,10,11,1,109.56792,18.28479,1765
11933,92087,30F5D42A1A8F1CF26F5C9617FCB06C4F,39183,14,15,1,109.55542,18.28208,1715
11942,92205,0046001E45A9DDB75555AADDDC352392,31071,0,14,14,109.58257,18.28458,1815
11943,92206,0046001E45A9DDB75555AADDDC352392,30854,16,17,1,109.56889,18.27076,1763
11944,92207,0046001E45A9DDB75555AADDDC352392,31071,18,23,5,109.58257,18.28458,1815
11949,92254,70A62761FE79F922D082380DA7747243,30854,0,17,17,109.56889,18.27076,1763
11950,92255,70A62761FE79F922D082380DA7747243,31561,17,19,2,109.56792,18.28479,1765
11951,92256,70A62761FE79F922D082380DA7747243,30854,20,22,2,109.56889,18.27076,1763
11954,92301,A749E400BFD3B5908671E939EC104DEE,30854,0,6,6,109.56889,18.27076,1763
11955,92302,A749E400BFD3B5908671E939EC104DEE,31071,6,8,2,109.58257,18.28458,1815
11956,92303,A749E400BFD3B5908671E939EC104DEE,30854,8,21,13,109.56889,18.27076,1763
11968,92333,608A55C14BAB2A5B627ACC1F39B89FB6,31945,0,13,13,109.58021,18.29403,1817
11969,92334,608A55C14BAB2A5B627ACC1F39B89FB6,31071,15,16,1,109.58257,18.28458,1815
11970,92335,608A55C14BAB2A5B627ACC1F39B89FB6,31945,21,22,1,109.58021,18.29403,1817
11974,92427,10EBF762D28520B09848288F7052CFDE,30854,0,6,6,109.56889,18.27076,1763
11975,92428,10EBF762D28520B09848288F7052CFDE,39101,8,17,9,109.50132,18.24931,1509
11976,92429,10EBF762D28520B09848288F7052CFDE,30854,20,23,3,109.56889,18.27076,1763
11983,92476,963B5F4C98446446023B8ED177B869B3,60361,0,6,6,109.51938,18.29681,1567
11984,92477,963B5F4C98446446023B8ED177B869B3,39183,11,17,6,109.55542,18.28208,1715
11985,92478,963B5F4C98446446023B8ED177B869B3,60361,18,23,5,109.51938,18.29681,1567
12004,92608,B621E9075674E792CCB217233825F9D1,30851,2,6,4,109.5616,18.27396,1713
12005,92609,B621E9075674E792CCB217233825F9D1,30854,11,12,1,109.56889,18.27076,1763
12006,92610,B621E9075674E792CCB217233825F9D1,60631,14,15,1,109.57778,18.27583,1814
12022,92754,7421066246AAD1C230E7E2A7ADF06E9D,60631,0,6,6,109.57778,18.27583,1814
12023,92755,7421066246AAD1C230E7E2A7ADF06E9D,30854,7,15,8,109.56889,18.27076,1763
12024,92756,7421066246AAD1C230E7E2A7ADF06E9D,31071,17,18,1,109.58257,18.28458,1815
12025,92757,7421066246AAD1C230E7E2A7ADF06E9D,30854,18,19,1,109.56889,18.27076,1763
12026,92775,A01B4012B619D942E7CC3AC9B78722B4,31561,0,1,1,109.56792,18.28479,1765
12027,92776,A01B4012B619D942E7CC3AC9B78722B4,30851,1,5,4,109.5616,18.27396,1713
12028,92777,A01B4012B619D942E7CC3AC9B78722B4,39183,7,8,1,109.55542,18.28208,1715
12029,92778,A01B4012B619D942E7CC3AC9B78722B4,31561,12,23,11,109.56792,18.28479,1765
12030,92798,417408FFDA93B177641D270D3A5C4B2D,31071,2,14,12,109.58257,18.28458,1815
12031,92799,417408FFDA93B177641D270D3A5C4B2D,60631,15,17,2,109.57778,18.27583,1814
12032,92800,417408FFDA93B177641D270D3A5C4B2D,31071,21,23,2,109.58257,18.28458,1815
12044,92871,0A9117B90774715AACE2ED3045D6F579,60041,0,7,7,109.39889,18.31944,1121
12045,92872,0A9117B90774715AACE2ED3045D6F579,31081,9,10,1,109.44639,18.30181,1318
12046,92873,0A9117B90774715AACE2ED3045D6F579,30761,13,15,2,109.45201,18.3,1318
12063,93070,AFCD0831F8AAAE7DDAE42327797F10EB,30854,1,2,1,109.56889,18.27076,1763
12064,93071,AFCD0831F8AAAE7DDAE42327797F10EB,31761,4,5,1,109.60521,18.27965,1914
12065,93072,AFCD0831F8AAAE7DDAE42327797F10EB,30854,10,11,1,109.56889,18.27076,1763
12066,93073,AFCD0831F8AAAE7DDAE42327797F10EB,31071,14,21,7,109.58257,18.28458,1815
12096,93262,2A6BA0678DDF16AF08BAC9E3FA3C9391,31561,0,5,5,109.56792,18.28479,1765
12097,93263,2A6BA0678DDF16AF08BAC9E3FA3C9391,30854,9,19,10,109.56889,18.27076,1763
12098,93264,2A6BA0678DDF16AF08BAC9E3FA3C9391,31561,22,23,1,109.56792,18.28479,1765
12111,93334,8AE547CC56788F82C32B9A8562096998,31071,0,7,7,109.58257,18.28458,1815
12112,93335,8AE547CC56788F82C32B9A8562096998,30854,7,16,9,109.56889,18.27076,1763
12113,93336,8AE547CC56788F82C32B9A8562096998,31071,16,18,2,109.58257,18.28458,1815
12130,93522,ABCD0851CC1C78BCD7AF6DBDF2F5DE49,60551,0,1,1,109.42722,18.30111,1218
12131,93523,ABCD0851CC1C78BCD7AF6DBDF2F5DE49,30821,1,5,4,109.43681,18.33639,1274
12132,93524,ABCD0851CC1C78BCD7AF6DBDF2F5DE49,60552,6,19,13,109.41729,18.30014,1218
12162,93735,6F25B46DE233F84CBE88187DB2427FA9,30201,0,6,6,109.4909,18.26465,1462
12163,93736,6F25B46DE233F84CBE88187DB2427FA9,31021,7,8,1,109.49021,18.27,1463
12164,93737,6F25B46DE233F84CBE88187DB2427FA9,30201,9,23,14,109.4909,18.26465,1462
12165,93741,C75BC5F85072980078D1BA009D1D1AB7,31561,0,6,6,109.56792,18.28479,1765
12166,93742,C75BC5F85072980078D1BA009D1D1AB7,39183,8,15,7,109.55542,18.28208,1715
12167,93743,C75BC5F85072980078D1BA009D1D1AB7,31561,15,16,1,109.56792,18.28479,1765
12168,93744,C75BC5F85072980078D1BA009D1D1AB7,39183,19,20,1,109.55542,18.28208,1715
12184,93909,00FD2268DE6E83934D2916174E81532F,30764,0,2,2,109.45806,18.29486,1367
12185,93910,00FD2268DE6E83934D2916174E81532F,30111,3,9,6,109.47583,18.30542,1419
12186,93911,00FD2268DE6E83934D2916174E81532F,60472,11,15,4,109.46625,18.29542,1367
12187,93912,00FD2268DE6E83934D2916174E81532F,30111,18,22,4,109.47583,18.30542,1419
12203,94004,9FD9B533440DEDA093A3D6D9A5E4AA42,31945,0,10,10,109.58021,18.29403,1817
12204,94005,9FD9B533440DEDA093A3D6D9A5E4AA42,30854,12,13,1,109.56889,18.27076,1763
12205,94006,9FD9B533440DEDA093A3D6D9A5E4AA42,31071,15,17,2,109.58257,18.28458,1815
12206,94007,9FD9B533440DEDA093A3D6D9A5E4AA42,30854,19,20,1,109.56889,18.27076,1763
12247,94228,FB69127E95B4D9EC5AF61282F8D7EEB7,31071,2,6,4,109.58257,18.28458,1815
12248,94229,FB69127E95B4D9EC5AF61282F8D7EEB7,30854,7,8,1,109.56889,18.27076,1763
12249,94230,FB69127E95B4D9EC5AF61282F8D7EEB7,30921,11,12,1,109.53903,18.29451,1667
12250,94231,FB69127E95B4D9EC5AF61282F8D7EEB7,30854,12,22,10,109.56889,18.27076,1763
12265,94379,3968C9A12C216FF93EDF454D44490440,30854,1,6,5,109.56889,18.27076,1763
12266,94380,3968C9A12C216FF93EDF454D44490440,30951,9,10,1,109.56208,18.25667,1761
12267,94381,3968C9A12C216FF93EDF454D44490440,31421,11,13,2,109.55382,18.22347,1705
12268,94382,3968C9A12C216FF93EDF454D44490440,30851,18,23,5,109.5616,18.27396,1713
12276,94493,9FC721E86703223349C05C95FE4BBB6F,60081,1,10,9,109.51097,18.22639,1556
12277,94494,9FC721E86703223349C05C95FE4BBB6F,31521,11,20,9,109.51458,18.22542,1555
12278,94495,9FC721E86703223349C05C95FE4BBB6F,60087,21,23,2,109.50688,18.22299,1505
12316,94717,09BC7492AFAC79ACDD6C82A3AF49EFB0,60361,0,6,6,109.51938,18.29681,1567
12317,94718,09BC7492AFAC79ACDD6C82A3AF49EFB0,60552,8,9,1,109.41729,18.30014,1218
12318,94719,09BC7492AFAC79ACDD6C82A3AF49EFB0,30854,10,12,2,109.56889,18.27076,1763
12319,94720,09BC7492AFAC79ACDD6C82A3AF49EFB0,60491,14,23,9,109.43354,18.30847,1269
12325,94798,A31156C6519BD5D8AB23829D811E9C63,30361,0,15,15,109.50347,18.24,1508
12326,94799,A31156C6519BD5D8AB23829D811E9C63,31041,15,18,3,109.50278,18.23701,1507
12327,94800,A31156C6519BD5D8AB23829D811E9C63,30511,20,23,3,109.51069,18.24208,1558
12328,94846,47A18820FDA9856131F74091D44B6BCB,31071,0,7,7,109.58257,18.28458,1815
12329,94847,47A18820FDA9856131F74091D44B6BCB,31561,9,15,6,109.56792,18.28479,1765
12330,94848,47A18820FDA9856131F74091D44B6BCB,30851,15,18,3,109.5616,18.27396,1713
12331,94849,47A18820FDA9856131F74091D44B6BCB,31561,19,21,2,109.56792,18.28479,1765
12332,94889,B663EE883B81AEB709AC84DCCEC3D38E,31945,1,8,7,109.58021,18.29403,1817
12333,94890,B663EE883B81AEB709AC84DCCEC3D38E,30854,9,12,3,109.56889,18.27076,1763
12334,94891,B663EE883B81AEB709AC84DCCEC3D38E,31945,13,14,1,109.58021,18.29403,1817
12335,94892,B663EE883B81AEB709AC84DCCEC3D38E,30854,15,19,4,109.56889,18.27076,1763
12357,94981,84DF4A7C208235D171EF56473BCCF210,31561,4,6,2,109.56792,18.28479,1765
12358,94982,84DF4A7C208235D171EF56473BCCF210,60631,8,18,10,109.57778,18.27583,1814
12359,94983,84DF4A7C208235D171EF56473BCCF210,30851,22,23,1,109.5616,18.27396,1713
12360,94996,015CDEB9169BCE5537ABAE49B6A63F2B,31071,5,7,2,109.58257,18.28458,1815
12361,94997,015CDEB9169BCE5537ABAE49B6A63F2B,30854,8,17,9,109.56889,18.27076,1763
12362,94998,015CDEB9169BCE5537ABAE49B6A63F2B,31071,18,20,2,109.58257,18.28458,1815
12363,94999,015CDEB9169BCE5537ABAE49B6A63F2B,31945,22,23,1,109.58021,18.29403,1817
12370,95040,7024F3A14F6F554DC6E80063E30315F0,30854,0,1,1,109.56889,18.27076,1763
12371,95041,7024F3A14F6F554DC6E80063E30315F0,31561,2,6,4,109.56792,18.28479,1765
12372,95042,7024F3A14F6F554DC6E80063E30315F0,39183,9,10,1,109.55542,18.28208,1715
12381,95155,C50EC98EBB3AD6F34D76F87C749DAC01,39181,0,10,10,109.55153,18.28035,1715
12382,95156,C50EC98EBB3AD6F34D76F87C749DAC01,31931,14,16,2,109.54771,18.29403,1667
12383,95157,C50EC98EBB3AD6F34D76F87C749DAC01,39181,17,18,1,109.55153,18.28035,1715
12384,95158,C50EC98EBB3AD6F34D76F87C749DAC01,39181,18,23,5,109.55153,18.28035,1715
12394,95184,AEED1E225CF3D1399AAF76E61B9A21EB,38951,0,12,12,109.48097,18.28868,1416
12395,95185,AEED1E225CF3D1399AAF76E61B9A21EB,38951,14,16,2,109.48097,18.28868,1416
12396,95186,AEED1E225CF3D1399AAF76E61B9A21EB,38951,17,22,5,109.48097,18.28868,1416
12405,95226,8D7B9451E0189947198D6AC9CE51CFEE,30761,0,2,2,109.45201,18.3,1318
12406,95227,8D7B9451E0189947198D6AC9CE51CFEE,60261,2,3,1,109.44326,18.3075,1319
12407,95228,8D7B9451E0189947198D6AC9CE51CFEE,31091,4,18,14,109.41201,18.31222,1170
12416,95253,335A7B1DE8538918FDA774EE3E402A76,30191,0,7,7,109.50361,18.22701,1506
12417,95254,335A7B1DE8538918FDA774EE3E402A76,31521,7,13,6,109.51458,18.22542,1555
12418,95255,335A7B1DE8538918FDA774EE3E402A76,30191,14,23,9,109.50361,18.22701,1506
12419,95260,3EDEED23FD96D9ADA498E55D7B0F4A62,30281,0,7,7,109.50597,18.27583,1514
12420,95261,3EDEED23FD96D9ADA498E55D7B0F4A62,31931,7,8,1,109.54771,18.29403,1667
12421,95262,3EDEED23FD96D9ADA498E55D7B0F4A62,39183,11,13,2,109.55542,18.28208,1715
12472,95597,CCCD2290FB632A48009771412BE68ADD,31561,0,9,9,109.56792,18.28479,1765
12473,95598,CCCD2290FB632A48009771412BE68ADD,30851,11,12,1,109.5616,18.27396,1713
12474,95599,CCCD2290FB632A48009771412BE68ADD,31561,14,21,7,109.56792,18.28479,1765
12480,95636,99CBAA6A65A50998F0A10B72B36210E4,30271,0,1,1,109.49132,18.23153,1456
12481,95637,99CBAA6A65A50998F0A10B72B36210E4,60231,2,18,16,109.49903,18.21972,1504
12482,95638,99CBAA6A65A50998F0A10B72B36210E4,30271,19,20,1,109.49132,18.23153,1456
12496,95865,BACB6801ACA2D5F4ABE5F40B34865F7A,31561,1,2,1,109.56792,18.28479,1765
12497,95866,BACB6801ACA2D5F4ABE5F40B34865F7A,60631,4,7,3,109.57778,18.27583,1814
12498,95867,BACB6801ACA2D5F4ABE5F40B34865F7A,30851,9,11,2,109.5616,18.27396,1713
12499,95882,A55D4129A4D1B105629D337545083A9E,39183,5,6,1,109.55542,18.28208,1715
12500,95883,A55D4129A4D1B105629D337545083A9E,31561,8,11,3,109.56792,18.28479,1765
12501,95884,A55D4129A4D1B105629D337545083A9E,39183,13,18,5,109.55542,18.28208,1715
12502,95885,A55D4129A4D1B105629D337545083A9E,31561,19,21,2,109.56792,18.28479,1765
12521,95986,1980C8D409DE9551539224B3D393CDAA,30071,0,1,1,109.52819,18.30472,1619
12522,95987,1980C8D409DE9551539224B3D393CDAA,31951,3,5,2,109.52174,18.30299,1568
12523,95988,1980C8D409DE9551539224B3D393CDAA,30071,5,23,18,109.52819,18.30472,1619
12542,96073,372B6FDE38B899AE3F54A72097165114,39183,0,17,17,109.55542,18.28208,1715
12543,96074,372B6FDE38B899AE3F54A72097165114,31561,17,18,1,109.56792,18.28479,1765
12544,96075,372B6FDE38B899AE3F54A72097165114,39183,21,22,1,109.55542,18.28208,1715
12555,96212,8752BC71725B50257436D50C6598F252,31071,0,6,6,109.58257,18.28458,1815
12556,96213,8752BC71725B50257436D50C6598F252,30854,8,10,2,109.56889,18.27076,1763
12557,96214,8752BC71725B50257436D50C6598F252,31071,12,13,1,109.58257,18.28458,1815
12558,96215,8752BC71725B50257436D50C6598F252,30854,13,20,7,109.56889,18.27076,1763
12562,96309,377A324496E54511961704972731A3D5,31821,0,8,8,109.51181,18.24924,1559
12563,96310,377A324496E54511961704972731A3D5,39111,12,14,2,109.5191,18.22597,1555
12564,96311,377A324496E54511961704972731A3D5,31391,16,18,2,109.50382,18.24285,1508
12565,96312,377A324496E54511961704972731A3D5,30201,20,22,2,109.4909,18.26465,1462
12571,96391,1412BA3B65BC1A2354CCBE297098A0E1,31071,0,13,13,109.58257,18.28458,1815
12572,96392,1412BA3B65BC1A2354CCBE297098A0E1,30854,15,21,6,109.56889,18.27076,1763
12573,96393,1412BA3B65BC1A2354CCBE297098A0E1,31071,22,23,1,109.58257,18.28458,1815
12581,96427,9AA959ED87D1ECC3053DED17290EFCBD,31561,4,6,2,109.56792,18.28479,1765
12582,96428,9AA959ED87D1ECC3053DED17290EFCBD,39183,8,10,2,109.55542,18.28208,1715
12583,96429,9AA959ED87D1ECC3053DED17290EFCBD,31561,10,11,1,109.56792,18.28479,1765
12584,96430,9AA959ED87D1ECC3053DED17290EFCBD,30854,13,14,1,109.56889,18.27076,1763
12606,96609,765E065B95790AB69D4C7204094FCA10,31071,0,6,6,109.58257,18.28458,1815
12607,96610,765E065B95790AB69D4C7204094FCA10,30854,6,8,2,109.56889,18.27076,1763
12608,96611,765E065B95790AB69D4C7204094FCA10,31071,10,20,10,109.58257,18.28458,1815
12613,96623,40285EE8CCE25C38988EC087545664EC,31071,1,7,6,109.58257,18.28458,1815
12614,96624,40285EE8CCE25C38988EC087545664EC,30854,7,20,13,109.56889,18.27076,1763
12615,96625,40285EE8CCE25C38988EC087545664EC,31071,20,21,1,109.58257,18.28458,1815
12635,96739,95D72611B2EA258C315A6529F3A1698E,30854,1,3,2,109.56889,18.27076,1763
12636,96740,95D72611B2EA258C315A6529F3A1698E,31071,4,12,8,109.58257,18.28458,1815
12637,96741,95D72611B2EA258C315A6529F3A1698E,30854,13,15,2,109.56889,18.27076,1763
12646,96873,D4F66FB71406E4E38A7A105B0CD3164D,30711,0,15,15,109.50271,18.25347,1510
12647,96874,D4F66FB71406E4E38A7A105B0CD3164D,60381,15,16,1,109.5241,18.22458,1605
12648,96875,D4F66FB71406E4E38A7A105B0CD3164D,30711,17,23,6,109.50271,18.25347,1510
12663,97047,39F25FE146A03325C93C111F2A943B6C,31945,0,13,13,109.58021,18.29403,1817
12664,97048,39F25FE146A03325C93C111F2A943B6C,30854,14,20,6,109.56889,18.27076,1763
12665,97049,39F25FE146A03325C93C111F2A943B6C,31945,22,23,1,109.58021,18.29403,1817
12677,97134,1E36640BE395A4EE8CCB2697222419A5,60631,0,6,6,109.57778,18.27583,1814
12678,97135,1E36640BE395A4EE8CCB2697222419A5,30854,7,10,3,109.56889,18.27076,1763
12679,97136,1E36640BE395A4EE8CCB2697222419A5,31071,14,16,2,109.58257,18.28458,1815
12680,97137,1E36640BE395A4EE8CCB2697222419A5,30854,18,19,1,109.56889,18.27076,1763
12681,97140,14AE6C820CE45F96077630992CABD33D,30851,0,11,11,109.5616,18.27396,1713
12682,97141,14AE6C820CE45F96077630992CABD33D,30951,11,13,2,109.56208,18.25667,1761
12683,97142,14AE6C820CE45F96077630992CABD33D,31551,17,22,5,109.55868,18.24222,1708
12692,97242,EC4B90EDBF35256FDB4D4F8B87DB8A04,31071,2,7,5,109.58257,18.28458,1815
12693,97243,EC4B90EDBF35256FDB4D4F8B87DB8A04,30854,8,16,8,109.56889,18.27076,1763
12694,97244,EC4B90EDBF35256FDB4D4F8B87DB8A04,31071,20,22,2,109.58257,18.28458,1815
12695,97250,E0A24740E2C54F3B77DB561A91D2BED7,30151,0,5,5,109.50986,18.25083,1560
12696,97251,E0A24740E2C54F3B77DB561A91D2BED7,30251,8,17,9,109.50611,18.26653,1512
12697,97252,E0A24740E2C54F3B77DB561A91D2BED7,30151,18,23,5,109.50986,18.25083,1560
12700,97333,0D69669D4DBC1CEB06269A084D86E853,30854,0,8,8,109.56889,18.27076,1763
12701,97334,0D69669D4DBC1CEB06269A084D86E853,30581,9,19,10,109.62257,18.24951,1959
12702,97335,0D69669D4DBC1CEB06269A084D86E853,60631,20,22,2,109.57778,18.27583,1814
12708,97486,EA446444DFE25212830F95291C13D19D,31931,0,6,6,109.54771,18.29403,1667
12709,97487,EA446444DFE25212830F95291C13D19D,39181,8,9,1,109.55153,18.28035,1715
12710,97488,EA446444DFE25212830F95291C13D19D,31931,12,20,8,109.54771,18.29403,1667
12728,97618,E218C587552A5DADC05C4E69685FE374,39183,0,6,6,109.55542,18.28208,1715
12729,97619,E218C587552A5DADC05C4E69685FE374,30854,8,20,12,109.56889,18.27076,1763
12730,97620,E218C587552A5DADC05C4E69685FE374,39183,21,23,2,109.55542,18.28208,1715
12739,97686,1D8B814EC83D52D7C5F3FED99C129EE0,30854,0,1,1,109.56889,18.27076,1763
12740,97687,1D8B814EC83D52D7C5F3FED99C129EE0,60631,4,6,2,109.57778,18.27583,1814
12741,97688,1D8B814EC83D52D7C5F3FED99C129EE0,30854,11,18,7,109.56889,18.27076,1763
12765,97905,AB43182259122294244C13D6FC66D4A1,60631,0,6,6,109.57778,18.27583,1814
12766,97906,AB43182259122294244C13D6FC66D4A1,30851,9,18,9,109.5616,18.27396,1713
12767,97907,AB43182259122294244C13D6FC66D4A1,60631,19,21,2,109.57778,18.27583,1814
12768,97934,036DFEF8CA623F9034F928149FE2468D,30821,0,3,3,109.43681,18.33639,1274
12769,97935,036DFEF8CA623F9034F928149FE2468D,30651,4,10,6,109.42611,18.385,1232
12770,97936,036DFEF8CA623F9034F928149FE2468D,30821,10,12,2,109.43681,18.33639,1274
12778,97977,F8D799D9161B0143E0D71C40472A357E,30071,0,8,8,109.52819,18.30472,1619
12779,97978,F8D799D9161B0143E0D71C40472A357E,30071,11,13,2,109.52819,18.30472,1619
12780,97979,F8D799D9161B0143E0D71C40472A357E,30071,17,19,2,109.52819,18.30472,1619
12781,97980,F8D799D9161B0143E0D71C40472A357E,30071,20,23,3,109.52819,18.30472,1619
12786,98022,7BF65E5054DA81A230AB5423620158E1,60631,2,13,11,109.57778,18.27583,1814
12787,98023,7BF65E5054DA81A230AB5423620158E1,31071,15,16,1,109.58257,18.28458,1815
12788,98024,7BF65E5054DA81A230AB5423620158E1,30854,17,20,3,109.56889,18.27076,1763
12789,98025,7BF65E5054DA81A230AB5423620158E1,60631,22,23,1,109.57778,18.27583,1814
12822,98305,C6C3BC01E542B810EF853FEEB6C81198,60361,0,5,5,109.51938,18.29681,1567
12823,98306,C6C3BC01E542B810EF853FEEB6C81198,60221,6,7,1,109.52569,18.29188,1616
12824,98307,C6C3BC01E542B810EF853FEEB6C81198,60361,8,17,9,109.51938,18.29681,1567
12873,98631,FC8552628F8A5A5219C1C30314657039,60661,0,8,8,109.548,18.2377,1657
12874,98632,FC8552628F8A5A5219C1C30314657039,30271,9,11,2,109.49132,18.23153,1456
12875,98633,FC8552628F8A5A5219C1C30314657039,39191,12,13,1,109.51493,18.23472,1557
12886,98813,9EA825CA50A62195A51752F975FDCF57,31071,3,15,12,109.58257,18.28458,1815
12887,98814,9EA825CA50A62195A51752F975FDCF57,30854,15,17,2,109.56889,18.27076,1763
12888,98815,9EA825CA50A62195A51752F975FDCF57,31071,18,20,2,109.58257,18.28458,1815
12907,98992,1B6EBBFF3B9D8A3E18753343B6A29EAE,31071,0,13,13,109.58257,18.28458,1815
12908,98993,1B6EBBFF3B9D8A3E18753343B6A29EAE,30851,14,18,4,109.5616,18.27396,1713
12909,98994,1B6EBBFF3B9D8A3E18753343B6A29EAE,31071,21,23,2,109.58257,18.28458,1815
12910,99056,68DBE0B52FD0AB95F1DD47068FD7847F,30181,0,11,11,109.51597,18.23313,1557
12911,99057,68DBE0B52FD0AB95F1DD47068FD7847F,31031,11,13,2,109.49979,18.25382,1510
12912,99058,68DBE0B52FD0AB95F1DD47068FD7847F,30181,13,21,8,109.51597,18.23313,1557
12921,99089,74206C862E4BA6236E7F7978D63D1D7D,30854,0,1,1,109.56889,18.27076,1763
12922,99090,74206C862E4BA6236E7F7978D63D1D7D,60631,1,2,1,109.57778,18.27583,1814
12923,99091,74206C862E4BA6236E7F7978D63D1D7D,30854,4,23,19,109.56889,18.27076,1763
12929,99142,2D8DAA5F24A7C71335ED6C7E0756CEA1,30711,0,7,7,109.50271,18.25347,1510
12930,99143,2D8DAA5F24A7C71335ED6C7E0756CEA1,38251,9,10,1,109.49618,18.25493,1510
12931,99144,2D8DAA5F24A7C71335ED6C7E0756CEA1,60291,12,15,3,109.50826,18.24639,1509
12932,99145,2D8DAA5F24A7C71335ED6C7E0756CEA1,60381,19,20,1,109.5241,18.22458,1605
12953,99311,8CA8213586CAC00347DCD29330308F27,31931,0,14,14,109.54771,18.29403,1667
12954,99312,8CA8213586CAC00347DCD29330308F27,30071,16,17,1,109.52819,18.30472,1619
12955,99313,8CA8213586CAC00347DCD29330308F27,31931,20,21,1,109.54771,18.29403,1667
12967,99441,080247CC19405F981D4BEFE1A1E9D339,39181,0,3,3,109.55153,18.28035,1715
12968,99442,080247CC19405F981D4BEFE1A1E9D339,31931,3,4,1,109.54771,18.29403,1667
12969,99443,080247CC19405F981D4BEFE1A1E9D339,39181,5,19,14,109.55153,18.28035,1715
12970,99444,080247CC19405F981D4BEFE1A1E9D339,31931,21,23,2,109.54771,18.29403,1667
12971,99479,19F803FB996471824A8A9928BBFAB433,39181,0,6,6,109.55153,18.28035,1715
12972,99480,19F803FB996471824A8A9928BBFAB433,31931,7,16,9,109.54771,18.29403,1667
12973,99481,19F803FB996471824A8A9928BBFAB433,39181,18,23,5,109.55153,18.28035,1715
12987,99651,7803AECF4FFC2BF233E3B7ACD0D2E9F8,39181,0,11,11,109.55153,18.28035,1715
12988,99652,7803AECF4FFC2BF233E3B7ACD0D2E9F8,31931,12,14,2,109.54771,18.29403,1667
12989,99653,7803AECF4FFC2BF233E3B7ACD0D2E9F8,39181,18,23,5,109.55153,18.28035,1715
12990,99673,5A888DC7A3AA300CC584D9862C5384A1,60221,1,7,6,109.52569,18.29188,1616
12991,99674,5A888DC7A3AA300CC584D9862C5384A1,39183,11,18,7,109.55542,18.28208,1715
12992,99675,5A888DC7A3AA300CC584D9862C5384A1,31261,21,22,1,109.51174,18.2466,1559
13004,99785,8AE8113E56204E191324933EBCC0418D,30181,0,1,1,109.51597,18.23313,1557
13005,99786,8AE8113E56204E191324933EBCC0418D,31206,2,3,1,109.50819,18.23549,1507
13006,99787,8AE8113E56204E191324933EBCC0418D,30181,4,5,1,109.51597,18.23313,1557
13020,100007,C358285726113434A30FBBA8DED710E7,60371,0,9,9,109.53063,18.30056,1618
13021,100008,C358285726113434A30FBBA8DED710E7,30071,11,12,1,109.52819,18.30472,1619
13022,100009,C358285726113434A30FBBA8DED710E7,31621,15,16,1,109.51035,18.29826,1568
13030,100071,24E98C0EC4A6054CC486A2611C493128,30854,2,5,3,109.56889,18.27076,1763
13031,100072,24E98C0EC4A6054CC486A2611C493128,31071,6,8,2,109.58257,18.28458,1815
13032,100073,24E98C0EC4A6054CC486A2611C493128,30854,8,9,1,109.56889,18.27076,1763
13033,100081,8621CFDF1B89A83351494618C53D033F,31071,1,8,7,109.58257,18.28458,1815
13034,100082,8621CFDF1B89A83351494618C53D033F,39181,8,10,2,109.55153,18.28035,1715
13035,100083,8621CFDF1B89A83351494618C53D033F,39181,10,13,3,109.55153,18.28035,1715
13036,100084,8621CFDF1B89A83351494618C53D033F,39181,15,23,8,109.55153,18.28035,1715
13073,100336,74A9CCA48CD6C2DA9FC7DFDB8817D50B,30851,2,3,1,109.5616,18.27396,1713
13074,100337,74A9CCA48CD6C2DA9FC7DFDB8817D50B,31945,3,5,2,109.58021,18.29403,1817
13075,100338,74A9CCA48CD6C2DA9FC7DFDB8817D50B,31071,8,10,2,109.58257,18.28458,1815
13076,100372,878FC5EBB1B28FAABA6E6BFD01664318,30251,0,16,16,109.50611,18.26653,1512
13077,100373,878FC5EBB1B28FAABA6E6BFD01664318,31181,17,18,1,109.50382,18.24813,1509
13078,100374,878FC5EBB1B28FAABA6E6BFD01664318,30251,21,23,2,109.50611,18.26653,1512
13086,100538,2DDF3A993BD69F79020EB97CF3A71819,38171,0,6,6,109.50799,18.28139,1515
13087,100539,2DDF3A993BD69F79020EB97CF3A71819,30161,10,15,5,109.50042,18.24389,1508
13088,100540,2DDF3A993BD69F79020EB97CF3A71819,30161,17,19,2,109.50042,18.24389,1508
13089,100541,2DDF3A993BD69F79020EB97CF3A71819,38171,21,23,2,109.50799,18.28139,1515
13095,100581,C9D18F84DE09060EAAE7ED1445E46CDD,30771,1,2,1,109.49938,18.26042,1511
13096,100582,C9D18F84DE09060EAAE7ED1445E46CDD,30911,2,9,7,109.50493,18.26181,1511
13097,100583,C9D18F84DE09060EAAE7ED1445E46CDD,31351,12,14,2,109.4959,18.28417,1465
13098,100584,EBD16061EA20EE33D9344D33735E5205,38891,0,6,6,109.51486,18.24118,1558
13099,100585,EBD16061EA20EE33D9344D33735E5205,31201,11,13,2,109.51042,18.23819,1558
13100,100586,EBD16061EA20EE33D9344D33735E5205,38291,14,17,3,109.51618,18.24313,1558
13113,100705,2F440A235E684ECEDD042B3100A4AE95,31071,0,7,7,109.58257,18.28458,1815
13114,100706,2F440A235E684ECEDD042B3100A4AE95,30854,9,15,6,109.56889,18.27076,1763
13115,100707,2F440A235E684ECEDD042B3100A4AE95,31561,18,19,1,109.56792,18.28479,1765
13138,100854,B55959B64746A18ECF5077B5F7359221,31561,0,6,6,109.56792,18.28479,1765
13139,100855,B55959B64746A18ECF5077B5F7359221,39183,8,10,2,109.55542,18.28208,1715
13140,100856,B55959B64746A18ECF5077B5F7359221,31561,11,14,3,109.56792,18.28479,1765
13146,101055,0C8D15C0488D521680F0DE3A28CFE111,30701,0,2,2,109.59313,18.32007,1871
13147,101056,0C8D15C0488D521680F0DE3A28CFE111,31811,2,3,1,109.54201,18.31806,1671
13148,101057,0C8D15C0488D521680F0DE3A28CFE111,30701,4,6,2,109.59313,18.32007,1871
13149,101079,0410C9BFB4956092D2C91E696A83188B,31071,1,6,5,109.58257,18.28458,1815
13150,101080,0410C9BFB4956092D2C91E696A83188B,30854,8,9,1,109.56889,18.27076,1763
13151,101081,0410C9BFB4956092D2C91E696A83188B,31071,11,13,2,109.58257,18.28458,1815
13152,101082,0410C9BFB4956092D2C91E696A83188B,30854,14,16,2,109.56889,18.27076,1763
13153,101094,64F4CDF664AA04E7B79DE93C57128CF6,31931,0,6,6,109.54771,18.29403,1667
13154,101095,64F4CDF664AA04E7B79DE93C57128CF6,39181,8,19,11,109.55153,18.28035,1715
13155,101096,64F4CDF664AA04E7B79DE93C57128CF6,31931,19,22,3,109.54771,18.29403,1667
13164,101108,45CCFCD3EBDF941E1C92B70ED06E8B5E,30854,0,8,8,109.56889,18.27076,1763
13165,101109,45CCFCD3EBDF941E1C92B70ED06E8B5E,31071,11,12,1,109.58257,18.28458,1815
13166,101110,45CCFCD3EBDF941E1C92B70ED06E8B5E,30854,12,16,4,109.56889,18.27076,1763
13174,101181,933C30058B1CA246EC59609197D7CAAB,31071,1,16,15,109.58257,18.28458,1815
13175,101182,933C30058B1CA246EC59609197D7CAAB,38157,19,21,2,109.51483,18.26958,1563
13176,101183,933C30058B1CA246EC59609197D7CAAB,31071,22,23,1,109.58257,18.28458,1815
13198,101378,C93386A9D86FE22A1FD4E5116045DD8D,31561,2,3,1,109.56792,18.28479,1765
13199,101379,C93386A9D86FE22A1FD4E5116045DD8D,39183,7,15,8,109.55542,18.28208,1715
13200,101380,C93386A9D86FE22A1FD4E5116045DD8D,30854,19,20,1,109.56889,18.27076,1763
13203,101421,2B8C748A18FA7D08D4335AD7C9DEF01B,31761,0,6,6,109.60521,18.27965,1914
13204,101422,2B8C748A18FA7D08D4335AD7C9DEF01B,30951,9,15,6,109.56208,18.25667,1761
13205,101423,2B8C748A18FA7D08D4335AD7C9DEF01B,31761,19,22,3,109.60521,18.27965,1914
13224,101596,D37BF241A4A35F0F341582CAF9EF0DD2,31205,0,1,1,109.51111,18.23736,1557
13225,101597,D37BF241A4A35F0F341582CAF9EF0DD2,31206,1,7,6,109.50819,18.23549,1507
13226,101598,D37BF241A4A35F0F341582CAF9EF0DD2,60081,9,13,4,109.51097,18.22639,1556
13227,101599,D37BF241A4A35F0F341582CAF9EF0DD2,39191,14,17,3,109.51493,18.23472,1557
13228,101618,0133DDFFB5CECBB261CEDEF10A82D50B,31561,0,11,11,109.56792,18.28479,1765
13229,101619,0133DDFFB5CECBB261CEDEF10A82D50B,31071,11,14,3,109.58257,18.28458,1815
13230,101620,0133DDFFB5CECBB261CEDEF10A82D50B,30234,14,16,2,109.60681,18.29979,1918
13270,101787,173CD7A2B7B334BC53A50A1D248FBCFE,31071,0,7,7,109.58257,18.28458,1815
13271,101788,173CD7A2B7B334BC53A50A1D248FBCFE,30854,7,9,2,109.56889,18.27076,1763
13272,101789,173CD7A2B7B334BC53A50A1D248FBCFE,31071,12,20,8,109.58257,18.28458,1815
13273,101793,451E2BF48CD7B253EB0892324E679BCC,38297,0,6,6,109.52576,18.24965,1609
13274,101794,451E2BF48CD7B253EB0892324E679BCC,60281,7,19,12,109.51743,18.25924,1561
13275,101795,451E2BF48CD7B253EB0892324E679BCC,60311,20,22,2,109.52097,18.24319,1558
13290,101887,2E10AE81CA4EDA6CD33CFF9EBE881FD8,31031,0,4,4,109.49979,18.25382,1510
13291,101888,2E10AE81CA4EDA6CD33CFF9EBE881FD8,31031,4,13,9,109.49979,18.25382,1510
13292,101889,2E10AE81CA4EDA6CD33CFF9EBE881FD8,31031,14,22,8,109.49979,18.25382,1510
13293,101890,2E10AE81CA4EDA6CD33CFF9EBE881FD8,30711,22,23,1,109.50271,18.25347,1510
13305,101945,6BB908E717D43CA60DB426B647CF8DE4,31091,0,7,7,109.41201,18.31222,1170
13306,101946,6BB908E717D43CA60DB426B647CF8DE4,60041,7,9,2,109.39889,18.31944,1121
13307,101947,6BB908E717D43CA60DB426B647CF8DE4,31091,12,23,11,109.41201,18.31222,1170
13320,101989,283001ED673D8EDBEF7EEB00BDB31533,60231,3,4,1,109.49903,18.21972,1504
13321,101990,283001ED673D8EDBEF7EEB00BDB31533,31181,6,14,8,109.50382,18.24813,1509
13322,101991,283001ED673D8EDBEF7EEB00BDB31533,30571,18,21,3,109.50243,18.21861,1504
13323,102006,42923D86FCA39B981325B127230BF145,30232,2,14,12,109.6191,18.31701,1971
13324,102007,42923D86FCA39B981325B127230BF145,31221,15,17,2,109.61333,18.26833,1913
13325,102008,42923D86FCA39B981325B127230BF145,30232,19,21,2,109.6191,18.31701,1971
13326,102042,FD45DAD5A6F6BB711255CB29E453CFF1,30854,0,15,15,109.56889,18.27076,1763
13327,102043,FD45DAD5A6F6BB711255CB29E453CFF1,60631,16,17,1,109.57778,18.27583,1814
13328,102044,FD45DAD5A6F6BB711255CB29E453CFF1,30854,21,23,2,109.56889,18.27076,1763
13331,102078,CB1C8502149DACE0B32B2F7416279EF2,30854,0,2,2,109.56889,18.27076,1763
13332,102079,CB1C8502149DACE0B32B2F7416279EF2,31071,3,6,3,109.58257,18.28458,1815
13333,102080,CB1C8502149DACE0B32B2F7416279EF2,30854,10,14,4,109.56889,18.27076,1763
13334,102081,CB1C8502149DACE0B32B2F7416279EF2,31071,15,23,8,109.58257,18.28458,1815
13335,102109,D39D64452E6BBEF7B3056CA239E1B86E,30854,0,6,6,109.56889,18.27076,1763
13336,102110,D39D64452E6BBEF7B3056CA239E1B86E,31561,6,9,3,109.56792,18.28479,1765
13337,102111,D39D64452E6BBEF7B3056CA239E1B86E,30854,9,23,14,109.56889,18.27076,1763
13345,102235,1FE2866848043A2C10AD87212485FE15,31071,0,6,6,109.58257,18.28458,1815
13346,102236,1FE2866848043A2C10AD87212485FE15,30854,7,11,4,109.56889,18.27076,1763
13347,102237,1FE2866848043A2C10AD87212485FE15,31071,11,14,3,109.58257,18.28458,1815
13351,102258,A97645679390087E090050CF3F130352,31931,0,14,14,109.54771,18.29403,1667
13352,102259,A97645679390087E090050CF3F130352,30921,14,15,1,109.53903,18.29451,1667
13353,102260,A97645679390087E090050CF3F130352,31931,20,23,3,109.54771,18.29403,1667
13354,102269,B5686BCA7E4C74E299FC4E3D24CAC39C,39151,0,9,9,109.49875,18.25097,1510
13355,102270,B5686BCA7E4C74E299FC4E3D24CAC39C,31531,9,11,2,109.49583,18.25972,1461
13356,102271,B5686BCA7E4C74E299FC4E3D24CAC39C,31031,12,14,2,109.49979,18.25382,1510
13357,102272,B5686BCA7E4C74E299FC4E3D24CAC39C,60131,14,15,1,109.49819,18.24778,1509
13358,102307,CD576F1C1CDFB89E6A99A20E65927346,31561,2,11,9,109.56792,18.28479,1765
13359,102308,CD576F1C1CDFB89E6A99A20E65927346,30854,15,16,1,109.56889,18.27076,1763
13360,102309,CD576F1C1CDFB89E6A99A20E65927346,31561,16,17,1,109.56792,18.28479,1765
13361,102310,CD576F1C1CDFB89E6A99A20E65927346,30854,18,19,1,109.56889,18.27076,1763
13362,102326,9C7AFD6F67C3677E74C4343080215938,60621,5,8,3,109.48354,18.27451,1464
13363,102327,9C7AFD6F67C3677E74C4343080215938,30421,11,15,4,109.50021,18.25861,1511
13364,102328,9C7AFD6F67C3677E74C4343080215938,60401,19,21,2,109.47444,18.27583,1414
13365,102329,9C7AFD6F67C3677E74C4343080215938,30171,21,23,2,109.48458,18.27139,1463
13366,102337,613BD9834E9B58F193261B0D819B4BF9,30854,0,2,2,109.56889,18.27076,1763
13367,102338,613BD9834E9B58F193261B0D819B4BF9,31071,2,5,3,109.58257,18.28458,1815
13368,102339,613BD9834E9B58F193261B0D819B4BF9,30854,7,9,2,109.56889,18.27076,1763
13369,102358,B712327B6033C61F37801CFD6DAC08AD,31951,2,4,2,109.52174,18.30299,1568
13370,102359,B712327B6033C61F37801CFD6DAC08AD,38484,6,10,4,109.53028,18.31528,1620
13371,102360,B712327B6033C61F37801CFD6DAC08AD,38484,12,22,10,109.53028,18.31528,1620
13396,102532,5C81DE179C8306F5FC21CD27B4FDA902,30854,0,1,1,109.56889,18.27076,1763
13397,102533,5C81DE179C8306F5FC21CD27B4FDA902,31561,2,11,9,109.56792,18.28479,1765
13398,102534,5C81DE179C8306F5FC21CD27B4FDA902,30854,14,15,1,109.56889,18.27076,1763
13401,102578,09605A95AE7BE30FC92DC699DB3FCBD0,31181,2,10,8,109.50382,18.24813,1509
13402,102579,09605A95AE7BE30FC92DC699DB3FCBD0,31461,13,15,2,109.5091,18.25389,1510
13403,102580,09605A95AE7BE30FC92DC699DB3FCBD0,30291,16,17,1,109.50403,18.27028,1513
13404,102581,09605A95AE7BE30FC92DC699DB3FCBD0,60201,18,20,2,109.5041,18.2509,1510
13414,102651,AA2A5396AD753E9245AC53C94BAEDECD,61011,0,4,4,109.60653,18.19076,1900
13415,102653,AA2A5396AD753E9245AC53C94BAEDECD,61011,7,9,2,109.60653,18.19076,1900
13416,102655,AA2A5396AD753E9245AC53C94BAEDECD,61011,11,13,2,109.60653,18.19076,1900
13417,102657,AA2A5396AD753E9245AC53C94BAEDECD,61011,17,19,2,109.60653,18.19076,1900
13441,102832,76DA946F4DC1318DD46A32E1D303D6B7,31931,0,6,6,109.54771,18.29403,1667
13442,102833,76DA946F4DC1318DD46A32E1D303D6B7,39181,7,9,2,109.55153,18.28035,1715
13443,102834,76DA946F4DC1318DD46A32E1D303D6B7,39181,13,18,5,109.55153,18.28035,1715
13444,102835,76DA946F4DC1318DD46A32E1D303D6B7,31931,19,22,3,109.54771,18.29403,1667
13450,102881,DD056101D68CBFC24096E8F587CC747C,31931,0,2,2,109.54771,18.29403,1667
13451,102882,DD056101D68CBFC24096E8F587CC747C,30071,7,20,13,109.52819,18.30472,1619
13452,102883,DD056101D68CBFC24096E8F587CC747C,31931,20,23,3,109.54771,18.29403,1667
13453,102916,D8B19999D42CFF7EB03B9BAFA13044AB,30111,1,12,11,109.47583,18.30542,1419
13454,102917,D8B19999D42CFF7EB03B9BAFA13044AB,60011,12,14,2,109.48965,18.30222,1468
13455,102918,D8B19999D42CFF7EB03B9BAFA13044AB,30351,18,20,2,109.41701,18.29292,1217
13456,102919,D8B19999D42CFF7EB03B9BAFA13044AB,60421,21,22,1,109.46333,18.31743,1371
13465,103003,E4B522EF4348156010E5C578EC13D60F,30854,0,13,13,109.56889,18.27076,1763
13466,103004,E4B522EF4348156010E5C578EC13D60F,31945,13,14,1,109.58021,18.29403,1817
13467,103005,E4B522EF4348156010E5C578EC13D60F,60211,18,21,3,109.63549,18.26049,2011
13470,103032,608A55C14BAB2A5B627ACC1F39B89FB6,31945,0,7,7,109.58021,18.29403,1817
13471,103033,608A55C14BAB2A5B627ACC1F39B89FB6,30854,7,17,10,109.56889,18.27076,1763
13472,103034,608A55C14BAB2A5B627ACC1F39B89FB6,31945,18,22,4,109.58021,18.29403,1817
13490,103145,3E01B14B28C0FDBF8BB343D61C8AA7D8,31931,0,10,10,109.54771,18.29403,1667
13491,103146,3E01B14B28C0FDBF8BB343D61C8AA7D8,30721,14,17,3,109.51597,18.28257,1565
13492,103147,3E01B14B28C0FDBF8BB343D61C8AA7D8,31931,19,20,1,109.54771,18.29403,1667
13493,103148,3E01B14B28C0FDBF8BB343D61C8AA7D8,60241,22,23,1,109.53319,18.28667,1616
13494,103182,963B5F4C98446446023B8ED177B869B3,60361,0,6,6,109.51938,18.29681,1567
13495,103183,963B5F4C98446446023B8ED177B869B3,39183,7,15,8,109.55542,18.28208,1715
13496,103184,963B5F4C98446446023B8ED177B869B3,60361,18,23,5,109.51938,18.29681,1567
13497,103199,3307E282D5537E0AA5F104D069243EA1,30341,0,8,8,109.3625,18.29167,966
13498,103200,3307E282D5537E0AA5F104D069243EA1,60561,9,10,1,109.38229,18.29785,1067
13499,103201,3307E282D5537E0AA5F104D069243EA1,30341,11,16,5,109.3625,18.29167,966
13507,103300,6DF7485545B790F22810B0EDD8F1B356,31945,0,7,7,109.58021,18.29403,1817
13508,103301,6DF7485545B790F22810B0EDD8F1B356,30854,7,10,3,109.56889,18.27076,1763
13509,103302,6DF7485545B790F22810B0EDD8F1B356,31945,12,23,11,109.58021,18.29403,1817
13518,103368,19E8353A2DD0F178EBFC3FFA3E623B24,31945,0,7,7,109.58021,18.29403,1817
13519,103369,19E8353A2DD0F178EBFC3FFA3E623B24,30854,8,10,2,109.56889,18.27076,1763
13520,103370,19E8353A2DD0F178EBFC3FFA3E623B24,31945,13,14,1,109.58021,18.29403,1817
13521,103371,19E8353A2DD0F178EBFC3FFA3E623B24,30854,19,22,3,109.56889,18.27076,1763
13527,103476,7421066246AAD1C230E7E2A7ADF06E9D,60631,1,7,6,109.57778,18.27583,1814
13528,103477,7421066246AAD1C230E7E2A7ADF06E9D,31071,9,10,1,109.58257,18.28458,1815
13529,103478,7421066246AAD1C230E7E2A7ADF06E9D,30854,10,15,5,109.56889,18.27076,1763
13530,103479,7421066246AAD1C230E7E2A7ADF06E9D,30851,19,22,3,109.5616,18.27396,1713
13531,103513,417408FFDA93B177641D270D3A5C4B2D,31071,0,7,7,109.58257,18.28458,1815
13532,103514,417408FFDA93B177641D270D3A5C4B2D,60631,8,17,9,109.57778,18.27583,1814
13533,103515,417408FFDA93B177641D270D3A5C4B2D,31071,21,23,2,109.58257,18.28458,1815
13538,103581,8BD746060F2815A9C4F773DEDC3A1172,38023,0,8,8,109.37132,18.28993,1016
13539,103582,8BD746060F2815A9C4F773DEDC3A1172,30341,9,12,3,109.3625,18.29167,966
13540,103583,8BD746060F2815A9C4F773DEDC3A1172,60054,15,16,1,109.3016,18.31229,770
13541,103584,8BD746060F2815A9C4F773DEDC3A1172,38025,18,19,1,109.36903,18.29167,1016
13568,103792,AFCD0831F8AAAE7DDAE42327797F10EB,31071,0,6,6,109.58257,18.28458,1815
13569,103793,AFCD0831F8AAAE7DDAE42327797F10EB,31761,7,9,2,109.60521,18.27965,1914
13570,103794,AFCD0831F8AAAE7DDAE42327797F10EB,31071,11,12,1,109.58257,18.28458,1815
13574,103823,9BD0746EAD915C7FE62E448DC71186FA,31071,0,1,1,109.58257,18.28458,1815
13575,103824,9BD0746EAD915C7FE62E448DC71186FA,31945,2,7,5,109.58021,18.29403,1817
13576,103825,9BD0746EAD915C7FE62E448DC71186FA,30854,7,14,7,109.56889,18.27076,1763
13594,103946,A1B6F712D4BC56F4FFD51F3D8AB7895D,30854,0,1,1,109.56889,18.27076,1763
13595,103947,A1B6F712D4BC56F4FFD51F3D8AB7895D,31561,1,6,5,109.56792,18.28479,1765
13596,103948,A1B6F712D4BC56F4FFD51F3D8AB7895D,30854,6,9,3,109.56889,18.27076,1763
13600,103962,E58F7930139B2ED51DE79005F05C056D,39183,0,3,3,109.55542,18.28208,1715
13601,103963,E58F7930139B2ED51DE79005F05C056D,31931,5,6,1,109.54771,18.29403,1667
13602,103964,E58F7930139B2ED51DE79005F05C056D,39183,10,23,13,109.55542,18.28208,1715
13605,103991,2A6BA0678DDF16AF08BAC9E3FA3C9391,31561,2,5,3,109.56792,18.28479,1765
13606,103992,2A6BA0678DDF16AF08BAC9E3FA3C9391,30854,9,11,2,109.56889,18.27076,1763
13607,103993,2A6BA0678DDF16AF08BAC9E3FA3C9391,31561,11,13,2,109.56792,18.28479,1765
13608,103994,2A6BA0678DDF16AF08BAC9E3FA3C9391,30854,15,20,5,109.56889,18.27076,1763
13647,104232,ABCD0851CC1C78BCD7AF6DBDF2F5DE49,60552,0,14,14,109.41729,18.30014,1218
13648,104233,ABCD0851CC1C78BCD7AF6DBDF2F5DE49,60551,14,15,1,109.42722,18.30111,1218
13649,104234,ABCD0851CC1C78BCD7AF6DBDF2F5DE49,31231,18,19,1,109.42597,18.29292,1217
13650,104235,ABCD0851CC1C78BCD7AF6DBDF2F5DE49,60552,19,21,2,109.41729,18.30014,1218
13654,104300,37B1280251A3C52411E939549A58D078,39183,0,6,6,109.55542,18.28208,1715
13655,104301,37B1280251A3C52411E939549A58D078,39181,8,9,1,109.55153,18.28035,1715
13656,104302,37B1280251A3C52411E939549A58D078,39183,10,20,10,109.55542,18.28208,1715
13657,104319,B643AC77F8D8498A9694D45BA8B0F75F,60631,0,14,14,109.57778,18.27583,1814
13658,104320,B643AC77F8D8498A9694D45BA8B0F75F,30854,16,17,1,109.56889,18.27076,1763
13659,104321,B643AC77F8D8498A9694D45BA8B0F75F,31561,20,23,3,109.56792,18.28479,1765
13665,104329,7252A0F90E29EC78621699C082578EF7,31361,0,7,7,109.47417,18.28292,1415
13666,104330,7252A0F90E29EC78621699C082578EF7,31181,7,10,3,109.50382,18.24813,1509
13667,104331,7252A0F90E29EC78621699C082578EF7,60504,13,15,2,109.47917,18.28903,1416
13668,104332,7252A0F90E29EC78621699C082578EF7,60361,19,22,3,109.51938,18.29681,1567
13672,104446,5426296000364EE32711CD0E73D782C8,30854,2,7,5,109.56889,18.27076,1763
13673,104447,5426296000364EE32711CD0E73D782C8,31561,12,14,2,109.56792,18.28479,1765
13674,104448,5426296000364EE32711CD0E73D782C8,31181,16,17,1,109.50382,18.24813,1509
13675,104449,5426296000364EE32711CD0E73D782C8,30854,19,20,1,109.56889,18.27076,1763
13677,104458,2361E8D6BAB0231B2E8E3C0F34517282,30084,0,7,7,109.50118,18.26972,1513
13678,104459,2361E8D6BAB0231B2E8E3C0F34517282,31061,8,18,10,109.53333,18.23257,1607
13679,104460,2361E8D6BAB0231B2E8E3C0F34517282,30081,19,23,4,109.50243,18.26632,1512
13688,104501,4995463B780282C9C030A19D9F49AEAC,31071,1,7,6,109.58257,18.28458,1815
13689,104502,4995463B780282C9C030A19D9F49AEAC,30854,7,18,11,109.56889,18.27076,1763
13690,104503,4995463B780282C9C030A19D9F49AEAC,31071,19,21,2,109.58257,18.28458,1815
13695,104588,00FD2268DE6E83934D2916174E81532F,60011,1,2,1,109.48965,18.30222,1468
13696,104589,00FD2268DE6E83934D2916174E81532F,30111,6,7,1,109.47583,18.30542,1419
13697,104590,00FD2268DE6E83934D2916174E81532F,60472,8,9,1,109.46625,18.29542,1367
13698,104591,00FD2268DE6E83934D2916174E81532F,30111,13,20,7,109.47583,18.30542,1419
13702,104619,B340EDEF4A878E8DF5CBEC25E465EACE,30854,2,5,3,109.56889,18.27076,1763
13703,104620,B340EDEF4A878E8DF5CBEC25E465EACE,60631,9,11,2,109.57778,18.27583,1814
13704,104621,B340EDEF4A878E8DF5CBEC25E465EACE,30854,13,18,5,109.56889,18.27076,1763
13705,104622,B340EDEF4A878E8DF5CBEC25E465EACE,30391,21,22,1,109.4975,18.27118,1513
13723,104719,662D882A6A10D0E6C3566690F0A40636,30854,0,17,17,109.56889,18.27076,1763
13724,104720,662D882A6A10D0E6C3566690F0A40636,31071,19,20,1,109.58257,18.28458,1815
13725,104721,662D882A6A10D0E6C3566690F0A40636,30854,21,22,1,109.56889,18.27076,1763
13737,104819,D1EBD1A5A8A922DEF994C933F10DD8DB,31031,0,10,10,109.49979,18.25382,1510
13738,104820,D1EBD1A5A8A922DEF994C933F10DD8DB,60381,14,17,3,109.5241,18.22458,1605
13739,104821,D1EBD1A5A8A922DEF994C933F10DD8DB,30281,18,23,5,109.50597,18.27583,1514
13749,104926,B49997E558EBA6E6EDC3CFE777E3F80C,39181,0,7,7,109.55153,18.28035,1715
13750,104927,B49997E558EBA6E6EDC3CFE777E3F80C,39181,10,13,3,109.55153,18.28035,1715
13751,104928,B49997E558EBA6E6EDC3CFE777E3F80C,39181,16,17,1,109.55153,18.28035,1715
13752,104929,B49997E558EBA6E6EDC3CFE777E3F80C,39181,18,23,5,109.55153,18.28035,1715
13759,104957,12A8D64B0FFBA77A4E6F190F59F8F9F6,38951,1,8,7,109.48097,18.28868,1416
13760,104958,12A8D64B0FFBA77A4E6F190F59F8F9F6,30201,9,12,3,109.4909,18.26465,1462
13761,104959,12A8D64B0FFBA77A4E6F190F59F8F9F6,38951,14,23,9,109.48097,18.28868,1416
13772,105154,9FC721E86703223349C05C95FE4BBB6F,60081,1,7,6,109.51097,18.22639,1556
13773,105155,9FC721E86703223349C05C95FE4BBB6F,31521,9,11,2,109.51458,18.22542,1555
13774,105156,9FC721E86703223349C05C95FE4BBB6F,60381,11,19,8,109.5241,18.22458,1605
13775,105157,9FC721E86703223349C05C95FE4BBB6F,60081,21,23,2,109.51097,18.22639,1556
13776,105174,14B910777C0D6CB8592C0F1A47ED8834,39183,0,8,8,109.55542,18.28208,1715
13777,105175,14B910777C0D6CB8592C0F1A47ED8834,31561,8,11,3,109.56792,18.28479,1765
13778,105176,14B910777C0D6CB8592C0F1A47ED8834,39183,11,13,2,109.55542,18.28208,1715
13785,105236,AAD7AB37FCCEE5FFD85BBA1A43FF0C73,30854,0,7,7,109.56889,18.27076,1763
13786,105237,AAD7AB37FCCEE5FFD85BBA1A43FF0C73,31561,11,17,6,109.56792,18.28479,1765
13787,105238,AAD7AB37FCCEE5FFD85BBA1A43FF0C73,30854,18,20,2,109.56889,18.27076,1763
13788,105254,C98DECAAC7B1CEF53BA610BF4A518961,39321,0,16,16,109.529,18.2167,1604
13789,105255,C98DECAAC7B1CEF53BA610BF4A518961,30161,18,20,2,109.50042,18.24389,1508
13790,105256,C98DECAAC7B1CEF53BA610BF4A518961,30421,21,23,2,109.50021,18.25861,1511
13793,105304,51F61C2B2AFEB6CE055DCFE40CCD58AD,60552,1,3,2,109.41729,18.30014,1218
13794,105305,51F61C2B2AFEB6CE055DCFE40CCD58AD,30351,4,8,4,109.41701,18.29292,1217
13795,105306,51F61C2B2AFEB6CE055DCFE40CCD58AD,60551,9,10,1,109.42722,18.30111,1218
13801,105364,2576A40187A845D7B849E820F16B3DB1,30854,3,10,7,109.56889,18.27076,1763
13802,105365,2576A40187A845D7B849E820F16B3DB1,31071,10,17,7,109.58257,18.28458,1815
13803,105366,2576A40187A845D7B849E820F16B3DB1,30854,18,20,2,109.56889,18.27076,1763
13815,105495,A31156C6519BD5D8AB23829D811E9C63,31041,1,9,8,109.50278,18.23701,1507
13816,105496,A31156C6519BD5D8AB23829D811E9C63,60201,11,12,1,109.5041,18.2509,1510
13817,105497,A31156C6519BD5D8AB23829D811E9C63,30361,13,23,10,109.50347,18.24,1508
13818,105502,0D3DA8126B134D203BB35373EAFFB116,31071,0,5,5,109.58257,18.28458,1815
13819,105503,0D3DA8126B134D203BB35373EAFFB116,30854,7,9,2,109.56889,18.27076,1763
13820,105504,0D3DA8126B134D203BB35373EAFFB116,31071,11,22,11,109.58257,18.28458,1815
13823,105559,47A18820FDA9856131F74091D44B6BCB,31561,3,13,10,109.56792,18.28479,1765
13824,105560,47A18820FDA9856131F74091D44B6BCB,30851,14,16,2,109.5616,18.27396,1713
13825,105561,47A18820FDA9856131F74091D44B6BCB,31561,19,20,1,109.56792,18.28479,1765
13839,105718,84DF4A7C208235D171EF56473BCCF210,30851,0,1,1,109.5616,18.27396,1713
13840,105719,84DF4A7C208235D171EF56473BCCF210,31561,4,7,3,109.56792,18.28479,1765
13841,105720,84DF4A7C208235D171EF56473BCCF210,60631,9,17,8,109.57778,18.27583,1814
13847,105739,8205D8404DFD9A6EF3060E66802D375E,30854,0,14,14,109.56889,18.27076,1763
13848,105740,8205D8404DFD9A6EF3060E66802D375E,31071,14,15,1,109.58257,18.28458,1815
13849,105741,8205D8404DFD9A6EF3060E66802D375E,30854,17,23,6,109.56889,18.27076,1763
13850,105754,DD7E0EAEDD4EFE17B18F06BF606BF2E5,31101,0,2,2,109.65389,18.23403,2057
13851,105755,DD7E0EAEDD4EFE17B18F06BF606BF2E5,38134,3,4,1,109.63931,18.23451,2007
13852,105756,DD7E0EAEDD4EFE17B18F06BF606BF2E5,30581,5,8,3,109.62257,18.24951,1959
13853,105757,83F8DEFB45E9970F803B6E01CF53475C,60361,0,3,3,109.51938,18.29681,1567
13854,105758,83F8DEFB45E9970F803B6E01CF53475C,31021,4,21,17,109.49021,18.27,1463
13855,105759,83F8DEFB45E9970F803B6E01CF53475C,60361,21,23,2,109.51938,18.29681,1567
13869,105886,663CE56232D73D50E42DEC41EA33269F,31931,2,9,7,109.54771,18.29403,1667
13870,105887,663CE56232D73D50E42DEC41EA33269F,30921,10,11,1,109.53903,18.29451,1667
13871,105888,663CE56232D73D50E42DEC41EA33269F,31931,11,15,4,109.54771,18.29403,1667
13872,105889,0D00E0CA974DDA00224ACCD00B993468,30854,0,5,5,109.56889,18.27076,1763
13873,105890,0D00E0CA974DDA00224ACCD00B993468,31561,8,9,1,109.56792,18.28479,1765
13874,105891,0D00E0CA974DDA00224ACCD00B993468,30851,12,15,3,109.5616,18.27396,1713
13875,105892,0D00E0CA974DDA00224ACCD00B993468,31071,19,21,2,109.58257,18.28458,1815
13884,105938,4A0A93A257347F50F0B6F0C8309FF3C3,31521,1,19,18,109.51458,18.22542,1555
13885,105939,4A0A93A257347F50F0B6F0C8309FF3C3,30361,19,21,2,109.50347,18.24,1508
13886,105940,4A0A93A257347F50F0B6F0C8309FF3C3,31521,21,23,2,109.51458,18.22542,1555
13887,105948,F00821368F615DCDAF214035D8EC4A44,31071,1,6,5,109.58257,18.28458,1815
13888,105949,F00821368F615DCDAF214035D8EC4A44,30854,10,16,6,109.56889,18.27076,1763
13889,105950,F00821368F615DCDAF214035D8EC4A44,31071,18,20,2,109.58257,18.28458,1815
13892,105982,6FE9D30AF9D5BAD1F717916B377146E9,31206,0,18,18,109.50819,18.23549,1507
13893,105983,6FE9D30AF9D5BAD1F717916B377146E9,60291,18,21,3,109.50826,18.24639,1509
13894,105984,6FE9D30AF9D5BAD1F717916B377146E9,38961,22,23,1,109.50847,18.23514,1507
13895,105985,934029FB5F97BCE114EDCE88F0393A63,30854,0,6,6,109.56889,18.27076,1763
13896,105986,934029FB5F97BCE114EDCE88F0393A63,30234,9,11,2,109.60681,18.29979,1918
13897,105987,934029FB5F97BCE114EDCE88F0393A63,31945,12,13,1,109.58021,18.29403,1817
13898,105990,C2CC718D695CB45C49C10B739F52F650,31031,1,11,10,109.49979,18.25382,1510
13899,105991,C2CC718D695CB45C49C10B739F52F650,31031,12,14,2,109.49979,18.25382,1510
13900,105992,C2CC718D695CB45C49C10B739F52F650,31031,15,23,8,109.49979,18.25382,1510
13901,106001,96F98526707B06BE1263CCD4F72E07A1,30854,0,12,12,109.56889,18.27076,1763
13902,106002,96F98526707B06BE1263CCD4F72E07A1,31071,16,18,2,109.58257,18.28458,1815
13903,106003,96F98526707B06BE1263CCD4F72E07A1,30854,19,20,1,109.56889,18.27076,1763
13904,106004,96F98526707B06BE1263CCD4F72E07A1,31945,20,22,2,109.58021,18.29403,1817
13907,106015,335A7B1DE8538918FDA774EE3E402A76,30191,0,7,7,109.50361,18.22701,1506
13908,106016,335A7B1DE8538918FDA774EE3E402A76,31521,7,16,9,109.51458,18.22542,1555
13909,106017,335A7B1DE8538918FDA774EE3E402A76,30191,18,23,5,109.50361,18.22701,1506
13910,106025,8D7B9451E0189947198D6AC9CE51CFEE,60504,1,3,2,109.47917,18.28903,1416
13911,106026,8D7B9451E0189947198D6AC9CE51CFEE,31091,5,18,13,109.41201,18.31222,1170
13912,106027,8D7B9451E0189947198D6AC9CE51CFEE,30111,18,23,5,109.47583,18.30542,1419
13920,106109,A14C813C3E3A7182759DA822342505B5,39183,0,6,6,109.55542,18.28208,1715
13921,106110,A14C813C3E3A7182759DA822342505B5,39181,7,8,1,109.55153,18.28035,1715
13922,106111,A14C813C3E3A7182759DA822342505B5,39183,11,13,2,109.55542,18.28208,1715
13923,106112,A14C813C3E3A7182759DA822342505B5,39181,13,23,10,109.55153,18.28035,1715
13925,106135,07169E7114E4F14C073261BAAC0D4491,61011,0,6,6,109.60653,18.19076,1900
13926,106137,07169E7114E4F14C073261BAAC0D4491,61011,8,13,5,109.60653,18.19076,1900
13927,106139,07169E7114E4F14C073261BAAC0D4491,61011,16,22,6,109.60653,18.19076,1900
13928,106148,6E2021B014C4D0B652A2E4FE8D2CF038,31071,4,7,3,109.58257,18.28458,1815
13929,106149,6E2021B014C4D0B652A2E4FE8D2CF038,30854,8,20,12,109.56889,18.27076,1763
13930,106150,6E2021B014C4D0B652A2E4FE8D2CF038,31071,21,23,2,109.58257,18.28458,1815
13931,106154,75BB5F056A285E641293B913E6CE7C17,30201,0,9,9,109.4909,18.26465,1462
13932,106155,75BB5F056A285E641293B913E6CE7C17,39183,10,11,1,109.55542,18.28208,1715
13933,106156,75BB5F056A285E641293B913E6CE7C17,38261,14,16,2,109.50361,18.28153,1515
13941,106226,121138E269BBF0B506FA8CE6CEB3BF52,31931,0,15,15,109.54771,18.29403,1667
13942,106227,121138E269BBF0B506FA8CE6CEB3BF52,39181,16,17,1,109.55153,18.28035,1715
13943,106228,121138E269BBF0B506FA8CE6CEB3BF52,31931,18,23,5,109.54771,18.29403,1667
13944,106242,9C1407835BC54BEBDB541F52E1DA1820,61011,0,1,1,109.60653,18.19076,1900
13945,106244,9C1407835BC54BEBDB541F52E1DA1820,61011,7,15,8,109.60653,18.19076,1900
13946,106246,9C1407835BC54BEBDB541F52E1DA1820,61011,21,23,2,109.60653,18.19076,1900
13957,106360,8C3D244B6DAAE8C73F174808255E03C6,60011,0,7,7,109.48965,18.30222,1468
13958,106361,8C3D244B6DAAE8C73F174808255E03C6,30111,10,12,2,109.47583,18.30542,1419
13959,106362,8C3D244B6DAAE8C73F174808255E03C6,30764,14,19,5,109.45806,18.29486,1367
13969,106415,B80D4B4CDBD08237A9C4254F8883AEF4,39151,0,7,7,109.49875,18.25097,1510
13970,106416,B80D4B4CDBD08237A9C4254F8883AEF4,31181,8,9,1,109.50382,18.24813,1509
13971,106417,B80D4B4CDBD08237A9C4254F8883AEF4,30711,12,14,2,109.50271,18.25347,1510
13972,106418,B80D4B4CDBD08237A9C4254F8883AEF4,39091,18,23,5,109.50097,18.25222,1510
13977,106438,CCCD2290FB632A48009771412BE68ADD,31561,0,6,6,109.56792,18.28479,1765
13978,106439,CCCD2290FB632A48009771412BE68ADD,39183,9,10,1,109.55542,18.28208,1715
13979,106440,CCCD2290FB632A48009771412BE68ADD,31561,14,15,1,109.56792,18.28479,1765
13980,106441,CCCD2290FB632A48009771412BE68ADD,39183,16,17,1,109.55542,18.28208,1715
13987,106482,6300414882932A98E73E91790947DC62,60281,1,6,5,109.51743,18.25924,1561
13988,106483,6300414882932A98E73E91790947DC62,30251,6,12,6,109.50611,18.26653,1512
13989,106484,6300414882932A98E73E91790947DC62,60281,12,23,11,109.51743,18.25924,1561
14004,106586,EF24901D99384F703B20FE07F2784FA0,30101,0,1,1,109.57299,18.33333,1773
14005,106587,EF24901D99384F703B20FE07F2784FA0,31631,1,7,6,109.59542,18.36826,1879
14006,106588,EF24901D99384F703B20FE07F2784FA0,30101,8,23,15,109.57299,18.33333,1773
14007,106596,8439399E87DFE1E3AC58B89ABF1408A7,31521,0,8,8,109.51458,18.22542,1555
14008,106597,8439399E87DFE1E3AC58B89ABF1408A7,60381,10,15,5,109.5241,18.22458,1605
14009,106598,8439399E87DFE1E3AC58B89ABF1408A7,30711,19,22,3,109.50271,18.25347,1510
14029,106808,46C761D2C5BB3E9FC0E036B374FF60F4,30854,0,1,1,109.56889,18.27076,1763
14030,106809,46C761D2C5BB3E9FC0E036B374FF60F4,31071,3,9,6,109.58257,18.28458,1815
14031,106810,46C761D2C5BB3E9FC0E036B374FF60F4,30854,10,23,13,109.56889,18.27076,1763
14036,106830,012ABD06F231728C214A4BA917E75B1C,30851,0,1,1,109.5616,18.27396,1713
14037,106831,012ABD06F231728C214A4BA917E75B1C,31561,2,3,1,109.56792,18.28479,1765
14038,106832,012ABD06F231728C214A4BA917E75B1C,30851,3,4,1,109.5616,18.27396,1713
14039,106833,012ABD06F231728C214A4BA917E75B1C,31561,8,14,6,109.56792,18.28479,1765
14060,107007,43E035AE85036EBD9891453E9567CB81,30151,0,7,7,109.50986,18.25083,1560
14061,107008,43E035AE85036EBD9891453E9567CB81,60504,11,14,3,109.47917,18.28903,1416
14062,107009,43E035AE85036EBD9891453E9567CB81,30151,19,23,4,109.50986,18.25083,1560
14072,107135,33408B368FAE333E336D708FABDADA78,60241,2,4,2,109.53319,18.28667,1616
14073,107136,33408B368FAE333E336D708FABDADA78,38154,5,6,1,109.5266,18.28278,1615
14074,107137,33408B368FAE333E336D708FABDADA78,60241,6,9,3,109.53319,18.28667,1616
14088,107222,3EAE2CCEF780CC2E20C47963EA2CF3C6,30854,5,10,5,109.56889,18.27076,1763
14089,107223,3EAE2CCEF780CC2E20C47963EA2CF3C6,31031,15,16,1,109.49979,18.25382,1510
14090,107224,3EAE2CCEF780CC2E20C47963EA2CF3C6,31071,20,22,2,109.58257,18.28458,1815
14093,107253,377A324496E54511961704972731A3D5,31821,0,6,6,109.51181,18.24924,1559
14094,107254,377A324496E54511961704972731A3D5,38297,10,13,3,109.52576,18.24965,1609
14095,107255,377A324496E54511961704972731A3D5,60311,17,18,1,109.52097,18.24319,1558
14096,107256,377A324496E54511961704972731A3D5,31821,19,23,4,109.51181,18.24924,1559
14117,107471,7084657DF30063A945AAA5EF4742695F,39181,0,8,8,109.55153,18.28035,1715
14118,107472,7084657DF30063A945AAA5EF4742695F,39183,10,16,6,109.55542,18.28208,1715
14119,107473,7084657DF30063A945AAA5EF4742695F,39181,17,23,6,109.55153,18.28035,1715
14122,107548,BBE4D8242EE46AE73AD69A56A00F4408,30201,0,7,7,109.4909,18.26465,1462
14123,107549,BBE4D8242EE46AE73AD69A56A00F4408,31271,8,17,9,109.48958,18.26257,1462
14124,107550,BBE4D8242EE46AE73AD69A56A00F4408,31021,18,20,2,109.49021,18.27,1463
14125,107551,BBE4D8242EE46AE73AD69A56A00F4408,30201,21,23,2,109.4909,18.26465,1462
14144,107761,033CEEC20746801745CF4A53CD517C31,30121,0,8,8,109.52861,18.27222,1613
14145,107762,033CEEC20746801745CF4A53CD517C31,60241,12,14,2,109.53319,18.28667,1616
14146,107763,033CEEC20746801745CF4A53CD517C31,30121,16,18,2,109.52861,18.27222,1613
14147,107764,033CEEC20746801745CF4A53CD517C31,31181,20,22,2,109.50382,18.24813,1509
14148,107786,F9DDAF94F02D470B0D29C2FB66604E6F,38145,0,4,4,109.378,18.2912,1066
14149,107787,F9DDAF94F02D470B0D29C2FB66604E6F,39063,5,6,1,109.386,18.2919,1066
14150,107788,F9DDAF94F02D470B0D29C2FB66604E6F,31081,8,10,2,109.44639,18.30181,1318
14155,107860,E75CF54BA14775FEDD26504F9F6B7365,31945,0,5,5,109.58021,18.29403,1817
14156,107861,E75CF54BA14775FEDD26504F9F6B7365,31561,7,16,9,109.56792,18.28479,1765
14157,107862,E75CF54BA14775FEDD26504F9F6B7365,31071,20,21,1,109.58257,18.28458,1815
14160,107887,156ACF9E791C8505B3E73D7CD02DD49B,60631,0,8,8,109.57778,18.27583,1814
14161,107888,156ACF9E791C8505B3E73D7CD02DD49B,30854,11,13,2,109.56889,18.27076,1763
14162,107889,156ACF9E791C8505B3E73D7CD02DD49B,60631,14,17,3,109.57778,18.27583,1814
14163,107890,156ACF9E791C8505B3E73D7CD02DD49B,30854,20,21,1,109.56889,18.27076,1763
14165,107924,2981C8B3C1AD0C63670497656AA260BB,30721,0,7,7,109.51597,18.28257,1565
14166,107925,2981C8B3C1AD0C63670497656AA260BB,60084,8,10,2,109.4984,18.2334,1507
14167,107926,2981C8B3C1AD0C63670497656AA260BB,30721,12,15,3,109.51597,18.28257,1565
14168,107927,2981C8B3C1AD0C63670497656AA260BB,38251,20,21,1,109.49618,18.25493,1510
14169,107954,8DA877D3A30401F86E81FB7BC1CA2A00,30854,0,2,2,109.56889,18.27076,1763
14170,107955,8DA877D3A30401F86E81FB7BC1CA2A00,31071,3,12,9,109.58257,18.28458,1815
14171,107956,8DA877D3A30401F86E81FB7BC1CA2A00,30854,15,17,2,109.56889,18.27076,1763
14172,107957,8DA877D3A30401F86E81FB7BC1CA2A00,31071,19,20,1,109.58257,18.28458,1815
14178,107967,58418A9EA4A7DC03127CB79C039A5185,30854,2,6,4,109.56889,18.27076,1763
14179,107968,58418A9EA4A7DC03127CB79C039A5185,31071,8,10,2,109.58257,18.28458,1815
14180,107969,58418A9EA4A7DC03127CB79C039A5185,39154,11,12,1,109.50201,18.25681,1511
14181,107973,523CCFE9EF18EE2D015CE7D473B58639,31931,5,13,8,109.54771,18.29403,1667
14182,107974,523CCFE9EF18EE2D015CE7D473B58639,39181,15,16,1,109.55153,18.28035,1715
14183,107975,523CCFE9EF18EE2D015CE7D473B58639,31931,17,21,4,109.54771,18.29403,1667
14206,108057,DFFF17B7FE30E79B8AABBB5CE171272F,31561,1,14,13,109.56792,18.28479,1765
14207,108058,DFFF17B7FE30E79B8AABBB5CE171272F,39183,16,17,1,109.55542,18.28208,1715
14208,108059,DFFF17B7FE30E79B8AABBB5CE171272F,31561,21,23,2,109.56792,18.28479,1765
14214,108134,EC4B90EDBF35256FDB4D4F8B87DB8A04,31071,2,6,4,109.58257,18.28458,1815
14215,108135,EC4B90EDBF35256FDB4D4F8B87DB8A04,30854,11,12,1,109.56889,18.27076,1763
14216,108136,EC4B90EDBF35256FDB4D4F8B87DB8A04,31071,12,22,10,109.58257,18.28458,1815
14239,108402,AC2BE2B0D2A9E2E1B52DE4DB520203D4,30071,0,6,6,109.52819,18.30472,1619
14240,108403,AC2BE2B0D2A9E2E1B52DE4DB520203D4,31931,7,15,8,109.54771,18.29403,1667
14241,108404,AC2BE2B0D2A9E2E1B52DE4DB520203D4,30071,19,20,1,109.52819,18.30472,1619
14242,108405,AC2BE2B0D2A9E2E1B52DE4DB520203D4,30071,21,23,2,109.52819,18.30472,1619
14252,108481,508BE380191F799297A31A7295856BDA,38094,0,12,12,109.45403,18.28778,1316
14253,108482,508BE380191F799297A31A7295856BDA,31701,16,18,2,109.44132,18.28833,1266
14254,108483,508BE380191F799297A31A7295856BDA,38094,19,23,4,109.45403,18.28778,1316
14255,108673,1B3E8931F1FF667205B6505EE53C6E2C,31071,0,3,3,109.58257,18.28458,1815
14256,108674,1B3E8931F1FF667205B6505EE53C6E2C,30854,7,13,6,109.56889,18.27076,1763
14257,108675,1B3E8931F1FF667205B6505EE53C6E2C,31071,15,23,8,109.58257,18.28458,1815
14268,108742,0C3DD1EABA2D708A2506DA8150CEC148,31561,0,6,6,109.56792,18.28479,1765
14269,108743,0C3DD1EABA2D708A2506DA8150CEC148,30854,8,11,3,109.56889,18.27076,1763
14270,108744,0C3DD1EABA2D708A2506DA8150CEC148,31561,11,23,12,109.56792,18.28479,1765
14271,108846,AB43182259122294244C13D6FC66D4A1,60631,0,2,2,109.57778,18.27583,1814
14272,108847,AB43182259122294244C13D6FC66D4A1,31071,4,5,1,109.58257,18.28458,1815
14273,108848,AB43182259122294244C13D6FC66D4A1,31561,8,10,2,109.56792,18.28479,1765
14290,108908,7BF65E5054DA81A230AB5423620158E1,31071,0,1,1,109.58257,18.28458,1815
14291,108909,7BF65E5054DA81A230AB5423620158E1,60631,1,7,6,109.57778,18.27583,1814
14292,108910,7BF65E5054DA81A230AB5423620158E1,30854,7,18,11,109.56889,18.27076,1763
14293,108968,728159D623DE360E7CBC8AEEC345E2FF,60661,0,9,9,109.548,18.2377,1657
14294,108969,728159D623DE360E7CBC8AEEC345E2FF,31321,11,13,2,109.63799,18.23201,2007
14295,108971,728159D623DE360E7CBC8AEEC345E2FF,60661,21,23,2,109.548,18.2377,1657
14300,109059,E649CF84A26278291AA1A5B5C5D01FCA,31561,0,5,5,109.56792,18.28479,1765
14301,109060,E649CF84A26278291AA1A5B5C5D01FCA,30854,6,18,12,109.56889,18.27076,1763
14302,109061,E649CF84A26278291AA1A5B5C5D01FCA,31561,20,23,3,109.56792,18.28479,1765
14371,109751,1B6EBBFF3B9D8A3E18753343B6A29EAE,31071,0,13,13,109.58257,18.28458,1815
14372,109752,1B6EBBFF3B9D8A3E18753343B6A29EAE,30851,14,17,3,109.5616,18.27396,1713
14373,109753,1B6EBBFF3B9D8A3E18753343B6A29EAE,31071,22,23,1,109.58257,18.28458,1815
14374,109775,45D6FEED987FF96C23D5532C0D645AC3,30281,0,8,8,109.50597,18.27583,1514
14375,109776,45D6FEED987FF96C23D5532C0D645AC3,30361,9,11,2,109.50347,18.24,1508
14376,109777,45D6FEED987FF96C23D5532C0D645AC3,38127,13,20,7,109.50833,18.27222,1513
14377,109778,45D6FEED987FF96C23D5532C0D645AC3,30281,21,23,2,109.50597,18.27583,1514
14383,109820,A8ABE4987042D12DD458C81CFD9663F5,30721,0,7,7,109.51597,18.28257,1565
14384,109821,A8ABE4987042D12DD458C81CFD9663F5,30771,8,15,7,109.49938,18.26042,1511
14385,109822,A8ABE4987042D12DD458C81CFD9663F5,38127,18,20,2,109.50833,18.27222,1513
14386,109848,74206C862E4BA6236E7F7978D63D1D7D,60631,1,4,3,109.57778,18.27583,1814
14387,109849,74206C862E4BA6236E7F7978D63D1D7D,30854,5,19,14,109.56889,18.27076,1763
14388,109850,74206C862E4BA6236E7F7978D63D1D7D,60631,19,20,1,109.57778,18.27583,1814
14389,109868,0B67294FA9DBD53325D63EA36C1B8784,30271,0,14,14,109.49132,18.23153,1456
14390,109869,0B67294FA9DBD53325D63EA36C1B8784,30211,15,16,1,109.49882,18.23931,1508
14391,109870,0B67294FA9DBD53325D63EA36C1B8784,30271,20,23,3,109.49132,18.23153,1456
14392,109896,C87F469509749B351A8671696022A99C,31561,0,5,5,109.56792,18.28479,1765
14393,109897,C87F469509749B351A8671696022A99C,30854,6,10,4,109.56889,18.27076,1763
14394,109898,C87F469509749B351A8671696022A99C,31561,11,23,12,109.56792,18.28479,1765
14395,109916,485CC43812013C7F1EB3AB947F1AE40F,30741,1,4,3,109.49833,18.28681,1516
14396,109917,485CC43812013C7F1EB3AB947F1AE40F,31864,5,8,3,109.49014,18.28333,1465
14397,109918,485CC43812013C7F1EB3AB947F1AE40F,60281,12,13,1,109.51743,18.25924,1561
14398,109919,485CC43812013C7F1EB3AB947F1AE40F,38185,17,19,2,109.51333,18.27347,1563
14421,110178,19F803FB996471824A8A9928BBFAB433,39181,0,6,6,109.55153,18.28035,1715
14422,110179,19F803FB996471824A8A9928BBFAB433,31931,6,8,2,109.54771,18.29403,1667
14423,110180,19F803FB996471824A8A9928BBFAB433,39181,11,13,2,109.55153,18.28035,1715
14424,110181,19F803FB996471824A8A9928BBFAB433,31931,14,18,4,109.54771,18.29403,1667
14428,110306,45FA8AF959A216E06C82392E21728E7F,31071,0,7,7,109.58257,18.28458,1815
14429,110307,45FA8AF959A216E06C82392E21728E7F,31561,8,10,2,109.56792,18.28479,1765
14430,110308,45FA8AF959A216E06C82392E21728E7F,31071,13,14,1,109.58257,18.28458,1815
14431,110309,45FA8AF959A216E06C82392E21728E7F,31561,14,23,9,109.56792,18.28479,1765
14451,110481,D7D9352263CF977FD0E7820F34F6CA72,30151,0,12,12,109.50986,18.25083,1560
14452,110482,D7D9352263CF977FD0E7820F34F6CA72,30511,14,15,1,109.51069,18.24208,1558
14453,110483,D7D9352263CF977FD0E7820F34F6CA72,38111,19,20,1,109.52007,18.22403,1555
14457,110608,B80D6AB96D3D5CEE71A70ED25275F830,38951,0,10,10,109.48097,18.28868,1416
14458,110609,B80D6AB96D3D5CEE71A70ED25275F830,38951,11,12,1,109.48097,18.28868,1416
14459,110610,B80D6AB96D3D5CEE71A70ED25275F830,31531,14,21,7,109.49583,18.25972,1461
14460,110611,B80D6AB96D3D5CEE71A70ED25275F830,38951,22,23,1,109.48097,18.28868,1416
14466,110692,9B24FEFE42610E15A8305E52C167D9B9,30854,1,2,1,109.56889,18.27076,1763
14467,110693,9B24FEFE42610E15A8305E52C167D9B9,60241,3,4,1,109.53319,18.28667,1616
14468,110694,9B24FEFE42610E15A8305E52C167D9B9,38154,6,7,1,109.5266,18.28278,1615
14474,110756,8621CFDF1B89A83351494618C53D033F,39181,3,10,7,109.55153,18.28035,1715
14475,110757,8621CFDF1B89A83351494618C53D033F,31071,12,14,2,109.58257,18.28458,1815
14476,110758,8621CFDF1B89A83351494618C53D033F,39181,14,20,6,109.55153,18.28035,1715
14477,110759,8621CFDF1B89A83351494618C53D033F,39181,21,23,2,109.55153,18.28035,1715
14509,111032,3C6C31F30579C628F9EDFADEE409AE9F,60241,0,7,7,109.53319,18.28667,1616
14510,111033,3C6C31F30579C628F9EDFADEE409AE9F,60201,8,9,1,109.5041,18.2509,1510
14511,111034,3C6C31F30579C628F9EDFADEE409AE9F,30071,11,12,1,109.52819,18.30472,1619
14516,111103,7B468825EC3CAA1A3172074B4283732A,38911,0,6,6,109.51674,18.24965,1559
14517,111104,7B468825EC3CAA1A3172074B4283732A,31201,7,12,5,109.51042,18.23819,1558
14518,111105,7B468825EC3CAA1A3172074B4283732A,31201,12,16,4,109.51042,18.23819,1558
14519,111106,7B468825EC3CAA1A3172074B4283732A,31206,17,19,2,109.50819,18.23549,1507
14522,111159,EBD16061EA20EE33D9344D33735E5205,38891,0,6,6,109.51486,18.24118,1558
14523,111160,EBD16061EA20EE33D9344D33735E5205,38291,10,11,1,109.51618,18.24313,1558
14524,111161,EBD16061EA20EE33D9344D33735E5205,38291,13,16,3,109.51618,18.24313,1558
14525,111162,EBD16061EA20EE33D9344D33735E5205,31201,19,20,1,109.51042,18.23819,1558
14538,111242,ADAB51A6D99BADC8222FC392D72ADA01,60281,0,13,13,109.51743,18.25924,1561
14539,111243,ADAB51A6D99BADC8222FC392D72ADA01,60311,14,18,4,109.52097,18.24319,1558
14540,111244,ADAB51A6D99BADC8222FC392D72ADA01,60281,19,23,4,109.51743,18.25924,1561
14544,111285,ACDEAAF45B65DE48CF80A48DBD3C775E,31071,0,7,7,109.58257,18.28458,1815
14545,111286,ACDEAAF45B65DE48CF80A48DBD3C775E,30854,10,11,1,109.56889,18.27076,1763
14546,111287,ACDEAAF45B65DE48CF80A48DBD3C775E,31071,11,18,7,109.58257,18.28458,1815
14547,111308,F3EA7BB85A440E2BE2D597787EA5279B,30051,0,7,7,109.48917,18.21215,1453
14548,111309,F3EA7BB85A440E2BE2D597787EA5279B,38834,7,8,1,109.47639,18.21146,1403
14549,111310,F3EA7BB85A440E2BE2D597787EA5279B,30051,9,13,4,109.48917,18.21215,1453
14550,111311,F3EA7BB85A440E2BE2D597787EA5279B,30571,13,19,6,109.50243,18.21861,1504
14562,111348,DB4DF566D4757FF3BB488F82DE126248,31561,4,6,2,109.56792,18.28479,1765
14563,111349,DB4DF566D4757FF3BB488F82DE126248,30851,6,9,3,109.5616,18.27396,1713
14564,111350,DB4DF566D4757FF3BB488F82DE126248,31561,12,22,10,109.56792,18.28479,1765
14567,111393,26F19CD72FDC9A2451096E387469F882,38951,0,13,13,109.48097,18.28868,1416
14568,111394,26F19CD72FDC9A2451096E387469F882,60501,13,14,1,109.48701,18.29021,1466
14569,111395,26F19CD72FDC9A2451096E387469F882,38951,15,23,8,109.48097,18.28868,1416
14580,111488,09390A13C8E5C15C1E5674E3DB9139EC,60201,3,4,1,109.5041,18.2509,1510
14581,111489,09390A13C8E5C15C1E5674E3DB9139EC,30711,5,11,6,109.50271,18.25347,1510
14582,111490,09390A13C8E5C15C1E5674E3DB9139EC,60161,15,17,2,109.49174,18.26181,1461
14583,111491,09390A13C8E5C15C1E5674E3DB9139EC,60201,21,23,2,109.5041,18.2509,1510
14590,111588,0C8D15C0488D521680F0DE3A28CFE111,31811,1,7,6,109.54201,18.31806,1671
14591,111589,0C8D15C0488D521680F0DE3A28CFE111,30701,7,14,7,109.59313,18.32007,1871
14592,111590,0C8D15C0488D521680F0DE3A28CFE111,31811,14,23,9,109.54201,18.31806,1671
14593,111602,CA3896FB33E9BC68E91955EDFF5D709B,31071,0,6,6,109.58257,18.28458,1815
14594,111603,CA3896FB33E9BC68E91955EDFF5D709B,30854,8,9,1,109.56889,18.27076,1763
14595,111604,CA3896FB33E9BC68E91955EDFF5D709B,31945,13,16,3,109.58021,18.29403,1817
14624,111862,C93386A9D86FE22A1FD4E5116045DD8D,31561,0,6,6,109.56792,18.28479,1765
14625,111863,C93386A9D86FE22A1FD4E5116045DD8D,39183,7,11,4,109.55542,18.28208,1715
14626,111864,C93386A9D86FE22A1FD4E5116045DD8D,31561,12,13,1,109.56792,18.28479,1765
14627,111865,C93386A9D86FE22A1FD4E5116045DD8D,39183,15,18,3,109.55542,18.28208,1715
14628,111895,2B8C748A18FA7D08D4335AD7C9DEF01B,31761,0,6,6,109.60521,18.27965,1914
14629,111896,2B8C748A18FA7D08D4335AD7C9DEF01B,30951,11,16,5,109.56208,18.25667,1761
14630,111897,2B8C748A18FA7D08D4335AD7C9DEF01B,31761,18,22,4,109.60521,18.27965,1914
14631,111908,D80AC69F36570B5458F4FDBA38D67740,60161,0,7,7,109.49174,18.26181,1461
14632,111909,D80AC69F36570B5458F4FDBA38D67740,60201,8,9,1,109.5041,18.2509,1510
14633,111910,D80AC69F36570B5458F4FDBA38D67740,31181,11,14,3,109.50382,18.24813,1509
14634,111911,D80AC69F36570B5458F4FDBA38D67740,60161,14,18,4,109.49174,18.26181,1461
14637,111914,BAFDD3A022A674BA6CCC93E365FAFC36,60131,0,7,7,109.49819,18.24778,1509
14638,111915,BAFDD3A022A674BA6CCC93E365FAFC36,38721,9,11,2,109.50368,18.27542,1514
14639,111916,BAFDD3A022A674BA6CCC93E365FAFC36,31461,13,14,1,109.5091,18.25389,1510
14640,111917,BAFDD3A022A674BA6CCC93E365FAFC36,38721,15,18,3,109.50368,18.27542,1514
14645,111965,BCF7902B3144684D44567B20BDAA780E,60614,0,7,7,109.48799,18.29521,1467
14646,111966,BCF7902B3144684D44567B20BDAA780E,30971,7,11,4,109.48708,18.29319,1467
14647,111967,BCF7902B3144684D44567B20BDAA780E,48647,12,14,2,109.48701,18.29042,1466
14684,112343,529A14F498129B0238F7B12A9FC7F6F7,31671,2,14,12,109.38965,18.29813,1068
14685,112344,529A14F498129B0238F7B12A9FC7F6F7,30761,14,16,2,109.45201,18.3,1318
14686,112345,529A14F498129B0238F7B12A9FC7F6F7,31671,18,20,2,109.38965,18.29813,1068
14687,112346,529A14F498129B0238F7B12A9FC7F6F7,30671,21,22,1,109.43611,18.30139,1268
14691,112371,2C3BD53A8702A47FB82F05FB4993B683,31561,0,14,14,109.56792,18.28479,1765
14692,112372,2C3BD53A8702A47FB82F05FB4993B683,39183,15,18,3,109.55542,18.28208,1715
14693,112373,2C3BD53A8702A47FB82F05FB4993B683,31561,20,22,2,109.56792,18.28479,1765
14697,112403,F6A1EBB84FE583E84185C423218578F5,31561,0,4,4,109.56792,18.28479,1765
14698,112404,F6A1EBB84FE583E84185C423218578F5,30854,8,9,1,109.56889,18.27076,1763
14699,112405,F6A1EBB84FE583E84185C423218578F5,31561,11,13,2,109.56792,18.28479,1765
14700,112406,F6A1EBB84FE583E84185C423218578F5,39183,18,19,1,109.55542,18.28208,1715
14701,112428,283001ED673D8EDBEF7EEB00BDB31533,30571,2,5,3,109.50243,18.21861,1504
14702,112429,283001ED673D8EDBEF7EEB00BDB31533,31181,7,12,5,109.50382,18.24813,1509
14703,112430,283001ED673D8EDBEF7EEB00BDB31533,60131,13,18,5,109.49819,18.24778,1509
14704,112431,283001ED673D8EDBEF7EEB00BDB31533,30571,19,23,4,109.50243,18.21861,1504
14714,112492,FD45DAD5A6F6BB711255CB29E453CFF1,30854,3,7,4,109.56889,18.27076,1763
14715,112493,FD45DAD5A6F6BB711255CB29E453CFF1,31561,7,9,2,109.56792,18.28479,1765
14716,112494,FD45DAD5A6F6BB711255CB29E453CFF1,30854,9,22,13,109.56889,18.27076,1763
14717,112536,D39D64452E6BBEF7B3056CA239E1B86E,30854,0,6,6,109.56889,18.27076,1763
14718,112537,D39D64452E6BBEF7B3056CA239E1B86E,31561,6,7,1,109.56792,18.28479,1765
14719,112538,D39D64452E6BBEF7B3056CA239E1B86E,30854,11,14,3,109.56889,18.27076,1763
14720,112539,D39D64452E6BBEF7B3056CA239E1B86E,31561,14,15,1,109.56792,18.28479,1765
14727,112694,CD576F1C1CDFB89E6A99A20E65927346,31071,0,2,2,109.58257,18.28458,1815
14728,112695,CD576F1C1CDFB89E6A99A20E65927346,30854,2,3,1,109.56889,18.27076,1763
14729,112696,CD576F1C1CDFB89E6A99A20E65927346,31561,4,5,1,109.56792,18.28479,1765
14741,112758,63FBAC0202144B00077561285E6A7F87,30821,0,17,17,109.43681,18.33639,1274
14742,112759,63FBAC0202144B00077561285E6A7F87,30651,17,19,2,109.42611,18.385,1232
14743,112760,63FBAC0202144B00077561285E6A7F87,30821,19,23,4,109.43681,18.33639,1274
14744,112779,070984703178D21DC5287E457C03691A,39181,0,11,11,109.55153,18.28035,1715
14745,112780,070984703178D21DC5287E457C03691A,39181,15,16,1,109.55153,18.28035,1715
14746,112781,070984703178D21DC5287E457C03691A,39181,19,23,4,109.55153,18.28035,1715
14747,112789,87ADC98470D754E65D1F229228B379D5,30851,0,7,7,109.5616,18.27396,1713
14748,112790,87ADC98470D754E65D1F229228B379D5,39183,9,13,4,109.55542,18.28208,1715
14749,112791,87ADC98470D754E65D1F229228B379D5,30851,17,23,6,109.5616,18.27396,1713
14758,112868,89362A3CA3AE6F5B75871F2110924F99,30851,0,14,14,109.5616,18.27396,1713
14759,112869,89362A3CA3AE6F5B75871F2110924F99,30951,14,16,2,109.56208,18.25667,1761
14760,112870,89362A3CA3AE6F5B75871F2110924F99,30851,17,23,6,109.5616,18.27396,1713
14778,113060,60085C98EDC64770922E20845B09F807,31931,0,6,6,109.54771,18.29403,1667
14779,113061,60085C98EDC64770922E20845B09F807,39183,7,8,1,109.55542,18.28208,1715
14780,113062,60085C98EDC64770922E20845B09F807,31931,11,21,10,109.54771,18.29403,1667
14791,113212,807332CEC38772FA8DF98C48FBD8DD1E,30851,2,5,3,109.5616,18.27396,1713
14792,113213,807332CEC38772FA8DF98C48FBD8DD1E,31561,10,16,6,109.56792,18.28479,1765
14793,113214,807332CEC38772FA8DF98C48FBD8DD1E,39183,17,18,1,109.55542,18.28208,1715
14794,113215,807332CEC38772FA8DF98C48FBD8DD1E,31561,21,23,2,109.56792,18.28479,1765
14801,113288,560794A44CA17A43FA34D0FA6C339747,30854,0,8,8,109.56889,18.27076,1763
14802,113289,560794A44CA17A43FA34D0FA6C339747,31071,9,11,2,109.58257,18.28458,1815
14803,113290,560794A44CA17A43FA34D0FA6C339747,30854,15,23,8,109.56889,18.27076,1763
14824,113449,C61360C6C8202A54143E165C2C08120B,30951,2,11,9,109.56208,18.25667,1761
14825,113450,C61360C6C8202A54143E165C2C08120B,30854,14,19,5,109.56889,18.27076,1763
14826,113451,C61360C6C8202A54143E165C2C08120B,30951,21,23,2,109.56208,18.25667,1761
14829,113518,2DA5948E96121EADE6CCFA0D33794EFE,38251,0,11,11,109.49618,18.25493,1510
14830,113519,2DA5948E96121EADE6CCFA0D33794EFE,31031,14,17,3,109.49979,18.25382,1510
14831,113520,2DA5948E96121EADE6CCFA0D33794EFE,31031,20,22,2,109.49979,18.25382,1510
14839,113591,77F5A37783010C53E376197FE3F1043D,60671,4,5,1,109.52979,18.31757,1621
14840,113592,77F5A37783010C53E376197FE3F1043D,30071,8,13,5,109.52819,18.30472,1619
14841,113593,77F5A37783010C53E376197FE3F1043D,38991,14,16,2,109.52681,18.30368,1618
14842,113594,77F5A37783010C53E376197FE3F1043D,60371,18,20,2,109.53063,18.30056,1618
14843,113607,0F558B6653C655C7F0BAEA9D66B33F57,31071,2,7,5,109.58257,18.28458,1815
14844,113608,0F558B6653C655C7F0BAEA9D66B33F57,30854,11,12,1,109.56889,18.27076,1763
14845,113609,0F558B6653C655C7F0BAEA9D66B33F57,31071,17,23,6,109.58257,18.28458,1815
14862,113673,A01E2FD84FFE4D782E40311D1ABC1ECB,38185,0,7,7,109.51333,18.27347,1563
14863,113674,A01E2FD84FFE4D782E40311D1ABC1ECB,39151,11,13,2,109.49875,18.25097,1510
14864,113675,A01E2FD84FFE4D782E40311D1ABC1ECB,30281,14,21,7,109.50597,18.27583,1514
14865,113729,A4743972EC2FC58546DD11935BDC0E1A,30711,0,8,8,109.50271,18.25347,1510
14866,113730,A4743972EC2FC58546DD11935BDC0E1A,30771,11,16,5,109.49938,18.26042,1511
14867,113731,A4743972EC2FC58546DD11935BDC0E1A,39091,20,23,3,109.50097,18.25222,1510
14882,113845,147470AD3D3B8724582C30D5F244A8B6,60421,2,5,3,109.46333,18.31743,1371
14883,113846,147470AD3D3B8724582C30D5F244A8B6,30111,6,9,3,109.47583,18.30542,1419
14884,113847,147470AD3D3B8724582C30D5F244A8B6,60421,9,19,10,109.46333,18.31743,1371
14913,114014,032BA6C7F044E8806CEB432AECA246EE,38484,0,7,7,109.53028,18.31528,1620
14914,114015,032BA6C7F044E8806CEB432AECA246EE,30071,7,11,4,109.52819,18.30472,1619
14915,114016,032BA6C7F044E8806CEB432AECA246EE,30561,11,20,9,109.52778,18.31938,1621
14916,114017,032BA6C7F044E8806CEB432AECA246EE,38484,22,23,1,109.53028,18.31528,1620
14921,114033,E58F7930139B2ED51DE79005F05C056D,39183,0,7,7,109.55542,18.28208,1715
14922,114034,E58F7930139B2ED51DE79005F05C056D,39181,8,16,8,109.55153,18.28035,1715
14923,114035,E58F7930139B2ED51DE79005F05C056D,39183,18,20,2,109.55542,18.28208,1715
14924,114036,E58F7930139B2ED51DE79005F05C056D,31561,22,23,1,109.56792,18.28479,1765
14927,114071,400FDACE29FFB166CA6FB4D2811F30A0,60331,0,7,7,109.505,18.26507,1512
14928,114072,400FDACE29FFB166CA6FB4D2811F30A0,30711,8,9,1,109.50271,18.25347,1510
14929,114073,400FDACE29FFB166CA6FB4D2811F30A0,30911,9,11,2,109.50493,18.26181,1511
14930,114074,400FDACE29FFB166CA6FB4D2811F30A0,30711,11,13,2,109.50271,18.25347,1510
14937,114114,75817DB682187A07461734D66E1E6492,60631,0,4,4,109.57778,18.27583,1814
14938,114115,75817DB682187A07461734D66E1E6492,30854,6,16,10,109.56889,18.27076,1763
14939,114116,75817DB682187A07461734D66E1E6492,60631,21,23,2,109.57778,18.27583,1814
14946,114194,34F3D64B41C252481F72E5CF931AC833,39183,1,6,5,109.55542,18.28208,1715
14947,114195,34F3D64B41C252481F72E5CF931AC833,30854,7,8,1,109.56889,18.27076,1763
14948,114196,34F3D64B41C252481F72E5CF931AC833,31071,12,21,9,109.58257,18.28458,1815
15020,114616,00FD2268DE6E83934D2916174E81532F,60472,2,4,2,109.46625,18.29542,1367
15021,114617,00FD2268DE6E83934D2916174E81532F,30111,6,9,3,109.47583,18.30542,1419
15022,114618,00FD2268DE6E83934D2916174E81532F,30761,9,12,3,109.45201,18.3,1318
15023,114619,00FD2268DE6E83934D2916174E81532F,30111,15,23,8,109.47583,18.30542,1419
15026,114645,B340EDEF4A878E8DF5CBEC25E465EACE,30854,2,4,2,109.56889,18.27076,1763
15027,114646,B340EDEF4A878E8DF5CBEC25E465EACE,31071,5,6,1,109.58257,18.28458,1815
15028,114647,B340EDEF4A878E8DF5CBEC25E465EACE,30854,11,16,5,109.56889,18.27076,1763
15029,114668,F198CAA1F49ACA5D003FD8F8473B3798,30854,0,1,1,109.56889,18.27076,1763
15030,114669,F198CAA1F49ACA5D003FD8F8473B3798,31071,1,7,6,109.58257,18.28458,1815
15031,114670,F198CAA1F49ACA5D003FD8F8473B3798,30854,7,23,16,109.56889,18.27076,1763
15043,114756,8C5A16299A6D294198C90C34C25C5949,39183,0,2,2,109.55542,18.28208,1715
15044,114757,8C5A16299A6D294198C90C34C25C5949,31561,3,4,1,109.56792,18.28479,1765
15045,114758,8C5A16299A6D294198C90C34C25C5949,30854,4,5,1,109.56889,18.27076,1763
15046,114771,096D8D59612F82CD076740A6D0A18387,38971,0,9,9,109.50743,18.25125,1510
15047,114772,096D8D59612F82CD076740A6D0A18387,30151,10,13,3,109.50986,18.25083,1560
15048,114773,096D8D59612F82CD076740A6D0A18387,38971,13,17,4,109.50743,18.25125,1510
15049,114774,096D8D59612F82CD076740A6D0A18387,30421,17,18,1,109.50021,18.25861,1511
15050,114777,8BB035B44D009B4E567D4EFF10F50E4D,30854,0,3,3,109.56889,18.27076,1763
15051,114778,8BB035B44D009B4E567D4EFF10F50E4D,30851,3,4,1,109.5616,18.27396,1713
15052,114779,8BB035B44D009B4E567D4EFF10F50E4D,30854,5,23,18,109.56889,18.27076,1763
15058,114860,0E0D6E55BB1995EBF85F6B7AA8765E55,60631,0,1,1,109.57778,18.27583,1814
15059,114861,0E0D6E55BB1995EBF85F6B7AA8765E55,30854,4,10,6,109.56889,18.27076,1763
15060,114862,0E0D6E55BB1995EBF85F6B7AA8765E55,30151,11,14,3,109.50986,18.25083,1560
15061,114873,C711EA8F4B039EAC279F7CFC24309A8A,38991,1,9,8,109.52681,18.30368,1618
15062,114874,C711EA8F4B039EAC279F7CFC24309A8A,38484,11,15,4,109.53028,18.31528,1620
15063,114875,C711EA8F4B039EAC279F7CFC24309A8A,30281,19,22,3,109.50597,18.27583,1514
15064,114879,2D39AE6120F2674000C6DBB8A6E572A0,31945,0,7,7,109.58021,18.29403,1817
15065,114880,2D39AE6120F2674000C6DBB8A6E572A0,30854,8,9,1,109.56889,18.27076,1763
15066,114881,2D39AE6120F2674000C6DBB8A6E572A0,31945,12,13,1,109.58021,18.29403,1817
15067,114882,2D39AE6120F2674000C6DBB8A6E572A0,30854,18,21,3,109.56889,18.27076,1763
15105,115175,C6E39197478B854A74FABF400B391655,31205,0,1,1,109.51111,18.23736,1557
15106,115176,C6E39197478B854A74FABF400B391655,60291,2,13,11,109.50826,18.24639,1509
15107,115177,C6E39197478B854A74FABF400B391655,39104,13,14,1,109.50104,18.2525,1510
15119,115232,0A80AC29DC2E111565D686AEC8FAB306,31031,2,11,9,109.49979,18.25382,1510
15120,115233,0A80AC29DC2E111565D686AEC8FAB306,30711,13,15,2,109.50271,18.25347,1510
15121,115234,0A80AC29DC2E111565D686AEC8FAB306,39321,19,20,1,109.529,18.2167,1604
15122,115235,0A80AC29DC2E111565D686AEC8FAB306,60381,20,22,2,109.5241,18.22458,1605
15123,115252,B40C23F05DF669D1A7928A9352D650F2,31205,0,1,1,109.51111,18.23736,1557
15124,115253,B40C23F05DF669D1A7928A9352D650F2,30161,1,15,14,109.50042,18.24389,1508
15125,115254,B40C23F05DF669D1A7928A9352D650F2,30511,15,17,2,109.51069,18.24208,1558
15126,115255,B40C23F05DF669D1A7928A9352D650F2,30161,18,20,2,109.50042,18.24389,1508
15137,115359,0D3DA8126B134D203BB35373EAFFB116,31071,0,13,13,109.58257,18.28458,1815
15138,115360,0D3DA8126B134D203BB35373EAFFB116,30854,14,17,3,109.56889,18.27076,1763
15139,115361,0D3DA8126B134D203BB35373EAFFB116,31071,17,22,5,109.58257,18.28458,1815
15148,115530,84DF4A7C208235D171EF56473BCCF210,30851,1,2,1,109.5616,18.27396,1713
15149,115531,84DF4A7C208235D171EF56473BCCF210,31561,3,7,4,109.56792,18.28479,1765
15150,115532,84DF4A7C208235D171EF56473BCCF210,60631,10,18,8,109.57778,18.27583,1814
15151,115533,84DF4A7C208235D171EF56473BCCF210,30851,19,23,4,109.5616,18.27396,1713
15156,115558,0B3E12180DEB0629FE3A7717272ACE4A,31221,5,6,1,109.61333,18.26833,1913
15157,115559,0B3E12180DEB0629FE3A7717272ACE4A,30581,8,11,3,109.62257,18.24951,1959
15158,115560,0B3E12180DEB0629FE3A7717272ACE4A,31221,13,15,2,109.61333,18.26833,1913
15159,115561,0B3E12180DEB0629FE3A7717272ACE4A,30854,18,22,4,109.56889,18.27076,1763
15164,115597,9905C3E423D151CCE1280F3A1732CE90,30854,0,6,6,109.56889,18.27076,1763
15165,115598,9905C3E423D151CCE1280F3A1732CE90,31071,6,17,11,109.58257,18.28458,1815
15166,115599,9905C3E423D151CCE1280F3A1732CE90,30854,18,23,5,109.56889,18.27076,1763
15172,115642,833001CDF394BB3F6E4F040C2A70AC27,30854,3,11,8,109.56889,18.27076,1763
15173,115643,833001CDF394BB3F6E4F040C2A70AC27,31071,13,14,1,109.58257,18.28458,1815
15174,115644,833001CDF394BB3F6E4F040C2A70AC27,30854,15,23,8,109.56889,18.27076,1763
15201,115712,C2CC718D695CB45C49C10B739F52F650,31031,0,9,9,109.49979,18.25382,1510
15202,115713,C2CC718D695CB45C49C10B739F52F650,31031,10,13,3,109.49979,18.25382,1510
15203,115714,C2CC718D695CB45C49C10B739F52F650,60084,14,16,2,109.4984,18.2334,1507
15212,115735,335A7B1DE8538918FDA774EE3E402A76,30191,0,7,7,109.50361,18.22701,1506
15213,115736,335A7B1DE8538918FDA774EE3E402A76,31521,7,13,6,109.51458,18.22542,1555
15214,115737,335A7B1DE8538918FDA774EE3E402A76,30191,17,23,6,109.50361,18.22701,1506
15235,116004,2A699167E9D3E245FFAC98B0B1AFC37B,30854,0,6,6,109.56889,18.27076,1763
15236,116005,2A699167E9D3E245FFAC98B0B1AFC37B,31071,7,8,1,109.58257,18.28458,1815
15237,116006,2A699167E9D3E245FFAC98B0B1AFC37B,30854,9,15,6,109.56889,18.27076,1763
15238,116012,10BB72F4E7990A3695C663829F0D188E,30081,1,8,7,109.50243,18.26632,1512
15239,116013,10BB72F4E7990A3695C663829F0D188E,39183,10,12,2,109.55542,18.28208,1715
15240,116014,10BB72F4E7990A3695C663829F0D188E,30081,12,14,2,109.50243,18.26632,1512
15251,116107,DC29C676832347947F366933ECB88090,31561,0,15,15,109.56792,18.28479,1765
15252,116108,DC29C676832347947F366933ECB88090,39183,15,18,3,109.55542,18.28208,1715
15253,116109,DC29C676832347947F366933ECB88090,31561,20,23,3,109.56792,18.28479,1765
15262,116227,EF24901D99384F703B20FE07F2784FA0,30101,0,1,1,109.57299,18.33333,1773
15263,116228,EF24901D99384F703B20FE07F2784FA0,31631,1,10,9,109.59542,18.36826,1879
15264,116229,EF24901D99384F703B20FE07F2784FA0,30101,12,23,11,109.57299,18.33333,1773
15284,116298,020753EF78F0A0C39658113A3377EA1E,30851,0,1,1,109.5616,18.27396,1713
15285,116299,020753EF78F0A0C39658113A3377EA1E,31561,2,12,10,109.56792,18.28479,1765
15286,116300,020753EF78F0A0C39658113A3377EA1E,39183,15,16,1,109.55542,18.28208,1715
15305,116449,1980C8D409DE9551539224B3D393CDAA,30071,0,4,4,109.52819,18.30472,1619
15306,116450,1980C8D409DE9551539224B3D393CDAA,31951,7,8,1,109.52174,18.30299,1568
15307,116451,1980C8D409DE9551539224B3D393CDAA,30071,8,13,5,109.52819,18.30472,1619
15308,116452,1980C8D409DE9551539224B3D393CDAA,31951,14,17,3,109.52174,18.30299,1568
15323,116590,43E035AE85036EBD9891453E9567CB81,30151,0,10,10,109.50986,18.25083,1560
15324,116591,43E035AE85036EBD9891453E9567CB81,30151,13,15,2,109.50986,18.25083,1560
15325,116592,43E035AE85036EBD9891453E9567CB81,30151,18,23,5,109.50986,18.25083,1560
15326,116593,9AC1B73A6A57A1A8B7B76A628C70874E,31071,1,14,13,109.58257,18.28458,1815
15327,116594,9AC1B73A6A57A1A8B7B76A628C70874E,30854,18,19,1,109.56889,18.27076,1763
15328,116595,9AC1B73A6A57A1A8B7B76A628C70874E,31071,20,22,2,109.58257,18.28458,1815
15331,116652,8752BC71725B50257436D50C6598F252,31761,0,2,2,109.60521,18.27965,1914
15332,116653,8752BC71725B50257436D50C6598F252,31071,4,6,2,109.58257,18.28458,1815
15333,116654,8752BC71725B50257436D50C6598F252,30581,10,11,1,109.62257,18.24951,1959
15334,116655,8752BC71725B50257436D50C6598F252,31071,12,14,2,109.58257,18.28458,1815
15340,116702,6A6113C1376DC676D51836D1E415DD5E,38271,0,7,7,109.62632,18.23049,1956
15341,116703,6A6113C1376DC676D51836D1E415DD5E,60321,8,9,1,109.63611,18.24306,2008
15342,116704,6A6113C1376DC676D51836D1E415DD5E,38271,10,12,2,109.62632,18.23049,1956
15343,116705,6A6113C1376DC676D51836D1E415DD5E,31521,17,20,3,109.51458,18.22542,1555
15369,116847,1412BA3B65BC1A2354CCBE297098A0E1,31071,4,8,4,109.58257,18.28458,1815
15370,116848,1412BA3B65BC1A2354CCBE297098A0E1,30854,10,12,2,109.56889,18.27076,1763
15371,116849,1412BA3B65BC1A2354CCBE297098A0E1,31071,12,14,2,109.58257,18.28458,1815
15372,116850,1412BA3B65BC1A2354CCBE297098A0E1,30854,15,21,6,109.56889,18.27076,1763
15373,116895,53453D8B736810206EC5A6632D159BE6,31931,0,16,16,109.54771,18.29403,1667
15374,116896,53453D8B736810206EC5A6632D159BE6,60371,16,20,4,109.53063,18.30056,1618
15375,116897,53453D8B736810206EC5A6632D159BE6,31931,20,23,3,109.54771,18.29403,1667
15383,116911,9AA959ED87D1ECC3053DED17290EFCBD,31561,3,5,2,109.56792,18.28479,1765
15384,116912,9AA959ED87D1ECC3053DED17290EFCBD,39183,7,10,3,109.55542,18.28208,1715
15385,116913,9AA959ED87D1ECC3053DED17290EFCBD,31561,11,13,2,109.56792,18.28479,1765
15386,116914,9AA959ED87D1ECC3053DED17290EFCBD,39183,13,16,3,109.55542,18.28208,1715
15399,116972,E475FCBFD73C578507E18D91DA2D8451,38951,2,7,5,109.48097,18.28868,1416
15400,116973,E475FCBFD73C578507E18D91DA2D8451,30971,10,12,2,109.48708,18.29319,1467
15401,116974,E475FCBFD73C578507E18D91DA2D8451,38951,12,13,1,109.48097,18.28868,1416
15402,116975,E475FCBFD73C578507E18D91DA2D8451,60614,14,15,1,109.48799,18.29521,1467
15406,117014,32D0EBFA645FCE8DAD65D018847E5043,39371,0,7,7,109.56627,18.2646,1762
15407,117015,32D0EBFA645FCE8DAD65D018847E5043,30854,9,10,1,109.56889,18.27076,1763
15408,117016,32D0EBFA645FCE8DAD65D018847E5043,39371,12,15,3,109.56627,18.2646,1762
15409,117017,32D0EBFA645FCE8DAD65D018847E5043,30854,19,21,2,109.56889,18.27076,1763
15414,117074,BBE4D8242EE46AE73AD69A56A00F4408,30201,0,7,7,109.4909,18.26465,1462
15415,117075,BBE4D8242EE46AE73AD69A56A00F4408,31021,7,10,3,109.49021,18.27,1463
15416,117076,BBE4D8242EE46AE73AD69A56A00F4408,31271,12,16,4,109.48958,18.26257,1462
15417,117077,BBE4D8242EE46AE73AD69A56A00F4408,30201,19,22,3,109.4909,18.26465,1462
15446,117287,E9E473F09C342630187345312F4A31D8,39181,0,14,14,109.55153,18.28035,1715
15447,117288,E9E473F09C342630187345312F4A31D8,39181,15,18,3,109.55153,18.28035,1715
15448,117289,E9E473F09C342630187345312F4A31D8,60171,21,22,1,109.51292,18.30694,1569
15481,117535,B34415F599F0ED7D1A073EE314A60B9B,31671,5,12,7,109.38965,18.29813,1068
15482,117536,B34415F599F0ED7D1A073EE314A60B9B,31681,13,14,1,109.40396,18.29979,1168
15483,117537,B34415F599F0ED7D1A073EE314A60B9B,31671,15,19,4,109.38965,18.29813,1068
15493,117598,E0A24740E2C54F3B77DB561A91D2BED7,30151,0,1,1,109.50986,18.25083,1560
15494,117599,E0A24740E2C54F3B77DB561A91D2BED7,30151,2,7,5,109.50986,18.25083,1560
15495,117600,E0A24740E2C54F3B77DB561A91D2BED7,30251,8,17,9,109.50611,18.26653,1512
15496,117601,E0A24740E2C54F3B77DB561A91D2BED7,30151,18,23,5,109.50986,18.25083,1560
15497,117619,10E6DCB22C04D9E1B01193CDA87B3193,60221,0,6,6,109.52569,18.29188,1616
15498,117620,10E6DCB22C04D9E1B01193CDA87B3193,31561,10,11,1,109.56792,18.28479,1765
15499,117621,10E6DCB22C04D9E1B01193CDA87B3193,30854,14,17,3,109.56889,18.27076,1763
15553,118156,D626C213FA0AAEAFB4EA6E1A519D93E5,31521,0,2,2,109.51458,18.22542,1555
15554,118157,D626C213FA0AAEAFB4EA6E1A519D93E5,39321,3,13,10,109.529,18.2167,1604
15555,118158,D626C213FA0AAEAFB4EA6E1A519D93E5,31521,14,15,1,109.51458,18.22542,1555
15556,118159,D626C213FA0AAEAFB4EA6E1A519D93E5,60381,19,23,4,109.5241,18.22458,1605
15563,118256,7BF65E5054DA81A230AB5423620158E1,60631,0,5,5,109.57778,18.27583,1814
15564,118257,7BF65E5054DA81A230AB5423620158E1,30854,7,12,5,109.56889,18.27076,1763
15565,118258,7BF65E5054DA81A230AB5423620158E1,60631,12,13,1,109.57778,18.27583,1814
15566,118259,7BF65E5054DA81A230AB5423620158E1,30854,15,19,4,109.56889,18.27076,1763
15576,118390,C6C3BC01E542B810EF853FEEB6C81198,60361,0,14,14,109.51938,18.29681,1567
15577,118391,C6C3BC01E542B810EF853FEEB6C81198,60221,15,16,1,109.52569,18.29188,1616
15578,118392,C6C3BC01E542B810EF853FEEB6C81198,60361,17,19,2,109.51938,18.29681,1567
15579,118395,3871846CD20CC7E3D76BFB165D15B326,30854,0,6,6,109.56889,18.27076,1763
15580,118396,3871846CD20CC7E3D76BFB165D15B326,31561,7,9,2,109.56792,18.28479,1765
15581,118397,3871846CD20CC7E3D76BFB165D15B326,30854,12,23,11,109.56889,18.27076,1763
15592,118493,FF811E88FEA9CBDF12E5CC54DEE7CCA1,39371,4,7,3,109.56627,18.2646,1762
15593,118494,FF811E88FEA9CBDF12E5CC54DEE7CCA1,30891,8,9,1,109.59431,18.28389,1865
15594,118495,FF811E88FEA9CBDF12E5CC54DEE7CCA1,30854,9,10,1,109.56889,18.27076,1763
15595,118505,0BC523536561C072856E101229AE8902,30854,0,6,6,109.56889,18.27076,1763
15596,118506,0BC523536561C072856E101229AE8902,30581,9,12,3,109.62257,18.24951,1959
15597,118507,0BC523536561C072856E101229AE8902,31071,14,21,7,109.58257,18.28458,1815
15598,118508,0BC523536561C072856E101229AE8902,60631,21,23,2,109.57778,18.27583,1814
15605,118575,FE95B3A32EFBC2838F293DF38F55FDD1,39183,2,5,3,109.55542,18.28208,1715
15606,118576,FE95B3A32EFBC2838F293DF38F55FDD1,31931,6,8,2,109.54771,18.29403,1667
15607,118577,FE95B3A32EFBC2838F293DF38F55FDD1,39183,8,19,11,109.55542,18.28208,1715
15610,118610,5A6C2C4A9B4DF43C379FCADC2CCFC5BC,38171,1,7,6,109.50799,18.28139,1515
15611,118611,5A6C2C4A9B4DF43C379FCADC2CCFC5BC,38261,10,11,1,109.50361,18.28153,1515
15612,118612,5A6C2C4A9B4DF43C379FCADC2CCFC5BC,38171,13,18,5,109.50799,18.28139,1515
15613,118613,5A6C2C4A9B4DF43C379FCADC2CCFC5BC,31531,18,23,5,109.49583,18.25972,1461
15614,118629,A295CDC40521CA815718307440F6AFE6,60504,0,4,4,109.47917,18.28903,1416
15615,118630,A295CDC40521CA815718307440F6AFE6,30671,4,7,3,109.43611,18.30139,1268
15616,118631,A295CDC40521CA815718307440F6AFE6,60551,12,14,2,109.42722,18.30111,1218
15627,118669,30CE72A519D49881F23B8123486E3A02,60411,0,9,9,109.32514,18.30854,869
15628,118670,30CE72A519D49881F23B8123486E3A02,31471,12,16,4,109.34583,18.29563,917
15629,118671,30CE72A519D49881F23B8123486E3A02,60411,19,23,4,109.32514,18.30854,869
15631,118818,D56A67341D1DA856D04BC2181FD404FB,60541,0,7,7,109.4084,18.29208,1167
15632,118819,D56A67341D1DA856D04BC2181FD404FB,30351,9,10,1,109.41701,18.29292,1217
15633,118820,D56A67341D1DA856D04BC2181FD404FB,60541,13,14,1,109.4084,18.29208,1167
15642,118918,FA93329D43DE3EEACED8008F20EF0365,38023,0,12,12,109.37132,18.28993,1016
15643,118919,FA93329D43DE3EEACED8008F20EF0365,31471,12,14,2,109.34583,18.29563,917
15644,118920,FA93329D43DE3EEACED8008F20EF0365,38023,17,23,6,109.37132,18.28993,1016
15651,118979,1B6EBBFF3B9D8A3E18753343B6A29EAE,31071,0,6,6,109.58257,18.28458,1815
15652,118980,1B6EBBFF3B9D8A3E18753343B6A29EAE,30851,7,16,9,109.5616,18.27396,1713
15653,118981,1B6EBBFF3B9D8A3E18753343B6A29EAE,31071,19,23,4,109.58257,18.28458,1815
15663,119099,68DBE0B52FD0AB95F1DD47068FD7847F,30181,0,9,9,109.51597,18.23313,1557
15664,119100,68DBE0B52FD0AB95F1DD47068FD7847F,60381,13,15,2,109.5241,18.22458,1605
15665,119101,68DBE0B52FD0AB95F1DD47068FD7847F,30181,18,20,2,109.51597,18.23313,1557
15666,119102,68DBE0B52FD0AB95F1DD47068FD7847F,30381,20,23,3,109.52521,18.24507,1609
15678,119256,C7B596C3998F49DC6B86FB54AB7111B3,31071,0,5,5,109.58257,18.28458,1815
15679,119257,C7B596C3998F49DC6B86FB54AB7111B3,30101,7,8,1,109.57299,18.33333,1773
15680,119258,C7B596C3998F49DC6B86FB54AB7111B3,30706,9,10,1,109.58833,18.31125,1820
15681,119259,C7B596C3998F49DC6B86FB54AB7111B3,31071,10,21,11,109.58257,18.28458,1815
15682,119272,CF1922E57BC1E2D5DC4336E820C48B77,60411,0,1,1,109.32514,18.30854,869
15683,119273,CF1922E57BC1E2D5DC4336E820C48B77,31471,2,5,3,109.34583,18.29563,917
15684,119274,CF1922E57BC1E2D5DC4336E820C48B77,60411,7,18,11,109.32514,18.30854,869
15687,119291,01339F6C6B37B246DACBDB2C4FDB46D0,30101,1,3,2,109.57299,18.33333,1773
15688,119292,01339F6C6B37B246DACBDB2C4FDB46D0,30941,3,4,1,109.5559,18.33938,1724
15689,119293,01339F6C6B37B246DACBDB2C4FDB46D0,30101,6,7,1,109.57299,18.33333,1773
15690,119294,01339F6C6B37B246DACBDB2C4FDB46D0,30941,7,9,2,109.5559,18.33938,1724
15701,119362,8C28D637CC74662A6171660AC17A06B6,38241,0,7,7,109.54111,18.30542,1669
15702,119363,8C28D637CC74662A6171660AC17A06B6,31951,7,8,1,109.52174,18.30299,1568
15703,119364,8C28D637CC74662A6171660AC17A06B6,60371,11,13,2,109.53063,18.30056,1618
15704,119365,8C28D637CC74662A6171660AC17A06B6,30854,16,17,1,109.56889,18.27076,1763
15715,119541,9BD095517798346F169AD6D898CA1A42,60361,0,6,6,109.51938,18.29681,1567
15716,119542,9BD095517798346F169AD6D898CA1A42,38154,6,8,2,109.5266,18.28278,1615
15717,119543,9BD095517798346F169AD6D898CA1A42,60361,10,23,13,109.51938,18.29681,1567
15732,119634,19F803FB996471824A8A9928BBFAB433,39181,0,5,5,109.55153,18.28035,1715
15733,119635,19F803FB996471824A8A9928BBFAB433,39181,7,8,1,109.55153,18.28035,1715
15734,119636,19F803FB996471824A8A9928BBFAB433,31931,11,12,1,109.54771,18.29403,1667
15735,119751,B530FB0D6C312ECBD89B74FD22C716DB,30181,0,2,2,109.51597,18.23313,1557
15736,119752,B530FB0D6C312ECBD89B74FD22C716DB,30181,3,11,8,109.51597,18.23313,1557
15737,119753,B530FB0D6C312ECBD89B74FD22C716DB,30361,12,14,2,109.50347,18.24,1508
15738,119754,B530FB0D6C312ECBD89B74FD22C716DB,38283,15,23,8,109.62229,18.22618,1956
15763,119899,875F4B80762D0E664890361D764F907D,60081,0,7,7,109.51097,18.22639,1556
15764,119900,875F4B80762D0E664890361D764F907D,30571,7,20,13,109.50243,18.21861,1504
15765,119901,875F4B80762D0E664890361D764F907D,30711,20,21,1,109.50271,18.25347,1510
15797,120231,17D13F6A66037B54FAB5668CDC734401,30721,0,6,6,109.51597,18.28257,1565
15798,120232,17D13F6A66037B54FAB5668CDC734401,39181,10,11,1,109.55153,18.28035,1715
15799,120233,17D13F6A66037B54FAB5668CDC734401,30721,13,23,10,109.51597,18.28257,1565
15805,120296,9B24FEFE42610E15A8305E52C167D9B9,38154,1,8,7,109.5266,18.28278,1615
15806,120297,9B24FEFE42610E15A8305E52C167D9B9,30854,10,11,1,109.56889,18.27076,1763
15807,120298,9B24FEFE42610E15A8305E52C167D9B9,38154,12,13,1,109.5266,18.28278,1615
15808,120299,9B24FEFE42610E15A8305E52C167D9B9,30854,16,17,1,109.56889,18.27076,1763
15815,120406,8621CFDF1B89A83351494618C53D033F,39181,0,12,12,109.55153,18.28035,1715
15816,120407,8621CFDF1B89A83351494618C53D033F,31071,13,15,2,109.58257,18.28458,1815
15817,120408,8621CFDF1B89A83351494618C53D033F,39181,16,23,7,109.55153,18.28035,1715
15825,120489,22B987DE38F8C4435934FE5E6190C4A2,60631,1,11,10,109.57778,18.27583,1814
15826,120490,22B987DE38F8C4435934FE5E6190C4A2,30581,16,18,2,109.62257,18.24951,1959
15827,120491,22B987DE38F8C4435934FE5E6190C4A2,60631,22,23,1,109.57778,18.27583,1814
15849,120658,8F3DE08315D720DC64DC898C5903196E,30854,0,12,12,109.56889,18.27076,1763
15850,120659,8F3DE08315D720DC64DC898C5903196E,60631,16,17,1,109.57778,18.27583,1814
15851,120660,8F3DE08315D720DC64DC898C5903196E,30854,21,23,2,109.56889,18.27076,1763
15860,120795,7B468825EC3CAA1A3172074B4283732A,38911,3,5,2,109.51674,18.24965,1559
15861,120796,7B468825EC3CAA1A3172074B4283732A,31201,7,19,12,109.51042,18.23819,1558
15862,120797,7B468825EC3CAA1A3172074B4283732A,38291,19,21,2,109.51618,18.24313,1558
15895,121051,5EBEA276FCB4A19AC5C987F5C7CC8908,38361,0,3,3,109.43667,18.29201,1267
15896,121052,5EBEA276FCB4A19AC5C987F5C7CC8908,60504,4,7,3,109.47917,18.28903,1416
15897,121053,5EBEA276FCB4A19AC5C987F5C7CC8908,38361,12,20,8,109.43667,18.29201,1267
15898,121054,5EBEA276FCB4A19AC5C987F5C7CC8908,60552,21,22,1,109.41729,18.30014,1218
15905,121079,DB4DF566D4757FF3BB488F82DE126248,31561,0,6,6,109.56792,18.28479,1765
15906,121080,DB4DF566D4757FF3BB488F82DE126248,30851,9,12,3,109.5616,18.27396,1713
15907,121081,DB4DF566D4757FF3BB488F82DE126248,31561,14,20,6,109.56792,18.28479,1765
15920,121393,0C8D15C0488D521680F0DE3A28CFE111,31811,0,6,6,109.54201,18.31806,1671
15921,121394,0C8D15C0488D521680F0DE3A28CFE111,30701,7,12,5,109.59313,18.32007,1871
15922,121395,0C8D15C0488D521680F0DE3A28CFE111,31811,16,19,3,109.54201,18.31806,1671
15923,121421,CA3896FB33E9BC68E91955EDFF5D709B,30854,0,7,7,109.56889,18.27076,1763
15924,121422,CA3896FB33E9BC68E91955EDFF5D709B,31945,12,13,1,109.58021,18.29403,1817
15925,121423,CA3896FB33E9BC68E91955EDFF5D709B,30854,13,14,1,109.56889,18.27076,1763
15926,121424,CA3896FB33E9BC68E91955EDFF5D709B,31071,18,20,2,109.58257,18.28458,1815
15930,121476,A2F498F18C66416187F7445E3041DB7D,38154,0,18,18,109.5266,18.28278,1615
15931,121477,A2F498F18C66416187F7445E3041DB7D,31031,18,20,2,109.49979,18.25382,1510
15932,121478,A2F498F18C66416187F7445E3041DB7D,30121,21,23,2,109.52861,18.27222,1613
15944,121706,14DC9638CB494ECD60B58F300BAA61B6,39181,0,6,6,109.55153,18.28035,1715
15945,121707,14DC9638CB494ECD60B58F300BAA61B6,39181,7,11,4,109.55153,18.28035,1715
15946,121708,14DC9638CB494ECD60B58F300BAA61B6,31931,16,17,1,109.54771,18.29403,1667
15947,121709,14DC9638CB494ECD60B58F300BAA61B6,39181,17,23,6,109.55153,18.28035,1715
15953,121758,EF0AF6DFF11E792E87881ED5E6F91398,38154,0,5,5,109.5266,18.28278,1615
15954,121759,EF0AF6DFF11E792E87881ED5E6F91398,39183,10,17,7,109.55542,18.28208,1715
15955,121760,EF0AF6DFF11E792E87881ED5E6F91398,30721,18,23,5,109.51597,18.28257,1565
15956,121764,C93386A9D86FE22A1FD4E5116045DD8D,31561,0,5,5,109.56792,18.28479,1765
15957,121765,C93386A9D86FE22A1FD4E5116045DD8D,39183,7,11,4,109.55542,18.28208,1715
15958,121766,C93386A9D86FE22A1FD4E5116045DD8D,31561,11,12,1,109.56792,18.28479,1765
15959,121767,C93386A9D86FE22A1FD4E5116045DD8D,39183,13,18,5,109.55542,18.28208,1715
15962,121818,BAFDD3A022A674BA6CCC93E365FAFC36,30084,0,1,1,109.50118,18.26972,1513
15963,121819,BAFDD3A022A674BA6CCC93E365FAFC36,30201,1,8,7,109.4909,18.26465,1462
15964,121820,BAFDD3A022A674BA6CCC93E365FAFC36,31461,12,13,1,109.5091,18.25389,1510
15987,122028,D37BF241A4A35F0F341582CAF9EF0DD2,39101,0,8,8,109.50132,18.24931,1509
15988,122029,D37BF241A4A35F0F341582CAF9EF0DD2,30421,8,11,3,109.50021,18.25861,1511
15989,122030,D37BF241A4A35F0F341582CAF9EF0DD2,30711,13,14,1,109.50271,18.25347,1510
16008,122129,8CF3C85B5C8D39E684EB13FC9B018A44,38157,0,16,16,109.51483,18.26958,1563
16009,122130,8CF3C85B5C8D39E684EB13FC9B018A44,39101,17,19,2,109.50132,18.24931,1509
16010,122131,8CF3C85B5C8D39E684EB13FC9B018A44,30201,19,20,1,109.4909,18.26465,1462
16011,122141,1D4558B4C0B5F77B61048106C84086AA,31091,0,6,6,109.41201,18.31222,1170
16012,122142,1D4558B4C0B5F77B61048106C84086AA,30354,6,11,5,109.42813,18.29076,1216
16013,122143,1D4558B4C0B5F77B61048106C84086AA,31231,13,15,2,109.42597,18.29292,1217
16017,122179,C709D01469E0800AF998DFAF42105CDC,30854,0,1,1,109.56889,18.27076,1763
16018,122180,C709D01469E0800AF998DFAF42105CDC,31561,6,17,11,109.56792,18.28479,1765
16019,122181,C709D01469E0800AF998DFAF42105CDC,60661,18,20,2,109.548,18.2377,1657
16020,122203,173CD7A2B7B334BC53A50A1D248FBCFE,31071,2,18,16,109.58257,18.28458,1815
16021,122204,173CD7A2B7B334BC53A50A1D248FBCFE,30854,19,22,3,109.56889,18.27076,1763
16022,122205,173CD7A2B7B334BC53A50A1D248FBCFE,31071,22,23,1,109.58257,18.28458,1815
16031,122334,DDE77D3A656666992FC3458B84010D43,39183,0,3,3,109.55542,18.28208,1715
16032,122335,DDE77D3A656666992FC3458B84010D43,31561,7,8,1,109.56792,18.28479,1765
16033,122336,DDE77D3A656666992FC3458B84010D43,39183,11,23,12,109.55542,18.28208,1715
16042,122369,2C3BD53A8702A47FB82F05FB4993B683,31561,0,5,5,109.56792,18.28479,1765
16043,122370,2C3BD53A8702A47FB82F05FB4993B683,39183,8,9,1,109.55542,18.28208,1715
16044,122371,2C3BD53A8702A47FB82F05FB4993B683,31561,12,13,1,109.56792,18.28479,1765
16045,122372,2C3BD53A8702A47FB82F05FB4993B683,39181,16,17,1,109.55153,18.28035,1715
16052,122434,F6A1EBB84FE583E84185C423218578F5,31561,0,5,5,109.56792,18.28479,1765
16053,122435,F6A1EBB84FE583E84185C423218578F5,39183,6,7,1,109.55542,18.28208,1715
16054,122436,F6A1EBB84FE583E84185C423218578F5,31561,12,20,8,109.56792,18.28479,1765
16059,122546,0E1B3CFC64EBB658DA96D0DCA834701E,61011,0,3,3,109.60653,18.19076,1900
16060,122548,0E1B3CFC64EBB658DA96D0DCA834701E,61011,5,6,1,109.60653,18.19076,1900
16061,122550,0E1B3CFC64EBB658DA96D0DCA834701E,61011,13,15,2,109.60653,18.19076,1900
16062,122552,0E1B3CFC64EBB658DA96D0DCA834701E,61011,19,21,2,109.60653,18.19076,1900
16063,122563,0E56047C2113CB9384943BEBAA9FF06B,31031,0,10,10,109.49979,18.25382,1510
16064,122564,0E56047C2113CB9384943BEBAA9FF06B,30711,13,14,1,109.50271,18.25347,1510
16065,122565,0E56047C2113CB9384943BEBAA9FF06B,31031,16,17,1,109.49979,18.25382,1510
16066,122566,0E56047C2113CB9384943BEBAA9FF06B,38251,20,22,2,109.49618,18.25493,1510
16069,122618,D39D64452E6BBEF7B3056CA239E1B86E,30854,0,5,5,109.56889,18.27076,1763
16070,122619,D39D64452E6BBEF7B3056CA239E1B86E,31561,7,11,4,109.56792,18.28479,1765
16071,122620,D39D64452E6BBEF7B3056CA239E1B86E,30854,11,23,12,109.56889,18.27076,1763
16101,122876,B712327B6033C61F37801CFD6DAC08AD,38484,0,14,14,109.53028,18.31528,1620
16102,122877,B712327B6033C61F37801CFD6DAC08AD,38484,15,18,3,109.53028,18.31528,1620
16103,122878,B712327B6033C61F37801CFD6DAC08AD,38484,19,22,3,109.53028,18.31528,1620
16104,122886,35EC94F70B365181176929B34C1D5C52,60361,0,1,1,109.51938,18.29681,1567
16105,122887,35EC94F70B365181176929B34C1D5C52,60221,2,8,6,109.52569,18.29188,1616
16106,122888,35EC94F70B365181176929B34C1D5C52,60361,9,20,11,109.51938,18.29681,1567
16107,122889,35EC94F70B365181176929B34C1D5C52,60221,21,23,2,109.52569,18.29188,1616
16129,123212,F47C4E1E39056C43B0AD32AC994AB7C0,31931,1,9,8,109.54771,18.29403,1667
16130,123213,F47C4E1E39056C43B0AD32AC994AB7C0,30921,10,12,2,109.53903,18.29451,1667
16131,123214,F47C4E1E39056C43B0AD32AC994AB7C0,31931,13,14,1,109.54771,18.29403,1667
16132,123233,64EA917EAAD3EB55DA2ABB227203C131,60631,0,7,7,109.57778,18.27583,1814
16133,123234,64EA917EAAD3EB55DA2ABB227203C131,30851,9,11,2,109.5616,18.27396,1713
16134,123235,64EA917EAAD3EB55DA2ABB227203C131,60631,11,13,2,109.57778,18.27583,1814
16136,123301,0F23B6E4E3B228AFE54C52B9B3D593D7,60524,0,9,9,109.42951,18.28993,1216
16137,123302,0F23B6E4E3B228AFE54C52B9B3D593D7,60551,9,15,6,109.42722,18.30111,1218
16138,123303,0F23B6E4E3B228AFE54C52B9B3D593D7,60524,18,21,3,109.42951,18.28993,1216
16152,123447,97C31877CA4226D0F1BA1C0E12066B56,60331,0,6,6,109.505,18.26507,1512
16153,123448,97C31877CA4226D0F1BA1C0E12066B56,30854,7,11,4,109.56889,18.27076,1763
16154,123449,97C31877CA4226D0F1BA1C0E12066B56,31071,13,14,1,109.58257,18.28458,1815
16155,123450,97C31877CA4226D0F1BA1C0E12066B56,30854,15,16,1,109.56889,18.27076,1763
16156,123454,A549C024E6F63EDBD3DC866F10DB11CE,31071,0,2,2,109.58257,18.28458,1815
16157,123455,A549C024E6F63EDBD3DC866F10DB11CE,30234,2,4,2,109.60681,18.29979,1918
16158,123456,A549C024E6F63EDBD3DC866F10DB11CE,30854,8,20,12,109.56889,18.27076,1763
16161,123463,70A62761FE79F922D082380DA7747243,30854,1,2,1,109.56889,18.27076,1763
16162,123464,70A62761FE79F922D082380DA7747243,31561,2,4,2,109.56792,18.28479,1765
16163,123465,70A62761FE79F922D082380DA7747243,30854,8,22,14,109.56889,18.27076,1763
16170,123534,F2620FCAAD481C8B0F3979FFE2786ED4,38356,2,13,11,109.50201,18.21486,1504
16171,123535,F2620FCAAD481C8B0F3979FFE2786ED4,38017,17,18,1,109.49729,18.21424,1504
16172,123536,F2620FCAAD481C8B0F3979FFE2786ED4,38356,19,21,2,109.50201,18.21486,1504
16186,123630,10EBF762D28520B09848288F7052CFDE,30854,0,6,6,109.56889,18.27076,1763
16187,123631,10EBF762D28520B09848288F7052CFDE,39101,7,12,5,109.50132,18.24931,1509
16188,123632,10EBF762D28520B09848288F7052CFDE,39101,13,19,6,109.50132,18.24931,1509
16189,123633,10EBF762D28520B09848288F7052CFDE,39183,20,21,1,109.55542,18.28208,1715
16195,123710,AAB3DCB18BAF89954DC0C8A658A6D766,31951,0,6,6,109.52174,18.30299,1568
16196,123711,AAB3DCB18BAF89954DC0C8A658A6D766,38881,7,15,8,109.51618,18.26431,1562
16197,123712,AAB3DCB18BAF89954DC0C8A658A6D766,30071,20,23,3,109.52819,18.30472,1619
16220,123845,6D0CBC29417959EBDF12F1FD604A5C61,60661,0,5,5,109.548,18.2377,1657
16221,123846,6D0CBC29417959EBDF12F1FD604A5C61,60381,7,8,1,109.5241,18.22458,1605
16222,123847,6D0CBC29417959EBDF12F1FD604A5C61,39321,9,11,2,109.529,18.2167,1604
16230,123964,0A29B4A7718F7E72873D130D95F796DA,38094,0,8,8,109.45403,18.28778,1316
16231,123965,0A29B4A7718F7E72873D130D95F796DA,30764,10,11,1,109.45806,18.29486,1367
16232,123966,0A29B4A7718F7E72873D130D95F796DA,60441,15,16,1,109.46792,18.28604,1366
16233,123967,1026894DC5FF9A7FAF3A2EE28B95E239,30854,1,5,4,109.56889,18.27076,1763
16234,123968,1026894DC5FF9A7FAF3A2EE28B95E239,39183,8,10,2,109.55542,18.28208,1715
16235,123969,1026894DC5FF9A7FAF3A2EE28B95E239,30891,12,14,2,109.59431,18.28389,1865
16243,123996,7421066246AAD1C230E7E2A7ADF06E9D,31071,1,2,1,109.58257,18.28458,1815
16244,123997,7421066246AAD1C230E7E2A7ADF06E9D,60631,3,4,1,109.57778,18.27583,1814
16245,123998,7421066246AAD1C230E7E2A7ADF06E9D,31071,9,10,1,109.58257,18.28458,1815
16246,123999,7421066246AAD1C230E7E2A7ADF06E9D,30854,13,22,9,109.56889,18.27076,1763
16266,124211,EFFEF00C078D502D6D0D1D469ACBA466,39041,0,8,8,109.40021,18.29278,1117
16267,124212,EFFEF00C078D502D6D0D1D469ACBA466,31471,9,11,2,109.34583,18.29563,917
16268,124213,EFFEF00C078D502D6D0D1D469ACBA466,39041,12,14,2,109.40021,18.29278,1117
16280,124305,147470AD3D3B8724582C30D5F244A8B6,60421,0,6,6,109.46333,18.31743,1371
16281,124306,147470AD3D3B8724582C30D5F244A8B6,30111,7,10,3,109.47583,18.30542,1419
16282,124307,147470AD3D3B8724582C30D5F244A8B6,60421,10,17,7,109.46333,18.31743,1371
16283,124308,147470AD3D3B8724582C30D5F244A8B6,30111,18,20,2,109.47583,18.30542,1419
16295,124394,0D62B1A1AE4A27E0E66F6B7C8CF804F4,31041,1,2,1,109.50278,18.23701,1507
16296,124395,0D62B1A1AE4A27E0E66F6B7C8CF804F4,30181,2,6,4,109.51597,18.23313,1557
16297,124396,0D62B1A1AE4A27E0E66F6B7C8CF804F4,31041,8,10,2,109.50278,18.23701,1507
16326,124627,C5A446AC7123103DC030E8D43C03C155,60221,0,9,9,109.52569,18.29188,1616
16327,124628,C5A446AC7123103DC030E8D43C03C155,30421,12,13,1,109.50021,18.25861,1511
16328,124629,C5A446AC7123103DC030E8D43C03C155,31031,13,15,2,109.49979,18.25382,1510
16329,124630,C5A446AC7123103DC030E8D43C03C155,60221,16,22,6,109.52569,18.29188,1616
16336,124769,53875E69050EC42E511A64D3211FA7B3,60631,3,4,1,109.57778,18.27583,1814
16337,124770,53875E69050EC42E511A64D3211FA7B3,31071,5,6,1,109.58257,18.28458,1815
16338,124771,53875E69050EC42E511A64D3211FA7B3,30854,10,11,1,109.56889,18.27076,1763
16357,124850,ABCD0851CC1C78BCD7AF6DBDF2F5DE49,60041,4,6,2,109.39889,18.31944,1121
16358,124851,ABCD0851CC1C78BCD7AF6DBDF2F5DE49,60552,8,12,4,109.41729,18.30014,1218
16359,124852,ABCD0851CC1C78BCD7AF6DBDF2F5DE49,60524,16,17,1,109.42951,18.28993,1216
16360,124853,ABCD0851CC1C78BCD7AF6DBDF2F5DE49,60552,18,21,3,109.41729,18.30014,1218
16374,125004,98EB1CF842CD30ED85E927AB3226642D,30234,3,6,3,109.60681,18.29979,1918
16375,125005,98EB1CF842CD30ED85E927AB3226642D,30891,6,8,2,109.59431,18.28389,1865
16376,125006,98EB1CF842CD30ED85E927AB3226642D,31071,11,23,12,109.58257,18.28458,1815
16377,125036,F0276D651C6FE98B640C5224E9458C5B,60361,0,6,6,109.51938,18.29681,1567
16378,125037,F0276D651C6FE98B640C5224E9458C5B,30681,8,9,1,109.48493,18.26917,1463
16379,125038,F0276D651C6FE98B640C5224E9458C5B,38315,12,15,3,109.48979,18.29764,1467
16394,125236,72D984C8386A232B13E9D168E7A1C5F8,60551,0,7,7,109.42722,18.30111,1218
16395,125237,72D984C8386A232B13E9D168E7A1C5F8,30671,7,9,2,109.43611,18.30139,1268
16396,125238,72D984C8386A232B13E9D168E7A1C5F8,38094,13,14,1,109.45403,18.28778,1316
16397,125239,72D984C8386A232B13E9D168E7A1C5F8,60541,18,19,1,109.4084,18.29208,1167
16398,125268,00FD2268DE6E83934D2916174E81532F,30111,2,3,1,109.47583,18.30542,1419
16399,125269,00FD2268DE6E83934D2916174E81532F,30761,5,7,2,109.45201,18.3,1318
16400,125270,00FD2268DE6E83934D2916174E81532F,60472,9,10,1,109.46625,18.29542,1367
16401,125271,00FD2268DE6E83934D2916174E81532F,30111,11,22,11,109.47583,18.30542,1419
16402,125309,B87EA32D7A8C628CB2B89E95996DDE3E,60371,1,7,6,109.53063,18.30056,1618
16403,125310,B87EA32D7A8C628CB2B89E95996DDE3E,31931,12,16,4,109.54771,18.29403,1667
16404,125311,B87EA32D7A8C628CB2B89E95996DDE3E,30921,16,21,5,109.53903,18.29451,1667
16405,125312,B87EA32D7A8C628CB2B89E95996DDE3E,60371,22,23,1,109.53063,18.30056,1618
16406,125313,B95D5FCFC7327770C14B6F9FFDB772BC,31071,1,4,3,109.58257,18.28458,1815
16407,125314,B95D5FCFC7327770C14B6F9FFDB772BC,30854,7,8,1,109.56889,18.27076,1763
16408,125315,B95D5FCFC7327770C14B6F9FFDB772BC,31071,8,9,1,109.58257,18.28458,1815
16409,125335,B340EDEF4A878E8DF5CBEC25E465EACE,30854,3,12,9,109.56889,18.27076,1763
16410,125336,B340EDEF4A878E8DF5CBEC25E465EACE,31071,12,14,2,109.58257,18.28458,1815
16411,125337,B340EDEF4A878E8DF5CBEC25E465EACE,30854,14,22,8,109.56889,18.27076,1763
16441,125597,0E0D6E55BB1995EBF85F6B7AA8765E55,30854,0,7,7,109.56889,18.27076,1763
16442,125598,0E0D6E55BB1995EBF85F6B7AA8765E55,60631,8,9,1,109.57778,18.27583,1814
16443,125599,0E0D6E55BB1995EBF85F6B7AA8765E55,30854,10,20,10,109.56889,18.27076,1763
16447,125620,2D39AE6120F2674000C6DBB8A6E572A0,31945,0,7,7,109.58021,18.29403,1817
16448,125621,2D39AE6120F2674000C6DBB8A6E572A0,30854,7,12,5,109.56889,18.27076,1763
16449,125622,2D39AE6120F2674000C6DBB8A6E572A0,31945,12,13,1,109.58021,18.29403,1817
16450,125623,2D39AE6120F2674000C6DBB8A6E572A0,31071,18,19,1,109.58257,18.28458,1815
16451,125658,2D683B3AD358B28A27E068E80E3AA9C8,31945,2,3,1,109.58021,18.29403,1817
16452,125659,2D683B3AD358B28A27E068E80E3AA9C8,31071,6,7,1,109.58257,18.28458,1815
16453,125660,2D683B3AD358B28A27E068E80E3AA9C8,30854,7,21,14,109.56889,18.27076,1763
16454,125673,770A00BDAFE9BCA8C9E9FA68066EED7D,31071,0,8,8,109.58257,18.28458,1815
16455,125674,770A00BDAFE9BCA8C9E9FA68066EED7D,30851,9,13,4,109.5616,18.27396,1713
16456,125675,770A00BDAFE9BCA8C9E9FA68066EED7D,31561,15,18,3,109.56792,18.28479,1765
16457,125676,770A00BDAFE9BCA8C9E9FA68066EED7D,31071,20,23,3,109.58257,18.28458,1815
16470,125921,B4818124F65C5DECA65889607824561E,30181,0,7,7,109.51597,18.23313,1557
16471,125922,B4818124F65C5DECA65889607824561E,31521,12,13,1,109.51458,18.22542,1555
16472,125923,B4818124F65C5DECA65889607824561E,30181,14,15,1,109.51597,18.23313,1557
16479,125987,9FC721E86703223349C05C95FE4BBB6F,60081,0,10,10,109.51097,18.22639,1556
16480,125988,9FC721E86703223349C05C95FE4BBB6F,60381,11,16,5,109.5241,18.22458,1605
16481,125989,9FC721E86703223349C05C95FE4BBB6F,31521,17,19,2,109.51458,18.22542,1555
16482,125990,9FC721E86703223349C05C95FE4BBB6F,60087,20,23,3,109.50688,18.22299,1505
16495,126069,1FC565965746807D5CEEE5746DEC2EDB,30731,0,2,2,109.50944,18.22306,1555
16496,126070,1FC565965746807D5CEEE5746DEC2EDB,30571,2,3,1,109.50243,18.21861,1504
16497,126071,1FC565965746807D5CEEE5746DEC2EDB,30731,4,16,12,109.50944,18.22306,1555
16512,126384,5274FB91D917823AD6AE120EE7F21099,31931,0,6,6,109.54771,18.29403,1667
16513,126385,5274FB91D917823AD6AE120EE7F21099,60241,7,8,1,109.53319,18.28667,1616
16514,126386,5274FB91D917823AD6AE120EE7F21099,31931,11,22,11,109.54771,18.29403,1667
16517,126440,74AD1AF2EA5153BD40BCF9A3F3F2C4E3,30854,1,2,1,109.56889,18.27076,1763
16518,126441,74AD1AF2EA5153BD40BCF9A3F3F2C4E3,31071,2,6,4,109.58257,18.28458,1815
16519,126442,74AD1AF2EA5153BD40BCF9A3F3F2C4E3,30854,7,12,5,109.56889,18.27076,1763
16530,126560,84DF4A7C208235D171EF56473BCCF210,30851,1,4,3,109.5616,18.27396,1713
16531,126561,84DF4A7C208235D171EF56473BCCF210,31561,4,7,3,109.56792,18.28479,1765
16532,126562,84DF4A7C208235D171EF56473BCCF210,60631,8,17,9,109.57778,18.27583,1814
16537,126663,C316CE65034FB3C77BE459147CBF943A,60291,0,8,8,109.50826,18.24639,1509
16538,126664,C316CE65034FB3C77BE459147CBF943A,30161,9,19,10,109.50042,18.24389,1508
16539,126665,C316CE65034FB3C77BE459147CBF943A,60291,20,22,2,109.50826,18.24639,1509
16558,126790,63B50A7073912A66CD527ABAF79EDA78,30271,1,3,2,109.49132,18.23153,1456
16559,126791,63B50A7073912A66CD527ABAF79EDA78,60084,3,4,1,109.4984,18.2334,1507
16560,126792,63B50A7073912A66CD527ABAF79EDA78,60291,9,10,1,109.50826,18.24639,1509
16578,126847,8D7B9451E0189947198D6AC9CE51CFEE,60504,0,2,2,109.47917,18.28903,1416
16579,126848,8D7B9451E0189947198D6AC9CE51CFEE,31091,5,20,15,109.41201,18.31222,1170
16580,126849,8D7B9451E0189947198D6AC9CE51CFEE,60261,22,23,1,109.44326,18.3075,1319
16596,126956,B93185B4820D7E0DEE74EBEA00941D15,60201,0,1,1,109.5041,18.2509,1510
16597,126957,B93185B4820D7E0DEE74EBEA00941D15,30911,4,17,13,109.50493,18.26181,1511
16598,126958,B93185B4820D7E0DEE74EBEA00941D15,31181,18,23,5,109.50382,18.24813,1509
16618,127070,C75EDA4A0DFCA4C39E64550333886E59,31561,0,6,6,109.56792,18.28479,1765
16619,127071,C75EDA4A0DFCA4C39E64550333886E59,31071,7,9,2,109.58257,18.28458,1815
16620,127072,C75EDA4A0DFCA4C39E64550333886E59,31561,10,20,10,109.56792,18.28479,1765
16621,127073,C75EDA4A0DFCA4C39E64550333886E59,31071,20,21,1,109.58257,18.28458,1815
16656,127286,DBB710D279E76C79F1E4B0766F579F8A,31071,0,7,7,109.58257,18.28458,1815
16657,127287,DBB710D279E76C79F1E4B0766F579F8A,30854,8,9,1,109.56889,18.27076,1763
16658,127288,DBB710D279E76C79F1E4B0766F579F8A,31071,12,14,2,109.58257,18.28458,1815
16659,127289,DBB710D279E76C79F1E4B0766F579F8A,30854,14,18,4,109.56889,18.27076,1763
16673,127452,55FA72F7A9567EE8C2569F2A3640F92B,60371,0,5,5,109.53063,18.30056,1618
16674,127453,55FA72F7A9567EE8C2569F2A3640F92B,39181,7,18,11,109.55153,18.28035,1715
16675,127454,55FA72F7A9567EE8C2569F2A3640F92B,60371,21,22,1,109.53063,18.30056,1618
16692,127580,DE44A87559E9DEE84B37BE840DB2C4AC,60054,0,7,7,109.3016,18.31229,770
16693,127581,DE44A87559E9DEE84B37BE840DB2C4AC,31471,7,8,1,109.34583,18.29563,917
16694,127582,DE44A87559E9DEE84B37BE840DB2C4AC,60054,8,23,15,109.3016,18.31229,770
16695,127613,020753EF78F0A0C39658113A3377EA1E,31561,0,5,5,109.56792,18.28479,1765
16696,127614,020753EF78F0A0C39658113A3377EA1E,39183,8,11,3,109.55542,18.28208,1715
16697,127615,020753EF78F0A0C39658113A3377EA1E,31561,11,15,4,109.56792,18.28479,1765
16721,127824,F3652FF504BC297E68234A33C1877043,31071,3,7,4,109.58257,18.28458,1815
16722,127825,F3652FF504BC297E68234A33C1877043,31945,12,14,2,109.58021,18.29403,1817
16723,127826,F3652FF504BC297E68234A33C1877043,30854,16,17,1,109.56889,18.27076,1763
16724,127874,A0CFD24F8D50ABCF6002C5FC96CEAB76,39183,0,6,6,109.55542,18.28208,1715
16725,127875,A0CFD24F8D50ABCF6002C5FC96CEAB76,31931,7,8,1,109.54771,18.29403,1667
16726,127876,A0CFD24F8D50ABCF6002C5FC96CEAB76,39181,9,15,6,109.55153,18.28035,1715
16727,127877,A0CFD24F8D50ABCF6002C5FC96CEAB76,39183,16,22,6,109.55542,18.28208,1715
16730,127968,43E035AE85036EBD9891453E9567CB81,30151,0,13,13,109.50986,18.25083,1560
16731,127969,43E035AE85036EBD9891453E9567CB81,30321,14,17,3,109.49563,18.29611,1467
16732,127970,43E035AE85036EBD9891453E9567CB81,30151,18,23,5,109.50986,18.25083,1560
16752,128230,377A324496E54511961704972731A3D5,31821,0,7,7,109.51181,18.24924,1559
16753,128231,377A324496E54511961704972731A3D5,31521,11,20,9,109.51458,18.22542,1555
16754,128232,377A324496E54511961704972731A3D5,31261,21,23,2,109.51174,18.2466,1559
16764,128392,7890099D98AA300C5BF12527E7372DB0,60631,0,7,7,109.57778,18.27583,1814
16765,128393,7890099D98AA300C5BF12527E7372DB0,31071,8,10,2,109.58257,18.28458,1815
16766,128394,7890099D98AA300C5BF12527E7372DB0,60631,12,20,8,109.57778,18.27583,1814
16767,128395,7890099D98AA300C5BF12527E7372DB0,30891,21,22,1,109.59431,18.28389,1865
16773,128551,BBE4D8242EE46AE73AD69A56A00F4408,30201,0,15,15,109.4909,18.26465,1462
16774,128552,BBE4D8242EE46AE73AD69A56A00F4408,31271,16,18,2,109.48958,18.26257,1462
16775,128553,BBE4D8242EE46AE73AD69A56A00F4408,30201,20,23,3,109.4909,18.26465,1462
16832,128934,00FC332040A284DA251A8D0705989FE9,31071,2,7,5,109.58257,18.28458,1815
16833,128935,00FC332040A284DA251A8D0705989FE9,30854,8,17,9,109.56889,18.27076,1763
16834,128936,00FC332040A284DA251A8D0705989FE9,39181,17,19,2,109.55153,18.28035,1715
16838,129016,8DA877D3A30401F86E81FB7BC1CA2A00,31071,0,10,10,109.58257,18.28458,1815
16839,129017,8DA877D3A30401F86E81FB7BC1CA2A00,30854,10,12,2,109.56889,18.27076,1763
16840,129018,8DA877D3A30401F86E81FB7BC1CA2A00,31071,14,20,6,109.58257,18.28458,1815
16853,129135,AB8F95D841F69DCC3177A6274025E5E6,39183,0,13,13,109.55542,18.28208,1715
16854,129136,AB8F95D841F69DCC3177A6274025E5E6,31931,14,15,1,109.54771,18.29403,1667
16855,129137,AB8F95D841F69DCC3177A6274025E5E6,39183,16,23,7,109.55542,18.28208,1715
16856,129140,DFFF17B7FE30E79B8AABBB5CE171272F,39183,3,4,1,109.55542,18.28208,1715
16857,129141,DFFF17B7FE30E79B8AABBB5CE171272F,31561,7,20,13,109.56792,18.28479,1765
16858,129142,DFFF17B7FE30E79B8AABBB5CE171272F,39183,21,23,2,109.55542,18.28208,1715
16865,129245,8CD15CF6B5FB4821940FF9AFE6D6CB84,39181,1,5,4,109.55153,18.28035,1715
16866,129246,8CD15CF6B5FB4821940FF9AFE6D6CB84,60371,6,7,1,109.53063,18.30056,1618
16867,129247,8CD15CF6B5FB4821940FF9AFE6D6CB84,30921,8,10,2,109.53903,18.29451,1667
16887,129446,03CEC0FDDD5484124514C6D24A63D4DD,31561,2,13,11,109.56792,18.28479,1765
16888,129447,03CEC0FDDD5484124514C6D24A63D4DD,39183,13,16,3,109.55542,18.28208,1715
16889,129448,03CEC0FDDD5484124514C6D24A63D4DD,31561,18,20,2,109.56792,18.28479,1765
16892,129470,EA446444DFE25212830F95291C13D19D,31931,0,6,6,109.54771,18.29403,1667
16893,129471,EA446444DFE25212830F95291C13D19D,39181,9,11,2,109.55153,18.28035,1715
16894,129472,EA446444DFE25212830F95291C13D19D,31931,11,21,10,109.54771,18.29403,1667
16901,129570,14F1CC63CDA098F9694EAC8584B9C7A5,31561,0,7,7,109.56792,18.28479,1765
16902,129571,14F1CC63CDA098F9694EAC8584B9C7A5,30854,11,12,1,109.56889,18.27076,1763
16903,129572,14F1CC63CDA098F9694EAC8584B9C7A5,31561,14,15,1,109.56792,18.28479,1765
16904,129604,12D34EABAB055EE48AA4835BB7A9952C,30771,0,10,10,109.49938,18.26042,1511
16905,129605,12D34EABAB055EE48AA4835BB7A9952C,30771,12,15,3,109.49938,18.26042,1511
16906,129608,12D34EABAB055EE48AA4835BB7A9952C,30771,21,23,2,109.49938,18.26042,1511
16913,129739,8880BF3B03853247B5235ADF19775070,31261,0,3,3,109.51174,18.2466,1559
16914,129740,8880BF3B03853247B5235ADF19775070,30371,6,12,6,109.51,18.24771,1559
16915,129741,8880BF3B03853247B5235ADF19775070,30371,12,23,11,109.51,18.24771,1559
16928,129842,1B3E8931F1FF667205B6505EE53C6E2C,31071,2,9,7,109.58257,18.28458,1815
16929,129843,1B3E8931F1FF667205B6505EE53C6E2C,30854,14,15,1,109.56889,18.27076,1763
16930,129844,1B3E8931F1FF667205B6505EE53C6E2C,31071,15,16,1,109.58257,18.28458,1815
16931,129845,1B3E8931F1FF667205B6505EE53C6E2C,30854,17,19,2,109.56889,18.27076,1763
16948,130097,599AFAF71D30C85AA4E0085C43FF5E03,31206,1,11,10,109.50819,18.23549,1507
16949,130098,599AFAF71D30C85AA4E0085C43FF5E03,38291,14,20,6,109.51618,18.24313,1558
16950,130099,599AFAF71D30C85AA4E0085C43FF5E03,39154,21,23,2,109.50201,18.25681,1511
16953,130142,7BF65E5054DA81A230AB5423620158E1,31071,0,4,4,109.58257,18.28458,1815
16954,130143,7BF65E5054DA81A230AB5423620158E1,60631,5,7,2,109.57778,18.27583,1814
16955,130144,7BF65E5054DA81A230AB5423620158E1,30854,7,16,9,109.56889,18.27076,1763
16956,130145,7BF65E5054DA81A230AB5423620158E1,60631,21,23,2,109.57778,18.27583,1814
16979,130391,6C0260646767B781577B5B8CE2471E51,38484,1,16,15,109.53028,18.31528,1620
16980,130392,6C0260646767B781577B5B8CE2471E51,30321,17,19,2,109.49563,18.29611,1467
16981,130393,6C0260646767B781577B5B8CE2471E51,38484,19,20,1,109.53028,18.31528,1620
16982,130394,6C0260646767B781577B5B8CE2471E51,38484,22,23,1,109.53028,18.31528,1620
17016,130596,8AABF5FDF2B06EB445749240A3894969,30854,1,2,1,109.56889,18.27076,1763
17017,130597,8AABF5FDF2B06EB445749240A3894969,31071,4,8,4,109.58257,18.28458,1815
17018,130598,8AABF5FDF2B06EB445749240A3894969,30854,10,12,2,109.56889,18.27076,1763
17019,130599,34AA33805012BEA88EDC4AD9018BC70E,31181,1,14,13,109.50382,18.24813,1509
17020,130600,34AA33805012BEA88EDC4AD9018BC70E,30421,15,16,1,109.50021,18.25861,1511
17021,130601,34AA33805012BEA88EDC4AD9018BC70E,31181,20,22,2,109.50382,18.24813,1509
17042,130860,408C4FED868686E7B96333835F4C4205,30854,0,7,7,109.56889,18.27076,1763
17043,130861,408C4FED868686E7B96333835F4C4205,31071,8,15,7,109.58257,18.28458,1815
17044,130862,408C4FED868686E7B96333835F4C4205,30201,18,20,2,109.4909,18.26465,1462
17045,130888,10BCCD747640470AAA03DB965CE24293,30291,0,7,7,109.50403,18.27028,1513
17046,130889,10BCCD747640470AAA03DB965CE24293,31951,12,16,4,109.52174,18.30299,1568
17047,130890,10BCCD747640470AAA03DB965CE24293,38061,18,20,2,109.50597,18.23118,1506
17052,130927,B4CEE67D4055F0121BB3723E506478C1,60131,0,7,7,109.49819,18.24778,1509
17053,130928,B4CEE67D4055F0121BB3723E506478C1,60381,8,10,2,109.5241,18.22458,1605
17054,130929,B4CEE67D4055F0121BB3723E506478C1,30421,15,17,2,109.50021,18.25861,1511
17055,130930,B4CEE67D4055F0121BB3723E506478C1,60621,19,23,4,109.48354,18.27451,1464
17061,131043,9B979E9430BCD0DDB6C78BBE525EBD2D,60631,4,5,1,109.57778,18.27583,1814
17062,131044,9B979E9430BCD0DDB6C78BBE525EBD2D,30854,8,20,12,109.56889,18.27076,1763
17063,131045,9B979E9430BCD0DDB6C78BBE525EBD2D,60631,22,23,1,109.57778,18.27583,1814
17069,131064,C1793DCC823463513E28F999E76F9ADC,60054,0,6,6,109.3016,18.31229,770
17070,131065,C1793DCC823463513E28F999E76F9ADC,31471,6,17,11,109.34583,18.29563,917
17071,131066,C1793DCC823463513E28F999E76F9ADC,60054,19,23,4,109.3016,18.31229,770
17072,131162,6751CEC3CF9B2AE78246C7287443D2B4,31945,0,7,7,109.58021,18.29403,1817
17073,131163,6751CEC3CF9B2AE78246C7287443D2B4,30854,8,18,10,109.56889,18.27076,1763
17074,131164,6751CEC3CF9B2AE78246C7287443D2B4,31945,20,23,3,109.58021,18.29403,1817
17078,131190,4294195F192797A89367A7AA50405953,30201,0,9,9,109.4909,18.26465,1462
17079,131191,4294195F192797A89367A7AA50405953,60524,9,11,2,109.42951,18.28993,1216
17080,131192,4294195F192797A89367A7AA50405953,31061,14,16,2,109.53333,18.23257,1607
17081,131193,4294195F192797A89367A7AA50405953,60641,17,23,6,109.53854,18.2359,1657
17122,131417,DF2AB4A2AE483AAADBD33D9CC2795C10,30854,0,13,13,109.56889,18.27076,1763
17123,131418,DF2AB4A2AE483AAADBD33D9CC2795C10,31071,14,15,1,109.58257,18.28458,1815
17124,131419,DF2AB4A2AE483AAADBD33D9CC2795C10,30854,18,20,2,109.56889,18.27076,1763
17125,131420,DF2AB4A2AE483AAADBD33D9CC2795C10,31071,20,23,3,109.58257,18.28458,1815
17126,131437,C7B596C3998F49DC6B86FB54AB7111B3,31071,0,5,5,109.58257,18.28458,1815
17127,131438,C7B596C3998F49DC6B86FB54AB7111B3,30706,6,8,2,109.58833,18.31125,1820
17128,131439,C7B596C3998F49DC6B86FB54AB7111B3,31071,9,23,14,109.58257,18.28458,1815
17133,131492,0EA31DC24D5B7028E03AA286B0DB11EF,31071,0,6,6,109.58257,18.28458,1815
17134,131493,0EA31DC24D5B7028E03AA286B0DB11EF,60631,10,12,2,109.57778,18.27583,1814
17135,131494,0EA31DC24D5B7028E03AA286B0DB11EF,31071,16,17,1,109.58257,18.28458,1815
17150,131629,9BD095517798346F169AD6D898CA1A42,60361,0,6,6,109.51938,18.29681,1567
17151,131630,9BD095517798346F169AD6D898CA1A42,60221,6,7,1,109.52569,18.29188,1616
17152,131631,9BD095517798346F169AD6D898CA1A42,60361,11,15,4,109.51938,18.29681,1567
17153,131632,9BD095517798346F169AD6D898CA1A42,60221,20,22,2,109.52569,18.29188,1616
17163,131710,080247CC19405F981D4BEFE1A1E9D339,39181,0,1,1,109.55153,18.28035,1715
17164,131711,080247CC19405F981D4BEFE1A1E9D339,31931,2,5,3,109.54771,18.29403,1667
17165,131712,080247CC19405F981D4BEFE1A1E9D339,60671,9,10,1,109.52979,18.31757,1621
17181,131951,BA987FAAC62A550769ECB5E13AC256A5,38171,0,8,8,109.50799,18.28139,1515
17182,131952,BA987FAAC62A550769ECB5E13AC256A5,31931,9,10,1,109.54771,18.29403,1667
17183,131953,BA987FAAC62A550769ECB5E13AC256A5,30151,12,13,1,109.50986,18.25083,1560
17184,131954,BA987FAAC62A550769ECB5E13AC256A5,38171,13,15,2,109.50799,18.28139,1515
17185,131963,4A6E6277F47F7550E2618B9C1ADC3166,30361,0,9,9,109.50347,18.24,1508
17186,131964,4A6E6277F47F7550E2618B9C1ADC3166,31391,10,11,1,109.50382,18.24285,1508
17187,131965,4A6E6277F47F7550E2618B9C1ADC3166,30361,13,23,10,109.50347,18.24,1508
17191,132058,5A888DC7A3AA300CC584D9862C5384A1,30421,0,1,1,109.50021,18.25861,1511
17192,132059,5A888DC7A3AA300CC584D9862C5384A1,31461,4,7,3,109.5091,18.25389,1510
17193,132060,5A888DC7A3AA300CC584D9862C5384A1,39181,12,14,2,109.55153,18.28035,1715
17194,132061,5A888DC7A3AA300CC584D9862C5384A1,31931,14,15,1,109.54771,18.29403,1667
17197,132087,875F4B80762D0E664890361D764F907D,60081,0,7,7,109.51097,18.22639,1556
17198,132088,875F4B80762D0E664890361D764F907D,30571,7,18,11,109.50243,18.21861,1504
17199,132089,875F4B80762D0E664890361D764F907D,60081,19,23,4,109.51097,18.22639,1556
17208,132206,9B389AE8E9B004176803CCEAFF69104A,60631,1,5,4,109.57778,18.27583,1814
17209,132207,9B389AE8E9B004176803CCEAFF69104A,31071,7,9,2,109.58257,18.28458,1815
17210,132208,9B389AE8E9B004176803CCEAFF69104A,60631,13,19,6,109.57778,18.27583,1814
17219,132274,47DB633DCEAA585A5A9E2D686518C9D0,30854,0,15,15,109.56889,18.27076,1763
17220,132275,47DB633DCEAA585A5A9E2D686518C9D0,30851,16,17,1,109.5616,18.27396,1713
17221,132276,47DB633DCEAA585A5A9E2D686518C9D0,30854,19,20,1,109.56889,18.27076,1763
17227,132321,B80D6AB96D3D5CEE71A70ED25275F830,38951,0,9,9,109.48097,18.28868,1416
17228,132322,B80D6AB96D3D5CEE71A70ED25275F830,38951,11,12,1,109.48097,18.28868,1416
17229,132323,B80D6AB96D3D5CEE71A70ED25275F830,31531,14,23,9,109.49583,18.25972,1461
17230,132332,17D13F6A66037B54FAB5668CDC734401,30721,0,6,6,109.51597,18.28257,1565
17231,132333,17D13F6A66037B54FAB5668CDC734401,31931,7,10,3,109.54771,18.29403,1667
17232,132334,17D13F6A66037B54FAB5668CDC734401,30721,13,23,10,109.51597,18.28257,1565
17236,132474,81D70A3ED522BA9C5A3A11D0C612F029,30731,0,1,1,109.50944,18.22306,1555
17237,132475,81D70A3ED522BA9C5A3A11D0C612F029,30731,2,6,4,109.50944,18.22306,1555
17238,132476,81D70A3ED522BA9C5A3A11D0C612F029,30221,9,11,2,109.57833,18.20222,1802
17239,132477,81D70A3ED522BA9C5A3A11D0C612F029,30191,16,17,1,109.50361,18.22701,1506
17255,132863,EB316856896788EC8FD871E122E95728,31811,0,3,3,109.54201,18.31806,1671
17256,132864,EB316856896788EC8FD871E122E95728,30701,3,7,4,109.59313,18.32007,1871
17257,132865,EB316856896788EC8FD871E122E95728,31811,7,17,10,109.54201,18.31806,1671
17258,132866,EB316856896788EC8FD871E122E95728,30701,21,23,2,109.59313,18.32007,1871
17259,132869,8F3DE08315D720DC64DC898C5903196E,30854,0,3,3,109.56889,18.27076,1763
17260,132870,8F3DE08315D720DC64DC898C5903196E,39371,4,5,1,109.56627,18.2646,1762
17261,132871,8F3DE08315D720DC64DC898C5903196E,60631,8,9,1,109.57778,18.27583,1814
17262,132872,8F3DE08315D720DC64DC898C5903196E,30854,12,23,11,109.56889,18.27076,1763
17271,133008,58DE8A719D3ADBEDAE163213845B460A,31071,0,7,7,109.58257,18.28458,1815
17272,133009,58DE8A719D3ADBEDAE163213845B460A,30854,8,11,3,109.56889,18.27076,1763
17273,133010,58DE8A719D3ADBEDAE163213845B460A,31071,12,23,11,109.58257,18.28458,1815
17297,133217,2F440A235E684ECEDD042B3100A4AE95,31071,0,7,7,109.58257,18.28458,1815
17298,133218,2F440A235E684ECEDD042B3100A4AE95,30101,9,10,1,109.57299,18.33333,1773
17299,133219,2F440A235E684ECEDD042B3100A4AE95,30854,13,18,5,109.56889,18.27076,1763
17300,133220,2F440A235E684ECEDD042B3100A4AE95,31071,18,23,5,109.58257,18.28458,1815
17301,133281,5EBEA276FCB4A19AC5C987F5C7CC8908,60472,2,7,5,109.46625,18.29542,1367
17302,133282,5EBEA276FCB4A19AC5C987F5C7CC8908,60401,10,12,2,109.47444,18.27583,1414
17303,133283,5EBEA276FCB4A19AC5C987F5C7CC8908,38361,12,15,3,109.43667,18.29201,1267
17304,133284,5EBEA276FCB4A19AC5C987F5C7CC8908,60552,18,21,3,109.41729,18.30014,1218
17310,133311,7B1A07C39637E996C01DF0A3D287D3C6,30854,3,13,10,109.56889,18.27076,1763
17311,133312,7B1A07C39637E996C01DF0A3D287D3C6,31071,14,16,2,109.58257,18.28458,1815
17312,133313,7B1A07C39637E996C01DF0A3D287D3C6,30854,16,21,5,109.56889,18.27076,1763
17316,133333,DB4DF566D4757FF3BB488F82DE126248,31561,0,16,16,109.56792,18.28479,1765
17317,133334,DB4DF566D4757FF3BB488F82DE126248,30851,16,18,2,109.5616,18.27396,1713
17318,133335,DB4DF566D4757FF3BB488F82DE126248,31561,19,22,3,109.56792,18.28479,1765
17322,133381,2683DB6FF8EE2860DFC386D0B7C69394,38991,0,6,6,109.52681,18.30368,1618
17323,133382,2683DB6FF8EE2860DFC386D0B7C69394,31931,9,15,6,109.54771,18.29403,1667
17324,133383,2683DB6FF8EE2860DFC386D0B7C69394,60371,20,22,2,109.53063,18.30056,1618
17329,133520,18EEDE3CAC40E34C9E86FDF8437ADA92,31391,0,7,7,109.50382,18.24285,1508
17330,133521,18EEDE3CAC40E34C9E86FDF8437ADA92,31201,7,10,3,109.51042,18.23819,1558
17331,133522,18EEDE3CAC40E34C9E86FDF8437ADA92,30181,10,18,8,109.51597,18.23313,1557
17332,133523,18EEDE3CAC40E34C9E86FDF8437ADA92,30181,19,23,4,109.51597,18.23313,1557
17339,133720,6B806948BC9187A91D033B4096721B00,31561,0,3,3,109.56792,18.28479,1765
17340,133721,6B806948BC9187A91D033B4096721B00,30854,5,7,2,109.56889,18.27076,1763
17341,133722,6B806948BC9187A91D033B4096721B00,31071,8,18,10,109.58257,18.28458,1815
17342,133723,6B806948BC9187A91D033B4096721B00,31561,20,21,1,109.56792,18.28479,1765
17352,133815,C608AF81E00885FA602816017BA139C9,30854,0,4,4,109.56889,18.27076,1763
17353,133816,C608AF81E00885FA602816017BA139C9,30891,7,16,9,109.59431,18.28389,1865
17354,133817,C608AF81E00885FA602816017BA139C9,39371,17,18,1,109.56627,18.2646,1762
17355,133818,C608AF81E00885FA602816017BA139C9,30854,22,23,1,109.56889,18.27076,1763
17361,134014,EF0AF6DFF11E792E87881ED5E6F91398,38154,0,5,5,109.5266,18.28278,1615
17362,134015,EF0AF6DFF11E792E87881ED5E6F91398,30851,9,11,2,109.5616,18.27396,1713
17363,134016,EF0AF6DFF11E792E87881ED5E6F91398,39183,12,18,6,109.55542,18.28208,1715
17364,134017,EF0AF6DFF11E792E87881ED5E6F91398,30721,20,22,2,109.51597,18.28257,1565
17372,134083,AE549D1F82210589834DD25B264622B0,31864,1,10,9,109.49014,18.28333,1465
17373,134084,AE549D1F82210589834DD25B264622B0,60281,13,14,1,109.51743,18.25924,1561
17374,134085,AE549D1F82210589834DD25B264622B0,31534,15,17,2,109.49368,18.25806,1461
17378,134127,EFDE35289FEC1E13D6F34EFEE66A8AD2,60631,0,7,7,109.57778,18.27583,1814
17379,134128,EFDE35289FEC1E13D6F34EFEE66A8AD2,31071,11,12,1,109.58257,18.28458,1815
17380,134129,EFDE35289FEC1E13D6F34EFEE66A8AD2,30854,15,16,1,109.56889,18.27076,1763
17381,134130,EFDE35289FEC1E13D6F34EFEE66A8AD2,60631,17,23,6,109.57778,18.27583,1814
17419,134419,C709D01469E0800AF998DFAF42105CDC,60631,0,1,1,109.57778,18.27583,1814
17420,134420,C709D01469E0800AF998DFAF42105CDC,31561,5,16,11,109.56792,18.28479,1765
17421,134421,C709D01469E0800AF998DFAF42105CDC,30854,19,23,4,109.56889,18.27076,1763
17429,134456,451E2BF48CD7B253EB0892324E679BCC,38297,0,5,5,109.52576,18.24965,1609
17430,134457,451E2BF48CD7B253EB0892324E679BCC,60281,7,18,11,109.51743,18.25924,1561
17431,134458,451E2BF48CD7B253EB0892324E679BCC,38291,20,22,2,109.51618,18.24313,1558
17432,134476,A1751D2F2B129C8CC66D88935FEF0CD4,30891,0,8,8,109.59431,18.28389,1865
17433,134477,A1751D2F2B129C8CC66D88935FEF0CD4,30854,10,14,4,109.56889,18.27076,1763
17434,134478,A1751D2F2B129C8CC66D88935FEF0CD4,30891,14,15,1,109.59431,18.28389,1865
17435,134479,A1751D2F2B129C8CC66D88935FEF0CD4,30854,16,21,5,109.56889,18.27076,1763
17439,134483,8A0382A2385C362EFE2664E8795F133E,39183,0,3,3,109.55542,18.28208,1715
17440,134484,8A0382A2385C362EFE2664E8795F133E,31561,3,5,2,109.56792,18.28479,1765
17441,134485,8A0382A2385C362EFE2664E8795F133E,39183,7,16,9,109.55542,18.28208,1715
17442,134486,8A0382A2385C362EFE2664E8795F133E,31561,21,23,2,109.56792,18.28479,1765
17443,134519,8883DF5E66B5FC284A8EF97DE8EAAAB3,30854,0,2,2,109.56889,18.27076,1763
17444,134520,8883DF5E66B5FC284A8EF97DE8EAAAB3,60631,3,4,1,109.57778,18.27583,1814
17445,134521,8883DF5E66B5FC284A8EF97DE8EAAAB3,30854,5,6,1,109.56889,18.27076,1763
17465,134699,F6A1EBB84FE583E84185C423218578F5,31561,0,5,5,109.56792,18.28479,1765
17466,134700,F6A1EBB84FE583E84185C423218578F5,30854,7,8,1,109.56889,18.27076,1763
17467,134701,F6A1EBB84FE583E84185C423218578F5,31561,10,23,13,109.56792,18.28479,1765
17495,135098,B0D7DAF8D84656FF4C7229ABB8EA1350,31561,0,9,9,109.56792,18.28479,1765
17496,135099,B0D7DAF8D84656FF4C7229ABB8EA1350,31071,11,14,3,109.58257,18.28458,1815
17497,135100,B0D7DAF8D84656FF4C7229ABB8EA1350,30854,15,21,6,109.56889,18.27076,1763
17498,135101,B0D7DAF8D84656FF4C7229ABB8EA1350,31561,21,22,1,109.56792,18.28479,1765
17504,135153,63FBAC0202144B00077561285E6A7F87,30821,0,6,6,109.43681,18.33639,1274
17505,135154,63FBAC0202144B00077561285E6A7F87,30651,7,8,1,109.42611,18.385,1232
17506,135155,63FBAC0202144B00077561285E6A7F87,30821,8,22,14,109.43681,18.33639,1274
17516,135297,7D632B68A96EBB9D6582527232D6634C,31461,0,9,9,109.5091,18.25389,1510
17517,135298,7D632B68A96EBB9D6582527232D6634C,30081,11,12,1,109.50243,18.26632,1512
17518,135299,7D632B68A96EBB9D6582527232D6634C,30421,14,15,1,109.50021,18.25861,1511
17522,135399,B78E7295CB13532B4E2C30EF158E297F,39183,0,12,12,109.55542,18.28208,1715
17523,135400,B78E7295CB13532B4E2C30EF158E297F,31561,17,18,1,109.56792,18.28479,1765
17524,135401,B78E7295CB13532B4E2C30EF158E297F,39183,20,21,1,109.55542,18.28208,1715
17535,135443,64EA917EAAD3EB55DA2ABB227203C131,60631,0,7,7,109.57778,18.27583,1814
17536,135444,64EA917EAAD3EB55DA2ABB227203C131,31071,8,9,1,109.58257,18.28458,1815
17537,135445,64EA917EAAD3EB55DA2ABB227203C131,60631,14,22,8,109.57778,18.27583,1814
17557,135696,A549C024E6F63EDBD3DC866F10DB11CE,31071,0,4,4,109.58257,18.28458,1815
17558,135697,A549C024E6F63EDBD3DC866F10DB11CE,30854,8,19,11,109.56889,18.27076,1763
17559,135698,A549C024E6F63EDBD3DC866F10DB11CE,31071,19,21,2,109.58257,18.28458,1815
17567,135790,695007B4E6ED5E35BFB785EA24AE0E83,30921,0,17,17,109.53903,18.29451,1667
17568,135791,695007B4E6ED5E35BFB785EA24AE0E83,31931,18,19,1,109.54771,18.29403,1667
17569,135792,695007B4E6ED5E35BFB785EA24AE0E83,30921,21,22,1,109.53903,18.29451,1667
17570,135793,560794A44CA17A43FA34D0FA6C339747,30854,0,1,1,109.56889,18.27076,1763
17571,135794,560794A44CA17A43FA34D0FA6C339747,31071,4,5,1,109.58257,18.28458,1815
17572,135795,560794A44CA17A43FA34D0FA6C339747,30854,5,7,2,109.56889,18.27076,1763
17583,135886,D75F3D28EEDDC3AAB22F587F99A79102,30851,0,2,2,109.5616,18.27396,1713
17584,135887,D75F3D28EEDDC3AAB22F587F99A79102,30854,2,8,6,109.56889,18.27076,1763
17585,135888,D75F3D28EEDDC3AAB22F587F99A79102,31071,9,10,1,109.58257,18.28458,1815
17586,135897,10EBF762D28520B09848288F7052CFDE,30854,0,5,5,109.56889,18.27076,1763
17587,135898,10EBF762D28520B09848288F7052CFDE,39101,7,17,10,109.50132,18.24931,1509
17588,135899,10EBF762D28520B09848288F7052CFDE,30854,18,20,2,109.56889,18.27076,1763
17593,135948,9856C1F2599E76C49A61F2B51C803266,38951,0,11,11,109.48097,18.28868,1416
17594,135949,9856C1F2599E76C49A61F2B51C803266,31031,11,13,2,109.49979,18.25382,1510
17595,135950,9856C1F2599E76C49A61F2B51C803266,31031,13,16,3,109.49979,18.25382,1510
17596,135951,9856C1F2599E76C49A61F2B51C803266,38951,17,20,3,109.48097,18.28868,1416
17605,135987,487FC583F0AF1414583ADA3127598053,60631,1,6,5,109.57778,18.27583,1814
17606,135988,487FC583F0AF1414583ADA3127598053,30854,10,11,1,109.56889,18.27076,1763
17607,135989,487FC583F0AF1414583ADA3127598053,31071,12,14,2,109.58257,18.28458,1815
17608,136000,5E6F81A7DA23F57413C15AC7514275E5,31945,1,7,6,109.58021,18.29403,1817
17609,136001,5E6F81A7DA23F57413C15AC7514275E5,31071,7,13,6,109.58257,18.28458,1815
17610,136002,5E6F81A7DA23F57413C15AC7514275E5,31945,15,18,3,109.58021,18.29403,1817
17611,136003,5E6F81A7DA23F57413C15AC7514275E5,31561,18,21,3,109.56792,18.28479,1765
17632,136122,D947329382FD9474122243533197BA56,60501,0,10,10,109.48701,18.29021,1466
17633,136123,D947329382FD9474122243533197BA56,39154,12,14,2,109.50201,18.25681,1511
17634,136125,D947329382FD9474122243533197BA56,39154,21,23,2,109.50201,18.25681,1511
17649,136236,26EBB7631BF09CB3B33D334FA74CC499,39111,0,6,6,109.5191,18.22597,1555
17650,136237,26EBB7631BF09CB3B33D334FA74CC499,30711,6,13,7,109.50271,18.25347,1510
17651,136238,26EBB7631BF09CB3B33D334FA74CC499,31521,16,18,2,109.51458,18.22542,1555
17652,136239,26EBB7631BF09CB3B33D334FA74CC499,31521,19,23,4,109.51458,18.22542,1555
17655,136274,0F558B6653C655C7F0BAEA9D66B33F57,30721,0,1,1,109.51597,18.28257,1565
17656,136275,0F558B6653C655C7F0BAEA9D66B33F57,31071,2,7,5,109.58257,18.28458,1815
17657,136276,0F558B6653C655C7F0BAEA9D66B33F57,30854,8,20,12,109.56889,18.27076,1763
17663,136316,A01B4012B619D942E7CC3AC9B78722B4,31561,0,1,1,109.56792,18.28479,1765
17664,136317,A01B4012B619D942E7CC3AC9B78722B4,39181,4,5,1,109.55153,18.28035,1715
17665,136318,A01B4012B619D942E7CC3AC9B78722B4,31561,9,23,14,109.56792,18.28479,1765
17668,136346,C153552CEA2677B0FF473AE565EA979E,30821,0,12,12,109.43681,18.33639,1274
17669,136347,C153552CEA2677B0FF473AE565EA979E,30651,12,13,1,109.42611,18.385,1232
17670,136348,C153552CEA2677B0FF473AE565EA979E,30821,13,19,6,109.43681,18.33639,1274
17686,136444,AD6CE74FEECB42F7806A62DA7A4CECCA,30851,0,1,1,109.5616,18.27396,1713
17687,136445,AD6CE74FEECB42F7806A62DA7A4CECCA,30854,2,6,4,109.56889,18.27076,1763
17688,136446,AD6CE74FEECB42F7806A62DA7A4CECCA,30851,7,9,2,109.5616,18.27396,1713
17711,136917,2A6BA0678DDF16AF08BAC9E3FA3C9391,31561,0,1,1,109.56792,18.28479,1765
17712,136918,2A6BA0678DDF16AF08BAC9E3FA3C9391,30854,3,19,16,109.56889,18.27076,1763
17713,136919,2A6BA0678DDF16AF08BAC9E3FA3C9391,31561,21,23,2,109.56792,18.28479,1765
17723,136976,178271E30A0C49B9F554254AB4E98C73,31391,2,4,2,109.50382,18.24285,1508
17724,136977,178271E30A0C49B9F554254AB4E98C73,31181,5,6,1,109.50382,18.24813,1509
17725,136978,178271E30A0C49B9F554254AB4E98C73,31391,7,8,1,109.50382,18.24285,1508
17726,136985,75817DB682187A07461734D66E1E6492,60631,0,4,4,109.57778,18.27583,1814
17727,136986,75817DB682187A07461734D66E1E6492,30854,8,18,10,109.56889,18.27076,1763
17728,136987,75817DB682187A07461734D66E1E6492,60631,18,23,5,109.57778,18.27583,1814
17733,137098,A249BB92E18839D454C438B797D69714,38291,0,16,16,109.51618,18.24313,1558
17734,137099,A249BB92E18839D454C438B797D69714,38891,19,21,2,109.51486,18.24118,1558
17735,137100,A249BB92E18839D454C438B797D69714,38291,21,23,2,109.51618,18.24313,1558
17748,137132,53875E69050EC42E511A64D3211FA7B3,31071,2,6,4,109.58257,18.28458,1815
17749,137133,53875E69050EC42E511A64D3211FA7B3,30854,8,9,1,109.56889,18.27076,1763
17750,137134,53875E69050EC42E511A64D3211FA7B3,30851,12,13,1,109.5616,18.27396,1713
17753,137165,95E09A72760B2799C2CC9BD7AF527107,31071,0,12,12,109.58257,18.28458,1815
17754,137166,95E09A72760B2799C2CC9BD7AF527107,30854,14,18,4,109.56889,18.27076,1763
17755,137167,95E09A72760B2799C2CC9BD7AF527107,31071,19,20,1,109.58257,18.28458,1815
17756,137168,95E09A72760B2799C2CC9BD7AF527107,30854,20,21,1,109.56889,18.27076,1763
17757,137177,C99018C5FE7BE36145E83B623599A9D0,31521,0,7,7,109.51458,18.22542,1555
17758,137178,C99018C5FE7BE36145E83B623599A9D0,31521,7,9,2,109.51458,18.22542,1555
17759,137179,C99018C5FE7BE36145E83B623599A9D0,31521,10,23,13,109.51458,18.22542,1555
17775,137267,E6541B4F346982101D887BAAF0315541,30854,1,6,5,109.56889,18.27076,1763
17776,137268,E6541B4F346982101D887BAAF0315541,31561,9,10,1,109.56792,18.28479,1765
17777,137269,E6541B4F346982101D887BAAF0315541,30854,12,23,11,109.56889,18.27076,1763
17796,137547,4995463B780282C9C030A19D9F49AEAC,30721,0,1,1,109.51597,18.28257,1565
17797,137548,4995463B780282C9C030A19D9F49AEAC,31071,2,5,3,109.58257,18.28458,1815
17798,137549,4995463B780282C9C030A19D9F49AEAC,30854,8,12,4,109.56889,18.27076,1763
17799,137550,4995463B780282C9C030A19D9F49AEAC,31171,15,23,8,109.50938,18.24917,1559
17815,137674,B340EDEF4A878E8DF5CBEC25E465EACE,31071,1,3,2,109.58257,18.28458,1815
17816,137675,B340EDEF4A878E8DF5CBEC25E465EACE,30854,5,7,2,109.56889,18.27076,1763
17817,137676,B340EDEF4A878E8DF5CBEC25E465EACE,31071,7,8,1,109.58257,18.28458,1815
17818,137677,B340EDEF4A878E8DF5CBEC25E465EACE,30854,8,23,15,109.56889,18.27076,1763
17831,137773,B32E0C141A5BC7BD81AEFEA867DBF2BA,30854,0,3,3,109.56889,18.27076,1763
17832,137774,B32E0C141A5BC7BD81AEFEA867DBF2BA,39371,4,5,1,109.56627,18.2646,1762
17833,137775,B32E0C141A5BC7BD81AEFEA867DBF2BA,30854,6,22,16,109.56889,18.27076,1763
17849,137810,552B98A65A23DB4CD390E78F3246E9C5,30071,0,6,6,109.52819,18.30472,1619
17850,137811,552B98A65A23DB4CD390E78F3246E9C5,31931,9,19,10,109.54771,18.29403,1667
17851,137812,552B98A65A23DB4CD390E78F3246E9C5,30921,20,23,3,109.53903,18.29451,1667
17876,138001,C1F9914EF577AE2A8300B1A3945A50FF,30851,0,7,7,109.5616,18.27396,1713
17877,138002,C1F9914EF577AE2A8300B1A3945A50FF,31561,7,8,1,109.56792,18.28479,1765
17878,138003,C1F9914EF577AE2A8300B1A3945A50FF,30851,11,12,1,109.5616,18.27396,1713
17882,138052,3BB007FDF28DB0E7E883BA594F721FFE,31181,0,6,6,109.50382,18.24813,1509
17883,138053,3BB007FDF28DB0E7E883BA594F721FFE,31181,7,8,1,109.50382,18.24813,1509
17884,138054,3BB007FDF28DB0E7E883BA594F721FFE,31181,9,22,13,109.50382,18.24813,1509
17922,138608,2576A40187A845D7B849E820F16B3DB1,30854,2,8,6,109.56889,18.27076,1763
17923,138609,2576A40187A845D7B849E820F16B3DB1,31561,10,19,9,109.56792,18.28479,1765
17924,138610,2576A40187A845D7B849E820F16B3DB1,30854,19,23,4,109.56889,18.27076,1763
17932,138791,5274FB91D917823AD6AE120EE7F21099,31931,0,5,5,109.54771,18.29403,1667
17933,138792,5274FB91D917823AD6AE120EE7F21099,60361,8,12,4,109.51938,18.29681,1567
17934,138793,5274FB91D917823AD6AE120EE7F21099,31931,14,18,4,109.54771,18.29403,1667
17937,138817,47A18820FDA9856131F74091D44B6BCB,31071,0,6,6,109.58257,18.28458,1815
17938,138818,47A18820FDA9856131F74091D44B6BCB,30851,8,12,4,109.5616,18.27396,1713
17939,138819,47A18820FDA9856131F74091D44B6BCB,31561,15,17,2,109.56792,18.28479,1765
17953,138919,2D913891935203F66178BF4BFC3F9DA5,60641,0,11,11,109.53854,18.2359,1657
17954,138921,2D913891935203F66178BF4BFC3F9DA5,30461,19,21,2,109.5116,18.26313,1562
17955,138922,2D913891935203F66178BF4BFC3F9DA5,30461,22,23,1,109.5116,18.26313,1562
17972,139050,A94F66C88B84FF0658441320CD9F667C,30854,0,13,13,109.56889,18.27076,1763
17973,139051,A94F66C88B84FF0658441320CD9F667C,31071,15,16,1,109.58257,18.28458,1815
17974,139052,A94F66C88B84FF0658441320CD9F667C,30854,17,20,3,109.56889,18.27076,1763
17977,139111,8CE55AC8BC984D52D16D6CE4872EB6FC,30511,0,5,5,109.51069,18.24208,1558
17978,139112,8CE55AC8BC984D52D16D6CE4872EB6FC,30161,7,11,4,109.50042,18.24389,1508
17979,139113,8CE55AC8BC984D52D16D6CE4872EB6FC,31031,12,13,1,109.49979,18.25382,1510
17980,139180,663CE56232D73D50E42DEC41EA33269F,31931,0,1,1,109.54771,18.29403,1667
17981,139181,663CE56232D73D50E42DEC41EA33269F,30921,4,9,5,109.53903,18.29451,1667
17982,139182,663CE56232D73D50E42DEC41EA33269F,31931,13,20,7,109.54771,18.29403,1667
17999,139289,335A7B1DE8538918FDA774EE3E402A76,30191,0,7,7,109.50361,18.22701,1506
18000,139290,335A7B1DE8538918FDA774EE3E402A76,60381,8,12,4,109.5241,18.22458,1605
18001,139291,335A7B1DE8538918FDA774EE3E402A76,30191,13,23,10,109.50361,18.22701,1506
18021,139393,B93185B4820D7E0DEE74EBEA00941D15,60201,0,2,2,109.5041,18.2509,1510
18022,139394,B93185B4820D7E0DEE74EBEA00941D15,30911,2,9,7,109.50493,18.26181,1511
18023,139395,B93185B4820D7E0DEE74EBEA00941D15,60201,12,20,8,109.5041,18.2509,1510
18024,139396,B93185B4820D7E0DEE74EBEA00941D15,30911,20,22,2,109.50493,18.26181,1511
18033,139495,6F590AF2C10C4B9F0F4E76B8E922550E,31945,1,15,14,109.58021,18.29403,1817
18034,139496,6F590AF2C10C4B9F0F4E76B8E922550E,31071,15,17,2,109.58257,18.28458,1815
18035,139497,6F590AF2C10C4B9F0F4E76B8E922550E,31945,20,23,3,109.58021,18.29403,1817
18052,139622,3A4E228E5E71900953BAD30C430563D8,60371,0,6,6,109.53063,18.30056,1618
18053,139623,3A4E228E5E71900953BAD30C430563D8,31945,10,11,1,109.58021,18.29403,1817
18054,139624,3A4E228E5E71900953BAD30C430563D8,60371,13,22,9,109.53063,18.30056,1618
18064,139792,DBB710D279E76C79F1E4B0766F579F8A,30441,2,3,1,109.64021,18.25424,2010
18065,139793,DBB710D279E76C79F1E4B0766F579F8A,31071,4,6,2,109.58257,18.28458,1815
18066,139794,DBB710D279E76C79F1E4B0766F579F8A,30854,10,15,5,109.56889,18.27076,1763
18067,139816,CCCD2290FB632A48009771412BE68ADD,31561,0,13,13,109.56792,18.28479,1765
18068,139817,CCCD2290FB632A48009771412BE68ADD,39183,14,18,4,109.55542,18.28208,1715
18069,139818,CCCD2290FB632A48009771412BE68ADD,31561,19,22,3,109.56792,18.28479,1765
18091,139996,3C5AEA306E8A69C707195C4150E77D90,60371,0,6,6,109.53063,18.30056,1618
18092,139997,3C5AEA306E8A69C707195C4150E77D90,39181,7,11,4,109.55153,18.28035,1715
18093,139998,3C5AEA306E8A69C707195C4150E77D90,31931,11,19,8,109.54771,18.29403,1667
18094,139999,3C5AEA306E8A69C707195C4150E77D90,39181,22,23,1,109.55153,18.28035,1715
18095,140032,EF24901D99384F703B20FE07F2784FA0,30101,0,4,4,109.57299,18.33333,1773
18096,140033,EF24901D99384F703B20FE07F2784FA0,31631,5,9,4,109.59542,18.36826,1879
18097,140034,EF24901D99384F703B20FE07F2784FA0,30101,13,16,3,109.57299,18.33333,1773
18098,140035,EF24901D99384F703B20FE07F2784FA0,31631,16,18,2,109.59542,18.36826,1879
18103,140059,E5E2DA460104E389257158E8D8C9FBDA,60281,0,5,5,109.51743,18.25924,1561
18104,140060,E5E2DA460104E389257158E8D8C9FBDA,31261,6,11,5,109.51174,18.2466,1559
18105,140061,E5E2DA460104E389257158E8D8C9FBDA,60281,15,23,8,109.51743,18.25924,1561
18114,140165,F9B937F9F26C2F09039C158F4674A0AD,30711,0,13,13,109.50271,18.25347,1510
18115,140166,F9B937F9F26C2F09039C158F4674A0AD,30711,13,21,8,109.50271,18.25347,1510
18116,140167,F9B937F9F26C2F09039C158F4674A0AD,60291,21,23,2,109.50826,18.24639,1509
18129,140301,51061B3DE820AF1C1C713EF684728003,30854,0,5,5,109.56889,18.27076,1763
18130,140302,51061B3DE820AF1C1C713EF684728003,31071,7,11,4,109.58257,18.28458,1815
18131,140303,51061B3DE820AF1C1C713EF684728003,30854,13,23,10,109.56889,18.27076,1763
18132,140307,A8E9C7BB918ADAD29A3EA7ACDDCD32D7,38951,0,12,12,109.48097,18.28868,1416
18133,140308,A8E9C7BB918ADAD29A3EA7ACDDCD32D7,30711,13,17,4,109.50271,18.25347,1510
18134,140309,A8E9C7BB918ADAD29A3EA7ACDDCD32D7,38951,18,22,4,109.48097,18.28868,1416
18135,140314,012ABD06F231728C214A4BA917E75B1C,31561,3,7,4,109.56792,18.28479,1765
18136,140315,012ABD06F231728C214A4BA917E75B1C,30851,9,22,13,109.5616,18.27396,1713
18137,140316,012ABD06F231728C214A4BA917E75B1C,31561,22,23,1,109.56792,18.28479,1765
18148,140483,43E035AE85036EBD9891453E9567CB81,30151,0,7,7,109.50986,18.25083,1560
18149,140484,43E035AE85036EBD9891453E9567CB81,60221,7,9,2,109.52569,18.29188,1616
18150,140485,43E035AE85036EBD9891453E9567CB81,30151,12,14,2,109.50986,18.25083,1560
18157,140570,8752BC71725B50257436D50C6598F252,31071,2,6,4,109.58257,18.28458,1815
18158,140571,8752BC71725B50257436D50C6598F252,30854,7,12,5,109.56889,18.27076,1763
18159,140572,8752BC71725B50257436D50C6598F252,31071,12,13,1,109.58257,18.28458,1815
18160,140573,8752BC71725B50257436D50C6598F252,30854,17,22,5,109.56889,18.27076,1763
18180,140781,CCBE9BD27BE45DF1D524AAA2624A3639,38121,0,7,7,109.51361,18.27813,1564
18181,140782,CCBE9BD27BE45DF1D524AAA2624A3639,31951,9,12,3,109.52174,18.30299,1568
18182,140783,CCBE9BD27BE45DF1D524AAA2624A3639,30324,13,14,1,109.50326,18.29257,1517
18223,141304,C8922FAF66F21ECAECB6B717FCD5A53B,60614,0,7,7,109.48799,18.29521,1467
18224,141305,C8922FAF66F21ECAECB6B717FCD5A53B,60391,9,11,2,109.47667,18.28757,1416
18225,141306,C8922FAF66F21ECAECB6B717FCD5A53B,60614,12,23,11,109.48799,18.29521,1467
18229,141310,3A06664B5E8646E5D468635B6C6056D9,60641,0,7,7,109.53854,18.2359,1657
18230,141311,3A06664B5E8646E5D468635B6C6056D9,31041,9,11,2,109.50278,18.23701,1507
18231,141312,3A06664B5E8646E5D468635B6C6056D9,60641,13,14,1,109.53854,18.2359,1657
18232,141322,9E8746086915F9D4A063A74CF0B5B7AB,31561,1,2,1,109.56792,18.28479,1765
18233,141323,9E8746086915F9D4A063A74CF0B5B7AB,30851,3,5,2,109.5616,18.27396,1713
18234,141324,9E8746086915F9D4A063A74CF0B5B7AB,31561,6,20,14,109.56792,18.28479,1765
18250,141461,8C37E67F8CE10233D1BCF73CC89419C9,60371,0,2,2,109.53063,18.30056,1618
18251,141462,8C37E67F8CE10233D1BCF73CC89419C9,60361,2,4,2,109.51938,18.29681,1567
18252,141463,8C37E67F8CE10233D1BCF73CC89419C9,60371,4,5,1,109.53063,18.30056,1618
18253,141478,E9E473F09C342630187345312F4A31D8,39181,0,8,8,109.55153,18.28035,1715
18254,141479,E9E473F09C342630187345312F4A31D8,39181,10,15,5,109.55153,18.28035,1715
18255,141480,E9E473F09C342630187345312F4A31D8,39181,16,18,2,109.55153,18.28035,1715
18260,141533,00FC332040A284DA251A8D0705989FE9,31071,0,7,7,109.58257,18.28458,1815
18261,141534,00FC332040A284DA251A8D0705989FE9,30854,9,10,1,109.56889,18.27076,1763
18262,141535,00FC332040A284DA251A8D0705989FE9,31071,12,13,1,109.58257,18.28458,1815
18263,141536,00FC332040A284DA251A8D0705989FE9,30854,15,20,5,109.56889,18.27076,1763
18264,141613,2AE38FAF341950B0B91404FFCE5A0F3E,39183,0,1,1,109.55542,18.28208,1715
18265,141614,2AE38FAF341950B0B91404FFCE5A0F3E,31931,3,4,1,109.54771,18.29403,1667
18266,141615,2AE38FAF341950B0B91404FFCE5A0F3E,30921,7,18,11,109.53903,18.29451,1667
18267,141616,2AE38FAF341950B0B91404FFCE5A0F3E,31931,21,23,2,109.54771,18.29403,1667
18268,141631,39F25FE146A03325C93C111F2A943B6C,31945,0,14,14,109.58021,18.29403,1817
18269,141632,39F25FE146A03325C93C111F2A943B6C,31071,14,16,2,109.58257,18.28458,1815
18270,141633,39F25FE146A03325C93C111F2A943B6C,30854,19,21,2,109.56889,18.27076,1763
18276,141716,A29628211427A99C58B8892C5311895B,60661,0,7,7,109.548,18.2377,1657
18277,141717,A29628211427A99C58B8892C5311895B,31461,8,17,9,109.5091,18.25389,1510
18278,141718,A29628211427A99C58B8892C5311895B,60661,19,23,4,109.548,18.2377,1657
18279,141719,3430E8CEDCC22A1F95C5B7D0C18C0DE6,38911,3,7,4,109.51674,18.24965,1559
18280,141720,3430E8CEDCC22A1F95C5B7D0C18C0DE6,30051,10,17,7,109.48917,18.21215,1453
18281,141721,3430E8CEDCC22A1F95C5B7D0C18C0DE6,30084,19,21,2,109.50118,18.26972,1513
18282,141722,3430E8CEDCC22A1F95C5B7D0C18C0DE6,31261,21,22,1,109.51174,18.2466,1559
18285,141829,EC4B90EDBF35256FDB4D4F8B87DB8A04,31071,0,7,7,109.58257,18.28458,1815
18286,141830,EC4B90EDBF35256FDB4D4F8B87DB8A04,30854,11,12,1,109.56889,18.27076,1763
18287,141831,EC4B90EDBF35256FDB4D4F8B87DB8A04,31071,13,15,2,109.58257,18.28458,1815
18288,141832,EC4B90EDBF35256FDB4D4F8B87DB8A04,30854,17,20,3,109.56889,18.27076,1763
18289,141841,E0A24740E2C54F3B77DB561A91D2BED7,38911,1,4,3,109.51674,18.24965,1559
18290,141842,E0A24740E2C54F3B77DB561A91D2BED7,30151,6,15,9,109.50986,18.25083,1560
18291,141843,E0A24740E2C54F3B77DB561A91D2BED7,30151,15,23,8,109.50986,18.25083,1560
18312,142062,622234A65D292D040A9E438A2770674C,30851,0,7,7,109.5616,18.27396,1713
18313,142063,622234A65D292D040A9E438A2770674C,31561,7,9,2,109.56792,18.28479,1765
18314,142064,622234A65D292D040A9E438A2770674C,30851,12,23,11,109.5616,18.27396,1713
18317,142077,87ACF3C6ADE430D2B9DFB3C954E0C031,39183,0,12,12,109.55542,18.28208,1715
18318,142078,87ACF3C6ADE430D2B9DFB3C954E0C031,31071,12,15,3,109.58257,18.28458,1815
18319,142079,87ACF3C6ADE430D2B9DFB3C954E0C031,30854,15,23,8,109.56889,18.27076,1763
18337,142313,43935A511269713B543CB39B6901EBBD,60463,0,1,1,109.52507,18.22438,1605
18338,142314,43935A511269713B543CB39B6901EBBD,30711,1,12,11,109.50271,18.25347,1510
18339,142315,43935A511269713B543CB39B6901EBBD,30361,12,16,4,109.50347,18.24,1508
18359,142553,A041475A7C7BA79F49047DBAA4FC5EC4,30921,0,16,16,109.53903,18.29451,1667
18360,142554,A041475A7C7BA79F49047DBAA4FC5EC4,31931,20,21,1,109.54771,18.29403,1667
18361,142555,A041475A7C7BA79F49047DBAA4FC5EC4,30921,21,22,1,109.53903,18.29451,1667
18382,142694,FCFB14BA36BDB7CD6A39612B9AE933B2,38127,0,7,7,109.50833,18.27222,1513
18383,142695,FCFB14BA36BDB7CD6A39612B9AE933B2,31931,10,11,1,109.54771,18.29403,1667
18384,142696,FCFB14BA36BDB7CD6A39612B9AE933B2,39181,12,13,1,109.55153,18.28035,1715
18385,142697,DE91F768E6CCDB78867FF54F078574C9,30854,2,10,8,109.56889,18.27076,1763
18386,142698,DE91F768E6CCDB78867FF54F078574C9,30084,12,14,2,109.50118,18.26972,1513
18387,142699,DE91F768E6CCDB78867FF54F078574C9,30854,14,20,6,109.56889,18.27076,1763
18405,142977,86B0297E36D6ADB85661F97C0262CD46,39151,0,7,7,109.49875,18.25097,1510
18406,142978,86B0297E36D6ADB85661F97C0262CD46,38251,7,10,3,109.49618,18.25493,1510
18407,142979,86B0297E36D6ADB85661F97C0262CD46,30361,14,15,1,109.50347,18.24,1508
18408,143012,14F21534C21254001A38352AD4BB0EF6,30854,1,4,3,109.56889,18.27076,1763
18409,143013,14F21534C21254001A38352AD4BB0EF6,31071,8,15,7,109.58257,18.28458,1815
18410,143014,14F21534C21254001A38352AD4BB0EF6,30854,17,18,1,109.56889,18.27076,1763
18411,143020,73AB39A458E40C81DB636B20F7F8FD9B,31251,0,1,1,109.18528,18.2975,317
18412,143022,73AB39A458E40C81DB636B20F7F8FD9B,31251,11,16,5,109.18528,18.2975,317
18413,143024,73AB39A458E40C81DB636B20F7F8FD9B,31251,19,22,3,109.18528,18.2975,317
18434,143294,4B6FFEFB36770528DA20871CE9291F99,31521,3,13,10,109.51458,18.22542,1555
18435,143295,4B6FFEFB36770528DA20871CE9291F99,60381,13,14,1,109.5241,18.22458,1605
18436,143296,4B6FFEFB36770528DA20871CE9291F99,31521,15,21,6,109.51458,18.22542,1555
18440,143314,9EF6440DA421994ED152A57FAE59B45B,31261,0,7,7,109.51174,18.2466,1559
18441,143315,9EF6440DA421994ED152A57FAE59B45B,38911,12,17,5,109.51674,18.24965,1559
18442,143316,9EF6440DA421994ED152A57FAE59B45B,31821,19,23,4,109.51181,18.24924,1559
18452,143392,53807C5DF0C6352AACADAB2463D03770,38127,1,3,2,109.50833,18.27222,1513
18453,143393,53807C5DF0C6352AACADAB2463D03770,30251,3,6,3,109.50611,18.26653,1512
18454,143394,53807C5DF0C6352AACADAB2463D03770,38127,6,15,9,109.50833,18.27222,1513
18455,143395,53807C5DF0C6352AACADAB2463D03770,30191,18,21,3,109.50361,18.22701,1506
18475,143696,A83BF34FB3DF79FCF76C955C7C1B2AAC,60381,0,1,1,109.5241,18.22458,1605
18476,143697,A83BF34FB3DF79FCF76C955C7C1B2AAC,60661,2,15,13,109.548,18.2377,1657
18477,143698,A83BF34FB3DF79FCF76C955C7C1B2AAC,31061,18,19,1,109.53333,18.23257,1607
18489,143783,E4C7AB656E412C7E33554D18277C9478,60291,0,12,12,109.50826,18.24639,1509
18490,143784,E4C7AB656E412C7E33554D18277C9478,31461,17,18,1,109.5091,18.25389,1510
18491,143785,E4C7AB656E412C7E33554D18277C9478,30511,19,21,2,109.51069,18.24208,1558
18507,143978,59F29435D748531F416A4F1636997ECF,31071,0,5,5,109.58257,18.28458,1815
18508,143979,59F29435D748531F416A4F1636997ECF,60631,7,8,1,109.57778,18.27583,1814
18509,143980,59F29435D748531F416A4F1636997ECF,30854,9,23,14,109.56889,18.27076,1763
18510,143981,80330CDF40FA4F7E847EE63DBBD75A32,31061,0,8,8,109.53333,18.23257,1607
18511,143982,80330CDF40FA4F7E847EE63DBBD75A32,31521,9,17,8,109.51458,18.22542,1555
18512,143983,80330CDF40FA4F7E847EE63DBBD75A32,30361,18,19,1,109.50347,18.24,1508
18513,143984,80330CDF40FA4F7E847EE63DBBD75A32,31521,20,23,3,109.51458,18.22542,1555
18518,143999,68DBE0B52FD0AB95F1DD47068FD7847F,60311,0,14,14,109.52097,18.24319,1558
18519,144000,68DBE0B52FD0AB95F1DD47068FD7847F,31521,14,16,2,109.51458,18.22542,1555
18520,144001,68DBE0B52FD0AB95F1DD47068FD7847F,38291,17,19,2,109.51618,18.24313,1558
18521,144002,68DBE0B52FD0AB95F1DD47068FD7847F,60311,21,22,1,109.52097,18.24319,1558
18522,144008,A8ABE4987042D12DD458C81CFD9663F5,38127,0,5,5,109.50833,18.27222,1513
18523,144009,A8ABE4987042D12DD458C81CFD9663F5,30951,9,11,2,109.56208,18.25667,1761
18524,144010,A8ABE4987042D12DD458C81CFD9663F5,30771,12,14,2,109.49938,18.26042,1511
18525,144011,A8ABE4987042D12DD458C81CFD9663F5,30771,17,23,6,109.49938,18.26042,1511
18547,144112,DECB7B3FC95BFA8620EFD8D9DE328252,30854,1,5,4,109.56889,18.27076,1763
18548,144113,DECB7B3FC95BFA8620EFD8D9DE328252,31945,7,8,1,109.58021,18.29403,1817
18549,144114,DECB7B3FC95BFA8620EFD8D9DE328252,30854,12,13,1,109.56889,18.27076,1763
18560,144318,5403ECE41AD9921A5DEF63FF6DE6A9D1,30854,0,3,3,109.56889,18.27076,1763
18561,144319,5403ECE41AD9921A5DEF63FF6DE6A9D1,31071,3,4,1,109.58257,18.28458,1815
18562,144320,5403ECE41AD9921A5DEF63FF6DE6A9D1,30854,5,23,18,109.56889,18.27076,1763
18563,144363,7171A8398911756415ECFCDCF96F249B,30851,0,7,7,109.5616,18.27396,1713
18564,144364,7171A8398911756415ECFCDCF96F249B,30951,9,10,1,109.56208,18.25667,1761
18565,144365,7171A8398911756415ECFCDCF96F249B,30851,10,15,5,109.5616,18.27396,1713
18602,144688,875F4B80762D0E664890361D764F907D,60081,0,7,7,109.51097,18.22639,1556
18603,144689,875F4B80762D0E664890361D764F907D,30571,7,18,11,109.50243,18.21861,1504
18604,144690,875F4B80762D0E664890361D764F907D,60081,19,23,4,109.51097,18.22639,1556
18623,144900,887B4CB1328C20D61945E5BC833B406E,60371,0,2,2,109.53063,18.30056,1618
18624,144901,887B4CB1328C20D61945E5BC833B406E,38991,2,3,1,109.52681,18.30368,1618
18625,144902,887B4CB1328C20D61945E5BC833B406E,60371,5,8,3,109.53063,18.30056,1618
18626,144903,887B4CB1328C20D61945E5BC833B406E,30031,9,10,1,109.53681,18.33313,1673
18632,144936,8E244E94833DBF281BCBFE2F4A36E102,30581,1,6,5,109.62257,18.24951,1959
18633,144937,8E244E94833DBF281BCBFE2F4A36E102,60641,10,15,5,109.53854,18.2359,1657
18634,144938,8E244E94833DBF281BCBFE2F4A36E102,30151,19,20,1,109.50986,18.25083,1560
18645,145047,DFA412D9BD2157FFEE8B040EC4F14C2E,30931,1,4,3,109.55653,18.32722,1722
18646,145048,DFA412D9BD2157FFEE8B040EC4F14C2E,30701,6,15,9,109.59313,18.32007,1871
18647,145049,DFA412D9BD2157FFEE8B040EC4F14C2E,31811,18,23,5,109.54201,18.31806,1671
18653,145144,D5F7EFA0DFDB55DFCF47173578729EA6,30581,1,2,1,109.62257,18.24951,1959
18654,145145,D5F7EFA0DFDB55DFCF47173578729EA6,60214,2,9,7,109.63104,18.24493,2009
18655,145146,D5F7EFA0DFDB55DFCF47173578729EA6,30581,10,11,1,109.62257,18.24951,1959
18667,145213,BE7763F8096EB5A037146E1CC4190538,30854,0,2,2,109.56889,18.27076,1763
18668,145214,BE7763F8096EB5A037146E1CC4190538,31561,4,5,1,109.56792,18.28479,1765
18669,145215,BE7763F8096EB5A037146E1CC4190538,30324,8,14,6,109.50326,18.29257,1517
18670,145304,4D190727D19452A2A511EC780EEEE090,31931,0,12,12,109.54771,18.29403,1667
18671,145305,4D190727D19452A2A511EC780EEEE090,30921,12,14,2,109.53903,18.29451,1667
18672,145306,4D190727D19452A2A511EC780EEEE090,31931,14,23,9,109.54771,18.29403,1667
18681,145411,8F3DE08315D720DC64DC898C5903196E,30854,5,8,3,109.56889,18.27076,1763
18682,145412,8F3DE08315D720DC64DC898C5903196E,31071,12,13,1,109.58257,18.28458,1815
18683,145413,8F3DE08315D720DC64DC898C5903196E,30854,14,15,1,109.56889,18.27076,1763
18699,145620,C8A5539982743C3D86E28F8FF2DA3472,30951,0,10,10,109.56208,18.25667,1761
18700,145621,C8A5539982743C3D86E28F8FF2DA3472,31421,12,13,1,109.55382,18.22347,1705
18701,145622,C8A5539982743C3D86E28F8FF2DA3472,30951,14,22,8,109.56208,18.25667,1761
18710,145843,5EBEA276FCB4A19AC5C987F5C7CC8908,60504,0,9,9,109.47917,18.28903,1416
18711,145844,5EBEA276FCB4A19AC5C987F5C7CC8908,38361,10,16,6,109.43667,18.29201,1267
18712,145845,5EBEA276FCB4A19AC5C987F5C7CC8908,60504,17,18,1,109.47917,18.28903,1416
18713,145846,5EBEA276FCB4A19AC5C987F5C7CC8908,60401,20,23,3,109.47444,18.27583,1414
18714,145847,3B6FF1F8D896A0A62DC7E65967011999,31561,0,1,1,109.56792,18.28479,1765
18715,145848,3B6FF1F8D896A0A62DC7E65967011999,39183,5,14,9,109.55542,18.28208,1715
18716,145849,3B6FF1F8D896A0A62DC7E65967011999,31561,14,15,1,109.56792,18.28479,1765
18720,145869,DB4DF566D4757FF3BB488F82DE126248,31561,1,14,13,109.56792,18.28479,1765
18721,145870,DB4DF566D4757FF3BB488F82DE126248,30851,15,18,3,109.5616,18.27396,1713
18722,145871,DB4DF566D4757FF3BB488F82DE126248,31561,18,22,4,109.56792,18.28479,1765
18727,145915,1FC5887E4053936D3ED4D738338DC172,30121,0,7,7,109.52861,18.27222,1613
18728,145916,1FC5887E4053936D3ED4D738338DC172,30851,7,10,3,109.5616,18.27396,1713
18729,145917,1FC5887E4053936D3ED4D738338DC172,30951,10,17,7,109.56208,18.25667,1761
18746,146183,64F4CDF664AA04E7B79DE93C57128CF6,31931,0,6,6,109.54771,18.29403,1667
18747,146184,64F4CDF664AA04E7B79DE93C57128CF6,39181,8,10,2,109.55153,18.28035,1715
18748,146185,64F4CDF664AA04E7B79DE93C57128CF6,39183,12,17,5,109.55542,18.28208,1715
18749,146186,64F4CDF664AA04E7B79DE93C57128CF6,31931,19,20,1,109.54771,18.29403,1667
18750,146193,45CCFCD3EBDF941E1C92B70ED06E8B5E,30854,0,14,14,109.56889,18.27076,1763
18751,146194,45CCFCD3EBDF941E1C92B70ED06E8B5E,31561,16,18,2,109.56792,18.28479,1765
18752,146195,45CCFCD3EBDF941E1C92B70ED06E8B5E,30854,20,21,1,109.56889,18.27076,1763
18753,146231,6B806948BC9187A91D033B4096721B00,31561,4,7,3,109.56792,18.28479,1765
18754,146232,6B806948BC9187A91D033B4096721B00,31071,9,19,10,109.58257,18.28458,1815
18755,146233,6B806948BC9187A91D033B4096721B00,30854,20,22,2,109.56889,18.27076,1763
18756,146234,6B806948BC9187A91D033B4096721B00,31561,22,23,1,109.56792,18.28479,1765
18759,146369,E65658506C2BF9C993BA69EE6D38B3C6,31951,0,17,17,109.52174,18.30299,1568
18760,146370,E65658506C2BF9C993BA69EE6D38B3C6,60361,18,19,1,109.51938,18.29681,1567
18761,146371,E65658506C2BF9C993BA69EE6D38B3C6,31951,19,20,1,109.52174,18.30299,1568
18762,146372,E65658506C2BF9C993BA69EE6D38B3C6,31561,21,22,1,109.56792,18.28479,1765
18784,146562,6587551DA47309E484D1302521C8D417,60631,1,14,13,109.57778,18.27583,1814
18785,146563,6587551DA47309E484D1302521C8D417,30854,17,18,1,109.56889,18.27076,1763
18786,146564,6587551DA47309E484D1302521C8D417,60631,20,21,1,109.57778,18.27583,1814
18788,146616,EFDE35289FEC1E13D6F34EFEE66A8AD2,60631,0,15,15,109.57778,18.27583,1814
18789,146617,EFDE35289FEC1E13D6F34EFEE66A8AD2,30854,18,20,2,109.56889,18.27076,1763
18790,146618,EFDE35289FEC1E13D6F34EFEE66A8AD2,31071,21,22,1,109.58257,18.28458,1815
18795,146752,28B366167501D3E270BF1F5EDB4474EC,31071,2,7,5,109.58257,18.28458,1815
18796,146753,28B366167501D3E270BF1F5EDB4474EC,31561,8,18,10,109.56792,18.28479,1765
18797,146754,28B366167501D3E270BF1F5EDB4474EC,31071,19,21,2,109.58257,18.28458,1815
18802,146831,C709D01469E0800AF998DFAF42105CDC,30854,0,4,4,109.56889,18.27076,1763
18803,146832,C709D01469E0800AF998DFAF42105CDC,31561,5,19,14,109.56792,18.28479,1765
18804,146833,C709D01469E0800AF998DFAF42105CDC,30854,19,21,2,109.56889,18.27076,1763
18807,146862,173CD7A2B7B334BC53A50A1D248FBCFE,30854,1,5,4,109.56889,18.27076,1763
18808,146863,173CD7A2B7B334BC53A50A1D248FBCFE,31071,8,10,2,109.58257,18.28458,1815
18809,146864,173CD7A2B7B334BC53A50A1D248FBCFE,30854,15,19,4,109.56889,18.27076,1763
18820,146957,0E00D7E0174B24239144B08D52B998E8,31931,0,9,9,109.54771,18.29403,1667
18821,146958,0E00D7E0174B24239144B08D52B998E8,60371,10,11,1,109.53063,18.30056,1618
18822,146959,0E00D7E0174B24239144B08D52B998E8,31931,12,17,5,109.54771,18.29403,1667
18827,147030,C8B662CAEBDC359FAD2D68CB046F51F0,30681,0,15,15,109.48493,18.26917,1463
18828,147031,C8B662CAEBDC359FAD2D68CB046F51F0,60401,15,17,2,109.47444,18.27583,1414
18829,147032,C8B662CAEBDC359FAD2D68CB046F51F0,30171,17,20,3,109.48458,18.27139,1463
18830,147033,C8B662CAEBDC359FAD2D68CB046F51F0,30681,21,23,2,109.48493,18.26917,1463
18843,147117,283001ED673D8EDBEF7EEB00BDB31533,38017,0,2,2,109.49729,18.21424,1504
18844,147118,283001ED673D8EDBEF7EEB00BDB31533,30571,2,4,2,109.50243,18.21861,1504
18845,147119,283001ED673D8EDBEF7EEB00BDB31533,60201,7,9,2,109.5041,18.2509,1510
18847,147162,FD45DAD5A6F6BB711255CB29E453CFF1,30854,0,8,8,109.56889,18.27076,1763
18848,147163,FD45DAD5A6F6BB711255CB29E453CFF1,31071,8,9,1,109.58257,18.28458,1815
18849,147164,FD45DAD5A6F6BB711255CB29E453CFF1,39183,13,14,1,109.55542,18.28208,1715
18852,147195,CB1C8502149DACE0B32B2F7416279EF2,31071,0,7,7,109.58257,18.28458,1815
18853,147196,CB1C8502149DACE0B32B2F7416279EF2,30854,7,8,1,109.56889,18.27076,1763
18854,147197,CB1C8502149DACE0B32B2F7416279EF2,31071,12,14,2,109.58257,18.28458,1815
18855,147198,CB1C8502149DACE0B32B2F7416279EF2,30854,17,18,1,109.56889,18.27076,1763
18862,147258,40C57F24FE0409ABB752B2031C349577,38951,0,8,8,109.48097,18.28868,1416
18863,147259,40C57F24FE0409ABB752B2031C349577,39041,8,15,7,109.40021,18.29278,1117
18864,147260,40C57F24FE0409ABB752B2031C349577,38951,19,23,4,109.48097,18.28868,1416
18868,147335,1FE2866848043A2C10AD87212485FE15,31071,0,2,2,109.58257,18.28458,1815
18869,147336,1FE2866848043A2C10AD87212485FE15,30854,6,13,7,109.56889,18.27076,1763
18870,147337,1FE2866848043A2C10AD87212485FE15,31071,14,15,1,109.58257,18.28458,1815
18871,147338,1FE2866848043A2C10AD87212485FE15,30854,18,20,2,109.56889,18.27076,1763
18879,147438,0695D4E7B3E726CA09D841B87798B560,30854,3,7,4,109.56889,18.27076,1763
18880,147439,0695D4E7B3E726CA09D841B87798B560,31071,7,8,1,109.58257,18.28458,1815
18881,147440,0695D4E7B3E726CA09D841B87798B560,30854,10,21,11,109.56889,18.27076,1763
18882,147459,B712327B6033C61F37801CFD6DAC08AD,38484,4,5,1,109.53028,18.31528,1620
18883,147460,B712327B6033C61F37801CFD6DAC08AD,38484,7,17,10,109.53028,18.31528,1620
18884,147461,B712327B6033C61F37801CFD6DAC08AD,31951,18,19,1,109.52174,18.30299,1568
18885,147462,B712327B6033C61F37801CFD6DAC08AD,38484,19,23,4,109.53028,18.31528,1620
18888,147514,79AB721DDB2EAA1CD0308535004E6A67,31071,0,9,9,109.58257,18.28458,1815
18889,147515,79AB721DDB2EAA1CD0308535004E6A67,30854,11,13,2,109.56889,18.27076,1763
18890,147516,79AB721DDB2EAA1CD0308535004E6A67,31071,13,15,2,109.58257,18.28458,1815
18891,147517,79AB721DDB2EAA1CD0308535004E6A67,30854,16,18,2,109.56889,18.27076,1763
18892,147533,8EF00336DF81276A821E166696CFF524,30324,0,8,8,109.50326,18.29257,1517
18893,147534,8EF00336DF81276A821E166696CFF524,38903,12,17,5,109.39229,18.29243,1117
18894,147535,8EF00336DF81276A821E166696CFF524,38141,18,23,5,109.39479,18.2916,1116
18902,147639,7D632B68A96EBB9D6582527232D6634C,30911,0,8,8,109.50493,18.26181,1511
18903,147640,7D632B68A96EBB9D6582527232D6634C,30151,10,16,6,109.50986,18.25083,1560
18904,147641,7D632B68A96EBB9D6582527232D6634C,30721,18,20,2,109.51597,18.28257,1565
18905,147642,7D632B68A96EBB9D6582527232D6634C,31461,22,23,1,109.5091,18.25389,1510
18918,147776,F47C4E1E39056C43B0AD32AC994AB7C0,31931,0,13,13,109.54771,18.29403,1667
18919,147777,F47C4E1E39056C43B0AD32AC994AB7C0,60361,13,17,4,109.51938,18.29681,1567
18920,147778,F47C4E1E39056C43B0AD32AC994AB7C0,31931,19,23,4,109.54771,18.29403,1667
18921,147802,192815485DBBC485508837480A81E25C,31461,0,7,7,109.5091,18.25389,1510
18922,147803,192815485DBBC485508837480A81E25C,30151,11,15,4,109.50986,18.25083,1560
18923,147804,192815485DBBC485508837480A81E25C,30151,15,17,2,109.50986,18.25083,1560
18924,147805,192815485DBBC485508837480A81E25C,60463,20,22,2,109.52507,18.22438,1605
18934,147925,A928E9F6C796FE1A60807BA003DE87BB,30854,5,7,2,109.56889,18.27076,1763
18935,147926,A928E9F6C796FE1A60807BA003DE87BB,39183,8,9,1,109.55542,18.28208,1715
18936,147927,A928E9F6C796FE1A60807BA003DE87BB,30854,13,21,8,109.56889,18.27076,1763
18972,148116,560794A44CA17A43FA34D0FA6C339747,30854,0,9,9,109.56889,18.27076,1763
18973,148117,560794A44CA17A43FA34D0FA6C339747,39104,9,11,2,109.50104,18.2525,1510
18974,148118,560794A44CA17A43FA34D0FA6C339747,30854,13,19,6,109.56889,18.27076,1763
18975,148122,86435198F57620D5DAC23B4A4DA78009,31931,5,6,1,109.54771,18.29403,1667
18976,148123,86435198F57620D5DAC23B4A4DA78009,39183,6,7,1,109.55542,18.28208,1715
18977,148124,86435198F57620D5DAC23B4A4DA78009,31931,9,23,14,109.54771,18.29403,1667
18978,148140,608A55C14BAB2A5B627ACC1F39B89FB6,31071,1,3,2,109.58257,18.28458,1815
18979,148141,608A55C14BAB2A5B627ACC1F39B89FB6,30854,7,9,2,109.56889,18.27076,1763
18980,148142,608A55C14BAB2A5B627ACC1F39B89FB6,31945,12,13,1,109.58021,18.29403,1817
18984,148205,410DD8A32244BC0C8E0A44B87218A19E,30854,0,10,10,109.56889,18.27076,1763
18985,148206,410DD8A32244BC0C8E0A44B87218A19E,31071,11,12,1,109.58257,18.28458,1815
18986,148207,410DD8A32244BC0C8E0A44B87218A19E,30854,13,23,10,109.56889,18.27076,1763
18987,148244,10EBF762D28520B09848288F7052CFDE,30854,0,6,6,109.56889,18.27076,1763
18988,148245,10EBF762D28520B09848288F7052CFDE,39101,8,16,8,109.50132,18.24931,1509
18989,148246,10EBF762D28520B09848288F7052CFDE,31561,19,23,4,109.56792,18.28479,1765
18990,148247,3E01B14B28C0FDBF8BB343D61C8AA7D8,60241,0,1,1,109.53319,18.28667,1616
18991,148248,3E01B14B28C0FDBF8BB343D61C8AA7D8,31931,1,16,15,109.54771,18.29403,1667
18992,148249,3E01B14B28C0FDBF8BB343D61C8AA7D8,60241,18,20,2,109.53319,18.28667,1616
18993,148250,3E01B14B28C0FDBF8BB343D61C8AA7D8,60331,21,23,2,109.505,18.26507,1512
19012,148423,9837FB962D7F62E426A73EBD66CBBE03,30271,1,17,16,109.49132,18.23153,1456
19013,148424,9837FB962D7F62E426A73EBD66CBBE03,60131,18,19,1,109.49819,18.24778,1509
19014,148425,9837FB962D7F62E426A73EBD66CBBE03,30271,22,23,1,109.49132,18.23153,1456
19022,148490,15A2A8790389D1537721C21B141A7A31,61011,2,3,1,109.60653,18.19076,1900
19023,148492,15A2A8790389D1537721C21B141A7A31,61011,5,10,5,109.60653,18.19076,1900
19024,148494,15A2A8790389D1537721C21B141A7A31,61011,17,21,4,109.60653,18.19076,1900
19037,148632,A01B4012B619D942E7CC3AC9B78722B4,31561,0,6,6,109.56792,18.28479,1765
19038,148633,A01B4012B619D942E7CC3AC9B78722B4,39183,9,10,1,109.55542,18.28208,1715
19039,148634,A01B4012B619D942E7CC3AC9B78722B4,31561,11,23,12,109.56792,18.28479,1765
19053,148749,AD6CE74FEECB42F7806A62DA7A4CECCA,30854,0,2,2,109.56889,18.27076,1763
19054,148750,AD6CE74FEECB42F7806A62DA7A4CECCA,30851,2,5,3,109.5616,18.27396,1713
19055,148751,AD6CE74FEECB42F7806A62DA7A4CECCA,30854,6,9,3,109.56889,18.27076,1763
19056,148805,EFFEF00C078D502D6D0D1D469ACBA466,38325,0,8,8,109.39792,18.2909,1116
19057,148806,EFFEF00C078D502D6D0D1D469ACBA466,31471,9,11,2,109.34583,18.29563,917
19058,148807,EFFEF00C078D502D6D0D1D469ACBA466,38325,12,15,3,109.39792,18.2909,1116
19064,148882,8DD23AA43C0F7967C45F7488D66F9159,30854,1,7,6,109.56889,18.27076,1763
19065,148883,8DD23AA43C0F7967C45F7488D66F9159,31945,11,12,1,109.58021,18.29403,1817
19066,148884,8DD23AA43C0F7967C45F7488D66F9159,30854,15,21,6,109.56889,18.27076,1763
19069,148897,147470AD3D3B8724582C30D5F244A8B6,60421,0,12,12,109.46333,18.31743,1371
19070,148898,147470AD3D3B8724582C30D5F244A8B6,30111,12,14,2,109.47583,18.30542,1419
19071,148899,147470AD3D3B8724582C30D5F244A8B6,60421,16,17,1,109.46333,18.31743,1371
19072,148900,147470AD3D3B8724582C30D5F244A8B6,30111,17,22,5,109.47583,18.30542,1419
19078,149044,C85D0B931BEF54F05B9ABBBB03212DB7,30854,0,3,3,109.56889,18.27076,1763
19079,149045,C85D0B931BEF54F05B9ABBBB03212DB7,31421,4,8,4,109.55382,18.22347,1705
19080,149046,C85D0B931BEF54F05B9ABBBB03212DB7,30854,13,20,7,109.56889,18.27076,1763
19093,149267,9E2C88D4E95B05198C1730806E1D4F8F,31071,0,4,4,109.58257,18.28458,1815
19094,149268,9E2C88D4E95B05198C1730806E1D4F8F,39183,5,10,5,109.55542,18.28208,1715
19095,149269,9E2C88D4E95B05198C1730806E1D4F8F,31071,11,12,1,109.58257,18.28458,1815
19096,149270,9E2C88D4E95B05198C1730806E1D4F8F,39183,13,15,2,109.55542,18.28208,1715
19097,149274,75817DB682187A07461734D66E1E6492,60631,0,4,4,109.57778,18.27583,1814
19098,149275,75817DB682187A07461734D66E1E6492,30854,4,16,12,109.56889,18.27076,1763
19099,149276,75817DB682187A07461734D66E1E6492,60631,19,23,4,109.57778,18.27583,1814
19100,149350,21C679D1B9FF307EA1AC2A89744209FE,38291,0,8,8,109.51618,18.24313,1558
19101,149351,21C679D1B9FF307EA1AC2A89744209FE,60281,8,12,4,109.51743,18.25924,1561
19102,149352,21C679D1B9FF307EA1AC2A89744209FE,38291,13,23,10,109.51618,18.24313,1558
19114,149447,4DA47CA7E0DF1887A4FCFA8DEF75F8FC,31761,0,7,7,109.60521,18.27965,1914
19115,149448,4DA47CA7E0DF1887A4FCFA8DEF75F8FC,30951,12,16,4,109.56208,18.25667,1761
19116,149449,4DA47CA7E0DF1887A4FCFA8DEF75F8FC,31761,18,23,5,109.60521,18.27965,1914
19121,149503,E6541B4F346982101D887BAAF0315541,30854,0,2,2,109.56889,18.27076,1763
19122,149504,E6541B4F346982101D887BAAF0315541,31931,3,5,2,109.54771,18.29403,1667
19123,149505,E6541B4F346982101D887BAAF0315541,30854,5,23,18,109.56889,18.27076,1763
19133,149570,B643AC77F8D8498A9694D45BA8B0F75F,31561,0,2,2,109.56792,18.28479,1765
19134,149571,B643AC77F8D8498A9694D45BA8B0F75F,60631,5,16,11,109.57778,18.27583,1814
19135,149572,B643AC77F8D8498A9694D45BA8B0F75F,31561,17,19,2,109.56792,18.28479,1765
19147,149708,5426296000364EE32711CD0E73D782C8,31071,4,5,1,109.58257,18.28458,1815
19148,149709,5426296000364EE32711CD0E73D782C8,30854,7,8,1,109.56889,18.27076,1763
19149,149710,5426296000364EE32711CD0E73D782C8,31561,10,15,5,109.56792,18.28479,1765
19152,149780,283C1DB08EC53022FE9E85C662A0B611,38951,0,16,16,109.48097,18.28868,1416
19153,149781,283C1DB08EC53022FE9E85C662A0B611,38951,17,18,1,109.48097,18.28868,1416
19154,149782,283C1DB08EC53022FE9E85C662A0B611,38951,20,23,3,109.48097,18.28868,1416
19176,150005,B32E0C141A5BC7BD81AEFEA867DBF2BA,39371,0,6,6,109.56627,18.2646,1762
19177,150006,B32E0C141A5BC7BD81AEFEA867DBF2BA,30854,9,11,2,109.56889,18.27076,1763
19178,150007,B32E0C141A5BC7BD81AEFEA867DBF2BA,31531,11,12,1,109.49583,18.25972,1461
19179,150008,B32E0C141A5BC7BD81AEFEA867DBF2BA,30854,15,23,8,109.56889,18.27076,1763
19208,150263,369F61D9EC42E510E242E24266B2C23F,30921,0,11,11,109.53903,18.29451,1667
19209,150264,369F61D9EC42E510E242E24266B2C23F,31931,11,13,2,109.54771,18.29403,1667
19210,150265,369F61D9EC42E510E242E24266B2C23F,30921,13,14,1,109.53903,18.29451,1667
19211,150266,369F61D9EC42E510E242E24266B2C23F,31931,14,21,7,109.54771,18.29403,1667
19212,150365,DC0EB400EA24BEE9EB39D315B0E6AEF0,60041,0,6,6,109.39889,18.31944,1121
19213,150366,DC0EB400EA24BEE9EB39D315B0E6AEF0,38871,10,12,2,109.44681,18.28625,1316
19214,150367,DC0EB400EA24BEE9EB39D315B0E6AEF0,31431,13,20,7,109.44639,18.29042,1316
19227,150492,BE8220A49F1231C0A022F4AA2075503E,31945,0,6,6,109.58021,18.29403,1817
19228,150493,BE8220A49F1231C0A022F4AA2075503E,30854,9,10,1,109.56889,18.27076,1763
19229,150494,BE8220A49F1231C0A022F4AA2075503E,31945,11,13,2,109.58021,18.29403,1817
19230,150495,BE8220A49F1231C0A022F4AA2075503E,30854,15,20,5,109.56889,18.27076,1763
19243,150614,A68637AA89BD62624E677D9E66C32FAD,39101,0,5,5,109.50132,18.24931,1509
19244,150615,A68637AA89BD62624E677D9E66C32FAD,30161,5,16,11,109.50042,18.24389,1508
19245,150616,A68637AA89BD62624E677D9E66C32FAD,30361,17,22,5,109.50347,18.24,1508
19252,150671,CFCFA94681CDD57855D6405C244168DD,30371,2,5,3,109.51,18.24771,1559
19253,150672,CFCFA94681CDD57855D6405C244168DD,38891,5,12,7,109.51486,18.24118,1558
19254,150673,CFCFA94681CDD57855D6405C244168DD,30371,13,16,3,109.51,18.24771,1559
19255,150674,CFCFA94681CDD57855D6405C244168DD,38891,20,23,3,109.51486,18.24118,1558
19257,150690,A8CC84F6441C04DAF82A74609E587ED2,30561,1,5,4,109.52778,18.31938,1621
19258,150691,A8CC84F6441C04DAF82A74609E587ED2,30561,10,12,2,109.52778,18.31938,1621
19259,150692,A8CC84F6441C04DAF82A74609E587ED2,31931,14,15,1,109.54771,18.29403,1667
19260,150723,B17D654C0C5F0BF2FDFE2DB8B9C0B83F,30421,4,16,12,109.50021,18.25861,1511
19261,150724,B17D654C0C5F0BF2FDFE2DB8B9C0B83F,60381,18,19,1,109.5241,18.22458,1605
19262,150725,B17D654C0C5F0BF2FDFE2DB8B9C0B83F,30711,21,23,2,109.50271,18.25347,1510
19263,150777,41BFDF202AA15C7D0EC7487840A4D094,30851,3,4,1,109.5616,18.27396,1713
19264,150778,41BFDF202AA15C7D0EC7487840A4D094,39183,5,6,1,109.55542,18.28208,1715
19265,150779,41BFDF202AA15C7D0EC7487840A4D094,30854,6,7,1,109.56889,18.27076,1763
19269,150791,61845632D07FAD90D178155204748FBA,60631,0,1,1,109.57778,18.27583,1814
19270,150792,61845632D07FAD90D178155204748FBA,30854,1,3,2,109.56889,18.27076,1763
19271,150793,61845632D07FAD90D178155204748FBA,30851,6,15,9,109.5616,18.27396,1713
19272,150794,61845632D07FAD90D178155204748FBA,30854,17,20,3,109.56889,18.27076,1763
19273,150809,DF34F38BEE4872598B76E0C6734B5964,38157,0,13,13,109.51483,18.26958,1563
19274,150810,DF34F38BEE4872598B76E0C6734B5964,31931,15,16,1,109.54771,18.29403,1667
19275,150811,DF34F38BEE4872598B76E0C6734B5964,31821,18,19,1,109.51181,18.24924,1559
19276,150812,DF34F38BEE4872598B76E0C6734B5964,31931,22,23,1,109.54771,18.29403,1667
19282,150913,47A18820FDA9856131F74091D44B6BCB,31071,0,6,6,109.58257,18.28458,1815
19283,150914,47A18820FDA9856131F74091D44B6BCB,30851,8,9,1,109.5616,18.27396,1713
19284,150915,47A18820FDA9856131F74091D44B6BCB,31561,10,12,2,109.56792,18.28479,1765
19291,151011,A9FCE0049DB44FE004EAFBF5B783F4A5,31071,1,4,3,109.58257,18.28458,1815
19292,151012,A9FCE0049DB44FE004EAFBF5B783F4A5,31945,4,6,2,109.58021,18.29403,1817
19293,151013,A9FCE0049DB44FE004EAFBF5B783F4A5,30854,8,19,11,109.56889,18.27076,1763
19294,151023,2D913891935203F66178BF4BFC3F9DA5,30461,0,14,14,109.5116,18.26313,1562
19295,151024,2D913891935203F66178BF4BFC3F9DA5,30854,14,16,2,109.56889,18.27076,1763
19296,151025,2D913891935203F66178BF4BFC3F9DA5,30461,17,23,6,109.5116,18.26313,1562
19310,151125,A94F66C88B84FF0658441320CD9F667C,30854,0,4,4,109.56889,18.27076,1763
19311,151126,A94F66C88B84FF0658441320CD9F667C,31945,4,5,1,109.58021,18.29403,1817
19312,151127,A94F66C88B84FF0658441320CD9F667C,31071,6,18,12,109.58257,18.28458,1815
19313,151128,A94F66C88B84FF0658441320CD9F667C,30854,19,20,1,109.56889,18.27076,1763
19316,151185,C316CE65034FB3C77BE459147CBF943A,60291,0,6,6,109.50826,18.24639,1509
19317,151186,C316CE65034FB3C77BE459147CBF943A,30161,7,9,2,109.50042,18.24389,1508
19318,151187,C316CE65034FB3C77BE459147CBF943A,30161,10,17,7,109.50042,18.24389,1508
19319,151188,C316CE65034FB3C77BE459147CBF943A,60291,20,23,3,109.50826,18.24639,1509
19327,151273,90316F668419B151242AF04D86EAF2CC,31761,0,2,2,109.60521,18.27965,1914
19328,151274,90316F668419B151242AF04D86EAF2CC,31071,4,21,17,109.58257,18.28458,1815
19329,151275,90316F668419B151242AF04D86EAF2CC,30854,22,23,1,109.56889,18.27076,1763
19345,151377,96F98526707B06BE1263CCD4F72E07A1,31071,1,7,6,109.58257,18.28458,1815
19346,151378,96F98526707B06BE1263CCD4F72E07A1,30854,9,16,7,109.56889,18.27076,1763
19347,151379,96F98526707B06BE1263CCD4F72E07A1,31945,17,18,1,109.58021,18.29403,1817
19348,151380,96F98526707B06BE1263CCD4F72E07A1,30854,19,23,4,109.56889,18.27076,1763
19350,151411,24B9CD23EC5587BA3102D06F602ACE38,60361,2,7,5,109.51938,18.29681,1567
19351,151412,24B9CD23EC5587BA3102D06F602ACE38,60171,10,11,1,109.51292,18.30694,1569
19352,151413,24B9CD23EC5587BA3102D06F602ACE38,39183,12,13,1,109.55542,18.28208,1715
19365,151456,ECE5F9061BD873B365108DCE1A2E8E9E,38271,0,13,13,109.62632,18.23049,1956
19366,151457,ECE5F9061BD873B365108DCE1A2E8E9E,31321,13,16,3,109.63799,18.23201,2007
19367,151458,ECE5F9061BD873B365108DCE1A2E8E9E,38271,19,21,2,109.62632,18.23049,1956
19368,151459,ECE5F9061BD873B365108DCE1A2E8E9E,31321,21,22,1,109.63799,18.23201,2007
19385,151580,0958879F2092FEC51B8948C9F5C46956,31231,0,7,7,109.42597,18.29292,1217
19386,151581,0958879F2092FEC51B8948C9F5C46956,60552,8,9,1,109.41729,18.30014,1218
19387,151583,0958879F2092FEC51B8948C9F5C46956,31231,16,23,7,109.42597,18.29292,1217
19401,151755,10BB72F4E7990A3695C663829F0D188E,30081,0,13,13,109.50243,18.26632,1512
19402,151756,10BB72F4E7990A3695C663829F0D188E,60331,16,17,1,109.505,18.26507,1512
19403,151757,10BB72F4E7990A3695C663829F0D188E,38157,17,19,2,109.51483,18.26958,1563
19404,151758,10BB72F4E7990A3695C663829F0D188E,30081,21,23,2,109.50243,18.26632,1512
19405,151795,DBB710D279E76C79F1E4B0766F579F8A,31071,0,14,14,109.58257,18.28458,1815
19406,151796,DBB710D279E76C79F1E4B0766F579F8A,30854,14,20,6,109.56889,18.27076,1763
19407,151797,DBB710D279E76C79F1E4B0766F579F8A,31071,21,23,2,109.58257,18.28458,1815
19408,151814,CCCD2290FB632A48009771412BE68ADD,31561,0,9,9,109.56792,18.28479,1765
19409,151815,CCCD2290FB632A48009771412BE68ADD,39183,9,10,1,109.55542,18.28208,1715
19410,151816,CCCD2290FB632A48009771412BE68ADD,31561,12,14,2,109.56792,18.28479,1765
19411,151817,CCCD2290FB632A48009771412BE68ADD,39183,16,17,1,109.55542,18.28208,1715
19414,151853,39FA7A486F1856D43C300CE94E4DB233,30391,0,7,7,109.4975,18.27118,1513
19415,151854,39FA7A486F1856D43C300CE94E4DB233,38127,8,10,2,109.50833,18.27222,1513
19416,151855,39FA7A486F1856D43C300CE94E4DB233,30084,12,23,11,109.50118,18.26972,1513
19419,151886,A2DBFF4E352E7B7C1EE25431C02FC741,31931,0,16,16,109.54771,18.29403,1667
19420,151887,A2DBFF4E352E7B7C1EE25431C02FC741,39183,16,17,1,109.55542,18.28208,1715
19421,151888,A2DBFF4E352E7B7C1EE25431C02FC741,31931,21,22,1,109.54771,18.29403,1667
19425,151901,0BABF9C6516F437130A3DD3C99553A57,31206,0,13,13,109.50819,18.23549,1507
19426,151902,0BABF9C6516F437130A3DD3C99553A57,60381,13,16,3,109.5241,18.22458,1605
19427,151903,0BABF9C6516F437130A3DD3C99553A57,31206,17,18,1,109.50819,18.23549,1507
19428,151913,6300414882932A98E73E91790947DC62,60281,0,11,11,109.51743,18.25924,1561
19429,151914,6300414882932A98E73E91790947DC62,60311,11,13,2,109.52097,18.24319,1558
19430,151915,6300414882932A98E73E91790947DC62,60281,13,23,10,109.51743,18.25924,1561
19444,152003,EF24901D99384F703B20FE07F2784FA0,31631,0,1,1,109.59542,18.36826,1879
19445,152004,EF24901D99384F703B20FE07F2784FA0,30101,4,6,2,109.57299,18.33333,1773
19446,152005,EF24901D99384F703B20FE07F2784FA0,31631,7,19,12,109.59542,18.36826,1879
19448,152097,1122041491C04B199A15F6E1E401D68F,30251,2,5,3,109.50611,18.26653,1512
19449,152098,1122041491C04B199A15F6E1E401D68F,30461,6,11,5,109.5116,18.26313,1562
19450,152099,1122041491C04B199A15F6E1E401D68F,60281,13,16,3,109.51743,18.25924,1561
19451,152100,1122041491C04B199A15F6E1E401D68F,30461,16,23,7,109.5116,18.26313,1562
19452,152106,7FD31F65A9E7574FDAD4A110ACBA289D,31931,5,10,5,109.54771,18.29403,1667
19453,152107,7FD31F65A9E7574FDAD4A110ACBA289D,60091,14,17,3,109.59729,18.30431,1869
19454,152108,7FD31F65A9E7574FDAD4A110ACBA289D,31561,18,19,1,109.56792,18.28479,1765
19455,152109,7FD31F65A9E7574FDAD4A110ACBA289D,31931,20,23,3,109.54771,18.29403,1667
19466,152248,56F818D0924E7BDB02CCC04065747626,31421,0,6,6,109.55382,18.22347,1705
19467,152249,56F818D0924E7BDB02CCC04065747626,30711,7,8,1,109.50271,18.25347,1510
19468,152250,56F818D0924E7BDB02CCC04065747626,38205,9,14,5,109.62743,18.23139,1956
19477,152347,D9AE11CD16B231308C3F0FB3F53BC3E9,31071,0,7,7,109.58257,18.28458,1815
19478,152348,D9AE11CD16B231308C3F0FB3F53BC3E9,30854,8,10,2,109.56889,18.27076,1763
19479,152349,D9AE11CD16B231308C3F0FB3F53BC3E9,31071,13,14,1,109.58257,18.28458,1815
19480,152350,D9AE11CD16B231308C3F0FB3F53BC3E9,30854,14,20,6,109.56889,18.27076,1763
19481,152416,8B9A9BFD1ACAD480EB101A91DBF2024D,30191,0,1,1,109.50361,18.22701,1506
19482,152417,8B9A9BFD1ACAD480EB101A91DBF2024D,38291,4,20,16,109.51618,18.24313,1558
19483,152418,8B9A9BFD1ACAD480EB101A91DBF2024D,30371,21,22,1,109.51,18.24771,1559
19484,152419,E840D759B1893A7E5B17DAF4E91C42F9,38027,1,7,6,109.38833,18.2909,1066
19485,152420,E840D759B1893A7E5B17DAF4E91C42F9,38027,10,11,1,109.38833,18.2909,1066
19486,152421,E840D759B1893A7E5B17DAF4E91C42F9,38027,13,23,10,109.38833,18.2909,1066
19489,152443,43E035AE85036EBD9891453E9567CB81,30151,0,6,6,109.50986,18.25083,1560
19490,152444,43E035AE85036EBD9891453E9567CB81,31531,11,13,2,109.49583,18.25972,1461
19491,152445,43E035AE85036EBD9891453E9567CB81,30421,13,15,2,109.50021,18.25861,1511
19492,152446,43E035AE85036EBD9891453E9567CB81,30151,19,23,4,109.50986,18.25083,1560
19510,152559,1A3FFDC65E8E8B2347B759A77F2F6BEE,30191,2,6,4,109.50361,18.22701,1506
19511,152560,1A3FFDC65E8E8B2347B759A77F2F6BEE,31521,8,21,13,109.51458,18.22542,1555
19512,152561,1A3FFDC65E8E8B2347B759A77F2F6BEE,30191,22,23,1,109.50361,18.22701,1506
19515,152584,08077B5D5F0A9938A81D328635D03C8B,30854,2,13,11,109.56889,18.27076,1763
19516,152585,08077B5D5F0A9938A81D328635D03C8B,31071,14,15,1,109.58257,18.28458,1815
19517,152586,08077B5D5F0A9938A81D328635D03C8B,30854,15,19,4,109.56889,18.27076,1763
19518,152587,08077B5D5F0A9938A81D328635D03C8B,31561,22,23,1,109.56792,18.28479,1765
19533,152799,9AA959ED87D1ECC3053DED17290EFCBD,31561,0,8,8,109.56792,18.28479,1765
19534,152800,9AA959ED87D1ECC3053DED17290EFCBD,31071,12,13,1,109.58257,18.28458,1815
19535,152801,9AA959ED87D1ECC3053DED17290EFCBD,39183,15,16,1,109.55542,18.28208,1715
19536,152802,9AA959ED87D1ECC3053DED17290EFCBD,31561,19,22,3,109.56792,18.28479,1765
19539,152830,7890099D98AA300C5BF12527E7372DB0,60631,0,8,8,109.57778,18.27583,1814
19540,152831,7890099D98AA300C5BF12527E7372DB0,31071,12,15,3,109.58257,18.28458,1815
19541,152832,7890099D98AA300C5BF12527E7372DB0,30854,18,20,2,109.56889,18.27076,1763
19542,152833,7890099D98AA300C5BF12527E7372DB0,60631,21,23,2,109.57778,18.27583,1814
19548,152919,C37DBDD12F85B1DFB17F9185AF0E7708,39371,0,6,6,109.56627,18.2646,1762
19549,152920,C37DBDD12F85B1DFB17F9185AF0E7708,30851,7,10,3,109.5616,18.27396,1713
19550,152921,C37DBDD12F85B1DFB17F9185AF0E7708,30951,11,22,11,109.56208,18.25667,1761
19551,152931,AECCCA10F076AF0904633347B64B94DB,30191,0,2,2,109.50361,18.22701,1506
19552,152932,AECCCA10F076AF0904633347B64B94DB,39111,3,4,1,109.5191,18.22597,1555
19553,152933,AECCCA10F076AF0904633347B64B94DB,30191,5,6,1,109.50361,18.22701,1506
19554,152934,AECCCA10F076AF0904633347B64B94DB,31521,7,13,6,109.51458,18.22542,1555
19555,152955,46F524E2239F39277AC568014393DFDF,60594,1,15,14,109.62694,18.22799,1956
19556,152956,46F524E2239F39277AC568014393DFDF,38052,17,19,2,109.62618,18.23042,1956
19557,152957,46F524E2239F39277AC568014393DFDF,60594,20,23,3,109.62694,18.22799,1956
19570,152987,BBE4D8242EE46AE73AD69A56A00F4408,30201,0,9,9,109.4909,18.26465,1462
19571,152988,BBE4D8242EE46AE73AD69A56A00F4408,31271,9,11,2,109.48958,18.26257,1462
19572,152989,BBE4D8242EE46AE73AD69A56A00F4408,31021,11,13,2,109.49021,18.27,1463
19573,152990,BBE4D8242EE46AE73AD69A56A00F4408,30201,13,23,10,109.4909,18.26465,1462
19581,153122,7D1ED6067ECBD941EFC43CE0A6ADAE71,30854,0,7,7,109.56889,18.27076,1763
19582,153123,7D1ED6067ECBD941EFC43CE0A6ADAE71,31945,9,11,2,109.58021,18.29403,1817
19583,153124,7D1ED6067ECBD941EFC43CE0A6ADAE71,30854,14,18,4,109.56889,18.27076,1763
19588,153159,A503639E15A0B5D04B0130D882921438,30711,0,9,9,109.50271,18.25347,1510
19589,153160,A503639E15A0B5D04B0130D882921438,30421,9,11,2,109.50021,18.25861,1511
19590,153161,A503639E15A0B5D04B0130D882921438,31031,11,22,11,109.49979,18.25382,1510
19600,153417,39F25FE146A03325C93C111F2A943B6C,30854,1,2,1,109.56889,18.27076,1763
19601,153418,39F25FE146A03325C93C111F2A943B6C,31945,2,6,4,109.58021,18.29403,1817
19602,153419,39F25FE146A03325C93C111F2A943B6C,30854,7,23,16,109.56889,18.27076,1763
19605,153491,1E36640BE395A4EE8CCB2697222419A5,60631,0,6,6,109.57778,18.27583,1814
19606,153492,1E36640BE395A4EE8CCB2697222419A5,30854,8,12,4,109.56889,18.27076,1763
19607,153493,1E36640BE395A4EE8CCB2697222419A5,60631,14,16,2,109.57778,18.27583,1814
19608,153494,1E36640BE395A4EE8CCB2697222419A5,30854,19,21,2,109.56889,18.27076,1763
19616,153507,DFFF17B7FE30E79B8AABBB5CE171272F,31561,0,10,10,109.56792,18.28479,1765
19617,153508,DFFF17B7FE30E79B8AABBB5CE171272F,39183,10,16,6,109.55542,18.28208,1715
19618,153509,DFFF17B7FE30E79B8AABBB5CE171272F,31561,17,22,5,109.56792,18.28479,1765
19623,153622,BD5DE467370306D034C70B320455BE36,39091,0,11,11,109.50097,18.25222,1510
19624,153623,BD5DE467370306D034C70B320455BE36,30421,16,17,1,109.50021,18.25861,1511
19625,153624,BD5DE467370306D034C70B320455BE36,39151,17,23,6,109.49875,18.25097,1510
19635,153839,622234A65D292D040A9E438A2770674C,30851,0,7,7,109.5616,18.27396,1713
19636,153840,622234A65D292D040A9E438A2770674C,31561,8,9,1,109.56792,18.28479,1765
19637,153841,622234A65D292D040A9E438A2770674C,30851,12,21,9,109.5616,18.27396,1713
19656,153992,A4D22152627C5C24F4D207D0FDD787D4,60311,0,1,1,109.52097,18.24319,1558
19657,153993,A4D22152627C5C24F4D207D0FDD787D4,60221,5,10,5,109.52569,18.29188,1616
19658,153994,A4D22152627C5C24F4D207D0FDD787D4,30854,14,15,1,109.56889,18.27076,1763
19659,153995,A4D22152627C5C24F4D207D0FDD787D4,60221,20,22,2,109.52569,18.29188,1616
19695,154283,EEC6B662D07BE95423A2DC77D2E69188,31071,0,8,8,109.58257,18.28458,1815
19696,154284,EEC6B662D07BE95423A2DC77D2E69188,30854,11,18,7,109.56889,18.27076,1763
19697,154285,EEC6B662D07BE95423A2DC77D2E69188,31071,20,21,1,109.58257,18.28458,1815
19698,154286,EEC6B662D07BE95423A2DC77D2E69188,30854,21,22,1,109.56889,18.27076,1763
19701,154405,452F0FF6BC36839041DCBEF2292D6E55,60661,2,9,7,109.548,18.2377,1657
19702,154406,452F0FF6BC36839041DCBEF2292D6E55,31521,10,14,4,109.51458,18.22542,1555
19703,154407,452F0FF6BC36839041DCBEF2292D6E55,30861,15,17,2,109.52722,18.22743,1606
19704,154408,452F0FF6BC36839041DCBEF2292D6E55,60661,21,23,2,109.548,18.2377,1657
19747,154721,B84B247FA61A8C12DFCCCF3C2D72006D,31071,0,7,7,109.58257,18.28458,1815
19748,154722,B84B247FA61A8C12DFCCCF3C2D72006D,30854,9,17,8,109.56889,18.27076,1763
19749,154723,B84B247FA61A8C12DFCCCF3C2D72006D,31071,17,19,2,109.58257,18.28458,1815
19750,154724,B84B247FA61A8C12DFCCCF3C2D72006D,30854,19,21,2,109.56889,18.27076,1763
19756,154766,6C0260646767B781577B5B8CE2471E51,38484,1,9,8,109.53028,18.31528,1620
19757,154767,6C0260646767B781577B5B8CE2471E51,38484,12,17,5,109.53028,18.31528,1620
19758,154768,6C0260646767B781577B5B8CE2471E51,38484,20,22,2,109.53028,18.31528,1620
19776,154968,8AABF5FDF2B06EB445749240A3894969,31071,1,8,7,109.58257,18.28458,1815
19777,154969,8AABF5FDF2B06EB445749240A3894969,30854,8,12,4,109.56889,18.27076,1763
19778,154970,8AABF5FDF2B06EB445749240A3894969,31071,12,13,1,109.58257,18.28458,1815
19786,155115,30CE72A519D49881F23B8123486E3A02,60054,2,8,6,109.3016,18.31229,770
19787,155116,30CE72A519D49881F23B8123486E3A02,60411,9,11,2,109.32514,18.30854,869
19788,155117,30CE72A519D49881F23B8123486E3A02,31471,16,17,1,109.34583,18.29563,917
19789,155118,30CE72A519D49881F23B8123486E3A02,60411,18,20,2,109.32514,18.30854,869
19796,155346,9B979E9430BCD0DDB6C78BBE525EBD2D,60631,3,6,3,109.57778,18.27583,1814
19797,155347,9B979E9430BCD0DDB6C78BBE525EBD2D,30854,7,20,13,109.56889,18.27076,1763
19798,155348,9B979E9430BCD0DDB6C78BBE525EBD2D,39371,20,22,2,109.56627,18.2646,1762
19799,155349,16C55088B9FD926AE4D7B338D0769967,30854,5,10,5,109.56889,18.27076,1763
19800,155350,16C55088B9FD926AE4D7B338D0769967,31531,11,13,2,109.49583,18.25972,1461
19801,155351,16C55088B9FD926AE4D7B338D0769967,30854,15,17,2,109.56889,18.27076,1763
19806,155463,0D1B933C65704EEE0CFA016AED0F8FDF,31071,0,9,9,109.58257,18.28458,1815
19807,155464,0D1B933C65704EEE0CFA016AED0F8FDF,30854,9,13,4,109.56889,18.27076,1763
19808,155465,0D1B933C65704EEE0CFA016AED0F8FDF,31071,15,18,3,109.58257,18.28458,1815
19815,155513,860C13CBFA013D0236AC6B4CB1CB4DEE,30721,1,8,7,109.51597,18.28257,1565
19816,155514,860C13CBFA013D0236AC6B4CB1CB4DEE,30324,10,12,2,109.50326,18.29257,1517
19817,155515,860C13CBFA013D0236AC6B4CB1CB4DEE,30711,13,16,3,109.50271,18.25347,1510
19818,155516,860C13CBFA013D0236AC6B4CB1CB4DEE,30721,17,19,2,109.51597,18.28257,1565
19819,155578,DECB7B3FC95BFA8620EFD8D9DE328252,30854,4,10,6,109.56889,18.27076,1763
19820,155579,DECB7B3FC95BFA8620EFD8D9DE328252,31945,14,15,1,109.58021,18.29403,1817
19821,155580,DECB7B3FC95BFA8620EFD8D9DE328252,30854,15,20,5,109.56889,18.27076,1763
19825,155614,B7EEF2B178640D89D1EA0EECF6DA162E,30711,0,8,8,109.50271,18.25347,1510
19826,155615,B7EEF2B178640D89D1EA0EECF6DA162E,31181,8,10,2,109.50382,18.24813,1509
19827,155616,B7EEF2B178640D89D1EA0EECF6DA162E,31181,11,12,1,109.50382,18.24813,1509
19828,155617,B7EEF2B178640D89D1EA0EECF6DA162E,31031,12,14,2,109.49979,18.25382,1510
19834,155662,4E9C73925B67466BCE6AE7E22B99BF20,30891,0,3,3,109.59431,18.28389,1865
19835,155663,4E9C73925B67466BCE6AE7E22B99BF20,39183,3,6,3,109.55542,18.28208,1715
19836,155664,4E9C73925B67466BCE6AE7E22B99BF20,31071,6,23,17,109.58257,18.28458,1815
19837,155674,FE5C9666AF69804A342901D01418FCD8,30181,0,1,1,109.51597,18.23313,1557
19838,155675,FE5C9666AF69804A342901D01418FCD8,30191,2,4,2,109.50361,18.22701,1506
19839,155676,FE5C9666AF69804A342901D01418FCD8,30181,5,8,3,109.51597,18.23313,1557
19857,155803,C97A61E87ADF22CB0CED7FFED3A35BC3,30951,3,4,1,109.56208,18.25667,1761
19858,155804,C97A61E87ADF22CB0CED7FFED3A35BC3,39371,8,9,1,109.56627,18.2646,1762
19859,155805,C97A61E87ADF22CB0CED7FFED3A35BC3,30851,14,19,5,109.5616,18.27396,1713
19865,155829,372A5433078073EAD18922D679CE0A73,60054,0,13,13,109.3016,18.31229,770
19866,155830,372A5433078073EAD18922D679CE0A73,60411,14,22,8,109.32514,18.30854,869
19867,155831,372A5433078073EAD18922D679CE0A73,60054,22,23,1,109.3016,18.31229,770
19889,155995,FF8CB3D02361FAEBFE418108180099D8,39154,0,1,1,109.50201,18.25681,1511
19890,155996,FF8CB3D02361FAEBFE418108180099D8,60201,1,13,12,109.5041,18.2509,1510
19891,155997,FF8CB3D02361FAEBFE418108180099D8,30711,14,22,8,109.50271,18.25347,1510
19892,156011,D4EE8E1A4C04A1FF0596E4221D0B8B42,30854,0,4,4,109.56889,18.27076,1763
19893,156012,D4EE8E1A4C04A1FF0596E4221D0B8B42,31071,7,14,7,109.58257,18.28458,1815
19894,156013,D4EE8E1A4C04A1FF0596E4221D0B8B42,30854,18,19,1,109.56889,18.27076,1763
19895,156014,D4EE8E1A4C04A1FF0596E4221D0B8B42,39091,20,22,2,109.50097,18.25222,1510
19896,156021,5A888DC7A3AA300CC584D9862C5384A1,30421,0,7,7,109.50021,18.25861,1511
19897,156022,5A888DC7A3AA300CC584D9862C5384A1,39181,8,11,3,109.55153,18.28035,1715
19898,156023,5A888DC7A3AA300CC584D9862C5384A1,39183,11,18,7,109.55542,18.28208,1715
19899,156034,875F4B80762D0E664890361D764F907D,60081,0,7,7,109.51097,18.22639,1556
19900,156035,875F4B80762D0E664890361D764F907D,30571,7,18,11,109.50243,18.21861,1504
19901,156036,875F4B80762D0E664890361D764F907D,60081,19,23,4,109.51097,18.22639,1556
19919,156140,A9F97D2464709590426A157138F3C687,31931,0,6,6,109.54771,18.29403,1667
19920,156141,A9F97D2464709590426A157138F3C687,39181,11,17,6,109.55153,18.28035,1715
19921,156142,A9F97D2464709590426A157138F3C687,31931,19,23,4,109.54771,18.29403,1667
19929,156200,C17F2EF1DEA79C8C951E3013EE071B2C,31071,0,7,7,109.58257,18.28458,1815
19930,156201,C17F2EF1DEA79C8C951E3013EE071B2C,30854,11,17,6,109.56889,18.27076,1763
19931,156202,C17F2EF1DEA79C8C951E3013EE071B2C,31561,20,23,3,109.56792,18.28479,1765
19932,156217,8E244E94833DBF281BCBFE2F4A36E102,30151,0,6,6,109.50986,18.25083,1560
19933,156219,8E244E94833DBF281BCBFE2F4A36E102,60391,17,18,1,109.47667,18.28757,1416
19934,156220,8E244E94833DBF281BCBFE2F4A36E102,60641,20,23,3,109.53854,18.2359,1657
19935,156230,B80D6AB96D3D5CEE71A70ED25275F830,38951,0,1,1,109.48097,18.28868,1416
19936,156231,B80D6AB96D3D5CEE71A70ED25275F830,38951,1,11,10,109.48097,18.28868,1416
19937,156232,B80D6AB96D3D5CEE71A70ED25275F830,31531,15,17,2,109.49583,18.25972,1461
19938,156233,B80D6AB96D3D5CEE71A70ED25275F830,38951,19,23,4,109.48097,18.28868,1416
19944,156321,855D815DC19AA779325469411A9E7B8A,30251,3,8,5,109.50611,18.26653,1512
19945,156322,855D815DC19AA779325469411A9E7B8A,38157,10,15,5,109.51483,18.26958,1563
19946,156323,855D815DC19AA779325469411A9E7B8A,30251,16,17,1,109.50611,18.26653,1512
19954,156375,8621CFDF1B89A83351494618C53D033F,39181,1,3,2,109.55153,18.28035,1715
19955,156376,8621CFDF1B89A83351494618C53D033F,31071,3,7,4,109.58257,18.28458,1815
19956,156377,8621CFDF1B89A83351494618C53D033F,30854,9,10,1,109.56889,18.27076,1763
19957,156378,8621CFDF1B89A83351494618C53D033F,39181,10,22,12,109.55153,18.28035,1715
19958,156390,5D7EC4507F4E76B3D5B0735531A150FF,30731,2,14,12,109.50944,18.22306,1555
19959,156391,5D7EC4507F4E76B3D5B0735531A150FF,30511,18,21,3,109.51069,18.24208,1558
19960,156392,5D7EC4507F4E76B3D5B0735531A150FF,30731,22,23,1,109.50944,18.22306,1555
19963,156442,EB291EA7E3235FF23960DA865075F183,39091,0,16,16,109.50097,18.25222,1510
19964,156443,EB291EA7E3235FF23960DA865075F183,39151,18,19,1,109.49875,18.25097,1510
19965,156444,EB291EA7E3235FF23960DA865075F183,60281,21,23,2,109.51743,18.25924,1561
19966,156491,23DF3A4510347EF32640F77C0A9AA1C8,30371,1,12,11,109.51,18.24771,1559
19967,156492,23DF3A4510347EF32640F77C0A9AA1C8,31821,16,19,3,109.51181,18.24924,1559
19968,156493,23DF3A4510347EF32640F77C0A9AA1C8,60281,20,23,3,109.51743,18.25924,1561
19977,156561,8F3DE08315D720DC64DC898C5903196E,31071,5,6,1,109.58257,18.28458,1815
19978,156562,8F3DE08315D720DC64DC898C5903196E,30854,6,17,11,109.56889,18.27076,1763
19979,156563,8F3DE08315D720DC64DC898C5903196E,31071,19,21,2,109.58257,18.28458,1815
20003,156767,909FBB0C84910641E7440FBAD40E8C52,39183,0,14,14,109.55542,18.28208,1715
20004,156768,909FBB0C84910641E7440FBAD40E8C52,31561,16,17,1,109.56792,18.28479,1765
20005,156769,909FBB0C84910641E7440FBAD40E8C52,39183,18,23,5,109.55542,18.28208,1715
20027,156905,CB44FE843228066922623C4A2B161A4C,60504,0,13,13,109.47917,18.28903,1416
20028,156906,CB44FE843228066922623C4A2B161A4C,30081,13,17,4,109.50243,18.26632,1512
20029,156907,CB44FE843228066922623C4A2B161A4C,30251,21,22,1,109.50611,18.26653,1512
20037,157061,0B1CC3266C9F341870D0B135F2AF352E,60472,2,3,1,109.46625,18.29542,1367
20038,157062,0B1CC3266C9F341870D0B135F2AF352E,30111,4,6,2,109.47583,18.30542,1419
20039,157063,0B1CC3266C9F341870D0B135F2AF352E,60441,7,8,1,109.46792,18.28604,1366
20040,157064,0B1CC3266C9F341870D0B135F2AF352E,31471,12,13,1,109.34583,18.29563,917
20059,157165,6B806948BC9187A91D033B4096721B00,30854,1,5,4,109.56889,18.27076,1763
20060,157166,6B806948BC9187A91D033B4096721B00,30851,10,11,1,109.5616,18.27396,1713
20061,157167,6B806948BC9187A91D033B4096721B00,31071,11,19,8,109.58257,18.28458,1815
20062,157168,DE5024DB59D5BF6AE5857A85EB7680EA,30854,0,13,13,109.56889,18.27076,1763
20063,157169,DE5024DB59D5BF6AE5857A85EB7680EA,31221,16,17,1,109.61333,18.26833,1913
20064,157170,DE5024DB59D5BF6AE5857A85EB7680EA,30854,18,23,5,109.56889,18.27076,1763
20067,157259,E292D83051830D054E89D209EEABA4B9,39183,1,6,5,109.55542,18.28208,1715
20068,157260,E292D83051830D054E89D209EEABA4B9,31561,8,9,1,109.56792,18.28479,1765
20069,157261,E292D83051830D054E89D209EEABA4B9,39183,9,16,7,109.55542,18.28208,1715
20070,157262,E292D83051830D054E89D209EEABA4B9,31071,20,22,2,109.58257,18.28458,1815
20073,157347,2B8C748A18FA7D08D4335AD7C9DEF01B,31761,0,6,6,109.60521,18.27965,1914
20074,157348,2B8C748A18FA7D08D4335AD7C9DEF01B,30851,10,14,4,109.5616,18.27396,1713
20075,157349,2B8C748A18FA7D08D4335AD7C9DEF01B,31761,18,23,5,109.60521,18.27965,1914
20086,157465,0133DDFFB5CECBB261CEDEF10A82D50B,30854,1,11,10,109.56889,18.27076,1763
20087,157466,0133DDFFB5CECBB261CEDEF10A82D50B,31071,11,14,3,109.58257,18.28458,1815
20088,157467,0133DDFFB5CECBB261CEDEF10A82D50B,31561,14,15,1,109.56792,18.28479,1765
20089,157468,0133DDFFB5CECBB261CEDEF10A82D50B,30854,19,21,2,109.56889,18.27076,1763
20109,157630,0E5593A90D661690BE3DAAA17AD936E2,38157,0,1,1,109.51483,18.26958,1563
20110,157631,0E5593A90D661690BE3DAAA17AD936E2,38127,3,6,3,109.50833,18.27222,1513
20111,157632,0E5593A90D661690BE3DAAA17AD936E2,38157,7,9,2,109.51483,18.26958,1563
20112,157633,0E5593A90D661690BE3DAAA17AD936E2,30291,13,18,5,109.50403,18.27028,1513
20122,157688,8FAAC7EA21AE7BB6F52A4D0F285944CD,38721,0,8,8,109.50368,18.27542,1514
20123,157689,8FAAC7EA21AE7BB6F52A4D0F285944CD,30281,11,16,5,109.50597,18.27583,1514
20124,157690,8FAAC7EA21AE7BB6F52A4D0F285944CD,39091,18,20,2,109.50097,18.25222,1510
20125,157691,8FAAC7EA21AE7BB6F52A4D0F285944CD,30281,21,23,2,109.50597,18.27583,1514
20140,157837,40C57F24FE0409ABB752B2031C349577,38951,0,8,8,109.48097,18.28868,1416
20141,157838,40C57F24FE0409ABB752B2031C349577,39041,8,10,2,109.40021,18.29278,1117
20142,157839,40C57F24FE0409ABB752B2031C349577,38951,11,23,12,109.48097,18.28868,1416
20143,157871,D6B54C643B88B86782DC30A38AD291FD,31561,0,9,9,109.56792,18.28479,1765
20144,157872,D6B54C643B88B86782DC30A38AD291FD,30854,12,17,5,109.56889,18.27076,1763
20145,157873,D6B54C643B88B86782DC30A38AD291FD,60221,18,21,3,109.52569,18.29188,1616
20162,158016,A7B3BDD8DC79485BA41EC7F220A41345,30854,0,1,1,109.56889,18.27076,1763
20163,158017,A7B3BDD8DC79485BA41EC7F220A41345,60631,3,10,7,109.57778,18.27583,1814
20164,158018,A7B3BDD8DC79485BA41EC7F220A41345,30854,12,18,6,109.56889,18.27076,1763
20165,158019,A7B3BDD8DC79485BA41EC7F220A41345,30421,21,23,2,109.50021,18.25861,1511
20166,158020,63FBAC0202144B00077561285E6A7F87,30821,0,5,5,109.43681,18.33639,1274
20167,158021,63FBAC0202144B00077561285E6A7F87,30651,8,9,1,109.42611,18.385,1232
20168,158022,63FBAC0202144B00077561285E6A7F87,30821,10,23,13,109.43681,18.33639,1274
20178,158141,5533066D8871087CCD481B88DD73EF7D,31361,0,6,6,109.47417,18.28292,1415
20179,158142,5533066D8871087CCD481B88DD73EF7D,60441,7,13,6,109.46792,18.28604,1366
20180,158143,5533066D8871087CCD481B88DD73EF7D,60401,13,14,1,109.47444,18.27583,1414
20181,158144,5533066D8871087CCD481B88DD73EF7D,31361,17,21,4,109.47417,18.28292,1415
20198,158334,0F23B6E4E3B228AFE54C52B9B3D593D7,60551,0,6,6,109.42722,18.30111,1218
20199,158335,0F23B6E4E3B228AFE54C52B9B3D593D7,60524,6,8,2,109.42951,18.28993,1216
20200,158336,0F23B6E4E3B228AFE54C52B9B3D593D7,60551,9,22,13,109.42722,18.30111,1218
20208,158376,975CB35586D2D95A387E2AA86A5AB719,31351,0,9,9,109.4959,18.28417,1465
20209,158377,975CB35586D2D95A387E2AA86A5AB719,30391,10,11,1,109.4975,18.27118,1513
20210,158378,975CB35586D2D95A387E2AA86A5AB719,30671,12,23,11,109.43611,18.30139,1268
20217,158441,A549C024E6F63EDBD3DC866F10DB11CE,31071,0,5,5,109.58257,18.28458,1815
20218,158442,A549C024E6F63EDBD3DC866F10DB11CE,30854,7,18,11,109.56889,18.27076,1763
20219,158443,A549C024E6F63EDBD3DC866F10DB11CE,31071,20,22,2,109.58257,18.28458,1815
20224,158475,A749E400BFD3B5908671E939EC104DEE,30854,1,2,1,109.56889,18.27076,1763
20225,158476,A749E400BFD3B5908671E939EC104DEE,31071,4,7,3,109.58257,18.28458,1815
20226,158477,A749E400BFD3B5908671E939EC104DEE,30854,10,22,12,109.56889,18.27076,1763
20237,158499,560794A44CA17A43FA34D0FA6C339747,31071,0,2,2,109.58257,18.28458,1815
20238,158500,560794A44CA17A43FA34D0FA6C339747,30854,3,10,7,109.56889,18.27076,1763
20239,158501,560794A44CA17A43FA34D0FA6C339747,31071,11,12,1,109.58257,18.28458,1815
20242,158512,DA759AC2EBBA8078FBC390D09D5C4EC7,31071,0,6,6,109.58257,18.28458,1815
20243,158513,DA759AC2EBBA8078FBC390D09D5C4EC7,30854,9,16,7,109.56889,18.27076,1763
20244,158514,DA759AC2EBBA8078FBC390D09D5C4EC7,31071,17,19,2,109.58257,18.28458,1815
20245,158515,DA759AC2EBBA8078FBC390D09D5C4EC7,30854,20,21,1,109.56889,18.27076,1763
20246,158516,608A55C14BAB2A5B627ACC1F39B89FB6,31945,3,7,4,109.58021,18.29403,1817
20247,158517,608A55C14BAB2A5B627ACC1F39B89FB6,30854,7,18,11,109.56889,18.27076,1763
20248,158518,608A55C14BAB2A5B627ACC1F39B89FB6,31945,20,22,2,109.58021,18.29403,1817
20251,158547,52820FDF38F5A08FADB7112AE77AAA8C,39151,0,16,16,109.49875,18.25097,1510
20252,158548,52820FDF38F5A08FADB7112AE77AAA8C,31031,19,21,2,109.49979,18.25382,1510
20253,158549,52820FDF38F5A08FADB7112AE77AAA8C,60201,21,22,1,109.5041,18.2509,1510
20254,158550,4C0037DB2C07F7F329CC1D9E10D614E3,60311,1,2,1,109.52097,18.24319,1558
20255,158551,4C0037DB2C07F7F329CC1D9E10D614E3,38297,6,7,1,109.52576,18.24965,1609
20256,158552,4C0037DB2C07F7F329CC1D9E10D614E3,60281,11,15,4,109.51743,18.25924,1561
20257,158553,4C0037DB2C07F7F329CC1D9E10D614E3,30771,18,19,1,109.49938,18.26042,1511
20260,158578,D75F3D28EEDDC3AAB22F587F99A79102,30854,0,6,6,109.56889,18.27076,1763
20261,158579,D75F3D28EEDDC3AAB22F587F99A79102,31071,7,10,3,109.58257,18.28458,1815
20262,158580,D75F3D28EEDDC3AAB22F587F99A79102,30854,10,23,13,109.56889,18.27076,1763
20289,158744,31953E35176E90848BE35F2C91BAE76A,31521,0,14,14,109.51458,18.22542,1555
20290,158745,31953E35176E90848BE35F2C91BAE76A,60381,14,17,3,109.5241,18.22458,1605
20291,158746,31953E35176E90848BE35F2C91BAE76A,31421,18,20,2,109.55382,18.22347,1705
20292,158747,31953E35176E90848BE35F2C91BAE76A,31521,21,23,2,109.51458,18.22542,1555
20295,158780,15A2A8790389D1537721C21B141A7A31,61011,0,2,2,109.60653,18.19076,1900
20296,158782,15A2A8790389D1537721C21B141A7A31,61011,8,11,3,109.60653,18.19076,1900
20297,158784,15A2A8790389D1537721C21B141A7A31,61011,14,23,9,109.60653,18.19076,1900
20307,158846,7421066246AAD1C230E7E2A7ADF06E9D,60631,0,6,6,109.57778,18.27583,1814
20308,158847,7421066246AAD1C230E7E2A7ADF06E9D,30854,9,18,9,109.56889,18.27076,1763
20309,158848,7421066246AAD1C230E7E2A7ADF06E9D,31071,19,20,1,109.58257,18.28458,1815
20310,158849,7421066246AAD1C230E7E2A7ADF06E9D,60631,21,23,2,109.57778,18.27583,1814
20311,158881,C153552CEA2677B0FF473AE565EA979E,30821,0,2,2,109.43681,18.33639,1274
20312,158882,C153552CEA2677B0FF473AE565EA979E,30651,2,10,8,109.42611,18.385,1232
20313,158883,C153552CEA2677B0FF473AE565EA979E,30821,11,15,4,109.43681,18.33639,1274
20314,158886,417408FFDA93B177641D270D3A5C4B2D,31071,0,6,6,109.58257,18.28458,1815
20315,158887,417408FFDA93B177641D270D3A5C4B2D,30854,7,19,12,109.56889,18.27076,1763
20316,158888,417408FFDA93B177641D270D3A5C4B2D,31071,19,23,4,109.58257,18.28458,1815
20317,158889,A5E738BCE3A14BFC61D30835FD8302F3,38321,0,9,9,109.39854,18.29132,1116
20318,158890,A5E738BCE3A14BFC61D30835FD8302F3,31701,9,11,2,109.44132,18.28833,1266
20319,158891,A5E738BCE3A14BFC61D30835FD8302F3,38321,12,19,7,109.39854,18.29132,1116
20345,159071,BD4652414D5C17466BA36FD4BD943A94,60221,0,2,2,109.52569,18.29188,1616
20346,159072,BD4652414D5C17466BA36FD4BD943A94,30721,2,4,2,109.51597,18.28257,1565
20347,159073,BD4652414D5C17466BA36FD4BD943A94,31931,8,9,1,109.54771,18.29403,1667
20356,159160,C85D0B931BEF54F05B9ABBBB03212DB7,30854,1,7,6,109.56889,18.27076,1763
20357,159161,C85D0B931BEF54F05B9ABBBB03212DB7,31561,8,9,1,109.56792,18.28479,1765
20358,159162,C85D0B931BEF54F05B9ABBBB03212DB7,30854,10,23,13,109.56889,18.27076,1763
20361,159232,410D55EA73A3884577B7B9B7E86B067E,30084,0,6,6,109.50118,18.26972,1513
20362,159233,410D55EA73A3884577B7B9B7E86B067E,30081,7,10,3,109.50243,18.26632,1512
20363,159234,410D55EA73A3884577B7B9B7E86B067E,39371,13,14,1,109.56627,18.2646,1762
20374,159303,B2420C24A59D2C27A09046B2EE9F5AF9,31071,0,1,1,109.58257,18.28458,1815
20375,159304,B2420C24A59D2C27A09046B2EE9F5AF9,30854,2,8,6,109.56889,18.27076,1763
20376,159305,B2420C24A59D2C27A09046B2EE9F5AF9,31071,8,22,14,109.58257,18.28458,1815
20377,159327,75817DB682187A07461734D66E1E6492,60631,0,4,4,109.57778,18.27583,1814
20378,159328,75817DB682187A07461734D66E1E6492,30854,7,17,10,109.56889,18.27076,1763
20379,159329,75817DB682187A07461734D66E1E6492,60631,20,23,3,109.57778,18.27583,1814
20380,159344,C09F93BE0702CB5D61E87026FDAA8287,30854,1,8,7,109.56889,18.27076,1763
20381,159345,C09F93BE0702CB5D61E87026FDAA8287,31561,10,14,4,109.56792,18.28479,1765
20382,159346,C09F93BE0702CB5D61E87026FDAA8287,30854,16,23,7,109.56889,18.27076,1763
20383,159352,005F3AEFE6DBF371ED1FD57736434098,31071,1,7,6,109.58257,18.28458,1815
20384,159353,005F3AEFE6DBF371ED1FD57736434098,30854,8,19,11,109.56889,18.27076,1763
20385,159354,005F3AEFE6DBF371ED1FD57736434098,31071,21,23,2,109.58257,18.28458,1815
20386,159384,21C679D1B9FF307EA1AC2A89744209FE,38291,2,13,11,109.51618,18.24313,1558
20387,159385,21C679D1B9FF307EA1AC2A89744209FE,60281,13,16,3,109.51743,18.25924,1561
20388,159386,21C679D1B9FF307EA1AC2A89744209FE,38291,17,23,6,109.51618,18.24313,1558
20391,159391,06FCF67485A2B44C8ABC96FDB92547C5,61011,0,6,6,109.60653,18.19076,1900
20392,159393,06FCF67485A2B44C8ABC96FDB92547C5,61011,8,11,3,109.60653,18.19076,1900
20393,159395,06FCF67485A2B44C8ABC96FDB92547C5,61011,21,23,2,109.60653,18.19076,1900
20406,159534,B643AC77F8D8498A9694D45BA8B0F75F,31561,0,1,1,109.56792,18.28479,1765
20407,159535,B643AC77F8D8498A9694D45BA8B0F75F,60631,4,16,12,109.57778,18.27583,1814
20408,159536,B643AC77F8D8498A9694D45BA8B0F75F,31561,17,23,6,109.56792,18.28479,1765
20415,159599,814DB78AAB9C214E275D20A34DB679ED,30854,0,10,10,109.56889,18.27076,1763
20416,159600,814DB78AAB9C214E275D20A34DB679ED,60201,11,12,1,109.5041,18.2509,1510
20417,159601,814DB78AAB9C214E275D20A34DB679ED,30854,15,21,6,109.56889,18.27076,1763
20418,159602,814DB78AAB9C214E275D20A34DB679ED,31071,22,23,1,109.58257,18.28458,1815
20419,159659,DB7C0C5D10FF666BA5EE6412A44C4119,31271,0,3,3,109.48958,18.26257,1462
20420,159660,DB7C0C5D10FF666BA5EE6412A44C4119,31531,3,4,1,109.49583,18.25972,1461
20421,159661,DB7C0C5D10FF666BA5EE6412A44C4119,31271,5,6,1,109.48958,18.26257,1462
20422,159662,27BCEF3137923B84211F08830816C810,30851,1,17,16,109.5616,18.27396,1713
20423,159663,27BCEF3137923B84211F08830816C810,31561,17,20,3,109.56792,18.28479,1765
20424,159664,27BCEF3137923B84211F08830816C810,30851,22,23,1,109.5616,18.27396,1713
20438,159707,5426296000364EE32711CD0E73D782C8,30854,2,8,6,109.56889,18.27076,1763
20439,159708,5426296000364EE32711CD0E73D782C8,31031,10,11,1,109.49979,18.25382,1510
20440,159709,5426296000364EE32711CD0E73D782C8,31561,13,14,1,109.56792,18.28479,1765
20441,159731,4995463B780282C9C030A19D9F49AEAC,31071,3,7,4,109.58257,18.28458,1815
20442,159732,4995463B780282C9C030A19D9F49AEAC,30854,9,17,8,109.56889,18.27076,1763
20443,159733,4995463B780282C9C030A19D9F49AEAC,31071,18,22,4,109.58257,18.28458,1815
20471,159925,8C5A16299A6D294198C90C34C25C5949,30854,0,2,2,109.56889,18.27076,1763
20472,159926,8C5A16299A6D294198C90C34C25C5949,30851,3,4,1,109.5616,18.27396,1713
20473,159927,8C5A16299A6D294198C90C34C25C5949,31561,4,16,12,109.56792,18.28479,1765
20474,159928,8C5A16299A6D294198C90C34C25C5949,39183,16,23,7,109.55542,18.28208,1715
20515,160110,3BB007FDF28DB0E7E883BA594F721FFE,31181,0,1,1,109.50382,18.24813,1509
20516,160111,3BB007FDF28DB0E7E883BA594F721FFE,39151,2,5,3,109.49875,18.25097,1510
20517,160112,3BB007FDF28DB0E7E883BA594F721FFE,31181,7,23,16,109.50382,18.24813,1509
20524,160192,3968C9A12C216FF93EDF454D44490440,39371,0,10,10,109.56627,18.2646,1762
20525,160193,3968C9A12C216FF93EDF454D44490440,30951,15,16,1,109.56208,18.25667,1761
20526,160194,3968C9A12C216FF93EDF454D44490440,30851,19,22,3,109.5616,18.27396,1713
20544,160334,A68637AA89BD62624E677D9E66C32FAD,30361,2,10,8,109.50347,18.24,1508
20545,160335,A68637AA89BD62624E677D9E66C32FAD,30161,11,17,6,109.50042,18.24389,1508
20546,160336,A68637AA89BD62624E677D9E66C32FAD,30361,17,20,3,109.50347,18.24,1508
20547,160401,B17D654C0C5F0BF2FDFE2DB8B9C0B83F,31031,0,1,1,109.49979,18.25382,1510
20548,160402,B17D654C0C5F0BF2FDFE2DB8B9C0B83F,31041,2,3,1,109.50278,18.23701,1507
20549,160403,B17D654C0C5F0BF2FDFE2DB8B9C0B83F,30771,4,22,18,109.49938,18.26042,1511
20561,160517,D75B532BF6F643579E3E2D7CFBC9B3F9,31071,0,7,7,109.58257,18.28458,1815
20562,160518,D75B532BF6F643579E3E2D7CFBC9B3F9,31561,7,9,2,109.56792,18.28479,1765
20563,160519,D75B532BF6F643579E3E2D7CFBC9B3F9,31071,9,23,14,109.58257,18.28458,1815
20572,160570,46B472A67DC212EE4047EBC9FB351124,31071,0,5,5,109.58257,18.28458,1815
20573,160571,46B472A67DC212EE4047EBC9FB351124,30854,7,8,1,109.56889,18.27076,1763
20574,160572,46B472A67DC212EE4047EBC9FB351124,31071,10,23,13,109.58257,18.28458,1815
20588,160613,E21BDA79D452CC6D5F26BA60A43939EC,31261,4,5,1,109.51174,18.2466,1559
20589,160614,E21BDA79D452CC6D5F26BA60A43939EC,30371,8,14,6,109.51,18.24771,1559
20590,160615,E21BDA79D452CC6D5F26BA60A43939EC,31261,14,15,1,109.51174,18.2466,1559
20591,160616,E21BDA79D452CC6D5F26BA60A43939EC,38911,17,20,3,109.51674,18.24965,1559
20597,160653,2CE19795F2549AFE8556FD3526787FA2,31071,0,7,7,109.58257,18.28458,1815
20598,160654,2CE19795F2549AFE8556FD3526787FA2,30851,9,17,8,109.5616,18.27396,1713
20599,160655,2CE19795F2549AFE8556FD3526787FA2,31071,20,23,3,109.58257,18.28458,1815
20600,160664,84DF4A7C208235D171EF56473BCCF210,31561,5,7,2,109.56792,18.28479,1765
20601,160665,84DF4A7C208235D171EF56473BCCF210,60631,9,18,9,109.57778,18.27583,1814
20602,160666,84DF4A7C208235D171EF56473BCCF210,31071,19,21,2,109.58257,18.28458,1815
20607,160682,015CDEB9169BCE5537ABAE49B6A63F2B,31071,0,7,7,109.58257,18.28458,1815
20608,160683,015CDEB9169BCE5537ABAE49B6A63F2B,30854,8,20,12,109.56889,18.27076,1763
20609,160684,015CDEB9169BCE5537ABAE49B6A63F2B,31071,22,23,1,109.58257,18.28458,1815
20621,160715,7024F3A14F6F554DC6E80063E30315F0,30854,0,2,2,109.56889,18.27076,1763
20622,160716,7024F3A14F6F554DC6E80063E30315F0,31561,3,8,5,109.56792,18.28479,1765
20623,160717,7024F3A14F6F554DC6E80063E30315F0,39183,8,18,10,109.55542,18.28208,1715
20624,160718,7024F3A14F6F554DC6E80063E30315F0,30854,22,23,1,109.56889,18.27076,1763
20630,160764,068F8725B235C28EDCF1ACB518984443,30071,0,7,7,109.52819,18.30472,1619
20631,160765,068F8725B235C28EDCF1ACB518984443,30071,9,10,1,109.52819,18.30472,1619
20632,160766,068F8725B235C28EDCF1ACB518984443,38991,12,13,1,109.52681,18.30368,1618
20639,160808,F00821368F615DCDAF214035D8EC4A44,31071,0,1,1,109.58257,18.28458,1815
20640,160809,F00821368F615DCDAF214035D8EC4A44,30854,4,12,8,109.56889,18.27076,1763
20641,160810,F00821368F615DCDAF214035D8EC4A44,31071,12,13,1,109.58257,18.28458,1815
20642,160811,F00821368F615DCDAF214035D8EC4A44,30854,14,15,1,109.56889,18.27076,1763
20643,160816,8C0E6B51FAFE21C31FB9AE08C36DF0A2,30921,0,16,16,109.53903,18.29451,1667
20644,160817,8C0E6B51FAFE21C31FB9AE08C36DF0A2,31931,18,20,2,109.54771,18.29403,1667
20645,160818,8C0E6B51FAFE21C31FB9AE08C36DF0A2,60241,20,22,2,109.53319,18.28667,1616
20648,160830,96F98526707B06BE1263CCD4F72E07A1,30854,0,4,4,109.56889,18.27076,1763
20649,160831,96F98526707B06BE1263CCD4F72E07A1,31071,5,10,5,109.58257,18.28458,1815
20650,160832,96F98526707B06BE1263CCD4F72E07A1,30854,10,17,7,109.56889,18.27076,1763
20651,160833,96F98526707B06BE1263CCD4F72E07A1,31071,18,23,5,109.58257,18.28458,1815
20663,160910,5DFB96E5E8A111915E2B8AFE3C420F16,30531,0,1,1,109.53271,18.21472,1604
20664,160911,5DFB96E5E8A111915E2B8AFE3C420F16,31421,4,6,2,109.55382,18.22347,1705
20665,160912,5DFB96E5E8A111915E2B8AFE3C420F16,31061,7,17,10,109.53333,18.23257,1607
20666,160913,5DFB96E5E8A111915E2B8AFE3C420F16,30531,19,23,4,109.53271,18.21472,1604
20682,161154,CCCD2290FB632A48009771412BE68ADD,31561,0,14,14,109.56792,18.28479,1765
20683,161155,CCCD2290FB632A48009771412BE68ADD,39183,15,16,1,109.55542,18.28208,1715
20684,161156,CCCD2290FB632A48009771412BE68ADD,31561,18,22,4,109.56792,18.28479,1765
20688,161166,2091DB2ACA69B10ADE950A23CC278A98,30151,1,3,2,109.50986,18.25083,1560
20689,161167,2091DB2ACA69B10ADE950A23CC278A98,60361,4,12,8,109.51938,18.29681,1567
20690,161168,2091DB2ACA69B10ADE950A23CC278A98,60274,12,15,3,109.514,18.2933,1567
20691,161169,2091DB2ACA69B10ADE950A23CC278A98,31021,15,18,3,109.49021,18.27,1463
20706,161411,A55D4129A4D1B105629D337545083A9E,31561,0,7,7,109.56792,18.28479,1765
20707,161412,A55D4129A4D1B105629D337545083A9E,30854,11,12,1,109.56889,18.27076,1763
20708,161413,A55D4129A4D1B105629D337545083A9E,31561,13,14,1,109.56792,18.28479,1765
20719,161470,A8E9C7BB918ADAD29A3EA7ACDDCD32D7,38951,0,15,15,109.48097,18.28868,1416
20720,161471,A8E9C7BB918ADAD29A3EA7ACDDCD32D7,30151,16,17,1,109.50986,18.25083,1560
20721,161472,A8E9C7BB918ADAD29A3EA7ACDDCD32D7,38951,18,23,5,109.48097,18.28868,1416
20726,161509,1980C8D409DE9551539224B3D393CDAA,30071,1,2,1,109.52819,18.30472,1619
20727,161510,1980C8D409DE9551539224B3D393CDAA,30071,4,7,3,109.52819,18.30472,1619
20728,161511,1980C8D409DE9551539224B3D393CDAA,31951,7,17,10,109.52174,18.30299,1568
20729,161512,1980C8D409DE9551539224B3D393CDAA,30071,17,21,4,109.52819,18.30472,1619
20730,161535,D9AE11CD16B231308C3F0FB3F53BC3E9,30854,0,6,6,109.56889,18.27076,1763
20731,161536,D9AE11CD16B231308C3F0FB3F53BC3E9,31071,9,10,1,109.58257,18.28458,1815
20732,161537,D9AE11CD16B231308C3F0FB3F53BC3E9,30854,12,14,2,109.56889,18.27076,1763
20733,161551,174B81E807CFD6D72A51A63141915219,30764,0,2,2,109.45806,18.29486,1367
20734,161552,174B81E807CFD6D72A51A63141915219,30111,2,5,3,109.47583,18.30542,1419
20735,161553,174B81E807CFD6D72A51A63141915219,60391,6,7,1,109.47667,18.28757,1416
20736,161602,8B9A9BFD1ACAD480EB101A91DBF2024D,30371,1,2,1,109.51,18.24771,1559
20737,161603,8B9A9BFD1ACAD480EB101A91DBF2024D,38291,3,19,16,109.51618,18.24313,1558
20738,161604,8B9A9BFD1ACAD480EB101A91DBF2024D,30371,19,22,3,109.51,18.24771,1559
20744,161651,2A1AB09F11CECAAFA5576058E9461FEA,31231,1,12,11,109.42597,18.29292,1217
20745,161652,2A1AB09F11CECAAFA5576058E9461FEA,30111,15,17,2,109.47583,18.30542,1419
20746,161653,2A1AB09F11CECAAFA5576058E9461FEA,31231,19,20,1,109.42597,18.29292,1217
20751,161716,08077B5D5F0A9938A81D328635D03C8B,31071,1,6,5,109.58257,18.28458,1815
20752,161717,08077B5D5F0A9938A81D328635D03C8B,30854,8,9,1,109.56889,18.27076,1763
20753,161718,08077B5D5F0A9938A81D328635D03C8B,31071,11,12,1,109.58257,18.28458,1815
20754,161719,08077B5D5F0A9938A81D328635D03C8B,30854,12,13,1,109.56889,18.27076,1763
20768,161795,4639E7F597994307D62A7FF9CC65CC1D,31071,0,6,6,109.58257,18.28458,1815
20769,161796,4639E7F597994307D62A7FF9CC65CC1D,30854,7,15,8,109.56889,18.27076,1763
20770,161797,4639E7F597994307D62A7FF9CC65CC1D,31071,18,20,2,109.58257,18.28458,1815
20785,161900,9AA959ED87D1ECC3053DED17290EFCBD,39183,1,2,1,109.55542,18.28208,1715
20786,161901,9AA959ED87D1ECC3053DED17290EFCBD,31561,3,8,5,109.56792,18.28479,1765
20787,161902,9AA959ED87D1ECC3053DED17290EFCBD,39183,9,10,1,109.55542,18.28208,1715
20805,162031,5525BF918B1E57DF5793EBC4D3539159,30381,0,13,13,109.52521,18.24507,1609
20806,162032,5525BF918B1E57DF5793EBC4D3539159,30711,14,15,1,109.50271,18.25347,1510
20807,162033,5525BF918B1E57DF5793EBC4D3539159,30381,18,22,4,109.52521,18.24507,1609
20808,162049,40285EE8CCE25C38988EC087545664EC,31071,0,7,7,109.58257,18.28458,1815
20809,162050,40285EE8CCE25C38988EC087545664EC,30854,10,11,1,109.56889,18.27076,1763
20810,162051,40285EE8CCE25C38988EC087545664EC,31071,14,17,3,109.58257,18.28458,1815
20811,162052,40285EE8CCE25C38988EC087545664EC,30854,20,22,2,109.56889,18.27076,1763
20812,162078,3B46764DEE9C1A14D1C3F1D56B4284FD,30921,0,1,1,109.53903,18.29451,1667
20813,162079,3B46764DEE9C1A14D1C3F1D56B4284FD,60361,2,10,8,109.51938,18.29681,1567
20814,162080,3B46764DEE9C1A14D1C3F1D56B4284FD,60171,11,12,1,109.51292,18.30694,1569
20842,162293,E75CF54BA14775FEDD26504F9F6B7365,31945,0,6,6,109.58021,18.29403,1817
20843,162294,E75CF54BA14775FEDD26504F9F6B7365,31561,7,16,9,109.56792,18.28479,1765
20844,162295,E75CF54BA14775FEDD26504F9F6B7365,31945,20,23,3,109.58021,18.29403,1817
20851,162353,FA53F02C9576867AA821D2C957A0BDBE,30581,0,8,8,109.62257,18.24951,1959
20852,162354,FA53F02C9576867AA821D2C957A0BDBE,31321,9,17,8,109.63799,18.23201,2007
20853,162355,FA53F02C9576867AA821D2C957A0BDBE,30851,19,21,2,109.5616,18.27396,1713
20854,162362,2AE38FAF341950B0B91404FFCE5A0F3E,31931,0,6,6,109.54771,18.29403,1667
20855,162363,2AE38FAF341950B0B91404FFCE5A0F3E,30921,6,17,11,109.53903,18.29451,1667
20856,162364,2AE38FAF341950B0B91404FFCE5A0F3E,31931,18,20,2,109.54771,18.29403,1667
20859,162367,39F25FE146A03325C93C111F2A943B6C,31945,1,7,6,109.58021,18.29403,1817
20860,162368,39F25FE146A03325C93C111F2A943B6C,31071,8,12,4,109.58257,18.28458,1815
20861,162369,39F25FE146A03325C93C111F2A943B6C,31945,12,13,1,109.58021,18.29403,1817
20862,162382,BDC0B96180E8B3E332A3ED9C8BE261B2,30671,0,1,1,109.43611,18.30139,1268
20863,162383,BDC0B96180E8B3E332A3ED9C8BE261B2,31231,4,6,2,109.42597,18.29292,1217
20864,162384,BDC0B96180E8B3E332A3ED9C8BE261B2,30671,7,14,7,109.43611,18.30139,1268
20871,162436,CFA6DB42B4EA79576A8AEA8F93765E81,30721,0,7,7,109.51597,18.28257,1565
20872,162437,CFA6DB42B4EA79576A8AEA8F93765E81,30084,9,17,8,109.50118,18.26972,1513
20873,162438,CFA6DB42B4EA79576A8AEA8F93765E81,31206,19,20,1,109.50819,18.23549,1507
20874,162439,DFFF17B7FE30E79B8AABBB5CE171272F,30854,0,6,6,109.56889,18.27076,1763
20875,162440,DFFF17B7FE30E79B8AABBB5CE171272F,31561,8,13,5,109.56792,18.28479,1765
20876,162441,DFFF17B7FE30E79B8AABBB5CE171272F,39183,17,19,2,109.55542,18.28208,1715
20877,162442,DFFF17B7FE30E79B8AABBB5CE171272F,31561,20,22,2,109.56792,18.28479,1765
20878,162451,B34415F599F0ED7D1A073EE314A60B9B,31671,0,11,11,109.38965,18.29813,1068
20879,162452,B34415F599F0ED7D1A073EE314A60B9B,60041,14,15,1,109.39889,18.31944,1121
20880,162453,B34415F599F0ED7D1A073EE314A60B9B,31671,20,22,2,109.38965,18.29813,1068
20887,162526,E0A24740E2C54F3B77DB561A91D2BED7,30151,0,7,7,109.50986,18.25083,1560
20888,162527,E0A24740E2C54F3B77DB561A91D2BED7,30251,8,12,4,109.50611,18.26653,1512
20889,162528,E0A24740E2C54F3B77DB561A91D2BED7,30251,12,18,6,109.50611,18.26653,1512
20890,162529,E0A24740E2C54F3B77DB561A91D2BED7,31821,18,23,5,109.51181,18.24924,1559
20891,162594,8AFD8FEB1A2AFA5CA33EEEE08ED05D66,60501,0,1,1,109.48701,18.29021,1466
20892,162595,8AFD8FEB1A2AFA5CA33EEEE08ED05D66,60504,4,5,1,109.47917,18.28903,1416
20893,162596,8AFD8FEB1A2AFA5CA33EEEE08ED05D66,30111,6,7,1,109.47583,18.30542,1419
20894,162635,979ABBB43C3434EE96D76E04CFC66E55,39151,0,4,4,109.49875,18.25097,1510
20895,162636,979ABBB43C3434EE96D76E04CFC66E55,60131,4,7,3,109.49819,18.24778,1509
20896,162637,979ABBB43C3434EE96D76E04CFC66E55,60201,7,23,16,109.5041,18.2509,1510
20908,162706,982A3533FF2DE923A7996414ED8DF792,31945,1,2,1,109.58021,18.29403,1817
20909,162707,982A3533FF2DE923A7996414ED8DF792,60631,4,5,1,109.57778,18.27583,1814
20910,162708,982A3533FF2DE923A7996414ED8DF792,31071,7,8,1,109.58257,18.28458,1815
20911,162715,87ACF3C6ADE430D2B9DFB3C954E0C031,31071,4,9,5,109.58257,18.28458,1815
20912,162716,87ACF3C6ADE430D2B9DFB3C954E0C031,39183,10,21,11,109.55542,18.28208,1715
20913,162717,87ACF3C6ADE430D2B9DFB3C954E0C031,31071,21,23,2,109.58257,18.28458,1815
20914,162732,EA446444DFE25212830F95291C13D19D,31931,1,13,12,109.54771,18.29403,1667
20915,162733,EA446444DFE25212830F95291C13D19D,39181,13,15,2,109.55153,18.28035,1715
20916,162734,EA446444DFE25212830F95291C13D19D,31931,16,17,1,109.54771,18.29403,1667
20917,162735,EA446444DFE25212830F95291C13D19D,39181,19,20,1,109.55153,18.28035,1715
20918,162760,1E93239453A807F80FEB34C902C59FA1,48601,0,4,4,109.51694,18.22514,1555
20919,162761,1E93239453A807F80FEB34C902C59FA1,60291,5,7,2,109.50826,18.24639,1509
20920,162762,1E93239453A807F80FEB34C902C59FA1,31521,7,12,5,109.51458,18.22542,1555
20921,162773,967E548F53382C36FB0D7FF12F6A99E7,31531,0,5,5,109.49583,18.25972,1461
20922,162774,967E548F53382C36FB0D7FF12F6A99E7,60331,7,10,3,109.505,18.26507,1512
20923,162775,967E548F53382C36FB0D7FF12F6A99E7,31531,11,13,2,109.49583,18.25972,1461
20924,162776,967E548F53382C36FB0D7FF12F6A99E7,60161,16,20,4,109.49174,18.26181,1461
20941,163090,452F0FF6BC36839041DCBEF2292D6E55,60661,0,8,8,109.548,18.2377,1657
20942,163091,452F0FF6BC36839041DCBEF2292D6E55,30861,10,12,2,109.52722,18.22743,1606
20943,163093,452F0FF6BC36839041DCBEF2292D6E55,60381,22,23,1,109.5241,18.22458,1605
20976,163220,410ABF8C14ACED0B5467A09396FAD1E3,31071,1,5,4,109.58257,18.28458,1815
20977,163221,410ABF8C14ACED0B5467A09396FAD1E3,31945,8,9,1,109.58021,18.29403,1817
20978,163222,410ABF8C14ACED0B5467A09396FAD1E3,30854,12,20,8,109.56889,18.27076,1763
20989,163359,B84B247FA61A8C12DFCCCF3C2D72006D,31071,3,9,6,109.58257,18.28458,1815
20990,163360,B84B247FA61A8C12DFCCCF3C2D72006D,30854,9,10,1,109.56889,18.27076,1763
20991,163361,B84B247FA61A8C12DFCCCF3C2D72006D,31071,11,19,8,109.58257,18.28458,1815
20992,163362,B84B247FA61A8C12DFCCCF3C2D72006D,30854,20,21,1,109.56889,18.27076,1763
21007,163457,C1C69C0EAD4ABEFD1467543102429D9B,30854,1,2,1,109.56889,18.27076,1763
21008,163458,C1C69C0EAD4ABEFD1467543102429D9B,39183,4,5,1,109.55542,18.28208,1715
21009,163459,C1C69C0EAD4ABEFD1467543102429D9B,31561,5,14,9,109.56792,18.28479,1765
21010,163460,C1C69C0EAD4ABEFD1467543102429D9B,30281,18,23,5,109.50597,18.27583,1514
21021,163507,1254ED270726E34A8E3E0767CE400812,31071,3,5,2,109.58257,18.28458,1815
21022,163508,1254ED270726E34A8E3E0767CE400812,31945,8,10,2,109.58021,18.29403,1817
21023,163509,1254ED270726E34A8E3E0767CE400812,31071,12,17,5,109.58257,18.28458,1815
21024,163517,CFFDD1BF3134B9FDD71614F40E1DE0FD,30854,2,4,2,109.56889,18.27076,1763
21025,163518,CFFDD1BF3134B9FDD71614F40E1DE0FD,31071,4,6,2,109.58257,18.28458,1815
21026,163519,CFFDD1BF3134B9FDD71614F40E1DE0FD,31945,10,11,1,109.58021,18.29403,1817
21027,163520,CFFDD1BF3134B9FDD71614F40E1DE0FD,31071,14,21,7,109.58257,18.28458,1815
21047,163610,1644C78B6566683D75956618DC25318D,31061,0,8,8,109.53333,18.23257,1607
21048,163611,1644C78B6566683D75956618DC25318D,30161,9,13,4,109.50042,18.24389,1508
21049,163612,1644C78B6566683D75956618DC25318D,31061,13,23,10,109.53333,18.23257,1607
21067,163768,77F4AC7CCE20E40974362ED501828AE5,60621,2,7,5,109.48354,18.27451,1464
21068,163769,77F4AC7CCE20E40974362ED501828AE5,60161,9,14,5,109.49174,18.26181,1461
21069,163770,77F4AC7CCE20E40974362ED501828AE5,31411,18,19,1,109.5016,18.23576,1507
21091,163926,0D1B933C65704EEE0CFA016AED0F8FDF,31071,1,2,1,109.58257,18.28458,1815
21092,163927,0D1B933C65704EEE0CFA016AED0F8FDF,30854,3,10,7,109.56889,18.27076,1763
21093,163928,0D1B933C65704EEE0CFA016AED0F8FDF,31071,14,23,9,109.58257,18.28458,1815
21094,163978,4D4289AE0DFBF4B5C79A47559DC2EBDD,31071,1,6,5,109.58257,18.28458,1815
21095,163979,4D4289AE0DFBF4B5C79A47559DC2EBDD,30854,6,7,1,109.56889,18.27076,1763
21096,163980,4D4289AE0DFBF4B5C79A47559DC2EBDD,39371,8,10,2,109.56627,18.2646,1762
21113,164082,E58E5EFF0A1D7ADABE8F5BBEE665ED0D,39321,2,7,5,109.529,18.2167,1604
21114,164083,E58E5EFF0A1D7ADABE8F5BBEE665ED0D,30861,8,13,5,109.52722,18.22743,1606
21115,164084,E58E5EFF0A1D7ADABE8F5BBEE665ED0D,31061,15,16,1,109.53333,18.23257,1607
21116,164085,E58E5EFF0A1D7ADABE8F5BBEE665ED0D,30861,17,22,5,109.52722,18.22743,1606
21119,164113,7E95AEA91A37473FF71C625BDD54FD92,60361,0,1,1,109.51938,18.29681,1567
21120,164114,7E95AEA91A37473FF71C625BDD54FD92,60226,3,4,1,109.5175,18.28778,1566
21121,164115,7E95AEA91A37473FF71C625BDD54FD92,60361,4,21,17,109.51938,18.29681,1567
21146,164316,90D91A493F9482486DCC3B27CF3F61EE,30854,0,7,7,109.56889,18.27076,1763
21147,164317,90D91A493F9482486DCC3B27CF3F61EE,31071,10,12,2,109.58257,18.28458,1815
21148,164318,90D91A493F9482486DCC3B27CF3F61EE,30854,15,16,1,109.56889,18.27076,1763
21151,164342,15195C578D4A8081B069C4B518039EFC,60231,1,6,5,109.49903,18.21972,1504
21152,164343,15195C578D4A8081B069C4B518039EFC,60161,9,10,1,109.49174,18.26181,1461
21153,164344,15195C578D4A8081B069C4B518039EFC,30051,11,14,3,109.48917,18.21215,1453
21154,164345,15195C578D4A8081B069C4B518039EFC,60161,16,22,6,109.49174,18.26181,1461
21162,164383,BD5D5103B08534F20AF53FB58E9A43CA,38241,1,5,4,109.54111,18.30542,1669
21163,164384,BD5D5103B08534F20AF53FB58E9A43CA,31931,5,6,1,109.54771,18.29403,1667
21164,164385,BD5D5103B08534F20AF53FB58E9A43CA,38241,7,9,2,109.54111,18.30542,1669
21165,164386,BD5D5103B08534F20AF53FB58E9A43CA,31931,11,13,2,109.54771,18.29403,1667
21170,164406,DD8DCE806AFFEAC5D779812E5F8F2B3D,30281,1,4,3,109.50597,18.27583,1514
21171,164407,DD8DCE806AFFEAC5D779812E5F8F2B3D,31071,6,9,3,109.58257,18.28458,1815
21172,164408,DD8DCE806AFFEAC5D779812E5F8F2B3D,30854,10,11,1,109.56889,18.27076,1763
21173,164409,DD8DCE806AFFEAC5D779812E5F8F2B3D,31071,13,14,1,109.58257,18.28458,1815
21184,164455,A969AA4D78FD71B9F4E643F763F4C75F,30221,0,7,7,109.57833,18.20222,1802
21185,164456,A969AA4D78FD71B9F4E643F763F4C75F,31521,7,9,2,109.51458,18.22542,1555
21186,164457,A969AA4D78FD71B9F4E643F763F4C75F,31521,11,21,10,109.51458,18.22542,1555
21187,164458,A969AA4D78FD71B9F4E643F763F4C75F,60381,21,23,2,109.5241,18.22458,1605
21195,164556,FF8CB3D02361FAEBFE418108180099D8,39154,0,6,6,109.50201,18.25681,1511
21196,164557,FF8CB3D02361FAEBFE418108180099D8,60201,6,15,9,109.5041,18.2509,1510
21197,164558,FF8CB3D02361FAEBFE418108180099D8,30711,15,22,7,109.50271,18.25347,1510
21198,164578,D4EE8E1A4C04A1FF0596E4221D0B8B42,31071,1,5,4,109.58257,18.28458,1815
21199,164579,D4EE8E1A4C04A1FF0596E4221D0B8B42,30854,7,8,1,109.56889,18.27076,1763
21200,164580,D4EE8E1A4C04A1FF0596E4221D0B8B42,31221,8,10,2,109.61333,18.26833,1913
21201,164581,D4EE8E1A4C04A1FF0596E4221D0B8B42,30854,12,13,1,109.56889,18.27076,1763
21202,164603,5A888DC7A3AA300CC584D9862C5384A1,30421,4,6,2,109.50021,18.25861,1511
21203,164604,5A888DC7A3AA300CC584D9862C5384A1,30771,7,9,2,109.49938,18.26042,1511
21204,164605,5A888DC7A3AA300CC584D9862C5384A1,39183,12,18,6,109.55542,18.28208,1715
21205,164627,45FC4D7B7AEB1BB8222449DDC064C06B,31945,0,6,6,109.58021,18.29403,1817
21206,164628,45FC4D7B7AEB1BB8222449DDC064C06B,30854,8,9,1,109.56889,18.27076,1763
21207,164629,45FC4D7B7AEB1BB8222449DDC064C06B,31945,9,22,13,109.58021,18.29403,1817
21224,164859,17D13F6A66037B54FAB5668CDC734401,30721,0,7,7,109.51597,18.28257,1565
21225,164860,17D13F6A66037B54FAB5668CDC734401,31931,9,17,8,109.54771,18.29403,1667
21226,164861,17D13F6A66037B54FAB5668CDC734401,30721,19,23,4,109.51597,18.28257,1565
21227,164909,430614CCBE3C6FA65CA55D075D8A9EA2,31071,0,6,6,109.58257,18.28458,1815
21228,164910,430614CCBE3C6FA65CA55D075D8A9EA2,31945,8,9,1,109.58021,18.29403,1817
21229,164911,430614CCBE3C6FA65CA55D075D8A9EA2,30854,12,17,5,109.56889,18.27076,1763
21230,164912,430614CCBE3C6FA65CA55D075D8A9EA2,31071,19,23,4,109.58257,18.28458,1815
21242,164939,8D3B10FD4DBC46DB93DA60040668F697,30854,0,13,13,109.56889,18.27076,1763
21243,164940,8D3B10FD4DBC46DB93DA60040668F697,39183,15,16,1,109.55542,18.28208,1715
21244,164941,8D3B10FD4DBC46DB93DA60040668F697,30854,19,23,4,109.56889,18.27076,1763
21253,165084,EB291EA7E3235FF23960DA865075F183,60281,0,7,7,109.51743,18.25924,1561
21254,165085,EB291EA7E3235FF23960DA865075F183,39101,8,12,4,109.50132,18.24931,1509
21255,165086,EB291EA7E3235FF23960DA865075F183,60281,13,14,1,109.51743,18.25924,1561
21256,165087,EB291EA7E3235FF23960DA865075F183,39091,14,15,1,109.50097,18.25222,1510
21257,165099,BBE4FEE5DC356F34A55E0F5D610B7841,38961,0,5,5,109.50847,18.23514,1507
21258,165100,BBE4FEE5DC356F34A55E0F5D610B7841,31201,6,7,1,109.51042,18.23819,1558
21259,165101,BBE4FEE5DC356F34A55E0F5D610B7841,31201,10,19,9,109.51042,18.23819,1558
21260,165102,BBE4FEE5DC356F34A55E0F5D610B7841,38961,21,22,1,109.50847,18.23514,1507
21268,165167,E9F64FD67E39C3E2C15C20715338A941,30921,0,9,9,109.53903,18.29451,1667
21269,165168,E9F64FD67E39C3E2C15C20715338A941,31931,11,13,2,109.54771,18.29403,1667
21270,165169,E9F64FD67E39C3E2C15C20715338A941,30921,15,18,3,109.53903,18.29451,1667
21271,165170,E9F64FD67E39C3E2C15C20715338A941,31931,18,19,1,109.54771,18.29403,1667
21272,165237,13C882817D5EF3329D8612AEE7E0F34D,31864,0,15,15,109.49014,18.28333,1465
21273,165238,13C882817D5EF3329D8612AEE7E0F34D,30711,15,16,1,109.50271,18.25347,1510
21274,165239,13C882817D5EF3329D8612AEE7E0F34D,31864,17,18,1,109.49014,18.28333,1465
21275,165240,13C882817D5EF3329D8612AEE7E0F34D,30084,19,22,3,109.50118,18.26972,1513
21282,165270,CBA29FB366E4111071C95C99C696D0E6,31561,0,8,8,109.56792,18.28479,1765
21283,165271,CBA29FB366E4111071C95C99C696D0E6,30854,8,11,3,109.56889,18.27076,1763
21284,165272,CBA29FB366E4111071C95C99C696D0E6,31561,11,20,9,109.56792,18.28479,1765
21285,165273,CBA29FB366E4111071C95C99C696D0E6,30854,20,21,1,109.56889,18.27076,1763
21291,165360,4B004637D3CFBCA65EA00FFD3F1EF7A6,30854,0,3,3,109.56889,18.27076,1763
21292,165361,4B004637D3CFBCA65EA00FFD3F1EF7A6,39183,3,11,8,109.55542,18.28208,1715
21293,165362,4B004637D3CFBCA65EA00FFD3F1EF7A6,31561,11,13,2,109.56792,18.28479,1765
21294,165363,FA6D7510012E571D09E23E75BE9DD4E6,60441,2,6,4,109.46792,18.28604,1366
21295,165364,FA6D7510012E571D09E23E75BE9DD4E6,38251,9,10,1,109.49618,18.25493,1510
21296,165365,FA6D7510012E571D09E23E75BE9DD4E6,31031,14,22,8,109.49979,18.25382,1510
21306,165439,EBD16061EA20EE33D9344D33735E5205,38891,0,6,6,109.51486,18.24118,1558
21307,165440,EBD16061EA20EE33D9344D33735E5205,31261,8,10,2,109.51174,18.2466,1559
21308,165441,EBD16061EA20EE33D9344D33735E5205,31201,10,19,9,109.51042,18.23819,1558
21309,165442,EBD16061EA20EE33D9344D33735E5205,38891,20,21,1,109.51486,18.24118,1558
21319,165546,DE85A2F9432633114A7B9A1B323B8AE9,30051,0,8,8,109.48917,18.21215,1453
21320,165547,DE85A2F9432633114A7B9A1B323B8AE9,60231,8,10,2,109.49903,18.21972,1504
21321,165548,DE85A2F9432633114A7B9A1B323B8AE9,30051,10,23,13,109.48917,18.21215,1453
21331,165601,5EBEA276FCB4A19AC5C987F5C7CC8908,60524,0,6,6,109.42951,18.28993,1216
21332,165602,5EBEA276FCB4A19AC5C987F5C7CC8908,60401,7,18,11,109.47444,18.27583,1414
21333,165603,5EBEA276FCB4A19AC5C987F5C7CC8908,60552,18,20,2,109.41729,18.30014,1218
21334,165604,5EBEA276FCB4A19AC5C987F5C7CC8908,38361,20,21,1,109.43667,18.29201,1267
21340,165632,45086BC0869D90A8E8F669EDA6561CFA,31071,0,1,1,109.58257,18.28458,1815
21341,165633,45086BC0869D90A8E8F669EDA6561CFA,31945,1,14,13,109.58021,18.29403,1817
21342,165634,45086BC0869D90A8E8F669EDA6561CFA,31071,17,23,6,109.58257,18.28458,1815
21360,165693,1FC5887E4053936D3ED4D738338DC172,30121,0,7,7,109.52861,18.27222,1613
21361,165694,1FC5887E4053936D3ED4D738338DC172,30851,8,9,1,109.5616,18.27396,1713
21362,165695,1FC5887E4053936D3ED4D738338DC172,30951,9,17,8,109.56208,18.25667,1761
21363,165696,B55959B64746A18ECF5077B5F7359221,31561,1,8,7,109.56792,18.28479,1765
21364,165697,B55959B64746A18ECF5077B5F7359221,39183,9,10,1,109.55542,18.28208,1715
21365,165698,B55959B64746A18ECF5077B5F7359221,31561,11,12,1,109.56792,18.28479,1765
21366,165699,B55959B64746A18ECF5077B5F7359221,30854,17,18,1,109.56889,18.27076,1763
21367,165768,D1E9F173C78819C710E28E8ACB6462D5,31391,0,9,9,109.50382,18.24285,1508
21368,165769,D1E9F173C78819C710E28E8ACB6462D5,30181,10,12,2,109.51597,18.23313,1557
21369,165770,D1E9F173C78819C710E28E8ACB6462D5,31201,13,18,5,109.51042,18.23819,1558
21403,166107,E65658506C2BF9C993BA69EE6D38B3C6,31951,0,1,1,109.52174,18.30299,1568
21404,166108,E65658506C2BF9C993BA69EE6D38B3C6,60361,2,5,3,109.51938,18.29681,1567
21405,166109,E65658506C2BF9C993BA69EE6D38B3C6,31951,6,8,2,109.52174,18.30299,1568
21406,166110,E65658506C2BF9C993BA69EE6D38B3C6,60361,10,14,4,109.51938,18.29681,1567
21420,166214,C93386A9D86FE22A1FD4E5116045DD8D,31561,0,6,6,109.56792,18.28479,1765
21421,166215,C93386A9D86FE22A1FD4E5116045DD8D,39183,10,18,8,109.55542,18.28208,1715
21422,166216,C93386A9D86FE22A1FD4E5116045DD8D,30854,19,21,2,109.56889,18.27076,1763
21423,166217,C93386A9D86FE22A1FD4E5116045DD8D,31561,21,23,2,109.56792,18.28479,1765
21442,166425,0133DDFFB5CECBB261CEDEF10A82D50B,30854,0,5,5,109.56889,18.27076,1763
21443,166426,0133DDFFB5CECBB261CEDEF10A82D50B,31561,8,10,2,109.56792,18.28479,1765
21444,166427,0133DDFFB5CECBB261CEDEF10A82D50B,31071,12,14,2,109.58257,18.28458,1815
21445,166428,0133DDFFB5CECBB261CEDEF10A82D50B,30854,15,17,2,109.56889,18.27076,1763
21446,166450,0841B38EFEEE80E4084E126D1C4D1973,31561,0,16,16,109.56792,18.28479,1765
21447,166451,0841B38EFEEE80E4084E126D1C4D1973,30854,16,19,3,109.56889,18.27076,1763
21448,166452,0841B38EFEEE80E4084E126D1C4D1973,31561,20,23,3,109.56792,18.28479,1765
21449,166477,0E129C09250C0D46273B4BD7E5225556,30151,0,6,6,109.50986,18.25083,1560
21450,166478,0E129C09250C0D46273B4BD7E5225556,30421,7,12,5,109.50021,18.25861,1511
21451,166479,0E129C09250C0D46273B4BD7E5225556,30151,16,18,2,109.50986,18.25083,1560
21452,166480,0E129C09250C0D46273B4BD7E5225556,60463,19,21,2,109.52507,18.22438,1605
21460,166525,1D4558B4C0B5F77B61048106C84086AA,60551,2,7,5,109.42722,18.30111,1218
21461,166526,1D4558B4C0B5F77B61048106C84086AA,31231,7,8,1,109.42597,18.29292,1217
21462,166527,1D4558B4C0B5F77B61048106C84086AA,31231,8,23,15,109.42597,18.29292,1217
21463,166573,C709D01469E0800AF998DFAF42105CDC,60631,0,6,6,109.57778,18.27583,1814
21464,166574,C709D01469E0800AF998DFAF42105CDC,31561,8,17,9,109.56792,18.28479,1765
21465,166575,C709D01469E0800AF998DFAF42105CDC,30854,18,23,5,109.56889,18.27076,1763
21493,166832,4E9347808E8F02AFB816F8344D637F34,38961,0,1,1,109.50847,18.23514,1507
21494,166833,4E9347808E8F02AFB816F8344D637F34,30741,2,18,16,109.49833,18.28681,1516
21495,166834,4E9347808E8F02AFB816F8344D637F34,30421,19,20,1,109.50021,18.25861,1511
21503,166942,1FE2866848043A2C10AD87212485FE15,31071,3,4,1,109.58257,18.28458,1815
21504,166943,1FE2866848043A2C10AD87212485FE15,30854,4,5,1,109.56889,18.27076,1763
21505,166944,1FE2866848043A2C10AD87212485FE15,31071,6,7,1,109.58257,18.28458,1815
21517,167095,A7B3BDD8DC79485BA41EC7F220A41345,60631,1,8,7,109.57778,18.27583,1814
21518,167096,A7B3BDD8DC79485BA41EC7F220A41345,30854,12,15,3,109.56889,18.27076,1763
21519,167097,A7B3BDD8DC79485BA41EC7F220A41345,60631,15,17,2,109.57778,18.27583,1814
21524,167116,B0D7DAF8D84656FF4C7229ABB8EA1350,31561,0,17,17,109.56792,18.28479,1765
21525,167117,B0D7DAF8D84656FF4C7229ABB8EA1350,30854,18,20,2,109.56889,18.27076,1763
21526,167118,B0D7DAF8D84656FF4C7229ABB8EA1350,31561,20,21,1,109.56792,18.28479,1765
21532,167225,8DA7661E8E46B66EF011FB9B9FA15609,38061,0,9,9,109.50597,18.23118,1506
21533,167226,8DA7661E8E46B66EF011FB9B9FA15609,39111,11,12,1,109.5191,18.22597,1555
21534,167227,8DA7661E8E46B66EF011FB9B9FA15609,60381,15,17,2,109.5241,18.22458,1605
21535,167228,8DA7661E8E46B66EF011FB9B9FA15609,39111,20,22,2,109.5191,18.22597,1555
21542,167261,B78E7295CB13532B4E2C30EF158E297F,39183,0,10,10,109.55542,18.28208,1715
21543,167262,B78E7295CB13532B4E2C30EF158E297F,30851,12,14,2,109.5616,18.27396,1713
21544,167263,B78E7295CB13532B4E2C30EF158E297F,31931,15,16,1,109.54771,18.29403,1667
21554,167315,8BE73BF558E3512B54F879E678FCD6C7,31201,3,10,7,109.51042,18.23819,1558
21555,167316,8BE73BF558E3512B54F879E678FCD6C7,31521,12,14,2,109.51458,18.22542,1555
21556,167317,8BE73BF558E3512B54F879E678FCD6C7,31521,15,16,1,109.51458,18.22542,1555
21557,167331,64EA917EAAD3EB55DA2ABB227203C131,60631,0,7,7,109.57778,18.27583,1814
21558,167332,64EA917EAAD3EB55DA2ABB227203C131,30854,12,15,3,109.56889,18.27076,1763
21559,167333,64EA917EAAD3EB55DA2ABB227203C131,60631,19,20,1,109.57778,18.27583,1814
21560,167334,64EA917EAAD3EB55DA2ABB227203C131,30851,21,22,1,109.5616,18.27396,1713
21569,167427,A928E9F6C796FE1A60807BA003DE87BB,30854,3,5,2,109.56889,18.27076,1763
21570,167428,A928E9F6C796FE1A60807BA003DE87BB,39181,9,17,8,109.55153,18.28035,1715
21571,167429,A928E9F6C796FE1A60807BA003DE87BB,30854,22,23,1,109.56889,18.27076,1763
21607,167604,D090D23BEAB243AAF74CB3648E81F65B,30851,4,7,3,109.5616,18.27396,1713
21608,167605,D090D23BEAB243AAF74CB3648E81F65B,31561,7,19,12,109.56792,18.28479,1765
21609,167606,D090D23BEAB243AAF74CB3648E81F65B,30851,19,20,1,109.5616,18.27396,1713
21610,167650,608A55C14BAB2A5B627ACC1F39B89FB6,31945,0,7,7,109.58021,18.29403,1817
21611,167651,608A55C14BAB2A5B627ACC1F39B89FB6,31071,8,10,2,109.58257,18.28458,1815
21612,167652,608A55C14BAB2A5B627ACC1F39B89FB6,31945,12,13,1,109.58021,18.29403,1817
21613,167653,608A55C14BAB2A5B627ACC1F39B89FB6,30854,13,15,2,109.56889,18.27076,1763
21623,167732,10EBF762D28520B09848288F7052CFDE,30854,0,7,7,109.56889,18.27076,1763
21624,167733,10EBF762D28520B09848288F7052CFDE,31561,8,17,9,109.56792,18.28479,1765
21625,167734,10EBF762D28520B09848288F7052CFDE,30854,20,23,3,109.56889,18.27076,1763
21627,167748,66DAA2740440F603A26B0FC0D4309DF2,30921,0,5,5,109.53903,18.29451,1667
21628,167749,66DAA2740440F603A26B0FC0D4309DF2,31931,7,8,1,109.54771,18.29403,1667
21629,167750,66DAA2740440F603A26B0FC0D4309DF2,30921,11,12,1,109.53903,18.29451,1667
21647,167965,89A01963B06628A3D6B13DA41FA507D1,31561,0,6,6,109.56792,18.28479,1765
21648,167966,89A01963B06628A3D6B13DA41FA507D1,30854,7,9,2,109.56889,18.27076,1763
21649,167967,89A01963B06628A3D6B13DA41FA507D1,31561,10,11,1,109.56792,18.28479,1765
21650,167968,89A01963B06628A3D6B13DA41FA507D1,30854,15,16,1,109.56889,18.27076,1763
21656,167989,7421066246AAD1C230E7E2A7ADF06E9D,60631,0,6,6,109.57778,18.27583,1814
21657,167990,7421066246AAD1C230E7E2A7ADF06E9D,30854,7,17,10,109.56889,18.27076,1763
21658,167991,7421066246AAD1C230E7E2A7ADF06E9D,60631,22,23,1,109.57778,18.27583,1814
21659,168012,BA14D3A3DF052B077104F1218BF7563E,31261,1,7,6,109.51174,18.2466,1559
21660,168013,BA14D3A3DF052B077104F1218BF7563E,31181,10,12,2,109.50382,18.24813,1509
21661,168014,BA14D3A3DF052B077104F1218BF7563E,31261,13,14,1,109.51174,18.2466,1559
21662,168015,A01B4012B619D942E7CC3AC9B78722B4,39183,2,5,3,109.55542,18.28208,1715
21663,168016,A01B4012B619D942E7CC3AC9B78722B4,31561,9,13,4,109.56792,18.28479,1765
21664,168017,A01B4012B619D942E7CC3AC9B78722B4,31931,13,15,2,109.54771,18.29403,1667
21665,168028,C153552CEA2677B0FF473AE565EA979E,30821,0,12,12,109.43681,18.33639,1274
21666,168029,C153552CEA2677B0FF473AE565EA979E,60424,15,17,2,109.44611,18.31736,1321
21667,168030,C153552CEA2677B0FF473AE565EA979E,30821,19,23,4,109.43681,18.33639,1274
21668,168036,417408FFDA93B177641D270D3A5C4B2D,31071,0,7,7,109.58257,18.28458,1815
21669,168037,417408FFDA93B177641D270D3A5C4B2D,30854,7,19,12,109.56889,18.27076,1763
21670,168038,417408FFDA93B177641D270D3A5C4B2D,31071,21,23,2,109.58257,18.28458,1815
21671,168081,28F7DFD4A036DBA4E68AFC71762D44D7,39371,1,2,1,109.56627,18.2646,1762
21672,168082,28F7DFD4A036DBA4E68AFC71762D44D7,30851,4,5,1,109.5616,18.27396,1713
21673,168083,28F7DFD4A036DBA4E68AFC71762D44D7,30951,8,15,7,109.56208,18.25667,1761
21674,168084,28F7DFD4A036DBA4E68AFC71762D44D7,31561,19,23,4,109.56792,18.28479,1765
21678,168104,AD6CE74FEECB42F7806A62DA7A4CECCA,39183,1,6,5,109.55542,18.28208,1715
21679,168105,AD6CE74FEECB42F7806A62DA7A4CECCA,31071,10,11,1,109.58257,18.28458,1815
21680,168106,AD6CE74FEECB42F7806A62DA7A4CECCA,30854,11,13,2,109.56889,18.27076,1763
21694,168225,8DD23AA43C0F7967C45F7488D66F9159,31071,1,8,7,109.58257,18.28458,1815
21695,168226,8DD23AA43C0F7967C45F7488D66F9159,31945,10,11,1,109.58021,18.29403,1817
21696,168227,8DD23AA43C0F7967C45F7488D66F9159,30854,15,21,6,109.56889,18.27076,1763
21718,168430,410D55EA73A3884577B7B9B7E86B067E,30084,1,7,6,109.50118,18.26972,1513
21719,168431,410D55EA73A3884577B7B9B7E86B067E,30084,8,14,6,109.50118,18.26972,1513
21720,168432,410D55EA73A3884577B7B9B7E86B067E,30084,17,22,5,109.50118,18.26972,1513
21725,168475,2A6BA0678DDF16AF08BAC9E3FA3C9391,31561,0,2,2,109.56792,18.28479,1765
21726,168476,2A6BA0678DDF16AF08BAC9E3FA3C9391,30854,2,3,1,109.56889,18.27076,1763
21727,168477,2A6BA0678DDF16AF08BAC9E3FA3C9391,31561,3,6,3,109.56792,18.28479,1765
21728,168478,2A6BA0678DDF16AF08BAC9E3FA3C9391,30854,9,19,10,109.56889,18.27076,1763
21734,168508,EA4D123112CD0AE32B6D1280D2074CF8,30921,0,18,18,109.53903,18.29451,1667
21735,168509,EA4D123112CD0AE32B6D1280D2074CF8,30911,19,20,1,109.50493,18.26181,1511
21736,168510,EA4D123112CD0AE32B6D1280D2074CF8,60621,21,22,1,109.48354,18.27451,1464
21737,168524,75817DB682187A07461734D66E1E6492,60631,0,4,4,109.57778,18.27583,1814
21738,168525,75817DB682187A07461734D66E1E6492,30854,4,10,6,109.56889,18.27076,1763
21739,168526,75817DB682187A07461734D66E1E6492,31071,14,15,1,109.58257,18.28458,1815
21740,168527,75817DB682187A07461734D66E1E6492,60631,18,23,5,109.57778,18.27583,1814
21744,168558,005F3AEFE6DBF371ED1FD57736434098,31071,0,7,7,109.58257,18.28458,1815
21745,168559,005F3AEFE6DBF371ED1FD57736434098,30854,8,10,2,109.56889,18.27076,1763
21746,168560,005F3AEFE6DBF371ED1FD57736434098,31071,10,11,1,109.58257,18.28458,1815
21752,168600,34F3D64B41C252481F72E5CF931AC833,39181,0,1,1,109.55153,18.28035,1715
21753,168601,34F3D64B41C252481F72E5CF931AC833,30851,2,14,12,109.5616,18.27396,1713
21754,168602,34F3D64B41C252481F72E5CF931AC833,31071,14,16,2,109.58257,18.28458,1815
21765,168646,95E09A72760B2799C2CC9BD7AF527107,31071,0,4,4,109.58257,18.28458,1815
21766,168647,95E09A72760B2799C2CC9BD7AF527107,30854,9,10,1,109.56889,18.27076,1763
21767,168648,95E09A72760B2799C2CC9BD7AF527107,31071,13,14,1,109.58257,18.28458,1815
21768,168649,95E09A72760B2799C2CC9BD7AF527107,30854,14,23,9,109.56889,18.27076,1763
21769,168666,EC70F9D6B8EC4124E51EFCFD87BAFA84,60504,0,8,8,109.47917,18.28903,1416
21770,168667,EC70F9D6B8EC4124E51EFCFD87BAFA84,38903,11,16,5,109.39229,18.29243,1117
21771,168668,EC70F9D6B8EC4124E51EFCFD87BAFA84,30324,18,20,2,109.50326,18.29257,1517
21772,168669,EC70F9D6B8EC4124E51EFCFD87BAFA84,60504,21,23,2,109.47917,18.28903,1416
21781,168724,C19430CE8DF26BDEF43903E57E682236,31561,0,14,14,109.56792,18.28479,1765
21782,168725,C19430CE8DF26BDEF43903E57E682236,30854,15,17,2,109.56889,18.27076,1763
21783,168726,C19430CE8DF26BDEF43903E57E682236,31561,19,23,4,109.56792,18.28479,1765
21784,168778,B643AC77F8D8498A9694D45BA8B0F75F,31561,0,1,1,109.56792,18.28479,1765
21785,168779,B643AC77F8D8498A9694D45BA8B0F75F,60631,5,16,11,109.57778,18.27583,1814
21786,168780,B643AC77F8D8498A9694D45BA8B0F75F,30854,18,19,1,109.56889,18.27076,1763
21787,168781,B643AC77F8D8498A9694D45BA8B0F75F,60631,21,23,2,109.57778,18.27583,1814
21793,168911,5426296000364EE32711CD0E73D782C8,30854,0,8,8,109.56889,18.27076,1763
21794,168912,5426296000364EE32711CD0E73D782C8,31561,13,20,7,109.56792,18.28479,1765
21795,168913,5426296000364EE32711CD0E73D782C8,30854,22,23,1,109.56889,18.27076,1763
21805,169034,00FD2268DE6E83934D2916174E81532F,60472,0,6,6,109.46625,18.29542,1367
21806,169035,00FD2268DE6E83934D2916174E81532F,30761,9,10,1,109.45201,18.3,1318
21807,169036,00FD2268DE6E83934D2916174E81532F,30111,10,23,13,109.47583,18.30542,1419
21824,169116,F198CAA1F49ACA5D003FD8F8473B3798,31071,1,11,10,109.58257,18.28458,1815
21825,169117,F198CAA1F49ACA5D003FD8F8473B3798,30854,11,13,2,109.56889,18.27076,1763
21826,169118,F198CAA1F49ACA5D003FD8F8473B3798,31071,13,21,8,109.58257,18.28458,1815
21827,169119,F198CAA1F49ACA5D003FD8F8473B3798,30854,21,23,2,109.56889,18.27076,1763
21830,169213,FEBC61D07262A46BE9A7FF14D2806B38,30854,0,11,11,109.56889,18.27076,1763
21831,169214,FEBC61D07262A46BE9A7FF14D2806B38,38251,15,16,1,109.49618,18.25493,1510
21832,169215,FEBC61D07262A46BE9A7FF14D2806B38,30854,17,23,6,109.56889,18.27076,1763
21853,169351,C1F9914EF577AE2A8300B1A3945A50FF,31561,1,3,2,109.56792,18.28479,1765
21854,169352,C1F9914EF577AE2A8300B1A3945A50FF,30851,4,15,11,109.5616,18.27396,1713
21855,169353,C1F9914EF577AE2A8300B1A3945A50FF,31561,20,21,1,109.56792,18.28479,1765
21858,169379,3BB007FDF28DB0E7E883BA594F721FFE,31181,0,1,1,109.50382,18.24813,1509
21859,169380,3BB007FDF28DB0E7E883BA594F721FFE,39151,3,6,3,109.49875,18.25097,1510
21860,169381,3BB007FDF28DB0E7E883BA594F721FFE,31181,8,23,15,109.50382,18.24813,1509
21861,169415,1D95C9F25428D40F06E5BFA001370E3C,31071,1,16,15,109.58257,18.28458,1815
21862,169416,1D95C9F25428D40F06E5BFA001370E3C,30854,18,19,1,109.56889,18.27076,1763
21863,169417,1D95C9F25428D40F06E5BFA001370E3C,31071,20,21,1,109.58257,18.28458,1815
21872,169492,301B337150415B5DF427DDCD9632DE5F,60631,0,7,7,109.57778,18.27583,1814
21873,169493,301B337150415B5DF427DDCD9632DE5F,30851,11,17,6,109.5616,18.27396,1713
21874,169494,301B337150415B5DF427DDCD9632DE5F,60631,20,23,3,109.57778,18.27583,1814
21893,169592,9FC721E86703223349C05C95FE4BBB6F,31521,0,11,11,109.51458,18.22542,1555
21894,169593,9FC721E86703223349C05C95FE4BBB6F,60381,11,19,8,109.5241,18.22458,1605
21895,169594,9FC721E86703223349C05C95FE4BBB6F,31521,19,21,2,109.51458,18.22542,1555
21896,169595,9FC721E86703223349C05C95FE4BBB6F,60087,22,23,1,109.50688,18.22299,1505
21900,169622,A68637AA89BD62624E677D9E66C32FAD,30361,0,8,8,109.50347,18.24,1508
21901,169623,A68637AA89BD62624E677D9E66C32FAD,30161,10,12,2,109.50042,18.24389,1508
21902,169624,A68637AA89BD62624E677D9E66C32FAD,30361,12,16,4,109.50347,18.24,1508
21903,169625,A68637AA89BD62624E677D9E66C32FAD,30161,17,23,6,109.50042,18.24389,1508
21904,169677,A8CC84F6441C04DAF82A74609E587ED2,38484,0,1,1,109.53028,18.31528,1620
21905,169678,A8CC84F6441C04DAF82A74609E587ED2,30561,2,3,1,109.52778,18.31938,1621
21906,169679,A8CC84F6441C04DAF82A74609E587ED2,31931,7,9,2,109.54771,18.29403,1667
21907,169680,A8CC84F6441C04DAF82A74609E587ED2,30561,12,13,1,109.52778,18.31938,1621
21908,169704,B17D654C0C5F0BF2FDFE2DB8B9C0B83F,60084,1,2,1,109.4984,18.2334,1507
21909,169705,B17D654C0C5F0BF2FDFE2DB8B9C0B83F,30421,3,19,16,109.50021,18.25861,1511
21910,169706,B17D654C0C5F0BF2FDFE2DB8B9C0B83F,30191,19,20,1,109.50361,18.22701,1506
21911,169752,90B0A60855A43B2DB99A0964CE51D3AF,31071,1,7,6,109.58257,18.28458,1815
21912,169753,90B0A60855A43B2DB99A0964CE51D3AF,30854,12,18,6,109.56889,18.27076,1763
21913,169754,90B0A60855A43B2DB99A0964CE51D3AF,31071,21,22,1,109.58257,18.28458,1815
21936,169910,47A18820FDA9856131F74091D44B6BCB,31561,0,14,14,109.56792,18.28479,1765
21937,169911,47A18820FDA9856131F74091D44B6BCB,30851,16,17,1,109.5616,18.27396,1713
21938,169912,47A18820FDA9856131F74091D44B6BCB,31561,20,21,1,109.56792,18.28479,1765
21942,169950,A9FCE0049DB44FE004EAFBF5B783F4A5,30854,1,16,15,109.56889,18.27076,1763
21943,169951,A9FCE0049DB44FE004EAFBF5B783F4A5,31071,16,17,1,109.58257,18.28458,1815
21944,169952,A9FCE0049DB44FE004EAFBF5B783F4A5,38154,21,22,1,109.5266,18.28278,1615
21962,170039,84DF4A7C208235D171EF56473BCCF210,30851,1,2,1,109.5616,18.27396,1713
21963,170040,84DF4A7C208235D171EF56473BCCF210,31561,5,7,2,109.56792,18.28479,1765
21964,170041,84DF4A7C208235D171EF56473BCCF210,60631,7,18,11,109.57778,18.27583,1814
21990,170250,335A7B1DE8538918FDA774EE3E402A76,30191,0,7,7,109.50361,18.22701,1506
21991,170251,335A7B1DE8538918FDA774EE3E402A76,31521,7,8,1,109.51458,18.22542,1555
21992,170252,335A7B1DE8538918FDA774EE3E402A76,60381,9,11,2,109.5241,18.22458,1605
21993,170253,335A7B1DE8538918FDA774EE3E402A76,30191,12,23,11,109.50361,18.22701,1506
21994,170260,E082FB5BD091C5B334EC1176FF352EE0,30071,0,8,8,109.52819,18.30472,1619
21995,170261,E082FB5BD091C5B334EC1176FF352EE0,31931,10,12,2,109.54771,18.29403,1667
21996,170262,E082FB5BD091C5B334EC1176FF352EE0,30071,12,22,10,109.52819,18.30472,1619
22007,170330,5DFB96E5E8A111915E2B8AFE3C420F16,30531,0,7,7,109.53271,18.21472,1604
22008,170331,5DFB96E5E8A111915E2B8AFE3C420F16,31061,8,18,10,109.53333,18.23257,1607
22009,170332,5DFB96E5E8A111915E2B8AFE3C420F16,60661,18,19,1,109.548,18.2377,1657
22010,170333,5DFB96E5E8A111915E2B8AFE3C420F16,30531,20,22,2,109.53271,18.21472,1604
22037,170562,2A699167E9D3E245FFAC98B0B1AFC37B,31181,0,7,7,109.50382,18.24813,1509
22038,170563,2A699167E9D3E245FFAC98B0B1AFC37B,60291,9,13,4,109.50826,18.24639,1509
22039,170564,2A699167E9D3E245FFAC98B0B1AFC37B,31181,15,17,2,109.50382,18.24813,1509
22040,170565,2A699167E9D3E245FFAC98B0B1AFC37B,60291,17,23,6,109.50826,18.24639,1509
22041,170577,59BC82AA673F3B026E4585AB957F187F,30211,4,7,3,109.49882,18.23931,1508
22042,170578,59BC82AA673F3B026E4585AB957F187F,60401,9,10,1,109.47444,18.27583,1414
22043,170579,59BC82AA673F3B026E4585AB957F187F,31021,12,14,2,109.49021,18.27,1463
22044,170580,59BC82AA673F3B026E4585AB957F187F,31521,14,23,9,109.51458,18.22542,1555
22047,170653,73EAC1341C5005A58B26B1A52457F38B,39151,0,5,5,109.49875,18.25097,1510
22048,170654,73EAC1341C5005A58B26B1A52457F38B,31181,6,20,14,109.50382,18.24813,1509
22049,170655,73EAC1341C5005A58B26B1A52457F38B,39091,22,23,1,109.50097,18.25222,1510
22077,170790,E5E2DA460104E389257158E8D8C9FBDA,60281,0,7,7,109.51743,18.25924,1561
22078,170791,E5E2DA460104E389257158E8D8C9FBDA,60311,8,10,2,109.52097,18.24319,1558
22079,170792,E5E2DA460104E389257158E8D8C9FBDA,60281,13,23,10,109.51743,18.25924,1561
22096,170952,012ABD06F231728C214A4BA917E75B1C,31561,0,2,2,109.56792,18.28479,1765
22097,170953,012ABD06F231728C214A4BA917E75B1C,30851,4,12,8,109.5616,18.27396,1713
22098,170954,012ABD06F231728C214A4BA917E75B1C,31561,15,16,1,109.56792,18.28479,1765
22099,170955,012ABD06F231728C214A4BA917E75B1C,30851,16,23,7,109.5616,18.27396,1713
22100,170958,51061B3DE820AF1C1C713EF684728003,31071,5,7,2,109.58257,18.28458,1815
22101,170959,51061B3DE820AF1C1C713EF684728003,30854,8,17,9,109.56889,18.27076,1763
22102,170960,51061B3DE820AF1C1C713EF684728003,30891,19,20,1,109.59431,18.28389,1865
22103,170961,51061B3DE820AF1C1C713EF684728003,31071,21,23,2,109.58257,18.28458,1815
22104,170962,A8E9C7BB918ADAD29A3EA7ACDDCD32D7,38951,0,7,7,109.48097,18.28868,1416
22105,170963,A8E9C7BB918ADAD29A3EA7ACDDCD32D7,38951,8,10,2,109.48097,18.28868,1416
22106,170964,A8E9C7BB918ADAD29A3EA7ACDDCD32D7,38951,12,23,11,109.48097,18.28868,1416
22114,171029,C1287E1F5E9B82EE35A85BDD5D31ACF1,30421,1,4,3,109.50021,18.25861,1511
22115,171030,C1287E1F5E9B82EE35A85BDD5D31ACF1,30381,8,10,2,109.52521,18.24507,1609
22116,171031,C1287E1F5E9B82EE35A85BDD5D31ACF1,31261,12,15,3,109.51174,18.2466,1559
22119,171071,8B9A9BFD1ACAD480EB101A91DBF2024D,38291,0,1,1,109.51618,18.24313,1558
22120,171072,8B9A9BFD1ACAD480EB101A91DBF2024D,30371,2,18,16,109.51,18.24771,1559
22121,171073,8B9A9BFD1ACAD480EB101A91DBF2024D,30421,20,23,3,109.50021,18.25861,1511
22122,171074,E9A67CAEAD4E146EE721320A56F893AA,31071,1,5,4,109.58257,18.28458,1815
22123,171075,E9A67CAEAD4E146EE721320A56F893AA,30854,7,8,1,109.56889,18.27076,1763
22124,171076,E9A67CAEAD4E146EE721320A56F893AA,31945,8,9,1,109.58021,18.29403,1817
22125,171077,E9A67CAEAD4E146EE721320A56F893AA,31071,12,13,1,109.58257,18.28458,1815
22126,171090,43E035AE85036EBD9891453E9567CB81,30151,1,8,7,109.50986,18.25083,1560
22127,171091,43E035AE85036EBD9891453E9567CB81,30151,10,14,4,109.50986,18.25083,1560
22128,171092,43E035AE85036EBD9891453E9567CB81,30151,19,23,4,109.50986,18.25083,1560
22129,171109,81596C8771F0BD5C8688C47E383316FD,39191,0,1,1,109.51493,18.23472,1557
22130,171110,81596C8771F0BD5C8688C47E383316FD,31201,2,5,3,109.51042,18.23819,1558
22131,171111,81596C8771F0BD5C8688C47E383316FD,30181,5,10,5,109.51597,18.23313,1557
22138,171150,8752BC71725B50257436D50C6598F252,31071,1,7,6,109.58257,18.28458,1815
22139,171151,8752BC71725B50257436D50C6598F252,30854,8,18,10,109.56889,18.27076,1763
22140,171152,8752BC71725B50257436D50C6598F252,31071,21,23,2,109.58257,18.28458,1815
22143,171206,C983E73D646629A775690ECA8920EB29,30101,2,5,3,109.57299,18.33333,1773
22144,171207,C983E73D646629A775690ECA8920EB29,31631,8,9,1,109.59542,18.36826,1879
22145,171208,C983E73D646629A775690ECA8920EB29,30101,11,17,6,109.57299,18.33333,1773
22146,171209,C983E73D646629A775690ECA8920EB29,31631,20,21,1,109.59542,18.36826,1879
22147,171217,6C7CFF92341DACF5390B37394F2B073B,60381,1,3,2,109.5241,18.22458,1605
22148,171218,6C7CFF92341DACF5390B37394F2B073B,39321,7,8,1,109.529,18.2167,1604
22149,171219,6C7CFF92341DACF5390B37394F2B073B,30731,12,13,1,109.50944,18.22306,1555
22150,171220,6C7CFF92341DACF5390B37394F2B073B,60381,15,17,2,109.5241,18.22458,1605
22157,171298,377A324496E54511961704972731A3D5,31821,0,8,8,109.51181,18.24924,1559
22158,171299,377A324496E54511961704972731A3D5,39111,12,14,2,109.5191,18.22597,1555
22159,171300,377A324496E54511961704972731A3D5,31521,17,21,4,109.51458,18.22542,1555
22167,171497,C37DBDD12F85B1DFB17F9185AF0E7708,30951,1,8,7,109.56208,18.25667,1761
22168,171498,C37DBDD12F85B1DFB17F9185AF0E7708,30851,8,11,3,109.5616,18.27396,1713
22169,171499,C37DBDD12F85B1DFB17F9185AF0E7708,30951,12,23,11,109.56208,18.25667,1761
22170,171508,7084657DF30063A945AAA5EF4742695F,39183,0,6,6,109.55542,18.28208,1715
22171,171509,7084657DF30063A945AAA5EF4742695F,31931,6,8,2,109.54771,18.29403,1667
22172,171510,7084657DF30063A945AAA5EF4742695F,39183,11,23,12,109.55542,18.28208,1715
22187,171659,C8922FAF66F21ECAECB6B717FCD5A53B,60614,0,13,13,109.48799,18.29521,1467
22188,171660,C8922FAF66F21ECAECB6B717FCD5A53B,60391,14,17,3,109.47667,18.28757,1416
22189,171661,C8922FAF66F21ECAECB6B717FCD5A53B,60614,17,23,6,109.48799,18.29521,1467
22227,172007,1E36640BE395A4EE8CCB2697222419A5,30854,1,3,2,109.56889,18.27076,1763
22228,172008,1E36640BE395A4EE8CCB2697222419A5,60631,5,9,4,109.57778,18.27583,1814
22229,172009,1E36640BE395A4EE8CCB2697222419A5,30854,9,18,9,109.56889,18.27076,1763
22230,172012,CFA6DB42B4EA79576A8AEA8F93765E81,30721,0,7,7,109.51597,18.28257,1565
22231,172013,CFA6DB42B4EA79576A8AEA8F93765E81,30291,10,12,2,109.50403,18.27028,1513
22232,172014,CFA6DB42B4EA79576A8AEA8F93765E81,30084,16,20,4,109.50118,18.26972,1513
22233,172015,CFA6DB42B4EA79576A8AEA8F93765E81,30721,21,23,2,109.51597,18.28257,1565
22234,172016,DFFF17B7FE30E79B8AABBB5CE171272F,30851,0,4,4,109.5616,18.27396,1713
22235,172017,DFFF17B7FE30E79B8AABBB5CE171272F,31561,4,7,3,109.56792,18.28479,1765
22236,172018,DFFF17B7FE30E79B8AABBB5CE171272F,39183,11,13,2,109.55542,18.28208,1715
22237,172019,DFFF17B7FE30E79B8AABBB5CE171272F,31561,13,21,8,109.56792,18.28479,1765
22238,172050,B34415F599F0ED7D1A073EE314A60B9B,31671,0,6,6,109.38965,18.29813,1068
22239,172051,B34415F599F0ED7D1A073EE314A60B9B,60041,6,8,2,109.39889,18.31944,1121
22240,172052,B34415F599F0ED7D1A073EE314A60B9B,31671,8,23,15,109.38965,18.29813,1068
22246,172132,8CD15CF6B5FB4821940FF9AFE6D6CB84,39181,0,1,1,109.55153,18.28035,1715
22247,172133,8CD15CF6B5FB4821940FF9AFE6D6CB84,39181,2,3,1,109.55153,18.28035,1715
22248,172134,8CD15CF6B5FB4821940FF9AFE6D6CB84,39181,4,5,1,109.55153,18.28035,1715
22249,172135,8CD15CF6B5FB4821940FF9AFE6D6CB84,31931,6,16,10,109.54771,18.29403,1667
22257,172149,E0A24740E2C54F3B77DB561A91D2BED7,30151,0,6,6,109.50986,18.25083,1560
22258,172150,E0A24740E2C54F3B77DB561A91D2BED7,30251,8,18,10,109.50611,18.26653,1512
22259,172151,E0A24740E2C54F3B77DB561A91D2BED7,30151,18,20,2,109.50986,18.25083,1560
22260,172152,E0A24740E2C54F3B77DB561A91D2BED7,31821,21,23,2,109.51181,18.24924,1559
22261,172165,10E6DCB22C04D9E1B01193CDA87B3193,30721,0,6,6,109.51597,18.28257,1565
22262,172166,10E6DCB22C04D9E1B01193CDA87B3193,31931,9,10,1,109.54771,18.29403,1667
22263,172167,10E6DCB22C04D9E1B01193CDA87B3193,39183,11,13,2,109.55542,18.28208,1715
22269,172303,87ACF3C6ADE430D2B9DFB3C954E0C031,31071,0,8,8,109.58257,18.28458,1815
22270,172304,87ACF3C6ADE430D2B9DFB3C954E0C031,30854,8,15,7,109.56889,18.27076,1763
22271,172305,87ACF3C6ADE430D2B9DFB3C954E0C031,31071,16,17,1,109.58257,18.28458,1815
22272,172306,87ACF3C6ADE430D2B9DFB3C954E0C031,30854,21,22,1,109.56889,18.27076,1763
22273,172307,ABE4E7AE3E68F27E859AAF9E649218E0,30121,0,7,7,109.52861,18.27222,1613
22274,172308,ABE4E7AE3E68F27E859AAF9E649218E0,30771,8,11,3,109.49938,18.26042,1511
22275,172309,ABE4E7AE3E68F27E859AAF9E649218E0,60281,14,17,3,109.51743,18.25924,1561
22276,172310,ABE4E7AE3E68F27E859AAF9E649218E0,30121,18,23,5,109.52861,18.27222,1613
22288,172379,2F3BB5BE10811E7F8F8565DAA2126DE6,39181,0,4,4,109.55153,18.28035,1715
22289,172380,2F3BB5BE10811E7F8F8565DAA2126DE6,31931,4,6,2,109.54771,18.29403,1667
22290,172381,2F3BB5BE10811E7F8F8565DAA2126DE6,39181,9,23,14,109.55153,18.28035,1715
22299,172529,E455476985FDFEBBD2CF96D40884A00A,38721,0,4,4,109.50368,18.27542,1514
22300,172530,E455476985FDFEBBD2CF96D40884A00A,30291,6,9,3,109.50403,18.27028,1513
22301,172531,E455476985FDFEBBD2CF96D40884A00A,60161,10,11,1,109.49174,18.26181,1461
22302,172532,E455476985FDFEBBD2CF96D40884A00A,30161,12,14,2,109.50042,18.24389,1508
22323,172767,AB43182259122294244C13D6FC66D4A1,30891,0,5,5,109.59431,18.28389,1865
22324,172768,AB43182259122294244C13D6FC66D4A1,60631,5,6,1,109.57778,18.27583,1814
22325,172769,AB43182259122294244C13D6FC66D4A1,31561,9,13,4,109.56792,18.28479,1765
22329,172773,036DFEF8CA623F9034F928149FE2468D,30821,0,2,2,109.43681,18.33639,1274
22330,172774,036DFEF8CA623F9034F928149FE2468D,30651,2,4,2,109.42611,18.385,1232
22331,172775,036DFEF8CA623F9034F928149FE2468D,30821,7,23,16,109.43681,18.33639,1274
22332,172828,FCFB14BA36BDB7CD6A39612B9AE933B2,38127,2,5,3,109.50833,18.27222,1513
22333,172829,FCFB14BA36BDB7CD6A39612B9AE933B2,31931,7,16,9,109.54771,18.29403,1667
22334,172830,FCFB14BA36BDB7CD6A39612B9AE933B2,38127,18,23,5,109.50833,18.27222,1513
22347,172889,7BF65E5054DA81A230AB5423620158E1,60631,1,4,3,109.57778,18.27583,1814
22348,172890,7BF65E5054DA81A230AB5423620158E1,31071,6,7,1,109.58257,18.28458,1815
22349,172891,7BF65E5054DA81A230AB5423620158E1,30854,9,23,14,109.56889,18.27076,1763
22350,173009,4053323049FA57896819CD5356E38746,31071,1,6,5,109.58257,18.28458,1815
22351,173010,4053323049FA57896819CD5356E38746,30681,10,12,2,109.48493,18.26917,1463
22352,173011,4053323049FA57896819CD5356E38746,30854,13,22,9,109.56889,18.27076,1763
22353,173021,9BF33DB1F7AC1D27E06AF501C14CCF2C,31931,0,8,8,109.54771,18.29403,1667
22354,173022,9BF33DB1F7AC1D27E06AF501C14CCF2C,39181,8,9,1,109.55153,18.28035,1715
22355,173023,9BF33DB1F7AC1D27E06AF501C14CCF2C,31931,12,23,11,109.54771,18.29403,1667
22363,173068,DAE4AED2552702E7E5B51363230E28AA,30171,0,7,7,109.48458,18.27139,1463
22364,173069,DAE4AED2552702E7E5B51363230E28AA,31231,8,9,1,109.42597,18.29292,1217
22365,173070,DAE4AED2552702E7E5B51363230E28AA,30171,13,15,2,109.48458,18.27139,1463
22366,173071,DAE4AED2552702E7E5B51363230E28AA,30171,20,21,1,109.48458,18.27139,1463
22380,173113,20C15B76A1E0DF79D86EDEAC7BC3D7B7,31071,0,8,8,109.58257,18.28458,1815
22381,173114,20C15B76A1E0DF79D86EDEAC7BC3D7B7,30854,12,14,2,109.56889,18.27076,1763
22382,173115,20C15B76A1E0DF79D86EDEAC7BC3D7B7,31071,19,23,4,109.58257,18.28458,1815
22383,173150,C1C69C0EAD4ABEFD1467543102429D9B,30281,0,1,1,109.50597,18.27583,1514
22384,173151,C1C69C0EAD4ABEFD1467543102429D9B,31561,2,7,5,109.56792,18.28479,1765
22385,173152,C1C69C0EAD4ABEFD1467543102429D9B,39183,11,21,10,109.55542,18.28208,1715
22388,173277,B2035C0684FF9CA861B7EB217CE5A160,60524,0,7,7,109.42951,18.28993,1216
22389,173278,B2035C0684FF9CA861B7EB217CE5A160,31471,10,17,7,109.34583,18.29563,917
22390,173279,B2035C0684FF9CA861B7EB217CE5A160,60041,18,19,1,109.39889,18.31944,1121
22396,173380,30CE72A519D49881F23B8123486E3A02,60411,0,10,10,109.32514,18.30854,869
22397,173381,30CE72A519D49881F23B8123486E3A02,31471,11,18,7,109.34583,18.29563,917
22398,173382,30CE72A519D49881F23B8123486E3A02,60411,18,23,5,109.32514,18.30854,869
22426,173616,E4C7AB656E412C7E33554D18277C9478,60291,2,11,9,109.50826,18.24639,1509
22427,173617,E4C7AB656E412C7E33554D18277C9478,38911,13,15,2,109.51674,18.24965,1559
22428,173618,E4C7AB656E412C7E33554D18277C9478,60331,17,19,2,109.505,18.26507,1512
22429,173619,E4C7AB656E412C7E33554D18277C9478,31461,22,23,1,109.5091,18.25389,1510
22430,173649,C91F430AC30B55A21F7C58F74A11754B,31071,1,6,5,109.58257,18.28458,1815
22431,173650,C91F430AC30B55A21F7C58F74A11754B,30854,7,8,1,109.56889,18.27076,1763
22432,173651,C91F430AC30B55A21F7C58F74A11754B,31071,12,23,11,109.58257,18.28458,1815
22452,173794,59F29435D748531F416A4F1636997ECF,60361,0,1,1,109.51938,18.29681,1567
22453,173795,59F29435D748531F416A4F1636997ECF,60631,4,5,1,109.57778,18.27583,1814
22454,173796,59F29435D748531F416A4F1636997ECF,31071,5,9,4,109.58257,18.28458,1815
22486,174190,9BD095517798346F169AD6D898CA1A42,60361,0,7,7,109.51938,18.29681,1567
22487,174191,9BD095517798346F169AD6D898CA1A42,60221,7,9,2,109.52569,18.29188,1616
22488,174192,9BD095517798346F169AD6D898CA1A42,60274,13,14,1,109.514,18.2933,1567
22489,174193,5403ECE41AD9921A5DEF63FF6DE6A9D1,30854,0,3,3,109.56889,18.27076,1763
22490,174194,5403ECE41AD9921A5DEF63FF6DE6A9D1,31071,4,11,7,109.58257,18.28458,1815
22491,174195,5403ECE41AD9921A5DEF63FF6DE6A9D1,30854,16,20,4,109.56889,18.27076,1763
22492,174214,15195C578D4A8081B069C4B518039EFC,60161,0,7,7,109.49174,18.26181,1461
22493,174215,15195C578D4A8081B069C4B518039EFC,60231,7,8,1,109.49903,18.21972,1504
22494,174216,15195C578D4A8081B069C4B518039EFC,60084,11,15,4,109.4984,18.2334,1507
22495,174217,15195C578D4A8081B069C4B518039EFC,60231,18,22,4,109.49903,18.21972,1504
22531,174563,8CF08DEE8EF83AC7333B837D79034776,31531,0,8,8,109.49583,18.25972,1461
22532,174565,8CF08DEE8EF83AC7333B837D79034776,30281,14,16,2,109.50597,18.27583,1514
22533,174566,8CF08DEE8EF83AC7333B837D79034776,31531,18,23,5,109.49583,18.25972,1461
22534,174589,FBDD80570A641C18D89F4987D07601F8,31561,0,3,3,109.56792,18.28479,1765
22535,174590,FBDD80570A641C18D89F4987D07601F8,30854,8,13,5,109.56889,18.27076,1763
22536,174591,FBDD80570A641C18D89F4987D07601F8,31561,15,23,8,109.56792,18.28479,1765
22539,174678,283E90F84EEBCE43BF6B6D42BDFBC3E7,31261,0,7,7,109.51174,18.2466,1559
22540,174679,283E90F84EEBCE43BF6B6D42BDFBC3E7,31261,8,13,5,109.51174,18.2466,1559
22541,174680,283E90F84EEBCE43BF6B6D42BDFBC3E7,31521,15,18,3,109.51458,18.22542,1555
22542,174681,283E90F84EEBCE43BF6B6D42BDFBC3E7,31261,18,23,5,109.51174,18.2466,1559
22549,174725,8C50A9A3D5A31C1286D1433D74FA3A6F,31071,0,1,1,109.58257,18.28458,1815
22550,174726,8C50A9A3D5A31C1286D1433D74FA3A6F,30854,1,8,7,109.56889,18.27076,1763
22551,174727,8C50A9A3D5A31C1286D1433D74FA3A6F,31071,9,10,1,109.58257,18.28458,1815
22552,174728,8C50A9A3D5A31C1286D1433D74FA3A6F,30854,13,15,2,109.56889,18.27076,1763
22553,174738,08D5EFAE8388B70BF24B8C765A0BDF86,31561,0,7,7,109.56792,18.28479,1765
22554,174739,08D5EFAE8388B70BF24B8C765A0BDF86,30854,10,12,2,109.56889,18.27076,1763
22555,174740,08D5EFAE8388B70BF24B8C765A0BDF86,31071,12,13,1,109.58257,18.28458,1815
22556,174744,17D13F6A66037B54FAB5668CDC734401,30721,0,7,7,109.51597,18.28257,1565
22557,174745,17D13F6A66037B54FAB5668CDC734401,31931,7,9,2,109.54771,18.29403,1667
22558,174746,17D13F6A66037B54FAB5668CDC734401,39183,12,14,2,109.55542,18.28208,1715
22559,174747,17D13F6A66037B54FAB5668CDC734401,30721,17,21,4,109.51597,18.28257,1565
22560,174751,6A26FED9158987DCFB21331785DB2E9C,39371,0,2,2,109.56627,18.2646,1762
22561,174752,6A26FED9158987DCFB21331785DB2E9C,30851,2,8,6,109.5616,18.27396,1713
22562,174753,6A26FED9158987DCFB21331785DB2E9C,39371,12,23,11,109.56627,18.2646,1762
22569,174835,36BCA39777B9D1E703C1404CDA6A45E7,30511,0,8,8,109.51069,18.24208,1558
22570,174836,36BCA39777B9D1E703C1404CDA6A45E7,31351,11,14,3,109.4959,18.28417,1465
22571,174837,36BCA39777B9D1E703C1404CDA6A45E7,31864,18,19,1,109.49014,18.28333,1465
22572,174838,36BCA39777B9D1E703C1404CDA6A45E7,30511,22,23,1,109.51069,18.24208,1558
22575,174862,DE841C2C767041F00D7DAF75FFC633F6,30771,2,4,2,109.49938,18.26042,1511
22576,174863,DE841C2C767041F00D7DAF75FFC633F6,30421,5,22,17,109.50021,18.25861,1511
22577,174864,DE841C2C767041F00D7DAF75FFC633F6,31561,22,23,1,109.56792,18.28479,1765
22585,174969,9F3E5E88FFF135A7A6F9D8C4CA8C3CCE,48574,0,8,8,109.48931,18.28458,1465
22586,174970,9F3E5E88FFF135A7A6F9D8C4CA8C3CCE,30071,11,12,1,109.52819,18.30472,1619
22587,174971,9F3E5E88FFF135A7A6F9D8C4CA8C3CCE,31861,13,14,1,109.49042,18.27549,1464
22588,175005,BE7763F8096EB5A037146E1CC4190538,30854,0,5,5,109.56889,18.27076,1763
22589,175006,BE7763F8096EB5A037146E1CC4190538,30324,7,17,10,109.50326,18.29257,1517
22590,175007,BE7763F8096EB5A037146E1CC4190538,30854,20,22,2,109.56889,18.27076,1763
22597,175018,EB291EA7E3235FF23960DA865075F183,38911,0,8,8,109.51674,18.24965,1559
22598,175019,EB291EA7E3235FF23960DA865075F183,39091,9,11,2,109.50097,18.25222,1510
22599,175020,EB291EA7E3235FF23960DA865075F183,31031,12,18,6,109.49979,18.25382,1510
22655,175400,019EB913544B8855829875D27D9C85B6,31201,0,9,9,109.51042,18.23819,1558
22656,175401,019EB913544B8855829875D27D9C85B6,30181,11,16,5,109.51597,18.23313,1557
22657,175402,019EB913544B8855829875D27D9C85B6,31201,20,22,2,109.51042,18.23819,1558
22668,175456,AE6DC7ACB81DB5F351E45AC25E5F5A3B,38297,5,7,2,109.52576,18.24965,1609
22669,175457,AE6DC7ACB81DB5F351E45AC25E5F5A3B,39091,8,12,4,109.50097,18.25222,1510
22670,175458,AE6DC7ACB81DB5F351E45AC25E5F5A3B,38297,12,19,7,109.52576,18.24965,1609
22671,175459,AE6DC7ACB81DB5F351E45AC25E5F5A3B,39191,21,22,1,109.51493,18.23472,1557
22684,175543,3B6FF1F8D896A0A62DC7E65967011999,39183,0,4,4,109.55542,18.28208,1715
22685,175544,3B6FF1F8D896A0A62DC7E65967011999,31561,5,7,2,109.56792,18.28479,1765
22686,175545,3B6FF1F8D896A0A62DC7E65967011999,39183,7,20,13,109.55542,18.28208,1715
22693,175611,FBC323A047041F71D8997C22FDE88F17,31321,1,13,12,109.63799,18.23201,2007
22694,175612,FBC323A047041F71D8997C22FDE88F17,30181,13,15,2,109.51597,18.23313,1557
22695,175613,FBC323A047041F71D8997C22FDE88F17,31321,20,22,2,109.63799,18.23201,2007
22715,175729,01F0083CC81D0009F9AAB8F7CAA0C106,30854,0,6,6,109.56889,18.27076,1763
22716,175730,01F0083CC81D0009F9AAB8F7CAA0C106,30851,7,9,2,109.5616,18.27396,1713
22717,175731,01F0083CC81D0009F9AAB8F7CAA0C106,30854,11,20,9,109.56889,18.27076,1763
22723,175810,13664B2E5419DDA8E26BAB65AA04153C,39191,0,12,12,109.51493,18.23472,1557
22724,175811,13664B2E5419DDA8E26BAB65AA04153C,30181,12,17,5,109.51597,18.23313,1557
22725,175812,13664B2E5419DDA8E26BAB65AA04153C,31421,19,20,1,109.55382,18.22347,1705
22726,175813,13664B2E5419DDA8E26BAB65AA04153C,39101,22,23,1,109.50132,18.24931,1509
22759,176062,7D30E1AF6572DC63597A758CCA3A5243,31251,1,7,6,109.18528,18.2975,317
22760,176063,7D30E1AF6572DC63597A758CCA3A5243,31145,7,8,1,109.20431,18.30479,369
22761,176064,7D30E1AF6572DC63597A758CCA3A5243,31781,10,12,2,109.19847,18.2975,367
22762,176065,7D30E1AF6572DC63597A758CCA3A5243,31145,13,15,2,109.20431,18.30479,369
22776,176196,EF0AF6DFF11E792E87881ED5E6F91398,30721,0,6,6,109.51597,18.28257,1565
22777,176197,EF0AF6DFF11E792E87881ED5E6F91398,39183,7,17,10,109.55542,18.28208,1715
22778,176198,EF0AF6DFF11E792E87881ED5E6F91398,38154,20,21,1,109.5266,18.28278,1615
22779,176205,C93386A9D86FE22A1FD4E5116045DD8D,31561,1,7,6,109.56792,18.28479,1765
22780,176206,C93386A9D86FE22A1FD4E5116045DD8D,39183,9,16,7,109.55542,18.28208,1715
22781,176207,C93386A9D86FE22A1FD4E5116045DD8D,30854,20,22,2,109.56889,18.27076,1763
22786,176289,01C3A40E8C2D18FB80BE4CD2C78B4B61,30711,0,12,12,109.50271,18.25347,1510
22787,176290,01C3A40E8C2D18FB80BE4CD2C78B4B61,60201,13,14,1,109.5041,18.2509,1510
22788,176291,01C3A40E8C2D18FB80BE4CD2C78B4B61,39091,14,17,3,109.50097,18.25222,1510
22789,176292,01C3A40E8C2D18FB80BE4CD2C78B4B61,30051,18,20,2,109.48917,18.21215,1453
22801,176326,3977578BE56276DA0700B04B81DC1356,31561,0,1,1,109.56792,18.28479,1765
22802,176327,3977578BE56276DA0700B04B81DC1356,30851,2,6,4,109.5616,18.27396,1713
22803,176328,3977578BE56276DA0700B04B81DC1356,31561,7,17,10,109.56792,18.28479,1765
22804,176329,3977578BE56276DA0700B04B81DC1356,30851,19,21,2,109.5616,18.27396,1713
22819,176498,42815E00E74F2DEE06DE8ADA6B858662,31561,0,14,14,109.56792,18.28479,1765
22820,176499,42815E00E74F2DEE06DE8ADA6B858662,30854,18,20,2,109.56889,18.27076,1763
22821,176500,42815E00E74F2DEE06DE8ADA6B858662,31071,21,22,1,109.58257,18.28458,1815
22822,176524,56C8C781972E8BFAF8A768A19AD7F590,30281,0,7,7,109.50597,18.27583,1514
22823,176527,56C8C781972E8BFAF8A768A19AD7F590,30281,19,20,1,109.50597,18.27583,1514
22824,176528,56C8C781972E8BFAF8A768A19AD7F590,38127,21,23,2,109.50833,18.27222,1513
22844,176624,8345A9276E866C21971E3C408D4E0341,30854,4,9,5,109.56889,18.27076,1763
22845,176625,8345A9276E866C21971E3C408D4E0341,31071,10,11,1,109.58257,18.28458,1815
22846,176626,8345A9276E866C21971E3C408D4E0341,30854,12,23,11,109.56889,18.27076,1763
22854,176739,F6A1EBB84FE583E84185C423218578F5,31561,0,6,6,109.56792,18.28479,1765
22855,176740,F6A1EBB84FE583E84185C423218578F5,39183,8,9,1,109.55542,18.28208,1715
22856,176741,F6A1EBB84FE583E84185C423218578F5,30854,9,10,1,109.56889,18.27076,1763
22866,176852,8C7667B6277A3C193B50CC18C706780E,31421,3,9,6,109.55382,18.22347,1705
22867,176853,8C7667B6277A3C193B50CC18C706780E,30951,9,10,1,109.56208,18.25667,1761
22868,176854,8C7667B6277A3C193B50CC18C706780E,39371,12,15,3,109.56627,18.2646,1762
22874,176891,40C57F24FE0409ABB752B2031C349577,38951,0,13,13,109.48097,18.28868,1416
22875,176892,40C57F24FE0409ABB752B2031C349577,38951,13,15,2,109.48097,18.28868,1416
22876,176893,40C57F24FE0409ABB752B2031C349577,30711,15,20,5,109.50271,18.25347,1510
22877,176894,40C57F24FE0409ABB752B2031C349577,38951,22,23,1,109.48097,18.28868,1416
22887,176976,1A1B5C664F8D6460240C73AB76187420,30854,0,9,9,109.56889,18.27076,1763
22888,176977,1A1B5C664F8D6460240C73AB76187420,31071,9,10,1,109.58257,18.28458,1815
22889,176978,1A1B5C664F8D6460240C73AB76187420,30854,13,20,7,109.56889,18.27076,1763
22900,177055,B0D7DAF8D84656FF4C7229ABB8EA1350,31561,1,7,6,109.56792,18.28479,1765
22901,177056,B0D7DAF8D84656FF4C7229ABB8EA1350,30854,11,15,4,109.56889,18.27076,1763
22902,177057,B0D7DAF8D84656FF4C7229ABB8EA1350,31561,17,19,2,109.56792,18.28479,1765
22909,177094,63FBAC0202144B00077561285E6A7F87,30821,5,10,5,109.43681,18.33639,1274
22910,177095,63FBAC0202144B00077561285E6A7F87,30651,14,16,2,109.42611,18.385,1232
22911,177096,63FBAC0202144B00077561285E6A7F87,30821,17,23,6,109.43681,18.33639,1274
22920,177188,89362A3CA3AE6F5B75871F2110924F99,30851,0,7,7,109.5616,18.27396,1713
22921,177189,89362A3CA3AE6F5B75871F2110924F99,30951,7,9,2,109.56208,18.25667,1761
22922,177190,89362A3CA3AE6F5B75871F2110924F99,39371,9,22,13,109.56627,18.2646,1762
22925,177232,43FEE4745615D8F20734EFB07A58D0A4,31421,1,2,1,109.55382,18.22347,1705
22926,177233,43FEE4745615D8F20734EFB07A58D0A4,31521,2,13,11,109.51458,18.22542,1555
22927,177234,43FEE4745615D8F20734EFB07A58D0A4,38251,14,22,8,109.49618,18.25493,1510
22928,177239,8DA7661E8E46B66EF011FB9B9FA15609,38061,0,6,6,109.50597,18.23118,1506
22929,177240,8DA7661E8E46B66EF011FB9B9FA15609,30731,7,10,3,109.50944,18.22306,1555
22930,177241,8DA7661E8E46B66EF011FB9B9FA15609,30181,12,13,1,109.51597,18.23313,1557
22935,177276,7FF3C6569A3990C03CAF6C52D3C8BC6C,60241,3,5,2,109.53319,18.28667,1616
22936,177277,7FF3C6569A3990C03CAF6C52D3C8BC6C,31931,6,16,10,109.54771,18.29403,1667
22937,177278,7FF3C6569A3990C03CAF6C52D3C8BC6C,60241,21,23,2,109.53319,18.28667,1616
22938,177311,AA2A5396AD753E9245AC53C94BAEDECD,61011,3,5,2,109.60653,18.19076,1900
22939,177313,AA2A5396AD753E9245AC53C94BAEDECD,61011,8,13,5,109.60653,18.19076,1900
22940,177315,AA2A5396AD753E9245AC53C94BAEDECD,61011,21,22,1,109.60653,18.19076,1900
22941,177323,F47C4E1E39056C43B0AD32AC994AB7C0,31931,2,15,13,109.54771,18.29403,1667
22942,177324,F47C4E1E39056C43B0AD32AC994AB7C0,60361,15,18,3,109.51938,18.29681,1567
22943,177325,F47C4E1E39056C43B0AD32AC994AB7C0,31931,18,23,5,109.54771,18.29403,1667
22958,177508,D8B19999D42CFF7EB03B9BAFA13044AB,60011,0,6,6,109.48965,18.30222,1468
22959,177509,D8B19999D42CFF7EB03B9BAFA13044AB,30111,6,17,11,109.47583,18.30542,1419
22960,177510,D8B19999D42CFF7EB03B9BAFA13044AB,31031,19,21,2,109.49979,18.25382,1510
22966,177534,A549C024E6F63EDBD3DC866F10DB11CE,31071,2,6,4,109.58257,18.28458,1815
22967,177535,A549C024E6F63EDBD3DC866F10DB11CE,30854,6,14,8,109.56889,18.27076,1763
22968,177536,A549C024E6F63EDBD3DC866F10DB11CE,31071,18,19,1,109.58257,18.28458,1815
22969,177537,A549C024E6F63EDBD3DC866F10DB11CE,30854,20,23,3,109.56889,18.27076,1763
22970,177560,E1108DE9382EA6DD2052A0875C7E83C6,31161,0,12,12,109.70229,18.31361,2270
22971,177561,E1108DE9382EA6DD2052A0875C7E83C6,60111,14,15,1,109.72556,18.31924,2371
22972,177562,E1108DE9382EA6DD2052A0875C7E83C6,31161,18,21,3,109.70229,18.31361,2270
22973,177573,21FBB6F0F825A6B1E89545963BB6C9D3,30854,1,3,2,109.56889,18.27076,1763
22974,177574,21FBB6F0F825A6B1E89545963BB6C9D3,60631,3,4,1,109.57778,18.27583,1814
22975,177575,21FBB6F0F825A6B1E89545963BB6C9D3,30854,5,6,1,109.56889,18.27076,1763
22976,177576,21FBB6F0F825A6B1E89545963BB6C9D3,60631,7,8,1,109.57778,18.27583,1814
22977,177590,E4B522EF4348156010E5C578EC13D60F,30854,5,6,1,109.56889,18.27076,1763
22978,177591,E4B522EF4348156010E5C578EC13D60F,31071,6,7,1,109.58257,18.28458,1815
22979,177592,E4B522EF4348156010E5C578EC13D60F,30854,8,14,6,109.56889,18.27076,1763
22980,177593,E4B522EF4348156010E5C578EC13D60F,30291,18,20,2,109.50403,18.27028,1513
22987,177612,560794A44CA17A43FA34D0FA6C339747,31071,4,6,2,109.58257,18.28458,1815
22988,177613,560794A44CA17A43FA34D0FA6C339747,30854,8,18,10,109.56889,18.27076,1763
22989,177614,560794A44CA17A43FA34D0FA6C339747,31071,19,20,1,109.58257,18.28458,1815
22994,177640,608A55C14BAB2A5B627ACC1F39B89FB6,31945,0,13,13,109.58021,18.29403,1817
22995,177641,608A55C14BAB2A5B627ACC1F39B89FB6,30854,13,17,4,109.56889,18.27076,1763
22996,177642,608A55C14BAB2A5B627ACC1F39B89FB6,31071,19,20,1,109.58257,18.28458,1815
22997,177643,608A55C14BAB2A5B627ACC1F39B89FB6,31945,22,23,1,109.58021,18.29403,1817
23003,177741,10EBF762D28520B09848288F7052CFDE,30854,2,7,5,109.56889,18.27076,1763
23004,177742,10EBF762D28520B09848288F7052CFDE,31561,7,19,12,109.56792,18.28479,1765
23005,177743,10EBF762D28520B09848288F7052CFDE,30854,19,23,4,109.56889,18.27076,1763
23014,177799,C61360C6C8202A54143E165C2C08120B,30951,0,1,1,109.56208,18.25667,1761
23015,177800,C61360C6C8202A54143E165C2C08120B,30854,1,3,2,109.56889,18.27076,1763
23016,177801,C61360C6C8202A54143E165C2C08120B,30951,5,8,3,109.56208,18.25667,1761
23017,177802,C61360C6C8202A54143E165C2C08120B,39371,10,20,10,109.56627,18.2646,1762
23018,177815,BE84D9BAD945F657EF3BFD7A07C2842B,38105,1,9,8,109.40299,18.29229,1117
23019,177816,BE84D9BAD945F657EF3BFD7A07C2842B,60541,13,19,6,109.4084,18.29208,1167
23020,177817,BE84D9BAD945F657EF3BFD7A07C2842B,60041,21,23,2,109.39889,18.31944,1121
23034,177916,6DF7485545B790F22810B0EDD8F1B356,30234,1,7,6,109.60681,18.29979,1918
23035,177917,6DF7485545B790F22810B0EDD8F1B356,30854,7,10,3,109.56889,18.27076,1763
23036,177918,6DF7485545B790F22810B0EDD8F1B356,31071,14,16,2,109.58257,18.28458,1815
23037,177919,6DF7485545B790F22810B0EDD8F1B356,30854,20,21,1,109.56889,18.27076,1763
23040,177985,15A2A8790389D1537721C21B141A7A31,61011,2,5,3,109.60653,18.19076,1900
23041,177987,15A2A8790389D1537721C21B141A7A31,61011,13,15,2,109.60653,18.19076,1900
23042,177989,15A2A8790389D1537721C21B141A7A31,61011,17,18,1,109.60653,18.19076,1900
23046,178022,990177E7F6C01BC630E60891F7DC3E29,60401,0,2,2,109.47444,18.27583,1414
23047,178023,990177E7F6C01BC630E60891F7DC3E29,30111,2,5,3,109.47583,18.30542,1419
23048,178026,990177E7F6C01BC630E60891F7DC3E29,60504,21,22,1,109.47917,18.28903,1416
23052,178073,D0016644D08E46EAD736BEE805BD7ECD,31864,0,8,8,109.49014,18.28333,1465
23053,178074,D0016644D08E46EAD736BEE805BD7ECD,30391,10,11,1,109.4975,18.27118,1513
23054,178075,D0016644D08E46EAD736BEE805BD7ECD,60221,13,14,1,109.52569,18.29188,1616
23060,178083,0F558B6653C655C7F0BAEA9D66B33F57,31071,0,6,6,109.58257,18.28458,1815
23061,178084,0F558B6653C655C7F0BAEA9D66B33F57,30854,7,18,11,109.56889,18.27076,1763
23062,178085,0F558B6653C655C7F0BAEA9D66B33F57,31071,20,21,1,109.58257,18.28458,1815
23070,178111,BC0EA07162A3720F3AF08008AC1D0A3A,31411,0,1,1,109.5016,18.23576,1507
23071,178112,BC0EA07162A3720F3AF08008AC1D0A3A,38971,1,7,6,109.50743,18.25125,1510
23072,178113,BC0EA07162A3720F3AF08008AC1D0A3A,31461,8,9,1,109.5091,18.25389,1510
23073,178114,BC0EA07162A3720F3AF08008AC1D0A3A,31461,11,13,2,109.5091,18.25389,1510
23085,178209,C153552CEA2677B0FF473AE565EA979E,30821,0,13,13,109.43681,18.33639,1274
23086,178210,C153552CEA2677B0FF473AE565EA979E,60424,15,16,1,109.44611,18.31736,1321
23087,178211,C153552CEA2677B0FF473AE565EA979E,30821,17,23,6,109.43681,18.33639,1274
23088,178214,417408FFDA93B177641D270D3A5C4B2D,31071,0,6,6,109.58257,18.28458,1815
23089,178215,417408FFDA93B177641D270D3A5C4B2D,30854,8,10,2,109.56889,18.27076,1763
23090,178216,417408FFDA93B177641D270D3A5C4B2D,31071,11,23,12,109.58257,18.28458,1815
23091,178293,28F7DFD4A036DBA4E68AFC71762D44D7,31561,0,6,6,109.56792,18.28479,1765
23092,178294,28F7DFD4A036DBA4E68AFC71762D44D7,30951,8,17,9,109.56208,18.25667,1761
23093,178295,28F7DFD4A036DBA4E68AFC71762D44D7,39371,17,23,6,109.56627,18.2646,1762
23097,178312,AD6CE74FEECB42F7806A62DA7A4CECCA,30851,0,6,6,109.5616,18.27396,1713
23098,178313,AD6CE74FEECB42F7806A62DA7A4CECCA,30854,9,15,6,109.56889,18.27076,1763
23099,178314,AD6CE74FEECB42F7806A62DA7A4CECCA,39183,19,23,4,109.55542,18.28208,1715
23100,178423,D2A5F87218CF25385163A2F3C4229CB8,30851,0,1,1,109.5616,18.27396,1713
23101,178424,D2A5F87218CF25385163A2F3C4229CB8,31561,1,12,11,109.56792,18.28479,1765
23102,178425,D2A5F87218CF25385163A2F3C4229CB8,30851,12,13,1,109.5616,18.27396,1713
23103,178426,D2A5F87218CF25385163A2F3C4229CB8,31561,14,23,9,109.56792,18.28479,1765
23104,178429,DF49F834C08C7E8FA6D78272EE1FB651,60361,0,7,7,109.51938,18.29681,1567
23105,178430,DF49F834C08C7E8FA6D78272EE1FB651,39371,10,12,2,109.56627,18.2646,1762
23106,178431,DF49F834C08C7E8FA6D78272EE1FB651,30851,12,14,2,109.5616,18.27396,1713
23107,178432,DF49F834C08C7E8FA6D78272EE1FB651,60361,18,23,5,109.51938,18.29681,1567
23137,178667,032BA6C7F044E8806CEB432AECA246EE,48621,0,6,6,109.52882,18.31743,1621
23138,178668,032BA6C7F044E8806CEB432AECA246EE,38484,7,17,10,109.53028,18.31528,1620
23139,178669,032BA6C7F044E8806CEB432AECA246EE,38484,18,23,5,109.53028,18.31528,1620
23142,178754,B2420C24A59D2C27A09046B2EE9F5AF9,30854,0,6,6,109.56889,18.27076,1763
23143,178755,B2420C24A59D2C27A09046B2EE9F5AF9,31071,8,15,7,109.58257,18.28458,1815
23144,178756,B2420C24A59D2C27A09046B2EE9F5AF9,31071,17,20,3,109.58257,18.28458,1815
23145,178757,B2420C24A59D2C27A09046B2EE9F5AF9,31071,21,23,2,109.58257,18.28458,1815
23163,178870,34F3D64B41C252481F72E5CF931AC833,30854,1,5,4,109.56889,18.27076,1763
23164,178871,34F3D64B41C252481F72E5CF931AC833,30851,7,10,3,109.5616,18.27396,1713
23165,178872,34F3D64B41C252481F72E5CF931AC833,30854,13,22,9,109.56889,18.27076,1763
23183,178968,BD1C8CAB0CA377D9350002A865081450,30081,0,7,7,109.50243,18.26632,1512
23184,178969,BD1C8CAB0CA377D9350002A865081450,30251,12,16,4,109.50611,18.26653,1512
23185,178970,BD1C8CAB0CA377D9350002A865081450,31021,17,18,1,109.49021,18.27,1463
23186,178971,BD1C8CAB0CA377D9350002A865081450,30251,19,23,4,109.50611,18.26653,1512
23224,179192,27BCEF3137923B84211F08830816C810,31561,0,1,1,109.56792,18.28479,1765
23225,179193,27BCEF3137923B84211F08830816C810,30851,2,5,3,109.5616,18.27396,1713
23226,179194,27BCEF3137923B84211F08830816C810,31561,8,9,1,109.56792,18.28479,1765
23237,179257,4995463B780282C9C030A19D9F49AEAC,30721,0,2,2,109.51597,18.28257,1565
23238,179258,4995463B780282C9C030A19D9F49AEAC,31071,3,6,3,109.58257,18.28458,1815
23239,179259,4995463B780282C9C030A19D9F49AEAC,30854,7,17,10,109.56889,18.27076,1763
23240,179260,4995463B780282C9C030A19D9F49AEAC,31071,19,22,3,109.58257,18.28458,1815
23246,179367,6F0540B756080DEA0630ADD22B34EFCA,30371,0,7,7,109.51,18.24771,1559
23247,179368,6F0540B756080DEA0630ADD22B34EFCA,30151,8,10,2,109.50986,18.25083,1560
23248,179369,6F0540B756080DEA0630ADD22B34EFCA,38801,11,18,7,109.51472,18.2584,1561
23249,179370,6F0540B756080DEA0630ADD22B34EFCA,30151,18,23,5,109.50986,18.25083,1560
23273,179453,EEBA7563A33B93144B19AD633FDB9890,31561,0,6,6,109.56792,18.28479,1765
23274,179454,EEBA7563A33B93144B19AD633FDB9890,30854,8,9,1,109.56889,18.27076,1763
23275,179455,EEBA7563A33B93144B19AD633FDB9890,31561,11,23,12,109.56792,18.28479,1765
23283,179520,552B98A65A23DB4CD390E78F3246E9C5,60241,2,6,4,109.53319,18.28667,1616
23284,179521,552B98A65A23DB4CD390E78F3246E9C5,30921,8,10,2,109.53903,18.29451,1667
23285,179522,552B98A65A23DB4CD390E78F3246E9C5,60241,12,13,1,109.53319,18.28667,1616
23286,179523,552B98A65A23DB4CD390E78F3246E9C5,30921,16,22,6,109.53903,18.29451,1667
23305,179708,44F505B3929E26B4B29F00CC284F3084,31071,3,4,1,109.58257,18.28458,1815
23306,179709,44F505B3929E26B4B29F00CC284F3084,60631,6,7,1,109.57778,18.27583,1814
23307,179710,44F505B3929E26B4B29F00CC284F3084,30854,10,21,11,109.56889,18.27076,1763
23317,179749,F95A4851DA9E4577D24C7EFA15F54F09,39321,0,17,17,109.529,18.2167,1604
23318,179750,F95A4851DA9E4577D24C7EFA15F54F09,60381,18,19,1,109.5241,18.22458,1605
23319,179751,F95A4851DA9E4577D24C7EFA15F54F09,39321,21,23,2,109.529,18.2167,1604
23331,179803,F5FE23BF42FC224C310CD42E08B0B950,31431,0,8,8,109.44639,18.29042,1316
23332,179804,F5FE23BF42FC224C310CD42E08B0B950,30764,9,10,1,109.45806,18.29486,1367
23333,179805,F5FE23BF42FC224C310CD42E08B0B950,38094,10,16,6,109.45403,18.28778,1316
23334,179806,F5FE23BF42FC224C310CD42E08B0B950,31701,18,22,4,109.44132,18.28833,1266
23371,180001,9FC721E86703223349C05C95FE4BBB6F,60081,1,10,9,109.51097,18.22639,1556
23372,180002,9FC721E86703223349C05C95FE4BBB6F,60381,11,14,3,109.5241,18.22458,1605
23373,180003,9FC721E86703223349C05C95FE4BBB6F,31521,15,23,8,109.51458,18.22542,1555
23376,180039,A68637AA89BD62624E677D9E66C32FAD,30161,0,9,9,109.50042,18.24389,1508
23377,180040,A68637AA89BD62624E677D9E66C32FAD,30151,12,14,2,109.50986,18.25083,1560
23378,180041,A68637AA89BD62624E677D9E66C32FAD,30161,14,16,2,109.50042,18.24389,1508
23379,180042,A68637AA89BD62624E677D9E66C32FAD,30361,17,22,5,109.50347,18.24,1508
23384,180088,7B8A7DE9549FE5EAAECC590C9484FFF7,38361,0,8,8,109.43667,18.29201,1267
23385,180089,7B8A7DE9549FE5EAAECC590C9484FFF7,31471,12,14,2,109.34583,18.29563,917
23386,180090,7B8A7DE9549FE5EAAECC590C9484FFF7,38361,16,23,7,109.43667,18.29201,1267
23398,180227,61845632D07FAD90D178155204748FBA,30851,0,5,5,109.5616,18.27396,1713
23399,180228,61845632D07FAD90D178155204748FBA,60631,10,20,10,109.57778,18.27583,1814
23400,180229,61845632D07FAD90D178155204748FBA,30851,20,21,1,109.5616,18.27396,1713
23404,180277,16DAC975E7E40EFDE62B9A017D79E7C1,31761,3,6,3,109.60521,18.27965,1914
23405,180278,16DAC975E7E40EFDE62B9A017D79E7C1,30854,8,10,2,109.56889,18.27076,1763
23406,180279,16DAC975E7E40EFDE62B9A017D79E7C1,60354,13,23,10,109.58701,18.28521,1815
23431,180394,46B472A67DC212EE4047EBC9FB351124,31071,0,10,10,109.58257,18.28458,1815
23432,180395,46B472A67DC212EE4047EBC9FB351124,31071,14,16,2,109.58257,18.28458,1815
23433,180396,46B472A67DC212EE4047EBC9FB351124,31071,17,23,6,109.58257,18.28458,1815
23469,180595,7024F3A14F6F554DC6E80063E30315F0,31561,4,5,1,109.56792,18.28479,1765
23470,180596,7024F3A14F6F554DC6E80063E30315F0,39183,7,9,2,109.55542,18.28208,1715
23471,180597,7024F3A14F6F554DC6E80063E30315F0,31561,13,15,2,109.56792,18.28479,1765
23484,180649,BE586ACB441383CC10D7CF3923850B73,31931,5,6,1,109.54771,18.29403,1667
23485,180650,BE586ACB441383CC10D7CF3923850B73,39181,8,15,7,109.55153,18.28035,1715
23486,180651,BE586ACB441383CC10D7CF3923850B73,31931,20,23,3,109.54771,18.29403,1667
23487,180659,66C8ABAC706935076EC04B86FC9279C1,60411,0,1,1,109.32514,18.30854,869
23488,180660,66C8ABAC706935076EC04B86FC9279C1,31471,1,5,4,109.34583,18.29563,917
23489,180661,66C8ABAC706935076EC04B86FC9279C1,60411,6,8,2,109.32514,18.30854,869
23494,180699,C50EC98EBB3AD6F34D76F87C749DAC01,39181,0,13,13,109.55153,18.28035,1715
23495,180700,C50EC98EBB3AD6F34D76F87C749DAC01,39181,14,17,3,109.55153,18.28035,1715
23496,180701,C50EC98EBB3AD6F34D76F87C749DAC01,39181,18,23,5,109.55153,18.28035,1715
23497,180729,2AB980E3003284F0269A1377C53CC1EB,38325,0,1,1,109.39792,18.2909,1116
23498,180730,2AB980E3003284F0269A1377C53CC1EB,60541,3,5,2,109.4084,18.29208,1167
23499,180731,2AB980E3003284F0269A1377C53CC1EB,38325,6,7,1,109.39792,18.2909,1116
23503,180749,FF90B6855593CFEA9A07FE008E94551D,30071,0,7,7,109.52819,18.30472,1619
23504,180750,FF90B6855593CFEA9A07FE008E94551D,31931,8,18,10,109.54771,18.29403,1667
23505,180751,FF90B6855593CFEA9A07FE008E94551D,30071,21,22,1,109.52819,18.30472,1619
23510,180793,96F98526707B06BE1263CCD4F72E07A1,31945,0,8,8,109.58021,18.29403,1817
23511,180794,96F98526707B06BE1263CCD4F72E07A1,30854,12,14,2,109.56889,18.27076,1763
23512,180795,96F98526707B06BE1263CCD4F72E07A1,31945,14,17,3,109.58021,18.29403,1817
23513,180796,96F98526707B06BE1263CCD4F72E07A1,31071,20,23,3,109.58257,18.28458,1815
23514,180797,335A7B1DE8538918FDA774EE3E402A76,30191,0,7,7,109.50361,18.22701,1506
23515,180798,335A7B1DE8538918FDA774EE3E402A76,31521,8,13,5,109.51458,18.22542,1555
23516,180799,335A7B1DE8538918FDA774EE3E402A76,30191,15,23,8,109.50361,18.22701,1506
23517,180804,E082FB5BD091C5B334EC1176FF352EE0,30071,0,7,7,109.52819,18.30472,1619
23518,180805,E082FB5BD091C5B334EC1176FF352EE0,31931,8,11,3,109.54771,18.29403,1667
23519,180806,E082FB5BD091C5B334EC1176FF352EE0,30071,12,22,10,109.52819,18.30472,1619
23522,180838,B16225DD3371073720184BB0D089E6D6,31561,0,6,6,109.56792,18.28479,1765
23523,180839,B16225DD3371073720184BB0D089E6D6,30854,7,8,1,109.56889,18.27076,1763
23524,180840,B16225DD3371073720184BB0D089E6D6,31561,10,11,1,109.56792,18.28479,1765
23525,180841,B16225DD3371073720184BB0D089E6D6,30854,13,14,1,109.56889,18.27076,1763
23531,180847,B93185B4820D7E0DEE74EBEA00941D15,31261,2,3,1,109.51174,18.2466,1559
23532,180848,B93185B4820D7E0DEE74EBEA00941D15,30251,4,5,1,109.50611,18.26653,1512
23533,180849,B93185B4820D7E0DEE74EBEA00941D15,30911,9,20,11,109.50493,18.26181,1511
23534,180850,B93185B4820D7E0DEE74EBEA00941D15,31261,22,23,1,109.51174,18.2466,1559
23544,180939,6EF68F35CE79552C1164E70C67C72C02,30121,0,9,9,109.52861,18.27222,1613
23545,180940,6EF68F35CE79552C1164E70C67C72C02,30854,10,19,9,109.56889,18.27076,1763
23546,180941,6EF68F35CE79552C1164E70C67C72C02,31041,20,21,1,109.50278,18.23701,1507
23547,180942,6EF68F35CE79552C1164E70C67C72C02,30121,22,23,1,109.52861,18.27222,1613
23548,180956,DF5038986CF763F139ACC3021B3CE64A,60594,0,8,8,109.62694,18.22799,1956
23549,180957,DF5038986CF763F139ACC3021B3CE64A,38052,8,10,2,109.62618,18.23042,1956
23550,180958,DF5038986CF763F139ACC3021B3CE64A,60594,14,17,3,109.62694,18.22799,1956
23558,181027,116A680F1141CB1D640294F052372134,60671,0,7,7,109.52979,18.31757,1621
23559,181028,116A680F1141CB1D640294F052372134,38241,7,8,1,109.54111,18.30542,1669
23560,181029,116A680F1141CB1D640294F052372134,30071,12,14,2,109.52819,18.30472,1619
23570,181149,CCCD2290FB632A48009771412BE68ADD,31561,0,13,13,109.56792,18.28479,1765
23571,181150,CCCD2290FB632A48009771412BE68ADD,39183,17,18,1,109.55542,18.28208,1715
23572,181151,CCCD2290FB632A48009771412BE68ADD,31561,22,23,1,109.56792,18.28479,1765
23574,181174,DC29C676832347947F366933ECB88090,31561,3,9,6,109.56792,18.28479,1765
23575,181175,DC29C676832347947F366933ECB88090,39183,9,11,2,109.55542,18.28208,1715
23576,181176,DC29C676832347947F366933ECB88090,31561,13,22,9,109.56792,18.28479,1765
23586,181246,43922725F0A46A5D2B5FC870E087F339,30854,5,18,13,109.56889,18.27076,1763
23587,181247,43922725F0A46A5D2B5FC870E087F339,60361,19,20,1,109.51938,18.29681,1567
23588,181248,43922725F0A46A5D2B5FC870E087F339,30854,20,22,2,109.56889,18.27076,1763
23598,181315,3C5AEA306E8A69C707195C4150E77D90,31931,2,6,4,109.54771,18.29403,1667
23599,181316,3C5AEA306E8A69C707195C4150E77D90,39181,6,10,4,109.55153,18.28035,1715
23600,181317,3C5AEA306E8A69C707195C4150E77D90,31931,11,12,1,109.54771,18.29403,1667
23601,181318,3C5AEA306E8A69C707195C4150E77D90,39183,14,17,3,109.55542,18.28208,1715
23604,181385,E5E2DA460104E389257158E8D8C9FBDA,60281,0,6,6,109.51743,18.25924,1561
23605,181386,E5E2DA460104E389257158E8D8C9FBDA,60311,6,11,5,109.52097,18.24319,1558
23606,181387,E5E2DA460104E389257158E8D8C9FBDA,60281,13,23,10,109.51743,18.25924,1561
23624,181457,7FD31F65A9E7574FDAD4A110ACBA289D,31931,1,2,1,109.54771,18.29403,1667
23625,181458,7FD31F65A9E7574FDAD4A110ACBA289D,60371,6,7,1,109.53063,18.30056,1618
23626,181459,7FD31F65A9E7574FDAD4A110ACBA289D,60171,9,10,1,109.51292,18.30694,1569
23630,181599,A8E9C7BB918ADAD29A3EA7ACDDCD32D7,38951,0,8,8,109.48097,18.28868,1416
23631,181600,A8E9C7BB918ADAD29A3EA7ACDDCD32D7,38951,8,15,7,109.48097,18.28868,1416
23632,181601,A8E9C7BB918ADAD29A3EA7ACDDCD32D7,30711,15,20,5,109.50271,18.25347,1510
23633,181602,A8E9C7BB918ADAD29A3EA7ACDDCD32D7,38951,21,22,1,109.48097,18.28868,1416
23639,181623,23C072325D16F69046C57FE53EA6F9E0,31071,1,8,7,109.58257,18.28458,1815
23640,181624,23C072325D16F69046C57FE53EA6F9E0,30854,12,13,1,109.56889,18.27076,1763
23641,181625,23C072325D16F69046C57FE53EA6F9E0,31071,13,23,10,109.58257,18.28458,1815
23642,181638,1980C8D409DE9551539224B3D393CDAA,30071,1,3,2,109.52819,18.30472,1619
23643,181639,1980C8D409DE9551539224B3D393CDAA,31951,6,8,2,109.52174,18.30299,1568
23644,181640,1980C8D409DE9551539224B3D393CDAA,30071,8,18,10,109.52819,18.30472,1619
23645,181641,1980C8D409DE9551539224B3D393CDAA,30071,20,22,2,109.52819,18.30472,1619
23666,181769,FA0EB766C44C307B69FC2247C53C674E,31031,0,7,7,109.49979,18.25382,1510
23667,181770,FA0EB766C44C307B69FC2247C53C674E,30421,7,9,2,109.50021,18.25861,1511
23668,181771,FA0EB766C44C307B69FC2247C53C674E,60131,12,15,3,109.49819,18.24778,1509
23669,181772,FA0EB766C44C307B69FC2247C53C674E,30151,18,22,4,109.50986,18.25083,1560
23670,181782,8B9A9BFD1ACAD480EB101A91DBF2024D,30421,0,2,2,109.50021,18.25861,1511
23671,181783,8B9A9BFD1ACAD480EB101A91DBF2024D,38291,2,18,16,109.51618,18.24313,1558
23672,181784,8B9A9BFD1ACAD480EB101A91DBF2024D,30421,18,22,4,109.50021,18.25861,1511
23676,181795,E9A67CAEAD4E146EE721320A56F893AA,31071,0,7,7,109.58257,18.28458,1815
23677,181796,E9A67CAEAD4E146EE721320A56F893AA,30854,11,12,1,109.56889,18.27076,1763
23678,181797,E9A67CAEAD4E146EE721320A56F893AA,31071,17,22,5,109.58257,18.28458,1815
23679,181827,F3EA4B3DF8A619A30272A53ECD9E968F,38185,2,8,6,109.51333,18.27347,1563
23680,181828,F3EA4B3DF8A619A30272A53ECD9E968F,38291,12,14,2,109.51618,18.24313,1558
23681,181829,F3EA4B3DF8A619A30272A53ECD9E968F,38185,19,23,4,109.51333,18.27347,1563
23684,181874,8752BC71725B50257436D50C6598F252,31071,0,13,13,109.58257,18.28458,1815
23685,181875,8752BC71725B50257436D50C6598F252,30854,14,16,2,109.56889,18.27076,1763
23686,181876,8752BC71725B50257436D50C6598F252,30234,18,20,2,109.60681,18.29979,1918
23687,181930,189633BA4D39EBA8A203BC9E364D4B1F,30381,0,7,7,109.52521,18.24507,1609
23688,181931,189633BA4D39EBA8A203BC9E364D4B1F,30051,12,18,6,109.48917,18.21215,1453
23689,181932,189633BA4D39EBA8A203BC9E364D4B1F,30721,19,20,1,109.51597,18.28257,1565
23702,182049,4639E7F597994307D62A7FF9CC65CC1D,30854,1,2,1,109.56889,18.27076,1763
23703,182050,4639E7F597994307D62A7FF9CC65CC1D,31071,2,6,4,109.58257,18.28458,1815
23704,182051,4639E7F597994307D62A7FF9CC65CC1D,30854,6,8,2,109.56889,18.27076,1763
23709,182158,53453D8B736810206EC5A6632D159BE6,31931,0,15,15,109.54771,18.29403,1667
23710,182159,53453D8B736810206EC5A6632D159BE6,60371,15,17,2,109.53063,18.30056,1618
23711,182160,53453D8B736810206EC5A6632D159BE6,31931,20,23,3,109.54771,18.29403,1667
23744,182378,9ADBCE363F6C95D971E05A07ACCD27F2,31945,1,2,1,109.58021,18.29403,1817
23745,182379,9ADBCE363F6C95D971E05A07ACCD27F2,30854,4,18,14,109.56889,18.27076,1763
23746,182380,9ADBCE363F6C95D971E05A07ACCD27F2,31071,21,23,2,109.58257,18.28458,1815
23756,182443,C8922FAF66F21ECAECB6B717FCD5A53B,60614,0,13,13,109.48799,18.29521,1467
23757,182444,C8922FAF66F21ECAECB6B717FCD5A53B,60391,14,16,2,109.47667,18.28757,1416
23758,182445,C8922FAF66F21ECAECB6B717FCD5A53B,60614,16,22,6,109.48799,18.29521,1467
23759,182448,9E8746086915F9D4A063A74CF0B5B7AB,30851,0,3,3,109.5616,18.27396,1713
23760,182449,9E8746086915F9D4A063A74CF0B5B7AB,31561,3,6,3,109.56792,18.28479,1765
23761,182450,9E8746086915F9D4A063A74CF0B5B7AB,39183,9,14,5,109.55542,18.28208,1715
23793,182624,08A066736557478B1013C0CF834491DF,30921,0,7,7,109.53903,18.29451,1667
23794,182625,08A066736557478B1013C0CF834491DF,31931,10,11,1,109.54771,18.29403,1667
23795,182626,08A066736557478B1013C0CF834491DF,30921,14,18,4,109.53903,18.29451,1667
23802,182683,E75CF54BA14775FEDD26504F9F6B7365,31945,0,6,6,109.58021,18.29403,1817
23803,182684,E75CF54BA14775FEDD26504F9F6B7365,31561,8,16,8,109.56792,18.28479,1765
23804,182685,E75CF54BA14775FEDD26504F9F6B7365,31945,19,21,2,109.58021,18.29403,1817
23805,182716,470B644FF80F707DCE59E28652EFEBA3,31361,0,2,2,109.47417,18.28292,1415
23806,182717,470B644FF80F707DCE59E28652EFEBA3,60391,3,5,2,109.47667,18.28757,1416
23807,182718,470B644FF80F707DCE59E28652EFEBA3,31361,5,6,1,109.47417,18.28292,1415
23816,182797,75616D7735994EB9CD2FE56D29700535,31561,1,9,8,109.56792,18.28479,1765
23817,182798,75616D7735994EB9CD2FE56D29700535,30854,11,13,2,109.56889,18.27076,1763
23818,182799,75616D7735994EB9CD2FE56D29700535,31561,14,17,3,109.56792,18.28479,1765
23821,182802,39F25FE146A03325C93C111F2A943B6C,31945,0,7,7,109.58021,18.29403,1817
23822,182803,39F25FE146A03325C93C111F2A943B6C,30854,7,8,1,109.56889,18.27076,1763
23823,182804,39F25FE146A03325C93C111F2A943B6C,31071,10,16,6,109.58257,18.28458,1815
23824,182805,39F25FE146A03325C93C111F2A943B6C,30854,16,22,6,109.56889,18.27076,1763
23855,183011,E0A24740E2C54F3B77DB561A91D2BED7,30371,0,7,7,109.51,18.24771,1559
23856,183012,E0A24740E2C54F3B77DB561A91D2BED7,30251,7,12,5,109.50611,18.26653,1512
23857,183013,E0A24740E2C54F3B77DB561A91D2BED7,30151,13,17,4,109.50986,18.25083,1560
23858,183014,8CD15CF6B5FB4821940FF9AFE6D6CB84,39181,0,10,10,109.55153,18.28035,1715
23859,183015,8CD15CF6B5FB4821940FF9AFE6D6CB84,31931,12,16,4,109.54771,18.29403,1667
23860,183016,8CD15CF6B5FB4821940FF9AFE6D6CB84,39181,19,23,4,109.55153,18.28035,1715
23893,183238,03CEC0FDDD5484124514C6D24A63D4DD,31561,0,4,4,109.56792,18.28479,1765
23894,183239,03CEC0FDDD5484124514C6D24A63D4DD,30854,4,6,2,109.56889,18.27076,1763
23895,183240,03CEC0FDDD5484124514C6D24A63D4DD,31561,7,19,12,109.56792,18.28479,1765
23896,183241,03CEC0FDDD5484124514C6D24A63D4DD,30854,19,23,4,109.56889,18.27076,1763
23899,183253,87ACF3C6ADE430D2B9DFB3C954E0C031,31071,5,13,8,109.58257,18.28458,1815
23900,183254,87ACF3C6ADE430D2B9DFB3C954E0C031,30854,14,16,2,109.56889,18.27076,1763
23901,183255,87ACF3C6ADE430D2B9DFB3C954E0C031,39183,17,19,2,109.55542,18.28208,1715
23902,183256,87ACF3C6ADE430D2B9DFB3C954E0C031,30854,21,23,2,109.56889,18.27076,1763
23910,183337,2F3BB5BE10811E7F8F8565DAA2126DE6,39181,0,4,4,109.55153,18.28035,1715
23911,183338,2F3BB5BE10811E7F8F8565DAA2126DE6,39181,7,8,1,109.55153,18.28035,1715
23912,183339,2F3BB5BE10811E7F8F8565DAA2126DE6,39181,9,23,14,109.55153,18.28035,1715
23949,183718,752B4C65CCCA1EA27D3C6EA24E289B9C,31071,0,7,7,109.58257,18.28458,1815
23950,183719,752B4C65CCCA1EA27D3C6EA24E289B9C,30854,8,10,2,109.56889,18.27076,1763
23951,183720,752B4C65CCCA1EA27D3C6EA24E289B9C,60301,13,14,1,109.60715,18.30993,1919
23952,183721,752B4C65CCCA1EA27D3C6EA24E289B9C,30854,17,21,4,109.56889,18.27076,1763
23960,183764,947F03940C60BAB03B48F948CC8A55AE,30851,0,10,10,109.5616,18.27396,1713
23961,183765,947F03940C60BAB03B48F948CC8A55AE,39154,12,13,1,109.50201,18.25681,1511
23962,183766,947F03940C60BAB03B48F948CC8A55AE,30854,18,23,5,109.56889,18.27076,1763
23973,183874,7BF65E5054DA81A230AB5423620158E1,60631,0,7,7,109.57778,18.27583,1814
23974,183875,7BF65E5054DA81A230AB5423620158E1,30854,7,18,11,109.56889,18.27076,1763
23975,183876,7BF65E5054DA81A230AB5423620158E1,38171,21,22,1,109.50799,18.28139,1515
23986,183943,E6651E3C6D8FEA2077D9EFC6D097D06C,38251,0,10,10,109.49618,18.25493,1510
23987,183944,E6651E3C6D8FEA2077D9EFC6D097D06C,38251,10,14,4,109.49618,18.25493,1510
23988,183945,E6651E3C6D8FEA2077D9EFC6D097D06C,38251,16,23,7,109.49618,18.25493,1510
23996,184052,A46BA306DAEA889FAC7ACE9E5FD6A1FF,30081,0,1,1,109.50243,18.26632,1512
23997,184053,A46BA306DAEA889FAC7ACE9E5FD6A1FF,39154,2,8,6,109.50201,18.25681,1511
23998,184054,A46BA306DAEA889FAC7ACE9E5FD6A1FF,30911,8,9,1,109.50493,18.26181,1511
24010,184165,C1C69C0EAD4ABEFD1467543102429D9B,31561,0,1,1,109.56792,18.28479,1765
24011,184166,C1C69C0EAD4ABEFD1467543102429D9B,39183,3,5,2,109.55542,18.28208,1715
24012,184167,C1C69C0EAD4ABEFD1467543102429D9B,31561,5,8,3,109.56792,18.28479,1765
24026,184245,8AABF5FDF2B06EB445749240A3894969,31071,0,8,8,109.58257,18.28458,1815
24027,184246,8AABF5FDF2B06EB445749240A3894969,30854,8,14,6,109.56889,18.27076,1763
24028,184247,8AABF5FDF2B06EB445749240A3894969,31071,18,20,2,109.58257,18.28458,1815
24029,184248,8AABF5FDF2B06EB445749240A3894969,31561,22,23,1,109.56792,18.28479,1765
24030,184269,4B6FFEFB36770528DA20871CE9291F99,31521,2,14,12,109.51458,18.22542,1555
24031,184270,4B6FFEFB36770528DA20871CE9291F99,31521,15,18,3,109.51458,18.22542,1555
24032,184271,4B6FFEFB36770528DA20871CE9291F99,39321,18,20,2,109.529,18.2167,1604
24033,184272,4B6FFEFB36770528DA20871CE9291F99,31521,20,21,1,109.51458,18.22542,1555
24042,184318,FE95B3A32EFBC2838F293DF38F55FDD1,39183,2,4,2,109.55542,18.28208,1715
24043,184319,FE95B3A32EFBC2838F293DF38F55FDD1,31561,9,11,2,109.56792,18.28479,1765
24044,184320,FE95B3A32EFBC2838F293DF38F55FDD1,39183,12,13,1,109.55542,18.28208,1715
24045,184321,FE95B3A32EFBC2838F293DF38F55FDD1,31561,14,15,1,109.56792,18.28479,1765
24048,184404,30CE72A519D49881F23B8123486E3A02,60411,1,13,12,109.32514,18.30854,869
24049,184405,30CE72A519D49881F23B8123486E3A02,31471,13,21,8,109.34583,18.29563,917
24050,184406,30CE72A519D49881F23B8123486E3A02,60411,21,22,1,109.32514,18.30854,869
24054,184439,9A1D1AA5EE2CD156CC396C667ED8C5B9,31071,0,6,6,109.58257,18.28458,1815
24055,184440,9A1D1AA5EE2CD156CC396C667ED8C5B9,30854,10,16,6,109.56889,18.27076,1763
24056,184441,9A1D1AA5EE2CD156CC396C667ED8C5B9,60631,20,21,1,109.57778,18.27583,1814
24057,184444,0E92CE103B7D015A3121B51920E312F8,31021,0,15,15,109.49021,18.27,1463
24058,184445,0E92CE103B7D015A3121B51920E312F8,38261,15,17,2,109.50361,18.28153,1515
24059,184446,0E92CE103B7D015A3121B51920E312F8,30421,19,21,2,109.50021,18.25861,1511
24060,184447,0E92CE103B7D015A3121B51920E312F8,31021,22,23,1,109.49021,18.27,1463
24066,184587,8FEFA204EA7EEB362556D906D163980A,30854,0,10,10,109.56889,18.27076,1763
24067,184588,8FEFA204EA7EEB362556D906D163980A,31071,12,13,1,109.58257,18.28458,1815
24068,184589,8FEFA204EA7EEB362556D906D163980A,30854,18,19,1,109.56889,18.27076,1763
24108,184804,8CD2F16F090DFFBF34897CAC847CB1B1,38991,0,11,11,109.52681,18.30368,1618
24109,184805,8CD2F16F090DFFBF34897CAC847CB1B1,38316,13,14,1,109.48542,18.27424,1464
24110,184806,8CD2F16F090DFFBF34897CAC847CB1B1,38991,18,23,5,109.52681,18.30368,1618
24118,184842,68DBE0B52FD0AB95F1DD47068FD7847F,30181,0,11,11,109.51597,18.23313,1557
24119,184843,68DBE0B52FD0AB95F1DD47068FD7847F,31521,12,15,3,109.51458,18.22542,1555
24120,184844,68DBE0B52FD0AB95F1DD47068FD7847F,30181,17,23,6,109.51597,18.23313,1557
24151,185087,222E0B6922623CE9FBB280F81068D40E,30371,3,4,1,109.51,18.24771,1559
24152,185088,222E0B6922623CE9FBB280F81068D40E,30731,6,14,8,109.50944,18.22306,1555
24153,185089,222E0B6922623CE9FBB280F81068D40E,31521,15,16,1,109.51458,18.22542,1555
24154,185090,222E0B6922623CE9FBB280F81068D40E,31421,18,20,2,109.55382,18.22347,1705
24157,185137,9BD095517798346F169AD6D898CA1A42,60274,0,1,1,109.514,18.2933,1567
24158,185138,9BD095517798346F169AD6D898CA1A42,60361,3,4,1,109.51938,18.29681,1567
24159,185139,9BD095517798346F169AD6D898CA1A42,60221,6,8,2,109.52569,18.29188,1616
24178,185378,FF8CB3D02361FAEBFE418108180099D8,39154,0,5,5,109.50201,18.25681,1511
24179,185379,FF8CB3D02361FAEBFE418108180099D8,60201,6,8,2,109.5041,18.2509,1510
24180,185380,FF8CB3D02361FAEBFE418108180099D8,31261,8,9,1,109.51174,18.2466,1559
24181,185381,FF8CB3D02361FAEBFE418108180099D8,30711,10,23,13,109.50271,18.25347,1510
24184,185414,5A888DC7A3AA300CC584D9862C5384A1,30771,4,5,1,109.49938,18.26042,1511
24185,185415,5A888DC7A3AA300CC584D9862C5384A1,39183,8,18,10,109.55542,18.28208,1715
24186,185416,5A888DC7A3AA300CC584D9862C5384A1,30421,20,23,3,109.50021,18.25861,1511
24187,185484,FBDD80570A641C18D89F4987D07601F8,31561,1,10,9,109.56792,18.28479,1765
24188,185485,FBDD80570A641C18D89F4987D07601F8,30854,11,16,5,109.56889,18.27076,1763
24189,185486,FBDD80570A641C18D89F4987D07601F8,31071,20,23,3,109.58257,18.28458,1815
24192,185525,A9F97D2464709590426A157138F3C687,31931,0,18,18,109.54771,18.29403,1667
24193,185526,A9F97D2464709590426A157138F3C687,39183,19,20,1,109.55542,18.28208,1715
24194,185527,A9F97D2464709590426A157138F3C687,31931,21,22,1,109.54771,18.29403,1667
24208,185604,17D13F6A66037B54FAB5668CDC734401,30721,0,6,6,109.51597,18.28257,1565
24209,185605,17D13F6A66037B54FAB5668CDC734401,31931,7,11,4,109.54771,18.29403,1667
24210,185606,17D13F6A66037B54FAB5668CDC734401,39181,13,15,2,109.55153,18.28035,1715
24211,185607,17D13F6A66037B54FAB5668CDC734401,30721,19,23,4,109.51597,18.28257,1565
24257,186017,9CCF240AA09CA64BC883A0FAC7F89243,31521,4,16,12,109.51458,18.22542,1555
24258,186018,9CCF240AA09CA64BC883A0FAC7F89243,60381,18,20,2,109.5241,18.22458,1605
24259,186019,9CCF240AA09CA64BC883A0FAC7F89243,60381,20,22,2,109.5241,18.22458,1605
24260,186032,4B004637D3CFBCA65EA00FFD3F1EF7A6,39183,2,3,1,109.55542,18.28208,1715
24261,186033,4B004637D3CFBCA65EA00FFD3F1EF7A6,31561,5,14,9,109.56792,18.28479,1765
24262,186034,4B004637D3CFBCA65EA00FFD3F1EF7A6,39183,15,16,1,109.55542,18.28208,1715
24263,186035,4B004637D3CFBCA65EA00FFD3F1EF7A6,31561,20,21,1,109.56792,18.28479,1765
24269,186095,706B8E0F0F5D1C9FC2F8EBB2574EE89F,30711,0,18,18,109.50271,18.25347,1510
24270,186096,706B8E0F0F5D1C9FC2F8EBB2574EE89F,30711,18,21,3,109.50271,18.25347,1510
24271,186097,706B8E0F0F5D1C9FC2F8EBB2574EE89F,30711,22,23,1,109.50271,18.25347,1510
24279,186140,909FBB0C84910641E7440FBAD40E8C52,39183,0,6,6,109.55542,18.28208,1715
24280,186141,909FBB0C84910641E7440FBAD40E8C52,31931,8,10,2,109.54771,18.29403,1667
24281,186142,909FBB0C84910641E7440FBAD40E8C52,39183,15,23,8,109.55542,18.28208,1715
24287,186184,DE85A2F9432633114A7B9A1B323B8AE9,30051,0,15,15,109.48917,18.21215,1453
24288,186185,DE85A2F9432633114A7B9A1B323B8AE9,38017,15,16,1,109.49729,18.21424,1504
24289,186186,DE85A2F9432633114A7B9A1B323B8AE9,30051,17,23,6,109.48917,18.21215,1453
24290,186195,2F440A235E684ECEDD042B3100A4AE95,31071,0,7,7,109.58257,18.28458,1815
24291,186196,2F440A235E684ECEDD042B3100A4AE95,30101,9,11,2,109.57299,18.33333,1773
24292,186197,2F440A235E684ECEDD042B3100A4AE95,30854,11,13,2,109.56889,18.27076,1763
24293,186200,0402BD114B7D5E20705E302B756CD062,60631,1,6,5,109.57778,18.27583,1814
24294,186201,0402BD114B7D5E20705E302B756CD062,30854,7,9,2,109.56889,18.27076,1763
24295,186202,0402BD114B7D5E20705E302B756CD062,31071,10,12,2,109.58257,18.28458,1815
24325,186300,B55959B64746A18ECF5077B5F7359221,31561,0,4,4,109.56792,18.28479,1765
24326,186301,B55959B64746A18ECF5077B5F7359221,39183,7,8,1,109.55542,18.28208,1715
24327,186302,B55959B64746A18ECF5077B5F7359221,31561,8,15,7,109.56792,18.28479,1765
24333,186335,7E8F7A106D56BA02167BE8BEC6D1DCB2,31071,0,8,8,109.58257,18.28458,1815
24334,186336,7E8F7A106D56BA02167BE8BEC6D1DCB2,60354,8,10,2,109.58701,18.28521,1815
24335,186337,7E8F7A106D56BA02167BE8BEC6D1DCB2,30854,13,15,2,109.56889,18.27076,1763
24336,186338,7E8F7A106D56BA02167BE8BEC6D1DCB2,31071,16,21,5,109.58257,18.28458,1815
24351,186507,45CCFCD3EBDF941E1C92B70ED06E8B5E,31561,2,3,1,109.56792,18.28479,1765
24352,186508,45CCFCD3EBDF941E1C92B70ED06E8B5E,30854,4,8,4,109.56889,18.27076,1763
24353,186509,45CCFCD3EBDF941E1C92B70ED06E8B5E,31945,8,9,1,109.58021,18.29403,1817
24360,186542,6B806948BC9187A91D033B4096721B00,31561,0,5,5,109.56792,18.28479,1765
24361,186543,6B806948BC9187A91D033B4096721B00,30851,8,9,1,109.5616,18.27396,1713
24362,186544,6B806948BC9187A91D033B4096721B00,31071,12,20,8,109.58257,18.28458,1815
24387,186723,14DC9638CB494ECD60B58F300BAA61B6,39181,0,11,11,109.55153,18.28035,1715
24388,186724,14DC9638CB494ECD60B58F300BAA61B6,39181,11,13,2,109.55153,18.28035,1715
24389,186725,14DC9638CB494ECD60B58F300BAA61B6,39181,15,23,8,109.55153,18.28035,1715
24390,186726,76B21384CC3EFE3F43353B93FDFE32EE,30821,2,7,5,109.43681,18.33639,1274
24391,186727,76B21384CC3EFE3F43353B93FDFE32EE,30651,7,8,1,109.42611,18.385,1232
24392,186728,76B21384CC3EFE3F43353B93FDFE32EE,30821,12,23,11,109.43681,18.33639,1274
24408,186866,3977578BE56276DA0700B04B81DC1356,31561,2,17,15,109.56792,18.28479,1765
24409,186867,3977578BE56276DA0700B04B81DC1356,30851,17,20,3,109.5616,18.27396,1713
24410,186868,3977578BE56276DA0700B04B81DC1356,31561,22,23,1,109.56792,18.28479,1765
24444,187056,FA14B010F60C7FB3B13194FAA13740E8,31561,1,3,2,109.56792,18.28479,1765
24445,187057,FA14B010F60C7FB3B13194FAA13740E8,30851,4,5,1,109.5616,18.27396,1713
24446,187058,FA14B010F60C7FB3B13194FAA13740E8,39183,10,11,1,109.55542,18.28208,1715
24447,187059,FA14B010F60C7FB3B13194FAA13740E8,31561,13,21,8,109.56792,18.28479,1765
24475,187169,DDE77D3A656666992FC3458B84010D43,39183,0,3,3,109.55542,18.28208,1715
24476,187170,DDE77D3A656666992FC3458B84010D43,31561,7,8,1,109.56792,18.28479,1765
24477,187171,DDE77D3A656666992FC3458B84010D43,39183,12,14,2,109.55542,18.28208,1715
24482,187202,2C3BD53A8702A47FB82F05FB4993B683,31561,2,3,1,109.56792,18.28479,1765
24483,187203,2C3BD53A8702A47FB82F05FB4993B683,39181,7,9,2,109.55153,18.28035,1715
24484,187204,2C3BD53A8702A47FB82F05FB4993B683,31561,11,22,11,109.56792,18.28479,1765
24500,187328,2951B609D4809F44409A5DD8DDED7FBC,60594,1,8,7,109.62694,18.22799,1956
24501,187329,2951B609D4809F44409A5DD8DDED7FBC,38052,10,13,3,109.62618,18.23042,1956
24502,187330,2951B609D4809F44409A5DD8DDED7FBC,60594,13,15,2,109.62694,18.22799,1956
24503,187331,2951B609D4809F44409A5DD8DDED7FBC,38331,19,23,4,109.62465,18.22736,1956
24509,187417,34AB502A442AA8EA4A7FB30471B204DB,38325,4,6,2,109.39792,18.2909,1116
24510,187418,34AB502A442AA8EA4A7FB30471B204DB,31431,8,9,1,109.44639,18.29042,1316
24511,187419,34AB502A442AA8EA4A7FB30471B204DB,38094,10,11,1,109.45403,18.28778,1316
24512,187420,34AB502A442AA8EA4A7FB30471B204DB,30341,13,14,1,109.3625,18.29167,966
24513,187428,1A1B5C664F8D6460240C73AB76187420,30854,0,1,1,109.56889,18.27076,1763
24514,187429,1A1B5C664F8D6460240C73AB76187420,31071,1,7,6,109.58257,18.28458,1815
24515,187430,1A1B5C664F8D6460240C73AB76187420,30854,7,9,2,109.56889,18.27076,1763
24518,187471,0695D4E7B3E726CA09D841B87798B560,31561,0,2,2,109.56792,18.28479,1765
24519,187472,0695D4E7B3E726CA09D841B87798B560,60354,5,6,1,109.58701,18.28521,1815
24520,187473,0695D4E7B3E726CA09D841B87798B560,30854,8,14,6,109.56889,18.27076,1763
24526,187513,63FBAC0202144B00077561285E6A7F87,30821,4,13,9,109.43681,18.33639,1274
24527,187514,63FBAC0202144B00077561285E6A7F87,30651,14,16,2,109.42611,18.385,1232
24528,187515,63FBAC0202144B00077561285E6A7F87,30821,16,23,7,109.43681,18.33639,1274
24529,187597,89362A3CA3AE6F5B75871F2110924F99,30851,0,6,6,109.5616,18.27396,1713
24530,187598,89362A3CA3AE6F5B75871F2110924F99,39371,8,9,1,109.56627,18.2646,1762
24531,187599,89362A3CA3AE6F5B75871F2110924F99,31551,12,16,4,109.55868,18.24222,1708
24532,187600,89362A3CA3AE6F5B75871F2110924F99,30851,16,23,7,109.5616,18.27396,1713
24533,187613,5533066D8871087CCD481B88DD73EF7D,31361,0,8,8,109.47417,18.28292,1415
24534,187614,5533066D8871087CCD481B88DD73EF7D,60401,10,18,8,109.47444,18.27583,1414
24535,187615,5533066D8871087CCD481B88DD73EF7D,31361,18,23,5,109.47417,18.28292,1415
24536,187620,77D805C7CC3CDE277FD34ED04AB294D2,31521,0,2,2,109.51458,18.22542,1555
24537,187621,77D805C7CC3CDE277FD34ED04AB294D2,39321,5,11,6,109.529,18.2167,1604
24538,187622,77D805C7CC3CDE277FD34ED04AB294D2,31521,13,16,3,109.51458,18.22542,1555
24539,187623,77D805C7CC3CDE277FD34ED04AB294D2,60381,19,21,2,109.5241,18.22458,1605
24542,187663,B78E7295CB13532B4E2C30EF158E297F,30854,2,5,3,109.56889,18.27076,1763
24543,187664,B78E7295CB13532B4E2C30EF158E297F,31931,5,10,5,109.54771,18.29403,1667
24544,187665,B78E7295CB13532B4E2C30EF158E297F,30851,12,15,3,109.5616,18.27396,1713
24552,187785,18073AD9E71B8DFC1E520C5E3653B1BD,31951,0,14,14,109.52174,18.30299,1568
24553,187786,18073AD9E71B8DFC1E520C5E3653B1BD,30421,16,18,2,109.50021,18.25861,1511
24554,187787,18073AD9E71B8DFC1E520C5E3653B1BD,30771,19,20,1,109.49938,18.26042,1511
24562,187869,491A112CD81B9085F752897809919691,31201,0,14,14,109.51042,18.23819,1558
24563,187870,491A112CD81B9085F752897809919691,60201,14,15,1,109.5041,18.2509,1510
24564,187871,491A112CD81B9085F752897809919691,31201,20,23,3,109.51042,18.23819,1558
24570,187912,21FBB6F0F825A6B1E89545963BB6C9D3,30854,2,3,1,109.56889,18.27076,1763
24571,187913,21FBB6F0F825A6B1E89545963BB6C9D3,30851,4,6,2,109.5616,18.27396,1713
24572,187914,21FBB6F0F825A6B1E89545963BB6C9D3,30854,9,10,1,109.56889,18.27076,1763
24573,187955,E4B522EF4348156010E5C578EC13D60F,30854,0,2,2,109.56889,18.27076,1763
24574,187956,E4B522EF4348156010E5C578EC13D60F,31071,3,8,5,109.58257,18.28458,1815
24575,187957,E4B522EF4348156010E5C578EC13D60F,30854,9,12,3,109.56889,18.27076,1763
24576,187965,DA759AC2EBBA8078FBC390D09D5C4EC7,60354,0,2,2,109.58701,18.28521,1815
24577,187966,DA759AC2EBBA8078FBC390D09D5C4EC7,30854,3,10,7,109.56889,18.27076,1763
24578,187967,DA759AC2EBBA8078FBC390D09D5C4EC7,31071,10,11,1,109.58257,18.28458,1815
24579,187968,DA759AC2EBBA8078FBC390D09D5C4EC7,30854,11,15,4,109.56889,18.27076,1763
24598,188132,3066D3BA0EF6F55E10FAD924A6ADDDEF,39091,0,1,1,109.50097,18.25222,1510
24599,188133,3066D3BA0EF6F55E10FAD924A6ADDDEF,30381,2,12,10,109.52521,18.24507,1609
24600,188134,3066D3BA0EF6F55E10FAD924A6ADDDEF,31031,14,15,1,109.49979,18.25382,1510
24601,188135,3066D3BA0EF6F55E10FAD924A6ADDDEF,30421,18,23,5,109.50021,18.25861,1511
24634,188333,C153552CEA2677B0FF473AE565EA979E,30821,3,6,3,109.43681,18.33639,1274
24635,188334,C153552CEA2677B0FF473AE565EA979E,30651,9,11,2,109.42611,18.385,1232
24636,188335,C153552CEA2677B0FF473AE565EA979E,30821,11,23,12,109.43681,18.33639,1274
24678,188661,BC2EDF4DF9C7FAD55BDEABA03DFA7284,31561,0,11,11,109.56792,18.28479,1765
24679,188662,BC2EDF4DF9C7FAD55BDEABA03DFA7284,30851,12,13,1,109.5616,18.27396,1713
24680,188663,BC2EDF4DF9C7FAD55BDEABA03DFA7284,39183,15,16,1,109.55542,18.28208,1715
24681,188664,BC2EDF4DF9C7FAD55BDEABA03DFA7284,31561,19,23,4,109.56792,18.28479,1765
24709,188991,C19430CE8DF26BDEF43903E57E682236,31561,0,13,13,109.56792,18.28479,1765
24710,188992,C19430CE8DF26BDEF43903E57E682236,30854,14,16,2,109.56889,18.27076,1763
24711,188993,C19430CE8DF26BDEF43903E57E682236,31561,20,23,3,109.56792,18.28479,1765
24718,189154,2361E8D6BAB0231B2E8E3C0F34517282,30291,0,8,8,109.50403,18.27028,1513
24719,189155,2361E8D6BAB0231B2E8E3C0F34517282,60331,10,13,3,109.505,18.26507,1512
24720,189156,2361E8D6BAB0231B2E8E3C0F34517282,30081,13,19,6,109.50243,18.26632,1512
24721,189157,2361E8D6BAB0231B2E8E3C0F34517282,30291,19,21,2,109.50403,18.27028,1513
24736,189307,996C0D9500BF90CC0E7F5A04C49A464B,31931,0,9,9,109.54771,18.29403,1667
24737,189308,996C0D9500BF90CC0E7F5A04C49A464B,30921,11,12,1,109.53903,18.29451,1667
24738,189309,996C0D9500BF90CC0E7F5A04C49A464B,31931,14,16,2,109.54771,18.29403,1667
24739,189310,996C0D9500BF90CC0E7F5A04C49A464B,39181,19,21,2,109.55153,18.28035,1715
24740,189330,B340EDEF4A878E8DF5CBEC25E465EACE,31071,0,1,1,109.58257,18.28458,1815
24741,189331,B340EDEF4A878E8DF5CBEC25E465EACE,30854,3,18,15,109.56889,18.27076,1763
24742,189332,B340EDEF4A878E8DF5CBEC25E465EACE,31071,21,23,2,109.58257,18.28458,1815
24763,189555,770A00BDAFE9BCA8C9E9FA68066EED7D,31071,0,5,5,109.58257,18.28458,1815
24764,189556,770A00BDAFE9BCA8C9E9FA68066EED7D,31561,8,20,12,109.56792,18.28479,1765
24765,189557,770A00BDAFE9BCA8C9E9FA68066EED7D,31071,20,22,2,109.58257,18.28458,1815
24769,189585,3BB007FDF28DB0E7E883BA594F721FFE,31181,0,11,11,109.50382,18.24813,1509
24770,189586,3BB007FDF28DB0E7E883BA594F721FFE,31181,12,14,2,109.50382,18.24813,1509
24771,189587,3BB007FDF28DB0E7E883BA594F721FFE,31181,16,23,7,109.50382,18.24813,1509
24772,189615,1D95C9F25428D40F06E5BFA001370E3C,31071,0,11,11,109.58257,18.28458,1815
24773,189616,1D95C9F25428D40F06E5BFA001370E3C,30854,11,16,5,109.56889,18.27076,1763
24774,189617,1D95C9F25428D40F06E5BFA001370E3C,31071,17,23,6,109.58257,18.28458,1815
24775,189647,DC0EB400EA24BEE9EB39D315B0E6AEF0,60041,0,7,7,109.39889,18.31944,1121
24776,189648,DC0EB400EA24BEE9EB39D315B0E6AEF0,31701,12,13,1,109.44132,18.28833,1266
24777,189649,DC0EB400EA24BEE9EB39D315B0E6AEF0,38871,18,23,5,109.44681,18.28625,1316
24778,189654,9FEA4B85EAE4FAEE1CAF0EABFF2FAEA1,31561,0,3,3,109.56792,18.28479,1765
24779,189655,9FEA4B85EAE4FAEE1CAF0EABFF2FAEA1,30854,4,5,1,109.56889,18.27076,1763
24780,189656,9FEA4B85EAE4FAEE1CAF0EABFF2FAEA1,31561,8,9,1,109.56792,18.28479,1765
24781,189657,9FEA4B85EAE4FAEE1CAF0EABFF2FAEA1,30854,11,23,12,109.56889,18.27076,1763
24809,189836,E8D51F8B53F290BFD73338AD2AD8C728,31561,3,5,2,109.56792,18.28479,1765
24810,189837,E8D51F8B53F290BFD73338AD2AD8C728,31931,8,15,7,109.54771,18.29403,1667
24811,189838,E8D51F8B53F290BFD73338AD2AD8C728,31561,19,22,3,109.56792,18.28479,1765
24847,190270,BE586ACB441383CC10D7CF3923850B73,31931,0,7,7,109.54771,18.29403,1667
24848,190271,BE586ACB441383CC10D7CF3923850B73,39181,7,16,9,109.55153,18.28035,1715
24849,190272,BE586ACB441383CC10D7CF3923850B73,31931,18,20,2,109.54771,18.29403,1667
24862,190349,FF90B6855593CFEA9A07FE008E94551D,60371,0,4,4,109.53063,18.30056,1618
24863,190350,FF90B6855593CFEA9A07FE008E94551D,30071,5,7,2,109.52819,18.30472,1619
24864,190351,FF90B6855593CFEA9A07FE008E94551D,31931,8,14,6,109.54771,18.29403,1667
24865,190352,FF90B6855593CFEA9A07FE008E94551D,30071,19,21,2,109.52819,18.30472,1619
24868,190377,96F98526707B06BE1263CCD4F72E07A1,31071,0,8,8,109.58257,18.28458,1815
24869,190378,96F98526707B06BE1263CCD4F72E07A1,30854,9,11,2,109.56889,18.27076,1763
24870,190379,96F98526707B06BE1263CCD4F72E07A1,31071,15,17,2,109.58257,18.28458,1815
24873,190439,B16225DD3371073720184BB0D089E6D6,31561,0,11,11,109.56792,18.28479,1765
24874,190440,B16225DD3371073720184BB0D089E6D6,30854,12,15,3,109.56889,18.27076,1763
24875,190441,B16225DD3371073720184BB0D089E6D6,31071,17,18,1,109.58257,18.28458,1815
24876,190442,B93185B4820D7E0DEE74EBEA00941D15,31261,0,1,1,109.51174,18.2466,1559
24877,190443,B93185B4820D7E0DEE74EBEA00941D15,30911,1,17,16,109.50493,18.26181,1511
24878,190444,B93185B4820D7E0DEE74EBEA00941D15,38291,21,23,2,109.51618,18.24313,1558
24890,190559,121138E269BBF0B506FA8CE6CEB3BF52,31931,0,7,7,109.54771,18.29403,1667
24891,190560,121138E269BBF0B506FA8CE6CEB3BF52,39181,8,10,2,109.55153,18.28035,1715
24892,190561,121138E269BBF0B506FA8CE6CEB3BF52,39181,12,18,6,109.55153,18.28035,1715
24893,190562,121138E269BBF0B506FA8CE6CEB3BF52,31931,20,23,3,109.54771,18.29403,1667
24905,190691,DBB710D279E76C79F1E4B0766F579F8A,31071,0,7,7,109.58257,18.28458,1815
24906,190692,DBB710D279E76C79F1E4B0766F579F8A,30854,8,16,8,109.56889,18.27076,1763
24907,190693,DBB710D279E76C79F1E4B0766F579F8A,60631,16,17,1,109.57778,18.27583,1814
24910,190716,CCCD2290FB632A48009771412BE68ADD,31561,0,14,14,109.56792,18.28479,1765
24911,190717,CCCD2290FB632A48009771412BE68ADD,39183,16,18,2,109.55542,18.28208,1715
24912,190718,CCCD2290FB632A48009771412BE68ADD,31561,20,21,1,109.56792,18.28479,1765
24933,190812,84D09807769454188E86D49181B1B5D0,39154,0,9,9,109.50201,18.25681,1511
24934,190813,84D09807769454188E86D49181B1B5D0,31181,11,13,2,109.50382,18.24813,1509
24935,190814,84D09807769454188E86D49181B1B5D0,60381,15,16,1,109.5241,18.22458,1605
24936,190815,84D09807769454188E86D49181B1B5D0,39154,19,21,2,109.50201,18.25681,1511
24956,191020,012ABD06F231728C214A4BA917E75B1C,31561,0,7,7,109.56792,18.28479,1765
24957,191021,012ABD06F231728C214A4BA917E75B1C,30851,10,14,4,109.5616,18.27396,1713
24958,191022,012ABD06F231728C214A4BA917E75B1C,31561,15,22,7,109.56792,18.28479,1765
24959,191026,A8E9C7BB918ADAD29A3EA7ACDDCD32D7,38951,0,11,11,109.48097,18.28868,1416
24960,191027,A8E9C7BB918ADAD29A3EA7ACDDCD32D7,38951,11,14,3,109.48097,18.28868,1416
24961,191028,A8E9C7BB918ADAD29A3EA7ACDDCD32D7,38951,14,23,9,109.48097,18.28868,1416
24965,191051,23C072325D16F69046C57FE53EA6F9E0,31071,0,9,9,109.58257,18.28458,1815
24966,191052,23C072325D16F69046C57FE53EA6F9E0,30854,11,12,1,109.56889,18.27076,1763
24967,191053,23C072325D16F69046C57FE53EA6F9E0,31811,15,16,1,109.54201,18.31806,1671
24968,191059,1980C8D409DE9551539224B3D393CDAA,38991,0,6,6,109.52681,18.30368,1618
24969,191060,1980C8D409DE9551539224B3D393CDAA,31951,6,8,2,109.52174,18.30299,1568
24970,191061,1980C8D409DE9551539224B3D393CDAA,30071,8,11,3,109.52819,18.30472,1619
24971,191062,1980C8D409DE9551539224B3D393CDAA,31951,13,18,5,109.52174,18.30299,1568
24981,191112,D9AE11CD16B231308C3F0FB3F53BC3E9,30854,0,8,8,109.56889,18.27076,1763
24982,191113,D9AE11CD16B231308C3F0FB3F53BC3E9,31071,9,10,1,109.58257,18.28458,1815
24983,191114,D9AE11CD16B231308C3F0FB3F53BC3E9,31071,11,16,5,109.58257,18.28458,1815
24984,191173,E9A67CAEAD4E146EE721320A56F893AA,31071,0,10,10,109.58257,18.28458,1815
24985,191174,E9A67CAEAD4E146EE721320A56F893AA,30854,14,17,3,109.56889,18.27076,1763
24986,191175,E9A67CAEAD4E146EE721320A56F893AA,31945,19,20,1,109.58021,18.29403,1817
24987,191176,E9A67CAEAD4E146EE721320A56F893AA,31071,21,23,2,109.58257,18.28458,1815
24988,191193,43E035AE85036EBD9891453E9567CB81,30151,0,14,14,109.50986,18.25083,1560
24989,191194,43E035AE85036EBD9891453E9567CB81,30151,17,19,2,109.50986,18.25083,1560
24990,191195,43E035AE85036EBD9891453E9567CB81,30151,21,23,2,109.50986,18.25083,1560
24998,191323,377A324496E54511961704972731A3D5,39111,0,1,1,109.5191,18.22597,1555
24999,191324,377A324496E54511961704972731A3D5,31821,1,8,7,109.51181,18.24924,1559
25000,191325,377A324496E54511961704972731A3D5,31521,13,15,2,109.51458,18.22542,1555
25001,191326,377A324496E54511961704972731A3D5,39111,17,21,4,109.5191,18.22597,1555
25008,191424,9AA959ED87D1ECC3053DED17290EFCBD,39183,0,4,4,109.55542,18.28208,1715
25009,191425,9AA959ED87D1ECC3053DED17290EFCBD,31561,5,7,2,109.56792,18.28479,1765
25010,191426,9AA959ED87D1ECC3053DED17290EFCBD,39183,8,16,8,109.55542,18.28208,1715
25011,191427,9AA959ED87D1ECC3053DED17290EFCBD,30851,19,20,1,109.5616,18.27396,1713
25017,191572,40285EE8CCE25C38988EC087545664EC,31071,4,7,3,109.58257,18.28458,1815
25018,191573,40285EE8CCE25C38988EC087545664EC,30854,10,15,5,109.56889,18.27076,1763
25019,191574,40285EE8CCE25C38988EC087545664EC,31071,18,19,1,109.58257,18.28458,1815
25020,191575,40285EE8CCE25C38988EC087545664EC,30854,22,23,1,109.56889,18.27076,1763
25021,191624,69F4307E378774E8E49F5A5A6F5C64A6,60281,0,4,4,109.51743,18.25924,1561
25022,191625,69F4307E378774E8E49F5A5A6F5C64A6,30921,8,13,5,109.53903,18.29451,1667
25023,191626,69F4307E378774E8E49F5A5A6F5C64A6,31931,15,16,1,109.54771,18.29403,1667
25024,191627,69F4307E378774E8E49F5A5A6F5C64A6,30921,18,20,2,109.53903,18.29451,1667
25053,191806,E75CF54BA14775FEDD26504F9F6B7365,31945,0,6,6,109.58021,18.29403,1817
25054,191807,E75CF54BA14775FEDD26504F9F6B7365,31561,7,17,10,109.56792,18.28479,1765
25055,191808,E75CF54BA14775FEDD26504F9F6B7365,31945,18,23,5,109.58021,18.29403,1817
25056,191825,D8EBCB05DE029B0DEDBF9FBDF3DA3C2D,60084,3,4,1,109.4984,18.2334,1507
25057,191826,D8EBCB05DE029B0DEDBF9FBDF3DA3C2D,30271,8,17,9,109.49132,18.23153,1456
25058,191827,D8EBCB05DE029B0DEDBF9FBDF3DA3C2D,31031,18,19,1,109.49979,18.25382,1510
25059,191828,D8EBCB05DE029B0DEDBF9FBDF3DA3C2D,30211,19,21,2,109.49882,18.23931,1508
25065,191855,D46DE9169E4BACF1D272EA5E0FDEF68F,31561,2,5,3,109.56792,18.28479,1765
25066,191856,D46DE9169E4BACF1D272EA5E0FDEF68F,39183,8,10,2,109.55542,18.28208,1715
25067,191857,D46DE9169E4BACF1D272EA5E0FDEF68F,31561,11,12,1,109.56792,18.28479,1765
25069,191877,2AE38FAF341950B0B91404FFCE5A0F3E,31931,0,6,6,109.54771,18.29403,1667
25070,191878,2AE38FAF341950B0B91404FFCE5A0F3E,30921,6,17,11,109.53903,18.29451,1667
25071,191879,2AE38FAF341950B0B91404FFCE5A0F3E,31931,18,22,4,109.54771,18.29403,1667
25087,191961,14AE6C820CE45F96077630992CABD33D,39371,2,13,11,109.56627,18.2646,1762
25088,191962,14AE6C820CE45F96077630992CABD33D,30851,13,14,1,109.5616,18.27396,1713
25089,191963,14AE6C820CE45F96077630992CABD33D,39371,14,16,2,109.56627,18.2646,1762
25090,191964,14AE6C820CE45F96077630992CABD33D,30951,18,21,3,109.56208,18.25667,1761
25105,192169,03CEC0FDDD5484124514C6D24A63D4DD,30854,0,2,2,109.56889,18.27076,1763
25106,192170,03CEC0FDDD5484124514C6D24A63D4DD,31561,4,13,9,109.56792,18.28479,1765
25107,192171,03CEC0FDDD5484124514C6D24A63D4DD,39183,14,16,2,109.55542,18.28208,1715
25108,192172,03CEC0FDDD5484124514C6D24A63D4DD,31561,16,20,4,109.56792,18.28479,1765
25113,192199,9FEB0895D82B765FC0B1993DBDBFB56B,31071,1,2,1,109.58257,18.28458,1815
25114,192200,9FEB0895D82B765FC0B1993DBDBFB56B,30854,3,16,13,109.56889,18.27076,1763
25115,192201,9FEB0895D82B765FC0B1993DBDBFB56B,31071,16,23,7,109.58257,18.28458,1815
25123,192230,2F3BB5BE10811E7F8F8565DAA2126DE6,39181,0,6,6,109.55153,18.28035,1715
25124,192231,2F3BB5BE10811E7F8F8565DAA2126DE6,39181,9,13,4,109.55153,18.28035,1715
25125,192232,2F3BB5BE10811E7F8F8565DAA2126DE6,39181,15,23,8,109.55153,18.28035,1715
25133,192419,4F1F2C63B1D8098AD9ABA50013979078,30151,0,2,2,109.50986,18.25083,1560
25134,192420,4F1F2C63B1D8098AD9ABA50013979078,30151,4,15,11,109.50986,18.25083,1560
25135,192421,4F1F2C63B1D8098AD9ABA50013979078,30051,16,17,1,109.48917,18.21215,1453
25136,192422,4F1F2C63B1D8098AD9ABA50013979078,60614,20,23,3,109.48799,18.29521,1467
25165,192617,ADC7B707FBBD7BF3F9ACE0C092DAADE5,30921,0,6,6,109.53903,18.29451,1667
25166,192618,ADC7B707FBBD7BF3F9ACE0C092DAADE5,31931,10,16,6,109.54771,18.29403,1667
25167,192619,ADC7B707FBBD7BF3F9ACE0C092DAADE5,30921,17,18,1,109.53903,18.29451,1667
25173,192650,C58D0182BFC61ED113EE3B09763C30B2,38185,0,6,6,109.51333,18.27347,1563
25174,192651,C58D0182BFC61ED113EE3B09763C30B2,31931,10,13,3,109.54771,18.29403,1667
25175,192652,C58D0182BFC61ED113EE3B09763C30B2,38127,18,19,1,109.50833,18.27222,1513
25176,192653,C58D0182BFC61ED113EE3B09763C30B2,38185,19,23,4,109.51333,18.27347,1563
25180,192712,4053323049FA57896819CD5356E38746,30854,1,10,9,109.56889,18.27076,1763
25181,192713,4053323049FA57896819CD5356E38746,31071,10,11,1,109.58257,18.28458,1815
25182,192714,4053323049FA57896819CD5356E38746,30854,12,23,11,109.56889,18.27076,1763
25183,192737,A46BA306DAEA889FAC7ACE9E5FD6A1FF,60331,1,6,5,109.505,18.26507,1512
25184,192738,A46BA306DAEA889FAC7ACE9E5FD6A1FF,30911,6,10,4,109.50493,18.26181,1511
25185,192739,A46BA306DAEA889FAC7ACE9E5FD6A1FF,30421,10,11,1,109.50021,18.25861,1511
25186,192740,A46BA306DAEA889FAC7ACE9E5FD6A1FF,30371,13,15,2,109.51,18.24771,1559
25187,192748,B84B247FA61A8C12DFCCCF3C2D72006D,30854,0,10,10,109.56889,18.27076,1763
25188,192749,B84B247FA61A8C12DFCCCF3C2D72006D,31071,10,11,1,109.58257,18.28458,1815
25189,192750,B84B247FA61A8C12DFCCCF3C2D72006D,30854,14,16,2,109.56889,18.27076,1763
25190,192751,B84B247FA61A8C12DFCCCF3C2D72006D,31071,16,18,2,109.58257,18.28458,1815
25191,192773,D17842D1E850E617B4B15889C460D1C5,31931,0,10,10,109.54771,18.29403,1667
25192,192774,D17842D1E850E617B4B15889C460D1C5,30921,11,12,1,109.53903,18.29451,1667
25193,192775,D17842D1E850E617B4B15889C460D1C5,31931,12,22,10,109.54771,18.29403,1667
25206,192805,20C15B76A1E0DF79D86EDEAC7BC3D7B7,30854,0,10,10,109.56889,18.27076,1763
25207,192806,20C15B76A1E0DF79D86EDEAC7BC3D7B7,31071,12,13,1,109.58257,18.28458,1815
25208,192807,20C15B76A1E0DF79D86EDEAC7BC3D7B7,31945,16,17,1,109.58021,18.29403,1817
25218,192928,4B6FFEFB36770528DA20871CE9291F99,31391,0,6,6,109.50382,18.24285,1508
25219,192929,4B6FFEFB36770528DA20871CE9291F99,60381,11,16,5,109.5241,18.22458,1605
25220,192930,4B6FFEFB36770528DA20871CE9291F99,31521,18,23,5,109.51458,18.22542,1555
25221,192933,FC4E540B07DB36C2A24C73051E1FA6C0,30171,0,8,8,109.48458,18.27139,1463
25222,192934,FC4E540B07DB36C2A24C73051E1FA6C0,60401,9,18,9,109.47444,18.27583,1414
25223,192935,FC4E540B07DB36C2A24C73051E1FA6C0,30171,20,23,3,109.48458,18.27139,1463
25231,192961,FE95B3A32EFBC2838F293DF38F55FDD1,30851,2,3,1,109.5616,18.27396,1713
25232,192962,FE95B3A32EFBC2838F293DF38F55FDD1,39183,3,14,11,109.55542,18.28208,1715
25233,192963,FE95B3A32EFBC2838F293DF38F55FDD1,31561,16,17,1,109.56792,18.28479,1765
25234,192964,FE95B3A32EFBC2838F293DF38F55FDD1,39183,17,19,2,109.55542,18.28208,1715
25242,193073,9A1D1AA5EE2CD156CC396C667ED8C5B9,31071,2,7,5,109.58257,18.28458,1815
25243,193074,9A1D1AA5EE2CD156CC396C667ED8C5B9,30854,8,11,3,109.56889,18.27076,1763
25244,193075,9A1D1AA5EE2CD156CC396C667ED8C5B9,31071,14,16,2,109.58257,18.28458,1815
25245,193076,9A1D1AA5EE2CD156CC396C667ED8C5B9,31071,20,22,2,109.58257,18.28458,1815
25256,193316,1B6EBBFF3B9D8A3E18753343B6A29EAE,31071,0,13,13,109.58257,18.28458,1815
25257,193317,1B6EBBFF3B9D8A3E18753343B6A29EAE,30851,15,16,1,109.5616,18.27396,1713
25258,193318,1B6EBBFF3B9D8A3E18753343B6A29EAE,31071,18,23,5,109.58257,18.28458,1815
25263,193357,FFCD3E0626E46D21B910BCE8EF3AFA0E,30731,3,5,2,109.50944,18.22306,1555
25264,193358,FFCD3E0626E46D21B910BCE8EF3AFA0E,30191,5,13,8,109.50361,18.22701,1506
25265,193359,FFCD3E0626E46D21B910BCE8EF3AFA0E,30711,13,19,6,109.50271,18.25347,1510
25266,193360,FFCD3E0626E46D21B910BCE8EF3AFA0E,30711,21,23,2,109.50271,18.25347,1510
25274,193420,68DBE0B52FD0AB95F1DD47068FD7847F,30181,0,11,11,109.51597,18.23313,1557
25275,193421,68DBE0B52FD0AB95F1DD47068FD7847F,30181,16,19,3,109.51597,18.23313,1557
25276,193422,68DBE0B52FD0AB95F1DD47068FD7847F,30181,20,21,1,109.51597,18.23313,1557
25277,193423,68DBE0B52FD0AB95F1DD47068FD7847F,60291,22,23,1,109.50826,18.24639,1509
25286,193467,184447FB27346CCB581EA0ECE0E04766,38991,0,6,6,109.52681,18.30368,1618
25287,193468,184447FB27346CCB581EA0ECE0E04766,31931,8,16,8,109.54771,18.29403,1667
25288,193469,184447FB27346CCB581EA0ECE0E04766,30071,19,20,1,109.52819,18.30472,1619
25289,193470,184447FB27346CCB581EA0ECE0E04766,38991,21,23,2,109.52681,18.30368,1618
25293,193496,22CF7007721E0F1D863F25E4633BE1AD,60311,0,12,12,109.52097,18.24319,1558
25294,193497,22CF7007721E0F1D863F25E4633BE1AD,31864,12,14,2,109.49014,18.28333,1465
25295,193498,22CF7007721E0F1D863F25E4633BE1AD,30084,16,17,1,109.50118,18.26972,1513
25296,193499,22CF7007721E0F1D863F25E4633BE1AD,60311,19,23,4,109.52097,18.24319,1558
25323,193737,EA4EEEA6F324C3F08DBAE63BA2B33BB6,30084,0,7,7,109.50118,18.26972,1513
25324,193738,EA4EEEA6F324C3F08DBAE63BA2B33BB6,30361,8,11,3,109.50347,18.24,1508
25325,193739,EA4EEEA6F324C3F08DBAE63BA2B33BB6,30084,12,16,4,109.50118,18.26972,1513
25326,193740,EA4EEEA6F324C3F08DBAE63BA2B33BB6,30511,17,23,6,109.51069,18.24208,1558
25365,194016,45FA8AF959A216E06C82392E21728E7F,31561,0,10,10,109.56792,18.28479,1765
25366,194017,45FA8AF959A216E06C82392E21728E7F,30851,14,16,2,109.5616,18.27396,1713
25367,194018,45FA8AF959A216E06C82392E21728E7F,31561,21,23,2,109.56792,18.28479,1765
25368,194059,D4EE8E1A4C04A1FF0596E4221D0B8B42,30854,1,2,1,109.56889,18.27076,1763
25369,194060,D4EE8E1A4C04A1FF0596E4221D0B8B42,31071,7,8,1,109.58257,18.28458,1815
25370,194061,D4EE8E1A4C04A1FF0596E4221D0B8B42,30854,8,12,4,109.56889,18.27076,1763
25371,194062,D4EE8E1A4C04A1FF0596E4221D0B8B42,31071,13,15,2,109.58257,18.28458,1815
25377,194087,21C41A61C814FFC904BE2F7898C083F4,30854,0,7,7,109.56889,18.27076,1763
25378,194088,21C41A61C814FFC904BE2F7898C083F4,31931,10,14,4,109.54771,18.29403,1667
25379,194089,21C41A61C814FFC904BE2F7898C083F4,30854,19,23,4,109.56889,18.27076,1763
25380,194105,5A888DC7A3AA300CC584D9862C5384A1,60331,2,8,6,109.505,18.26507,1512
25381,194106,5A888DC7A3AA300CC584D9862C5384A1,30421,8,10,2,109.50021,18.25861,1511
25382,194107,5A888DC7A3AA300CC584D9862C5384A1,39183,11,15,4,109.55542,18.28208,1715
25389,194253,92D84094136F2FB8B7D41AECD69A79AD,31206,0,8,8,109.50819,18.23549,1507
25390,194254,92D84094136F2FB8B7D41AECD69A79AD,31201,12,14,2,109.51042,18.23819,1558
25391,194255,92D84094136F2FB8B7D41AECD69A79AD,31461,15,18,3,109.5091,18.25389,1510
25392,194256,92D84094136F2FB8B7D41AECD69A79AD,31201,22,23,1,109.51042,18.23819,1558
25409,194354,0442B38E8824E569B00E80CCEFC70940,31561,1,4,3,109.56792,18.28479,1765
25410,194355,0442B38E8824E569B00E80CCEFC70940,30071,7,9,2,109.52819,18.30472,1619
25411,194356,0442B38E8824E569B00E80CCEFC70940,39183,9,11,2,109.55542,18.28208,1715
25412,194357,0442B38E8824E569B00E80CCEFC70940,31561,12,22,10,109.56792,18.28479,1765
25417,194482,855D815DC19AA779325469411A9E7B8A,30251,0,6,6,109.50611,18.26653,1512
25418,194483,855D815DC19AA779325469411A9E7B8A,38157,6,8,2,109.51483,18.26958,1563
25419,194484,855D815DC19AA779325469411A9E7B8A,38157,12,14,2,109.51483,18.26958,1563
25420,194485,855D815DC19AA779325469411A9E7B8A,38157,18,23,5,109.51483,18.26958,1563
25433,194614,4AA92C2276692190731459431C798101,31945,0,6,6,109.58021,18.29403,1817
25434,194615,4AA92C2276692190731459431C798101,31071,7,8,1,109.58257,18.28458,1815
25435,194616,4AA92C2276692190731459431C798101,31945,9,17,8,109.58021,18.29403,1817
25436,194617,4AA92C2276692190731459431C798101,30854,19,21,2,109.56889,18.27076,1763
25451,194740,A8D0FB018199C38EC19D3E276F96B59B,30741,0,13,13,109.49833,18.28681,1516
25452,194741,A8D0FB018199C38EC19D3E276F96B59B,38911,14,15,1,109.51674,18.24965,1559
25453,194742,A8D0FB018199C38EC19D3E276F96B59B,30741,16,17,1,109.49833,18.28681,1516
25454,194743,A8D0FB018199C38EC19D3E276F96B59B,30121,21,22,1,109.52861,18.27222,1613
25457,194794,58979C567AA82D4656FBA764FCCBAA6B,31671,0,7,7,109.38965,18.29813,1068
25458,194795,58979C567AA82D4656FBA764FCCBAA6B,38027,7,15,8,109.38833,18.2909,1066
25459,194796,58979C567AA82D4656FBA764FCCBAA6B,31671,19,23,4,109.38965,18.29813,1068
25464,194906,58DE8A719D3ADBEDAE163213845B460A,31071,0,7,7,109.58257,18.28458,1815
25465,194907,58DE8A719D3ADBEDAE163213845B460A,30854,9,12,3,109.56889,18.27076,1763
25466,194908,58DE8A719D3ADBEDAE163213845B460A,31071,12,13,1,109.58257,18.28458,1815
25467,194909,58DE8A719D3ADBEDAE163213845B460A,30854,14,17,3,109.56889,18.27076,1763
25482,195080,0402BD114B7D5E20705E302B756CD062,60631,1,6,5,109.57778,18.27583,1814
25483,195081,0402BD114B7D5E20705E302B756CD062,30854,10,14,4,109.56889,18.27076,1763
25484,195082,0402BD114B7D5E20705E302B756CD062,31071,19,21,2,109.58257,18.28458,1815
25490,195111,ACDEAAF45B65DE48CF80A48DBD3C775E,30854,2,3,1,109.56889,18.27076,1763
25491,195112,ACDEAAF45B65DE48CF80A48DBD3C775E,31071,5,6,1,109.58257,18.28458,1815
25492,195113,ACDEAAF45B65DE48CF80A48DBD3C775E,30854,8,22,14,109.56889,18.27076,1763
25510,195188,DB4DF566D4757FF3BB488F82DE126248,31561,0,6,6,109.56792,18.28479,1765
25511,195189,DB4DF566D4757FF3BB488F82DE126248,30851,6,8,2,109.5616,18.27396,1713
25512,195190,DB4DF566D4757FF3BB488F82DE126248,31561,8,16,8,109.56792,18.28479,1765
25513,195191,DB4DF566D4757FF3BB488F82DE126248,30854,19,20,1,109.56889,18.27076,1763
25535,195332,01F0083CC81D0009F9AAB8F7CAA0C106,30854,0,6,6,109.56889,18.27076,1763
25536,195333,01F0083CC81D0009F9AAB8F7CAA0C106,31561,8,9,1,109.56792,18.28479,1765
25537,195334,01F0083CC81D0009F9AAB8F7CAA0C106,30854,12,13,1,109.56889,18.27076,1763
25546,195501,0C8D15C0488D521680F0DE3A28CFE111,31811,0,11,11,109.54201,18.31806,1671
25547,195502,0C8D15C0488D521680F0DE3A28CFE111,30701,12,21,9,109.59313,18.32007,1871
25548,195503,0C8D15C0488D521680F0DE3A28CFE111,31811,21,23,2,109.54201,18.31806,1671
25578,195765,5AE5291D69C9CAB9DE596EEA8E795748,31391,0,6,6,109.50382,18.24285,1508
25579,195766,5AE5291D69C9CAB9DE596EEA8E795748,60381,7,8,1,109.5241,18.22458,1605
25580,195767,5AE5291D69C9CAB9DE596EEA8E795748,30181,9,10,1,109.51597,18.23313,1557
25581,195768,5AE5291D69C9CAB9DE596EEA8E795748,31201,10,11,1,109.51042,18.23819,1558
25587,195814,C93386A9D86FE22A1FD4E5116045DD8D,31561,3,5,2,109.56792,18.28479,1765
25588,195815,C93386A9D86FE22A1FD4E5116045DD8D,39183,8,18,10,109.55542,18.28208,1715
25589,195816,C93386A9D86FE22A1FD4E5116045DD8D,30854,20,21,1,109.56889,18.27076,1763
25590,195817,C93386A9D86FE22A1FD4E5116045DD8D,31561,22,23,1,109.56792,18.28479,1765
25618,196059,0133DDFFB5CECBB261CEDEF10A82D50B,30854,0,1,1,109.56889,18.27076,1763
25619,196060,0133DDFFB5CECBB261CEDEF10A82D50B,31561,1,16,15,109.56792,18.28479,1765
25620,196061,0133DDFFB5CECBB261CEDEF10A82D50B,30854,19,21,2,109.56889,18.27076,1763
25629,196099,10558344D002FD2874D637BA4ECA768A,30051,0,11,11,109.48917,18.21215,1453
25630,196100,10558344D002FD2874D637BA4ECA768A,30771,11,14,3,109.49938,18.26042,1511
25631,196101,10558344D002FD2874D637BA4ECA768A,30051,17,21,4,109.48917,18.21215,1453
25632,196102,10558344D002FD2874D637BA4ECA768A,60291,21,23,2,109.50826,18.24639,1509
25635,196122,0E129C09250C0D46273B4BD7E5225556,30151,0,6,6,109.50986,18.25083,1560
25636,196123,0E129C09250C0D46273B4BD7E5225556,30421,6,11,5,109.50021,18.25861,1511
25637,196124,0E129C09250C0D46273B4BD7E5225556,60161,11,13,2,109.49174,18.26181,1461
25673,196323,0E5593A90D661690BE3DAAA17AD936E2,30281,0,6,6,109.50597,18.27583,1514
25674,196324,0E5593A90D661690BE3DAAA17AD936E2,31206,6,7,1,109.50819,18.23549,1507
25675,196325,0E5593A90D661690BE3DAAA17AD936E2,38127,8,15,7,109.50833,18.27222,1513
25694,196406,8FAAC7EA21AE7BB6F52A4D0F285944CD,38157,1,7,6,109.51483,18.26958,1563
25695,196407,8FAAC7EA21AE7BB6F52A4D0F285944CD,30191,10,19,9,109.50361,18.22701,1506
25696,196408,8FAAC7EA21AE7BB6F52A4D0F285944CD,30281,20,23,3,109.50597,18.27583,1514
25700,196423,F6A1EBB84FE583E84185C423218578F5,31561,0,5,5,109.56792,18.28479,1765
25701,196424,F6A1EBB84FE583E84185C423218578F5,39181,6,7,1,109.55153,18.28035,1715
25702,196425,F6A1EBB84FE583E84185C423218578F5,30854,8,9,1,109.56889,18.27076,1763
25703,196426,F6A1EBB84FE583E84185C423218578F5,31561,12,22,10,109.56792,18.28479,1765
25718,196556,2951B609D4809F44409A5DD8DDED7FBC,60594,0,5,5,109.62694,18.22799,1956
25719,196557,2951B609D4809F44409A5DD8DDED7FBC,31723,7,9,2,109.68563,18.23701,2207
25720,196558,2951B609D4809F44409A5DD8DDED7FBC,60594,9,12,3,109.62694,18.22799,1956
25721,196559,2951B609D4809F44409A5DD8DDED7FBC,38052,13,21,8,109.62618,18.23042,1956
25729,196603,40C57F24FE0409ABB752B2031C349577,38951,0,17,17,109.48097,18.28868,1416
25730,196604,40C57F24FE0409ABB752B2031C349577,30321,18,19,1,109.49563,18.29611,1467
25731,196605,40C57F24FE0409ABB752B2031C349577,38951,20,23,3,109.48097,18.28868,1416
25747,196701,A97645679390087E090050CF3F130352,31931,0,19,19,109.54771,18.29403,1667
25748,196702,A97645679390087E090050CF3F130352,30071,19,21,2,109.52819,18.30472,1619
25749,196703,A97645679390087E090050CF3F130352,31931,22,23,1,109.54771,18.29403,1667
25781,196970,B78E7295CB13532B4E2C30EF158E297F,39183,2,5,3,109.55542,18.28208,1715
25782,196971,B78E7295CB13532B4E2C30EF158E297F,31931,7,9,2,109.54771,18.29403,1667
25783,196972,B78E7295CB13532B4E2C30EF158E297F,39183,9,11,2,109.55542,18.28208,1715
25795,197105,0F23B6E4E3B228AFE54C52B9B3D593D7,60524,1,10,9,109.42951,18.28993,1216
25796,197106,0F23B6E4E3B228AFE54C52B9B3D593D7,60551,12,14,2,109.42722,18.30111,1218
25797,197107,0F23B6E4E3B228AFE54C52B9B3D593D7,60524,14,18,4,109.42951,18.28993,1216
25798,197108,0F23B6E4E3B228AFE54C52B9B3D593D7,60551,20,23,3,109.42722,18.30111,1218
25807,197157,76DA946F4DC1318DD46A32E1D303D6B7,31931,0,17,17,109.54771,18.29403,1667
25808,197158,76DA946F4DC1318DD46A32E1D303D6B7,39183,17,18,1,109.55542,18.28208,1715
25809,197159,76DA946F4DC1318DD46A32E1D303D6B7,31931,19,23,4,109.54771,18.29403,1667
25812,197173,8293619D825F160795AE71B17456FBCB,60354,0,6,6,109.58701,18.28521,1815
25813,197174,8293619D825F160795AE71B17456FBCB,60631,11,13,2,109.57778,18.27583,1814
25814,197175,8293619D825F160795AE71B17456FBCB,31071,14,16,2,109.58257,18.28458,1815
25830,197318,608A55C14BAB2A5B627ACC1F39B89FB6,31945,0,7,7,109.58021,18.29403,1817
25831,197319,608A55C14BAB2A5B627ACC1F39B89FB6,30854,8,19,11,109.56889,18.27076,1763
25832,197320,608A55C14BAB2A5B627ACC1F39B89FB6,31945,20,22,2,109.58021,18.29403,1817
25840,197425,10EBF762D28520B09848288F7052CFDE,30854,1,7,6,109.56889,18.27076,1763
25841,197426,10EBF762D28520B09848288F7052CFDE,31561,9,15,6,109.56792,18.28479,1765
25842,197427,10EBF762D28520B09848288F7052CFDE,30854,18,20,2,109.56889,18.27076,1763
25859,197570,949173524C1E5F3B9BD54D60F0306D0C,30854,2,5,3,109.56889,18.27076,1763
25860,197571,949173524C1E5F3B9BD54D60F0306D0C,30711,8,16,8,109.50271,18.25347,1510
25861,197572,949173524C1E5F3B9BD54D60F0306D0C,31561,18,23,5,109.56792,18.28479,1765
25867,197685,0F558B6653C655C7F0BAEA9D66B33F57,31071,0,6,6,109.58257,18.28458,1815
25868,197686,0F558B6653C655C7F0BAEA9D66B33F57,30854,10,16,6,109.56889,18.27076,1763
25869,197687,0F558B6653C655C7F0BAEA9D66B33F57,30721,18,20,2,109.51597,18.28257,1565
25870,197688,0F558B6653C655C7F0BAEA9D66B33F57,39053,21,23,2,109.511,18.2771,1564
25875,197696,CE3E597F5969146BCA318406842E8817,60631,1,4,3,109.57778,18.27583,1814
25876,197697,CE3E597F5969146BCA318406842E8817,39183,8,17,9,109.55542,18.28208,1715
25877,197698,CE3E597F5969146BCA318406842E8817,60631,22,23,1,109.57778,18.27583,1814
25884,197722,7421066246AAD1C230E7E2A7ADF06E9D,60631,0,7,7,109.57778,18.27583,1814
25885,197723,7421066246AAD1C230E7E2A7ADF06E9D,30854,7,18,11,109.56889,18.27076,1763
25886,197724,7421066246AAD1C230E7E2A7ADF06E9D,30721,19,21,2,109.51597,18.28257,1565
25887,197725,7421066246AAD1C230E7E2A7ADF06E9D,39053,21,23,2,109.511,18.2771,1564
25891,197778,417408FFDA93B177641D270D3A5C4B2D,30891,1,3,2,109.59431,18.28389,1865
25892,197779,417408FFDA93B177641D270D3A5C4B2D,31071,5,6,1,109.58257,18.28458,1815
25893,197780,417408FFDA93B177641D270D3A5C4B2D,30854,7,10,3,109.56889,18.27076,1763
25894,197781,417408FFDA93B177641D270D3A5C4B2D,31071,10,23,13,109.58257,18.28458,1815
25895,197787,00408CE72418A3CE9FCFA7311EFCBB62,31071,1,6,5,109.58257,18.28458,1815
25896,197788,00408CE72418A3CE9FCFA7311EFCBB62,30854,7,8,1,109.56889,18.27076,1763
25897,197789,00408CE72418A3CE9FCFA7311EFCBB62,31071,8,11,3,109.58257,18.28458,1815
25898,197790,00408CE72418A3CE9FCFA7311EFCBB62,30854,12,20,8,109.56889,18.27076,1763
25912,197876,EA27C1DACC015E381783BB03940DBA88,38484,0,2,2,109.53028,18.31528,1620
25913,197877,EA27C1DACC015E381783BB03940DBA88,31951,3,7,4,109.52174,18.30299,1568
25914,197878,EA27C1DACC015E381783BB03940DBA88,31561,11,12,1,109.56792,18.28479,1765
25917,197899,AA42C8D5F23E17A418E66C8770B385FE,30151,0,10,10,109.50986,18.25083,1560
25918,197900,AA42C8D5F23E17A418E66C8770B385FE,30084,10,12,2,109.50118,18.26972,1513
25919,197901,AA42C8D5F23E17A418E66C8770B385FE,30151,14,15,1,109.50986,18.25083,1560
25926,197980,147470AD3D3B8724582C30D5F244A8B6,60421,0,16,16,109.46333,18.31743,1371
25927,197981,147470AD3D3B8724582C30D5F244A8B6,30111,17,19,2,109.47583,18.30542,1419
25928,197982,147470AD3D3B8724582C30D5F244A8B6,60421,19,23,4,109.46333,18.31743,1371
25934,198048,D517610C2076C41FED0ED80CB6FFB44C,31561,0,6,6,109.56792,18.28479,1765
25935,198049,D517610C2076C41FED0ED80CB6FFB44C,30851,6,20,14,109.5616,18.27396,1713
25936,198050,D517610C2076C41FED0ED80CB6FFB44C,31561,22,23,1,109.56792,18.28479,1765
25948,198124,C85D0B931BEF54F05B9ABBBB03212DB7,30854,0,10,10,109.56889,18.27076,1763
25949,198125,C85D0B931BEF54F05B9ABBBB03212DB7,31561,10,15,5,109.56792,18.28479,1765
25950,198126,C85D0B931BEF54F05B9ABBBB03212DB7,30854,16,17,1,109.56889,18.27076,1763
25956,198196,EDD211647BCC1D3CABF473CB2801C791,30361,0,11,11,109.50347,18.24,1508
25957,198197,EDD211647BCC1D3CABF473CB2801C791,30161,12,14,2,109.50042,18.24389,1508
25958,198198,EDD211647BCC1D3CABF473CB2801C791,30161,16,22,6,109.50042,18.24389,1508
25979,198399,ECCCA5770AD6AA7162B63EC395B55856,60631,0,7,7,109.57778,18.27583,1814
25980,198400,ECCCA5770AD6AA7162B63EC395B55856,30951,8,15,7,109.56208,18.25667,1761
25981,198401,ECCCA5770AD6AA7162B63EC395B55856,60631,20,23,3,109.57778,18.27583,1814
25984,198430,53875E69050EC42E511A64D3211FA7B3,60631,1,6,5,109.57778,18.27583,1814
25985,198431,53875E69050EC42E511A64D3211FA7B3,30854,8,17,9,109.56889,18.27076,1763
25986,198432,53875E69050EC42E511A64D3211FA7B3,60631,19,23,4,109.57778,18.27583,1814
25987,198491,BD1C8CAB0CA377D9350002A865081450,30251,0,6,6,109.50611,18.26653,1512
25988,198492,BD1C8CAB0CA377D9350002A865081450,30081,8,10,2,109.50243,18.26632,1512
25989,198493,BD1C8CAB0CA377D9350002A865081450,30711,15,17,2,109.50271,18.25347,1510
25990,198494,BD1C8CAB0CA377D9350002A865081450,30251,21,22,1,109.50611,18.26653,1512
25991,198501,ABCD0851CC1C78BCD7AF6DBDF2F5DE49,60552,0,2,2,109.41729,18.30014,1218
25992,198502,ABCD0851CC1C78BCD7AF6DBDF2F5DE49,30671,6,7,1,109.43611,18.30139,1268
25993,198503,ABCD0851CC1C78BCD7AF6DBDF2F5DE49,60552,8,17,9,109.41729,18.30014,1218
25994,198504,ABCD0851CC1C78BCD7AF6DBDF2F5DE49,60551,22,23,1,109.42722,18.30111,1218
25997,198507,5E97A4561E11AAC4FBC53FD068EAA52B,30854,0,14,14,109.56889,18.27076,1763
25998,198508,5E97A4561E11AAC4FBC53FD068EAA52B,31031,16,19,3,109.49979,18.25382,1510
25999,198509,5E97A4561E11AAC4FBC53FD068EAA52B,30854,21,23,2,109.56889,18.27076,1763
26000,198532,17A4545370685D172A08774EFEF86DD3,39181,2,9,7,109.55153,18.28035,1715
26001,198533,17A4545370685D172A08774EFEF86DD3,31071,11,12,1,109.58257,18.28458,1815
26002,198534,17A4545370685D172A08774EFEF86DD3,39181,13,17,4,109.55153,18.28035,1715
26006,198560,F61486EBE9C0037CE6ECF4E72C7FFAB0,31521,0,8,8,109.51458,18.22542,1555
26007,198561,F61486EBE9C0037CE6ECF4E72C7FFAB0,31521,8,11,3,109.51458,18.22542,1555
26008,198562,F61486EBE9C0037CE6ECF4E72C7FFAB0,31521,12,17,5,109.51458,18.22542,1555
26009,198563,F61486EBE9C0037CE6ECF4E72C7FFAB0,30731,20,22,2,109.50944,18.22306,1555
26012,198709,27BCEF3137923B84211F08830816C810,31561,0,1,1,109.56792,18.28479,1765
26013,198710,27BCEF3137923B84211F08830816C810,30851,1,8,7,109.5616,18.27396,1713
26014,198712,27BCEF3137923B84211F08830816C810,30851,21,23,2,109.5616,18.27396,1713
26017,198746,CBFB6695A565EE8288E80536B0FF653C,60631,0,6,6,109.57778,18.27583,1814
26018,198747,CBFB6695A565EE8288E80536B0FF653C,30854,6,8,2,109.56889,18.27076,1763
26019,198748,CBFB6695A565EE8288E80536B0FF653C,60631,12,13,1,109.57778,18.27583,1814
26020,198771,5426296000364EE32711CD0E73D782C8,31561,1,2,1,109.56792,18.28479,1765
26021,198772,5426296000364EE32711CD0E73D782C8,30854,5,11,6,109.56889,18.27076,1763
26022,198773,5426296000364EE32711CD0E73D782C8,31071,12,13,1,109.58257,18.28458,1815
26045,198921,996C0D9500BF90CC0E7F5A04C49A464B,31931,0,1,1,109.54771,18.29403,1667
26046,198922,996C0D9500BF90CC0E7F5A04C49A464B,39181,3,7,4,109.55153,18.28035,1715
26047,198923,996C0D9500BF90CC0E7F5A04C49A464B,31931,9,21,12,109.54771,18.29403,1667
26048,198936,B340EDEF4A878E8DF5CBEC25E465EACE,31071,0,2,2,109.58257,18.28458,1815
26049,198937,B340EDEF4A878E8DF5CBEC25E465EACE,30854,3,11,8,109.56889,18.27076,1763
26050,198938,B340EDEF4A878E8DF5CBEC25E465EACE,30084,12,13,1,109.50118,18.26972,1513
26051,198939,B340EDEF4A878E8DF5CBEC25E465EACE,30854,15,16,1,109.56889,18.27076,1763
26060,199041,8C5A16299A6D294198C90C34C25C5949,30851,0,2,2,109.5616,18.27396,1713
26061,199042,8C5A16299A6D294198C90C34C25C5949,39183,3,6,3,109.55542,18.28208,1715
26062,199043,8C5A16299A6D294198C90C34C25C5949,31561,8,11,3,109.56792,18.28479,1765
26067,199086,0423E588F6BE60693A7FCE42ABBAFF59,31231,0,14,14,109.42597,18.29292,1217
26068,199087,0423E588F6BE60693A7FCE42ABBAFF59,31471,16,17,1,109.34583,18.29563,917
26069,199088,0423E588F6BE60693A7FCE42ABBAFF59,31231,18,23,5,109.42597,18.29292,1217
26110,199491,9FC721E86703223349C05C95FE4BBB6F,60081,0,9,9,109.51097,18.22639,1556
26111,199492,9FC721E86703223349C05C95FE4BBB6F,60381,11,20,9,109.5241,18.22458,1605
26112,199493,9FC721E86703223349C05C95FE4BBB6F,60081,20,22,2,109.51097,18.22639,1556
26113,199508,CE134334D65848FE094D43D90ED46C80,38111,0,6,6,109.52007,18.22403,1555
26114,199509,CE134334D65848FE094D43D90ED46C80,38111,7,19,12,109.52007,18.22403,1555
26115,199510,CE134334D65848FE094D43D90ED46C80,31521,19,20,1,109.51458,18.22542,1555
26116,199511,CE134334D65848FE094D43D90ED46C80,38111,21,23,2,109.52007,18.22403,1555
26133,199627,3389A095460231D31BA622B7185D6321,31231,0,1,1,109.42597,18.29292,1217
26134,199628,3389A095460231D31BA622B7185D6321,60552,2,3,1,109.41729,18.30014,1218
26135,199629,3389A095460231D31BA622B7185D6321,31681,6,19,13,109.40396,18.29979,1168
26136,199630,3389A095460231D31BA622B7185D6321,60552,21,23,2,109.41729,18.30014,1218
26153,199756,7108C89027EB031E7A5F6707D053C8A4,38061,0,11,11,109.50597,18.23118,1506
26154,199757,7108C89027EB031E7A5F6707D053C8A4,60381,13,15,2,109.5241,18.22458,1605
26155,199758,7108C89027EB031E7A5F6707D053C8A4,38052,17,21,4,109.62618,18.23042,1956
26158,199797,A65416E0023DB5B05C85EFD796D8188E,60401,0,1,1,109.47444,18.27583,1414
26159,199798,A65416E0023DB5B05C85EFD796D8188E,38251,2,14,12,109.49618,18.25493,1510
26160,199799,A65416E0023DB5B05C85EFD796D8188E,60441,16,18,2,109.46792,18.28604,1366
26161,199800,A65416E0023DB5B05C85EFD796D8188E,31031,20,22,2,109.49979,18.25382,1510
26172,199868,46B472A67DC212EE4047EBC9FB351124,31071,0,6,6,109.58257,18.28458,1815
26173,199869,46B472A67DC212EE4047EBC9FB351124,31071,7,9,2,109.58257,18.28458,1815
26174,199870,46B472A67DC212EE4047EBC9FB351124,30854,10,12,2,109.56889,18.27076,1763
26178,199979,1AFA3FBCD4D68449B676809F8F32C1FB,30324,0,1,1,109.50326,18.29257,1517
26179,199980,1AFA3FBCD4D68449B676809F8F32C1FB,30741,2,3,1,109.49833,18.28681,1516
26180,199981,1AFA3FBCD4D68449B676809F8F32C1FB,30324,3,6,3,109.50326,18.29257,1517
26181,200036,AE469023AED34059A59DE7E300668B8A,30681,0,6,6,109.48493,18.26917,1463
26182,200037,AE469023AED34059A59DE7E300668B8A,30271,8,9,1,109.49132,18.23153,1456
26183,200038,AE469023AED34059A59DE7E300668B8A,31231,11,14,3,109.42597,18.29292,1217
26191,200085,BCE29A3A46F5A479B3F0FA50B11216DE,60631,2,15,13,109.57778,18.27583,1814
26192,200086,BCE29A3A46F5A479B3F0FA50B11216DE,30854,15,16,1,109.56889,18.27076,1763
26193,200087,BCE29A3A46F5A479B3F0FA50B11216DE,31071,20,21,1,109.58257,18.28458,1815
26196,200092,A94F66C88B84FF0658441320CD9F667C,31071,1,7,6,109.58257,18.28458,1815
26197,200093,A94F66C88B84FF0658441320CD9F667C,30854,9,16,7,109.56889,18.27076,1763
26198,200094,A94F66C88B84FF0658441320CD9F667C,31071,17,18,1,109.58257,18.28458,1815
26199,200095,A94F66C88B84FF0658441320CD9F667C,31071,20,23,3,109.58257,18.28458,1815
26218,200168,5E1CFBE3DFE86DADC6CC4F4423C546C7,38331,0,13,13,109.62465,18.22736,1956
26219,200169,5E1CFBE3DFE86DADC6CC4F4423C546C7,38283,14,16,2,109.62229,18.22618,1956
26220,200170,5E1CFBE3DFE86DADC6CC4F4423C546C7,30441,18,21,3,109.64021,18.25424,2010
26229,200211,C50EC98EBB3AD6F34D76F87C749DAC01,39181,0,6,6,109.55153,18.28035,1715
26230,200212,C50EC98EBB3AD6F34D76F87C749DAC01,31931,6,9,3,109.54771,18.29403,1667
26231,200213,C50EC98EBB3AD6F34D76F87C749DAC01,39181,13,17,4,109.55153,18.28035,1715
26232,200214,C50EC98EBB3AD6F34D76F87C749DAC01,39181,18,23,5,109.55153,18.28035,1715
26236,200250,7AFC8085101D104BD77EE20C33AECEB4,48647,0,6,6,109.48701,18.29042,1466
26237,200251,7AFC8085101D104BD77EE20C33AECEB4,30764,6,7,1,109.45806,18.29486,1367
26238,200252,7AFC8085101D104BD77EE20C33AECEB4,48647,8,9,1,109.48701,18.29042,1466
26239,200260,F00821368F615DCDAF214035D8EC4A44,31071,0,4,4,109.58257,18.28458,1815
26240,200261,F00821368F615DCDAF214035D8EC4A44,31071,5,7,2,109.58257,18.28458,1815
26241,200262,F00821368F615DCDAF214035D8EC4A44,30854,7,16,9,109.56889,18.27076,1763
26242,200263,F00821368F615DCDAF214035D8EC4A44,31071,18,22,4,109.58257,18.28458,1815
26245,200278,559FD1DF7FB03AA92C9149566C4A2E28,60131,0,5,5,109.49819,18.24778,1509
26246,200279,559FD1DF7FB03AA92C9149566C4A2E28,60291,5,7,2,109.50826,18.24639,1509
26247,200281,559FD1DF7FB03AA92C9149566C4A2E28,30361,19,22,3,109.50347,18.24,1508
26253,200313,934029FB5F97BCE114EDCE88F0393A63,30854,0,12,12,109.56889,18.27076,1763
26254,200314,934029FB5F97BCE114EDCE88F0393A63,30421,15,18,3,109.50021,18.25861,1511
26255,200315,934029FB5F97BCE114EDCE88F0393A63,39371,21,23,2,109.56627,18.2646,1762
26265,200371,E082FB5BD091C5B334EC1176FF352EE0,30071,0,15,15,109.52819,18.30472,1619
26266,200372,E082FB5BD091C5B334EC1176FF352EE0,30921,15,16,1,109.53903,18.29451,1667
26267,200373,E082FB5BD091C5B334EC1176FF352EE0,30071,19,23,4,109.52819,18.30472,1619
26268,200385,D5B91D126489D960AE97CC8A6C1B036B,31571,0,12,12,109.61563,18.23326,1957
26269,200386,D5B91D126489D960AE97CC8A6C1B036B,30441,15,17,2,109.64021,18.25424,2010
26270,200387,D5B91D126489D960AE97CC8A6C1B036B,31571,20,22,2,109.61563,18.23326,1957
26275,200431,B93185B4820D7E0DEE74EBEA00941D15,30911,0,5,5,109.50493,18.26181,1511
26276,200432,B93185B4820D7E0DEE74EBEA00941D15,30251,5,6,1,109.50611,18.26653,1512
26277,200433,B93185B4820D7E0DEE74EBEA00941D15,30911,6,19,13,109.50493,18.26181,1511
26278,200434,B93185B4820D7E0DEE74EBEA00941D15,38291,20,22,2,109.51618,18.24313,1558
26281,200480,71048DA762610C5657DD6D8242833DC9,30234,0,2,2,109.60681,18.29979,1918
26282,200481,71048DA762610C5657DD6D8242833DC9,39371,3,5,2,109.56627,18.2646,1762
26283,200482,71048DA762610C5657DD6D8242833DC9,30234,5,7,2,109.60681,18.29979,1918
26330,200808,B6F812E63295803956F25D278E925B23,30681,0,9,9,109.48493,18.26917,1463
26331,200809,B6F812E63295803956F25D278E925B23,30854,13,14,1,109.56889,18.27076,1763
26332,200810,B6F812E63295803956F25D278E925B23,38127,14,22,8,109.50833,18.27222,1513
26342,200874,A2DBFF4E352E7B7C1EE25431C02FC741,31931,0,14,14,109.54771,18.29403,1667
26343,200875,A2DBFF4E352E7B7C1EE25431C02FC741,39181,15,18,3,109.55153,18.28035,1715
26344,200876,A2DBFF4E352E7B7C1EE25431C02FC741,31931,19,21,2,109.54771,18.29403,1667
26349,200949,E34FF61340C5B86CF9FD0AD454D26266,60331,0,7,7,109.505,18.26507,1512
26350,200950,E34FF61340C5B86CF9FD0AD454D26266,30251,10,14,4,109.50611,18.26653,1512
26351,200951,E34FF61340C5B86CF9FD0AD454D26266,60131,14,18,4,109.49819,18.24778,1509
26352,200952,E34FF61340C5B86CF9FD0AD454D26266,60331,19,23,4,109.505,18.26507,1512
26353,200959,3C5AEA306E8A69C707195C4150E77D90,31931,1,6,5,109.54771,18.29403,1667
26354,200960,3C5AEA306E8A69C707195C4150E77D90,39181,7,10,3,109.55153,18.28035,1715
26355,200961,3C5AEA306E8A69C707195C4150E77D90,39181,14,17,3,109.55153,18.28035,1715
26356,200962,3C5AEA306E8A69C707195C4150E77D90,31931,19,22,3,109.54771,18.29403,1667
26357,200976,DF1914B7230B32BA806E8A8749CAD846,60261,0,10,10,109.44326,18.3075,1319
26358,200977,DF1914B7230B32BA806E8A8749CAD846,60421,12,15,3,109.46333,18.31743,1371
26359,200978,DF1914B7230B32BA806E8A8749CAD846,60501,18,20,2,109.48701,18.29021,1466
26372,201023,79BABDF74F5861A434085432A23D4B92,31071,0,8,8,109.58257,18.28458,1815
26373,201024,79BABDF74F5861A434085432A23D4B92,30854,10,13,3,109.56889,18.27076,1763
26374,201025,79BABDF74F5861A434085432A23D4B92,31071,14,20,6,109.58257,18.28458,1815
26375,201066,020753EF78F0A0C39658113A3377EA1E,31561,0,7,7,109.56792,18.28479,1765
26376,201067,020753EF78F0A0C39658113A3377EA1E,39183,7,8,1,109.55542,18.28208,1715
26377,201068,020753EF78F0A0C39658113A3377EA1E,31561,8,22,14,109.56792,18.28479,1765
26382,201112,EB0139E0BBB300F5407E4F7BCDA3B148,38291,0,14,14,109.51618,18.24313,1558
26383,201113,EB0139E0BBB300F5407E4F7BCDA3B148,31521,14,18,4,109.51458,18.22542,1555
26384,201114,EB0139E0BBB300F5407E4F7BCDA3B148,30421,19,20,1,109.50021,18.25861,1511
26417,201409,43E035AE85036EBD9891453E9567CB81,30151,0,8,8,109.50986,18.25083,1560
26418,201410,43E035AE85036EBD9891453E9567CB81,30151,12,14,2,109.50986,18.25083,1560
26419,201411,43E035AE85036EBD9891453E9567CB81,30321,16,22,6,109.49563,18.29611,1467
26456,201661,37657A593A7A700C5ECCE5BB0AAAABA7,31931,0,13,13,109.54771,18.29403,1667
26457,201662,37657A593A7A700C5ECCE5BB0AAAABA7,30921,13,18,5,109.53903,18.29451,1667
26458,201663,37657A593A7A700C5ECCE5BB0AAAABA7,31931,18,19,1,109.54771,18.29403,1667
26459,201696,D0644281647025A7A26484BC424A7256,38331,2,6,4,109.62465,18.22736,1956
26460,201697,D0644281647025A7A26484BC424A7256,38052,9,13,4,109.62618,18.23042,1956
26461,201698,D0644281647025A7A26484BC424A7256,31321,17,18,1,109.63799,18.23201,2007
26462,201699,D0644281647025A7A26484BC424A7256,38052,19,22,3,109.62618,18.23042,1956
26466,201717,53453D8B736810206EC5A6632D159BE6,31931,0,15,15,109.54771,18.29403,1667
26467,201718,53453D8B736810206EC5A6632D159BE6,30921,17,18,1,109.53903,18.29451,1667
26468,201719,53453D8B736810206EC5A6632D159BE6,31931,19,23,4,109.54771,18.29403,1667
26498,201918,40285EE8CCE25C38988EC087545664EC,30854,0,17,17,109.56889,18.27076,1763
26499,201919,40285EE8CCE25C38988EC087545664EC,31071,19,20,1,109.58257,18.28458,1815
26500,201920,40285EE8CCE25C38988EC087545664EC,30854,22,23,1,109.56889,18.27076,1763
26501,201967,03E3094FE0344513E64DAE470C33E920,39181,0,10,10,109.55153,18.28035,1715
26502,201968,03E3094FE0344513E64DAE470C33E920,31931,12,17,5,109.54771,18.29403,1667
26503,201969,03E3094FE0344513E64DAE470C33E920,39181,19,23,4,109.55153,18.28035,1715
26512,202078,C8922FAF66F21ECAECB6B717FCD5A53B,60614,0,6,6,109.48799,18.29521,1467
26513,202079,C8922FAF66F21ECAECB6B717FCD5A53B,60391,6,9,3,109.47667,18.28757,1416
26514,202080,C8922FAF66F21ECAECB6B717FCD5A53B,60614,9,23,14,109.48799,18.29521,1467
26517,202092,A503639E15A0B5D04B0130D882921438,31031,0,15,15,109.49979,18.25382,1510
26518,202093,A503639E15A0B5D04B0130D882921438,31031,16,17,1,109.49979,18.25382,1510
26519,202094,A503639E15A0B5D04B0130D882921438,31031,17,22,5,109.49979,18.25382,1510
26520,202124,19DF3AF20A6216C60974B8B3423BEBC6,31931,0,2,2,109.54771,18.29403,1667
26521,202125,19DF3AF20A6216C60974B8B3423BEBC6,30921,3,4,1,109.53903,18.29451,1667
26522,202126,19DF3AF20A6216C60974B8B3423BEBC6,31931,6,21,15,109.54771,18.29403,1667
26524,202215,E9E473F09C342630187345312F4A31D8,39181,0,14,14,109.55153,18.28035,1715
26525,202216,E9E473F09C342630187345312F4A31D8,31931,15,16,1,109.54771,18.29403,1667
26526,202217,E9E473F09C342630187345312F4A31D8,39181,16,23,7,109.55153,18.28035,1715
26569,202527,F59D1DD533185F561FFF6EDE7E603AAA,30561,0,14,14,109.52778,18.31938,1621
26570,202528,F59D1DD533185F561FFF6EDE7E603AAA,30071,15,18,3,109.52819,18.30472,1619
26571,202529,F59D1DD533185F561FFF6EDE7E603AAA,30561,18,23,5,109.52778,18.31938,1621
26577,202631,DFEFB1CD7965FB8E2BDF1B532ED92233,30921,0,7,7,109.53903,18.29451,1667
26578,202632,DFEFB1CD7965FB8E2BDF1B532ED92233,31561,8,15,7,109.56792,18.28479,1765
26579,202633,DFEFB1CD7965FB8E2BDF1B532ED92233,30921,16,23,7,109.53903,18.29451,1667
26595,202824,5106C265E7997749AD66854B6E7AAB9E,60401,0,1,1,109.47444,18.27583,1414
26596,202825,5106C265E7997749AD66854B6E7AAB9E,60161,2,8,6,109.49174,18.26181,1461
26597,202826,5106C265E7997749AD66854B6E7AAB9E,60131,9,11,2,109.49819,18.24778,1509
26650,203424,5FFBB1AD7CFFD00A6727DD7B087830E2,31071,1,3,2,109.58257,18.28458,1815
26651,203425,5FFBB1AD7CFFD00A6727DD7B087830E2,31561,5,6,1,109.56792,18.28479,1765
26652,203426,5FFBB1AD7CFFD00A6727DD7B087830E2,30851,6,11,5,109.5616,18.27396,1713
26653,203427,5FFBB1AD7CFFD00A6727DD7B087830E2,30324,13,15,2,109.50326,18.29257,1517
26656,203432,FCFB14BA36BDB7CD6A39612B9AE933B2,38127,0,7,7,109.50833,18.27222,1513
26657,203433,FCFB14BA36BDB7CD6A39612B9AE933B2,39181,7,8,1,109.55153,18.28035,1715
26658,203434,FCFB14BA36BDB7CD6A39612B9AE933B2,31931,9,16,7,109.54771,18.29403,1667
26659,203435,FCFB14BA36BDB7CD6A39612B9AE933B2,38127,19,23,4,109.50833,18.27222,1513
26685,203661,A46BA306DAEA889FAC7ACE9E5FD6A1FF,30081,0,10,10,109.50243,18.26632,1512
26686,203662,A46BA306DAEA889FAC7ACE9E5FD6A1FF,30511,10,12,2,109.51069,18.24208,1558
26687,203663,A46BA306DAEA889FAC7ACE9E5FD6A1FF,60291,12,14,2,109.50826,18.24639,1509
26688,203664,A46BA306DAEA889FAC7ACE9E5FD6A1FF,30911,15,18,3,109.50493,18.26181,1511
26689,203676,B84B247FA61A8C12DFCCCF3C2D72006D,31071,0,7,7,109.58257,18.28458,1815
26690,203677,B84B247FA61A8C12DFCCCF3C2D72006D,31071,12,13,1,109.58257,18.28458,1815
26691,203678,B84B247FA61A8C12DFCCCF3C2D72006D,30854,15,17,2,109.56889,18.27076,1763
26696,203723,6C0260646767B781577B5B8CE2471E51,60361,3,5,2,109.51938,18.29681,1567
26697,203724,6C0260646767B781577B5B8CE2471E51,38484,9,10,1,109.53028,18.31528,1620
26698,203725,6C0260646767B781577B5B8CE2471E51,30561,11,12,1,109.52778,18.31938,1621
26699,203726,6C0260646767B781577B5B8CE2471E51,38484,13,23,10,109.53028,18.31528,1620
26703,203756,39D4F14340B4650E084697607335F122,30161,0,11,11,109.50042,18.24389,1508
26704,203757,39D4F14340B4650E084697607335F122,30161,12,15,3,109.50042,18.24389,1508
26705,203758,39D4F14340B4650E084697607335F122,31031,19,23,4,109.49979,18.25382,1510
26706,203790,D212E372ACDD591706F32A616297B314,30854,0,8,8,109.56889,18.27076,1763
26707,203791,D212E372ACDD591706F32A616297B314,39371,9,10,1,109.56627,18.2646,1762
26708,203792,D212E372ACDD591706F32A616297B314,30891,13,14,1,109.59431,18.28389,1865
26730,204002,FC8552628F8A5A5219C1C30314657039,60661,0,8,8,109.548,18.2377,1657
26731,204003,FC8552628F8A5A5219C1C30314657039,60084,12,13,1,109.4984,18.2334,1507
26732,204004,FC8552628F8A5A5219C1C30314657039,30771,16,18,2,109.49938,18.26042,1511
26733,204005,FC8552628F8A5A5219C1C30314657039,60661,20,23,3,109.548,18.2377,1657
26770,204437,6751CEC3CF9B2AE78246C7287443D2B4,31071,0,6,6,109.58257,18.28458,1815
26771,204438,6751CEC3CF9B2AE78246C7287443D2B4,30854,8,19,11,109.56889,18.27076,1763
26772,204439,6751CEC3CF9B2AE78246C7287443D2B4,31945,20,21,1,109.58021,18.29403,1817
26773,204450,C2B7B3A3FAB31B432C169B25FFB0A1F6,60354,0,7,7,109.58701,18.28521,1815
26774,204451,C2B7B3A3FAB31B432C169B25FFB0A1F6,31945,8,18,10,109.58021,18.29403,1817
26775,204452,C2B7B3A3FAB31B432C169B25FFB0A1F6,30854,22,23,1,109.56889,18.27076,1763
26779,204456,1B6EBBFF3B9D8A3E18753343B6A29EAE,31071,0,6,6,109.58257,18.28458,1815
26780,204457,1B6EBBFF3B9D8A3E18753343B6A29EAE,30851,10,11,1,109.5616,18.27396,1713
26781,204458,1B6EBBFF3B9D8A3E18753343B6A29EAE,31071,11,23,12,109.58257,18.28458,1815
26784,204473,EC89B2FFE00F967E6D0A3B697A6D636D,31071,0,8,8,109.58257,18.28458,1815
26785,204474,EC89B2FFE00F967E6D0A3B697A6D636D,30854,9,15,6,109.56889,18.27076,1763
26786,204475,EC89B2FFE00F967E6D0A3B697A6D636D,31071,18,22,4,109.58257,18.28458,1815
26797,204603,7A9EDF4DC03F94839B13F40FCA0FD567,60661,0,10,10,109.548,18.2377,1657
26798,204604,7A9EDF4DC03F94839B13F40FCA0FD567,30391,12,15,3,109.4975,18.27118,1513
26799,204605,7A9EDF4DC03F94839B13F40FCA0FD567,30421,18,19,1,109.50021,18.25861,1511
26800,204606,7A9EDF4DC03F94839B13F40FCA0FD567,60661,20,23,3,109.548,18.2377,1657
26801,204612,22CF7007721E0F1D863F25E4633BE1AD,60311,0,8,8,109.52097,18.24319,1558
26802,204613,22CF7007721E0F1D863F25E4633BE1AD,39154,12,14,2,109.50201,18.25681,1511
26803,204614,22CF7007721E0F1D863F25E4633BE1AD,30084,14,15,1,109.50118,18.26972,1513
26804,204615,22CF7007721E0F1D863F25E4633BE1AD,60311,16,23,7,109.52097,18.24319,1558
26809,204652,E58E5EFF0A1D7ADABE8F5BBEE665ED0D,60381,0,1,1,109.5241,18.22458,1605
26810,204653,E58E5EFF0A1D7ADABE8F5BBEE665ED0D,39321,4,10,6,109.529,18.2167,1604
26811,204654,E58E5EFF0A1D7ADABE8F5BBEE665ED0D,30861,13,17,4,109.52722,18.22743,1606
26812,204655,E58E5EFF0A1D7ADABE8F5BBEE665ED0D,30861,19,22,3,109.52722,18.22743,1606
26832,204720,05A6C1DED7CE090E72BB3736D69758C5,60631,0,6,6,109.57778,18.27583,1814
26833,204721,05A6C1DED7CE090E72BB3736D69758C5,30854,6,11,5,109.56889,18.27076,1763
26834,204722,05A6C1DED7CE090E72BB3736D69758C5,31071,14,15,1,109.58257,18.28458,1815
26835,204723,05A6C1DED7CE090E72BB3736D69758C5,30851,18,19,1,109.5616,18.27396,1713
26846,204821,222E0B6922623CE9FBB280F81068D40E,30281,0,1,1,109.50597,18.27583,1514
26847,204822,222E0B6922623CE9FBB280F81068D40E,30121,1,6,5,109.52861,18.27222,1613
26848,204823,222E0B6922623CE9FBB280F81068D40E,30854,7,13,6,109.56889,18.27076,1763
26869,204989,3E314B350F6DFD63303B103E9B7D6941,30731,0,10,10,109.50944,18.22306,1555
26870,204990,3E314B350F6DFD63303B103E9B7D6941,60381,10,11,1,109.5241,18.22458,1605
26871,204991,3E314B350F6DFD63303B103E9B7D6941,38111,16,17,1,109.52007,18.22403,1555
26872,204992,3E314B350F6DFD63303B103E9B7D6941,31521,19,22,3,109.51458,18.22542,1555
26894,205136,A6CF31A63571639AB283D5F43FB98748,39191,2,4,2,109.51493,18.23472,1557
26895,205137,A6CF31A63571639AB283D5F43FB98748,30181,5,7,2,109.51597,18.23313,1557
26896,205138,A6CF31A63571639AB283D5F43FB98748,30361,8,9,1,109.50347,18.24,1508
26897,205173,F95DF9F1082F8C3737D4149B9D06BBC7,38251,0,9,9,109.49618,18.25493,1510
26898,205174,F95DF9F1082F8C3737D4149B9D06BBC7,31461,11,15,4,109.5091,18.25389,1510
26899,205175,F95DF9F1082F8C3737D4149B9D06BBC7,60281,15,18,3,109.51743,18.25924,1561
26900,205178,BB31DF7CD95EBDC65D12089CF34DDE37,31521,1,12,11,109.51458,18.22542,1555
26901,205179,BB31DF7CD95EBDC65D12089CF34DDE37,30421,15,16,1,109.50021,18.25861,1511
26902,205180,BB31DF7CD95EBDC65D12089CF34DDE37,31521,17,23,6,109.51458,18.22542,1555
26906,205226,D4EE8E1A4C04A1FF0596E4221D0B8B42,30854,0,6,6,109.56889,18.27076,1763
26907,205227,D4EE8E1A4C04A1FF0596E4221D0B8B42,31071,7,8,1,109.58257,18.28458,1815
26908,205228,D4EE8E1A4C04A1FF0596E4221D0B8B42,30854,10,11,1,109.56889,18.27076,1763
26909,205229,D4EE8E1A4C04A1FF0596E4221D0B8B42,31071,12,23,11,109.58257,18.28458,1815
26929,205500,17D13F6A66037B54FAB5668CDC734401,30721,0,6,6,109.51597,18.28257,1565
26930,205501,17D13F6A66037B54FAB5668CDC734401,31931,7,15,8,109.54771,18.29403,1667
26931,205502,17D13F6A66037B54FAB5668CDC734401,30721,20,23,3,109.51597,18.28257,1565
26932,205514,08D5EFAE8388B70BF24B8C765A0BDF86,31561,0,7,7,109.56792,18.28479,1765
26933,205515,08D5EFAE8388B70BF24B8C765A0BDF86,30854,10,11,1,109.56889,18.27076,1763
26934,205516,08D5EFAE8388B70BF24B8C765A0BDF86,31561,13,23,10,109.56792,18.28479,1765
26944,205605,8D3B10FD4DBC46DB93DA60040668F697,30854,0,6,6,109.56889,18.27076,1763
26945,205606,8D3B10FD4DBC46DB93DA60040668F697,30071,7,9,2,109.52819,18.30472,1619
26946,205607,8D3B10FD4DBC46DB93DA60040668F697,30854,11,23,12,109.56889,18.27076,1763
26968,205827,EDC17F917D3B692B137ACF040E1D7AE4,30421,0,8,8,109.50021,18.25861,1511
26969,205828,EDC17F917D3B692B137ACF040E1D7AE4,31561,9,17,8,109.56792,18.28479,1765
26970,205829,EDC17F917D3B692B137ACF040E1D7AE4,30421,21,23,2,109.50021,18.25861,1511
26991,206041,58DE8A719D3ADBEDAE163213845B460A,31071,0,7,7,109.58257,18.28458,1815
26992,206042,58DE8A719D3ADBEDAE163213845B460A,30854,8,10,2,109.56889,18.27076,1763
26993,206043,58DE8A719D3ADBEDAE163213845B460A,31071,12,14,2,109.58257,18.28458,1815
27023,206279,2F440A235E684ECEDD042B3100A4AE95,31071,0,7,7,109.58257,18.28458,1815
27024,206280,2F440A235E684ECEDD042B3100A4AE95,30854,7,19,12,109.56889,18.27076,1763
27025,206281,2F440A235E684ECEDD042B3100A4AE95,31071,20,23,3,109.58257,18.28458,1815
27050,206421,0312B43ACF9ED1D8304E325E851AEE29,30851,0,7,7,109.5616,18.27396,1713
27051,206422,0312B43ACF9ED1D8304E325E851AEE29,31181,9,10,1,109.50382,18.24813,1509
27052,206423,0312B43ACF9ED1D8304E325E851AEE29,31561,15,19,4,109.56792,18.28479,1765
27053,206424,0312B43ACF9ED1D8304E325E851AEE29,30851,21,23,2,109.5616,18.27396,1713
27064,206548,64F066E95B9E85CA35F8A30036F511A3,38951,0,8,8,109.48097,18.28868,1416
27065,206549,64F066E95B9E85CA35F8A30036F511A3,38951,12,14,2,109.48097,18.28868,1416
27066,206550,64F066E95B9E85CA35F8A30036F511A3,38951,14,19,5,109.48097,18.28868,1416
27085,206742,45CCFCD3EBDF941E1C92B70ED06E8B5E,30854,0,7,7,109.56889,18.27076,1763
27086,206743,45CCFCD3EBDF941E1C92B70ED06E8B5E,31945,8,9,1,109.58021,18.29403,1817
27087,206744,45CCFCD3EBDF941E1C92B70ED06E8B5E,30854,11,22,11,109.56889,18.27076,1763
27093,206773,6B806948BC9187A91D033B4096721B00,31561,5,7,2,109.56792,18.28479,1765
27094,206774,6B806948BC9187A91D033B4096721B00,31071,11,19,8,109.58257,18.28458,1815
27095,206775,6B806948BC9187A91D033B4096721B00,31561,20,22,2,109.56792,18.28479,1765
27111,206915,E65658506C2BF9C993BA69EE6D38B3C6,31951,0,17,17,109.52174,18.30299,1568
27112,206916,E65658506C2BF9C993BA69EE6D38B3C6,60361,17,19,2,109.51938,18.29681,1567
27113,206917,E65658506C2BF9C993BA69EE6D38B3C6,31561,21,23,2,109.56792,18.28479,1765
27122,207071,C93386A9D86FE22A1FD4E5116045DD8D,31561,0,6,6,109.56792,18.28479,1765
27123,207072,C93386A9D86FE22A1FD4E5116045DD8D,39183,7,11,4,109.55542,18.28208,1715
27124,207073,C93386A9D86FE22A1FD4E5116045DD8D,31561,13,14,1,109.56792,18.28479,1765
27125,207074,C93386A9D86FE22A1FD4E5116045DD8D,39183,14,15,1,109.55542,18.28208,1715
27131,207106,8A13D61E438E2D948DE2F55318BED098,60071,0,5,5,109.75674,18.31583,2470
27132,207107,8A13D61E438E2D948DE2F55318BED098,38707,5,6,1,109.73778,18.35368,2427
27133,207108,8A13D61E438E2D948DE2F55318BED098,38707,8,9,1,109.73778,18.35368,2427
27176,207375,3F80F6C7ECC59E36D89C8EF1746C8724,38961,0,3,3,109.50847,18.23514,1507
27177,207376,3F80F6C7ECC59E36D89C8EF1746C8724,39053,4,10,6,109.511,18.2771,1564
27178,207377,3F80F6C7ECC59E36D89C8EF1746C8724,30281,13,14,1,109.50597,18.27583,1514
27179,207378,3F80F6C7ECC59E36D89C8EF1746C8724,31206,17,20,3,109.50819,18.23549,1507
27182,207389,56C8C781972E8BFAF8A768A19AD7F590,30281,0,9,9,109.50597,18.27583,1514
27183,207390,56C8C781972E8BFAF8A768A19AD7F590,30421,12,14,2,109.50021,18.25861,1511
27184,207391,56C8C781972E8BFAF8A768A19AD7F590,38127,18,23,5,109.50833,18.27222,1513
27190,207424,FA14B010F60C7FB3B13194FAA13740E8,31561,1,3,2,109.56792,18.28479,1765
27191,207425,FA14B010F60C7FB3B13194FAA13740E8,39183,7,8,1,109.55542,18.28208,1715
27192,207426,FA14B010F60C7FB3B13194FAA13740E8,31561,8,22,14,109.56792,18.28479,1765
27199,207465,8A0382A2385C362EFE2664E8795F133E,31561,0,1,1,109.56792,18.28479,1765
27200,207466,8A0382A2385C362EFE2664E8795F133E,39183,1,18,17,109.55542,18.28208,1715
27201,207467,8A0382A2385C362EFE2664E8795F133E,31561,20,23,3,109.56792,18.28479,1765
27204,207538,0E5593A90D661690BE3DAAA17AD936E2,30281,1,7,6,109.50597,18.27583,1514
27205,207539,0E5593A90D661690BE3DAAA17AD936E2,38127,11,19,8,109.50833,18.27222,1513
27206,207540,0E5593A90D661690BE3DAAA17AD936E2,30291,20,21,1,109.50403,18.27028,1513
27224,207625,6BB908E717D43CA60DB426B647CF8DE4,31091,0,14,14,109.41201,18.31222,1170
27225,207626,6BB908E717D43CA60DB426B647CF8DE4,60041,14,15,1,109.39889,18.31944,1121
27226,207627,6BB908E717D43CA60DB426B647CF8DE4,31091,17,23,6,109.41201,18.31222,1170
27232,207683,03400E70232608A9491D68EE417E3691,30771,0,6,6,109.49938,18.26042,1511
27233,207684,03400E70232608A9491D68EE417E3691,60281,7,13,6,109.51743,18.25924,1561
27234,207685,03400E70232608A9491D68EE417E3691,31521,14,16,2,109.51458,18.22542,1555
27259,207954,CD576F1C1CDFB89E6A99A20E65927346,30854,2,7,5,109.56889,18.27076,1763
27260,207955,CD576F1C1CDFB89E6A99A20E65927346,31561,8,19,11,109.56792,18.28479,1765
27261,207956,CD576F1C1CDFB89E6A99A20E65927346,30854,20,22,2,109.56889,18.27076,1763
27262,208006,B712327B6033C61F37801CFD6DAC08AD,31951,5,6,1,109.52174,18.30299,1568
27263,208007,B712327B6033C61F37801CFD6DAC08AD,38484,7,13,6,109.53028,18.31528,1620
27264,208008,B712327B6033C61F37801CFD6DAC08AD,38484,14,23,9,109.53028,18.31528,1620
27271,208034,63FBAC0202144B00077561285E6A7F87,30821,1,14,13,109.43681,18.33639,1274
27272,208035,63FBAC0202144B00077561285E6A7F87,30651,14,16,2,109.42611,18.385,1232
27273,208036,63FBAC0202144B00077561285E6A7F87,30821,16,23,7,109.43681,18.33639,1274
27288,208247,E46795A590C643FCDE6B993B35621D2F,30921,1,2,1,109.53903,18.29451,1667
27289,208248,E46795A590C643FCDE6B993B35621D2F,31931,5,6,1,109.54771,18.29403,1667
27290,208249,E46795A590C643FCDE6B993B35621D2F,30351,9,11,2,109.41701,18.29292,1217
27291,208250,B78E7295CB13532B4E2C30EF158E297F,31931,0,1,1,109.54771,18.29403,1667
27292,208251,B78E7295CB13532B4E2C30EF158E297F,30854,2,6,4,109.56889,18.27076,1763
27293,208252,B78E7295CB13532B4E2C30EF158E297F,31931,8,11,3,109.54771,18.29403,1667
27310,208396,76DA946F4DC1318DD46A32E1D303D6B7,31931,0,7,7,109.54771,18.29403,1667
27311,208397,76DA946F4DC1318DD46A32E1D303D6B7,39181,11,13,2,109.55153,18.28035,1715
27312,208398,76DA946F4DC1318DD46A32E1D303D6B7,31931,16,23,7,109.54771,18.29403,1667
27315,208413,8293619D825F160795AE71B17456FBCB,30854,0,1,1,109.56889,18.27076,1763
27316,208414,8293619D825F160795AE71B17456FBCB,60631,1,2,1,109.57778,18.27583,1814
27317,208415,8293619D825F160795AE71B17456FBCB,60211,3,6,3,109.63549,18.26049,2011
27318,208416,8293619D825F160795AE71B17456FBCB,30854,9,23,14,109.56889,18.27076,1763
27319,208435,491A112CD81B9085F752897809919691,31201,0,5,5,109.51042,18.23819,1558
27320,208436,491A112CD81B9085F752897809919691,30181,7,8,1,109.51597,18.23313,1557
27321,208437,491A112CD81B9085F752897809919691,30151,12,14,2,109.50986,18.25083,1560
27324,208491,CD10EF600C408C94A1E83184DAC14278,30371,0,1,1,109.51,18.24771,1559
27325,208492,CD10EF600C408C94A1E83184DAC14278,31521,2,11,9,109.51458,18.22542,1555
27326,208493,CD10EF600C408C94A1E83184DAC14278,60381,11,13,2,109.5241,18.22458,1605
27327,208494,97C31877CA4226D0F1BA1C0E12066B56,30251,0,6,6,109.50611,18.26653,1512
27328,208495,97C31877CA4226D0F1BA1C0E12066B56,31561,9,13,4,109.56792,18.28479,1765
27329,208496,97C31877CA4226D0F1BA1C0E12066B56,30854,13,17,4,109.56889,18.27076,1763
27330,208497,97C31877CA4226D0F1BA1C0E12066B56,60331,22,23,1,109.505,18.26507,1512
27345,208589,608A55C14BAB2A5B627ACC1F39B89FB6,31945,0,7,7,109.58021,18.29403,1817
27346,208590,608A55C14BAB2A5B627ACC1F39B89FB6,31071,9,12,3,109.58257,18.28458,1815
27347,208591,608A55C14BAB2A5B627ACC1F39B89FB6,31945,15,23,8,109.58021,18.29403,1817
27348,208617,28413CB0160B68347E92144BE214EF48,60084,0,6,6,109.4984,18.2334,1507
27349,208618,28413CB0160B68347E92144BE214EF48,30191,6,7,1,109.50361,18.22701,1506
27350,208619,28413CB0160B68347E92144BE214EF48,30511,8,9,1,109.51069,18.24208,1558
27351,208620,28413CB0160B68347E92144BE214EF48,60081,10,11,1,109.51097,18.22639,1556
27352,208674,10EBF762D28520B09848288F7052CFDE,30854,0,6,6,109.56889,18.27076,1763
27353,208675,10EBF762D28520B09848288F7052CFDE,31561,6,16,10,109.56792,18.28479,1765
27354,208676,10EBF762D28520B09848288F7052CFDE,30854,17,23,6,109.56889,18.27076,1763
27355,208681,D5C80E85989FC489DEFCCD6817C6F0CE,31031,0,7,7,109.49979,18.25382,1510
27356,208682,D5C80E85989FC489DEFCCD6817C6F0CE,31864,12,14,2,109.49014,18.28333,1465
27357,208683,D5C80E85989FC489DEFCCD6817C6F0CE,39151,19,23,4,109.49875,18.25097,1510
27393,208937,0F558B6653C655C7F0BAEA9D66B33F57,31071,4,5,1,109.58257,18.28458,1815
27394,208938,0F558B6653C655C7F0BAEA9D66B33F57,31071,8,9,1,109.58257,18.28458,1815
27395,208939,0F558B6653C655C7F0BAEA9D66B33F57,30854,12,15,3,109.56889,18.27076,1763
27408,209001,0A48A76A646C70DF6B9924881BA2168A,30071,0,6,6,109.52819,18.30472,1619
27409,209002,0A48A76A646C70DF6B9924881BA2168A,31931,9,18,9,109.54771,18.29403,1667
27410,209003,0A48A76A646C70DF6B9924881BA2168A,30071,19,23,4,109.52819,18.30472,1619
27411,209008,417408FFDA93B177641D270D3A5C4B2D,31071,0,6,6,109.58257,18.28458,1815
27412,209009,417408FFDA93B177641D270D3A5C4B2D,30854,6,15,9,109.56889,18.27076,1763
27413,209010,417408FFDA93B177641D270D3A5C4B2D,31071,15,23,8,109.58257,18.28458,1815
27432,209187,D2A5F87218CF25385163A2F3C4229CB8,31561,0,2,2,109.56792,18.28479,1765
27433,209188,D2A5F87218CF25385163A2F3C4229CB8,30851,2,16,14,109.5616,18.27396,1713
27434,209189,D2A5F87218CF25385163A2F3C4229CB8,31271,18,19,1,109.48958,18.26257,1462
27435,209190,D2A5F87218CF25385163A2F3C4229CB8,31561,21,22,1,109.56792,18.28479,1765
27437,209229,8DD23AA43C0F7967C45F7488D66F9159,31945,0,1,1,109.58021,18.29403,1817
27438,209230,8DD23AA43C0F7967C45F7488D66F9159,31071,1,5,4,109.58257,18.28458,1815
27439,209231,8DD23AA43C0F7967C45F7488D66F9159,30854,7,10,3,109.56889,18.27076,1763
27440,209232,8DD23AA43C0F7967C45F7488D66F9159,31945,12,14,2,109.58021,18.29403,1817
27446,209259,147470AD3D3B8724582C30D5F244A8B6,60421,0,8,8,109.46333,18.31743,1371
27447,209260,147470AD3D3B8724582C30D5F244A8B6,30111,8,10,2,109.47583,18.30542,1419
27448,209261,147470AD3D3B8724582C30D5F244A8B6,60421,11,22,11,109.46333,18.31743,1371
27453,209364,BC2EDF4DF9C7FAD55BDEABA03DFA7284,31561,0,6,6,109.56792,18.28479,1765
27454,209365,BC2EDF4DF9C7FAD55BDEABA03DFA7284,30854,6,8,2,109.56889,18.27076,1763
27455,209366,BC2EDF4DF9C7FAD55BDEABA03DFA7284,31561,10,13,3,109.56792,18.28479,1765
27456,209367,BC2EDF4DF9C7FAD55BDEABA03DFA7284,39181,13,15,2,109.55153,18.28035,1715
27467,209482,E58F7930139B2ED51DE79005F05C056D,39181,3,15,12,109.55153,18.28035,1715
27468,209483,E58F7930139B2ED51DE79005F05C056D,39183,16,18,2,109.55542,18.28208,1715
27469,209484,E58F7930139B2ED51DE79005F05C056D,31561,21,23,2,109.56792,18.28479,1765
27476,209526,2A6BA0678DDF16AF08BAC9E3FA3C9391,30854,0,1,1,109.56889,18.27076,1763
27477,209527,2A6BA0678DDF16AF08BAC9E3FA3C9391,31561,2,7,5,109.56792,18.28479,1765
27478,209528,2A6BA0678DDF16AF08BAC9E3FA3C9391,30854,9,18,9,109.56889,18.27076,1763
27503,209680,A249BB92E18839D454C438B797D69714,60261,0,7,7,109.44326,18.3075,1319
27504,209681,A249BB92E18839D454C438B797D69714,60491,11,13,2,109.43354,18.30847,1269
27505,209682,A249BB92E18839D454C438B797D69714,60261,17,19,2,109.44326,18.3075,1319
27518,209786,17A4545370685D172A08774EFEF86DD3,30851,0,1,1,109.5616,18.27396,1713
27519,209787,17A4545370685D172A08774EFEF86DD3,31071,1,2,1,109.58257,18.28458,1815
27520,209788,17A4545370685D172A08774EFEF86DD3,30851,5,7,2,109.5616,18.27396,1713
27521,209789,17A4545370685D172A08774EFEF86DD3,39181,9,15,6,109.55153,18.28035,1715
27522,209811,F61486EBE9C0037CE6ECF4E72C7FFAB0,38117,0,6,6,109.51611,18.22354,1555
27523,209812,F61486EBE9C0037CE6ECF4E72C7FFAB0,30731,6,8,2,109.50944,18.22306,1555
27524,209813,F61486EBE9C0037CE6ECF4E72C7FFAB0,31521,9,15,6,109.51458,18.22542,1555
27525,209814,F61486EBE9C0037CE6ECF4E72C7FFAB0,31521,19,21,2,109.51458,18.22542,1555
27533,209832,37B1280251A3C52411E939549A58D078,39183,0,14,14,109.55542,18.28208,1715
27534,209833,37B1280251A3C52411E939549A58D078,39181,16,17,1,109.55153,18.28035,1715
27535,209834,37B1280251A3C52411E939549A58D078,39183,18,23,5,109.55542,18.28208,1715
27536,209846,B643AC77F8D8498A9694D45BA8B0F75F,60631,1,7,6,109.57778,18.27583,1814
27537,209847,B643AC77F8D8498A9694D45BA8B0F75F,30854,8,11,3,109.56889,18.27076,1763
27538,209848,B643AC77F8D8498A9694D45BA8B0F75F,60631,13,16,3,109.57778,18.27583,1814
27539,209849,B643AC77F8D8498A9694D45BA8B0F75F,31561,20,22,2,109.56792,18.28479,1765
27540,209882,CE70D3AAC3EF6B01DB8A5F34BD94E77D,30821,0,13,13,109.43681,18.33639,1274
27541,209883,CE70D3AAC3EF6B01DB8A5F34BD94E77D,30651,13,15,2,109.42611,18.385,1232
27542,209884,CE70D3AAC3EF6B01DB8A5F34BD94E77D,30821,16,22,6,109.43681,18.33639,1274
27543,209885,CE70D3AAC3EF6B01DB8A5F34BD94E77D,30651,22,23,1,109.42611,18.385,1232
27558,210004,42208654DD68D689FEE2FABD4C7FC956,30051,2,3,1,109.48917,18.21215,1453
27559,210005,42208654DD68D689FEE2FABD4C7FC956,30511,6,7,1,109.51069,18.24208,1558
27560,210006,42208654DD68D689FEE2FABD4C7FC956,30361,11,13,2,109.50347,18.24,1508
27568,210119,B87EA32D7A8C628CB2B89E95996DDE3E,60371,0,7,7,109.53063,18.30056,1618
27569,210120,B87EA32D7A8C628CB2B89E95996DDE3E,31931,8,15,7,109.54771,18.29403,1667
27570,210121,B87EA32D7A8C628CB2B89E95996DDE3E,30854,16,17,1,109.56889,18.27076,1763
27576,210143,B340EDEF4A878E8DF5CBEC25E465EACE,30854,0,2,2,109.56889,18.27076,1763
27577,210144,B340EDEF4A878E8DF5CBEC25E465EACE,60354,4,8,4,109.58701,18.28521,1815
27578,210145,B340EDEF4A878E8DF5CBEC25E465EACE,30854,9,23,14,109.56889,18.27076,1763
27582,210179,9FD9B533440DEDA093A3D6D9A5E4AA42,31945,3,7,4,109.58021,18.29403,1817
27583,210180,9FD9B533440DEDA093A3D6D9A5E4AA42,60361,11,14,3,109.51938,18.29681,1567
27584,210181,9FD9B533440DEDA093A3D6D9A5E4AA42,31945,17,20,3,109.58021,18.29403,1817
27585,210182,9FD9B533440DEDA093A3D6D9A5E4AA42,60361,21,22,1,109.51938,18.29681,1567
27619,210421,44F505B3929E26B4B29F00CC284F3084,60631,2,8,6,109.57778,18.27583,1814
27620,210422,44F505B3929E26B4B29F00CC284F3084,30854,11,18,7,109.56889,18.27076,1763
27621,210423,44F505B3929E26B4B29F00CC284F3084,31071,18,21,3,109.58257,18.28458,1815
27622,210424,770A00BDAFE9BCA8C9E9FA68066EED7D,31071,0,6,6,109.58257,18.28458,1815
27623,210425,770A00BDAFE9BCA8C9E9FA68066EED7D,31561,9,17,8,109.56792,18.28479,1765
27624,210426,770A00BDAFE9BCA8C9E9FA68066EED7D,31071,21,23,2,109.58257,18.28458,1815
27631,210483,22328E79B5A8943E5A27CE35499D706B,38251,0,8,8,109.49618,18.25493,1510
27632,210484,22328E79B5A8943E5A27CE35499D706B,60274,9,10,1,109.514,18.2933,1567
27633,210485,22328E79B5A8943E5A27CE35499D706B,38127,11,12,1,109.50833,18.27222,1513
27634,210486,22328E79B5A8943E5A27CE35499D706B,60274,14,16,2,109.514,18.2933,1567
27663,210658,94C4D5691F7DFC1AB38806AFFAC1389E,30921,1,11,10,109.53903,18.29451,1667
27664,210659,94C4D5691F7DFC1AB38806AFFAC1389E,31931,13,14,1,109.54771,18.29403,1667
27665,210660,94C4D5691F7DFC1AB38806AFFAC1389E,30921,16,18,2,109.53903,18.29451,1667
27666,210661,94C4D5691F7DFC1AB38806AFFAC1389E,31931,20,23,3,109.54771,18.29403,1667
27669,210725,9FC721E86703223349C05C95FE4BBB6F,60081,0,8,8,109.51097,18.22639,1556
27670,210726,9FC721E86703223349C05C95FE4BBB6F,60381,13,20,7,109.5241,18.22458,1605
27671,210727,9FC721E86703223349C05C95FE4BBB6F,60087,21,23,2,109.50688,18.22299,1505
27672,210735,B81DEDE33B0853E35D97557F334A4861,60361,0,5,5,109.51938,18.29681,1567
27673,210736,B81DEDE33B0853E35D97557F334A4861,31931,8,18,10,109.54771,18.29403,1667
27674,210737,B81DEDE33B0853E35D97557F334A4861,60361,19,23,4,109.51938,18.29681,1567
27677,210759,A68637AA89BD62624E677D9E66C32FAD,31461,0,8,8,109.5091,18.25389,1510
27678,210760,A68637AA89BD62624E677D9E66C32FAD,30161,8,17,9,109.50042,18.24389,1508
27679,210761,A68637AA89BD62624E677D9E66C32FAD,30361,19,23,4,109.50347,18.24,1508
27680,210786,CFCFA94681CDD57855D6405C244168DD,31201,3,11,8,109.51042,18.23819,1558
27681,210787,CFCFA94681CDD57855D6405C244168DD,38891,12,18,6,109.51486,18.24118,1558
27682,210788,CFCFA94681CDD57855D6405C244168DD,31821,21,22,1,109.51181,18.24924,1559
27683,210859,3389A095460231D31BA622B7185D6321,60552,0,2,2,109.41729,18.30014,1218
27684,210860,3389A095460231D31BA622B7185D6321,31681,6,17,11,109.40396,18.29979,1168
27685,210861,3389A095460231D31BA622B7185D6321,60552,18,20,2,109.41729,18.30014,1218
27686,210862,3389A095460231D31BA622B7185D6321,31231,22,23,1,109.42597,18.29292,1217
27694,210962,51B9FE31A6261A2E6FE900B23D8E8A33,60391,0,17,17,109.47667,18.28757,1416
27695,210963,51B9FE31A6261A2E6FE900B23D8E8A33,30741,20,21,1,109.49833,18.28681,1516
27696,210964,51B9FE31A6261A2E6FE900B23D8E8A33,60391,22,23,1,109.47667,18.28757,1416
27697,210971,60ACD2B6657BEEA3D1B558DE71329F84,60311,0,8,8,109.52097,18.24319,1558
27698,210972,60ACD2B6657BEEA3D1B558DE71329F84,30271,11,16,5,109.49132,18.23153,1456
27699,210973,60ACD2B6657BEEA3D1B558DE71329F84,60311,20,23,3,109.52097,18.24319,1558
27700,210976,DF34F38BEE4872598B76E0C6734B5964,30121,0,9,9,109.52861,18.27222,1613
27701,210977,DF34F38BEE4872598B76E0C6734B5964,60241,14,15,1,109.53319,18.28667,1616
27702,210978,DF34F38BEE4872598B76E0C6734B5964,31931,18,23,5,109.54771,18.29403,1667
27703,211033,122D07F80E4FAC68FAE7EDBB2DF1AFA3,60631,2,5,3,109.57778,18.27583,1814
27704,211034,122D07F80E4FAC68FAE7EDBB2DF1AFA3,30854,9,11,2,109.56889,18.27076,1763
27705,211035,122D07F80E4FAC68FAE7EDBB2DF1AFA3,31071,13,14,1,109.58257,18.28458,1815
27706,211036,122D07F80E4FAC68FAE7EDBB2DF1AFA3,30854,15,18,3,109.56889,18.27076,1763
27707,211059,00145806BBF2F60A963743509F901155,60331,1,6,5,109.505,18.26507,1512
27708,211060,00145806BBF2F60A963743509F901155,38157,6,15,9,109.51483,18.26958,1563
27709,211061,00145806BBF2F60A963743509F901155,30291,16,19,3,109.50403,18.27028,1513
27710,211062,00145806BBF2F60A963743509F901155,60331,21,22,1,109.505,18.26507,1512
27712,211086,47A18820FDA9856131F74091D44B6BCB,31561,0,7,7,109.56792,18.28479,1765
27713,211087,47A18820FDA9856131F74091D44B6BCB,31071,12,13,1,109.58257,18.28458,1815
27714,211088,47A18820FDA9856131F74091D44B6BCB,31561,14,23,9,109.56792,18.28479,1765
27729,211240,8E06EAC16B0EF776FA1BAAC5B9747325,30511,0,7,7,109.51069,18.24208,1558
27730,211241,8E06EAC16B0EF776FA1BAAC5B9747325,60201,11,12,1,109.5041,18.2509,1510
27731,211242,8E06EAC16B0EF776FA1BAAC5B9747325,30511,12,23,11,109.51069,18.24208,1558
27747,211302,E4D199FCE009427481C9D06B9609AB1E,31931,1,14,13,109.54771,18.29403,1667
27748,211303,E4D199FCE009427481C9D06B9609AB1E,39181,17,20,3,109.55153,18.28035,1715
27749,211304,E4D199FCE009427481C9D06B9609AB1E,31931,20,21,1,109.54771,18.29403,1667
27769,211445,96F98526707B06BE1263CCD4F72E07A1,31071,0,16,16,109.58257,18.28458,1815
27770,211446,96F98526707B06BE1263CCD4F72E07A1,30854,17,19,2,109.56889,18.27076,1763
27771,211447,96F98526707B06BE1263CCD4F72E07A1,31071,19,20,1,109.58257,18.28458,1815
27782,211477,CB2B883155D37146FD4D4AA009B8CC00,31531,0,4,4,109.49583,18.25972,1461
27783,211478,CB2B883155D37146FD4D4AA009B8CC00,30771,5,17,12,109.49938,18.26042,1511
27784,211479,CB2B883155D37146FD4D4AA009B8CC00,38251,21,22,1,109.49618,18.25493,1510
27792,211544,B93185B4820D7E0DEE74EBEA00941D15,38291,0,1,1,109.51618,18.24313,1558
27793,211545,B93185B4820D7E0DEE74EBEA00941D15,30911,2,10,8,109.50493,18.26181,1511
27794,211546,B93185B4820D7E0DEE74EBEA00941D15,30911,10,22,12,109.50493,18.26181,1511
27798,211588,F84D949DDCBF25D5530F771BC55E0B9D,31321,0,3,3,109.63799,18.23201,2007
27799,211589,F84D949DDCBF25D5530F771BC55E0B9D,31571,4,5,1,109.61563,18.23326,1957
27800,211590,F84D949DDCBF25D5530F771BC55E0B9D,61011,6,16,10,109.60653,18.19076,1900
27801,211591,F84D949DDCBF25D5530F771BC55E0B9D,31321,18,23,5,109.63799,18.23201,2007
27825,211829,DBB710D279E76C79F1E4B0766F579F8A,31071,0,1,1,109.58257,18.28458,1815
27826,211830,DBB710D279E76C79F1E4B0766F579F8A,60211,3,4,1,109.63549,18.26049,2011
27827,211831,DBB710D279E76C79F1E4B0766F579F8A,31071,5,14,9,109.58257,18.28458,1815
27833,211859,8799356B7181F28146A203E5F86C52F0,31351,0,8,8,109.4959,18.28417,1465
27834,211860,8799356B7181F28146A203E5F86C52F0,30321,9,12,3,109.49563,18.29611,1467
27835,211861,8799356B7181F28146A203E5F86C52F0,31351,15,16,1,109.4959,18.28417,1465
27840,211907,A2DBFF4E352E7B7C1EE25431C02FC741,31931,0,5,5,109.54771,18.29403,1667
27841,211908,A2DBFF4E352E7B7C1EE25431C02FC741,39183,9,10,1,109.55542,18.28208,1715
27842,211909,A2DBFF4E352E7B7C1EE25431C02FC741,31931,12,23,11,109.54771,18.29403,1667
27848,211915,0B625DE57093602A177FF6EF2935F6D3,31521,0,1,1,109.51458,18.22542,1555
27849,211916,0B625DE57093602A177FF6EF2935F6D3,31521,2,3,1,109.51458,18.22542,1555
27850,211917,0B625DE57093602A177FF6EF2935F6D3,60381,4,11,7,109.5241,18.22458,1605
27851,211918,0B625DE57093602A177FF6EF2935F6D3,31521,12,23,11,109.51458,18.22542,1555
27854,211992,3C5AEA306E8A69C707195C4150E77D90,31931,1,4,3,109.54771,18.29403,1667
27855,211993,3C5AEA306E8A69C707195C4150E77D90,39181,6,10,4,109.55153,18.28035,1715
27856,211994,3C5AEA306E8A69C707195C4150E77D90,31931,11,13,2,109.54771,18.29403,1667
27857,211995,3C5AEA306E8A69C707195C4150E77D90,39181,15,21,6,109.55153,18.28035,1715
27868,212063,8D496C0E2DB1FF881021B05CE10C0242,30854,0,10,10,109.56889,18.27076,1763
27869,212064,8D496C0E2DB1FF881021B05CE10C0242,30711,11,13,2,109.50271,18.25347,1510
27870,212065,8D496C0E2DB1FF881021B05CE10C0242,30854,16,19,3,109.56889,18.27076,1763
27871,212089,5DC6E4C80EB444425AE8AF64A7960C0A,60614,0,6,6,109.48799,18.29521,1467
27872,212090,5DC6E4C80EB444425AE8AF64A7960C0A,60501,7,8,1,109.48701,18.29021,1466
27873,212091,5DC6E4C80EB444425AE8AF64A7960C0A,60614,8,10,2,109.48799,18.29521,1467
27874,212093,5DC6E4C80EB444425AE8AF64A7960C0A,60614,16,23,7,109.48799,18.29521,1467
27875,212139,8819F09BB0735F6A8E80552A57CCCF5D,31521,1,9,8,109.51458,18.22542,1555
27876,212140,8819F09BB0735F6A8E80552A57CCCF5D,38111,10,12,2,109.52007,18.22403,1555
27877,212141,8819F09BB0735F6A8E80552A57CCCF5D,30361,12,14,2,109.50347,18.24,1508
27893,212284,66B46B2B6466319F5394240B88A355B7,38911,0,1,1,109.51674,18.24965,1559
27894,212285,66B46B2B6466319F5394240B88A355B7,38291,2,5,3,109.51618,18.24313,1558
27895,212286,66B46B2B6466319F5394240B88A355B7,39183,6,14,8,109.55542,18.28208,1715
27896,212287,66B46B2B6466319F5394240B88A355B7,38911,16,22,6,109.51674,18.24965,1559
27911,212567,189633BA4D39EBA8A203BC9E364D4B1F,30381,0,10,10,109.52521,18.24507,1609
27912,212568,189633BA4D39EBA8A203BC9E364D4B1F,60231,13,17,4,109.49903,18.21972,1504
27913,212569,189633BA4D39EBA8A203BC9E364D4B1F,60381,18,19,1,109.5241,18.22458,1605
27914,212570,189633BA4D39EBA8A203BC9E364D4B1F,30741,21,23,2,109.49833,18.28681,1516
27915,212592,815B1E622D05FD49F310F3AFE15701D1,60661,0,8,8,109.548,18.2377,1657
27916,212593,815B1E622D05FD49F310F3AFE15701D1,60463,9,15,6,109.52507,18.22438,1605
27917,212594,815B1E622D05FD49F310F3AFE15701D1,30854,17,21,4,109.56889,18.27076,1763
27918,212653,8FE97C1052D63DE830211C405D8F5442,39371,0,5,5,109.56627,18.2646,1762
27919,212654,8FE97C1052D63DE830211C405D8F5442,39183,6,7,1,109.55542,18.28208,1715
27920,212655,8FE97C1052D63DE830211C405D8F5442,30854,8,15,7,109.56889,18.27076,1763
27926,212705,6422CB87ACC55DDEF6EBE8946593C808,60291,1,2,1,109.50826,18.24639,1509
27927,212706,6422CB87ACC55DDEF6EBE8946593C808,30721,2,10,8,109.51597,18.28257,1565
27928,212707,6422CB87ACC55DDEF6EBE8946593C808,38171,13,21,8,109.50799,18.28139,1515
27951,212949,67F0367E877FC8B8EED5BAE43170FD94,30181,0,4,4,109.51597,18.23313,1557
27952,212950,67F0367E877FC8B8EED5BAE43170FD94,30711,6,14,8,109.50271,18.25347,1510
27953,212951,67F0367E877FC8B8EED5BAE43170FD94,30181,14,23,9,109.51597,18.23313,1557
27967,213027,69F4307E378774E8E49F5A5A6F5C64A6,30921,0,9,9,109.53903,18.29451,1667
27968,213028,69F4307E378774E8E49F5A5A6F5C64A6,31931,13,16,3,109.54771,18.29403,1667
27969,213029,69F4307E378774E8E49F5A5A6F5C64A6,60221,18,20,2,109.52569,18.29188,1616
27970,213030,69F4307E378774E8E49F5A5A6F5C64A6,30921,21,23,2,109.53903,18.29451,1667
27976,213075,7D1ED6067ECBD941EFC43CE0A6ADAE71,30854,0,1,1,109.56889,18.27076,1763
27977,213076,7D1ED6067ECBD941EFC43CE0A6ADAE71,31071,2,4,2,109.58257,18.28458,1815
27978,213077,7D1ED6067ECBD941EFC43CE0A6ADAE71,30854,4,21,17,109.56889,18.27076,1763
27979,213086,9E8746086915F9D4A063A74CF0B5B7AB,31561,0,3,3,109.56792,18.28479,1765
27980,213087,9E8746086915F9D4A063A74CF0B5B7AB,30851,4,6,2,109.5616,18.27396,1713
27981,213088,9E8746086915F9D4A063A74CF0B5B7AB,31561,9,10,1,109.56792,18.28479,1765
27989,213203,033CEEC20746801745CF4A53CD517C31,31261,0,8,8,109.51174,18.2466,1559
27990,213204,033CEEC20746801745CF4A53CD517C31,30741,9,13,4,109.49833,18.28681,1516
27991,213205,033CEEC20746801745CF4A53CD517C31,60241,13,16,3,109.53319,18.28667,1616
27992,213206,033CEEC20746801745CF4A53CD517C31,30711,19,20,1,109.50271,18.25347,1510
27994,213245,5CFFF8D919E96524101209E188C669B3,31951,0,9,9,109.52174,18.30299,1568
27995,213246,5CFFF8D919E96524101209E188C669B3,60301,9,10,1,109.60715,18.30993,1919
27996,213247,5CFFF8D919E96524101209E188C669B3,31951,12,14,2,109.52174,18.30299,1568
28014,213367,81946AFE1D298F3B40176C804AE3EF84,31951,0,3,3,109.52174,18.30299,1568
28015,213368,81946AFE1D298F3B40176C804AE3EF84,38484,4,5,1,109.53028,18.31528,1620
28016,213369,81946AFE1D298F3B40176C804AE3EF84,60241,8,16,8,109.53319,18.28667,1616
28037,213417,D46DE9169E4BACF1D272EA5E0FDEF68F,30854,0,4,4,109.56889,18.27076,1763
28038,213418,D46DE9169E4BACF1D272EA5E0FDEF68F,30851,6,11,5,109.5616,18.27396,1713
28039,213419,D46DE9169E4BACF1D272EA5E0FDEF68F,31561,11,16,5,109.56792,18.28479,1765
28040,213426,2981C8B3C1AD0C63670497656AA260BB,30721,0,7,7,109.51597,18.28257,1565
28041,213427,2981C8B3C1AD0C63670497656AA260BB,60084,9,10,1,109.4984,18.2334,1507
28042,213429,2981C8B3C1AD0C63670497656AA260BB,60031,18,20,2,109.49694,18.31632,1521
28043,213460,39F25FE146A03325C93C111F2A943B6C,31945,0,5,5,109.58021,18.29403,1817
28044,213461,39F25FE146A03325C93C111F2A943B6C,30854,8,21,13,109.56889,18.27076,1763
28045,213462,39F25FE146A03325C93C111F2A943B6C,31945,21,23,2,109.58021,18.29403,1817
28046,213503,5DE4A4FBB65CCE260678025A043BEB2F,38105,0,15,15,109.40299,18.29229,1117
28047,213504,5DE4A4FBB65CCE260678025A043BEB2F,38102,16,17,1,109.40875,18.29111,1166
28048,213505,5DE4A4FBB65CCE260678025A043BEB2F,38105,19,23,4,109.40299,18.29229,1117
28049,213546,CFA6DB42B4EA79576A8AEA8F93765E81,30721,1,10,9,109.51597,18.28257,1565
28050,213547,CFA6DB42B4EA79576A8AEA8F93765E81,39181,10,11,1,109.55153,18.28035,1715
28051,213548,CFA6DB42B4EA79576A8AEA8F93765E81,30721,15,23,8,109.51597,18.28257,1565
28054,213585,D5A941B7629B76426207AF63E861B5B0,60354,0,11,11,109.58701,18.28521,1815
28055,213586,D5A941B7629B76426207AF63E861B5B0,31071,14,17,3,109.58257,18.28458,1815
28056,213587,D5A941B7629B76426207AF63E861B5B0,30854,19,21,2,109.56889,18.27076,1763
28073,213687,C1BB6603CFDF86A619E9B76EAEAEF5D3,31071,0,7,7,109.58257,18.28458,1815
28074,213688,C1BB6603CFDF86A619E9B76EAEAEF5D3,31071,11,13,2,109.58257,18.28458,1815
28075,213689,C1BB6603CFDF86A619E9B76EAEAEF5D3,38315,15,17,2,109.48979,18.29764,1467
28086,213906,102A3C1C3179D6FF6A52B59C3B4087A1,31181,0,1,1,109.50382,18.24813,1509
28087,213907,102A3C1C3179D6FF6A52B59C3B4087A1,31391,2,10,8,109.50382,18.24285,1508
28088,213908,102A3C1C3179D6FF6A52B59C3B4087A1,31181,11,23,12,109.50382,18.24813,1509
28113,214192,FEB695B11F58C51C72553BEB72CBDB8F,31521,0,19,19,109.51458,18.22542,1555
28114,214193,FEB695B11F58C51C72553BEB72CBDB8F,31031,19,21,2,109.49979,18.25382,1510
28115,214194,FEB695B11F58C51C72553BEB72CBDB8F,60201,21,22,1,109.5041,18.2509,1510
28116,214233,4F1F2C63B1D8098AD9ABA50013979078,31461,1,12,11,109.5091,18.25389,1510
28117,214234,4F1F2C63B1D8098AD9ABA50013979078,30861,15,18,3,109.52722,18.22743,1606
28118,214235,4F1F2C63B1D8098AD9ABA50013979078,30421,19,21,2,109.50021,18.25861,1511
28119,214236,4F1F2C63B1D8098AD9ABA50013979078,31261,21,23,2,109.51174,18.2466,1559
28140,214476,7BF65E5054DA81A230AB5423620158E1,60631,0,7,7,109.57778,18.27583,1814
28141,214477,7BF65E5054DA81A230AB5423620158E1,31071,9,11,2,109.58257,18.28458,1815
28142,214478,7BF65E5054DA81A230AB5423620158E1,30854,13,16,3,109.56889,18.27076,1763
28143,214479,7BF65E5054DA81A230AB5423620158E1,60631,20,23,3,109.57778,18.27583,1814
28147,214516,C58D0182BFC61ED113EE3B09763C30B2,38185,0,14,14,109.51333,18.27347,1563
28148,214517,C58D0182BFC61ED113EE3B09763C30B2,31031,14,17,3,109.49979,18.25382,1510
28149,214518,C58D0182BFC61ED113EE3B09763C30B2,38185,18,23,5,109.51333,18.27347,1563
28161,214617,9BF33DB1F7AC1D27E06AF501C14CCF2C,31931,0,7,7,109.54771,18.29403,1667
28162,214618,9BF33DB1F7AC1D27E06AF501C14CCF2C,39181,8,11,3,109.55153,18.28035,1715
28163,214619,9BF33DB1F7AC1D27E06AF501C14CCF2C,31931,11,23,12,109.54771,18.29403,1667
28182,214735,2EB46D736E608EB8E50DA36D9E401F1D,38331,0,10,10,109.62465,18.22736,1956
28183,214736,2EB46D736E608EB8E50DA36D9E401F1D,31221,11,13,2,109.61333,18.26833,1913
28184,214737,2EB46D736E608EB8E50DA36D9E401F1D,38331,14,23,9,109.62465,18.22736,1956
28185,214738,8F6EA1C108FADA76A214A7ED71ECE3D1,30891,1,5,4,109.59431,18.28389,1865
28186,214739,8F6EA1C108FADA76A214A7ED71ECE3D1,30854,6,14,8,109.56889,18.27076,1763
28187,214740,8F6EA1C108FADA76A214A7ED71ECE3D1,30851,14,15,1,109.5616,18.27396,1713
28188,214741,8F6EA1C108FADA76A214A7ED71ECE3D1,30854,17,18,1,109.56889,18.27076,1763
28189,214852,E988DA8DA294A7CCEAA28AECB6C26A8F,31431,0,8,8,109.44639,18.29042,1316
28190,214853,E988DA8DA294A7CCEAA28AECB6C26A8F,31701,12,14,2,109.44132,18.28833,1266
28191,214854,E988DA8DA294A7CCEAA28AECB6C26A8F,38871,14,18,4,109.44681,18.28625,1316
28192,214855,E988DA8DA294A7CCEAA28AECB6C26A8F,31701,18,20,2,109.44132,18.28833,1266
28194,214877,8AABF5FDF2B06EB445749240A3894969,30854,0,9,9,109.56889,18.27076,1763
28195,214878,8AABF5FDF2B06EB445749240A3894969,31071,13,20,7,109.58257,18.28458,1815
28196,214879,8AABF5FDF2B06EB445749240A3894969,30854,22,23,1,109.56889,18.27076,1763
28201,214921,F315998EC48289C5B7879B7FA5033861,30711,0,9,9,109.50271,18.25347,1510
28202,214922,F315998EC48289C5B7879B7FA5033861,31461,12,15,3,109.5091,18.25389,1510
28203,214923,F315998EC48289C5B7879B7FA5033861,39154,20,22,2,109.50201,18.25681,1511
28212,215073,64FF3E93355E6DCA29977E04D316EABA,39091,2,7,5,109.50097,18.25222,1510
28213,215074,64FF3E93355E6DCA29977E04D316EABA,60311,9,10,1,109.52097,18.24319,1558
28214,215075,64FF3E93355E6DCA29977E04D316EABA,31261,12,16,4,109.51174,18.2466,1559
28215,215076,64FF3E93355E6DCA29977E04D316EABA,38973,17,22,5,109.51097,18.25389,1560
28218,215099,9A1D1AA5EE2CD156CC396C667ED8C5B9,30854,0,1,1,109.56889,18.27076,1763
28219,215100,9A1D1AA5EE2CD156CC396C667ED8C5B9,31071,1,16,15,109.58257,18.28458,1815
28220,215101,9A1D1AA5EE2CD156CC396C667ED8C5B9,60631,17,18,1,109.57778,18.27583,1814
28228,215189,267109764004253FF1AD548611BE6E82,39371,0,6,6,109.56627,18.2646,1762
28229,215190,267109764004253FF1AD548611BE6E82,30891,9,14,5,109.59431,18.28389,1865
28230,215191,267109764004253FF1AD548611BE6E82,39371,18,23,5,109.56627,18.2646,1762
28240,215280,9B979E9430BCD0DDB6C78BBE525EBD2D,60631,0,1,1,109.57778,18.27583,1814
28241,215281,9B979E9430BCD0DDB6C78BBE525EBD2D,30854,2,18,16,109.56889,18.27076,1763
28242,215282,9B979E9430BCD0DDB6C78BBE525EBD2D,39371,20,21,1,109.56627,18.2646,1762
28243,215336,E499E78D259E27068B57F40CF87421E0,60614,0,7,7,109.48799,18.29521,1467
28244,215337,E499E78D259E27068B57F40CF87421E0,60501,8,9,1,109.48701,18.29021,1466
28245,215338,E499E78D259E27068B57F40CF87421E0,30421,11,14,3,109.50021,18.25861,1511
28249,215366,C1F100A79C441D3FFDBAE922D32DC8D2,30854,0,20,20,109.56889,18.27076,1763
28250,215367,C1F100A79C441D3FFDBAE922D32DC8D2,31945,20,21,1,109.58021,18.29403,1817
28251,215368,C1F100A79C441D3FFDBAE922D32DC8D2,30854,22,23,1,109.56889,18.27076,1763
28252,215378,C2B7B3A3FAB31B432C169B25FFB0A1F6,30854,0,8,8,109.56889,18.27076,1763
28253,215379,C2B7B3A3FAB31B432C169B25FFB0A1F6,31071,12,14,2,109.58257,18.28458,1815
28254,215380,C2B7B3A3FAB31B432C169B25FFB0A1F6,31945,14,16,2,109.58021,18.29403,1817
28299,215610,C7B596C3998F49DC6B86FB54AB7111B3,31071,0,5,5,109.58257,18.28458,1815
28300,215611,C7B596C3998F49DC6B86FB54AB7111B3,30706,6,9,3,109.58833,18.31125,1820
28301,215612,C7B596C3998F49DC6B86FB54AB7111B3,31071,10,22,12,109.58257,18.28458,1815
28303,215664,A9634A2AD8447824C1C9412CBBCC32E0,31181,0,14,14,109.50382,18.24813,1509
28304,215665,A9634A2AD8447824C1C9412CBBCC32E0,31531,14,15,1,109.49583,18.25972,1461
28305,215666,A9634A2AD8447824C1C9412CBBCC32E0,31181,20,23,3,109.50382,18.24813,1509
28306,215740,222E0B6922623CE9FBB280F81068D40E,39321,0,5,5,109.529,18.2167,1604
28307,215741,222E0B6922623CE9FBB280F81068D40E,30531,6,8,2,109.53271,18.21472,1604
28308,215742,222E0B6922623CE9FBB280F81068D40E,30731,10,13,3,109.50944,18.22306,1555
28367,216163,A673316D9E7622125C9B466801BB0DCE,31221,0,1,1,109.61333,18.26833,1913
28368,216164,A673316D9E7622125C9B466801BB0DCE,38275,2,6,4,109.62875,18.22938,2006
28369,216165,A673316D9E7622125C9B466801BB0DCE,31571,6,7,1,109.61563,18.23326,1957
28370,216209,9B389AE8E9B004176803CCEAFF69104A,39371,1,4,3,109.56627,18.2646,1762
28371,216210,9B389AE8E9B004176803CCEAFF69104A,30951,7,15,8,109.56208,18.25667,1761
28372,216211,9B389AE8E9B004176803CCEAFF69104A,30854,18,20,2,109.56889,18.27076,1763
28377,216298,17D13F6A66037B54FAB5668CDC734401,30721,0,6,6,109.51597,18.28257,1565
28378,216299,17D13F6A66037B54FAB5668CDC734401,31931,8,9,1,109.54771,18.29403,1667
28379,216300,17D13F6A66037B54FAB5668CDC734401,39181,9,17,8,109.55153,18.28035,1715
28380,216301,17D13F6A66037B54FAB5668CDC734401,30721,21,23,2,109.51597,18.28257,1565
28390,216395,855D815DC19AA779325469411A9E7B8A,30251,0,1,1,109.50611,18.26653,1512
28391,216396,855D815DC19AA779325469411A9E7B8A,38157,3,8,5,109.51483,18.26958,1563
28392,216397,855D815DC19AA779325469411A9E7B8A,30251,11,12,1,109.50611,18.26653,1512
28393,216398,855D815DC19AA779325469411A9E7B8A,38157,12,16,4,109.51483,18.26958,1563
28410,216675,DEFDF52078F80D0DB257A40413FF368C,31071,0,5,5,109.58257,18.28458,1815
28411,216676,DEFDF52078F80D0DB257A40413FF368C,30854,6,20,14,109.56889,18.27076,1763
28412,216677,DEFDF52078F80D0DB257A40413FF368C,31071,21,22,1,109.58257,18.28458,1815
28413,216678,DEFDF52078F80D0DB257A40413FF368C,30854,22,23,1,109.56889,18.27076,1763
28416,216776,4B004637D3CFBCA65EA00FFD3F1EF7A6,31561,0,6,6,109.56792,18.28479,1765
28417,216777,4B004637D3CFBCA65EA00FFD3F1EF7A6,30071,8,9,1,109.52819,18.30472,1619
28418,216778,4B004637D3CFBCA65EA00FFD3F1EF7A6,39183,9,11,2,109.55542,18.28208,1715
28419,216779,4B004637D3CFBCA65EA00FFD3F1EF7A6,31561,11,23,12,109.56792,18.28479,1765
28420,216827,EBD16061EA20EE33D9344D33735E5205,31441,0,12,12,109.51181,18.24424,1559
28421,216828,EBD16061EA20EE33D9344D33735E5205,31261,14,17,3,109.51174,18.2466,1559
28422,216829,EBD16061EA20EE33D9344D33735E5205,31441,17,23,6,109.51181,18.24424,1559
28430,216915,AE6DC7ACB81DB5F351E45AC25E5F5A3B,60281,0,1,1,109.51743,18.25924,1561
28431,216916,AE6DC7ACB81DB5F351E45AC25E5F5A3B,60381,2,3,1,109.5241,18.22458,1605
28432,216917,AE6DC7ACB81DB5F351E45AC25E5F5A3B,38297,5,7,2,109.52576,18.24965,1609
28433,216918,AE6DC7ACB81DB5F351E45AC25E5F5A3B,39154,8,11,3,109.50201,18.25681,1511
28439,216961,ACDEAAF45B65DE48CF80A48DBD3C775E,31071,1,6,5,109.58257,18.28458,1815
28440,216962,ACDEAAF45B65DE48CF80A48DBD3C775E,30854,7,19,12,109.56889,18.27076,1763
28441,216963,ACDEAAF45B65DE48CF80A48DBD3C775E,31071,19,20,1,109.58257,18.28458,1815
28442,216968,5EBEA276FCB4A19AC5C987F5C7CC8908,60621,0,9,9,109.48354,18.27451,1464
28443,216969,5EBEA276FCB4A19AC5C987F5C7CC8908,60551,10,11,1,109.42722,18.30111,1218
28444,216970,5EBEA276FCB4A19AC5C987F5C7CC8908,38361,13,14,1,109.43667,18.29201,1267
28445,216981,DB4DF566D4757FF3BB488F82DE126248,31561,0,15,15,109.56792,18.28479,1765
28446,216982,DB4DF566D4757FF3BB488F82DE126248,30851,16,18,2,109.5616,18.27396,1713
28447,216983,DB4DF566D4757FF3BB488F82DE126248,31561,18,23,5,109.56792,18.28479,1765
28448,217031,B55959B64746A18ECF5077B5F7359221,31561,0,5,5,109.56792,18.28479,1765
28449,217032,B55959B64746A18ECF5077B5F7359221,60331,8,10,2,109.505,18.26507,1512
28450,217033,B55959B64746A18ECF5077B5F7359221,31561,11,13,2,109.56792,18.28479,1765
28468,217242,CA3896FB33E9BC68E91955EDFF5D709B,60631,0,6,6,109.57778,18.27583,1814
28469,217243,CA3896FB33E9BC68E91955EDFF5D709B,31945,10,11,1,109.58021,18.29403,1817
28470,217244,CA3896FB33E9BC68E91955EDFF5D709B,30854,15,23,8,109.56889,18.27076,1763
28471,217288,6B806948BC9187A91D033B4096721B00,31561,2,8,6,109.56792,18.28479,1765
28472,217289,6B806948BC9187A91D033B4096721B00,30851,10,12,2,109.5616,18.27396,1713
28473,217290,6B806948BC9187A91D033B4096721B00,31071,12,17,5,109.58257,18.28458,1815
28479,217408,149F44702DEC8C73589BE6524F0A1FFD,30854,5,14,9,109.56889,18.27076,1763
28480,217409,149F44702DEC8C73589BE6524F0A1FFD,60631,15,17,2,109.57778,18.27583,1814
28481,217410,149F44702DEC8C73589BE6524F0A1FFD,30854,18,20,2,109.56889,18.27076,1763
28482,217411,011859AA130B61CD7FFEFC39AEF2B9BF,30821,1,11,10,109.43681,18.33639,1274
28483,217412,011859AA130B61CD7FFEFC39AEF2B9BF,30651,13,15,2,109.42611,18.385,1232
28484,217413,011859AA130B61CD7FFEFC39AEF2B9BF,60472,15,19,4,109.46625,18.29542,1367
28485,217414,011859AA130B61CD7FFEFC39AEF2B9BF,30821,21,22,1,109.43681,18.33639,1274
28499,217499,C93386A9D86FE22A1FD4E5116045DD8D,31561,3,6,3,109.56792,18.28479,1765
28500,217500,C93386A9D86FE22A1FD4E5116045DD8D,39183,9,10,1,109.55542,18.28208,1715
28501,217501,C93386A9D86FE22A1FD4E5116045DD8D,31561,11,13,2,109.56792,18.28479,1765
28521,217632,7C9A3DA4FAA96538C9DBC71D98F4E61B,38157,0,7,7,109.51483,18.26958,1563
28522,217633,7C9A3DA4FAA96538C9DBC71D98F4E61B,30854,9,10,1,109.56889,18.27076,1763
28523,217634,7C9A3DA4FAA96538C9DBC71D98F4E61B,31561,12,14,2,109.56792,18.28479,1765
28524,217635,7C9A3DA4FAA96538C9DBC71D98F4E61B,30854,17,18,1,109.56889,18.27076,1763
28525,217713,0E129C09250C0D46273B4BD7E5225556,30151,0,6,6,109.50986,18.25083,1560
28526,217714,0E129C09250C0D46273B4BD7E5225556,39154,7,8,1,109.50201,18.25681,1511
28527,217717,0E129C09250C0D46273B4BD7E5225556,60281,19,21,2,109.51743,18.25924,1561
28528,217718,0E129C09250C0D46273B4BD7E5225556,30151,21,23,2,109.50986,18.25083,1560
28533,217754,3F80F6C7ECC59E36D89C8EF1746C8724,39053,2,10,8,109.511,18.2771,1564
28534,217755,3F80F6C7ECC59E36D89C8EF1746C8724,60291,12,13,1,109.50826,18.24639,1509
28535,217756,3F80F6C7ECC59E36D89C8EF1746C8724,30191,13,14,1,109.50361,18.22701,1506
28536,217757,3F80F6C7ECC59E36D89C8EF1746C8724,38891,19,20,1,109.51486,18.24118,1558
28537,217768,5D4E252AC551D7DB97A6F7C764F981F2,31351,0,7,7,109.4959,18.28417,1465
28538,217769,5D4E252AC551D7DB97A6F7C764F981F2,60331,12,13,1,109.505,18.26507,1512
28539,217770,5D4E252AC551D7DB97A6F7C764F981F2,38127,16,17,1,109.50833,18.27222,1513
28540,217771,5D4E252AC551D7DB97A6F7C764F981F2,31351,20,23,3,109.4959,18.28417,1465
28541,217776,C709D01469E0800AF998DFAF42105CDC,30854,1,2,1,109.56889,18.27076,1763
28542,217777,C709D01469E0800AF998DFAF42105CDC,31561,7,16,9,109.56792,18.28479,1765
28543,217778,C709D01469E0800AF998DFAF42105CDC,30854,18,22,4,109.56889,18.27076,1763
28550,217831,3160CBE2F0CDCB610575CDC881D9968C,38297,0,14,14,109.52576,18.24965,1609
28551,217832,3160CBE2F0CDCB610575CDC881D9968C,38185,17,18,1,109.51333,18.27347,1563
28552,217833,3160CBE2F0CDCB610575CDC881D9968C,30861,18,20,2,109.52722,18.22743,1606
28553,217834,3160CBE2F0CDCB610575CDC881D9968C,38297,22,23,1,109.52576,18.24965,1609
28558,217892,DDE77D3A656666992FC3458B84010D43,39183,0,4,4,109.55542,18.28208,1715
28559,217893,DDE77D3A656666992FC3458B84010D43,31561,7,8,1,109.56792,18.28479,1765
28560,217894,DDE77D3A656666992FC3458B84010D43,39183,9,13,4,109.55542,18.28208,1715
28583,218098,D39D64452E6BBEF7B3056CA239E1B86E,30854,0,6,6,109.56889,18.27076,1763
28584,218099,D39D64452E6BBEF7B3056CA239E1B86E,31561,6,8,2,109.56792,18.28479,1765
28585,218100,D39D64452E6BBEF7B3056CA239E1B86E,30854,9,17,8,109.56889,18.27076,1763
28598,218190,6E55CCA79B55B824AD4C2A947EDB25E3,38361,0,10,10,109.43667,18.29201,1267
28599,218191,6E55CCA79B55B824AD4C2A947EDB25E3,31471,11,12,1,109.34583,18.29563,917
28600,218192,6E55CCA79B55B824AD4C2A947EDB25E3,38361,16,23,7,109.43667,18.29201,1267
28601,218196,34AB502A442AA8EA4A7FB30471B204DB,30171,0,6,6,109.48458,18.27139,1463
28602,218197,34AB502A442AA8EA4A7FB30471B204DB,60401,8,19,11,109.47444,18.27583,1414
28603,218198,34AB502A442AA8EA4A7FB30471B204DB,60621,19,23,4,109.48354,18.27451,1464
28604,218212,0502EBC4DE012139F0DB860901E25767,38361,0,9,9,109.43667,18.29201,1267
28605,218213,0502EBC4DE012139F0DB860901E25767,31471,10,14,4,109.34583,18.29563,917
28606,218214,0502EBC4DE012139F0DB860901E25767,38361,16,23,7,109.43667,18.29201,1267
28609,218250,CD576F1C1CDFB89E6A99A20E65927346,30854,5,6,1,109.56889,18.27076,1763
28610,218251,CD576F1C1CDFB89E6A99A20E65927346,31561,7,10,3,109.56792,18.28479,1765
28611,218252,CD576F1C1CDFB89E6A99A20E65927346,30854,12,15,3,109.56889,18.27076,1763
28612,218253,CD576F1C1CDFB89E6A99A20E65927346,31561,16,18,2,109.56792,18.28479,1765
28618,218340,63FBAC0202144B00077561285E6A7F87,30821,0,7,7,109.43681,18.33639,1274
28619,218341,63FBAC0202144B00077561285E6A7F87,30651,8,9,1,109.42611,18.385,1232
28620,218342,63FBAC0202144B00077561285E6A7F87,30821,9,22,13,109.43681,18.33639,1274
28621,218382,225EDE82328108AFB3E7EE610CA3F074,60371,0,5,5,109.53063,18.30056,1618
28622,218383,225EDE82328108AFB3E7EE610CA3F074,31931,7,9,2,109.54771,18.29403,1667
28623,218384,225EDE82328108AFB3E7EE610CA3F074,60371,11,12,1,109.53063,18.30056,1618
28624,218431,89362A3CA3AE6F5B75871F2110924F99,30851,0,6,6,109.5616,18.27396,1713
28625,218432,89362A3CA3AE6F5B75871F2110924F99,30951,10,13,3,109.56208,18.25667,1761
28626,218433,89362A3CA3AE6F5B75871F2110924F99,39371,14,16,2,109.56627,18.2646,1762
28627,218434,89362A3CA3AE6F5B75871F2110924F99,30851,18,23,5,109.5616,18.27396,1713
28637,218483,09605A95AE7BE30FC92DC699DB3FCBD0,30711,0,9,9,109.50271,18.25347,1510
28638,218484,09605A95AE7BE30FC92DC699DB3FCBD0,31171,9,10,1,109.50938,18.24917,1559
28639,218485,09605A95AE7BE30FC92DC699DB3FCBD0,31461,10,12,2,109.5091,18.25389,1510
28640,218486,09605A95AE7BE30FC92DC699DB3FCBD0,30711,12,13,1,109.50271,18.25347,1510
28647,218578,182D5101D28D51096306D4EF5FDD4501,60084,0,1,1,109.4984,18.2334,1507
28648,218579,182D5101D28D51096306D4EF5FDD4501,30271,1,5,4,109.49132,18.23153,1456
28649,218581,182D5101D28D51096306D4EF5FDD4501,30271,20,21,1,109.49132,18.23153,1456
28657,218675,30F5D42A1A8F1CF26F5C9617FCB06C4F,39181,0,5,5,109.55153,18.28035,1715
28658,218676,30F5D42A1A8F1CF26F5C9617FCB06C4F,31561,8,9,1,109.56792,18.28479,1765
28659,218677,30F5D42A1A8F1CF26F5C9617FCB06C4F,39181,13,16,3,109.55153,18.28035,1715
28660,218678,30F5D42A1A8F1CF26F5C9617FCB06C4F,31561,20,23,3,109.56792,18.28479,1765
28664,218837,97C31877CA4226D0F1BA1C0E12066B56,30251,0,6,6,109.50611,18.26653,1512
28665,218838,97C31877CA4226D0F1BA1C0E12066B56,30854,7,14,7,109.56889,18.27076,1763
28666,218839,97C31877CA4226D0F1BA1C0E12066B56,30251,18,20,2,109.50611,18.26653,1512
28667,218840,97C31877CA4226D0F1BA1C0E12066B56,60331,21,23,2,109.505,18.26507,1512
28686,218964,A551EAA1DE74C03D4B9F4BD7AE33BA27,39183,0,6,6,109.55542,18.28208,1715
28687,218965,A551EAA1DE74C03D4B9F4BD7AE33BA27,60631,7,8,1,109.57778,18.27583,1814
28688,218966,A551EAA1DE74C03D4B9F4BD7AE33BA27,30854,8,17,9,109.56889,18.27076,1763
28707,219087,66B36EAB2804138C84FF096B3B06E748,30421,0,1,1,109.50021,18.25861,1511
28708,219088,66B36EAB2804138C84FF096B3B06E748,38881,3,5,2,109.51618,18.26431,1562
28709,219089,66B36EAB2804138C84FF096B3B06E748,30421,7,15,8,109.50021,18.25861,1511
28722,219177,2C5F898948A2B7909519666936FBF333,38707,0,6,6,109.73778,18.35368,2427
28723,219178,2C5F898948A2B7909519666936FBF333,38707,8,13,5,109.73778,18.35368,2427
28724,219179,2C5F898948A2B7909519666936FBF333,38707,15,23,8,109.73778,18.35368,2427
28751,219329,E2A4A2ABBE2AAFDE32C6FA06BCCC268D,31071,0,4,4,109.58257,18.28458,1815
28752,219330,E2A4A2ABBE2AAFDE32C6FA06BCCC268D,30854,8,9,1,109.56889,18.27076,1763
28753,219331,E2A4A2ABBE2AAFDE32C6FA06BCCC268D,31071,9,23,14,109.58257,18.28458,1815
28759,219337,417408FFDA93B177641D270D3A5C4B2D,31071,0,6,6,109.58257,18.28458,1815
28760,219338,417408FFDA93B177641D270D3A5C4B2D,30854,6,17,11,109.56889,18.27076,1763
28761,219339,417408FFDA93B177641D270D3A5C4B2D,31071,20,22,2,109.58257,18.28458,1815
28766,219413,84633D8BA654ABD696C26ED03FF61CB6,30084,0,8,8,109.50118,18.26972,1513
28767,219414,84633D8BA654ABD696C26ED03FF61CB6,31531,8,14,6,109.49583,18.25972,1461
28768,219416,84633D8BA654ABD696C26ED03FF61CB6,30084,21,23,2,109.50118,18.26972,1513
28772,219435,4C70C56742FCE6C02E7446B5A71E4F50,30854,0,5,5,109.56889,18.27076,1763
28773,219436,4C70C56742FCE6C02E7446B5A71E4F50,60354,10,14,4,109.58701,18.28521,1815
28774,219437,4C70C56742FCE6C02E7446B5A71E4F50,30854,14,20,6,109.56889,18.27076,1763
28775,219438,4C70C56742FCE6C02E7446B5A71E4F50,31071,21,23,2,109.58257,18.28458,1815
28792,219529,147470AD3D3B8724582C30D5F244A8B6,60421,0,8,8,109.46333,18.31743,1371
28793,219530,147470AD3D3B8724582C30D5F244A8B6,30111,9,11,2,109.47583,18.30542,1419
28794,219531,147470AD3D3B8724582C30D5F244A8B6,60421,12,23,11,109.46333,18.31743,1371
28795,219564,B0D9C7F7AA90828414D1A7F1933C372F,60631,0,10,10,109.57778,18.27583,1814
28796,219565,B0D9C7F7AA90828414D1A7F1933C372F,31561,15,17,2,109.56792,18.28479,1765
28797,219566,B0D9C7F7AA90828414D1A7F1933C372F,60631,20,23,3,109.57778,18.27583,1814
28798,219573,D6B14C7387647D8C883334DAFB518257,30854,0,7,7,109.56889,18.27076,1763
28799,219574,D6B14C7387647D8C883334DAFB518257,31561,7,10,3,109.56792,18.28479,1765
28800,219575,D6B14C7387647D8C883334DAFB518257,30854,13,22,9,109.56889,18.27076,1763
28809,219651,BC2EDF4DF9C7FAD55BDEABA03DFA7284,31561,0,5,5,109.56792,18.28479,1765
28810,219652,BC2EDF4DF9C7FAD55BDEABA03DFA7284,39183,6,8,2,109.55542,18.28208,1715
28811,219653,BC2EDF4DF9C7FAD55BDEABA03DFA7284,30854,9,11,2,109.56889,18.27076,1763
28812,219654,BC2EDF4DF9C7FAD55BDEABA03DFA7284,39183,16,18,2,109.55542,18.28208,1715
28815,219681,1582BEC240072EC51899932D6A0A257A,30891,1,8,7,109.59431,18.28389,1865
28816,219682,1582BEC240072EC51899932D6A0A257A,30854,9,12,3,109.56889,18.27076,1763
28817,219683,1582BEC240072EC51899932D6A0A257A,30891,15,21,6,109.59431,18.28389,1865
28835,219920,06FCF67485A2B44C8ABC96FDB92547C5,61011,0,8,8,109.60653,18.19076,1900
28836,219922,06FCF67485A2B44C8ABC96FDB92547C5,61011,12,15,3,109.60653,18.19076,1900
28837,219924,06FCF67485A2B44C8ABC96FDB92547C5,61011,18,23,5,109.60653,18.19076,1900
28842,219963,6040C1D616FEA927996002EE01FC4BDC,31071,0,7,7,109.58257,18.28458,1815
28843,219964,6040C1D616FEA927996002EE01FC4BDC,30854,8,9,1,109.56889,18.27076,1763
28844,219965,6040C1D616FEA927996002EE01FC4BDC,31071,10,23,13,109.58257,18.28458,1815
28848,219999,434A797657732D96E867632E246AC267,60381,0,15,15,109.5241,18.22458,1605
28849,220000,434A797657732D96E867632E246AC267,31421,15,16,1,109.55382,18.22347,1705
28850,220001,434A797657732D96E867632E246AC267,60381,17,23,6,109.5241,18.22458,1605
28856,220096,37B1280251A3C52411E939549A58D078,39183,0,13,13,109.55542,18.28208,1715
28857,220097,37B1280251A3C52411E939549A58D078,31561,16,17,1,109.56792,18.28479,1765
28858,220098,37B1280251A3C52411E939549A58D078,39183,17,23,6,109.55542,18.28208,1715
28883,220283,4D944399BAAD1AD37CC1D68A51FA53FD,30161,0,6,6,109.50042,18.24389,1508
28884,220284,4D944399BAAD1AD37CC1D68A51FA53FD,31021,9,10,1,109.49021,18.27,1463
28885,220285,4D944399BAAD1AD37CC1D68A51FA53FD,30161,11,23,12,109.50042,18.24389,1508
28921,220581,AB23564C2A438938AB9FCEB6A1EF8561,30121,0,8,8,109.52861,18.27222,1613
28922,220582,AB23564C2A438938AB9FCEB6A1EF8561,30771,9,11,2,109.49938,18.26042,1511
28923,220583,AB23564C2A438938AB9FCEB6A1EF8561,30121,12,18,6,109.52861,18.27222,1613
28924,220584,AB23564C2A438938AB9FCEB6A1EF8561,30771,18,22,4,109.49938,18.26042,1511
28961,220899,B81DEDE33B0853E35D97557F334A4861,60361,0,6,6,109.51938,18.29681,1567
28962,220900,B81DEDE33B0853E35D97557F334A4861,31931,6,11,5,109.54771,18.29403,1667
28963,220901,B81DEDE33B0853E35D97557F334A4861,60371,14,18,4,109.53063,18.30056,1618
28964,220902,B81DEDE33B0853E35D97557F334A4861,60361,18,23,5,109.51938,18.29681,1567
28982,221013,B17D654C0C5F0BF2FDFE2DB8B9C0B83F,31206,0,2,2,109.50819,18.23549,1507
28983,221014,B17D654C0C5F0BF2FDFE2DB8B9C0B83F,60084,3,4,1,109.4984,18.2334,1507
28984,221015,B17D654C0C5F0BF2FDFE2DB8B9C0B83F,30771,5,12,7,109.49938,18.26042,1511
28985,221016,B17D654C0C5F0BF2FDFE2DB8B9C0B83F,31551,16,20,4,109.55868,18.24222,1708
29010,221167,D334753E33AD01D79142036B3D85543F,31561,0,5,5,109.56792,18.28479,1765
29011,221168,D334753E33AD01D79142036B3D85543F,39183,6,8,2,109.55542,18.28208,1715
29012,221169,D334753E33AD01D79142036B3D85543F,31561,12,23,11,109.56792,18.28479,1765
29013,221170,00145806BBF2F60A963743509F901155,60331,0,15,15,109.505,18.26507,1512
29014,221171,00145806BBF2F60A963743509F901155,30291,16,19,3,109.50403,18.27028,1513
29015,221172,00145806BBF2F60A963743509F901155,60331,20,23,3,109.505,18.26507,1512
29016,221187,FF9BA552E9DDFB17524AA333EB7B78B5,31931,0,9,9,109.54771,18.29403,1667
29017,221188,FF9BA552E9DDFB17524AA333EB7B78B5,60371,13,16,3,109.53063,18.30056,1618
29018,221189,FF9BA552E9DDFB17524AA333EB7B78B5,31931,17,19,2,109.54771,18.29403,1667
29019,221192,47A18820FDA9856131F74091D44B6BCB,31561,0,6,6,109.56792,18.28479,1765
29020,221193,47A18820FDA9856131F74091D44B6BCB,30851,10,11,1,109.5616,18.27396,1713
29021,221194,47A18820FDA9856131F74091D44B6BCB,31561,12,22,10,109.56792,18.28479,1765
29045,221349,84DF4A7C208235D171EF56473BCCF210,30851,0,4,4,109.5616,18.27396,1713
29046,221350,84DF4A7C208235D171EF56473BCCF210,31561,4,7,3,109.56792,18.28479,1765
29047,221351,84DF4A7C208235D171EF56473BCCF210,60631,8,18,10,109.57778,18.27583,1814
29063,221393,A94F66C88B84FF0658441320CD9F667C,60631,0,6,6,109.57778,18.27583,1814
29064,221394,A94F66C88B84FF0658441320CD9F667C,30854,7,12,5,109.56889,18.27076,1763
29065,221395,A94F66C88B84FF0658441320CD9F667C,31071,14,15,1,109.58257,18.28458,1815
29066,221396,A94F66C88B84FF0658441320CD9F667C,30854,18,19,1,109.56889,18.27076,1763
29067,221416,7024F3A14F6F554DC6E80063E30315F0,31561,0,5,5,109.56792,18.28479,1765
29068,221417,7024F3A14F6F554DC6E80063E30315F0,39183,8,16,8,109.55542,18.28208,1715
29069,221418,7024F3A14F6F554DC6E80063E30315F0,31561,18,19,1,109.56792,18.28479,1765
29074,221503,567BF1868FBA42FA9B3B29F2CA13F65D,60361,0,3,3,109.51938,18.29681,1567
29075,221504,567BF1868FBA42FA9B3B29F2CA13F65D,31931,5,6,1,109.54771,18.29403,1667
29076,221505,567BF1868FBA42FA9B3B29F2CA13F65D,30921,6,16,10,109.53903,18.29451,1667
29077,221506,567BF1868FBA42FA9B3B29F2CA13F65D,31931,17,22,5,109.54771,18.29403,1667
29078,221522,F00821368F615DCDAF214035D8EC4A44,31761,1,3,2,109.60521,18.27965,1914
29079,221523,F00821368F615DCDAF214035D8EC4A44,31071,4,12,8,109.58257,18.28458,1815
29080,221524,F00821368F615DCDAF214035D8EC4A44,30854,14,19,5,109.56889,18.27076,1763
29081,221545,934029FB5F97BCE114EDCE88F0393A63,31071,0,5,5,109.58257,18.28458,1815
29082,221546,934029FB5F97BCE114EDCE88F0393A63,30854,8,20,12,109.56889,18.27076,1763
29083,221547,934029FB5F97BCE114EDCE88F0393A63,39371,20,23,3,109.56627,18.2646,1762
29086,221567,335A7B1DE8538918FDA774EE3E402A76,30191,0,7,7,109.50361,18.22701,1506
29087,221568,335A7B1DE8538918FDA774EE3E402A76,31521,9,13,4,109.51458,18.22542,1555
29088,221569,335A7B1DE8538918FDA774EE3E402A76,30191,14,23,9,109.50361,18.22701,1506
29090,221587,D5B91D126489D960AE97CC8A6C1B036B,39331,2,4,2,109.62125,18.22708,1956
29091,221588,D5B91D126489D960AE97CC8A6C1B036B,31571,6,9,3,109.61563,18.23326,1957
29092,221589,D5B91D126489D960AE97CC8A6C1B036B,30441,10,15,5,109.64021,18.25424,2010
29093,221590,D5B91D126489D960AE97CC8A6C1B036B,31571,15,21,6,109.61563,18.23326,1957
29098,221641,68D5553872A94DDAC491FB747742F965,30854,0,7,7,109.56889,18.27076,1763
29099,221642,68D5553872A94DDAC491FB747742F965,30851,8,9,1,109.5616,18.27396,1713
29100,221644,68D5553872A94DDAC491FB747742F965,30854,17,22,5,109.56889,18.27076,1763
29112,221706,6E2021B014C4D0B652A2E4FE8D2CF038,31071,0,9,9,109.58257,18.28458,1815
29113,221707,6E2021B014C4D0B652A2E4FE8D2CF038,30854,9,16,7,109.56889,18.27076,1763
29114,221708,6E2021B014C4D0B652A2E4FE8D2CF038,31071,21,23,2,109.58257,18.28458,1815
29119,221774,AA17AFDA929E42B241ADF1BFA6E7435E,31206,1,3,2,109.50819,18.23549,1507
29120,221775,AA17AFDA929E42B241ADF1BFA6E7435E,39191,6,7,1,109.51493,18.23472,1557
29121,221776,AA17AFDA929E42B241ADF1BFA6E7435E,31201,7,22,15,109.51042,18.23819,1558
29122,221780,B1CCD68E3CC8A7232EF2DE7E986C4789,30681,0,11,11,109.48493,18.26917,1463
29123,221781,B1CCD68E3CC8A7232EF2DE7E986C4789,38094,11,13,2,109.45403,18.28778,1316
29124,221782,B1CCD68E3CC8A7232EF2DE7E986C4789,30681,15,23,8,109.48493,18.26917,1463
29141,221948,CCCD2290FB632A48009771412BE68ADD,31561,0,9,9,109.56792,18.28479,1765
29142,221949,CCCD2290FB632A48009771412BE68ADD,39183,9,11,2,109.55542,18.28208,1715
29143,221950,CCCD2290FB632A48009771412BE68ADD,31561,11,15,4,109.56792,18.28479,1765
29144,221951,CCCD2290FB632A48009771412BE68ADD,39183,15,17,2,109.55542,18.28208,1715
29154,221987,6300414882932A98E73E91790947DC62,60281,0,9,9,109.51743,18.25924,1561
29155,221988,6300414882932A98E73E91790947DC62,38291,9,12,3,109.51618,18.24313,1558
29156,221989,6300414882932A98E73E91790947DC62,60281,13,22,9,109.51743,18.25924,1561
29184,222142,020753EF78F0A0C39658113A3377EA1E,31561,0,7,7,109.56792,18.28479,1765
29185,222143,020753EF78F0A0C39658113A3377EA1E,39183,10,11,1,109.55542,18.28208,1715
29186,222144,020753EF78F0A0C39658113A3377EA1E,31561,12,22,10,109.56792,18.28479,1765
29187,222151,3971E288F0FB50DDE06A11C534E966DA,31561,2,7,5,109.56792,18.28479,1765
29188,222152,3971E288F0FB50DDE06A11C534E966DA,30891,12,13,1,109.59431,18.28389,1865
29189,222153,3971E288F0FB50DDE06A11C534E966DA,31071,14,20,6,109.58257,18.28458,1815
29190,222159,1FE34463C604482338E93206E38E7B82,39151,1,7,6,109.49875,18.25097,1510
29191,222160,1FE34463C604482338E93206E38E7B82,60161,8,14,6,109.49174,18.26181,1461
29192,222161,1FE34463C604482338E93206E38E7B82,30361,18,21,3,109.50347,18.24,1508
29207,222302,DA42D442B42F4821B174308450A49075,38361,0,8,8,109.43667,18.29201,1267
29208,222303,DA42D442B42F4821B174308450A49075,31471,12,14,2,109.34583,18.29563,917
29209,222304,DA42D442B42F4821B174308450A49075,38361,16,23,7,109.43667,18.29201,1267
29222,222365,5D56123A0C68AD72DA20EA4585A51B48,60381,0,8,8,109.5241,18.22458,1605
29223,222366,5D56123A0C68AD72DA20EA4585A51B48,60641,9,16,7,109.53854,18.2359,1657
29224,222367,5D56123A0C68AD72DA20EA4585A51B48,30861,16,18,2,109.52722,18.22743,1606
29225,222371,D9AE11CD16B231308C3F0FB3F53BC3E9,31071,1,6,5,109.58257,18.28458,1815
29226,222372,D9AE11CD16B231308C3F0FB3F53BC3E9,30854,10,12,2,109.56889,18.27076,1763
29227,222373,D9AE11CD16B231308C3F0FB3F53BC3E9,31071,13,18,5,109.58257,18.28458,1815
29231,222441,8B9A9BFD1ACAD480EB101A91DBF2024D,38291,1,8,7,109.51618,18.24313,1558
29232,222442,8B9A9BFD1ACAD480EB101A91DBF2024D,38911,8,11,3,109.51674,18.24965,1559
29233,222443,8B9A9BFD1ACAD480EB101A91DBF2024D,38291,12,23,11,109.51618,18.24313,1558
29242,222475,F3EA4B3DF8A619A30272A53ECD9E968F,30251,0,7,7,109.50611,18.26653,1512
29243,222476,F3EA4B3DF8A619A30272A53ECD9E968F,38157,11,13,2,109.51483,18.26958,1563
29244,222477,F3EA4B3DF8A619A30272A53ECD9E968F,30251,13,15,2,109.50611,18.26653,1512
29245,222483,750172FB82300DA02225CC4F7256EE00,30381,0,6,6,109.52521,18.24507,1609
29246,222484,750172FB82300DA02225CC4F7256EE00,39183,6,14,8,109.55542,18.28208,1715
29247,222485,750172FB82300DA02225CC4F7256EE00,31561,14,15,1,109.56792,18.28479,1765
29248,222486,750172FB82300DA02225CC4F7256EE00,30381,19,23,4,109.52521,18.24507,1609
29249,222541,8752BC71725B50257436D50C6598F252,31071,0,7,7,109.58257,18.28458,1815
29250,222542,8752BC71725B50257436D50C6598F252,30854,9,11,2,109.56889,18.27076,1763
29251,222543,8752BC71725B50257436D50C6598F252,31071,11,13,2,109.58257,18.28458,1815
29252,222544,8752BC71725B50257436D50C6598F252,30854,15,22,7,109.56889,18.27076,1763
29255,222632,4400F433FA6469B70604006808D90C30,30731,0,5,5,109.50944,18.22306,1555
29256,222633,4400F433FA6469B70604006808D90C30,31421,6,12,6,109.55382,18.22347,1705
29257,222634,4400F433FA6469B70604006808D90C30,60381,14,15,1,109.5241,18.22458,1605
29258,222635,4400F433FA6469B70604006808D90C30,31421,15,23,8,109.55382,18.22347,1705
29259,222636,815B1E622D05FD49F310F3AFE15701D1,60661,0,8,8,109.548,18.2377,1657
29260,222637,815B1E622D05FD49F310F3AFE15701D1,60463,8,15,7,109.52507,18.22438,1605
29261,222638,815B1E622D05FD49F310F3AFE15701D1,30854,18,22,4,109.56889,18.27076,1763
29267,222698,D4AA3869830031578B573FD0033C24A8,31931,0,8,8,109.54771,18.29403,1667
29268,222699,D4AA3869830031578B573FD0033C24A8,60371,12,18,6,109.53063,18.30056,1618
29269,222700,D4AA3869830031578B573FD0033C24A8,31931,18,22,4,109.54771,18.29403,1667
29294,222852,3C1A2536A78CF30193CED5E3EEACBE7E,30851,0,6,6,109.5616,18.27396,1713
29295,222853,3C1A2536A78CF30193CED5E3EEACBE7E,30854,7,8,1,109.56889,18.27076,1763
29296,222854,3C1A2536A78CF30193CED5E3EEACBE7E,31561,8,9,1,109.56792,18.28479,1765
29310,223055,84599FEEE94509A3E8D44F4C45C7CC01,31671,0,7,7,109.38965,18.29813,1068
29311,223056,84599FEEE94509A3E8D44F4C45C7CC01,30764,8,9,1,109.45806,18.29486,1367
29312,223057,84599FEEE94509A3E8D44F4C45C7CC01,31671,12,22,10,109.38965,18.29813,1068
29313,223062,9E8746086915F9D4A063A74CF0B5B7AB,30851,0,5,5,109.5616,18.27396,1713
29314,223063,9E8746086915F9D4A063A74CF0B5B7AB,39183,9,11,2,109.55542,18.28208,1715
29315,223064,9E8746086915F9D4A063A74CF0B5B7AB,31561,12,13,1,109.56792,18.28479,1765
29316,223074,C8922FAF66F21ECAECB6B717FCD5A53B,60614,0,15,15,109.48799,18.29521,1467
29317,223075,C8922FAF66F21ECAECB6B717FCD5A53B,60391,16,17,1,109.47667,18.28757,1416
29318,223076,C8922FAF66F21ECAECB6B717FCD5A53B,60614,17,20,3,109.48799,18.29521,1467
29331,223215,123358A15833F823249D8A62EDE35161,31461,0,1,1,109.5091,18.25389,1510
29332,223216,123358A15833F823249D8A62EDE35161,39091,1,3,2,109.50097,18.25222,1510
29333,223217,123358A15833F823249D8A62EDE35161,30711,5,7,2,109.50271,18.25347,1510
29334,223218,123358A15833F823249D8A62EDE35161,31461,9,11,2,109.5091,18.25389,1510
29346,223336,D46DE9169E4BACF1D272EA5E0FDEF68F,31561,0,13,13,109.56792,18.28479,1765
29347,223337,D46DE9169E4BACF1D272EA5E0FDEF68F,30854,14,16,2,109.56889,18.27076,1763
29348,223338,D46DE9169E4BACF1D272EA5E0FDEF68F,31561,18,19,1,109.56792,18.28479,1765
29351,223379,39F25FE146A03325C93C111F2A943B6C,31945,0,13,13,109.58021,18.29403,1817
29352,223380,39F25FE146A03325C93C111F2A943B6C,30854,13,15,2,109.56889,18.27076,1763
29353,223381,39F25FE146A03325C93C111F2A943B6C,31071,17,19,2,109.58257,18.28458,1815
29354,223382,39F25FE146A03325C93C111F2A943B6C,30854,19,20,1,109.56889,18.27076,1763
29355,223383,58418A9EA4A7DC03127CB79C039A5185,60354,0,8,8,109.58701,18.28521,1815
29356,223384,58418A9EA4A7DC03127CB79C039A5185,30854,10,18,8,109.56889,18.27076,1763
29357,223385,58418A9EA4A7DC03127CB79C039A5185,60354,19,23,4,109.58701,18.28521,1815
29358,223454,AB8F95D841F69DCC3177A6274025E5E6,39183,0,14,14,109.55542,18.28208,1715
29359,223455,AB8F95D841F69DCC3177A6274025E5E6,31561,15,16,1,109.56792,18.28479,1765
29360,223456,AB8F95D841F69DCC3177A6274025E5E6,39183,16,23,7,109.55542,18.28208,1715
29380,223734,622234A65D292D040A9E438A2770674C,30851,0,6,6,109.5616,18.27396,1713
29381,223735,622234A65D292D040A9E438A2770674C,31561,8,10,2,109.56792,18.28479,1765
29382,223736,622234A65D292D040A9E438A2770674C,30851,10,14,4,109.5616,18.27396,1713
29383,223737,E99D6570F853F6293054C74E1A290524,60354,1,7,6,109.58701,18.28521,1815
29384,223738,E99D6570F853F6293054C74E1A290524,30854,7,10,3,109.56889,18.27076,1763
29385,223739,E99D6570F853F6293054C74E1A290524,60354,13,15,2,109.58701,18.28521,1815
29386,223740,E99D6570F853F6293054C74E1A290524,30854,18,21,3,109.56889,18.27076,1763
29416,224145,5121CF17D14D2AAD91DBD81D7766DFCC,38052,0,10,10,109.62618,18.23042,1956
29417,224146,5121CF17D14D2AAD91DBD81D7766DFCC,31521,12,13,1,109.51458,18.22542,1555
29418,224147,5121CF17D14D2AAD91DBD81D7766DFCC,31521,14,20,6,109.51458,18.22542,1555
29419,224148,5121CF17D14D2AAD91DBD81D7766DFCC,30731,22,23,1,109.50944,18.22306,1555
29450,224412,4053323049FA57896819CD5356E38746,31071,1,6,5,109.58257,18.28458,1815
29451,224413,4053323049FA57896819CD5356E38746,30681,10,11,1,109.48493,18.26917,1463
29452,224414,4053323049FA57896819CD5356E38746,30854,12,22,10,109.56889,18.27076,1763
29466,224513,8F6EA1C108FADA76A214A7ED71ECE3D1,30891,1,6,5,109.59431,18.28389,1865
29467,224514,8F6EA1C108FADA76A214A7ED71ECE3D1,30854,10,15,5,109.56889,18.27076,1763
29468,224515,8F6EA1C108FADA76A214A7ED71ECE3D1,39183,17,19,2,109.55542,18.28208,1715
29489,224683,FE95B3A32EFBC2838F293DF38F55FDD1,39183,1,5,4,109.55542,18.28208,1715
29490,224684,FE95B3A32EFBC2838F293DF38F55FDD1,31561,7,17,10,109.56792,18.28479,1765
29491,224685,FE95B3A32EFBC2838F293DF38F55FDD1,39181,21,23,2,109.55153,18.28035,1715
29504,224802,64FF3E93355E6DCA29977E04D316EABA,38973,0,9,9,109.51097,18.25389,1560
29505,224803,64FF3E93355E6DCA29977E04D316EABA,30151,13,14,1,109.50986,18.25083,1560
29506,224804,64FF3E93355E6DCA29977E04D316EABA,30151,16,18,2,109.50986,18.25083,1560
29507,224809,9A1D1AA5EE2CD156CC396C667ED8C5B9,31071,0,1,1,109.58257,18.28458,1815
29508,224810,9A1D1AA5EE2CD156CC396C667ED8C5B9,30854,1,10,9,109.56889,18.27076,1763
29509,224811,9A1D1AA5EE2CD156CC396C667ED8C5B9,31071,13,14,1,109.58257,18.28458,1815
29527,224934,267109764004253FF1AD548611BE6E82,39371,0,6,6,109.56627,18.2646,1762
29528,224935,267109764004253FF1AD548611BE6E82,30891,8,10,2,109.59431,18.28389,1865
29529,224936,267109764004253FF1AD548611BE6E82,39183,10,11,1,109.55542,18.28208,1715
29542,225115,1B6EBBFF3B9D8A3E18753343B6A29EAE,31071,3,14,11,109.58257,18.28458,1815
29543,225116,1B6EBBFF3B9D8A3E18753343B6A29EAE,30851,15,16,1,109.5616,18.27396,1713
29544,225117,1B6EBBFF3B9D8A3E18753343B6A29EAE,31071,19,23,4,109.58257,18.28458,1815
29548,225144,45D6FEED987FF96C23D5532C0D645AC3,30281,0,13,13,109.50597,18.27583,1514
29549,225145,45D6FEED987FF96C23D5532C0D645AC3,30854,14,17,3,109.56889,18.27076,1763
29550,225146,45D6FEED987FF96C23D5532C0D645AC3,30151,19,20,1,109.50986,18.25083,1560
29564,225244,4E9700B026D20ABF45FFBA72DED9D886,38951,1,15,14,109.48097,18.28868,1416
29565,225245,4E9700B026D20ABF45FFBA72DED9D886,38951,16,18,2,109.48097,18.28868,1416
29566,225246,4E9700B026D20ABF45FFBA72DED9D886,60621,19,20,1,109.48354,18.27451,1464
29567,225247,4E9700B026D20ABF45FFBA72DED9D886,38951,22,23,1,109.48097,18.28868,1416
29592,225371,2CF83F5125C6075E2ACA9C17C2979C64,31071,0,5,5,109.58257,18.28458,1815
29593,225372,2CF83F5125C6075E2ACA9C17C2979C64,30854,9,18,9,109.56889,18.27076,1763
29594,225373,2CF83F5125C6075E2ACA9C17C2979C64,31071,18,22,4,109.58257,18.28458,1815
29599,225451,15195C578D4A8081B069C4B518039EFC,60084,3,5,2,109.4984,18.2334,1507
29600,225452,15195C578D4A8081B069C4B518039EFC,60161,6,11,5,109.49174,18.26181,1461
29601,225453,15195C578D4A8081B069C4B518039EFC,60231,12,13,1,109.49903,18.21972,1504
29602,225454,15195C578D4A8081B069C4B518039EFC,30051,16,17,1,109.48917,18.21215,1453
29631,225703,D4EE8E1A4C04A1FF0596E4221D0B8B42,31071,0,8,8,109.58257,18.28458,1815
29632,225704,D4EE8E1A4C04A1FF0596E4221D0B8B42,30854,9,21,12,109.56889,18.27076,1763
29633,225705,D4EE8E1A4C04A1FF0596E4221D0B8B42,31071,21,23,2,109.58257,18.28458,1815
29639,225747,8CF08DEE8EF83AC7333B837D79034776,38251,0,3,3,109.49618,18.25493,1510
29640,225748,8CF08DEE8EF83AC7333B837D79034776,31531,3,5,2,109.49583,18.25972,1461
29641,225749,8CF08DEE8EF83AC7333B837D79034776,38251,6,8,2,109.49618,18.25493,1510
29656,225808,7A214C2AB4CE0E87DF8DB230B9F95561,30101,0,6,6,109.57299,18.33333,1773
29657,225809,7A214C2AB4CE0E87DF8DB230B9F95561,31631,8,9,1,109.59542,18.36826,1879
29658,225810,7A214C2AB4CE0E87DF8DB230B9F95561,30101,11,23,12,109.57299,18.33333,1773
29661,225821,A9F97D2464709590426A157138F3C687,31931,0,7,7,109.54771,18.29403,1667
29662,225822,A9F97D2464709590426A157138F3C687,39181,10,17,7,109.55153,18.28035,1715
29663,225823,A9F97D2464709590426A157138F3C687,31931,21,23,2,109.54771,18.29403,1667
29685,225952,2C222853895C7F3CD32A59ECC6E42FBB,60281,0,3,3,109.51743,18.25924,1561
29686,225953,2C222853895C7F3CD32A59ECC6E42FBB,30251,3,4,1,109.50611,18.26653,1512
29687,225954,2C222853895C7F3CD32A59ECC6E42FBB,30461,5,9,4,109.5116,18.26313,1562
29688,225974,12C3A1F813E3302C96798332CE4982EC,60524,0,6,6,109.42951,18.28993,1216
29689,225975,12C3A1F813E3302C96798332CE4982EC,30351,7,8,1,109.41701,18.29292,1217
29690,225976,12C3A1F813E3302C96798332CE4982EC,60552,12,13,1,109.41729,18.30014,1218
29691,225977,12C3A1F813E3302C96798332CE4982EC,31236,14,15,1,109.42965,18.29111,1216
29692,226062,8621CFDF1B89A83351494618C53D033F,31071,0,1,1,109.58257,18.28458,1815
29693,226063,8621CFDF1B89A83351494618C53D033F,39181,2,16,14,109.55153,18.28035,1715
29694,226064,8621CFDF1B89A83351494618C53D033F,31071,16,17,1,109.58257,18.28458,1815
29695,226065,8621CFDF1B89A83351494618C53D033F,39181,17,23,6,109.55153,18.28035,1715
29708,226154,AE1D2CB811A45E9D0BA691392CEA1100,31071,0,9,9,109.58257,18.28458,1815
29709,226155,AE1D2CB811A45E9D0BA691392CEA1100,30854,10,17,7,109.56889,18.27076,1763
29710,226156,AE1D2CB811A45E9D0BA691392CEA1100,31071,19,23,4,109.58257,18.28458,1815
29735,226471,3018A59307B3FCF174C9259743A17A51,31071,0,7,7,109.58257,18.28458,1815
29736,226472,3018A59307B3FCF174C9259743A17A51,30854,9,12,3,109.56889,18.27076,1763
29737,226473,3018A59307B3FCF174C9259743A17A51,31071,12,16,4,109.58257,18.28458,1815
29738,226474,3018A59307B3FCF174C9259743A17A51,31071,20,23,3,109.58257,18.28458,1815
29739,226478,706B8E0F0F5D1C9FC2F8EBB2574EE89F,39154,0,3,3,109.50201,18.25681,1511
29740,226479,706B8E0F0F5D1C9FC2F8EBB2574EE89F,30711,4,13,9,109.50271,18.25347,1510
29741,226480,706B8E0F0F5D1C9FC2F8EBB2574EE89F,60131,13,22,9,109.49819,18.24778,1509
29747,226536,20D1C5EEC84E3CA2311E758AF8880F3B,60311,0,3,3,109.52097,18.24319,1558
29748,226537,20D1C5EEC84E3CA2311E758AF8880F3B,38911,4,7,3,109.51674,18.24965,1559
29749,226538,20D1C5EEC84E3CA2311E758AF8880F3B,60281,11,12,1,109.51743,18.25924,1561
29750,226539,20D1C5EEC84E3CA2311E758AF8880F3B,38911,13,15,2,109.51674,18.24965,1559
29751,226553,78F6F1AD59E58A4AF036125B18ED2B6C,38157,0,8,8,109.51483,18.26958,1563
29752,226554,78F6F1AD59E58A4AF036125B18ED2B6C,38121,12,14,2,109.51361,18.27813,1564
29753,226555,78F6F1AD59E58A4AF036125B18ED2B6C,31071,15,18,3,109.58257,18.28458,1815
29754,226556,78F6F1AD59E58A4AF036125B18ED2B6C,39053,20,23,3,109.511,18.2771,1564
29776,226651,0312B43ACF9ED1D8304E325E851AEE29,30851,0,14,14,109.5616,18.27396,1713
29777,226652,0312B43ACF9ED1D8304E325E851AEE29,31561,15,16,1,109.56792,18.28479,1765
29778,226653,0312B43ACF9ED1D8304E325E851AEE29,30851,19,23,4,109.5616,18.27396,1713
29785,226726,D1E9F173C78819C710E28E8ACB6462D5,31391,0,11,11,109.50382,18.24285,1508
29786,226727,D1E9F173C78819C710E28E8ACB6462D5,60201,11,13,2,109.5041,18.2509,1510
29787,226728,D1E9F173C78819C710E28E8ACB6462D5,30511,13,23,10,109.51069,18.24208,1558
29797,226875,8265A029C672FE0377EF574CC3ADF2A8,30851,0,2,2,109.5616,18.27396,1713
29798,226876,8265A029C672FE0377EF574CC3ADF2A8,31561,2,5,3,109.56792,18.28479,1765
29799,226877,8265A029C672FE0377EF574CC3ADF2A8,39183,7,17,10,109.55542,18.28208,1715
29800,226878,8265A029C672FE0377EF574CC3ADF2A8,30854,21,23,2,109.56889,18.27076,1763
29803,226936,6B806948BC9187A91D033B4096721B00,31561,0,8,8,109.56792,18.28479,1765
29804,226937,6B806948BC9187A91D033B4096721B00,31071,9,20,11,109.58257,18.28458,1815
29805,226938,6B806948BC9187A91D033B4096721B00,31561,20,22,2,109.56792,18.28479,1765
29806,226941,97E1B26BF8A5E1ECE36FFEB9F9E6544C,30681,0,6,6,109.48493,18.26917,1463
29807,226942,97E1B26BF8A5E1ECE36FFEB9F9E6544C,60401,7,9,2,109.47444,18.27583,1414
29808,226943,97E1B26BF8A5E1ECE36FFEB9F9E6544C,30681,10,12,2,109.48493,18.26917,1463
29818,227022,80BA695BEE7DAB7E0B7889A474F27816,31071,0,1,1,109.58257,18.28458,1815
29819,227023,80BA695BEE7DAB7E0B7889A474F27816,30854,4,6,2,109.56889,18.27076,1763
29820,227024,80BA695BEE7DAB7E0B7889A474F27816,31071,7,8,1,109.58257,18.28458,1815
29821,227025,E65658506C2BF9C993BA69EE6D38B3C6,31951,3,4,1,109.52174,18.30299,1568
29822,227026,E65658506C2BF9C993BA69EE6D38B3C6,60361,5,6,1,109.51938,18.29681,1567
29823,227027,E65658506C2BF9C993BA69EE6D38B3C6,31951,6,19,13,109.52174,18.30299,1568
29824,227028,E65658506C2BF9C993BA69EE6D38B3C6,31561,21,23,2,109.56792,18.28479,1765
29832,227135,C93386A9D86FE22A1FD4E5116045DD8D,31561,0,9,9,109.56792,18.28479,1765
29833,227136,C93386A9D86FE22A1FD4E5116045DD8D,39183,10,15,5,109.55542,18.28208,1715
29834,227137,C93386A9D86FE22A1FD4E5116045DD8D,31561,15,17,2,109.56792,18.28479,1765
29835,227138,C93386A9D86FE22A1FD4E5116045DD8D,30854,19,20,1,109.56889,18.27076,1763
29867,227403,7D3715670DBD868CBE84944A90E4C6E8,38027,0,6,6,109.38833,18.2909,1066
29868,227404,7D3715670DBD868CBE84944A90E4C6E8,60561,8,13,5,109.38229,18.29785,1067
29869,227405,7D3715670DBD868CBE84944A90E4C6E8,38027,13,16,3,109.38833,18.2909,1066
29870,227406,7D3715670DBD868CBE84944A90E4C6E8,30761,19,20,1,109.45201,18.3,1318
29889,227546,DDE77D3A656666992FC3458B84010D43,39183,3,4,1,109.55542,18.28208,1715
29890,227547,DDE77D3A656666992FC3458B84010D43,31561,5,21,16,109.56792,18.28479,1765
29891,227548,DDE77D3A656666992FC3458B84010D43,39183,21,22,1,109.55542,18.28208,1715
29899,227666,EAD0F857A028E27AEC5E665129C31CC4,60121,0,7,7,109.74507,18.37472,2430
29900,227667,EAD0F857A028E27AEC5E665129C31CC4,30961,9,15,6,109.74042,18.37903,2431
29901,227668,EAD0F857A028E27AEC5E665129C31CC4,60121,18,19,1,109.74507,18.37472,2430
29912,227772,D1B09D14086A317457A98E1E3E3BED6B,39181,0,6,6,109.55153,18.28035,1715
29913,227773,D1B09D14086A317457A98E1E3E3BED6B,31931,7,9,2,109.54771,18.29403,1667
29914,227774,D1B09D14086A317457A98E1E3E3BED6B,39181,11,16,5,109.55153,18.28035,1715
29915,227775,D1B09D14086A317457A98E1E3E3BED6B,30711,18,23,5,109.50271,18.25347,1510
29916,227804,E72C27EE9814EBDCED7E0237D87F0F45,60401,0,14,14,109.47444,18.27583,1414
29917,227805,E72C27EE9814EBDCED7E0237D87F0F45,31951,17,19,2,109.52174,18.30299,1568
29918,227806,E72C27EE9814EBDCED7E0237D87F0F45,60401,21,22,1,109.47444,18.27583,1414
29927,227836,4BCFB9B7DA47F954D069C9FF9050BF88,31071,0,5,5,109.58257,18.28458,1815
29928,227837,4BCFB9B7DA47F954D069C9FF9050BF88,30854,8,15,7,109.56889,18.27076,1763
29929,227838,4BCFB9B7DA47F954D069C9FF9050BF88,31071,18,21,3,109.58257,18.28458,1815
29930,227839,4BCFB9B7DA47F954D069C9FF9050BF88,30854,22,23,1,109.56889,18.27076,1763
29931,227844,6FDD8510FC3FD17D36965B0963BD7329,30854,0,5,5,109.56889,18.27076,1763
29932,227845,6FDD8510FC3FD17D36965B0963BD7329,31561,6,7,1,109.56792,18.28479,1765
29933,227846,6FDD8510FC3FD17D36965B0963BD7329,30854,9,23,14,109.56889,18.27076,1763
29936,227878,E9DC5E3F06A9FBF162477C6043E75224,30851,0,3,3,109.5616,18.27396,1713
29937,227879,E9DC5E3F06A9FBF162477C6043E75224,31071,3,6,3,109.58257,18.28458,1815
29938,227880,E9DC5E3F06A9FBF162477C6043E75224,31931,7,9,2,109.54771,18.29403,1667
29939,227888,0695D4E7B3E726CA09D841B87798B560,30854,0,14,14,109.56889,18.27076,1763
29940,227889,0695D4E7B3E726CA09D841B87798B560,31561,18,19,1,109.56792,18.28479,1765
29941,227890,0695D4E7B3E726CA09D841B87798B560,30854,22,23,1,109.56889,18.27076,1763
29945,227935,A7B3BDD8DC79485BA41EC7F220A41345,60631,0,9,9,109.57778,18.27583,1814
29946,227936,A7B3BDD8DC79485BA41EC7F220A41345,30854,10,17,7,109.56889,18.27076,1763
29947,227937,A7B3BDD8DC79485BA41EC7F220A41345,60631,19,22,3,109.57778,18.27583,1814
29953,228037,89362A3CA3AE6F5B75871F2110924F99,30851,0,7,7,109.5616,18.27396,1713
29954,228038,89362A3CA3AE6F5B75871F2110924F99,30951,11,16,5,109.56208,18.25667,1761
29955,228039,89362A3CA3AE6F5B75871F2110924F99,30851,19,23,4,109.5616,18.27396,1713
29966,228129,B78E7295CB13532B4E2C30EF158E297F,39183,2,3,1,109.55542,18.28208,1715
29967,228130,B78E7295CB13532B4E2C30EF158E297F,30851,3,6,3,109.5616,18.27396,1713
29968,228131,B78E7295CB13532B4E2C30EF158E297F,31561,10,11,1,109.56792,18.28479,1765
29969,228132,B78E7295CB13532B4E2C30EF158E297F,30854,12,14,2,109.56889,18.27076,1763
29986,228276,30F5D42A1A8F1CF26F5C9617FCB06C4F,30854,0,1,1,109.56889,18.27076,1763
29987,228277,30F5D42A1A8F1CF26F5C9617FCB06C4F,39183,2,4,2,109.55542,18.28208,1715
29988,228278,30F5D42A1A8F1CF26F5C9617FCB06C4F,31561,4,14,10,109.56792,18.28479,1765
29994,228354,491A112CD81B9085F752897809919691,60291,2,3,1,109.50826,18.24639,1509
29995,228355,491A112CD81B9085F752897809919691,31206,3,5,2,109.50819,18.23549,1507
29996,228356,491A112CD81B9085F752897809919691,60291,5,7,2,109.50826,18.24639,1509
29997,228362,DD056101D68CBFC24096E8F587CC747C,30071,0,1,1,109.52819,18.30472,1619
29998,228363,DD056101D68CBFC24096E8F587CC747C,30921,1,6,5,109.53903,18.29451,1667
29999,228364,DD056101D68CBFC24096E8F587CC747C,31931,6,22,16,109.54771,18.29403,1667
30017,228463,A749E400BFD3B5908671E939EC104DEE,30854,0,9,9,109.56889,18.27076,1763
30018,228464,A749E400BFD3B5908671E939EC104DEE,31071,10,12,2,109.58257,18.28458,1815
30019,228465,A749E400BFD3B5908671E939EC104DEE,30854,12,14,2,109.56889,18.27076,1763
30020,228466,A749E400BFD3B5908671E939EC104DEE,31071,18,20,2,109.58257,18.28458,1815
30024,228561,10EBF762D28520B09848288F7052CFDE,30854,3,6,3,109.56889,18.27076,1763
30025,228562,10EBF762D28520B09848288F7052CFDE,39101,8,17,9,109.50132,18.24931,1509
30026,228563,10EBF762D28520B09848288F7052CFDE,30854,18,23,5,109.56889,18.27076,1763
30041,228618,5E6F81A7DA23F57413C15AC7514275E5,31945,0,12,12,109.58021,18.29403,1817
30042,228619,5E6F81A7DA23F57413C15AC7514275E5,31071,13,14,1,109.58257,18.28458,1815
30043,228620,5E6F81A7DA23F57413C15AC7514275E5,31945,14,16,2,109.58021,18.29403,1817
30044,228621,5E6F81A7DA23F57413C15AC7514275E5,31561,20,22,2,109.56792,18.28479,1765
30053,228739,CF73D0D52A41EE420FB8269A6F6AF679,39371,2,8,6,109.56627,18.2646,1762
30054,228740,CF73D0D52A41EE420FB8269A6F6AF679,30854,12,15,3,109.56889,18.27076,1763
30055,228741,CF73D0D52A41EE420FB8269A6F6AF679,60131,19,22,3,109.49819,18.24778,1509
30059,228778,5E4E8438E1ACB3B3BDC485F2AF3A8A03,30071,0,14,14,109.52819,18.30472,1619
30060,228779,5E4E8438E1ACB3B3BDC485F2AF3A8A03,31931,15,16,1,109.54771,18.29403,1667
30061,228780,5E4E8438E1ACB3B3BDC485F2AF3A8A03,30071,20,22,2,109.52819,18.30472,1619
30062,228784,7AF4921BC4D1712A961904D0ECC91550,38484,0,5,5,109.53028,18.31528,1620
30063,228785,7AF4921BC4D1712A961904D0ECC91550,38991,6,7,1,109.52681,18.30368,1618
30064,228786,7AF4921BC4D1712A961904D0ECC91550,30071,9,10,1,109.52819,18.30472,1619
30065,228788,7AF4921BC4D1712A961904D0ECC91550,38484,19,23,4,109.53028,18.31528,1620
30066,228789,0F558B6653C655C7F0BAEA9D66B33F57,31071,0,7,7,109.58257,18.28458,1815
30067,228790,0F558B6653C655C7F0BAEA9D66B33F57,30854,9,11,2,109.56889,18.27076,1763
30068,228791,0F558B6653C655C7F0BAEA9D66B33F57,31071,12,13,1,109.58257,18.28458,1815
30069,228792,0F558B6653C655C7F0BAEA9D66B33F57,30854,16,20,4,109.56889,18.27076,1763
30085,228923,503843EC837742985DC0A9C166C6B65E,31061,0,2,2,109.53333,18.23257,1607
30086,228924,503843EC837742985DC0A9C166C6B65E,31421,3,4,1,109.55382,18.22347,1705
30087,228925,503843EC837742985DC0A9C166C6B65E,31061,7,23,16,109.53333,18.23257,1607
30100,228981,D4448A1349B0563C78F16B479359A95F,31071,1,2,1,109.58257,18.28458,1815
30101,228982,D4448A1349B0563C78F16B479359A95F,31761,2,8,6,109.60521,18.27965,1914
30102,228983,D4448A1349B0563C78F16B479359A95F,30854,9,12,3,109.56889,18.27076,1763
30117,229105,D517610C2076C41FED0ED80CB6FFB44C,31561,0,6,6,109.56792,18.28479,1765
30118,229106,D517610C2076C41FED0ED80CB6FFB44C,30851,6,10,4,109.5616,18.27396,1713
30119,229107,D517610C2076C41FED0ED80CB6FFB44C,31561,13,14,1,109.56792,18.28479,1765
30120,229108,D517610C2076C41FED0ED80CB6FFB44C,30851,14,22,8,109.5616,18.27396,1713
30146,229351,EA4D123112CD0AE32B6D1280D2074CF8,30921,0,7,7,109.53903,18.29451,1667
30147,229352,EA4D123112CD0AE32B6D1280D2074CF8,31931,7,10,3,109.54771,18.29403,1667
30148,229353,EA4D123112CD0AE32B6D1280D2074CF8,30171,14,20,6,109.48458,18.27139,1463
30151,229363,75817DB682187A07461734D66E1E6492,30854,2,13,11,109.56889,18.27076,1763
30152,229364,75817DB682187A07461734D66E1E6492,31071,15,17,2,109.58257,18.28458,1815
30153,229365,75817DB682187A07461734D66E1E6492,31061,19,20,1,109.53333,18.23257,1607
30154,229366,75817DB682187A07461734D66E1E6492,60631,22,23,1,109.57778,18.27583,1814
30157,229400,005F3AEFE6DBF371ED1FD57736434098,31071,0,7,7,109.58257,18.28458,1815
30158,229401,005F3AEFE6DBF371ED1FD57736434098,30854,9,17,8,109.56889,18.27076,1763
30159,229402,005F3AEFE6DBF371ED1FD57736434098,31071,18,19,1,109.58257,18.28458,1815
30164,229448,ECCCA5770AD6AA7162B63EC395B55856,60631,0,7,7,109.57778,18.27583,1814
30165,229449,ECCCA5770AD6AA7162B63EC395B55856,39371,11,13,2,109.56627,18.2646,1762
30166,229450,ECCCA5770AD6AA7162B63EC395B55856,30951,15,16,1,109.56208,18.25667,1761
30167,229451,ECCCA5770AD6AA7162B63EC395B55856,60631,18,23,5,109.57778,18.27583,1814
30175,229531,17A4545370685D172A08774EFEF86DD3,30851,0,1,1,109.5616,18.27396,1713
30176,229532,17A4545370685D172A08774EFEF86DD3,31071,3,6,3,109.58257,18.28458,1815
30177,229533,17A4545370685D172A08774EFEF86DD3,39181,6,15,9,109.55153,18.28035,1715
30178,229534,E9B9BA7767032FDC0F26CEC5BEDEFC07,38157,0,6,6,109.51483,18.26958,1563
30179,229535,E9B9BA7767032FDC0F26CEC5BEDEFC07,30854,8,10,2,109.56889,18.27076,1763
30180,229536,E9B9BA7767032FDC0F26CEC5BEDEFC07,30181,12,16,4,109.51597,18.23313,1557
30202,229801,8C8DB7A18864109B823771C405E00B29,60351,0,6,6,109.58403,18.28958,1816
30203,229802,8C8DB7A18864109B823771C405E00B29,30951,8,17,9,109.56208,18.25667,1761
30204,229803,8C8DB7A18864109B823771C405E00B29,60351,21,22,1,109.58403,18.28958,1816
30226,229891,1D2F8DB1F8B6A2081E1A43DDF558491D,31951,1,9,8,109.52174,18.30299,1568
30227,229892,1D2F8DB1F8B6A2081E1A43DDF558491D,38484,9,11,2,109.53028,18.31528,1620
30228,229893,1D2F8DB1F8B6A2081E1A43DDF558491D,31951,11,23,12,109.52174,18.30299,1568
30248,230076,AED8643ACDE55B6379729A30DFF61487,31561,4,11,7,109.56792,18.28479,1765
30249,230077,AED8643ACDE55B6379729A30DFF61487,38157,11,13,2,109.51483,18.26958,1563
30250,230078,AED8643ACDE55B6379729A30DFF61487,30281,15,16,1,109.50597,18.27583,1514
30251,230079,AED8643ACDE55B6379729A30DFF61487,38157,16,23,7,109.51483,18.26958,1563
30256,230143,FFFC0994E5C15BDB165344716912442C,30854,0,6,6,109.56889,18.27076,1763
30257,230144,FFFC0994E5C15BDB165344716912442C,31551,6,9,3,109.55868,18.24222,1708
30258,230145,FFFC0994E5C15BDB165344716912442C,31554,9,17,8,109.55521,18.2459,1709
30259,230146,FFFC0994E5C15BDB165344716912442C,39371,20,22,2,109.56627,18.2646,1762
30260,230150,9FEA4B85EAE4FAEE1CAF0EABFF2FAEA1,31561,0,5,5,109.56792,18.28479,1765
30261,230151,9FEA4B85EAE4FAEE1CAF0EABFF2FAEA1,39183,8,9,1,109.55542,18.28208,1715
30262,230152,9FEA4B85EAE4FAEE1CAF0EABFF2FAEA1,31561,12,13,1,109.56792,18.28479,1765
30265,230246,8507BAE8053D976762BBCE04A96D60EE,38903,0,10,10,109.39229,18.29243,1117
30266,230247,8507BAE8053D976762BBCE04A96D60EE,38325,11,14,3,109.39792,18.2909,1116
30267,230248,8507BAE8053D976762BBCE04A96D60EE,38903,14,17,3,109.39229,18.29243,1117
30276,230289,9FC721E86703223349C05C95FE4BBB6F,60081,0,9,9,109.51097,18.22639,1556
30277,230290,9FC721E86703223349C05C95FE4BBB6F,31521,10,17,7,109.51458,18.22542,1555
30278,230291,9FC721E86703223349C05C95FE4BBB6F,31521,19,20,1,109.51458,18.22542,1555
30279,230292,9FC721E86703223349C05C95FE4BBB6F,60087,21,23,2,109.50688,18.22299,1505
30280,230296,A68637AA89BD62624E677D9E66C32FAD,30161,1,10,9,109.50042,18.24389,1508
30281,230297,A68637AA89BD62624E677D9E66C32FAD,30361,12,17,5,109.50347,18.24,1508
30282,230298,A68637AA89BD62624E677D9E66C32FAD,30161,17,23,6,109.50042,18.24389,1508
30296,230374,3389A095460231D31BA622B7185D6321,30351,0,1,1,109.41701,18.29292,1217
30297,230375,3389A095460231D31BA622B7185D6321,31231,1,6,5,109.42597,18.29292,1217
30298,230376,3389A095460231D31BA622B7185D6321,31681,6,18,12,109.40396,18.29979,1168
30305,230471,0D3DA8126B134D203BB35373EAFFB116,31071,4,5,1,109.58257,18.28458,1815
30306,230472,0D3DA8126B134D203BB35373EAFFB116,30854,8,10,2,109.56889,18.27076,1763
30307,230473,0D3DA8126B134D203BB35373EAFFB116,31071,12,13,1,109.58257,18.28458,1815
30308,230474,0D3DA8126B134D203BB35373EAFFB116,30854,17,22,5,109.56889,18.27076,1763
30309,230481,D334753E33AD01D79142036B3D85543F,31561,0,13,13,109.56792,18.28479,1765
30310,230482,D334753E33AD01D79142036B3D85543F,39181,14,16,2,109.55153,18.28035,1715
30311,230483,D334753E33AD01D79142036B3D85543F,30854,17,18,1,109.56889,18.27076,1763
30312,230484,D334753E33AD01D79142036B3D85543F,31561,18,23,5,109.56792,18.28479,1765
30316,230626,84DF4A7C208235D171EF56473BCCF210,30851,0,4,4,109.5616,18.27396,1713
30317,230627,84DF4A7C208235D171EF56473BCCF210,31561,4,6,2,109.56792,18.28479,1765
30318,230628,84DF4A7C208235D171EF56473BCCF210,60631,7,18,11,109.57778,18.27583,1814
30329,230690,7024F3A14F6F554DC6E80063E30315F0,31561,0,5,5,109.56792,18.28479,1765
30330,230691,7024F3A14F6F554DC6E80063E30315F0,39183,9,18,9,109.55542,18.28208,1715
30331,230692,7024F3A14F6F554DC6E80063E30315F0,31561,22,23,1,109.56792,18.28479,1765
30336,230699,BE586ACB441383CC10D7CF3923850B73,31931,0,6,6,109.54771,18.29403,1667
30337,230700,BE586ACB441383CC10D7CF3923850B73,39181,9,10,1,109.55153,18.28035,1715
30338,230701,BE586ACB441383CC10D7CF3923850B73,31931,12,14,2,109.54771,18.29403,1667
30349,230772,567BF1868FBA42FA9B3B29F2CA13F65D,31931,0,15,15,109.54771,18.29403,1667
30350,230773,567BF1868FBA42FA9B3B29F2CA13F65D,30921,16,17,1,109.53903,18.29451,1667
30351,230774,567BF1868FBA42FA9B3B29F2CA13F65D,31931,19,22,3,109.54771,18.29403,1667
30357,230795,FF90B6855593CFEA9A07FE008E94551D,60221,3,5,2,109.52569,18.29188,1616
30358,230796,FF90B6855593CFEA9A07FE008E94551D,60241,5,7,2,109.53319,18.28667,1616
30359,230797,FF90B6855593CFEA9A07FE008E94551D,31931,8,17,9,109.54771,18.29403,1667
30360,230798,FF90B6855593CFEA9A07FE008E94551D,60241,20,23,3,109.53319,18.28667,1616
30368,230850,335A7B1DE8538918FDA774EE3E402A76,30191,0,7,7,109.50361,18.22701,1506
30369,230851,335A7B1DE8538918FDA774EE3E402A76,31521,7,9,2,109.51458,18.22542,1555
30370,230853,335A7B1DE8538918FDA774EE3E402A76,30191,17,21,4,109.50361,18.22701,1506
30378,230901,D73D0E1690714CD7F442C709F67E4771,60361,0,7,7,109.51938,18.29681,1567
30379,230902,D73D0E1690714CD7F442C709F67E4771,39371,10,14,4,109.56627,18.2646,1762
30380,230903,D73D0E1690714CD7F442C709F67E4771,60361,18,23,5,109.51938,18.29681,1567
30384,230916,B93185B4820D7E0DEE74EBEA00941D15,38291,0,1,1,109.51618,18.24313,1558
30385,230917,B93185B4820D7E0DEE74EBEA00941D15,30911,3,18,15,109.50493,18.26181,1511
30386,230918,B93185B4820D7E0DEE74EBEA00941D15,60201,19,20,1,109.5041,18.2509,1510
30387,230919,B93185B4820D7E0DEE74EBEA00941D15,38291,21,22,1,109.51618,18.24313,1558
30393,230965,409F5E8F01172D32BBE91132149C037E,31861,0,1,1,109.49042,18.27549,1464
30394,230966,409F5E8F01172D32BBE91132149C037E,38371,2,7,5,109.50972,18.23924,1558
30395,230967,409F5E8F01172D32BBE91132149C037E,31931,8,17,9,109.54771,18.29403,1667
30396,230980,6EF68F35CE79552C1164E70C67C72C02,30121,0,8,8,109.52861,18.27222,1613
30397,230981,6EF68F35CE79552C1164E70C67C72C02,30854,11,17,6,109.56889,18.27076,1763
30398,230982,6EF68F35CE79552C1164E70C67C72C02,60661,19,21,2,109.548,18.2377,1657
30407,231092,D2BE39F7C6BE2553FAEEB8E39136B40A,60274,0,10,10,109.514,18.2933,1567
30408,231093,D2BE39F7C6BE2553FAEEB8E39136B40A,30151,12,13,1,109.50986,18.25083,1560
30409,231094,D2BE39F7C6BE2553FAEEB8E39136B40A,30721,15,16,1,109.51597,18.28257,1565
30410,231095,D2BE39F7C6BE2553FAEEB8E39136B40A,60401,20,23,3,109.47444,18.27583,1414
30411,231096,3520FED22A4D572CBFE1B08BD2743E22,30361,1,4,3,109.50347,18.24,1508
30412,231097,3520FED22A4D572CBFE1B08BD2743E22,30361,6,16,10,109.50347,18.24,1508
30413,231098,3520FED22A4D572CBFE1B08BD2743E22,31181,16,19,3,109.50382,18.24813,1509
30414,231099,3520FED22A4D572CBFE1B08BD2743E22,60235,21,22,1,109.49269,18.2253,1455
30417,231214,D9689370CD6256E9753C2B0B13067E2B,30854,0,6,6,109.56889,18.27076,1763
30418,231215,D9689370CD6256E9753C2B0B13067E2B,31071,7,8,1,109.58257,18.28458,1815
30419,231216,D9689370CD6256E9753C2B0B13067E2B,30854,8,22,14,109.56889,18.27076,1763
30430,231252,38AA3DA5E97F70E8689E8DE10EE9EB59,30854,3,14,11,109.56889,18.27076,1763
30431,231253,38AA3DA5E97F70E8689E8DE10EE9EB59,31945,14,16,2,109.58021,18.29403,1817
30432,231254,38AA3DA5E97F70E8689E8DE10EE9EB59,30854,17,23,6,109.56889,18.27076,1763
30433,231271,CCCD2290FB632A48009771412BE68ADD,31561,2,8,6,109.56792,18.28479,1765
30434,231272,CCCD2290FB632A48009771412BE68ADD,39183,8,10,2,109.55542,18.28208,1715
30435,231273,CCCD2290FB632A48009771412BE68ADD,31561,12,16,4,109.56792,18.28479,1765
30436,231277,8799356B7181F28146A203E5F86C52F0,60661,0,8,8,109.548,18.2377,1657
30437,231278,8799356B7181F28146A203E5F86C52F0,30051,13,14,1,109.48917,18.21215,1453
30438,231279,8799356B7181F28146A203E5F86C52F0,60231,17,22,5,109.49903,18.21972,1504
30445,231325,6DA732BBEB142DF897DCE85AB09B72FB,31571,1,5,4,109.61563,18.23326,1957
30446,231326,6DA732BBEB142DF897DCE85AB09B72FB,38052,6,10,4,109.62618,18.23042,1956
30447,231327,6DA732BBEB142DF897DCE85AB09B72FB,60594,14,17,3,109.62694,18.22799,1956
30448,231328,6DA732BBEB142DF897DCE85AB09B72FB,38052,20,22,2,109.62618,18.23042,1956
30451,231362,4E2E832AE9D054F6D1F41FA6FCE0E148,39183,0,6,6,109.55542,18.28208,1715
30452,231363,4E2E832AE9D054F6D1F41FA6FCE0E148,31561,7,12,5,109.56792,18.28479,1765
30453,231364,4E2E832AE9D054F6D1F41FA6FCE0E148,39183,16,17,1,109.55542,18.28208,1715
30454,231379,E34FF61340C5B86CF9FD0AD454D26266,30251,0,11,11,109.50611,18.26653,1512
30455,231380,E34FF61340C5B86CF9FD0AD454D26266,31521,14,18,4,109.51458,18.22542,1555
30456,231381,E34FF61340C5B86CF9FD0AD454D26266,60331,19,23,4,109.505,18.26507,1512
30467,231416,EF24901D99384F703B20FE07F2784FA0,30101,2,10,8,109.57299,18.33333,1773
30468,231417,EF24901D99384F703B20FE07F2784FA0,31631,11,16,5,109.59542,18.36826,1879
30469,231418,EF24901D99384F703B20FE07F2784FA0,30101,18,23,5,109.57299,18.33333,1773
30493,231601,012ABD06F231728C214A4BA917E75B1C,31561,0,15,15,109.56792,18.28479,1765
30494,231602,012ABD06F231728C214A4BA917E75B1C,30851,19,20,1,109.5616,18.27396,1713
30495,231603,012ABD06F231728C214A4BA917E75B1C,31561,20,21,1,109.56792,18.28479,1765
30496,231617,A8E9C7BB918ADAD29A3EA7ACDDCD32D7,38951,0,8,8,109.48097,18.28868,1416
30497,231618,A8E9C7BB918ADAD29A3EA7ACDDCD32D7,38951,9,12,3,109.48097,18.28868,1416
30498,231619,A8E9C7BB918ADAD29A3EA7ACDDCD32D7,38951,16,19,3,109.48097,18.28868,1416
30499,231620,A8E9C7BB918ADAD29A3EA7ACDDCD32D7,30741,20,23,3,109.49833,18.28681,1516
30503,231656,8468419E5C597B7D73CBDE87F8FF8BC8,30721,0,8,8,109.51597,18.28257,1565
30504,231657,8468419E5C597B7D73CBDE87F8FF8BC8,39053,8,11,3,109.511,18.2771,1564
30505,231658,8468419E5C597B7D73CBDE87F8FF8BC8,38171,12,14,2,109.50799,18.28139,1515
30506,231659,8468419E5C597B7D73CBDE87F8FF8BC8,39053,14,17,3,109.511,18.2771,1564
30512,231670,A0CFD24F8D50ABCF6002C5FC96CEAB76,39183,0,6,6,109.55542,18.28208,1715
30513,231671,A0CFD24F8D50ABCF6002C5FC96CEAB76,31931,7,8,1,109.54771,18.29403,1667
30514,231672,A0CFD24F8D50ABCF6002C5FC96CEAB76,39183,11,19,8,109.55542,18.28208,1715
30515,231673,A0CFD24F8D50ABCF6002C5FC96CEAB76,39181,20,23,3,109.55153,18.28035,1715
30523,231744,ED7913F0E84A3913E9686380D06A1441,60084,3,15,12,109.4984,18.2334,1507
30524,231745,ED7913F0E84A3913E9686380D06A1441,60381,18,20,2,109.5241,18.22458,1605
30525,231746,ED7913F0E84A3913E9686380D06A1441,60291,21,22,1,109.50826,18.24639,1509
30526,231769,8B9A9BFD1ACAD480EB101A91DBF2024D,38291,1,14,13,109.51618,18.24313,1558
30527,231770,8B9A9BFD1ACAD480EB101A91DBF2024D,30371,15,16,1,109.51,18.24771,1559
30528,231771,8B9A9BFD1ACAD480EB101A91DBF2024D,30421,20,23,3,109.50021,18.25861,1511
30530,231828,8752BC71725B50257436D50C6598F252,31071,0,7,7,109.58257,18.28458,1815
30531,231829,8752BC71725B50257436D50C6598F252,30854,7,20,13,109.56889,18.27076,1763
30532,231830,8752BC71725B50257436D50C6598F252,31071,21,22,1,109.58257,18.28458,1815
30542,232015,37657A593A7A700C5ECCE5BB0AAAABA7,31931,0,17,17,109.54771,18.29403,1667
30543,232016,37657A593A7A700C5ECCE5BB0AAAABA7,30921,18,19,1,109.53903,18.29451,1667
30544,232017,37657A593A7A700C5ECCE5BB0AAAABA7,30281,19,21,2,109.50597,18.27583,1514
30547,232042,ACAB8C7B92298FFCEC0006246A6D65D6,39183,0,6,6,109.55542,18.28208,1715
30548,232043,ACAB8C7B92298FFCEC0006246A6D65D6,39181,11,14,3,109.55153,18.28035,1715
30549,232044,ACAB8C7B92298FFCEC0006246A6D65D6,39183,14,23,9,109.55542,18.28208,1715
30550,232075,53453D8B736810206EC5A6632D159BE6,31931,0,13,13,109.54771,18.29403,1667
30551,232076,53453D8B736810206EC5A6632D159BE6,60371,14,15,1,109.53063,18.30056,1618
30552,232077,53453D8B736810206EC5A6632D159BE6,31931,17,22,5,109.54771,18.29403,1667
30553,232078,1BAA4EB92824E45EC2E36C90288F6A84,31531,1,7,6,109.49583,18.25972,1461
30554,232079,1BAA4EB92824E45EC2E36C90288F6A84,31031,10,14,4,109.49979,18.25382,1510
30555,232080,1BAA4EB92824E45EC2E36C90288F6A84,31031,18,22,4,109.49979,18.25382,1510
30562,232113,06537811BB9239FB7E750F0ECA1D11A2,30941,0,2,2,109.5559,18.33938,1724
30563,232114,06537811BB9239FB7E750F0ECA1D11A2,30931,2,6,4,109.55653,18.32722,1722
30564,232115,06537811BB9239FB7E750F0ECA1D11A2,30941,6,7,1,109.5559,18.33938,1724
30565,232124,D96E01B8E0F0DE9C160C9FEAFDCFDB6D,31071,1,7,6,109.58257,18.28458,1815
30566,232125,D96E01B8E0F0DE9C160C9FEAFDCFDB6D,30854,7,9,2,109.56889,18.27076,1763
30567,232126,D96E01B8E0F0DE9C160C9FEAFDCFDB6D,31071,12,14,2,109.58257,18.28458,1815
30579,232250,468231DFF07583BA8A222D360B2FDB3A,60501,0,8,8,109.48701,18.29021,1466
30580,232251,468231DFF07583BA8A222D360B2FDB3A,30084,9,10,1,109.50118,18.26972,1513
30581,232252,468231DFF07583BA8A222D360B2FDB3A,30391,14,18,4,109.4975,18.27118,1513
30582,232253,468231DFF07583BA8A222D360B2FDB3A,60501,20,23,3,109.48701,18.29021,1466
30588,232295,03E3094FE0344513E64DAE470C33E920,39181,0,10,10,109.55153,18.28035,1715
30589,232296,03E3094FE0344513E64DAE470C33E920,31931,12,14,2,109.54771,18.29403,1667
30590,232297,03E3094FE0344513E64DAE470C33E920,39181,18,23,5,109.55153,18.28035,1715
30595,232335,8FA14F3D719E2918EE3FBDE51EA0AD04,60354,0,11,11,109.58701,18.28521,1815
30596,232336,8FA14F3D719E2918EE3FBDE51EA0AD04,30854,11,13,2,109.56889,18.27076,1763
30597,232337,8FA14F3D719E2918EE3FBDE51EA0AD04,31071,16,23,7,109.58257,18.28458,1815
30603,232414,033CEEC20746801745CF4A53CD517C31,60241,0,2,2,109.53319,18.28667,1616
30604,232415,033CEEC20746801745CF4A53CD517C31,31181,2,8,6,109.50382,18.24813,1509
30605,232416,033CEEC20746801745CF4A53CD517C31,60291,10,15,5,109.50826,18.24639,1509
30606,232417,033CEEC20746801745CF4A53CD517C31,31821,18,22,4,109.51181,18.24924,1559
30607,232457,E9E473F09C342630187345312F4A31D8,39181,0,8,8,109.55153,18.28035,1715
30608,232458,E9E473F09C342630187345312F4A31D8,31931,8,10,2,109.54771,18.29403,1667
30609,232459,E9E473F09C342630187345312F4A31D8,39181,13,23,10,109.55153,18.28035,1715
30614,232490,B1715BAACD2551A031737B51F74CE832,30371,0,9,9,109.51,18.24771,1559
30615,232491,B1715BAACD2551A031737B51F74CE832,30421,9,17,8,109.50021,18.25861,1511
30616,232492,B1715BAACD2551A031737B51F74CE832,30371,20,23,3,109.51,18.24771,1559
30617,232523,E75CF54BA14775FEDD26504F9F6B7365,31945,0,5,5,109.58021,18.29403,1817
30618,232524,E75CF54BA14775FEDD26504F9F6B7365,31561,6,18,12,109.56792,18.28479,1765
30619,232525,E75CF54BA14775FEDD26504F9F6B7365,31945,22,23,1,109.58021,18.29403,1817
30620,232526,00FC332040A284DA251A8D0705989FE9,31071,0,7,7,109.58257,18.28458,1815
30621,232527,00FC332040A284DA251A8D0705989FE9,30854,7,8,1,109.56889,18.27076,1763
30622,232528,00FC332040A284DA251A8D0705989FE9,31071,10,21,11,109.58257,18.28458,1815
30635,232602,58418A9EA4A7DC03127CB79C039A5185,60354,0,9,9,109.58701,18.28521,1815
30636,232603,58418A9EA4A7DC03127CB79C039A5185,30854,12,18,6,109.56889,18.27076,1763
30637,232604,58418A9EA4A7DC03127CB79C039A5185,60354,19,23,4,109.58701,18.28521,1815
30643,232665,DFFF17B7FE30E79B8AABBB5CE171272F,31561,0,11,11,109.56792,18.28479,1765
30644,232666,DFFF17B7FE30E79B8AABBB5CE171272F,39183,12,14,2,109.55542,18.28208,1715
30645,232667,DFFF17B7FE30E79B8AABBB5CE171272F,31561,14,21,7,109.56792,18.28479,1765
30653,232726,8CD15CF6B5FB4821940FF9AFE6D6CB84,30921,0,5,5,109.53903,18.29451,1667
30654,232727,8CD15CF6B5FB4821940FF9AFE6D6CB84,31931,5,15,10,109.54771,18.29403,1667
30655,232728,8CD15CF6B5FB4821940FF9AFE6D6CB84,30071,16,18,2,109.52819,18.30472,1619
30661,232773,5A1FDC762E3A00EF6FB4C515806ADF6A,38911,0,13,13,109.51674,18.24965,1559
30662,232774,5A1FDC762E3A00EF6FB4C515806ADF6A,38291,14,22,8,109.51618,18.24313,1558
30663,232775,5A1FDC762E3A00EF6FB4C515806ADF6A,31261,22,23,1,109.51174,18.2466,1559
30674,232927,03CEC0FDDD5484124514C6D24A63D4DD,30854,0,1,1,109.56889,18.27076,1763
30675,232928,03CEC0FDDD5484124514C6D24A63D4DD,31561,1,5,4,109.56792,18.28479,1765
30676,232929,03CEC0FDDD5484124514C6D24A63D4DD,39183,7,17,10,109.55542,18.28208,1715
30677,232941,2881766FA99B9AF1E265FF9153E350E0,31671,0,9,9,109.38965,18.29813,1068
30678,232942,2881766FA99B9AF1E265FF9153E350E0,31471,10,12,2,109.34583,18.29563,917
30679,232943,2881766FA99B9AF1E265FF9153E350E0,60411,14,15,1,109.32514,18.30854,869
30690,233074,82FA50C876D91311B7DA8BB626927288,31945,0,4,4,109.58021,18.29403,1817
30691,233075,82FA50C876D91311B7DA8BB626927288,30854,8,10,2,109.56889,18.27076,1763
30692,233076,82FA50C876D91311B7DA8BB626927288,31351,13,16,3,109.4959,18.28417,1465
30705,233239,6BF671BC76B2463D72102139E4EB1018,60371,0,1,1,109.53063,18.30056,1618
30706,233240,6BF671BC76B2463D72102139E4EB1018,31931,4,5,1,109.54771,18.29403,1667
30707,233241,6BF671BC76B2463D72102139E4EB1018,38241,6,15,9,109.54111,18.30542,1669
30708,233242,6BF671BC76B2463D72102139E4EB1018,60371,16,17,1,109.53063,18.30056,1618
30709,233251,5121CF17D14D2AAD91DBD81D7766DFCC,31521,0,6,6,109.51458,18.22542,1555
30710,233252,5121CF17D14D2AAD91DBD81D7766DFCC,30731,7,10,3,109.50944,18.22306,1555
30711,233253,5121CF17D14D2AAD91DBD81D7766DFCC,31521,10,16,6,109.51458,18.22542,1555
30739,233362,F5EB56BD5801B85A9E4703584DF6DFA6,31071,0,2,2,109.58257,18.28458,1815
30740,233363,F5EB56BD5801B85A9E4703584DF6DFA6,31071,3,10,7,109.58257,18.28458,1815
30741,233364,F5EB56BD5801B85A9E4703584DF6DFA6,31071,12,16,4,109.58257,18.28458,1815
30742,233392,E6651E3C6D8FEA2077D9EFC6D097D06C,38251,0,14,14,109.49618,18.25493,1510
30743,233393,E6651E3C6D8FEA2077D9EFC6D097D06C,31031,17,21,4,109.49979,18.25382,1510
30744,233394,E6651E3C6D8FEA2077D9EFC6D097D06C,38251,22,23,1,109.49618,18.25493,1510
30753,233497,B84B247FA61A8C12DFCCCF3C2D72006D,31071,2,7,5,109.58257,18.28458,1815
30754,233498,B84B247FA61A8C12DFCCCF3C2D72006D,30854,8,9,1,109.56889,18.27076,1763
30755,233499,B84B247FA61A8C12DFCCCF3C2D72006D,31945,13,15,2,109.58021,18.29403,1817
30792,233822,D001062E96DDE99C5A38D3DD89B4A1A5,30854,0,1,1,109.56889,18.27076,1763
30793,233823,D001062E96DDE99C5A38D3DD89B4A1A5,39371,1,2,1,109.56627,18.2646,1762
30794,233824,D001062E96DDE99C5A38D3DD89B4A1A5,30854,4,7,3,109.56889,18.27076,1763
30795,233832,6C09CE755C8436D31143C1E3AA51623D,39371,0,1,1,109.56627,18.2646,1762
30796,233833,6C09CE755C8436D31143C1E3AA51623D,31071,1,2,1,109.58257,18.28458,1815
30797,233834,6C09CE755C8436D31143C1E3AA51623D,39371,5,6,1,109.56627,18.2646,1762
30798,233835,6C09CE755C8436D31143C1E3AA51623D,30854,11,16,5,109.56889,18.27076,1763
30823,234148,184447FB27346CCB581EA0ECE0E04766,38991,0,6,6,109.52681,18.30368,1618
30824,234149,184447FB27346CCB581EA0ECE0E04766,31931,8,16,8,109.54771,18.29403,1667
30825,234150,184447FB27346CCB581EA0ECE0E04766,30071,19,23,4,109.52819,18.30472,1619
30836,234288,A9634A2AD8447824C1C9412CBBCC32E0,31181,0,6,6,109.50382,18.24813,1509
30837,234289,A9634A2AD8447824C1C9412CBBCC32E0,31531,9,12,3,109.49583,18.25972,1461
30838,234290,A9634A2AD8447824C1C9412CBBCC32E0,31181,12,15,3,109.50382,18.24813,1509
30839,234291,A9634A2AD8447824C1C9412CBBCC32E0,31531,15,16,1,109.49583,18.25972,1461
30896,234772,4A260D34614CE6238F06D54A86B043DE,30854,0,16,16,109.56889,18.27076,1763
30897,234773,4A260D34614CE6238F06D54A86B043DE,60631,16,17,1,109.57778,18.27583,1814
30898,234774,4A260D34614CE6238F06D54A86B043DE,30854,19,20,1,109.56889,18.27076,1763
30908,234833,7A214C2AB4CE0E87DF8DB230B9F95561,30101,0,6,6,109.57299,18.33333,1773
30909,234834,7A214C2AB4CE0E87DF8DB230B9F95561,31631,6,8,2,109.59542,18.36826,1879
30910,234835,7A214C2AB4CE0E87DF8DB230B9F95561,30101,10,23,13,109.57299,18.33333,1773
30911,234838,9B389AE8E9B004176803CCEAFF69104A,60631,1,3,2,109.57778,18.27583,1814
30912,234839,9B389AE8E9B004176803CCEAFF69104A,30951,6,17,11,109.56208,18.25667,1761
30913,234840,9B389AE8E9B004176803CCEAFF69104A,60631,17,19,2,109.57778,18.27583,1814
30924,234950,B80D6AB96D3D5CEE71A70ED25275F830,38951,0,9,9,109.48097,18.28868,1416
30925,234951,B80D6AB96D3D5CEE71A70ED25275F830,31531,13,16,3,109.49583,18.25972,1461
30926,234952,B80D6AB96D3D5CEE71A70ED25275F830,38951,20,21,1,109.48097,18.28868,1416
30927,234964,0442B38E8824E569B00E80CCEFC70940,30854,3,4,1,109.56889,18.27076,1763
30928,234965,0442B38E8824E569B00E80CCEFC70940,39183,9,16,7,109.55542,18.28208,1715
30929,234966,0442B38E8824E569B00E80CCEFC70940,30854,18,19,1,109.56889,18.27076,1763
30930,234967,0442B38E8824E569B00E80CCEFC70940,31561,20,22,2,109.56792,18.28479,1765
30938,235093,8D3B10FD4DBC46DB93DA60040668F697,30854,0,6,6,109.56889,18.27076,1763
30939,235094,8D3B10FD4DBC46DB93DA60040668F697,31561,9,10,1,109.56792,18.28479,1765
30940,235095,8D3B10FD4DBC46DB93DA60040668F697,30854,12,23,11,109.56889,18.27076,1763
30945,235158,8621CFDF1B89A83351494618C53D033F,39181,0,5,5,109.55153,18.28035,1715
30946,235159,8621CFDF1B89A83351494618C53D033F,31071,6,16,10,109.58257,18.28458,1815
30947,235160,8621CFDF1B89A83351494618C53D033F,39181,16,20,4,109.55153,18.28035,1715
30948,235218,BE7763F8096EB5A037146E1CC4190538,30854,0,5,5,109.56889,18.27076,1763
30949,235219,BE7763F8096EB5A037146E1CC4190538,39183,7,18,11,109.55542,18.28208,1715
30950,235220,BE7763F8096EB5A037146E1CC4190538,31071,19,20,1,109.58257,18.28458,1815
30966,235409,EB316856896788EC8FD871E122E95728,31811,1,4,3,109.54201,18.31806,1671
30967,235410,EB316856896788EC8FD871E122E95728,30701,6,14,8,109.59313,18.32007,1871
30968,235411,EB316856896788EC8FD871E122E95728,31811,14,18,4,109.54201,18.31806,1671
30969,235412,EB316856896788EC8FD871E122E95728,30701,18,23,5,109.59313,18.32007,1871
30979,235516,4B004637D3CFBCA65EA00FFD3F1EF7A6,31561,0,12,12,109.56792,18.28479,1765
30980,235517,4B004637D3CFBCA65EA00FFD3F1EF7A6,30071,14,15,1,109.52819,18.30472,1619
30981,235518,4B004637D3CFBCA65EA00FFD3F1EF7A6,31561,18,20,2,109.56792,18.28479,1765
30982,235531,9DE8C13901CC7D63E2F1A6CC92603604,31071,1,2,1,109.58257,18.28458,1815
30983,235532,9DE8C13901CC7D63E2F1A6CC92603604,30851,3,5,2,109.5616,18.27396,1713
30984,235533,9DE8C13901CC7D63E2F1A6CC92603604,30854,8,20,12,109.56889,18.27076,1763
31026,235771,3B6FF1F8D896A0A62DC7E65967011999,39183,0,12,12,109.55542,18.28208,1715
31027,235772,3B6FF1F8D896A0A62DC7E65967011999,31561,13,15,2,109.56792,18.28479,1765
31028,235773,3B6FF1F8D896A0A62DC7E65967011999,39183,15,20,5,109.55542,18.28208,1715
31040,235819,FBC323A047041F71D8997C22FDE88F17,30181,1,9,8,109.51597,18.23313,1557
31041,235820,FBC323A047041F71D8997C22FDE88F17,38346,10,17,7,109.49688,18.21306,1503
31042,235821,FBC323A047041F71D8997C22FDE88F17,38017,19,21,2,109.49729,18.21424,1504
31052,235848,9F7BD4B191C6CDB262073FE9BC5F12C5,30281,0,3,3,109.50597,18.27583,1514
31053,235849,9F7BD4B191C6CDB262073FE9BC5F12C5,38127,4,9,5,109.50833,18.27222,1513
31054,235850,9F7BD4B191C6CDB262073FE9BC5F12C5,38721,9,10,1,109.50368,18.27542,1514
31060,236008,13664B2E5419DDA8E26BAB65AA04153C,39191,0,16,16,109.51493,18.23472,1557
31061,236009,13664B2E5419DDA8E26BAB65AA04153C,30271,17,18,1,109.49132,18.23153,1456
31062,236010,13664B2E5419DDA8E26BAB65AA04153C,30191,20,21,1,109.50361,18.22701,1506
31068,236019,DF98647F15F7D91E899C4DF73529607A,30921,5,7,2,109.53903,18.29451,1667
31069,236020,DF98647F15F7D91E899C4DF73529607A,60371,7,9,2,109.53063,18.30056,1618
31070,236021,DF98647F15F7D91E899C4DF73529607A,31931,11,16,5,109.54771,18.29403,1667
31092,236181,E65658506C2BF9C993BA69EE6D38B3C6,31951,1,13,12,109.52174,18.30299,1568
31093,236182,E65658506C2BF9C993BA69EE6D38B3C6,60361,14,16,2,109.51938,18.29681,1567
31094,236183,E65658506C2BF9C993BA69EE6D38B3C6,31951,16,20,4,109.52174,18.30299,1568
31095,236184,E65658506C2BF9C993BA69EE6D38B3C6,31561,21,22,1,109.56792,18.28479,1765
31100,236277,372BCC9E34709FCD9ED7D887E115E777,31561,1,13,12,109.56792,18.28479,1765
31101,236278,372BCC9E34709FCD9ED7D887E115E777,30854,13,16,3,109.56889,18.27076,1763
31102,236279,372BCC9E34709FCD9ED7D887E115E777,31561,17,18,1,109.56792,18.28479,1765
31103,236280,372BCC9E34709FCD9ED7D887E115E777,31071,19,23,4,109.58257,18.28458,1815
31104,236298,C93386A9D86FE22A1FD4E5116045DD8D,31561,0,5,5,109.56792,18.28479,1765
31105,236299,C93386A9D86FE22A1FD4E5116045DD8D,39183,6,10,4,109.55542,18.28208,1715
31106,236300,C93386A9D86FE22A1FD4E5116045DD8D,31561,11,19,8,109.56792,18.28479,1765
31107,236301,C93386A9D86FE22A1FD4E5116045DD8D,30854,19,20,1,109.56889,18.27076,1763
31110,236376,299B7BC2E95F0240F64F76032ECBC4BA,39191,0,7,7,109.51493,18.23472,1557
31111,236377,299B7BC2E95F0240F64F76032ECBC4BA,60281,8,9,1,109.51743,18.25924,1561
31112,236378,299B7BC2E95F0240F64F76032ECBC4BA,30181,10,13,3,109.51597,18.23313,1557
31113,236379,299B7BC2E95F0240F64F76032ECBC4BA,30711,15,16,1,109.50271,18.25347,1510
31120,236391,DA10676C4DA702E02A2C3FFFAC40ABA2,31561,0,4,4,109.56792,18.28479,1765
31121,236392,DA10676C4DA702E02A2C3FFFAC40ABA2,39183,8,10,2,109.55542,18.28208,1715
31122,236393,DA10676C4DA702E02A2C3FFFAC40ABA2,31561,10,18,8,109.56792,18.28479,1765
31141,236562,90E761563218966BF6DD1FD6E24DA0E3,60321,0,9,9,109.63611,18.24306,2008
31142,236563,90E761563218966BF6DD1FD6E24DA0E3,31571,10,12,2,109.61563,18.23326,1957
31143,236564,90E761563218966BF6DD1FD6E24DA0E3,31101,15,17,2,109.65389,18.23403,2057
31152,236587,C709D01469E0800AF998DFAF42105CDC,30854,1,5,4,109.56889,18.27076,1763
31153,236588,C709D01469E0800AF998DFAF42105CDC,31561,6,18,12,109.56792,18.28479,1765
31154,236589,C709D01469E0800AF998DFAF42105CDC,30854,19,23,4,109.56889,18.27076,1763
31167,236639,8A0382A2385C362EFE2664E8795F133E,39183,0,4,4,109.55542,18.28208,1715
31168,236640,8A0382A2385C362EFE2664E8795F133E,31561,4,5,1,109.56792,18.28479,1765
31169,236641,8A0382A2385C362EFE2664E8795F133E,39183,9,13,4,109.55542,18.28208,1715
31170,236642,8A0382A2385C362EFE2664E8795F133E,31561,14,15,1,109.56792,18.28479,1765
31171,236643,3160CBE2F0CDCB610575CDC881D9968C,38297,0,7,7,109.52576,18.24965,1609
31172,236644,3160CBE2F0CDCB610575CDC881D9968C,38261,8,9,1,109.50361,18.28153,1515
31173,236645,3160CBE2F0CDCB610575CDC881D9968C,38297,11,14,3,109.52576,18.24965,1609
31185,236760,C5190185E6A850F6CC88937542E0EA31,31071,3,4,1,109.58257,18.28458,1815
31186,236761,C5190185E6A850F6CC88937542E0EA31,31071,5,6,1,109.58257,18.28458,1815
31187,236762,C5190185E6A850F6CC88937542E0EA31,39371,8,9,1,109.56627,18.2646,1762
31188,236763,C5190185E6A850F6CC88937542E0EA31,30854,9,16,7,109.56889,18.27076,1763
31207,236907,40C57F24FE0409ABB752B2031C349577,38951,0,7,7,109.48097,18.28868,1416
31208,236908,40C57F24FE0409ABB752B2031C349577,38073,11,12,1,109.40813,18.30958,1169
31209,236909,40C57F24FE0409ABB752B2031C349577,38951,17,22,5,109.48097,18.28868,1416
31210,236950,50C497E938D256053EDA53A1DE0E2147,31931,0,18,18,109.54771,18.29403,1667
31211,236951,50C497E938D256053EDA53A1DE0E2147,60371,20,21,1,109.53063,18.30056,1618
31212,236952,50C497E938D256053EDA53A1DE0E2147,31931,22,23,1,109.54771,18.29403,1667
31220,237064,0AD99509D112B17EDC0942E5CD8E86E4,30071,0,6,6,109.52819,18.30472,1619
31221,237065,0AD99509D112B17EDC0942E5CD8E86E4,30921,8,14,6,109.53903,18.29451,1667
31222,237066,0AD99509D112B17EDC0942E5CD8E86E4,31931,16,18,2,109.54771,18.29403,1667
31223,237067,0AD99509D112B17EDC0942E5CD8E86E4,30071,19,23,4,109.52819,18.30472,1619
31224,237073,0695D4E7B3E726CA09D841B87798B560,60354,1,5,4,109.58701,18.28521,1815
31225,237074,0695D4E7B3E726CA09D841B87798B560,30854,9,16,7,109.56889,18.27076,1763
31226,237075,0695D4E7B3E726CA09D841B87798B560,31071,16,18,2,109.58257,18.28458,1815
31227,237076,0695D4E7B3E726CA09D841B87798B560,30854,22,23,1,109.56889,18.27076,1763
31237,237118,63FBAC0202144B00077561285E6A7F87,30821,0,7,7,109.43681,18.33639,1274
31238,237119,63FBAC0202144B00077561285E6A7F87,30651,7,10,3,109.42611,18.385,1232
31239,237120,63FBAC0202144B00077561285E6A7F87,30821,10,23,13,109.43681,18.33639,1274
31248,237217,1593E13193A160EF9BE2323C5CE79FFF,30071,0,9,9,109.52819,18.30472,1619
31249,237218,1593E13193A160EF9BE2323C5CE79FFF,30084,10,12,2,109.50118,18.26972,1513
31250,237219,1593E13193A160EF9BE2323C5CE79FFF,38241,13,19,6,109.54111,18.30542,1669
31279,237414,30F5D42A1A8F1CF26F5C9617FCB06C4F,31561,1,3,2,109.56792,18.28479,1765
31280,237415,30F5D42A1A8F1CF26F5C9617FCB06C4F,39183,5,15,10,109.55542,18.28208,1715
31281,237416,30F5D42A1A8F1CF26F5C9617FCB06C4F,30071,16,17,1,109.52819,18.30472,1619
31282,237417,30F5D42A1A8F1CF26F5C9617FCB06C4F,39183,18,20,2,109.55542,18.28208,1715
31288,237463,A928E9F6C796FE1A60807BA003DE87BB,30234,2,7,5,109.60681,18.29979,1918
31289,237464,A928E9F6C796FE1A60807BA003DE87BB,31071,11,13,2,109.58257,18.28458,1815
31290,237465,A928E9F6C796FE1A60807BA003DE87BB,30854,16,19,3,109.56889,18.27076,1763
31291,237466,A928E9F6C796FE1A60807BA003DE87BB,31071,22,23,1,109.58257,18.28458,1815
31297,237550,807332CEC38772FA8DF98C48FBD8DD1E,31561,1,6,5,109.56792,18.28479,1765
31298,237551,807332CEC38772FA8DF98C48FBD8DD1E,39183,6,9,3,109.55542,18.28208,1715
31299,237552,807332CEC38772FA8DF98C48FBD8DD1E,31561,11,21,10,109.56792,18.28479,1765
31312,237593,A549C024E6F63EDBD3DC866F10DB11CE,31945,2,3,1,109.58021,18.29403,1817
31313,237594,A549C024E6F63EDBD3DC866F10DB11CE,30854,7,9,2,109.56889,18.27076,1763
31314,237595,A549C024E6F63EDBD3DC866F10DB11CE,31071,10,12,2,109.58257,18.28458,1815
31315,237596,A549C024E6F63EDBD3DC866F10DB11CE,30854,14,20,6,109.56889,18.27076,1763
31320,237629,A749E400BFD3B5908671E939EC104DEE,30854,1,13,12,109.56889,18.27076,1763
31321,237630,A749E400BFD3B5908671E939EC104DEE,31071,17,19,2,109.58257,18.28458,1815
31322,237631,A749E400BFD3B5908671E939EC104DEE,30854,21,23,2,109.56889,18.27076,1763
31332,237725,D75F3D28EEDDC3AAB22F587F99A79102,30854,0,10,10,109.56889,18.27076,1763
31333,237726,D75F3D28EEDDC3AAB22F587F99A79102,30851,11,14,3,109.5616,18.27396,1713
31334,237727,D75F3D28EEDDC3AAB22F587F99A79102,31071,18,20,2,109.58257,18.28458,1815
31344,237789,546C572FC49C780F9A9AF62ED98666DF,30351,0,8,8,109.41701,18.29292,1217
31345,237790,546C572FC49C780F9A9AF62ED98666DF,30681,9,10,1,109.48493,18.26917,1463
31346,237791,546C572FC49C780F9A9AF62ED98666DF,30351,12,19,7,109.41701,18.29292,1217
31347,237792,546C572FC49C780F9A9AF62ED98666DF,30681,21,22,1,109.48493,18.26917,1463
31348,237811,5E6F81A7DA23F57413C15AC7514275E5,31561,1,2,1,109.56792,18.28479,1765
31349,237812,5E6F81A7DA23F57413C15AC7514275E5,31071,5,8,3,109.58257,18.28458,1815
31350,237813,5E6F81A7DA23F57413C15AC7514275E5,31945,12,23,11,109.58021,18.29403,1817
31364,237981,0F558B6653C655C7F0BAEA9D66B33F57,31761,5,6,1,109.60521,18.27965,1914
31365,237982,0F558B6653C655C7F0BAEA9D66B33F57,31071,11,12,1,109.58257,18.28458,1815
31366,237983,0F558B6653C655C7F0BAEA9D66B33F57,30854,13,16,3,109.56889,18.27076,1763
31411,238143,AAD294F97E8F953422B544ED61B36D13,31071,0,6,6,109.58257,18.28458,1815
31412,238144,AAD294F97E8F953422B544ED61B36D13,31551,8,10,2,109.55868,18.24222,1708
31413,238145,AAD294F97E8F953422B544ED61B36D13,31554,15,16,1,109.55521,18.2459,1709
31423,238204,D2A5F87218CF25385163A2F3C4229CB8,30851,0,8,8,109.5616,18.27396,1713
31424,238205,D2A5F87218CF25385163A2F3C4229CB8,31561,8,9,1,109.56792,18.28479,1765
31425,238206,D2A5F87218CF25385163A2F3C4229CB8,30851,14,23,9,109.5616,18.27396,1713
31442,238282,598A3D86FECCB6897F5914EE10CDED04,30051,0,1,1,109.48917,18.21215,1453
31443,238283,598A3D86FECCB6897F5914EE10CDED04,31031,2,6,4,109.49979,18.25382,1510
31444,238284,598A3D86FECCB6897F5914EE10CDED04,30051,7,22,15,109.48917,18.21215,1453
31447,238320,6129383099E3ED1C56067EF35AD26C00,30191,0,10,10,109.50361,18.22701,1506
31448,238321,6129383099E3ED1C56067EF35AD26C00,31206,12,13,1,109.50819,18.23549,1507
31449,238322,6129383099E3ED1C56067EF35AD26C00,31521,18,22,4,109.51458,18.22542,1555
31450,238331,4257B02173BB27432EB8329AFD2B7099,31461,0,7,7,109.5091,18.25389,1510
31451,238332,4257B02173BB27432EB8329AFD2B7099,60641,8,9,1,109.53854,18.2359,1657
31452,238335,4257B02173BB27432EB8329AFD2B7099,30711,20,21,1,109.50271,18.25347,1510
31453,238336,4257B02173BB27432EB8329AFD2B7099,31461,21,23,2,109.5091,18.25389,1510
31456,238363,BC2EDF4DF9C7FAD55BDEABA03DFA7284,31561,0,5,5,109.56792,18.28479,1765
31457,238364,BC2EDF4DF9C7FAD55BDEABA03DFA7284,30854,6,7,1,109.56889,18.27076,1763
31458,238365,BC2EDF4DF9C7FAD55BDEABA03DFA7284,31561,11,23,12,109.56792,18.28479,1765
31461,238377,91B67A451BCA48674F80C454F3D349F4,39181,5,8,3,109.55153,18.28035,1715
31462,238378,91B67A451BCA48674F80C454F3D349F4,31931,9,15,6,109.54771,18.29403,1667
31463,238379,91B67A451BCA48674F80C454F3D349F4,39181,19,23,4,109.55153,18.28035,1715
31469,238431,7B2AEE2086698683607EDDDB4B678234,38154,0,6,6,109.5266,18.28278,1615
31470,238432,7B2AEE2086698683607EDDDB4B678234,60221,6,8,2,109.52569,18.29188,1616
31471,238433,7B2AEE2086698683607EDDDB4B678234,38154,10,12,2,109.5266,18.28278,1615
31472,238434,7B2AEE2086698683607EDDDB4B678234,60221,16,18,2,109.52569,18.29188,1616
31482,238516,796508A45D039A2F5E7DA411A8474D31,30234,0,7,7,109.60681,18.29979,1918
31483,238517,796508A45D039A2F5E7DA411A8474D31,30854,12,16,4,109.56889,18.27076,1763
31484,238518,796508A45D039A2F5E7DA411A8474D31,30234,17,21,4,109.60681,18.29979,1918
31485,238519,EA4D123112CD0AE32B6D1280D2074CF8,30921,0,7,7,109.53903,18.29451,1667
31486,238520,EA4D123112CD0AE32B6D1280D2074CF8,31931,7,12,5,109.54771,18.29403,1667
31487,238521,EA4D123112CD0AE32B6D1280D2074CF8,30921,14,23,9,109.53903,18.29451,1667
31513,238656,BD1C8CAB0CA377D9350002A865081450,30251,0,7,7,109.50611,18.26653,1512
31514,238657,BD1C8CAB0CA377D9350002A865081450,30251,8,12,4,109.50611,18.26653,1512
31515,238658,BD1C8CAB0CA377D9350002A865081450,31021,13,14,1,109.49021,18.27,1463
31519,238669,C19430CE8DF26BDEF43903E57E682236,31561,0,14,14,109.56792,18.28479,1765
31520,238670,C19430CE8DF26BDEF43903E57E682236,30854,18,19,1,109.56889,18.27076,1763
31521,238671,C19430CE8DF26BDEF43903E57E682236,31561,20,23,3,109.56792,18.28479,1765
31522,238678,17A4545370685D172A08774EFEF86DD3,31071,0,2,2,109.58257,18.28458,1815
31523,238679,17A4545370685D172A08774EFEF86DD3,30851,4,5,1,109.5616,18.27396,1713
31524,238680,17A4545370685D172A08774EFEF86DD3,39181,7,16,9,109.55153,18.28035,1715
31525,238681,E9B9BA7767032FDC0F26CEC5BEDEFC07,30721,0,7,7,109.51597,18.28257,1565
31526,238682,E9B9BA7767032FDC0F26CEC5BEDEFC07,30181,7,14,7,109.51597,18.23313,1557
31527,238683,E9B9BA7767032FDC0F26CEC5BEDEFC07,30854,14,17,3,109.56889,18.27076,1763
31528,238684,E9B9BA7767032FDC0F26CEC5BEDEFC07,60221,20,21,1,109.52569,18.29188,1616
31529,238689,E6541B4F346982101D887BAAF0315541,30854,0,7,7,109.56889,18.27076,1763
31530,238690,E6541B4F346982101D887BAAF0315541,30851,8,9,1,109.5616,18.27396,1713
31531,238691,E6541B4F346982101D887BAAF0315541,30854,10,18,8,109.56889,18.27076,1763
31540,238748,CE70D3AAC3EF6B01DB8A5F34BD94E77D,30651,2,3,1,109.42611,18.385,1232
31541,238749,CE70D3AAC3EF6B01DB8A5F34BD94E77D,30821,7,8,1,109.43681,18.33639,1274
31542,238750,CE70D3AAC3EF6B01DB8A5F34BD94E77D,30651,8,11,3,109.42611,18.385,1232
31543,238751,CE70D3AAC3EF6B01DB8A5F34BD94E77D,30821,12,21,9,109.43681,18.33639,1274
31550,238816,B90755FA392DFA726BB1851A64C95B6A,60661,3,5,2,109.548,18.2377,1657
31551,238817,B90755FA392DFA726BB1851A64C95B6A,60381,7,15,8,109.5241,18.22458,1605
31552,238818,B90755FA392DFA726BB1851A64C95B6A,31421,15,22,7,109.55382,18.22347,1705
31556,238833,5426296000364EE32711CD0E73D782C8,31071,1,6,5,109.58257,18.28458,1815
31557,238834,5426296000364EE32711CD0E73D782C8,31561,9,15,6,109.56792,18.28479,1765
31558,238835,5426296000364EE32711CD0E73D782C8,30854,19,23,4,109.56889,18.27076,1763
31587,239096,1D2F8DB1F8B6A2081E1A43DDF558491D,31951,0,14,14,109.52174,18.30299,1568
31588,239097,1D2F8DB1F8B6A2081E1A43DDF558491D,38484,15,17,2,109.53028,18.31528,1620
31589,239098,1D2F8DB1F8B6A2081E1A43DDF558491D,31951,18,22,4,109.52174,18.30299,1568
31594,239114,0526FBDD03CECB7E3925506B4441EC17,31041,0,8,8,109.50278,18.23701,1507
31595,239115,0526FBDD03CECB7E3925506B4441EC17,30511,8,17,9,109.51069,18.24208,1558
31596,239116,0526FBDD03CECB7E3925506B4441EC17,31443,17,23,6,109.5116,18.24438,1559
31616,239261,770A00BDAFE9BCA8C9E9FA68066EED7D,31071,0,6,6,109.58257,18.28458,1815
31617,239262,770A00BDAFE9BCA8C9E9FA68066EED7D,31561,7,20,13,109.56792,18.28479,1765
31618,239263,770A00BDAFE9BCA8C9E9FA68066EED7D,31071,21,23,2,109.58257,18.28458,1815
31622,239281,A6CCB3B38301DFF4978B708468E178C6,38291,1,12,11,109.51618,18.24313,1558
31623,239282,A6CCB3B38301DFF4978B708468E178C6,38291,14,16,2,109.51618,18.24313,1558
31624,239283,A6CCB3B38301DFF4978B708468E178C6,30271,16,18,2,109.49132,18.23153,1456
31625,239284,A6CCB3B38301DFF4978B708468E178C6,31461,19,23,4,109.5091,18.25389,1510
31640,239379,9FEA4B85EAE4FAEE1CAF0EABFF2FAEA1,30854,0,5,5,109.56889,18.27076,1763
31641,239380,9FEA4B85EAE4FAEE1CAF0EABFF2FAEA1,39183,7,17,10,109.55542,18.28208,1715
31642,239381,9FEA4B85EAE4FAEE1CAF0EABFF2FAEA1,31561,18,20,2,109.56792,18.28479,1765
31643,239444,C01D7F4C525517694A04D5EAA5AD2420,31071,0,8,8,109.58257,18.28458,1815
31644,239445,C01D7F4C525517694A04D5EAA5AD2420,39183,8,9,1,109.55542,18.28208,1715
31645,239446,C01D7F4C525517694A04D5EAA5AD2420,31071,12,14,2,109.58257,18.28458,1815
31646,239466,94C4D5691F7DFC1AB38806AFFAC1389E,31931,0,3,3,109.54771,18.29403,1667
31647,239467,94C4D5691F7DFC1AB38806AFFAC1389E,30921,3,8,5,109.53903,18.29451,1667
31648,239468,94C4D5691F7DFC1AB38806AFFAC1389E,31931,10,19,9,109.54771,18.29403,1667
31657,239525,B81DEDE33B0853E35D97557F334A4861,60361,0,6,6,109.51938,18.29681,1567
31658,239526,B81DEDE33B0853E35D97557F334A4861,60371,7,11,4,109.53063,18.30056,1618
31659,239527,B81DEDE33B0853E35D97557F334A4861,31931,12,15,3,109.54771,18.29403,1667
31660,239528,B81DEDE33B0853E35D97557F334A4861,60361,19,23,4,109.51938,18.29681,1567
31690,239775,D334753E33AD01D79142036B3D85543F,31561,0,5,5,109.56792,18.28479,1765
31691,239776,D334753E33AD01D79142036B3D85543F,39183,7,9,2,109.55542,18.28208,1715
31692,239777,D334753E33AD01D79142036B3D85543F,31561,11,13,2,109.56792,18.28479,1765
31693,239778,D334753E33AD01D79142036B3D85543F,39183,13,14,1,109.55542,18.28208,1715
31702,239884,A9FCE0049DB44FE004EAFBF5B783F4A5,31945,0,7,7,109.58021,18.29403,1817
31703,239885,A9FCE0049DB44FE004EAFBF5B783F4A5,30854,9,16,7,109.56889,18.27076,1763
31704,239886,A9FCE0049DB44FE004EAFBF5B783F4A5,31945,20,23,3,109.58021,18.29403,1817
31705,239905,E21BDA79D452CC6D5F26BA60A43939EC,38911,0,3,3,109.51674,18.24965,1559
31706,239906,E21BDA79D452CC6D5F26BA60A43939EC,60291,5,6,1,109.50826,18.24639,1509
31707,239907,E21BDA79D452CC6D5F26BA60A43939EC,38911,7,8,1,109.51674,18.24965,1559
31721,239977,84DF4A7C208235D171EF56473BCCF210,30851,0,3,3,109.5616,18.27396,1713
31722,239978,84DF4A7C208235D171EF56473BCCF210,31561,4,7,3,109.56792,18.28479,1765
31723,239979,84DF4A7C208235D171EF56473BCCF210,60631,7,17,10,109.57778,18.27583,1814
31726,239988,1411F9F89E8C658605CC1C5E821DCFD9,31071,1,7,6,109.58257,18.28458,1815
31727,239989,1411F9F89E8C658605CC1C5E821DCFD9,30854,9,15,6,109.56889,18.27076,1763
31728,239990,1411F9F89E8C658605CC1C5E821DCFD9,31071,15,21,6,109.58257,18.28458,1815
31729,239991,1411F9F89E8C658605CC1C5E821DCFD9,30854,22,23,1,109.56889,18.27076,1763
31738,240017,A94F66C88B84FF0658441320CD9F667C,60631,0,5,5,109.57778,18.27583,1814
31739,240018,A94F66C88B84FF0658441320CD9F667C,31071,5,6,1,109.58257,18.28458,1815
31740,240019,A94F66C88B84FF0658441320CD9F667C,30854,8,17,9,109.56889,18.27076,1763
31762,240183,335A7B1DE8538918FDA774EE3E402A76,60087,0,6,6,109.50688,18.22299,1505
31763,240184,335A7B1DE8538918FDA774EE3E402A76,31521,8,10,2,109.51458,18.22542,1555
31764,240185,335A7B1DE8538918FDA774EE3E402A76,60381,10,12,2,109.5241,18.22458,1605
31765,240186,335A7B1DE8538918FDA774EE3E402A76,30191,13,23,10,109.50361,18.22701,1506
31768,240198,9676D231632C729F79D05034B4DCEB1F,38484,2,11,9,109.53028,18.31528,1620
31769,240199,9676D231632C729F79D05034B4DCEB1F,30561,12,14,2,109.52778,18.31938,1621
31770,240200,9676D231632C729F79D05034B4DCEB1F,38484,15,16,1,109.53028,18.31528,1620
31771,240201,9676D231632C729F79D05034B4DCEB1F,30561,19,23,4,109.52778,18.31938,1621
31781,240291,6EF68F35CE79552C1164E70C67C72C02,30121,0,8,8,109.52861,18.27222,1613
31782,240292,6EF68F35CE79552C1164E70C67C72C02,30854,10,19,9,109.56889,18.27076,1763
31783,240293,6EF68F35CE79552C1164E70C67C72C02,38251,20,22,2,109.49618,18.25493,1510
31784,240346,6E2021B014C4D0B652A2E4FE8D2CF038,31071,0,7,7,109.58257,18.28458,1815
31785,240347,6E2021B014C4D0B652A2E4FE8D2CF038,30854,8,15,7,109.56889,18.27076,1763
31786,240348,6E2021B014C4D0B652A2E4FE8D2CF038,60221,19,21,2,109.52569,18.29188,1616
31787,240349,6E2021B014C4D0B652A2E4FE8D2CF038,30721,22,23,1,109.51597,18.28257,1565
31793,240487,C82725A09C032EE9BFF2088FCCC60D1D,30854,3,10,7,109.56889,18.27076,1763
31794,240488,C82725A09C032EE9BFF2088FCCC60D1D,60631,12,14,2,109.57778,18.27583,1814
31795,240489,C82725A09C032EE9BFF2088FCCC60D1D,30854,18,19,1,109.56889,18.27076,1763
31796,240490,C82725A09C032EE9BFF2088FCCC60D1D,60631,19,20,1,109.57778,18.27583,1814
31797,240495,DBB710D279E76C79F1E4B0766F579F8A,31071,0,7,7,109.58257,18.28458,1815
31798,240496,DBB710D279E76C79F1E4B0766F579F8A,30854,8,10,2,109.56889,18.27076,1763
31799,240497,DBB710D279E76C79F1E4B0766F579F8A,31071,12,14,2,109.58257,18.28458,1815
31800,240498,DBB710D279E76C79F1E4B0766F579F8A,30854,15,21,6,109.56889,18.27076,1763
31803,240538,DC29C676832347947F366933ECB88090,31561,0,13,13,109.56792,18.28479,1765
31804,240539,DC29C676832347947F366933ECB88090,39183,16,18,2,109.55542,18.28208,1715
31805,240540,DC29C676832347947F366933ECB88090,31561,21,23,2,109.56792,18.28479,1765
31811,240564,2FE0F3A82C27452F04A6B927F514EFA7,39111,0,1,1,109.5191,18.22597,1555
31812,240565,2FE0F3A82C27452F04A6B927F514EFA7,31551,1,8,7,109.55868,18.24222,1708
31813,240566,2FE0F3A82C27452F04A6B927F514EFA7,31554,13,23,10,109.55521,18.2459,1709
31835,240697,EF24901D99384F703B20FE07F2784FA0,30101,0,11,11,109.57299,18.33333,1773
31836,240698,EF24901D99384F703B20FE07F2784FA0,31631,11,18,7,109.59542,18.36826,1879
31837,240699,EF24901D99384F703B20FE07F2784FA0,30101,18,23,5,109.57299,18.33333,1773
31869,240933,1980C8D409DE9551539224B3D393CDAA,30071,0,2,2,109.52819,18.30472,1619
31870,240934,1980C8D409DE9551539224B3D393CDAA,31951,3,4,1,109.52174,18.30299,1568
31871,240935,1980C8D409DE9551539224B3D393CDAA,30071,5,15,10,109.52819,18.30472,1619
31872,240936,1980C8D409DE9551539224B3D393CDAA,31951,15,19,4,109.52174,18.30299,1568
31880,240968,D9AE11CD16B231308C3F0FB3F53BC3E9,30854,0,12,12,109.56889,18.27076,1763
31881,240969,D9AE11CD16B231308C3F0FB3F53BC3E9,31071,12,14,2,109.58257,18.28458,1815
31882,240970,D9AE11CD16B231308C3F0FB3F53BC3E9,30854,18,23,5,109.56889,18.27076,1763
31885,241010,8B9A9BFD1ACAD480EB101A91DBF2024D,38291,0,15,15,109.51618,18.24313,1558
31886,241011,8B9A9BFD1ACAD480EB101A91DBF2024D,30371,17,20,3,109.51,18.24771,1559
31887,241012,8B9A9BFD1ACAD480EB101A91DBF2024D,30711,21,22,1,109.50271,18.25347,1510
31903,241267,ACAB8C7B92298FFCEC0006246A6D65D6,39183,0,6,6,109.55542,18.28208,1715
31904,241268,ACAB8C7B92298FFCEC0006246A6D65D6,31931,7,9,2,109.54771,18.29403,1667
31905,241269,ACAB8C7B92298FFCEC0006246A6D65D6,39183,11,22,11,109.55542,18.28208,1715
31911,241341,53453D8B736810206EC5A6632D159BE6,31931,0,8,8,109.54771,18.29403,1667
31912,241342,53453D8B736810206EC5A6632D159BE6,60371,8,10,2,109.53063,18.30056,1618
31913,241343,53453D8B736810206EC5A6632D159BE6,31931,12,23,11,109.54771,18.29403,1667
31925,241419,3C1A2536A78CF30193CED5E3EEACBE7E,30851,0,12,12,109.5616,18.27396,1713
31926,241420,3C1A2536A78CF30193CED5E3EEACBE7E,31561,13,16,3,109.56792,18.28479,1765
31927,241421,3C1A2536A78CF30193CED5E3EEACBE7E,30854,17,18,1,109.56889,18.27076,1763
31928,241422,3C1A2536A78CF30193CED5E3EEACBE7E,30851,21,22,1,109.5616,18.27396,1713
31929,241433,9E45264EC835227EA5B2232A2B85D7B9,31521,0,10,10,109.51458,18.22542,1555
31930,241434,9E45264EC835227EA5B2232A2B85D7B9,60381,10,12,2,109.5241,18.22458,1605
31931,241435,9E45264EC835227EA5B2232A2B85D7B9,31521,13,19,6,109.51458,18.22542,1555
31932,241436,9E45264EC835227EA5B2232A2B85D7B9,30731,19,21,2,109.50944,18.22306,1555
31935,241510,40285EE8CCE25C38988EC087545664EC,30854,2,4,2,109.56889,18.27076,1763
31936,241511,40285EE8CCE25C38988EC087545664EC,31071,4,7,3,109.58257,18.28458,1815
31937,241512,40285EE8CCE25C38988EC087545664EC,30854,7,9,2,109.56889,18.27076,1763
31938,241568,3B46764DEE9C1A14D1C3F1D56B4284FD,31931,0,3,3,109.54771,18.29403,1667
31939,241569,3B46764DEE9C1A14D1C3F1D56B4284FD,60361,4,16,12,109.51938,18.29681,1567
31940,241570,3B46764DEE9C1A14D1C3F1D56B4284FD,60241,17,18,1,109.53319,18.28667,1616
31941,241571,3B46764DEE9C1A14D1C3F1D56B4284FD,60361,19,22,3,109.51938,18.29681,1567
31954,241663,85E3E19546A8845252074D0B609723D5,39371,0,14,14,109.56627,18.2646,1762
31955,241664,85E3E19546A8845252074D0B609723D5,30891,14,15,1,109.59431,18.28389,1865
31956,241665,85E3E19546A8845252074D0B609723D5,39371,19,23,4,109.56627,18.2646,1762
31958,241679,8A19D38C67DEBBE2072401E23B2467C5,31161,0,10,10,109.70229,18.31361,2270
31959,241680,8A19D38C67DEBBE2072401E23B2467C5,60114,15,16,1,109.73028,18.33847,2374
31960,241681,8A19D38C67DEBBE2072401E23B2467C5,31161,19,23,4,109.70229,18.31361,2270
31966,241687,CB3A5B3354EA507D300C9FEBE9F524E3,39181,0,16,16,109.55153,18.28035,1715
31967,241688,CB3A5B3354EA507D300C9FEBE9F524E3,30711,20,21,1,109.50271,18.25347,1510
31968,241689,CB3A5B3354EA507D300C9FEBE9F524E3,30911,21,23,2,109.50493,18.26181,1511
31969,241717,033CEEC20746801745CF4A53CD517C31,31821,0,8,8,109.51181,18.24924,1559
31970,241718,033CEEC20746801745CF4A53CD517C31,31181,10,11,1,109.50382,18.24813,1509
31971,241719,033CEEC20746801745CF4A53CD517C31,31821,12,17,5,109.51181,18.24924,1559
31972,241720,033CEEC20746801745CF4A53CD517C31,30281,20,23,3,109.50597,18.27583,1514
31977,241765,E9E473F09C342630187345312F4A31D8,39181,0,8,8,109.55153,18.28035,1715
31978,241766,E9E473F09C342630187345312F4A31D8,39181,10,18,8,109.55153,18.28035,1715
31979,241767,E9E473F09C342630187345312F4A31D8,39181,19,23,4,109.55153,18.28035,1715
31985,241836,00FC332040A284DA251A8D0705989FE9,31071,1,11,10,109.58257,18.28458,1815
31986,241837,00FC332040A284DA251A8D0705989FE9,30854,14,15,1,109.56889,18.27076,1763
31987,241838,00FC332040A284DA251A8D0705989FE9,31071,18,20,2,109.58257,18.28458,1815
31988,241861,81946AFE1D298F3B40176C804AE3EF84,60171,1,3,2,109.51292,18.30694,1569
31989,241862,81946AFE1D298F3B40176C804AE3EF84,31931,7,16,9,109.54771,18.29403,1667
31990,241863,81946AFE1D298F3B40176C804AE3EF84,60171,18,20,2,109.51292,18.30694,1569
31991,241864,81946AFE1D298F3B40176C804AE3EF84,38484,21,22,1,109.53028,18.31528,1620
31996,241895,6FF08122E48AB794FE75A66E236D4C05,31521,0,17,17,109.51458,18.22542,1555
31997,241896,6FF08122E48AB794FE75A66E236D4C05,60381,19,20,1,109.5241,18.22458,1605
31998,241897,6FF08122E48AB794FE75A66E236D4C05,31521,21,23,2,109.51458,18.22542,1555
32003,241947,39F25FE146A03325C93C111F2A943B6C,31945,0,6,6,109.58021,18.29403,1817
32004,241948,39F25FE146A03325C93C111F2A943B6C,31071,10,12,2,109.58257,18.28458,1815
32005,241949,39F25FE146A03325C93C111F2A943B6C,31945,12,13,1,109.58021,18.29403,1817
32006,241950,39F25FE146A03325C93C111F2A943B6C,30854,17,18,1,109.56889,18.27076,1763
32007,241951,58418A9EA4A7DC03127CB79C039A5185,60354,0,13,13,109.58701,18.28521,1815
32008,241952,58418A9EA4A7DC03127CB79C039A5185,30854,15,17,2,109.56889,18.27076,1763
32009,241953,58418A9EA4A7DC03127CB79C039A5185,60354,18,23,5,109.58701,18.28521,1815
32015,242028,14AE6C820CE45F96077630992CABD33D,39371,0,7,7,109.56627,18.2646,1762
32016,242029,14AE6C820CE45F96077630992CABD33D,31421,9,11,2,109.55382,18.22347,1705
32017,242030,14AE6C820CE45F96077630992CABD33D,30951,13,21,8,109.56208,18.25667,1761
32018,242031,14AE6C820CE45F96077630992CABD33D,30851,21,23,2,109.5616,18.27396,1713
32019,242044,DFFF17B7FE30E79B8AABBB5CE171272F,31561,0,13,13,109.56792,18.28479,1765
32020,242045,DFFF17B7FE30E79B8AABBB5CE171272F,39183,14,18,4,109.55542,18.28208,1715
32021,242046,DFFF17B7FE30E79B8AABBB5CE171272F,31561,20,22,2,109.56792,18.28479,1765
32022,242076,D5A941B7629B76426207AF63E861B5B0,31071,0,7,7,109.58257,18.28458,1815
32023,242077,D5A941B7629B76426207AF63E861B5B0,30854,7,9,2,109.56889,18.27076,1763
32024,242078,D5A941B7629B76426207AF63E861B5B0,31071,9,12,3,109.58257,18.28458,1815
32025,242079,D5A941B7629B76426207AF63E861B5B0,30854,12,13,1,109.56889,18.27076,1763
32030,242113,DD386856863F7E131E32C81950505B78,31031,0,8,8,109.49979,18.25382,1510
32031,242115,DD386856863F7E131E32C81950505B78,31031,18,19,1,109.49979,18.25382,1510
32032,242116,DD386856863F7E131E32C81950505B78,60131,21,22,1,109.49819,18.24778,1509
32049,242286,03CEC0FDDD5484124514C6D24A63D4DD,30854,0,2,2,109.56889,18.27076,1763
32050,242287,03CEC0FDDD5484124514C6D24A63D4DD,31561,3,19,16,109.56792,18.28479,1765
32051,242288,03CEC0FDDD5484124514C6D24A63D4DD,30854,20,21,1,109.56889,18.27076,1763
32052,242371,D01D236B816B958BA0840FB83B5A7890,31861,1,7,6,109.49042,18.27549,1464
32053,242372,D01D236B816B958BA0840FB83B5A7890,30171,11,12,1,109.48458,18.27139,1463
32054,242373,D01D236B816B958BA0840FB83B5A7890,31861,13,14,1,109.49042,18.27549,1464
32055,242383,14F1CC63CDA098F9694EAC8584B9C7A5,31071,3,4,1,109.58257,18.28458,1815
32056,242384,14F1CC63CDA098F9694EAC8584B9C7A5,30811,8,9,1,109.65188,18.26257,2062
32057,242385,14F1CC63CDA098F9694EAC8584B9C7A5,31071,13,15,2,109.58257,18.28458,1815
32058,242386,14F1CC63CDA098F9694EAC8584B9C7A5,30854,16,19,3,109.56889,18.27076,1763
32077,242691,DE91F768E6CCDB78867FF54F078574C9,30854,2,12,10,109.56889,18.27076,1763
32078,242692,DE91F768E6CCDB78867FF54F078574C9,60631,15,17,2,109.57778,18.27583,1814
32079,242693,DE91F768E6CCDB78867FF54F078574C9,31421,18,20,2,109.55382,18.22347,1705
32080,242694,F8D799D9161B0143E0D71C40472A357E,30071,0,12,12,109.52819,18.30472,1619
32081,242695,F8D799D9161B0143E0D71C40472A357E,30071,12,18,6,109.52819,18.30472,1619
32082,242696,F8D799D9161B0143E0D71C40472A357E,31951,18,22,4,109.52174,18.30299,1568
32085,242734,7BF65E5054DA81A230AB5423620158E1,60631,2,6,4,109.57778,18.27583,1814
32086,242735,7BF65E5054DA81A230AB5423620158E1,31071,9,10,1,109.58257,18.28458,1815
32087,242736,7BF65E5054DA81A230AB5423620158E1,30854,11,22,11,109.56889,18.27076,1763
32096,242833,AAC7E9546787DDB508C41969C1E453E7,30711,0,8,8,109.50271,18.25347,1510
32097,242834,AAC7E9546787DDB508C41969C1E453E7,60381,13,14,1,109.5241,18.22458,1605
32098,242835,AAC7E9546787DDB508C41969C1E453E7,39154,15,16,1,109.50201,18.25681,1511
32099,242836,AAC7E9546787DDB508C41969C1E453E7,30421,19,21,2,109.50021,18.25861,1511
32100,242882,B84B247FA61A8C12DFCCCF3C2D72006D,31945,2,7,5,109.58021,18.29403,1817
32101,242883,B84B247FA61A8C12DFCCCF3C2D72006D,30854,10,11,1,109.56889,18.27076,1763
32102,242884,B84B247FA61A8C12DFCCCF3C2D72006D,31071,12,14,2,109.58257,18.28458,1815
32103,242903,D17842D1E850E617B4B15889C460D1C5,31931,1,14,13,109.54771,18.29403,1667
32104,242904,D17842D1E850E617B4B15889C460D1C5,30921,17,19,2,109.53903,18.29451,1667
32105,242905,D17842D1E850E617B4B15889C460D1C5,31931,22,23,1,109.54771,18.29403,1667
32122,242943,52626520133C58C019E9712FB19D3224,38171,0,7,7,109.50799,18.28139,1515
32123,242944,52626520133C58C019E9712FB19D3224,30711,10,16,6,109.50271,18.25347,1510
32124,242945,52626520133C58C019E9712FB19D3224,38171,20,23,3,109.50799,18.28139,1515
32128,243015,A2C55049671AD4BF47BD49086A12C13F,30421,0,19,19,109.50021,18.25861,1511
32129,243016,A2C55049671AD4BF47BD49086A12C13F,60381,19,21,2,109.5241,18.22458,1605
32130,243017,A2C55049671AD4BF47BD49086A12C13F,30421,21,23,2,109.50021,18.25861,1511
32134,243113,B2035C0684FF9CA861B7EB217CE5A160,60524,1,7,6,109.42951,18.28993,1216
32135,243114,B2035C0684FF9CA861B7EB217CE5A160,30351,8,18,10,109.41701,18.29292,1217
32136,243115,B2035C0684FF9CA861B7EB217CE5A160,31236,20,21,1,109.42965,18.29111,1216
32137,243116,B2035C0684FF9CA861B7EB217CE5A160,60041,22,23,1,109.39889,18.31944,1121
32138,243124,FD8E83DD7FF39A687AC2462EEEA479A1,30171,0,6,6,109.48458,18.27139,1463
32139,243125,FD8E83DD7FF39A687AC2462EEEA479A1,60401,6,9,3,109.47444,18.27583,1414
32140,243126,FD8E83DD7FF39A687AC2462EEEA479A1,30171,9,11,2,109.48458,18.27139,1463
32187,243598,1B6EBBFF3B9D8A3E18753343B6A29EAE,31071,0,6,6,109.58257,18.28458,1815
32188,243599,1B6EBBFF3B9D8A3E18753343B6A29EAE,31561,8,10,2,109.56792,18.28479,1765
32189,243600,1B6EBBFF3B9D8A3E18753343B6A29EAE,31071,12,14,2,109.58257,18.28458,1815
32190,243601,1B6EBBFF3B9D8A3E18753343B6A29EAE,31561,17,18,1,109.56792,18.28479,1765
32203,243644,68DBE0B52FD0AB95F1DD47068FD7847F,60311,0,14,14,109.52097,18.24319,1558
32204,243645,68DBE0B52FD0AB95F1DD47068FD7847F,30181,15,17,2,109.51597,18.23313,1557
32205,243646,68DBE0B52FD0AB95F1DD47068FD7847F,38291,18,20,2,109.51618,18.24313,1558
32206,243647,68DBE0B52FD0AB95F1DD47068FD7847F,30181,20,21,1,109.51597,18.23313,1557
32207,243657,A8ABE4987042D12DD458C81CFD9663F5,38127,0,7,7,109.50833,18.27222,1513
32208,243658,A8ABE4987042D12DD458C81CFD9663F5,30421,8,13,5,109.50021,18.25861,1511
32209,243659,A8ABE4987042D12DD458C81CFD9663F5,30771,18,20,2,109.49938,18.26042,1511
32210,243660,A8ABE4987042D12DD458C81CFD9663F5,30771,22,23,1,109.49938,18.26042,1511
32217,243754,7E95AEA91A37473FF71C625BDD54FD92,60274,0,6,6,109.514,18.2933,1567
32218,243755,7E95AEA91A37473FF71C625BDD54FD92,60361,6,20,14,109.51938,18.29681,1567
32219,243756,7E95AEA91A37473FF71C625BDD54FD92,60274,20,23,3,109.514,18.2933,1567
32243,244019,7F6E66BC10419161F6457A6D79258EDB,31361,0,8,8,109.47417,18.28292,1415
32244,244020,7F6E66BC10419161F6457A6D79258EDB,60401,8,10,2,109.47444,18.27583,1414
32245,244021,7F6E66BC10419161F6457A6D79258EDB,38251,12,14,2,109.49618,18.25493,1510
32246,244022,7F6E66BC10419161F6457A6D79258EDB,38094,14,15,1,109.45403,18.28778,1316
32247,244037,F941446F9B0207C03AB7C20D9AC6A7F4,31931,0,16,16,109.54771,18.29403,1667
32248,244038,F941446F9B0207C03AB7C20D9AC6A7F4,60371,17,18,1,109.53063,18.30056,1618
32249,244039,F941446F9B0207C03AB7C20D9AC6A7F4,31931,18,23,5,109.54771,18.29403,1667
32269,244217,D4EE8E1A4C04A1FF0596E4221D0B8B42,31071,3,11,8,109.58257,18.28458,1815
32270,244218,D4EE8E1A4C04A1FF0596E4221D0B8B42,30854,11,14,3,109.56889,18.27076,1763
32271,244219,D4EE8E1A4C04A1FF0596E4221D0B8B42,31071,15,16,1,109.58257,18.28458,1815
32272,244220,D4EE8E1A4C04A1FF0596E4221D0B8B42,30854,17,23,6,109.56889,18.27076,1763
32294,244338,9B389AE8E9B004176803CCEAFF69104A,39371,0,5,5,109.56627,18.2646,1762
32295,244339,9B389AE8E9B004176803CCEAFF69104A,30951,7,15,8,109.56208,18.25667,1761
32296,244340,9B389AE8E9B004176803CCEAFF69104A,60631,16,18,2,109.57778,18.27583,1814
32297,244341,9B389AE8E9B004176803CCEAFF69104A,39371,22,23,1,109.56627,18.2646,1762
32318,244457,17D13F6A66037B54FAB5668CDC734401,30721,0,7,7,109.51597,18.28257,1565
32319,244458,17D13F6A66037B54FAB5668CDC734401,31931,7,18,11,109.54771,18.29403,1667
32320,244459,17D13F6A66037B54FAB5668CDC734401,30721,20,22,2,109.51597,18.28257,1565
32332,244585,1E1181D91A7FDEE2449092386CA6A77C,60041,0,6,6,109.39889,18.31944,1121
32333,244586,1E1181D91A7FDEE2449092386CA6A77C,60552,6,8,2,109.41729,18.30014,1218
32334,244587,1E1181D91A7FDEE2449092386CA6A77C,60041,11,13,2,109.39889,18.31944,1121
32335,244600,8621CFDF1B89A83351494618C53D033F,39181,1,6,5,109.55153,18.28035,1715
32336,244601,8621CFDF1B89A83351494618C53D033F,31071,9,18,9,109.58257,18.28458,1815
32337,244602,8621CFDF1B89A83351494618C53D033F,30851,20,22,2,109.5616,18.27396,1713
32338,244603,3E0CC1F431A959DE24ABB41EC7702F6D,60524,3,8,5,109.42951,18.28993,1216
32339,244604,3E0CC1F431A959DE24ABB41EC7702F6D,30351,12,13,1,109.41701,18.29292,1217
32340,244605,3E0CC1F431A959DE24ABB41EC7702F6D,31231,15,18,3,109.42597,18.29292,1217
32341,244606,3E0CC1F431A959DE24ABB41EC7702F6D,30351,22,23,1,109.41701,18.29292,1217
32357,244682,63CB222117AB8A54673799718246EF46,30084,2,9,7,109.50118,18.26972,1513
32358,244683,63CB222117AB8A54673799718246EF46,30081,12,15,3,109.50243,18.26632,1512
32359,244684,63CB222117AB8A54673799718246EF46,30711,16,18,2,109.50271,18.25347,1510
32360,244685,63CB222117AB8A54673799718246EF46,30084,20,21,1,109.50118,18.26972,1513
32361,244698,703AD9701692A79156581C270F9F1324,31221,0,5,5,109.61333,18.26833,1913
32362,244700,703AD9701692A79156581C270F9F1324,31221,10,15,5,109.61333,18.26833,1913
32363,244701,703AD9701692A79156581C270F9F1324,60594,18,19,1,109.62694,18.22799,1956
32364,244702,703AD9701692A79156581C270F9F1324,30581,20,21,1,109.62257,18.24951,1959
32369,244850,754661A1CBF0E640F6CB66845B93104E,60661,0,6,6,109.548,18.2377,1657
32370,244851,754661A1CBF0E640F6CB66845B93104E,60641,7,8,1,109.53854,18.2359,1657
32371,244852,754661A1CBF0E640F6CB66845B93104E,60661,13,23,10,109.548,18.2377,1657
32374,244890,4E8A1FFC680701A862F9A60D8BF0780C,38162,0,8,8,109.43944,18.28889,1266
32375,244891,4E8A1FFC680701A862F9A60D8BF0780C,31701,9,18,9,109.44132,18.28833,1266
32376,244892,4E8A1FFC680701A862F9A60D8BF0780C,38162,20,21,1,109.43944,18.28889,1266
32377,244893,4E8A1FFC680701A862F9A60D8BF0780C,60472,22,23,1,109.46625,18.29542,1367
32378,244897,878FC5EBB1B28FAABA6E6BFD01664318,30251,0,7,7,109.50611,18.26653,1512
32379,244898,878FC5EBB1B28FAABA6E6BFD01664318,30711,8,10,2,109.50271,18.25347,1510
32380,244899,878FC5EBB1B28FAABA6E6BFD01664318,30251,12,17,5,109.50611,18.26653,1512
32381,244900,878FC5EBB1B28FAABA6E6BFD01664318,31031,20,21,1,109.49979,18.25382,1510
32382,244915,CD3BCBAB8571FB81953C842A434E5DB8,31071,0,6,6,109.58257,18.28458,1815
32383,244916,CD3BCBAB8571FB81953C842A434E5DB8,30854,6,13,7,109.56889,18.27076,1763
32384,244917,CD3BCBAB8571FB81953C842A434E5DB8,31071,14,16,2,109.58257,18.28458,1815
32385,244918,CD3BCBAB8571FB81953C842A434E5DB8,30854,16,20,4,109.56889,18.27076,1763
32391,245000,92387D10E48410A653E7FED699DEDE76,39183,0,6,6,109.55542,18.28208,1715
32392,245001,92387D10E48410A653E7FED699DEDE76,31071,7,8,1,109.58257,18.28458,1815
32393,245002,92387D10E48410A653E7FED699DEDE76,30851,12,13,1,109.5616,18.27396,1713
32399,245068,CD83F2F70DCDDC76ED162E9187E37A88,39183,0,9,9,109.55542,18.28208,1715
32400,245069,CD83F2F70DCDDC76ED162E9187E37A88,31931,11,17,6,109.54771,18.29403,1667
32401,245070,CD83F2F70DCDDC76ED162E9187E37A88,31561,21,23,2,109.56792,18.28479,1765
32402,245071,909FBB0C84910641E7440FBAD40E8C52,39183,0,8,8,109.55542,18.28208,1715
32403,245072,909FBB0C84910641E7440FBAD40E8C52,31071,11,14,3,109.58257,18.28458,1815
32404,245073,909FBB0C84910641E7440FBAD40E8C52,30851,15,17,2,109.5616,18.27396,1713
32409,245126,AE6DC7ACB81DB5F351E45AC25E5F5A3B,31206,0,2,2,109.50819,18.23549,1507
32410,245127,AE6DC7ACB81DB5F351E45AC25E5F5A3B,38297,4,7,3,109.52576,18.24965,1609
32411,245128,AE6DC7ACB81DB5F351E45AC25E5F5A3B,30771,8,10,2,109.49938,18.26042,1511
32412,245129,AE6DC7ACB81DB5F351E45AC25E5F5A3B,38297,12,23,11,109.52576,18.24965,1609
32421,245163,0402BD114B7D5E20705E302B756CD062,60631,0,7,7,109.57778,18.27583,1814
32422,245164,0402BD114B7D5E20705E302B756CD062,31071,8,9,1,109.58257,18.28458,1815
32423,245165,0402BD114B7D5E20705E302B756CD062,30854,11,20,9,109.56889,18.27076,1763
32437,245241,0312B43ACF9ED1D8304E325E851AEE29,31561,3,13,10,109.56792,18.28479,1765
32438,245242,0312B43ACF9ED1D8304E325E851AEE29,30851,15,16,1,109.5616,18.27396,1713
32439,245243,0312B43ACF9ED1D8304E325E851AEE29,31561,16,17,1,109.56792,18.28479,1765
32440,245244,0312B43ACF9ED1D8304E325E851AEE29,30851,21,23,2,109.5616,18.27396,1713
32457,245409,7EB4F76900011DECC835981CBE847D5E,31561,0,1,1,109.56792,18.28479,1765
32458,245410,7EB4F76900011DECC835981CBE847D5E,30854,2,5,3,109.56889,18.27076,1763
32459,245411,7EB4F76900011DECC835981CBE847D5E,31561,6,16,10,109.56792,18.28479,1765
32462,245446,8265A029C672FE0377EF574CC3ADF2A8,30854,0,6,6,109.56889,18.27076,1763
32463,245447,8265A029C672FE0377EF574CC3ADF2A8,39181,7,8,1,109.55153,18.28035,1715
32464,245448,8265A029C672FE0377EF574CC3ADF2A8,39183,8,10,2,109.55542,18.28208,1715
32465,245449,8265A029C672FE0377EF574CC3ADF2A8,30854,11,14,3,109.56889,18.27076,1763
32471,245533,348364DAC537A5A7729C356B64D64B52,39183,0,6,6,109.55542,18.28208,1715
32472,245534,348364DAC537A5A7729C356B64D64B52,39181,6,10,4,109.55153,18.28035,1715
32473,245535,348364DAC537A5A7729C356B64D64B52,31931,11,13,2,109.54771,18.29403,1667
32474,245536,348364DAC537A5A7729C356B64D64B52,31561,15,16,1,109.56792,18.28479,1765
32479,245543,A8B250EB4B4FCB9AA28B7DB7DA08558B,38157,3,4,1,109.51483,18.26958,1563
32480,245544,A8B250EB4B4FCB9AA28B7DB7DA08558B,31931,8,9,1,109.54771,18.29403,1667
32481,245545,A8B250EB4B4FCB9AA28B7DB7DA08558B,30854,14,15,1,109.56889,18.27076,1763
32482,245577,E292D83051830D054E89D209EEABA4B9,31071,0,9,9,109.58257,18.28458,1815
32483,245578,E292D83051830D054E89D209EEABA4B9,31561,11,19,8,109.56792,18.28479,1765
32484,245579,E292D83051830D054E89D209EEABA4B9,30854,22,23,1,109.56889,18.27076,1763
32487,245619,372BCC9E34709FCD9ED7D887E115E777,31561,1,6,5,109.56792,18.28479,1765
32488,245620,372BCC9E34709FCD9ED7D887E115E777,30854,7,10,3,109.56889,18.27076,1763
32489,245621,372BCC9E34709FCD9ED7D887E115E777,31561,12,22,10,109.56792,18.28479,1765
32494,245722,EFDE35289FEC1E13D6F34EFEE66A8AD2,60631,0,7,7,109.57778,18.27583,1814
32495,245723,EFDE35289FEC1E13D6F34EFEE66A8AD2,30854,7,17,10,109.56889,18.27076,1763
32496,245724,EFDE35289FEC1E13D6F34EFEE66A8AD2,60631,19,23,4,109.57778,18.27583,1814
32500,245737,DA10676C4DA702E02A2C3FFFAC40ABA2,31561,0,7,7,109.56792,18.28479,1765
32501,245738,DA10676C4DA702E02A2C3FFFAC40ABA2,39371,11,12,1,109.56627,18.2646,1762
32502,245739,DA10676C4DA702E02A2C3FFFAC40ABA2,31561,13,23,10,109.56792,18.28479,1765
32512,245920,C709D01469E0800AF998DFAF42105CDC,30854,0,6,6,109.56889,18.27076,1763
32513,245921,C709D01469E0800AF998DFAF42105CDC,31561,6,15,9,109.56792,18.28479,1765
32514,245922,C709D01469E0800AF998DFAF42105CDC,30854,18,21,3,109.56889,18.27076,1763
32515,245943,FA14B010F60C7FB3B13194FAA13740E8,31561,0,13,13,109.56792,18.28479,1765
32516,245944,FA14B010F60C7FB3B13194FAA13740E8,30851,14,16,2,109.5616,18.27396,1713
32517,245945,FA14B010F60C7FB3B13194FAA13740E8,31561,16,17,1,109.56792,18.28479,1765
32518,245946,FA14B010F60C7FB3B13194FAA13740E8,30854,21,22,1,109.56889,18.27076,1763
32519,245954,451E2BF48CD7B253EB0892324E679BCC,38291,3,5,2,109.51618,18.24313,1558
32520,245955,451E2BF48CD7B253EB0892324E679BCC,60281,9,19,10,109.51743,18.25924,1561
32521,245956,451E2BF48CD7B253EB0892324E679BCC,38297,20,21,1,109.52576,18.24965,1609
32526,245997,B0EA82CA44F2A5DBEC337F9E5C778FEC,39183,0,8,8,109.55542,18.28208,1715
32527,245998,B0EA82CA44F2A5DBEC337F9E5C778FEC,39181,8,10,2,109.55153,18.28035,1715
32528,245999,B0EA82CA44F2A5DBEC337F9E5C778FEC,31931,14,15,1,109.54771,18.29403,1667
32535,246110,2C3BD53A8702A47FB82F05FB4993B683,31561,0,13,13,109.56792,18.28479,1765
32536,246111,2C3BD53A8702A47FB82F05FB4993B683,30854,16,17,1,109.56889,18.27076,1763
32537,246112,2C3BD53A8702A47FB82F05FB4993B683,31561,18,23,5,109.56792,18.28479,1765
32559,246246,810CE53DFCE3F9F9B1D54C13B89D4921,30504,0,7,7,109.705,18.35368,2277
32560,246248,810CE53DFCE3F9F9B1D54C13B89D4921,30504,15,18,3,109.705,18.35368,2277
32561,246249,810CE53DFCE3F9F9B1D54C13B89D4921,60117,18,23,5,109.73604,18.35681,2427
32578,246361,CD576F1C1CDFB89E6A99A20E65927346,30854,0,13,13,109.56889,18.27076,1763
32579,246362,CD576F1C1CDFB89E6A99A20E65927346,31071,15,17,2,109.58257,18.28458,1815
32580,246363,CD576F1C1CDFB89E6A99A20E65927346,30854,17,23,6,109.56889,18.27076,1763
32581,246370,2E4974DC6B5DC914D4BEF4B8CF2CC13B,31081,0,7,7,109.44639,18.30181,1318
32582,246371,2E4974DC6B5DC914D4BEF4B8CF2CC13B,60391,7,15,8,109.47667,18.28757,1416
32583,246372,2E4974DC6B5DC914D4BEF4B8CF2CC13B,31081,18,23,5,109.44639,18.30181,1318
32586,246401,B712327B6033C61F37801CFD6DAC08AD,38484,0,11,11,109.53028,18.31528,1620
32587,246402,B712327B6033C61F37801CFD6DAC08AD,38484,14,16,2,109.53028,18.31528,1620
32588,246403,B712327B6033C61F37801CFD6DAC08AD,38484,19,23,4,109.53028,18.31528,1620
32591,246433,DF296B63A64E364FCDA4C38B0935EEEE,30511,0,1,1,109.51069,18.24208,1558
32592,246434,DF296B63A64E364FCDA4C38B0935EEEE,30151,4,10,6,109.50986,18.25083,1560
32593,246435,DF296B63A64E364FCDA4C38B0935EEEE,30511,11,23,12,109.51069,18.24208,1558
32596,246521,09605A95AE7BE30FC92DC699DB3FCBD0,31861,0,2,2,109.49042,18.27549,1464
32597,246522,09605A95AE7BE30FC92DC699DB3FCBD0,30711,2,12,10,109.50271,18.25347,1510
32598,246523,09605A95AE7BE30FC92DC699DB3FCBD0,31461,15,16,1,109.5091,18.25389,1510
32599,246524,09605A95AE7BE30FC92DC699DB3FCBD0,31181,19,23,4,109.50382,18.24813,1509
32602,246584,B78E7295CB13532B4E2C30EF158E297F,30854,0,3,3,109.56889,18.27076,1763
32603,246585,B78E7295CB13532B4E2C30EF158E297F,31931,4,14,10,109.54771,18.29403,1667
32604,246586,B78E7295CB13532B4E2C30EF158E297F,30854,16,18,2,109.56889,18.27076,1763
32605,246587,B78E7295CB13532B4E2C30EF158E297F,31561,19,20,1,109.56792,18.28479,1765
32613,246714,686A151A10363ED54A6F439954DA26E0,31761,0,3,3,109.60521,18.27965,1914
32614,246716,686A151A10363ED54A6F439954DA26E0,38052,8,9,1,109.62618,18.23042,1956
32615,246717,686A151A10363ED54A6F439954DA26E0,30441,14,21,7,109.64021,18.25424,2010
32616,246718,686A151A10363ED54A6F439954DA26E0,60594,22,23,1,109.62694,18.22799,1956
32622,246811,0F09C2BE6A190F4BF3D635D6A9F19FD3,60661,0,7,7,109.548,18.2377,1657
32623,246812,0F09C2BE6A190F4BF3D635D6A9F19FD3,30121,11,16,5,109.52861,18.27222,1613
32624,246813,0F09C2BE6A190F4BF3D635D6A9F19FD3,38291,21,23,2,109.51618,18.24313,1558
32630,246851,560794A44CA17A43FA34D0FA6C339747,30854,0,6,6,109.56889,18.27076,1763
32631,246852,560794A44CA17A43FA34D0FA6C339747,39104,10,12,2,109.50104,18.2525,1510
32632,246853,560794A44CA17A43FA34D0FA6C339747,31071,15,16,1,109.58257,18.28458,1815
32633,246854,560794A44CA17A43FA34D0FA6C339747,30854,16,17,1,109.56889,18.27076,1763
32638,246870,608A55C14BAB2A5B627ACC1F39B89FB6,31945,0,7,7,109.58021,18.29403,1817
32639,246871,608A55C14BAB2A5B627ACC1F39B89FB6,30854,9,19,10,109.56889,18.27076,1763
32640,246872,608A55C14BAB2A5B627ACC1F39B89FB6,31071,21,22,1,109.58257,18.28458,1815
32641,246951,10EBF762D28520B09848288F7052CFDE,30854,5,7,2,109.56889,18.27076,1763
32642,246952,10EBF762D28520B09848288F7052CFDE,30711,7,8,1,109.50271,18.25347,1510
32643,246953,10EBF762D28520B09848288F7052CFDE,39101,9,23,14,109.50132,18.24931,1509
32645,247015,7C44F60024D8983C8531DB7CE2E3A44C,38961,1,2,1,109.50847,18.23514,1507
32646,247016,7C44F60024D8983C8531DB7CE2E3A44C,30181,2,4,2,109.51597,18.23313,1557
32647,247017,7C44F60024D8983C8531DB7CE2E3A44C,39191,5,7,2,109.51493,18.23472,1557
32653,247032,DF5348A8E25901EBB63BBF3F6126BB02,31761,1,2,1,109.60521,18.27965,1914
32654,247033,DF5348A8E25901EBB63BBF3F6126BB02,31071,4,15,11,109.58257,18.28458,1815
32655,247034,DF5348A8E25901EBB63BBF3F6126BB02,30854,18,23,5,109.56889,18.27076,1763
32658,247077,CF73D0D52A41EE420FB8269A6F6AF679,30854,2,4,2,109.56889,18.27076,1763
32659,247078,CF73D0D52A41EE420FB8269A6F6AF679,30441,4,6,2,109.64021,18.25424,2010
32660,247079,CF73D0D52A41EE420FB8269A6F6AF679,30854,6,7,1,109.56889,18.27076,1763
32661,247080,13A373BC775CFA4B513754EBD5FDCB11,31021,0,8,8,109.49021,18.27,1463
32662,247081,13A373BC775CFA4B513754EBD5FDCB11,60311,12,14,2,109.52097,18.24319,1558
32663,247082,13A373BC775CFA4B513754EBD5FDCB11,38297,15,18,3,109.52576,18.24965,1609
32664,247083,13A373BC775CFA4B513754EBD5FDCB11,31021,20,23,3,109.49021,18.27,1463
32665,247110,FD383D619F571E97F6F509FAB965E5A5,60571,0,15,15,109.50722,18.25056,1510
32666,247111,FD383D619F571E97F6F509FAB965E5A5,31171,16,17,1,109.50938,18.24917,1559
32667,247112,FD383D619F571E97F6F509FAB965E5A5,60641,19,21,2,109.53854,18.2359,1657
32672,247120,0F558B6653C655C7F0BAEA9D66B33F57,31071,1,6,5,109.58257,18.28458,1815
32673,247121,0F558B6653C655C7F0BAEA9D66B33F57,30854,9,17,8,109.56889,18.27076,1763
32674,247122,0F558B6653C655C7F0BAEA9D66B33F57,31071,19,20,1,109.58257,18.28458,1815
32675,247126,1026894DC5FF9A7FAF3A2EE28B95E239,39183,2,5,3,109.55542,18.28208,1715
32676,247127,1026894DC5FF9A7FAF3A2EE28B95E239,30854,7,8,1,109.56889,18.27076,1763
32677,247128,1026894DC5FF9A7FAF3A2EE28B95E239,30891,12,14,2,109.59431,18.28389,1865
32678,247129,1026894DC5FF9A7FAF3A2EE28B95E239,30854,16,22,6,109.56889,18.27076,1763
32679,247132,209BA418BA15162F274A1DAAB6F56238,39181,0,5,5,109.55153,18.28035,1715
32680,247133,209BA418BA15162F274A1DAAB6F56238,39181,5,10,5,109.55153,18.28035,1715
32681,247134,209BA418BA15162F274A1DAAB6F56238,31561,14,16,2,109.56792,18.28479,1765
32682,247135,209BA418BA15162F274A1DAAB6F56238,31931,20,22,2,109.54771,18.29403,1667
32702,247212,E377A804A4E01831C27E7EA806A7C42A,31864,0,5,5,109.49014,18.28333,1465
32703,247213,E377A804A4E01831C27E7EA806A7C42A,31361,6,19,13,109.47417,18.28292,1415
32704,247214,E377A804A4E01831C27E7EA806A7C42A,31864,20,23,3,109.49014,18.28333,1465
32718,247282,62893E04FCF540C6F38C23E5C7023557,31351,0,8,8,109.4959,18.28417,1465
32719,247283,62893E04FCF540C6F38C23E5C7023557,31931,11,16,5,109.54771,18.29403,1667
32720,247284,62893E04FCF540C6F38C23E5C7023557,31351,18,23,5,109.4959,18.28417,1465
32725,247325,C1602FB5A20BD98313F7CC13F431D061,30271,0,7,7,109.49132,18.23153,1456
32726,247326,C1602FB5A20BD98313F7CC13F431D061,30771,9,10,1,109.49938,18.26042,1511
32727,247327,C1602FB5A20BD98313F7CC13F431D061,30421,11,14,3,109.50021,18.25861,1511
32733,247337,BD4652414D5C17466BA36FD4BD943A94,60221,0,6,6,109.52569,18.29188,1616
32734,247338,BD4652414D5C17466BA36FD4BD943A94,39183,8,9,1,109.55542,18.28208,1715
32735,247339,BD4652414D5C17466BA36FD4BD943A94,31931,12,14,2,109.54771,18.29403,1667
32739,247390,96F3F18E296FC5227B6BB34F58650A63,60524,0,8,8,109.42951,18.28993,1216
32740,247391,96F3F18E296FC5227B6BB34F58650A63,31471,11,14,3,109.34583,18.29563,917
32741,247392,96F3F18E296FC5227B6BB34F58650A63,60524,16,23,7,109.42951,18.28993,1216
32742,247414,EBD33964FCE275C1E00E1A22DCBD8F60,30921,0,6,6,109.53903,18.29451,1667
32743,247415,EBD33964FCE275C1E00E1A22DCBD8F60,31931,8,10,2,109.54771,18.29403,1667
32744,247416,EBD33964FCE275C1E00E1A22DCBD8F60,60241,12,18,6,109.53319,18.28667,1616
32745,247421,528F99F7FD8CA49B85B45B64A5D784BA,39183,2,4,2,109.55542,18.28208,1715
32746,247422,528F99F7FD8CA49B85B45B64A5D784BA,30851,5,8,3,109.5616,18.27396,1713
32747,247423,528F99F7FD8CA49B85B45B64A5D784BA,31561,10,16,6,109.56792,18.28479,1765
32748,247424,528F99F7FD8CA49B85B45B64A5D784BA,30851,19,20,1,109.5616,18.27396,1713
32751,247454,6128117B6C62D97BBF6E959D2F3E0A2E,39183,0,5,5,109.55542,18.28208,1715
32752,247455,6128117B6C62D97BBF6E959D2F3E0A2E,31931,6,7,1,109.54771,18.29403,1667
32753,247456,6128117B6C62D97BBF6E959D2F3E0A2E,31561,11,13,2,109.56792,18.28479,1765
32755,247489,BC2EDF4DF9C7FAD55BDEABA03DFA7284,31561,0,5,5,109.56792,18.28479,1765
32756,247490,BC2EDF4DF9C7FAD55BDEABA03DFA7284,30851,6,15,9,109.5616,18.27396,1713
32757,247491,BC2EDF4DF9C7FAD55BDEABA03DFA7284,31561,19,23,4,109.56792,18.28479,1765
32758,247500,91B67A451BCA48674F80C454F3D349F4,39181,0,6,6,109.55153,18.28035,1715
32759,247501,91B67A451BCA48674F80C454F3D349F4,31931,7,18,11,109.54771,18.29403,1667
32760,247502,91B67A451BCA48674F80C454F3D349F4,60361,20,22,2,109.51938,18.29681,1567
32779,247627,75817DB682187A07461734D66E1E6492,60631,0,4,4,109.57778,18.27583,1814
32780,247628,75817DB682187A07461734D66E1E6492,30854,6,17,11,109.56889,18.27076,1763
32781,247629,75817DB682187A07461734D66E1E6492,60631,21,23,2,109.57778,18.27583,1814
32787,247654,86B53E128647666CEA9BD4D18A34AC90,60084,5,18,13,109.4984,18.2334,1507
32788,247655,86B53E128647666CEA9BD4D18A34AC90,38127,19,20,1,109.50833,18.27222,1513
32789,247656,86B53E128647666CEA9BD4D18A34AC90,31206,21,23,2,109.50819,18.23549,1507
32799,247685,34F3D64B41C252481F72E5CF931AC833,30854,1,10,9,109.56889,18.27076,1763
32800,247686,34F3D64B41C252481F72E5CF931AC833,31071,11,12,1,109.58257,18.28458,1815
32801,247687,34F3D64B41C252481F72E5CF931AC833,30851,17,18,1,109.5616,18.27396,1713
32808,247727,BAB9B8A3D1E7FB96DB94A06687C464B3,60504,0,14,14,109.47917,18.28903,1416
32809,247728,BAB9B8A3D1E7FB96DB94A06687C464B3,60524,16,19,3,109.42951,18.28993,1216
32810,247729,BAB9B8A3D1E7FB96DB94A06687C464B3,60504,22,23,1,109.47917,18.28903,1416
32813,247761,C19430CE8DF26BDEF43903E57E682236,31561,0,6,6,109.56792,18.28479,1765
32814,247762,C19430CE8DF26BDEF43903E57E682236,30854,9,11,2,109.56889,18.27076,1763
32815,247763,C19430CE8DF26BDEF43903E57E682236,31561,14,23,9,109.56792,18.28479,1765
32816,247778,17A4545370685D172A08774EFEF86DD3,31071,0,3,3,109.58257,18.28458,1815
32817,247779,17A4545370685D172A08774EFEF86DD3,30851,3,6,3,109.5616,18.27396,1713
32818,247780,17A4545370685D172A08774EFEF86DD3,39181,6,10,4,109.55153,18.28035,1715
32819,247826,B643AC77F8D8498A9694D45BA8B0F75F,31561,4,5,1,109.56792,18.28479,1765
32820,247827,B643AC77F8D8498A9694D45BA8B0F75F,60631,6,15,9,109.57778,18.27583,1814
32821,247828,B643AC77F8D8498A9694D45BA8B0F75F,31071,20,21,1,109.58257,18.28458,1815
32822,247862,F73DB45474E9091AA79E623BDF11C321,39181,0,10,10,109.55153,18.28035,1715
32823,247863,F73DB45474E9091AA79E623BDF11C321,31561,10,14,4,109.56792,18.28479,1765
32824,247864,F73DB45474E9091AA79E623BDF11C321,30851,14,16,2,109.5616,18.27396,1713
32825,247865,F73DB45474E9091AA79E623BDF11C321,31561,19,23,4,109.56792,18.28479,1765
32837,248061,6F0540B756080DEA0630ADD22B34EFCA,30371,0,8,8,109.51,18.24771,1559
32838,248062,6F0540B756080DEA0630ADD22B34EFCA,38801,8,17,9,109.51472,18.2584,1561
32839,248063,6F0540B756080DEA0630ADD22B34EFCA,39154,18,21,3,109.50201,18.25681,1511
32840,248064,6F0540B756080DEA0630ADD22B34EFCA,30371,22,23,1,109.51,18.24771,1559
32843,248073,B340EDEF4A878E8DF5CBEC25E465EACE,60281,0,1,1,109.51743,18.25924,1561
32844,248074,B340EDEF4A878E8DF5CBEC25E465EACE,31071,4,6,2,109.58257,18.28458,1815
32845,248075,B340EDEF4A878E8DF5CBEC25E465EACE,30854,8,23,15,109.56889,18.27076,1763
32865,248189,292F7AA5A13D44513985CC059AB0B0E9,31071,0,6,6,109.58257,18.28458,1815
32866,248190,292F7AA5A13D44513985CC059AB0B0E9,30854,10,12,2,109.56889,18.27076,1763
32867,248191,292F7AA5A13D44513985CC059AB0B0E9,31071,13,14,1,109.58257,18.28458,1815
32868,248192,292F7AA5A13D44513985CC059AB0B0E9,30854,18,20,2,109.56889,18.27076,1763
32886,248289,770A00BDAFE9BCA8C9E9FA68066EED7D,31071,0,6,6,109.58257,18.28458,1815
32887,248290,770A00BDAFE9BCA8C9E9FA68066EED7D,31561,9,20,11,109.56792,18.28479,1765
32888,248291,770A00BDAFE9BCA8C9E9FA68066EED7D,31071,21,22,1,109.58257,18.28458,1815
32892,248340,F5FE23BF42FC224C310CD42E08B0B950,31431,0,9,9,109.44639,18.29042,1316
32893,248341,F5FE23BF42FC224C310CD42E08B0B950,38094,9,14,5,109.45403,18.28778,1316
32894,248342,F5FE23BF42FC224C310CD42E08B0B950,60441,14,16,2,109.46792,18.28604,1366
32895,248343,F5FE23BF42FC224C310CD42E08B0B950,31431,18,22,4,109.44639,18.29042,1316
32905,248463,94C4D5691F7DFC1AB38806AFFAC1389E,31931,0,15,15,109.54771,18.29403,1667
32906,248464,94C4D5691F7DFC1AB38806AFFAC1389E,60241,16,17,1,109.53319,18.28667,1616
32907,248465,94C4D5691F7DFC1AB38806AFFAC1389E,31931,17,18,1,109.54771,18.29403,1667
32916,248499,9FC721E86703223349C05C95FE4BBB6F,60081,0,9,9,109.51097,18.22639,1556
32917,248500,9FC721E86703223349C05C95FE4BBB6F,60381,11,16,5,109.5241,18.22458,1605
32918,248501,9FC721E86703223349C05C95FE4BBB6F,31521,16,20,4,109.51458,18.22542,1555
32919,248502,9FC721E86703223349C05C95FE4BBB6F,60087,21,23,2,109.50688,18.22299,1505
32920,248542,A68637AA89BD62624E677D9E66C32FAD,31391,0,5,5,109.50382,18.24285,1508
32921,248543,A68637AA89BD62624E677D9E66C32FAD,30161,5,10,5,109.50042,18.24389,1508
32922,248544,A68637AA89BD62624E677D9E66C32FAD,30161,14,16,2,109.50042,18.24389,1508
32923,248545,A68637AA89BD62624E677D9E66C32FAD,30161,17,23,6,109.50042,18.24389,1508
32924,248546,0989A1FA83098A129EC9A63DDE064266,31071,0,1,1,109.58257,18.28458,1815
32925,248547,0989A1FA83098A129EC9A63DDE064266,31761,3,4,1,109.60521,18.27965,1914
32926,248548,0989A1FA83098A129EC9A63DDE064266,31071,6,12,6,109.58257,18.28458,1815
32927,248549,0989A1FA83098A129EC9A63DDE064266,30854,13,14,1,109.56889,18.27076,1763
32931,248576,CFCFA94681CDD57855D6405C244168DD,38891,0,1,1,109.51486,18.24118,1558
32932,248577,CFCFA94681CDD57855D6405C244168DD,31201,5,17,12,109.51042,18.23819,1558
32933,248578,CFCFA94681CDD57855D6405C244168DD,38891,20,22,2,109.51486,18.24118,1558
32949,248761,1472501D05A1FAACE24DF762AD55D1B1,38052,5,11,6,109.62618,18.23042,1956
32950,248762,1472501D05A1FAACE24DF762AD55D1B1,60594,15,17,2,109.62694,18.22799,1956
32951,248763,1472501D05A1FAACE24DF762AD55D1B1,38052,18,23,5,109.62618,18.23042,1956
32969,248921,AD64464DD39A90A4C30F70259EC094DF,39181,0,7,7,109.55153,18.28035,1715
32970,248922,AD64464DD39A90A4C30F70259EC094DF,39181,8,10,2,109.55153,18.28035,1715
32971,248923,AD64464DD39A90A4C30F70259EC094DF,31931,14,19,5,109.54771,18.29403,1667
32978,248930,201045A9C980BD8E53B16B9129DFE596,30854,0,1,1,109.56889,18.27076,1763
32979,248931,201045A9C980BD8E53B16B9129DFE596,31071,6,15,9,109.58257,18.28458,1815
32980,248932,201045A9C980BD8E53B16B9129DFE596,30854,16,17,1,109.56889,18.27076,1763
32981,248933,201045A9C980BD8E53B16B9129DFE596,31071,17,18,1,109.58257,18.28458,1815
32986,248938,84DF4A7C208235D171EF56473BCCF210,30851,0,5,5,109.5616,18.27396,1713
32987,248939,84DF4A7C208235D171EF56473BCCF210,31561,6,7,1,109.56792,18.28479,1765
32988,248940,84DF4A7C208235D171EF56473BCCF210,60631,7,19,12,109.57778,18.27583,1814
32989,248941,84DF4A7C208235D171EF56473BCCF210,30851,19,20,1,109.5616,18.27396,1713
32996,248954,1411F9F89E8C658605CC1C5E821DCFD9,31071,0,3,3,109.58257,18.28458,1815
32997,248955,1411F9F89E8C658605CC1C5E821DCFD9,31071,4,8,4,109.58257,18.28458,1815
32998,248956,1411F9F89E8C658605CC1C5E821DCFD9,30854,10,23,13,109.56889,18.27076,1763
33001,248989,A94F66C88B84FF0658441320CD9F667C,60631,0,14,14,109.57778,18.27583,1814
33002,248990,A94F66C88B84FF0658441320CD9F667C,30854,14,21,7,109.56889,18.27076,1763
33003,248991,A94F66C88B84FF0658441320CD9F667C,31071,21,23,2,109.58257,18.28458,1815
33013,249038,BE586ACB441383CC10D7CF3923850B73,31931,0,13,13,109.54771,18.29403,1667
33014,249039,BE586ACB441383CC10D7CF3923850B73,30851,14,17,3,109.5616,18.27396,1713
33015,249040,BE586ACB441383CC10D7CF3923850B73,31931,20,23,3,109.54771,18.29403,1667
33029,249109,F00821368F615DCDAF214035D8EC4A44,31071,0,6,6,109.58257,18.28458,1815
33030,249110,F00821368F615DCDAF214035D8EC4A44,30854,10,16,6,109.56889,18.27076,1763
33031,249111,F00821368F615DCDAF214035D8EC4A44,60221,16,17,1,109.52569,18.29188,1616
33032,249143,96F98526707B06BE1263CCD4F72E07A1,31071,0,7,7,109.58257,18.28458,1815
33033,249144,96F98526707B06BE1263CCD4F72E07A1,31071,10,11,1,109.58257,18.28458,1815
33034,249145,96F98526707B06BE1263CCD4F72E07A1,30854,11,12,1,109.56889,18.27076,1763
33035,249146,96F98526707B06BE1263CCD4F72E07A1,31071,17,18,1,109.58257,18.28458,1815
33036,249149,335A7B1DE8538918FDA774EE3E402A76,30191,0,7,7,109.50361,18.22701,1506
33037,249150,335A7B1DE8538918FDA774EE3E402A76,31521,10,13,3,109.51458,18.22542,1555
33038,249151,335A7B1DE8538918FDA774EE3E402A76,30191,13,23,10,109.50361,18.22701,1506
33041,249162,E082FB5BD091C5B334EC1176FF352EE0,30071,0,13,13,109.52819,18.30472,1619
33042,249163,E082FB5BD091C5B334EC1176FF352EE0,31931,16,17,1,109.54771,18.29403,1667
33043,249164,E082FB5BD091C5B334EC1176FF352EE0,30071,21,23,2,109.52819,18.30472,1619
33055,249285,6EF68F35CE79552C1164E70C67C72C02,30121,0,8,8,109.52861,18.27222,1613
33056,249286,6EF68F35CE79552C1164E70C67C72C02,30854,13,17,4,109.56889,18.27076,1763
33057,249287,6EF68F35CE79552C1164E70C67C72C02,30121,20,23,3,109.52861,18.27222,1613
33069,249444,7B9D64657CE26DF907B4C2AC87C9F431,60371,1,5,4,109.53063,18.30056,1618
33070,249445,7B9D64657CE26DF907B4C2AC87C9F431,38241,6,11,5,109.54111,18.30542,1669
33071,249446,7B9D64657CE26DF907B4C2AC87C9F431,60371,15,18,3,109.53063,18.30056,1618
33072,249447,7B9D64657CE26DF907B4C2AC87C9F431,31931,21,22,1,109.54771,18.29403,1667
33073,249465,C82725A09C032EE9BFF2088FCCC60D1D,30854,1,9,8,109.56889,18.27076,1763
33074,249466,C82725A09C032EE9BFF2088FCCC60D1D,60631,9,19,10,109.57778,18.27583,1814
33075,249467,C82725A09C032EE9BFF2088FCCC60D1D,30854,20,21,1,109.56889,18.27076,1763
33087,249524,BE1BF0E0C00568838DBD1FF7CA7ADE1C,39183,2,3,1,109.55542,18.28208,1715
33088,249525,BE1BF0E0C00568838DBD1FF7CA7ADE1C,31561,6,13,7,109.56792,18.28479,1765
33089,249526,BE1BF0E0C00568838DBD1FF7CA7ADE1C,30854,15,23,8,109.56889,18.27076,1763
33103,249641,8C8ACEC2013CE5C2D40BBAF03FC36A40,31071,3,4,1,109.58257,18.28458,1815
33104,249642,8C8ACEC2013CE5C2D40BBAF03FC36A40,39183,7,8,1,109.55542,18.28208,1715
33105,249643,8C8ACEC2013CE5C2D40BBAF03FC36A40,30854,9,22,13,109.56889,18.27076,1763
33115,249675,89CB07D241B8B48DE23BAD11AA55AD0A,30809,1,10,9,109.4891,18.28229,1465
33116,249676,89CB07D241B8B48DE23BAD11AA55AD0A,30421,10,12,2,109.50021,18.25861,1511
33117,249677,89CB07D241B8B48DE23BAD11AA55AD0A,30809,12,15,3,109.4891,18.28229,1465
33134,249789,012ABD06F231728C214A4BA917E75B1C,31561,0,12,12,109.56792,18.28479,1765
33135,249790,012ABD06F231728C214A4BA917E75B1C,30851,16,17,1,109.5616,18.27396,1713
33136,249791,012ABD06F231728C214A4BA917E75B1C,31561,20,21,1,109.56792,18.28479,1765
33139,249879,5C3AF23B43D26582C5A8FB4D1CB9A5DB,39043,1,7,6,109.40778,18.29049,1166
33140,249880,5C3AF23B43D26582C5A8FB4D1CB9A5DB,38102,7,9,2,109.40875,18.29111,1166
33141,249882,5C3AF23B43D26582C5A8FB4D1CB9A5DB,38094,18,19,1,109.45403,18.28778,1316
33155,249998,CC893ED1EC980A84714A8CD884DE01CB,30721,0,12,12,109.51597,18.28257,1565
33156,249999,CC893ED1EC980A84714A8CD884DE01CB,38171,14,15,1,109.50799,18.28139,1515
33157,250000,CC893ED1EC980A84714A8CD884DE01CB,60281,17,20,3,109.51743,18.25924,1561
33168,250046,C983E73D646629A775690ECA8920EB29,30101,0,6,6,109.57299,18.33333,1773
33169,250047,C983E73D646629A775690ECA8920EB29,31631,9,10,1,109.59542,18.36826,1879
33170,250048,C983E73D646629A775690ECA8920EB29,30101,13,15,2,109.57299,18.33333,1773
33171,250049,C983E73D646629A775690ECA8920EB29,31631,17,18,1,109.59542,18.36826,1879
33172,250050,6C7CFF92341DACF5390B37394F2B073B,30731,1,7,6,109.50944,18.22306,1555
33173,250051,6C7CFF92341DACF5390B37394F2B073B,39321,9,16,7,109.529,18.2167,1604
33174,250052,6C7CFF92341DACF5390B37394F2B073B,60281,18,19,1,109.51743,18.25924,1561
33175,250053,6C7CFF92341DACF5390B37394F2B073B,31461,20,23,3,109.5091,18.25389,1510
33185,250178,53453D8B736810206EC5A6632D159BE6,31931,0,14,14,109.54771,18.29403,1667
33186,250179,53453D8B736810206EC5A6632D159BE6,60371,14,15,1,109.53063,18.30056,1618
33187,250180,53453D8B736810206EC5A6632D159BE6,31931,16,23,7,109.54771,18.29403,1667
33205,250254,D96E01B8E0F0DE9C160C9FEAFDCFDB6D,31071,1,7,6,109.58257,18.28458,1815
33206,250255,D96E01B8E0F0DE9C160C9FEAFDCFDB6D,30854,11,12,1,109.56889,18.27076,1763
33207,250256,D96E01B8E0F0DE9C160C9FEAFDCFDB6D,31071,13,14,1,109.58257,18.28458,1815
33208,250257,D96E01B8E0F0DE9C160C9FEAFDCFDB6D,30854,15,22,7,109.56889,18.27076,1763
33214,250275,3C1A2536A78CF30193CED5E3EEACBE7E,30851,0,2,2,109.5616,18.27396,1713
33215,250276,3C1A2536A78CF30193CED5E3EEACBE7E,30854,4,14,10,109.56889,18.27076,1763
33216,250277,3C1A2536A78CF30193CED5E3EEACBE7E,31561,14,16,2,109.56792,18.28479,1765
33217,250278,3C1A2536A78CF30193CED5E3EEACBE7E,30851,19,22,3,109.5616,18.27396,1713
33235,250425,BAEF9F862D9A902CDB4B10017EC20830,60221,0,8,8,109.52569,18.29188,1616
33236,250426,BAEF9F862D9A902CDB4B10017EC20830,30921,9,10,1,109.53903,18.29451,1667
33237,250427,BAEF9F862D9A902CDB4B10017EC20830,31931,12,17,5,109.54771,18.29403,1667
33238,250428,BAEF9F862D9A902CDB4B10017EC20830,60221,21,23,2,109.52569,18.29188,1616
33252,250517,04ABA8BFD5D63DDF1B83BA0577C9019C,39371,0,11,11,109.56627,18.2646,1762
33253,250518,04ABA8BFD5D63DDF1B83BA0577C9019C,31071,14,17,3,109.58257,18.28458,1815
33254,250519,04ABA8BFD5D63DDF1B83BA0577C9019C,31761,20,21,1,109.60521,18.27965,1914
33287,250648,6FF08122E48AB794FE75A66E236D4C05,31521,0,18,18,109.51458,18.22542,1555
33288,250649,6FF08122E48AB794FE75A66E236D4C05,60381,18,20,2,109.5241,18.22458,1605
33289,250650,6FF08122E48AB794FE75A66E236D4C05,31521,21,23,2,109.51458,18.22542,1555
33290,250689,2AE38FAF341950B0B91404FFCE5A0F3E,39183,4,5,1,109.55542,18.28208,1715
33291,250690,2AE38FAF341950B0B91404FFCE5A0F3E,31931,6,7,1,109.54771,18.29403,1667
33292,250691,2AE38FAF341950B0B91404FFCE5A0F3E,30921,9,10,1,109.53903,18.29451,1667
33298,250700,58418A9EA4A7DC03127CB79C039A5185,31071,0,11,11,109.58257,18.28458,1815
33299,250701,58418A9EA4A7DC03127CB79C039A5185,30854,11,19,8,109.56889,18.27076,1763
33300,250702,58418A9EA4A7DC03127CB79C039A5185,60354,20,23,3,109.58701,18.28521,1815
33301,250703,523CCFE9EF18EE2D015CE7D473B58639,31931,5,14,9,109.54771,18.29403,1667
33302,250704,523CCFE9EF18EE2D015CE7D473B58639,30071,14,16,2,109.52819,18.30472,1619
33303,250705,523CCFE9EF18EE2D015CE7D473B58639,31931,16,22,6,109.54771,18.29403,1667
33308,250767,CFA6DB42B4EA79576A8AEA8F93765E81,30721,0,7,7,109.51597,18.28257,1565
33309,250768,CFA6DB42B4EA79576A8AEA8F93765E81,60084,8,18,10,109.4984,18.2334,1507
33310,250769,CFA6DB42B4EA79576A8AEA8F93765E81,38251,18,19,1,109.49618,18.25493,1510
33311,250770,CFA6DB42B4EA79576A8AEA8F93765E81,30721,19,23,4,109.51597,18.28257,1565
33312,250783,DFFF17B7FE30E79B8AABBB5CE171272F,30854,0,5,5,109.56889,18.27076,1763
33313,250784,DFFF17B7FE30E79B8AABBB5CE171272F,31561,10,11,1,109.56792,18.28479,1765
33314,250785,DFFF17B7FE30E79B8AABBB5CE171272F,30854,11,13,2,109.56889,18.27076,1763
33317,250855,BD5DE467370306D034C70B320455BE36,30161,2,12,10,109.50042,18.24389,1508
33318,250856,BD5DE467370306D034C70B320455BE36,30161,12,14,2,109.50042,18.24389,1508
33319,250857,BD5DE467370306D034C70B320455BE36,60131,19,23,4,109.49819,18.24778,1509
33350,251247,4F1F2C63B1D8098AD9ABA50013979078,60084,0,1,1,109.4984,18.2334,1507
33351,251248,4F1F2C63B1D8098AD9ABA50013979078,31461,1,13,12,109.5091,18.25389,1510
33352,251249,4F1F2C63B1D8098AD9ABA50013979078,30511,14,16,2,109.51069,18.24208,1558
33353,251250,4F1F2C63B1D8098AD9ABA50013979078,31521,17,19,2,109.51458,18.22542,1555
33366,251343,6D3F7AF92DDEA3B5452C1769E3304CDD,30581,3,5,2,109.62257,18.24951,1959
33367,251344,6D3F7AF92DDEA3B5452C1769E3304CDD,60594,6,8,2,109.62694,18.22799,1956
33368,251345,6D3F7AF92DDEA3B5452C1769E3304CDD,38052,8,12,4,109.62618,18.23042,1956
33369,251346,6D3F7AF92DDEA3B5452C1769E3304CDD,60594,15,19,4,109.62694,18.22799,1956
33370,251355,AB43182259122294244C13D6FC66D4A1,60631,0,6,6,109.57778,18.27583,1814
33371,251356,AB43182259122294244C13D6FC66D4A1,31561,10,15,5,109.56792,18.28479,1765
33372,251357,AB43182259122294244C13D6FC66D4A1,30851,16,17,1,109.5616,18.27396,1713
33373,251358,AB43182259122294244C13D6FC66D4A1,31071,19,21,2,109.58257,18.28458,1815
33381,251381,F8D799D9161B0143E0D71C40472A357E,30071,0,15,15,109.52819,18.30472,1619
33382,251382,F8D799D9161B0143E0D71C40472A357E,30071,16,17,1,109.52819,18.30472,1619
33383,251383,F8D799D9161B0143E0D71C40472A357E,31951,18,20,2,109.52174,18.30299,1568
33415,251549,C6C3BC01E542B810EF853FEEB6C81198,60361,0,6,6,109.51938,18.29681,1567
33416,251550,C6C3BC01E542B810EF853FEEB6C81198,60274,11,12,1,109.514,18.2933,1567
33417,251551,C6C3BC01E542B810EF853FEEB6C81198,60361,14,18,4,109.51938,18.29681,1567
33418,251552,C6C3BC01E542B810EF853FEEB6C81198,31561,19,20,1,109.56792,18.28479,1765
33426,251611,52626520133C58C019E9712FB19D3224,38171,0,7,7,109.50799,18.28139,1515
33427,251612,52626520133C58C019E9712FB19D3224,39091,8,10,2,109.50097,18.25222,1510
33428,251613,52626520133C58C019E9712FB19D3224,30711,11,14,3,109.50271,18.25347,1510
33479,251889,64FF3E93355E6DCA29977E04D316EABA,30511,0,2,2,109.51069,18.24208,1558
33480,251890,64FF3E93355E6DCA29977E04D316EABA,38973,3,8,5,109.51097,18.25389,1560
33481,251891,64FF3E93355E6DCA29977E04D316EABA,30151,11,17,6,109.50986,18.25083,1560
33482,251892,64FF3E93355E6DCA29977E04D316EABA,30711,21,23,2,109.50271,18.25347,1510
33524,252221,68DBE0B52FD0AB95F1DD47068FD7847F,60311,1,8,7,109.52097,18.24319,1558
33525,252222,68DBE0B52FD0AB95F1DD47068FD7847F,31201,11,13,2,109.51042,18.23819,1558
33526,252223,68DBE0B52FD0AB95F1DD47068FD7847F,30181,14,22,8,109.51597,18.23313,1557
33566,252488,372A5433078073EAD18922D679CE0A73,60054,2,4,2,109.3016,18.31229,770
33567,252489,372A5433078073EAD18922D679CE0A73,60411,7,9,2,109.32514,18.30854,869
33568,252490,372A5433078073EAD18922D679CE0A73,60054,12,14,2,109.3016,18.31229,770
33569,252491,372A5433078073EAD18922D679CE0A73,60411,15,21,6,109.32514,18.30854,869
33576,252589,FF8CB3D02361FAEBFE418108180099D8,39154,0,6,6,109.50201,18.25681,1511
33577,252590,FF8CB3D02361FAEBFE418108180099D8,31461,10,11,1,109.5091,18.25389,1510
33578,252591,FF8CB3D02361FAEBFE418108180099D8,30711,12,22,10,109.50271,18.25347,1510
33581,252596,7803AECF4FFC2BF233E3B7ACD0D2E9F8,31561,0,6,6,109.56792,18.28479,1765
33582,252597,7803AECF4FFC2BF233E3B7ACD0D2E9F8,39371,7,8,1,109.56627,18.2646,1762
33583,252598,7803AECF4FFC2BF233E3B7ACD0D2E9F8,30851,9,11,2,109.5616,18.27396,1713
33586,252667,D2D609608AA1D4DD8E18DD3745793D0D,39371,0,6,6,109.56627,18.2646,1762
33587,252668,D2D609608AA1D4DD8E18DD3745793D0D,38251,10,12,2,109.49618,18.25493,1510
33588,252669,D2D609608AA1D4DD8E18DD3745793D0D,30854,14,20,6,109.56889,18.27076,1763
33589,252676,6F55ACFC3A2BD8567407A1426439CC11,60171,2,8,6,109.51292,18.30694,1569
33590,252677,6F55ACFC3A2BD8567407A1426439CC11,30071,9,14,5,109.52819,18.30472,1619
33591,252678,6F55ACFC3A2BD8567407A1426439CC11,60171,14,22,8,109.51292,18.30694,1569
33592,252682,7A214C2AB4CE0E87DF8DB230B9F95561,30101,0,5,5,109.57299,18.33333,1773
33593,252683,7A214C2AB4CE0E87DF8DB230B9F95561,31631,6,10,4,109.59542,18.36826,1879
33594,252684,7A214C2AB4CE0E87DF8DB230B9F95561,30101,10,14,4,109.57299,18.33333,1773
33608,252832,8D3B10FD4DBC46DB93DA60040668F697,30854,0,6,6,109.56889,18.27076,1763
33609,252833,8D3B10FD4DBC46DB93DA60040668F697,31561,6,8,2,109.56792,18.28479,1765
33610,252834,8D3B10FD4DBC46DB93DA60040668F697,30854,11,22,11,109.56889,18.27076,1763
33626,252969,332A868849E47177376F9755C981E1C1,60441,0,3,3,109.46792,18.28604,1366
33627,252970,332A868849E47177376F9755C981E1C1,60391,5,15,10,109.47667,18.28757,1416
33628,252971,332A868849E47177376F9755C981E1C1,60391,15,18,3,109.47667,18.28757,1416
33629,252972,332A868849E47177376F9755C981E1C1,31351,20,22,2,109.4959,18.28417,1465
33635,253056,EB316856896788EC8FD871E122E95728,31811,1,8,7,109.54201,18.31806,1671
33636,253057,EB316856896788EC8FD871E122E95728,30701,10,14,4,109.59313,18.32007,1871
33637,253058,EB316856896788EC8FD871E122E95728,31811,18,19,1,109.54201,18.31806,1671
33638,253059,EB316856896788EC8FD871E122E95728,30701,20,23,3,109.59313,18.32007,1871
33653,253178,58DE8A719D3ADBEDAE163213845B460A,31071,0,7,7,109.58257,18.28458,1815
33654,253179,58DE8A719D3ADBEDAE163213845B460A,31071,10,14,4,109.58257,18.28458,1815
33655,253180,58DE8A719D3ADBEDAE163213845B460A,30854,18,22,4,109.56889,18.27076,1763
33673,253337,5EBEA276FCB4A19AC5C987F5C7CC8908,60552,0,2,2,109.41729,18.30014,1218
33674,253338,5EBEA276FCB4A19AC5C987F5C7CC8908,60524,3,6,3,109.42951,18.28993,1216
33675,253339,5EBEA276FCB4A19AC5C987F5C7CC8908,60621,8,18,10,109.48354,18.27451,1464
33694,253481,D40486BFA9AC720A5137C9EAFB418BFA,60361,0,7,7,109.51938,18.29681,1567
33695,253482,D40486BFA9AC720A5137C9EAFB418BFA,31561,8,9,1,109.56792,18.28479,1765
33696,253483,D40486BFA9AC720A5137C9EAFB418BFA,30721,13,14,1,109.51597,18.28257,1565
33697,253491,41D4EB5552A7A416EEB26FAA30F55A4B,31561,1,3,2,109.56792,18.28479,1765
33698,253492,41D4EB5552A7A416EEB26FAA30F55A4B,39371,4,6,2,109.56627,18.2646,1762
33699,253493,41D4EB5552A7A416EEB26FAA30F55A4B,31561,6,13,7,109.56792,18.28479,1765
33700,253494,41D4EB5552A7A416EEB26FAA30F55A4B,30851,14,16,2,109.5616,18.27396,1713
33703,253520,8265A029C672FE0377EF574CC3ADF2A8,39371,0,5,5,109.56627,18.2646,1762
33704,253521,8265A029C672FE0377EF574CC3ADF2A8,30854,8,13,5,109.56889,18.27076,1763
33705,253522,8265A029C672FE0377EF574CC3ADF2A8,31561,14,16,2,109.56792,18.28479,1765
33712,253674,EF0AF6DFF11E792E87881ED5E6F91398,30721,0,6,6,109.51597,18.28257,1565
33713,253675,EF0AF6DFF11E792E87881ED5E6F91398,31561,7,8,1,109.56792,18.28479,1765
33714,253676,EF0AF6DFF11E792E87881ED5E6F91398,30854,13,15,2,109.56889,18.27076,1763
33739,253903,C709D01469E0800AF998DFAF42105CDC,60631,0,1,1,109.57778,18.27583,1814
33740,253904,C709D01469E0800AF998DFAF42105CDC,30854,1,4,3,109.56889,18.27076,1763
33741,253905,C709D01469E0800AF998DFAF42105CDC,31561,8,20,12,109.56792,18.28479,1765
33742,253906,C709D01469E0800AF998DFAF42105CDC,30854,20,23,3,109.56889,18.27076,1763
33747,253927,7D700D7B939DF0B50E1623297FA9AE05,60371,0,2,2,109.53063,18.30056,1618
33748,253928,7D700D7B939DF0B50E1623297FA9AE05,31931,2,7,5,109.54771,18.29403,1667
33749,253929,7D700D7B939DF0B50E1623297FA9AE05,60241,7,11,4,109.53319,18.28667,1616
33750,253935,3160CBE2F0CDCB610575CDC881D9968C,38297,0,7,7,109.52576,18.24965,1609
33751,253936,3160CBE2F0CDCB610575CDC881D9968C,38261,8,9,1,109.50361,18.28153,1515
33752,253937,3160CBE2F0CDCB610575CDC881D9968C,38297,12,14,2,109.52576,18.24965,1609
33759,253990,0E5593A90D661690BE3DAAA17AD936E2,38157,0,7,7,109.51483,18.26958,1563
33760,253991,0E5593A90D661690BE3DAAA17AD936E2,30711,8,10,2,109.50271,18.25347,1510
33761,253992,0E5593A90D661690BE3DAAA17AD936E2,30281,12,14,2,109.50597,18.27583,1514
33762,253995,DDE77D3A656666992FC3458B84010D43,30854,1,4,3,109.56889,18.27076,1763
33763,253996,DDE77D3A656666992FC3458B84010D43,31561,5,8,3,109.56792,18.28479,1765
33764,253997,DDE77D3A656666992FC3458B84010D43,31931,9,10,1,109.54771,18.29403,1667
33773,254018,C5190185E6A850F6CC88937542E0EA31,31071,2,3,1,109.58257,18.28458,1815
33774,254019,C5190185E6A850F6CC88937542E0EA31,30854,7,18,11,109.56889,18.27076,1763
33775,254020,C5190185E6A850F6CC88937542E0EA31,39371,19,23,4,109.56627,18.2646,1762
33776,254034,2C3BD53A8702A47FB82F05FB4993B683,31561,1,6,5,109.56792,18.28479,1765
33777,254035,2C3BD53A8702A47FB82F05FB4993B683,30854,7,16,9,109.56889,18.27076,1763
33778,254036,2C3BD53A8702A47FB82F05FB4993B683,30851,19,20,1,109.5616,18.27396,1713
33782,254060,F6A1EBB84FE583E84185C423218578F5,31561,0,6,6,109.56792,18.28479,1765
33783,254061,F6A1EBB84FE583E84185C423218578F5,30854,10,18,8,109.56889,18.27076,1763
33784,254062,F6A1EBB84FE583E84185C423218578F5,31561,21,23,2,109.56792,18.28479,1765
33787,254107,8DA93D1F2D8B94217DB7D46C30E61BA4,60371,1,6,5,109.53063,18.30056,1618
33788,254108,8DA93D1F2D8B94217DB7D46C30E61BA4,38991,7,8,1,109.52681,18.30368,1618
33789,254109,8DA93D1F2D8B94217DB7D46C30E61BA4,31931,11,16,5,109.54771,18.29403,1667
33790,254110,8DA93D1F2D8B94217DB7D46C30E61BA4,60371,18,23,5,109.53063,18.30056,1618
33802,254192,D59CA492BEF79FDC348123BFCC88F4DD,30071,1,6,5,109.52819,18.30472,1619
33803,254193,D59CA492BEF79FDC348123BFCC88F4DD,31931,8,13,5,109.54771,18.29403,1667
33804,254194,D59CA492BEF79FDC348123BFCC88F4DD,60241,14,15,1,109.53319,18.28667,1616
33807,254233,B712327B6033C61F37801CFD6DAC08AD,38484,3,7,4,109.53028,18.31528,1620
33808,254234,B712327B6033C61F37801CFD6DAC08AD,30561,7,10,3,109.52778,18.31938,1621
33809,254235,B712327B6033C61F37801CFD6DAC08AD,38484,14,15,1,109.53028,18.31528,1620
33810,254240,63FBAC0202144B00077561285E6A7F87,30821,1,5,4,109.43681,18.33639,1274
33811,254241,63FBAC0202144B00077561285E6A7F87,30651,7,10,3,109.42611,18.385,1232
33812,254242,63FBAC0202144B00077561285E6A7F87,30821,10,23,13,109.43681,18.33639,1274
33826,254441,8DE0BC5B468E9CBE441685A75439C8EB,30271,0,3,3,109.49132,18.23153,1456
33827,254442,8DE0BC5B468E9CBE441685A75439C8EB,60231,5,7,2,109.49903,18.21972,1504
33828,254443,8DE0BC5B468E9CBE441685A75439C8EB,60161,9,11,2,109.49174,18.26181,1461
33832,254532,A549C024E6F63EDBD3DC866F10DB11CE,31071,1,5,4,109.58257,18.28458,1815
33833,254533,A549C024E6F63EDBD3DC866F10DB11CE,31761,7,8,1,109.60521,18.27965,1914
33834,254534,A549C024E6F63EDBD3DC866F10DB11CE,30854,8,17,9,109.56889,18.27076,1763
33835,254535,A549C024E6F63EDBD3DC866F10DB11CE,31071,19,21,2,109.58257,18.28458,1815
33841,254611,10EBF762D28520B09848288F7052CFDE,30854,0,6,6,109.56889,18.27076,1763
33842,254612,10EBF762D28520B09848288F7052CFDE,39101,7,18,11,109.50132,18.24931,1509
33843,254613,10EBF762D28520B09848288F7052CFDE,31561,21,23,2,109.56792,18.28479,1765
33847,254669,3066D3BA0EF6F55E10FAD924A6ADDDEF,31205,0,1,1,109.51111,18.23736,1557
33848,254670,3066D3BA0EF6F55E10FAD924A6ADDDEF,30381,3,13,10,109.52521,18.24507,1609
33849,254671,3066D3BA0EF6F55E10FAD924A6ADDDEF,31181,14,15,1,109.50382,18.24813,1509
33852,254720,08298D6D3F79F7819C6B0F651C6D5327,31521,1,10,9,109.51458,18.22542,1555
33853,254721,08298D6D3F79F7819C6B0F651C6D5327,30731,10,13,3,109.50944,18.22306,1555
33854,254722,08298D6D3F79F7819C6B0F651C6D5327,31521,13,14,1,109.51458,18.22542,1555
33855,254723,08298D6D3F79F7819C6B0F651C6D5327,31521,14,16,2,109.51458,18.22542,1555
33856,254736,16F10E4F562E88FDBE5E3B7B9CEB3BC4,31071,1,5,4,109.58257,18.28458,1815
33857,254737,16F10E4F562E88FDBE5E3B7B9CEB3BC4,30854,6,8,2,109.56889,18.27076,1763
33858,254738,16F10E4F562E88FDBE5E3B7B9CEB3BC4,39371,9,11,2,109.56627,18.2646,1762
33859,254739,16F10E4F562E88FDBE5E3B7B9CEB3BC4,31071,13,21,8,109.58257,18.28458,1815
33860,254745,1026894DC5FF9A7FAF3A2EE28B95E239,30891,0,5,5,109.59431,18.28389,1865
33861,254746,1026894DC5FF9A7FAF3A2EE28B95E239,31071,5,6,1,109.58257,18.28458,1815
33862,254747,1026894DC5FF9A7FAF3A2EE28B95E239,30854,10,23,13,109.56889,18.27076,1763
33867,254769,D70D11871FB47AB4743A9AB8A25E5AA8,38241,0,5,5,109.54111,18.30542,1669
33868,254770,D70D11871FB47AB4743A9AB8A25E5AA8,60241,6,18,12,109.53319,18.28667,1616
33869,254771,D70D11871FB47AB4743A9AB8A25E5AA8,38241,21,23,2,109.54111,18.30542,1669
33870,254772,417408FFDA93B177641D270D3A5C4B2D,30891,0,4,4,109.59431,18.28389,1865
33871,254773,417408FFDA93B177641D270D3A5C4B2D,30854,6,19,13,109.56889,18.27076,1763
33872,254774,417408FFDA93B177641D270D3A5C4B2D,31071,21,23,2,109.58257,18.28458,1815
33878,254908,C1602FB5A20BD98313F7CC13F431D061,30731,0,1,1,109.50944,18.22306,1555
33879,254909,C1602FB5A20BD98313F7CC13F431D061,60084,2,7,5,109.4984,18.2334,1507
33880,254910,C1602FB5A20BD98313F7CC13F431D061,30771,7,9,2,109.49938,18.26042,1511
33881,254911,C1602FB5A20BD98313F7CC13F431D061,30771,10,23,13,109.49938,18.26042,1511
33891,254966,528F99F7FD8CA49B85B45B64A5D784BA,30851,1,5,4,109.5616,18.27396,1713
33892,254967,528F99F7FD8CA49B85B45B64A5D784BA,31561,6,15,9,109.56792,18.28479,1765
33893,254968,528F99F7FD8CA49B85B45B64A5D784BA,30851,18,22,4,109.5616,18.27396,1713
33894,254990,BC2EDF4DF9C7FAD55BDEABA03DFA7284,31561,0,5,5,109.56792,18.28479,1765
33895,254991,BC2EDF4DF9C7FAD55BDEABA03DFA7284,30854,6,7,1,109.56889,18.27076,1763
33896,254992,BC2EDF4DF9C7FAD55BDEABA03DFA7284,31561,11,13,2,109.56792,18.28479,1765
33911,255079,C13C99E7ADCAE70C71F0965D0D6E9496,31931,0,13,13,109.54771,18.29403,1667
33912,255080,C13C99E7ADCAE70C71F0965D0D6E9496,30071,15,16,1,109.52819,18.30472,1619
33913,255081,C13C99E7ADCAE70C71F0965D0D6E9496,39181,18,21,3,109.55153,18.28035,1715
33914,255085,8207EF3B9F6D8D19623CD7D3DDB7ECE2,38325,0,1,1,109.39792,18.2909,1116
33915,255086,8207EF3B9F6D8D19623CD7D3DDB7ECE2,38903,1,4,3,109.39229,18.29243,1117
33916,255087,8207EF3B9F6D8D19623CD7D3DDB7ECE2,39041,5,6,1,109.40021,18.29278,1117
33917,255088,8207EF3B9F6D8D19623CD7D3DDB7ECE2,38903,7,8,1,109.39229,18.29243,1117
33923,255137,E16204D131FCD957D5ADB9592C1DD0ED,31561,0,7,7,109.56792,18.28479,1765
33924,255138,E16204D131FCD957D5ADB9592C1DD0ED,31071,10,14,4,109.58257,18.28458,1815
33925,255139,E16204D131FCD957D5ADB9592C1DD0ED,30421,16,18,2,109.50021,18.25861,1511
33926,255140,E16204D131FCD957D5ADB9592C1DD0ED,31071,22,23,1,109.58257,18.28458,1815
33929,255183,34F3D64B41C252481F72E5CF931AC833,31071,0,6,6,109.58257,18.28458,1815
33930,255184,34F3D64B41C252481F72E5CF931AC833,30851,7,9,2,109.5616,18.27396,1713
33931,255185,34F3D64B41C252481F72E5CF931AC833,31071,10,11,1,109.58257,18.28458,1815
33946,255368,4995463B780282C9C030A19D9F49AEAC,39371,0,1,1,109.56627,18.2646,1762
33947,255369,4995463B780282C9C030A19D9F49AEAC,31071,1,6,5,109.58257,18.28458,1815
33948,255370,4995463B780282C9C030A19D9F49AEAC,30854,7,23,16,109.56889,18.27076,1763
34007,255742,9FC721E86703223349C05C95FE4BBB6F,60081,2,10,8,109.51097,18.22639,1556
34008,255743,9FC721E86703223349C05C95FE4BBB6F,31521,11,20,9,109.51458,18.22542,1555
34009,255744,9FC721E86703223349C05C95FE4BBB6F,60087,21,23,2,109.50688,18.22299,1505
34010,255767,A68637AA89BD62624E677D9E66C32FAD,30161,0,6,6,109.50042,18.24389,1508
34011,255768,A68637AA89BD62624E677D9E66C32FAD,30361,6,7,1,109.50347,18.24,1508
34012,255769,A68637AA89BD62624E677D9E66C32FAD,30161,12,16,4,109.50042,18.24389,1508
34013,255770,A68637AA89BD62624E677D9E66C32FAD,30161,21,23,2,109.50042,18.24389,1508
34024,255855,3D39BFF619D555933510C63A4C03CAF1,60371,2,9,7,109.53063,18.30056,1618
34025,255856,3D39BFF619D555933510C63A4C03CAF1,30281,12,15,3,109.50597,18.27583,1514
34026,255857,3D39BFF619D555933510C63A4C03CAF1,38127,16,22,6,109.50833,18.27222,1513
34030,255866,E4F5CE5AA4109B668FB550C6654CBB79,30854,0,4,4,109.56889,18.27076,1763
34031,255867,E4F5CE5AA4109B668FB550C6654CBB79,30851,4,15,11,109.5616,18.27396,1713
34032,255868,E4F5CE5AA4109B668FB550C6654CBB79,39183,20,23,3,109.55542,18.28208,1715
34038,255997,AD64464DD39A90A4C30F70259EC094DF,30071,1,4,3,109.52819,18.30472,1619
34039,255998,AD64464DD39A90A4C30F70259EC094DF,31931,5,15,10,109.54771,18.29403,1667
34040,255999,AD64464DD39A90A4C30F70259EC094DF,30071,16,17,1,109.52819,18.30472,1619
34041,256000,AD64464DD39A90A4C30F70259EC094DF,39181,20,23,3,109.55153,18.28035,1715
34048,256015,84DF4A7C208235D171EF56473BCCF210,30851,0,3,3,109.5616,18.27396,1713
34049,256016,84DF4A7C208235D171EF56473BCCF210,31561,4,7,3,109.56792,18.28479,1765
34050,256017,84DF4A7C208235D171EF56473BCCF210,60631,8,16,8,109.57778,18.27583,1814
34053,256028,A94F66C88B84FF0658441320CD9F667C,60631,1,2,1,109.57778,18.27583,1814
34054,256029,A94F66C88B84FF0658441320CD9F667C,31071,2,7,5,109.58257,18.28458,1815
34055,256030,A94F66C88B84FF0658441320CD9F667C,30854,8,15,7,109.56889,18.27076,1763
34061,256048,C316CE65034FB3C77BE459147CBF943A,31171,0,8,8,109.50938,18.24917,1559
34062,256049,C316CE65034FB3C77BE459147CBF943A,30161,8,17,9,109.50042,18.24389,1508
34063,256050,C316CE65034FB3C77BE459147CBF943A,30161,17,18,1,109.50042,18.24389,1508
34064,256051,C316CE65034FB3C77BE459147CBF943A,60291,20,22,2,109.50826,18.24639,1509
34067,256069,D6A345956751BA2ACC5430EDF68A104F,60671,0,5,5,109.52979,18.31757,1621
34068,256070,D6A345956751BA2ACC5430EDF68A104F,31931,6,15,9,109.54771,18.29403,1667
34069,256071,D6A345956751BA2ACC5430EDF68A104F,39181,19,23,4,109.55153,18.28035,1715
34072,256078,504005D0B9E64BA26E5EEC5B5E6B3A0C,31931,0,9,9,109.54771,18.29403,1667
34073,256079,504005D0B9E64BA26E5EEC5B5E6B3A0C,30071,9,11,2,109.52819,18.30472,1619
34074,256080,504005D0B9E64BA26E5EEC5B5E6B3A0C,31931,12,23,11,109.54771,18.29403,1667
34075,256088,C5536869E807B602F99387523BE0105F,38291,0,7,7,109.51618,18.24313,1558
34076,256089,C5536869E807B602F99387523BE0105F,39191,7,12,5,109.51493,18.23472,1557
34077,256090,C5536869E807B602F99387523BE0105F,31181,14,15,1,109.50382,18.24813,1509
34082,256131,96F98526707B06BE1263CCD4F72E07A1,31071,0,7,7,109.58257,18.28458,1815
34083,256132,96F98526707B06BE1263CCD4F72E07A1,31071,11,13,2,109.58257,18.28458,1815
34084,256133,96F98526707B06BE1263CCD4F72E07A1,60354,15,19,4,109.58701,18.28521,1815
34093,256222,6146A81FA42903D7E835D6037ED21C81,30181,0,18,18,109.51597,18.23313,1557
34094,256223,6146A81FA42903D7E835D6037ED21C81,31521,19,20,1,109.51458,18.22542,1555
34095,256224,6146A81FA42903D7E835D6037ED21C81,30181,21,23,2,109.51597,18.23313,1557
34098,256325,DBB710D279E76C79F1E4B0766F579F8A,30441,0,1,1,109.64021,18.25424,2010
34099,256326,DBB710D279E76C79F1E4B0766F579F8A,60211,2,4,2,109.63549,18.26049,2011
34100,256327,DBB710D279E76C79F1E4B0766F579F8A,31071,6,7,1,109.58257,18.28458,1815
34101,256328,DBB710D279E76C79F1E4B0766F579F8A,30854,11,12,1,109.56889,18.27076,1763
34107,256412,EF24901D99384F703B20FE07F2784FA0,30101,0,11,11,109.57299,18.33333,1773
34108,256413,EF24901D99384F703B20FE07F2784FA0,31631,12,13,1,109.59542,18.36826,1879
34109,256414,EF24901D99384F703B20FE07F2784FA0,30101,14,23,9,109.57299,18.33333,1773
34127,256597,D9AE11CD16B231308C3F0FB3F53BC3E9,30854,0,8,8,109.56889,18.27076,1763
34128,256598,D9AE11CD16B231308C3F0FB3F53BC3E9,31071,13,14,1,109.58257,18.28458,1815
34129,256599,D9AE11CD16B231308C3F0FB3F53BC3E9,30854,17,20,3,109.56889,18.27076,1763
34133,256627,8848858055E44B41A644E297337DB5B6,39111,1,7,6,109.5191,18.22597,1555
34134,256628,8848858055E44B41A644E297337DB5B6,38111,12,15,3,109.52007,18.22403,1555
34135,256629,8848858055E44B41A644E297337DB5B6,31521,16,17,1,109.51458,18.22542,1555
34136,256630,8848858055E44B41A644E297337DB5B6,30361,18,20,2,109.50347,18.24,1508
34137,256634,8B9A9BFD1ACAD480EB101A91DBF2024D,38291,1,17,16,109.51618,18.24313,1558
34138,256635,8B9A9BFD1ACAD480EB101A91DBF2024D,30371,18,19,1,109.51,18.24771,1559
34139,256636,8B9A9BFD1ACAD480EB101A91DBF2024D,38291,20,23,3,109.51618,18.24313,1558
34144,256789,9A0B6BA153A1BEC43BEEC25807F83E36,60671,5,7,2,109.52979,18.31757,1621
34145,256790,9A0B6BA153A1BEC43BEEC25807F83E36,31931,12,18,6,109.54771,18.29403,1667
34146,256791,9A0B6BA153A1BEC43BEEC25807F83E36,39181,19,23,4,109.55153,18.28035,1715
34147,256809,F1114751990E9EE36CDB7660EAA9CD6F,31071,0,4,4,109.58257,18.28458,1815
34148,256810,F1114751990E9EE36CDB7660EAA9CD6F,30854,4,5,1,109.56889,18.27076,1763
34149,256811,F1114751990E9EE36CDB7660EAA9CD6F,31071,6,7,1,109.58257,18.28458,1815
34150,256812,F1114751990E9EE36CDB7660EAA9CD6F,30854,7,15,8,109.56889,18.27076,1763
34151,256813,ACAB8C7B92298FFCEC0006246A6D65D6,30854,1,5,4,109.56889,18.27076,1763
34152,256814,ACAB8C7B92298FFCEC0006246A6D65D6,30851,8,11,3,109.5616,18.27396,1713
34153,256815,ACAB8C7B92298FFCEC0006246A6D65D6,30854,13,14,1,109.56889,18.27076,1763
34154,256816,ACAB8C7B92298FFCEC0006246A6D65D6,39183,19,23,4,109.55542,18.28208,1715
34162,256864,9AA959ED87D1ECC3053DED17290EFCBD,30854,0,4,4,109.56889,18.27076,1763
34163,256865,9AA959ED87D1ECC3053DED17290EFCBD,31561,6,17,11,109.56792,18.28479,1765
34164,256866,9AA959ED87D1ECC3053DED17290EFCBD,30854,17,18,1,109.56889,18.27076,1763
34165,256867,9AA959ED87D1ECC3053DED17290EFCBD,31561,21,23,2,109.56792,18.28479,1765
34168,256903,D292C6B85C9FA2C551E460BECA0F6A0D,31321,3,12,9,109.63799,18.23201,2007
34169,256904,D292C6B85C9FA2C551E460BECA0F6A0D,30441,13,14,1,109.64021,18.25424,2010
34170,256905,D292C6B85C9FA2C551E460BECA0F6A0D,31321,14,17,3,109.63799,18.23201,2007
34171,256932,5B5FB16F9BE2A1826D497C2695908410,31561,2,3,1,109.56792,18.28479,1765
34172,256933,5B5FB16F9BE2A1826D497C2695908410,31071,6,7,1,109.58257,18.28458,1815
34173,256934,5B5FB16F9BE2A1826D497C2695908410,30854,7,8,1,109.56889,18.27076,1763
34174,256935,5B5FB16F9BE2A1826D497C2695908410,31561,12,14,2,109.56792,18.28479,1765
34175,256949,40285EE8CCE25C38988EC087545664EC,31071,3,7,4,109.58257,18.28458,1815
34176,256950,40285EE8CCE25C38988EC087545664EC,30854,10,11,1,109.56889,18.27076,1763
34177,256951,40285EE8CCE25C38988EC087545664EC,31071,14,16,2,109.58257,18.28458,1815
34178,256952,40285EE8CCE25C38988EC087545664EC,30854,18,19,1,109.56889,18.27076,1763
34179,256981,03E3094FE0344513E64DAE470C33E920,31931,1,2,1,109.54771,18.29403,1667
34180,256982,03E3094FE0344513E64DAE470C33E920,60671,4,6,2,109.52979,18.31757,1621
34181,256983,03E3094FE0344513E64DAE470C33E920,31931,7,15,8,109.54771,18.29403,1667
34182,256984,03E3094FE0344513E64DAE470C33E920,39181,20,23,3,109.55153,18.28035,1715
34185,257022,BAEF9F862D9A902CDB4B10017EC20830,60241,0,7,7,109.53319,18.28667,1616
34186,257023,BAEF9F862D9A902CDB4B10017EC20830,31931,7,18,11,109.54771,18.29403,1667
34187,257024,BAEF9F862D9A902CDB4B10017EC20830,48631,19,21,2,109.52903,18.31743,1621
34188,257025,BAEF9F862D9A902CDB4B10017EC20830,60241,22,23,1,109.53319,18.28667,1616
34193,257154,52D077B19C6C1BD347E6DC20309A3DC3,31561,0,4,4,109.56792,18.28479,1765
34194,257155,52D077B19C6C1BD347E6DC20309A3DC3,30854,5,9,4,109.56889,18.27076,1763
34195,257156,52D077B19C6C1BD347E6DC20309A3DC3,31071,12,23,11,109.58257,18.28458,1815
34203,257175,8FFDB178B42E132A09286D0A8A4D99CA,31521,0,8,8,109.51458,18.22542,1555
34204,257177,8FFDB178B42E132A09286D0A8A4D99CA,31521,16,18,2,109.51458,18.22542,1555
34205,257178,8FFDB178B42E132A09286D0A8A4D99CA,31521,19,20,1,109.51458,18.22542,1555
34206,257179,8FFDB178B42E132A09286D0A8A4D99CA,31521,21,23,2,109.51458,18.22542,1555
34209,257192,81946AFE1D298F3B40176C804AE3EF84,31951,0,3,3,109.52174,18.30299,1568
34210,257193,81946AFE1D298F3B40176C804AE3EF84,31931,6,14,8,109.54771,18.29403,1667
34211,257194,81946AFE1D298F3B40176C804AE3EF84,60241,15,17,2,109.53319,18.28667,1616
34212,257195,81946AFE1D298F3B40176C804AE3EF84,31951,19,22,3,109.52174,18.30299,1568
34220,257240,39F25FE146A03325C93C111F2A943B6C,31071,1,15,14,109.58257,18.28458,1815
34221,257241,39F25FE146A03325C93C111F2A943B6C,30854,17,18,1,109.56889,18.27076,1763
34222,257242,39F25FE146A03325C93C111F2A943B6C,31945,22,23,1,109.58021,18.29403,1817
34228,257298,B34415F599F0ED7D1A073EE314A60B9B,31671,0,6,6,109.38965,18.29813,1068
34229,257299,B34415F599F0ED7D1A073EE314A60B9B,60041,6,8,2,109.39889,18.31944,1121
34230,257300,B34415F599F0ED7D1A073EE314A60B9B,31671,8,18,10,109.38965,18.29813,1068
34231,257343,10E6DCB22C04D9E1B01193CDA87B3193,30721,0,7,7,109.51597,18.28257,1565
34232,257344,10E6DCB22C04D9E1B01193CDA87B3193,31931,7,8,1,109.54771,18.29403,1667
34233,257345,10E6DCB22C04D9E1B01193CDA87B3193,30854,9,10,1,109.56889,18.27076,1763
34246,257457,03CEC0FDDD5484124514C6D24A63D4DD,31561,0,13,13,109.56792,18.28479,1765
34247,257458,03CEC0FDDD5484124514C6D24A63D4DD,30854,15,17,2,109.56889,18.27076,1763
34248,257459,03CEC0FDDD5484124514C6D24A63D4DD,31561,22,23,1,109.56792,18.28479,1765
34253,257564,1BC010F6BA936B1BC6461BB11F6A6D07,31261,0,7,7,109.51174,18.2466,1559
34254,257565,1BC010F6BA936B1BC6461BB11F6A6D07,38185,7,12,5,109.51333,18.27347,1563
34255,257566,1BC010F6BA936B1BC6461BB11F6A6D07,31261,13,15,2,109.51174,18.2466,1559
34264,257648,80D5971B84EF3A2477C3F057B855AF63,31071,0,7,7,109.58257,18.28458,1815
34265,257649,80D5971B84EF3A2477C3F057B855AF63,30854,8,10,2,109.56889,18.27076,1763
34266,257650,80D5971B84EF3A2477C3F057B855AF63,31071,11,15,4,109.58257,18.28458,1815
34267,257657,A3F1517845C5D84C612625B9AE2F7500,30854,0,2,2,109.56889,18.27076,1763
34268,257658,A3F1517845C5D84C612625B9AE2F7500,31071,3,7,4,109.58257,18.28458,1815
34269,257659,A3F1517845C5D84C612625B9AE2F7500,30854,7,9,2,109.56889,18.27076,1763
34270,257660,A3F1517845C5D84C612625B9AE2F7500,31071,14,15,1,109.58257,18.28458,1815
34271,257761,F8D799D9161B0143E0D71C40472A357E,30071,0,19,19,109.52819,18.30472,1619
34272,257762,F8D799D9161B0143E0D71C40472A357E,31951,19,21,2,109.52174,18.30299,1568
34273,257763,F8D799D9161B0143E0D71C40472A357E,30071,21,23,2,109.52819,18.30472,1619
34281,257787,7BF65E5054DA81A230AB5423620158E1,60631,0,5,5,109.57778,18.27583,1814
34282,257788,7BF65E5054DA81A230AB5423620158E1,30854,7,10,3,109.56889,18.27076,1763
34283,257789,7BF65E5054DA81A230AB5423620158E1,31071,11,12,1,109.58257,18.28458,1815
34290,257814,FF374776E6D44861C88B04D75BCDE244,30181,0,14,14,109.51597,18.23313,1557
34291,257815,FF374776E6D44861C88B04D75BCDE244,31201,14,19,5,109.51042,18.23819,1558
34292,257816,FF374776E6D44861C88B04D75BCDE244,31206,19,23,4,109.50819,18.23549,1507
34312,257954,C1C69C0EAD4ABEFD1467543102429D9B,30854,0,6,6,109.56889,18.27076,1763
34313,257955,C1C69C0EAD4ABEFD1467543102429D9B,31561,11,12,1,109.56792,18.28479,1765
34314,257956,C1C69C0EAD4ABEFD1467543102429D9B,30854,15,16,1,109.56889,18.27076,1763
34315,257957,63B5E489F3503F8EC6E40A38F9D2117C,60241,3,4,1,109.53319,18.28667,1616
34316,257958,63B5E489F3503F8EC6E40A38F9D2117C,60361,9,10,1,109.51938,18.29681,1567
34317,257959,63B5E489F3503F8EC6E40A38F9D2117C,60171,10,13,3,109.51292,18.30694,1569
34318,257980,EF7DCA5602FCDF14AF156D676A8ED902,31561,4,8,4,109.56792,18.28479,1765
34319,257981,EF7DCA5602FCDF14AF156D676A8ED902,30854,11,13,2,109.56889,18.27076,1763
34320,257982,EF7DCA5602FCDF14AF156D676A8ED902,31561,14,20,6,109.56792,18.28479,1765
34321,257999,CFFDD1BF3134B9FDD71614F40E1DE0FD,31561,0,3,3,109.56792,18.28479,1765
34322,258000,CFFDD1BF3134B9FDD71614F40E1DE0FD,31071,4,7,3,109.58257,18.28458,1815
34323,258001,CFFDD1BF3134B9FDD71614F40E1DE0FD,30851,7,8,1,109.5616,18.27396,1713
34324,258002,CFFDD1BF3134B9FDD71614F40E1DE0FD,31071,10,12,2,109.58257,18.28458,1815
34325,258036,A4D782DD7C0CB1B25E56BFC209FED42C,60241,0,10,10,109.53319,18.28667,1616
34326,258037,A4D782DD7C0CB1B25E56BFC209FED42C,31931,11,13,2,109.54771,18.29403,1667
34327,258038,A4D782DD7C0CB1B25E56BFC209FED42C,60241,13,16,3,109.53319,18.28667,1616
34330,258041,7B832C4EEA998F0828995CEC1FF24330,30854,0,9,9,109.56889,18.27076,1763
34331,258042,7B832C4EEA998F0828995CEC1FF24330,39091,10,11,1,109.50097,18.25222,1510
34332,258043,7B832C4EEA998F0828995CEC1FF24330,60631,15,16,1,109.57778,18.27583,1814
34333,258044,7B832C4EEA998F0828995CEC1FF24330,30854,19,21,2,109.56889,18.27076,1763
34340,258099,30CE72A519D49881F23B8123486E3A02,60411,0,6,6,109.32514,18.30854,869
34341,258100,30CE72A519D49881F23B8123486E3A02,31471,10,12,2,109.34583,18.29563,917
34342,258101,30CE72A519D49881F23B8123486E3A02,60411,14,16,2,109.32514,18.30854,869
34345,258126,610275798AB59486D52727134DFD1B86,31206,0,9,9,109.50819,18.23549,1507
34346,258127,610275798AB59486D52727134DFD1B86,30191,12,13,1,109.50361,18.22701,1506
34347,258128,610275798AB59486D52727134DFD1B86,60081,15,16,1,109.51097,18.22639,1556
34348,258133,408C4FED868686E7B96333835F4C4205,60631,0,2,2,109.57778,18.27583,1814
34349,258134,408C4FED868686E7B96333835F4C4205,30854,2,3,1,109.56889,18.27076,1763
34350,258135,408C4FED868686E7B96333835F4C4205,60631,4,6,2,109.57778,18.27583,1814
34363,258363,68DBE0B52FD0AB95F1DD47068FD7847F,31521,0,3,3,109.51458,18.22542,1555
34364,258364,68DBE0B52FD0AB95F1DD47068FD7847F,30181,3,15,12,109.51597,18.23313,1557
34365,258365,68DBE0B52FD0AB95F1DD47068FD7847F,31521,20,21,1,109.51458,18.22542,1555
34366,258366,68DBE0B52FD0AB95F1DD47068FD7847F,30181,21,23,2,109.51597,18.23313,1557
34400,258604,14DD9E5DCCEFE8BE7425556E4E04FC9A,31071,4,5,1,109.58257,18.28458,1815
34401,258605,14DD9E5DCCEFE8BE7425556E4E04FC9A,31071,9,11,2,109.58257,18.28458,1815
34402,258606,14DD9E5DCCEFE8BE7425556E4E04FC9A,39371,12,14,2,109.56627,18.2646,1762
34403,258607,14DD9E5DCCEFE8BE7425556E4E04FC9A,31071,14,15,1,109.58257,18.28458,1815
34413,258674,29F0AB18AE2C2E1FE6E9AA7900F465E3,38013,0,1,1,109.49514,18.21951,1454
34414,258675,29F0AB18AE2C2E1FE6E9AA7900F465E3,30051,4,5,1,109.48917,18.21215,1453
34415,258676,29F0AB18AE2C2E1FE6E9AA7900F465E3,38013,6,8,2,109.49514,18.21951,1454
34416,258684,080247CC19405F981D4BEFE1A1E9D339,31931,0,1,1,109.54771,18.29403,1667
34417,258685,080247CC19405F981D4BEFE1A1E9D339,39181,1,14,13,109.55153,18.28035,1715
34418,258686,080247CC19405F981D4BEFE1A1E9D339,31931,18,20,2,109.54771,18.29403,1667
34431,258802,E962057A533C6B0B9B10FCC6C7E429E6,30181,0,16,16,109.51597,18.23313,1557
34432,258803,E962057A533C6B0B9B10FCC6C7E429E6,38251,17,21,4,109.49618,18.25493,1510
34433,258804,E962057A533C6B0B9B10FCC6C7E429E6,30181,22,23,1,109.51597,18.23313,1557
34443,258956,92D84094136F2FB8B7D41AECD69A79AD,31201,0,8,8,109.51042,18.23819,1558
34444,258957,92D84094136F2FB8B7D41AECD69A79AD,30711,10,11,1,109.50271,18.25347,1510
34445,258958,92D84094136F2FB8B7D41AECD69A79AD,31201,11,12,1,109.51042,18.23819,1558
34446,258987,C17F2EF1DEA79C8C951E3013EE071B2C,31071,0,6,6,109.58257,18.28458,1815
34447,258988,C17F2EF1DEA79C8C951E3013EE071B2C,60631,7,8,1,109.57778,18.27583,1814
34448,258989,C17F2EF1DEA79C8C951E3013EE071B2C,30854,10,11,1,109.56889,18.27076,1763
34466,259040,A950B25B10B5260D4693DCD3A4C6281C,31931,0,6,6,109.54771,18.29403,1667
34467,259041,A950B25B10B5260D4693DCD3A4C6281C,39181,8,10,2,109.55153,18.28035,1715
34468,259042,A950B25B10B5260D4693DCD3A4C6281C,31931,10,23,13,109.54771,18.29403,1667
34469,259056,74CF56553C56FC34941FD45214B7C747,31761,3,4,1,109.60521,18.27965,1914
34470,259057,74CF56553C56FC34941FD45214B7C747,31071,4,16,12,109.58257,18.28458,1815
34471,259058,74CF56553C56FC34941FD45214B7C747,30854,19,20,1,109.56889,18.27076,1763
34477,259072,DE841C2C767041F00D7DAF75FFC633F6,31561,0,1,1,109.56792,18.28479,1765
34478,259073,DE841C2C767041F00D7DAF75FFC633F6,30421,3,22,19,109.50021,18.25861,1511
34479,259074,DE841C2C767041F00D7DAF75FFC633F6,31561,22,23,1,109.56792,18.28479,1765
34484,259115,1E1181D91A7FDEE2449092386CA6A77C,60041,0,5,5,109.39889,18.31944,1121
34485,259116,1E1181D91A7FDEE2449092386CA6A77C,60552,7,9,2,109.41729,18.30014,1218
34486,259117,1E1181D91A7FDEE2449092386CA6A77C,60041,12,14,2,109.39889,18.31944,1121
34490,259134,3E0CC1F431A959DE24ABB41EC7702F6D,60524,2,9,7,109.42951,18.28993,1216
34491,259135,3E0CC1F431A959DE24ABB41EC7702F6D,30351,10,12,2,109.41701,18.29292,1217
34492,259136,3E0CC1F431A959DE24ABB41EC7702F6D,60524,13,14,1,109.42951,18.28993,1216
34493,259137,3E0CC1F431A959DE24ABB41EC7702F6D,30351,17,18,1,109.41701,18.29292,1217
34494,259174,22B987DE38F8C4435934FE5E6190C4A2,30854,4,6,2,109.56889,18.27076,1763
34495,259175,22B987DE38F8C4435934FE5E6190C4A2,30581,8,18,10,109.62257,18.24951,1959
34496,259176,22B987DE38F8C4435934FE5E6190C4A2,30854,20,22,2,109.56889,18.27076,1763
34497,259177,EE3BF893B663DDE86AC1FCAF91C64AC6,60371,0,8,8,109.53063,18.30056,1618
34498,259178,EE3BF893B663DDE86AC1FCAF91C64AC6,30921,9,10,1,109.53903,18.29451,1667
34499,259179,EE3BF893B663DDE86AC1FCAF91C64AC6,31931,12,14,2,109.54771,18.29403,1667
34500,259183,BE7763F8096EB5A037146E1CC4190538,30854,1,3,2,109.56889,18.27076,1763
34501,259184,BE7763F8096EB5A037146E1CC4190538,39181,8,11,3,109.55153,18.28035,1715
34502,259185,BE7763F8096EB5A037146E1CC4190538,31561,15,16,1,109.56792,18.28479,1765
34503,259186,BE7763F8096EB5A037146E1CC4190538,39183,17,20,3,109.55542,18.28208,1715
34509,259246,4D190727D19452A2A511EC780EEEE090,31271,1,2,1,109.48958,18.26257,1462
34510,259247,4D190727D19452A2A511EC780EEEE090,60274,3,4,1,109.514,18.2933,1567
34511,259248,4D190727D19452A2A511EC780EEEE090,30921,6,13,7,109.53903,18.29451,1667
34512,259276,2191B2AD5C915B8862D4C345F0A13CFB,31071,0,1,1,109.58257,18.28458,1815
34513,259277,2191B2AD5C915B8862D4C345F0A13CFB,60354,2,3,1,109.58701,18.28521,1815
34514,259278,2191B2AD5C915B8862D4C345F0A13CFB,31071,4,7,3,109.58257,18.28458,1815
34515,259279,2191B2AD5C915B8862D4C345F0A13CFB,30851,8,11,3,109.5616,18.27396,1713
34524,259361,CD3BCBAB8571FB81953C842A434E5DB8,31071,0,5,5,109.58257,18.28458,1815
34525,259362,CD3BCBAB8571FB81953C842A434E5DB8,30854,6,9,3,109.56889,18.27076,1763
34526,259363,CD3BCBAB8571FB81953C842A434E5DB8,31071,12,21,9,109.58257,18.28458,1815
34533,259416,58DE8A719D3ADBEDAE163213845B460A,31071,0,14,14,109.58257,18.28458,1815
34534,259417,58DE8A719D3ADBEDAE163213845B460A,30854,16,18,2,109.56889,18.27076,1763
34535,259418,58DE8A719D3ADBEDAE163213845B460A,31071,21,23,2,109.58257,18.28458,1815
34559,259523,2F440A235E684ECEDD042B3100A4AE95,31071,0,7,7,109.58257,18.28458,1815
34560,259524,2F440A235E684ECEDD042B3100A4AE95,30854,10,19,9,109.56889,18.27076,1763
34561,259525,2F440A235E684ECEDD042B3100A4AE95,60331,21,23,2,109.505,18.26507,1512
34566,259551,3B6FF1F8D896A0A62DC7E65967011999,39183,0,8,8,109.55542,18.28208,1715
34567,259552,3B6FF1F8D896A0A62DC7E65967011999,30854,11,13,2,109.56889,18.27076,1763
34568,259553,3B6FF1F8D896A0A62DC7E65967011999,39183,14,16,2,109.55542,18.28208,1715
34569,259554,3B6FF1F8D896A0A62DC7E65967011999,31561,20,21,1,109.56792,18.28479,1765
34587,259815,6B806948BC9187A91D033B4096721B00,30854,0,1,1,109.56889,18.27076,1763
34588,259816,6B806948BC9187A91D033B4096721B00,31561,5,7,2,109.56792,18.28479,1765
34589,259817,6B806948BC9187A91D033B4096721B00,31071,11,17,6,109.58257,18.28458,1815
34590,259818,6B806948BC9187A91D033B4096721B00,31561,21,22,1,109.56792,18.28479,1765
34607,259900,149F44702DEC8C73589BE6524F0A1FFD,30854,2,8,6,109.56889,18.27076,1763
34608,259901,149F44702DEC8C73589BE6524F0A1FFD,60631,9,12,3,109.57778,18.27583,1814
34609,259902,149F44702DEC8C73589BE6524F0A1FFD,30854,12,13,1,109.56889,18.27076,1763
34610,259903,3D65D225F4333E0EF5D32AA289735091,30511,0,17,17,109.51069,18.24208,1558
34611,259904,3D65D225F4333E0EF5D32AA289735091,30361,18,19,1,109.50347,18.24,1508
34612,259905,3D65D225F4333E0EF5D32AA289735091,30511,20,23,3,109.51069,18.24208,1558
34624,260064,B7E330D15F4B46614A332696B5F7027D,31931,0,20,20,109.54771,18.29403,1667
34625,260065,B7E330D15F4B46614A332696B5F7027D,31561,20,21,1,109.56792,18.28479,1765
34626,260066,B7E330D15F4B46614A332696B5F7027D,31931,22,23,1,109.54771,18.29403,1667
34633,260178,451E2BF48CD7B253EB0892324E679BCC,38297,0,5,5,109.52576,18.24965,1609
34634,260179,451E2BF48CD7B253EB0892324E679BCC,60281,6,18,12,109.51743,18.25924,1561
34635,260180,451E2BF48CD7B253EB0892324E679BCC,38297,18,22,4,109.52576,18.24965,1609
34638,260266,0E5593A90D661690BE3DAAA17AD936E2,38127,0,4,4,109.50833,18.27222,1513
34639,260267,0E5593A90D661690BE3DAAA17AD936E2,60504,7,8,1,109.47917,18.28903,1416
34640,260268,0E5593A90D661690BE3DAAA17AD936E2,38127,12,14,2,109.50833,18.27222,1513
34641,260275,DDE77D3A656666992FC3458B84010D43,39183,0,13,13,109.55542,18.28208,1715
34642,260276,DDE77D3A656666992FC3458B84010D43,31561,14,20,6,109.56792,18.28479,1765
34643,260277,DDE77D3A656666992FC3458B84010D43,39183,20,21,1,109.55542,18.28208,1715
34644,260278,40667E55EDAC334B8D18CEA71CBD34F4,30111,1,3,2,109.47583,18.30542,1419
34645,260279,40667E55EDAC334B8D18CEA71CBD34F4,31081,3,5,2,109.44639,18.30181,1318
34646,260280,40667E55EDAC334B8D18CEA71CBD34F4,60504,6,7,1,109.47917,18.28903,1416
34647,260281,40667E55EDAC334B8D18CEA71CBD34F4,31081,11,12,1,109.44639,18.30181,1318
34665,260353,F6A1EBB84FE583E84185C423218578F5,31561,0,5,5,109.56792,18.28479,1765
34666,260354,F6A1EBB84FE583E84185C423218578F5,39183,6,7,1,109.55542,18.28208,1715
34667,260355,F6A1EBB84FE583E84185C423218578F5,31561,12,22,10,109.56792,18.28479,1765
34692,260472,6355DB26EDDE6874FD7A9DB8EAA41564,30854,2,8,6,109.56889,18.27076,1763
34693,260473,6355DB26EDDE6874FD7A9DB8EAA41564,31071,9,10,1,109.58257,18.28458,1815
34694,260474,6355DB26EDDE6874FD7A9DB8EAA41564,30854,10,12,2,109.56889,18.27076,1763
34697,260527,4BCFB9B7DA47F954D069C9FF9050BF88,31071,0,8,8,109.58257,18.28458,1815
34698,260528,4BCFB9B7DA47F954D069C9FF9050BF88,30854,10,12,2,109.56889,18.27076,1763
34699,260529,4BCFB9B7DA47F954D069C9FF9050BF88,31071,16,17,1,109.58257,18.28458,1815
34700,260530,4BCFB9B7DA47F954D069C9FF9050BF88,31071,21,23,2,109.58257,18.28458,1815
34716,260600,63FBAC0202144B00077561285E6A7F87,30821,0,13,13,109.43681,18.33639,1274
34717,260601,63FBAC0202144B00077561285E6A7F87,30651,14,15,1,109.42611,18.385,1232
34718,260602,63FBAC0202144B00077561285E6A7F87,30821,16,21,5,109.43681,18.33639,1274
34719,260612,DF296B63A64E364FCDA4C38B0935EEEE,30711,2,3,1,109.50271,18.25347,1510
34720,260613,DF296B63A64E364FCDA4C38B0935EEEE,30151,3,16,13,109.50986,18.25083,1560
34721,260614,DF296B63A64E364FCDA4C38B0935EEEE,30511,17,23,6,109.51069,18.24208,1558
34727,260666,9E2CAA912E7C38B3460AB2C8B985CA0D,31071,0,6,6,109.58257,18.28458,1815
34728,260667,9E2CAA912E7C38B3460AB2C8B985CA0D,30854,7,16,9,109.56889,18.27076,1763
34729,260668,9E2CAA912E7C38B3460AB2C8B985CA0D,31071,20,23,3,109.58257,18.28458,1815
34738,260766,F47C4E1E39056C43B0AD32AC994AB7C0,31931,5,8,3,109.54771,18.29403,1667
34739,260767,F47C4E1E39056C43B0AD32AC994AB7C0,30921,9,10,1,109.53903,18.29451,1667
34740,260768,F47C4E1E39056C43B0AD32AC994AB7C0,31931,11,22,11,109.54771,18.29403,1667
34741,260813,BE6692F33DB9008EB8798E9F18021EDA,39183,0,5,5,109.55542,18.28208,1715
34742,260814,BE6692F33DB9008EB8798E9F18021EDA,39181,6,14,8,109.55153,18.28035,1715
34743,260815,BE6692F33DB9008EB8798E9F18021EDA,39181,15,17,2,109.55153,18.28035,1715
34745,260838,30F5D42A1A8F1CF26F5C9617FCB06C4F,31561,1,8,7,109.56792,18.28479,1765
34746,260839,30F5D42A1A8F1CF26F5C9617FCB06C4F,30071,10,11,1,109.52819,18.30472,1619
34747,260840,30F5D42A1A8F1CF26F5C9617FCB06C4F,31561,14,23,9,109.56792,18.28479,1765
34750,260906,423E2A7AD06C927EE0BD23EE3AB605E3,30854,1,6,5,109.56889,18.27076,1763
34751,260907,423E2A7AD06C927EE0BD23EE3AB605E3,31071,10,12,2,109.58257,18.28458,1815
34752,260908,423E2A7AD06C927EE0BD23EE3AB605E3,30854,15,16,1,109.56889,18.27076,1763
34755,260930,17044E2739C9A19F4DCFEBDB273C9F8A,31521,0,12,12,109.51458,18.22542,1555
34756,260931,17044E2739C9A19F4DCFEBDB273C9F8A,30731,13,14,1,109.50944,18.22306,1555
34757,260932,17044E2739C9A19F4DCFEBDB273C9F8A,39321,14,18,4,109.529,18.2167,1604
34758,260933,17044E2739C9A19F4DCFEBDB273C9F8A,31521,19,23,4,109.51458,18.22542,1555
34769,260994,86435198F57620D5DAC23B4A4DA78009,39183,0,4,4,109.55542,18.28208,1715
34770,260995,86435198F57620D5DAC23B4A4DA78009,31931,9,12,3,109.54771,18.29403,1667
34771,260996,86435198F57620D5DAC23B4A4DA78009,39183,14,20,6,109.55542,18.28208,1715
34776,261035,85586D73EA48B4F4D520D899B0BE0554,30291,0,5,5,109.50403,18.27028,1513
34777,261036,85586D73EA48B4F4D520D899B0BE0554,30854,7,8,1,109.56889,18.27076,1763
34778,261037,85586D73EA48B4F4D520D899B0BE0554,39181,10,17,7,109.55153,18.28035,1715
34779,261038,85586D73EA48B4F4D520D899B0BE0554,30291,20,23,3,109.50403,18.27028,1513
34780,261049,10EBF762D28520B09848288F7052CFDE,30854,0,1,1,109.56889,18.27076,1763
34781,261050,10EBF762D28520B09848288F7052CFDE,31561,3,4,1,109.56792,18.28479,1765
34782,261051,10EBF762D28520B09848288F7052CFDE,39101,7,17,10,109.50132,18.24931,1509
34783,261052,10EBF762D28520B09848288F7052CFDE,30854,19,22,3,109.56889,18.27076,1763
34800,261169,08298D6D3F79F7819C6B0F651C6D5327,31521,3,10,7,109.51458,18.22542,1555
34801,261170,08298D6D3F79F7819C6B0F651C6D5327,30361,12,14,2,109.50347,18.24,1508
34802,261171,08298D6D3F79F7819C6B0F651C6D5327,31521,14,20,6,109.51458,18.22542,1555
34803,261172,08298D6D3F79F7819C6B0F651C6D5327,60381,21,23,2,109.5241,18.22458,1605
34824,261280,417408FFDA93B177641D270D3A5C4B2D,31071,0,6,6,109.58257,18.28458,1815
34825,261281,417408FFDA93B177641D270D3A5C4B2D,30854,6,21,15,109.56889,18.27076,1763
34826,261282,417408FFDA93B177641D270D3A5C4B2D,31071,22,23,1,109.58257,18.28458,1815
34847,261460,D6B14C7387647D8C883334DAFB518257,31071,0,7,7,109.58257,18.28458,1815
34848,261461,D6B14C7387647D8C883334DAFB518257,39183,10,16,6,109.55542,18.28208,1715
34849,261462,D6B14C7387647D8C883334DAFB518257,39053,20,22,2,109.511,18.2771,1564
34865,261611,EBF906C5498076BCFA3E97DF6001B4F3,30854,0,5,5,109.56889,18.27076,1763
34866,261612,EBF906C5498076BCFA3E97DF6001B4F3,60631,7,15,8,109.57778,18.27583,1814
34867,261613,EBF906C5498076BCFA3E97DF6001B4F3,30854,16,17,1,109.56889,18.27076,1763
34876,261665,75817DB682187A07461734D66E1E6492,60631,0,4,4,109.57778,18.27583,1814
34877,261666,75817DB682187A07461734D66E1E6492,30854,5,17,12,109.56889,18.27076,1763
34878,261667,75817DB682187A07461734D66E1E6492,60631,22,23,1,109.57778,18.27583,1814
34882,261690,005F3AEFE6DBF371ED1FD57736434098,31071,1,2,1,109.58257,18.28458,1815
34883,261691,005F3AEFE6DBF371ED1FD57736434098,60211,3,6,3,109.63549,18.26049,2011
34884,261692,005F3AEFE6DBF371ED1FD57736434098,30854,7,17,10,109.56889,18.27076,1763
34885,261693,005F3AEFE6DBF371ED1FD57736434098,31071,21,23,2,109.58257,18.28458,1815
34889,261708,86B53E128647666CEA9BD4D18A34AC90,60084,1,5,4,109.4984,18.2334,1507
34890,261709,86B53E128647666CEA9BD4D18A34AC90,31391,8,9,1,109.50382,18.24285,1508
34891,261710,86B53E128647666CEA9BD4D18A34AC90,60084,11,13,2,109.4984,18.2334,1507
34892,261711,86B53E128647666CEA9BD4D18A34AC90,31206,17,20,3,109.50819,18.23549,1507
34896,261751,8176D8142708363A5FC68B07CA2CF3DF,60081,0,5,5,109.51097,18.22639,1556
34897,261752,8176D8142708363A5FC68B07CA2CF3DF,39191,6,9,3,109.51493,18.23472,1557
34898,261753,8176D8142708363A5FC68B07CA2CF3DF,60381,11,12,1,109.5241,18.22458,1605
34899,261757,8D8AA41210FC9E2D5DD4D81CF4DB18D7,60361,0,5,5,109.51938,18.29681,1567
34900,261758,8D8AA41210FC9E2D5DD4D81CF4DB18D7,30071,5,8,3,109.52819,18.30472,1619
34901,261759,8D8AA41210FC9E2D5DD4D81CF4DB18D7,30084,12,13,1,109.50118,18.26972,1513
34902,261779,ABCD0851CC1C78BCD7AF6DBDF2F5DE49,60552,5,8,3,109.41729,18.30014,1218
34903,261780,ABCD0851CC1C78BCD7AF6DBDF2F5DE49,60551,9,11,2,109.42722,18.30111,1218
34904,261781,ABCD0851CC1C78BCD7AF6DBDF2F5DE49,60552,11,19,8,109.41729,18.30014,1218
34913,261803,C19430CE8DF26BDEF43903E57E682236,31561,0,8,8,109.56792,18.28479,1765
34914,261804,C19430CE8DF26BDEF43903E57E682236,30854,8,9,1,109.56889,18.27076,1763
34915,261805,C19430CE8DF26BDEF43903E57E682236,31561,13,23,10,109.56792,18.28479,1765
34921,261818,E6541B4F346982101D887BAAF0315541,30854,0,6,6,109.56889,18.27076,1763
34922,261819,E6541B4F346982101D887BAAF0315541,31561,7,9,2,109.56792,18.28479,1765
34923,261820,E6541B4F346982101D887BAAF0315541,30854,12,14,2,109.56889,18.27076,1763
34925,261912,5426296000364EE32711CD0E73D782C8,31071,1,8,7,109.58257,18.28458,1815
34926,261913,5426296000364EE32711CD0E73D782C8,30854,11,12,1,109.56889,18.27076,1763
34927,261914,5426296000364EE32711CD0E73D782C8,31071,15,21,6,109.58257,18.28458,1815
34928,261915,5426296000364EE32711CD0E73D782C8,30854,22,23,1,109.56889,18.27076,1763
34942,262077,1D2F8DB1F8B6A2081E1A43DDF558491D,31951,1,12,11,109.52174,18.30299,1568
34943,262078,1D2F8DB1F8B6A2081E1A43DDF558491D,30071,13,15,2,109.52819,18.30472,1619
34944,262079,1D2F8DB1F8B6A2081E1A43DDF558491D,30561,19,21,2,109.52778,18.31938,1621
34964,262222,770A00BDAFE9BCA8C9E9FA68066EED7D,31071,0,6,6,109.58257,18.28458,1815
34965,262223,770A00BDAFE9BCA8C9E9FA68066EED7D,31561,7,21,14,109.56792,18.28479,1765
34966,262224,770A00BDAFE9BCA8C9E9FA68066EED7D,31071,21,23,2,109.58257,18.28458,1815
34973,262315,FFFC0994E5C15BDB165344716912442C,39371,0,3,3,109.56627,18.2646,1762
34974,262316,FFFC0994E5C15BDB165344716912442C,30854,4,6,2,109.56889,18.27076,1763
34975,262317,FFFC0994E5C15BDB165344716912442C,31554,7,17,10,109.55521,18.2459,1709
34976,262318,FFFC0994E5C15BDB165344716912442C,31551,19,21,2,109.55868,18.24222,1708
34985,262376,46D3900FF4CD0CE137E6DB2E5BBC5B87,39183,0,14,14,109.55542,18.28208,1715
34986,262377,46D3900FF4CD0CE137E6DB2E5BBC5B87,30854,14,16,2,109.56889,18.27076,1763
34987,262378,46D3900FF4CD0CE137E6DB2E5BBC5B87,39183,20,22,2,109.55542,18.28208,1715
35003,262641,85D2E0E28FB58C7F8A0D7BC94160D3DD,31561,2,3,1,109.56792,18.28479,1765
35004,262642,85D2E0E28FB58C7F8A0D7BC94160D3DD,30854,5,8,3,109.56889,18.27076,1763
35005,262643,85D2E0E28FB58C7F8A0D7BC94160D3DD,30851,12,14,2,109.5616,18.27396,1713
35006,262644,85D2E0E28FB58C7F8A0D7BC94160D3DD,30854,15,17,2,109.56889,18.27076,1763
35012,262731,DD45185853A1666007498BC4DFEF5242,30681,0,4,4,109.48493,18.26917,1463
35013,262732,DD45185853A1666007498BC4DFEF5242,31561,4,6,2,109.56792,18.28479,1765
35014,262733,DD45185853A1666007498BC4DFEF5242,30681,10,12,2,109.48493,18.26917,1463
35023,262773,E4D199FCE009427481C9D06B9609AB1E,31931,1,10,9,109.54771,18.29403,1667
35024,262774,E4D199FCE009427481C9D06B9609AB1E,39181,10,17,7,109.55153,18.28035,1715
35025,262775,E4D199FCE009427481C9D06B9609AB1E,31931,19,21,2,109.54771,18.29403,1667
35026,262776,E4D199FCE009427481C9D06B9609AB1E,39181,21,23,2,109.55153,18.28035,1715
35038,262885,567BF1868FBA42FA9B3B29F2CA13F65D,60371,1,3,2,109.53063,18.30056,1618
35039,262886,567BF1868FBA42FA9B3B29F2CA13F65D,60361,4,8,4,109.51938,18.29681,1567
35040,262887,567BF1868FBA42FA9B3B29F2CA13F65D,31931,11,23,12,109.54771,18.29403,1667
35047,262937,335A7B1DE8538918FDA774EE3E402A76,30191,0,6,6,109.50361,18.22701,1506
35048,262938,335A7B1DE8538918FDA774EE3E402A76,31521,10,12,2,109.51458,18.22542,1555
35049,262939,335A7B1DE8538918FDA774EE3E402A76,30191,17,23,6,109.50361,18.22701,1506
35055,262998,B93185B4820D7E0DEE74EBEA00941D15,38291,0,1,1,109.51618,18.24313,1558
35056,262999,B93185B4820D7E0DEE74EBEA00941D15,31461,1,2,1,109.5091,18.25389,1510
35057,263000,B93185B4820D7E0DEE74EBEA00941D15,30911,3,19,16,109.50493,18.26181,1511
35058,263001,B93185B4820D7E0DEE74EBEA00941D15,38291,21,23,2,109.51618,18.24313,1558
35060,263039,6E2021B014C4D0B652A2E4FE8D2CF038,31071,0,8,8,109.58257,18.28458,1815
35061,263040,6E2021B014C4D0B652A2E4FE8D2CF038,30854,8,9,1,109.56889,18.27076,1763
35062,263041,6E2021B014C4D0B652A2E4FE8D2CF038,31071,13,14,1,109.58257,18.28458,1815
35063,263042,6E2021B014C4D0B652A2E4FE8D2CF038,30854,16,17,1,109.56889,18.27076,1763
35069,263098,121138E269BBF0B506FA8CE6CEB3BF52,31931,0,13,13,109.54771,18.29403,1667
35070,263099,121138E269BBF0B506FA8CE6CEB3BF52,39181,16,17,1,109.55153,18.28035,1715
35071,263100,121138E269BBF0B506FA8CE6CEB3BF52,31931,18,23,5,109.54771,18.29403,1667
35072,263130,3520FED22A4D572CBFE1B08BD2743E22,30511,0,4,4,109.51069,18.24208,1558
35073,263131,3520FED22A4D572CBFE1B08BD2743E22,31391,7,19,12,109.50382,18.24285,1508
35074,263132,3520FED22A4D572CBFE1B08BD2743E22,60291,21,23,2,109.50826,18.24639,1509
35086,263221,C82725A09C032EE9BFF2088FCCC60D1D,30854,1,11,10,109.56889,18.27076,1763
35087,263222,C82725A09C032EE9BFF2088FCCC60D1D,31071,13,15,2,109.58257,18.28458,1815
35088,263223,C82725A09C032EE9BFF2088FCCC60D1D,30854,16,18,2,109.56889,18.27076,1763
35094,263257,73EAC1341C5005A58B26B1A52457F38B,31181,0,4,4,109.50382,18.24813,1509
35095,263258,73EAC1341C5005A58B26B1A52457F38B,31181,5,14,9,109.50382,18.24813,1509
35096,263259,73EAC1341C5005A58B26B1A52457F38B,30121,15,18,3,109.52861,18.27222,1613
35110,263346,3C5AEA306E8A69C707195C4150E77D90,31931,1,6,5,109.54771,18.29403,1667
35111,263347,3C5AEA306E8A69C707195C4150E77D90,39181,7,9,2,109.55153,18.28035,1715
35112,263348,3C5AEA306E8A69C707195C4150E77D90,31931,13,20,7,109.54771,18.29403,1667
35116,263399,F5E480BCE870DAE347CB60AA32F4CA1B,31071,0,4,4,109.58257,18.28458,1815
35117,263400,F5E480BCE870DAE347CB60AA32F4CA1B,30854,7,8,1,109.56889,18.27076,1763
35118,263401,F5E480BCE870DAE347CB60AA32F4CA1B,31071,12,13,1,109.58257,18.28458,1815
35129,263435,1122041491C04B199A15F6E1E401D68F,60281,0,9,9,109.51743,18.25924,1561
35130,263436,1122041491C04B199A15F6E1E401D68F,30461,12,19,7,109.5116,18.26313,1562
35131,263437,1122041491C04B199A15F6E1E401D68F,60291,20,22,2,109.50826,18.24639,1509
35141,263523,51061B3DE820AF1C1C713EF684728003,31071,1,7,6,109.58257,18.28458,1815
35142,263524,51061B3DE820AF1C1C713EF684728003,30854,9,19,10,109.56889,18.27076,1763
35143,263525,51061B3DE820AF1C1C713EF684728003,60354,20,23,3,109.58701,18.28521,1815
35148,263573,1980C8D409DE9551539224B3D393CDAA,30071,0,8,8,109.52819,18.30472,1619
35149,263574,1980C8D409DE9551539224B3D393CDAA,31951,8,13,5,109.52174,18.30299,1568
35150,263575,1980C8D409DE9551539224B3D393CDAA,30071,13,23,10,109.52819,18.30472,1619
35156,263756,C983E73D646629A775690ECA8920EB29,30101,0,6,6,109.57299,18.33333,1773
35157,263757,C983E73D646629A775690ECA8920EB29,31631,7,16,9,109.59542,18.36826,1879
35158,263758,C983E73D646629A775690ECA8920EB29,30101,17,18,1,109.57299,18.33333,1773
35159,263796,DECFA2425C3F22CB4A82B4145E73203B,60524,0,3,3,109.42951,18.28993,1216
35160,263797,DECFA2425C3F22CB4A82B4145E73203B,60552,3,5,2,109.41729,18.30014,1218
35161,263798,DECFA2425C3F22CB4A82B4145E73203B,60041,8,9,1,109.39889,18.31944,1121
35162,263799,DECFA2425C3F22CB4A82B4145E73203B,60552,13,19,6,109.41729,18.30014,1218
35168,263852,FA724E83D7D22E41E07D0D2550D22166,30854,0,10,10,109.56889,18.27076,1763
35169,263853,FA724E83D7D22E41E07D0D2550D22166,39371,11,13,2,109.56627,18.2646,1762
35170,263854,FA724E83D7D22E41E07D0D2550D22166,30854,16,23,7,109.56889,18.27076,1763
35181,263929,C0D13B38478FDA6E2CD0CFA376A29EAB,30721,0,15,15,109.51597,18.28257,1565
35182,263930,C0D13B38478FDA6E2CD0CFA376A29EAB,38251,17,19,2,109.49618,18.25493,1510
35183,263931,C0D13B38478FDA6E2CD0CFA376A29EAB,30721,21,23,2,109.51597,18.28257,1565
35184,263941,4CC3058F56A42FB99DF66B1D4EA3395F,30421,0,8,8,109.50021,18.25861,1511
35185,263942,4CC3058F56A42FB99DF66B1D4EA3395F,30771,10,11,1,109.49938,18.26042,1511
35186,263943,4CC3058F56A42FB99DF66B1D4EA3395F,30771,16,23,7,109.49938,18.26042,1511
35189,264037,C8922FAF66F21ECAECB6B717FCD5A53B,60614,0,16,16,109.48799,18.29521,1467
35190,264038,C8922FAF66F21ECAECB6B717FCD5A53B,60391,17,18,1,109.47667,18.28757,1416
35191,264039,C8922FAF66F21ECAECB6B717FCD5A53B,60614,18,21,3,109.48799,18.29521,1467
35205,264133,1419F2503130508E06D5FA0D4A5CF329,31031,0,9,9,109.49979,18.25382,1510
35206,264134,1419F2503130508E06D5FA0D4A5CF329,31261,13,20,7,109.51174,18.2466,1559
35207,264135,1419F2503130508E06D5FA0D4A5CF329,60291,22,23,1,109.50826,18.24639,1509
35217,264181,08A066736557478B1013C0CF834491DF,30921,0,7,7,109.53903,18.29451,1667
35218,264182,08A066736557478B1013C0CF834491DF,31931,10,20,10,109.54771,18.29403,1667
35219,264183,08A066736557478B1013C0CF834491DF,30921,20,21,1,109.53903,18.29451,1667
35222,264212,52D077B19C6C1BD347E6DC20309A3DC3,31071,0,13,13,109.58257,18.28458,1815
35223,264213,52D077B19C6C1BD347E6DC20309A3DC3,30854,16,17,1,109.56889,18.27076,1763
35224,264214,52D077B19C6C1BD347E6DC20309A3DC3,31071,20,23,3,109.58257,18.28458,1815
35225,264227,E75CF54BA14775FEDD26504F9F6B7365,31945,1,5,4,109.58021,18.29403,1817
35226,264228,E75CF54BA14775FEDD26504F9F6B7365,31561,7,14,7,109.56792,18.28479,1765
35227,264229,E75CF54BA14775FEDD26504F9F6B7365,30854,17,19,2,109.56889,18.27076,1763
35228,264230,00FC332040A284DA251A8D0705989FE9,31071,1,2,1,109.58257,18.28458,1815
35229,264231,00FC332040A284DA251A8D0705989FE9,31945,2,4,2,109.58021,18.29403,1817
35230,264232,00FC332040A284DA251A8D0705989FE9,31071,4,5,1,109.58257,18.28458,1815
35231,264233,00FC332040A284DA251A8D0705989FE9,30854,10,15,5,109.56889,18.27076,1763
35232,264244,8FFDB178B42E132A09286D0A8A4D99CA,31521,0,1,1,109.51458,18.22542,1555
35233,264245,8FFDB178B42E132A09286D0A8A4D99CA,39321,1,5,4,109.529,18.2167,1604
35234,264246,8FFDB178B42E132A09286D0A8A4D99CA,31521,10,16,6,109.51458,18.22542,1555
35235,264247,8FFDB178B42E132A09286D0A8A4D99CA,31521,19,22,3,109.51458,18.22542,1555
35236,264276,6FF08122E48AB794FE75A66E236D4C05,31521,0,13,13,109.51458,18.22542,1555
35237,264277,6FF08122E48AB794FE75A66E236D4C05,60381,13,14,1,109.5241,18.22458,1605
35238,264278,6FF08122E48AB794FE75A66E236D4C05,31521,14,17,3,109.51458,18.22542,1555
35239,264279,6FF08122E48AB794FE75A66E236D4C05,39111,22,23,1,109.5191,18.22597,1555
35247,264394,DFFF17B7FE30E79B8AABBB5CE171272F,31561,3,9,6,109.56792,18.28479,1765
35248,264395,DFFF17B7FE30E79B8AABBB5CE171272F,39183,9,11,2,109.55542,18.28208,1715
35249,264396,DFFF17B7FE30E79B8AABBB5CE171272F,31561,15,16,1,109.56792,18.28479,1765
35288,264893,7C4B45B599684104AFE3AA992CD3924A,60211,2,15,13,109.63549,18.26049,2011
35289,264894,7C4B45B599684104AFE3AA992CD3924A,30811,17,20,3,109.65188,18.26257,2062
35290,264895,7C4B45B599684104AFE3AA992CD3924A,60211,21,23,2,109.63549,18.26049,2011
35302,265042,ED3CB0620A65788A56B29EB6491965A0,30461,0,12,12,109.5116,18.26313,1562
35303,265043,ED3CB0620A65788A56B29EB6491965A0,31461,12,14,2,109.5091,18.25389,1510
35304,265044,ED3CB0620A65788A56B29EB6491965A0,60281,14,15,1,109.51743,18.25924,1561
35305,265045,ED3CB0620A65788A56B29EB6491965A0,38881,18,23,5,109.51618,18.26431,1562
35317,265236,6C0260646767B781577B5B8CE2471E51,38484,0,11,11,109.53028,18.31528,1620
35318,265237,6C0260646767B781577B5B8CE2471E51,38484,11,13,2,109.53028,18.31528,1620
35319,265238,6C0260646767B781577B5B8CE2471E51,38484,13,15,2,109.53028,18.31528,1620
35320,265239,6C0260646767B781577B5B8CE2471E51,30561,19,21,2,109.52778,18.31938,1621
35321,265240,20C15B76A1E0DF79D86EDEAC7BC3D7B7,31945,1,5,4,109.58021,18.29403,1817
35322,265241,20C15B76A1E0DF79D86EDEAC7BC3D7B7,30854,5,8,3,109.56889,18.27076,1763
35323,265242,20C15B76A1E0DF79D86EDEAC7BC3D7B7,31071,10,23,13,109.58257,18.28458,1815
35345,265381,FC4E540B07DB36C2A24C73051E1FA6C0,30171,0,5,5,109.48458,18.27139,1463
35346,265382,FC4E540B07DB36C2A24C73051E1FA6C0,60621,6,9,3,109.48354,18.27451,1464
35347,265383,FC4E540B07DB36C2A24C73051E1FA6C0,60401,9,16,7,109.47444,18.27583,1414
35348,265384,FC4E540B07DB36C2A24C73051E1FA6C0,30171,17,23,6,109.48458,18.27139,1463
35351,265487,30CE72A519D49881F23B8123486E3A02,60411,0,9,9,109.32514,18.30854,869
35352,265488,30CE72A519D49881F23B8123486E3A02,31471,10,11,1,109.34583,18.29563,917
35353,265489,30CE72A519D49881F23B8123486E3A02,60411,12,18,6,109.32514,18.30854,869
35357,265528,408C4FED868686E7B96333835F4C4205,31071,0,5,5,109.58257,18.28458,1815
35358,265529,408C4FED868686E7B96333835F4C4205,30854,9,10,1,109.56889,18.27076,1763
35359,265530,408C4FED868686E7B96333835F4C4205,31071,10,15,5,109.58257,18.28458,1815
35360,265531,408C4FED868686E7B96333835F4C4205,30854,16,22,6,109.56889,18.27076,1763
35361,265550,798BF3B08F72A16A6DEAAA235F1899BB,61011,0,3,3,109.60653,18.19076,1900
35362,265552,798BF3B08F72A16A6DEAAA235F1899BB,61011,11,13,2,109.60653,18.19076,1900
35363,265554,798BF3B08F72A16A6DEAAA235F1899BB,61011,16,18,2,109.60653,18.19076,1900
35371,265656,9B979E9430BCD0DDB6C78BBE525EBD2D,60631,0,2,2,109.57778,18.27583,1814
35372,265657,9B979E9430BCD0DDB6C78BBE525EBD2D,30854,6,12,6,109.56889,18.27076,1763
35373,265658,9B979E9430BCD0DDB6C78BBE525EBD2D,39371,16,22,6,109.56627,18.2646,1762
35385,265811,68DBE0B52FD0AB95F1DD47068FD7847F,30181,0,10,10,109.51597,18.23313,1557
35386,265812,68DBE0B52FD0AB95F1DD47068FD7847F,39111,12,14,2,109.5191,18.22597,1555
35387,265813,68DBE0B52FD0AB95F1DD47068FD7847F,30181,14,17,3,109.51597,18.23313,1557
35388,265814,68DBE0B52FD0AB95F1DD47068FD7847F,30181,17,23,6,109.51597,18.23313,1557
35405,265909,066CC6CBB5ADF978A93AF5D0C3292806,31931,0,3,3,109.54771,18.29403,1667
35406,265910,066CC6CBB5ADF978A93AF5D0C3292806,30071,3,7,4,109.52819,18.30472,1619
35407,265911,066CC6CBB5ADF978A93AF5D0C3292806,60091,9,11,2,109.59729,18.30431,1869
35417,265980,2CF83F5125C6075E2ACA9C17C2979C64,31071,1,2,1,109.58257,18.28458,1815
35418,265981,2CF83F5125C6075E2ACA9C17C2979C64,31071,2,3,1,109.58257,18.28458,1815
35419,265982,2CF83F5125C6075E2ACA9C17C2979C64,30854,8,20,12,109.56889,18.27076,1763
35420,265983,2CF83F5125C6075E2ACA9C17C2979C64,31071,20,21,1,109.58257,18.28458,1815
35434,266213,65AD296DD65C9EEA3C22EA02904A768E,31561,1,7,6,109.56792,18.28479,1765
35435,266214,65AD296DD65C9EEA3C22EA02904A768E,30854,8,18,10,109.56889,18.27076,1763
35436,266215,65AD296DD65C9EEA3C22EA02904A768E,31561,18,19,1,109.56792,18.28479,1765
35442,266249,45FA8AF959A216E06C82392E21728E7F,31071,0,8,8,109.58257,18.28458,1815
35443,266250,45FA8AF959A216E06C82392E21728E7F,31561,9,11,2,109.56792,18.28479,1765
35444,266251,45FA8AF959A216E06C82392E21728E7F,31071,13,14,1,109.58257,18.28458,1815
35445,266252,45FA8AF959A216E06C82392E21728E7F,31561,16,17,1,109.56792,18.28479,1765
35446,266312,875F4B80762D0E664890361D764F907D,60081,0,7,7,109.51097,18.22639,1556
35447,266313,875F4B80762D0E664890361D764F907D,60231,7,17,10,109.49903,18.21972,1504
35448,266314,875F4B80762D0E664890361D764F907D,60081,18,23,5,109.51097,18.22639,1556
35449,266353,09C160BFB128F08F5906511FF56340F0,38023,0,10,10,109.37132,18.28993,1016
35450,266354,09C160BFB128F08F5906511FF56340F0,60054,13,15,2,109.3016,18.31229,770
35451,266355,09C160BFB128F08F5906511FF56340F0,38023,16,23,7,109.37132,18.28993,1016
35454,266383,D2D609608AA1D4DD8E18DD3745793D0D,30854,0,3,3,109.56889,18.27076,1763
35455,266384,D2D609608AA1D4DD8E18DD3745793D0D,31071,4,11,7,109.58257,18.28458,1815
35456,266385,D2D609608AA1D4DD8E18DD3745793D0D,30854,12,13,1,109.56889,18.27076,1763
35457,266386,D2D609608AA1D4DD8E18DD3745793D0D,39371,14,15,1,109.56627,18.2646,1762
35467,266396,1DA88ED70B6ADE8EAE3D8F549B029C10,30511,1,6,5,109.51069,18.24208,1558
35468,266397,1DA88ED70B6ADE8EAE3D8F549B029C10,60131,7,8,1,109.49819,18.24778,1509
35469,266400,1DA88ED70B6ADE8EAE3D8F549B029C10,31031,17,23,6,109.49979,18.25382,1510
35470,266403,D7D9352263CF977FD0E7820F34F6CA72,39101,0,1,1,109.50132,18.24931,1509
35471,266404,D7D9352263CF977FD0E7820F34F6CA72,30151,2,11,9,109.50986,18.25083,1560
35472,266405,D7D9352263CF977FD0E7820F34F6CA72,30151,12,14,2,109.50986,18.25083,1560
35473,266411,81BB8442D113627FA1326BEB8BF192ED,60631,0,5,5,109.57778,18.27583,1814
35474,266412,81BB8442D113627FA1326BEB8BF192ED,30854,6,8,2,109.56889,18.27076,1763
35475,266413,81BB8442D113627FA1326BEB8BF192ED,31071,11,12,1,109.58257,18.28458,1815
35496,266520,2BCE896904CBDBCAF567B2CFB43BBDA9,30681,0,8,8,109.48493,18.26917,1463
35497,266521,2BCE896904CBDBCAF567B2CFB43BBDA9,60291,12,13,1,109.50826,18.24639,1509
35498,266522,2BCE896904CBDBCAF567B2CFB43BBDA9,60614,14,15,1,109.48799,18.29521,1467
35512,266647,8621CFDF1B89A83351494618C53D033F,39181,0,1,1,109.55153,18.28035,1715
35513,266648,8621CFDF1B89A83351494618C53D033F,31071,1,5,4,109.58257,18.28458,1815
35514,266649,8621CFDF1B89A83351494618C53D033F,39181,8,14,6,109.55153,18.28035,1715
35515,266650,8621CFDF1B89A83351494618C53D033F,31931,15,17,2,109.54771,18.29403,1667
35549,266845,A88EC491B6BCB711E1CE9190F711D4DE,38291,0,8,8,109.51618,18.24313,1558
35550,266846,A88EC491B6BCB711E1CE9190F711D4DE,60131,9,10,1,109.49819,18.24778,1509
35551,266847,A88EC491B6BCB711E1CE9190F711D4DE,38291,13,21,8,109.51618,18.24313,1558
35572,266977,58DE8A719D3ADBEDAE163213845B460A,60211,0,6,6,109.63549,18.26049,2011
35573,266978,58DE8A719D3ADBEDAE163213845B460A,30854,10,18,8,109.56889,18.27076,1763
35574,266979,58DE8A719D3ADBEDAE163213845B460A,31071,18,21,3,109.58257,18.28458,1815
35575,266980,58DE8A719D3ADBEDAE163213845B460A,30854,21,22,1,109.56889,18.27076,1763
35605,267140,ACDEAAF45B65DE48CF80A48DBD3C775E,31071,3,6,3,109.58257,18.28458,1815
35606,267141,ACDEAAF45B65DE48CF80A48DBD3C775E,30854,9,16,7,109.56889,18.27076,1763
35607,267142,ACDEAAF45B65DE48CF80A48DBD3C775E,31071,16,19,3,109.58257,18.28458,1815
35619,267184,DB4DF566D4757FF3BB488F82DE126248,30851,0,3,3,109.5616,18.27396,1713
35620,267185,DB4DF566D4757FF3BB488F82DE126248,31561,4,16,12,109.56792,18.28479,1765
35621,267186,DB4DF566D4757FF3BB488F82DE126248,60351,17,18,1,109.58403,18.28958,1816
35622,267187,EF1BB24884CAA5A60101DD1EB36004EC,60621,3,6,3,109.48354,18.27451,1464
35623,267188,EF1BB24884CAA5A60101DD1EB36004EC,60401,7,9,2,109.47444,18.27583,1414
35624,267189,EF1BB24884CAA5A60101DD1EB36004EC,31461,12,13,1,109.5091,18.25389,1510
35625,267190,EF1BB24884CAA5A60101DD1EB36004EC,38157,13,14,1,109.51483,18.26958,1563
35626,267195,0312B43ACF9ED1D8304E325E851AEE29,30851,0,8,8,109.5616,18.27396,1713
35627,267196,0312B43ACF9ED1D8304E325E851AEE29,31561,12,15,3,109.56792,18.28479,1765
35628,267197,0312B43ACF9ED1D8304E325E851AEE29,30851,15,20,5,109.5616,18.27396,1713
35634,267229,8F7FB30507503E99C612B652ADC863DC,60381,0,6,6,109.5241,18.22458,1605
35635,267230,8F7FB30507503E99C612B652ADC863DC,31421,7,16,9,109.55382,18.22347,1705
35636,267231,8F7FB30507503E99C612B652ADC863DC,60381,16,18,2,109.5241,18.22458,1605
35637,267285,E0223036572082E83876AFB7D72B2DD2,31931,0,8,8,109.54771,18.29403,1667
35638,267286,E0223036572082E83876AFB7D72B2DD2,30921,9,10,1,109.53903,18.29451,1667
35639,267287,E0223036572082E83876AFB7D72B2DD2,31931,11,20,9,109.54771,18.29403,1667
35640,267295,179FD4660C817BD29234A518F00339D3,60231,3,8,5,109.49903,18.21972,1504
35641,267296,179FD4660C817BD29234A518F00339D3,60161,12,16,4,109.49174,18.26181,1461
35642,267297,179FD4660C817BD29234A518F00339D3,60231,16,18,2,109.49903,18.21972,1504
35672,267565,BD36B617B5735ECF01B192DD8C734880,31421,0,10,10,109.55382,18.22347,1705
35673,267566,BD36B617B5735ECF01B192DD8C734880,60381,14,17,3,109.5241,18.22458,1605
35674,267567,BD36B617B5735ECF01B192DD8C734880,31421,18,20,2,109.55382,18.22347,1705
35690,267691,5205655EC583F6392BC68C8BB9865108,31071,2,7,5,109.58257,18.28458,1815
35691,267692,5205655EC583F6392BC68C8BB9865108,30854,7,11,4,109.56889,18.27076,1763
35692,267693,5205655EC583F6392BC68C8BB9865108,31071,15,16,1,109.58257,18.28458,1815
35699,267745,24892DF473AC6ED4692FBD552CF21D37,60381,0,11,11,109.5241,18.22458,1605
35700,267746,24892DF473AC6ED4692FBD552CF21D37,39321,14,16,2,109.529,18.2167,1604
35701,267747,24892DF473AC6ED4692FBD552CF21D37,60381,20,23,3,109.5241,18.22458,1605
35706,267844,C709D01469E0800AF998DFAF42105CDC,30854,0,5,5,109.56889,18.27076,1763
35707,267845,C709D01469E0800AF998DFAF42105CDC,31561,7,16,9,109.56792,18.28479,1765
35708,267846,C709D01469E0800AF998DFAF42105CDC,30854,18,21,3,109.56889,18.27076,1763
35709,267850,FA14B010F60C7FB3B13194FAA13740E8,31561,1,5,4,109.56792,18.28479,1765
35710,267851,FA14B010F60C7FB3B13194FAA13740E8,39183,9,11,2,109.55542,18.28208,1715
35711,267852,FA14B010F60C7FB3B13194FAA13740E8,31561,11,13,2,109.56792,18.28479,1765
35717,267874,85DE989B49E37442443C5A3C8C9B6ECA,31231,0,6,6,109.42597,18.29292,1217
35718,267875,85DE989B49E37442443C5A3C8C9B6ECA,31431,7,9,2,109.44639,18.29042,1316
35719,267876,85DE989B49E37442443C5A3C8C9B6ECA,30671,12,17,5,109.43611,18.30139,1268
35720,267877,85DE989B49E37442443C5A3C8C9B6ECA,31231,19,23,4,109.42597,18.29292,1217
35737,267998,283001ED673D8EDBEF7EEB00BDB31533,30351,0,5,5,109.41701,18.29292,1217
35738,267999,283001ED673D8EDBEF7EEB00BDB31533,31671,6,15,9,109.38965,18.29813,1068
35739,268000,283001ED673D8EDBEF7EEB00BDB31533,31231,17,21,4,109.42597,18.29292,1217
35753,268068,CB1C8502149DACE0B32B2F7416279EF2,31071,1,7,6,109.58257,18.28458,1815
35754,268069,CB1C8502149DACE0B32B2F7416279EF2,30854,7,10,3,109.56889,18.27076,1763
35755,268070,CB1C8502149DACE0B32B2F7416279EF2,31945,12,13,1,109.58021,18.29403,1817
35772,268140,CFF5BE3C5C109C874F96B9E9841D39B0,30171,0,9,9,109.48458,18.27139,1463
35773,268141,CFF5BE3C5C109C874F96B9E9841D39B0,30171,13,17,4,109.48458,18.27139,1463
35774,268142,CFF5BE3C5C109C874F96B9E9841D39B0,30171,17,23,6,109.48458,18.27139,1463
35787,268246,914EFDE50A6F5785153D97029FF6400E,39183,0,12,12,109.55542,18.28208,1715
35788,268247,914EFDE50A6F5785153D97029FF6400E,30071,12,14,2,109.52819,18.30472,1619
35789,268248,914EFDE50A6F5785153D97029FF6400E,39183,17,18,1,109.55542,18.28208,1715
35790,268249,914EFDE50A6F5785153D97029FF6400E,31931,18,23,5,109.54771,18.29403,1667
35802,268289,A7B3BDD8DC79485BA41EC7F220A41345,60631,1,8,7,109.57778,18.27583,1814
35803,268290,A7B3BDD8DC79485BA41EC7F220A41345,30854,12,19,7,109.56889,18.27076,1763
35804,268291,A7B3BDD8DC79485BA41EC7F220A41345,30421,22,23,1,109.50021,18.25861,1511
35824,268397,CBF71892C67A397772665402624216C5,39183,0,11,11,109.55542,18.28208,1715
35825,268398,CBF71892C67A397772665402624216C5,31931,13,14,1,109.54771,18.29403,1667
35826,268399,CBF71892C67A397772665402624216C5,39183,17,22,5,109.55542,18.28208,1715
35830,268574,557A975BF2F1D3135462224F08758153,38154,1,2,1,109.5266,18.28278,1615
35831,268575,557A975BF2F1D3135462224F08758153,31951,3,14,11,109.52174,18.30299,1568
35832,268576,557A975BF2F1D3135462224F08758153,60221,15,17,2,109.52569,18.29188,1616
35833,268577,557A975BF2F1D3135462224F08758153,31951,18,20,2,109.52174,18.30299,1568
35844,268631,E18C3F4B9E8C48C1B46EB6B7E96BEFCA,31681,1,7,6,109.40396,18.29979,1168
35845,268632,E18C3F4B9E8C48C1B46EB6B7E96BEFCA,38105,7,9,2,109.40299,18.29229,1117
35846,268633,E18C3F4B9E8C48C1B46EB6B7E96BEFCA,31681,13,16,3,109.40396,18.29979,1168
35847,268634,E18C3F4B9E8C48C1B46EB6B7E96BEFCA,38102,19,21,2,109.40875,18.29111,1166
35848,268658,A549C024E6F63EDBD3DC866F10DB11CE,30234,0,5,5,109.60681,18.29979,1918
35849,268659,A549C024E6F63EDBD3DC866F10DB11CE,30854,9,14,5,109.56889,18.27076,1763
35850,268660,A549C024E6F63EDBD3DC866F10DB11CE,31071,17,19,2,109.58257,18.28458,1815
35860,268713,C5B2C146A715B405C4C002F4F3423FFB,31181,1,8,7,109.50382,18.24813,1509
35861,268714,C5B2C146A715B405C4C002F4F3423FFB,39091,8,9,1,109.50097,18.25222,1510
35862,268715,C5B2C146A715B405C4C002F4F3423FFB,60291,10,13,3,109.50826,18.24639,1509
35863,268728,86435198F57620D5DAC23B4A4DA78009,39183,1,7,6,109.55542,18.28208,1715
35864,268729,86435198F57620D5DAC23B4A4DA78009,31931,8,16,8,109.54771,18.29403,1667
35865,268730,86435198F57620D5DAC23B4A4DA78009,39183,18,20,2,109.55542,18.28208,1715
35874,268779,D75F3D28EEDDC3AAB22F587F99A79102,31071,1,4,3,109.58257,18.28458,1815
35875,268780,D75F3D28EEDDC3AAB22F587F99A79102,30854,5,9,4,109.56889,18.27076,1763
35876,268781,D75F3D28EEDDC3AAB22F587F99A79102,31071,11,17,6,109.58257,18.28458,1815
35877,268782,D75F3D28EEDDC3AAB22F587F99A79102,30854,19,23,4,109.56889,18.27076,1763
35878,268791,10EBF762D28520B09848288F7052CFDE,30854,0,6,6,109.56889,18.27076,1763
35879,268792,10EBF762D28520B09848288F7052CFDE,31561,6,12,6,109.56792,18.28479,1765
35880,268793,10EBF762D28520B09848288F7052CFDE,31071,12,15,3,109.58257,18.28458,1815
35881,268794,10EBF762D28520B09848288F7052CFDE,30854,16,23,7,109.56889,18.27076,1763
35893,268856,B09F6CB43F7BB3E6391589239BFB1120,38951,0,17,17,109.48097,18.28868,1416
35894,268857,B09F6CB43F7BB3E6391589239BFB1120,38261,19,20,1,109.50361,18.28153,1515
35895,268858,B09F6CB43F7BB3E6391589239BFB1120,39053,21,23,2,109.511,18.2771,1564
35916,268950,08560778CB8997D42461ACE816D78234,39151,0,2,2,109.49875,18.25097,1510
35917,268951,08560778CB8997D42461ACE816D78234,60401,3,4,1,109.47444,18.27583,1414
35918,268952,08560778CB8997D42461ACE816D78234,60161,7,8,1,109.49174,18.26181,1461
35919,268953,08560778CB8997D42461ACE816D78234,38315,12,13,1,109.48979,18.29764,1467
35931,269058,417408FFDA93B177641D270D3A5C4B2D,31071,0,6,6,109.58257,18.28458,1815
35932,269059,417408FFDA93B177641D270D3A5C4B2D,30854,6,20,14,109.56889,18.27076,1763
35933,269060,417408FFDA93B177641D270D3A5C4B2D,31071,21,23,2,109.58257,18.28458,1815
35960,269240,147470AD3D3B8724582C30D5F244A8B6,60421,0,16,16,109.46333,18.31743,1371
35961,269241,147470AD3D3B8724582C30D5F244A8B6,30111,17,19,2,109.47583,18.30542,1419
35962,269242,147470AD3D3B8724582C30D5F244A8B6,60421,20,22,2,109.46333,18.31743,1371
35997,269522,2D3A7C5FA7BB9EA13D3B1F294EF7FCC8,60381,0,8,8,109.5241,18.22458,1605
35998,269523,2D3A7C5FA7BB9EA13D3B1F294EF7FCC8,60381,10,13,3,109.5241,18.22458,1605
35999,269524,2D3A7C5FA7BB9EA13D3B1F294EF7FCC8,30161,15,18,3,109.50042,18.24389,1508
36000,269530,E16204D131FCD957D5ADB9592C1DD0ED,30854,0,8,8,109.56889,18.27076,1763
36001,269531,E16204D131FCD957D5ADB9592C1DD0ED,31071,13,14,1,109.58257,18.28458,1815
36002,269532,E16204D131FCD957D5ADB9592C1DD0ED,31071,15,19,4,109.58257,18.28458,1815
36005,269535,005F3AEFE6DBF371ED1FD57736434098,31071,0,7,7,109.58257,18.28458,1815
36006,269536,005F3AEFE6DBF371ED1FD57736434098,30854,7,21,14,109.56889,18.27076,1763
36007,269537,005F3AEFE6DBF371ED1FD57736434098,31071,22,23,1,109.58257,18.28458,1815
36008,269561,34F3D64B41C252481F72E5CF931AC833,31071,0,1,1,109.58257,18.28458,1815
36009,269562,34F3D64B41C252481F72E5CF931AC833,30851,3,5,2,109.5616,18.27396,1713
36010,269563,34F3D64B41C252481F72E5CF931AC833,30854,6,20,14,109.56889,18.27076,1763
36026,269624,17A4545370685D172A08774EFEF86DD3,31071,3,4,1,109.58257,18.28458,1815
36027,269625,17A4545370685D172A08774EFEF86DD3,30851,4,6,2,109.5616,18.27396,1713
36028,269626,17A4545370685D172A08774EFEF86DD3,31071,6,9,3,109.58257,18.28458,1815
36039,269767,5426296000364EE32711CD0E73D782C8,30854,3,13,10,109.56889,18.27076,1763
36040,269768,5426296000364EE32711CD0E73D782C8,31071,14,15,1,109.58257,18.28458,1815
36041,269769,5426296000364EE32711CD0E73D782C8,30854,17,18,1,109.56889,18.27076,1763
36042,269788,91EC74D2B208A10BECBB101C6735C578,38171,0,1,1,109.50799,18.28139,1515
36043,269789,91EC74D2B208A10BECBB101C6735C578,31864,1,7,6,109.49014,18.28333,1465
36044,269790,91EC74D2B208A10BECBB101C6735C578,60171,7,13,6,109.51292,18.30694,1569
36054,269886,6FBDDF7419820F8908B8A8CE3C81E7C3,30171,1,3,2,109.48458,18.27139,1463
36055,269887,6FBDDF7419820F8908B8A8CE3C81E7C3,60621,4,19,15,109.48354,18.27451,1464
36056,269888,6FBDDF7419820F8908B8A8CE3C81E7C3,60401,20,21,1,109.47444,18.27583,1414
36057,269889,6FBDDF7419820F8908B8A8CE3C81E7C3,60621,22,23,1,109.48354,18.27451,1464
36066,269987,1D2F8DB1F8B6A2081E1A43DDF558491D,31951,0,9,9,109.52174,18.30299,1568
36067,269988,1D2F8DB1F8B6A2081E1A43DDF558491D,30071,10,11,1,109.52819,18.30472,1619
36068,269989,1D2F8DB1F8B6A2081E1A43DDF558491D,31951,11,19,8,109.52174,18.30299,1568
36075,269996,0526FBDD03CECB7E3925506B4441EC17,31443,0,9,9,109.5116,18.24438,1559
36076,269997,0526FBDD03CECB7E3925506B4441EC17,60361,9,11,2,109.51938,18.29681,1567
36077,269998,0526FBDD03CECB7E3925506B4441EC17,31443,12,20,8,109.5116,18.24438,1559
36080,270092,C711EA8F4B039EAC279F7CFC24309A8A,30071,0,10,10,109.52819,18.30472,1619
36081,270093,C711EA8F4B039EAC279F7CFC24309A8A,30071,11,13,2,109.52819,18.30472,1619
36082,270094,C711EA8F4B039EAC279F7CFC24309A8A,30071,16,18,2,109.52819,18.30472,1619
36083,270095,C711EA8F4B039EAC279F7CFC24309A8A,38484,20,22,2,109.53028,18.31528,1620
36102,270280,46D3900FF4CD0CE137E6DB2E5BBC5B87,39183,0,12,12,109.55542,18.28208,1715
36103,270281,46D3900FF4CD0CE137E6DB2E5BBC5B87,31561,15,17,2,109.56792,18.28479,1765
36104,270282,46D3900FF4CD0CE137E6DB2E5BBC5B87,39183,17,23,6,109.55542,18.28208,1715
36138,270525,D334753E33AD01D79142036B3D85543F,31561,0,5,5,109.56792,18.28479,1765
36139,270526,D334753E33AD01D79142036B3D85543F,39183,6,11,5,109.55542,18.28208,1715
36140,270527,D334753E33AD01D79142036B3D85543F,31561,15,16,1,109.56792,18.28479,1765
36141,270563,47A18820FDA9856131F74091D44B6BCB,31071,0,6,6,109.58257,18.28458,1815
36142,270564,47A18820FDA9856131F74091D44B6BCB,31561,7,10,3,109.56792,18.28479,1765
36143,270565,47A18820FDA9856131F74091D44B6BCB,31071,12,13,1,109.58257,18.28458,1815
36144,270566,47A18820FDA9856131F74091D44B6BCB,31561,14,21,7,109.56792,18.28479,1765
36151,270707,8E06EAC16B0EF776FA1BAAC5B9747325,30911,0,8,8,109.50493,18.26181,1511
36152,270708,8E06EAC16B0EF776FA1BAAC5B9747325,30511,11,13,2,109.51069,18.24208,1558
36153,270709,8E06EAC16B0EF776FA1BAAC5B9747325,30511,15,18,3,109.51069,18.24208,1558
36154,270710,8E06EAC16B0EF776FA1BAAC5B9747325,60331,18,23,5,109.505,18.26507,1512
36160,270718,84DF4A7C208235D171EF56473BCCF210,30851,0,3,3,109.5616,18.27396,1713
36161,270719,84DF4A7C208235D171EF56473BCCF210,31561,3,6,3,109.56792,18.28479,1765
36162,270720,84DF4A7C208235D171EF56473BCCF210,60631,7,16,9,109.57778,18.27583,1814
36186,270789,7024F3A14F6F554DC6E80063E30315F0,31561,2,14,12,109.56792,18.28479,1765
36187,270790,7024F3A14F6F554DC6E80063E30315F0,30854,15,16,1,109.56889,18.27076,1763
36188,270791,7024F3A14F6F554DC6E80063E30315F0,31561,21,23,2,109.56792,18.28479,1765
36194,270868,8B167331F8E78254A4CBA6A89A1236BC,60524,0,7,7,109.42951,18.28993,1216
36195,270869,8B167331F8E78254A4CBA6A89A1236BC,60401,12,13,1,109.47444,18.27583,1414
36196,270870,8B167331F8E78254A4CBA6A89A1236BC,60524,14,15,1,109.42951,18.28993,1216
36197,270871,8B167331F8E78254A4CBA6A89A1236BC,60551,16,17,1,109.42722,18.30111,1218
36204,270898,F00821368F615DCDAF214035D8EC4A44,31071,1,2,1,109.58257,18.28458,1815
36205,270899,F00821368F615DCDAF214035D8EC4A44,30854,2,11,9,109.56889,18.27076,1763
36206,270900,F00821368F615DCDAF214035D8EC4A44,60354,15,16,1,109.58701,18.28521,1815
36207,270920,96F98526707B06BE1263CCD4F72E07A1,31071,0,8,8,109.58257,18.28458,1815
36208,270921,96F98526707B06BE1263CCD4F72E07A1,30854,9,10,1,109.56889,18.27076,1763
36209,270922,96F98526707B06BE1263CCD4F72E07A1,31071,11,13,2,109.58257,18.28458,1815
36210,270923,335A7B1DE8538918FDA774EE3E402A76,30191,0,7,7,109.50361,18.22701,1506
36211,270924,335A7B1DE8538918FDA774EE3E402A76,31521,9,13,4,109.51458,18.22542,1555
36212,270925,335A7B1DE8538918FDA774EE3E402A76,30191,13,23,10,109.50361,18.22701,1506
36221,271006,409F5E8F01172D32BBE91132149C037E,38376,0,9,9,109.50924,18.24,1558
36222,271007,409F5E8F01172D32BBE91132149C037E,30171,10,12,2,109.48458,18.27139,1463
36223,271008,409F5E8F01172D32BBE91132149C037E,30361,12,14,2,109.50347,18.24,1508
36224,271009,409F5E8F01172D32BBE91132149C037E,31271,19,20,1,109.48958,18.26257,1462
36230,271021,75BB5F056A285E641293B913E6CE7C17,38291,0,8,8,109.51618,18.24313,1558
36231,271022,75BB5F056A285E641293B913E6CE7C17,60311,8,11,3,109.52097,18.24319,1558
36232,271023,75BB5F056A285E641293B913E6CE7C17,31864,12,14,2,109.49014,18.28333,1465
36259,271178,DBB710D279E76C79F1E4B0766F579F8A,31071,1,7,6,109.58257,18.28458,1815
36260,271179,DBB710D279E76C79F1E4B0766F579F8A,30854,9,10,1,109.56889,18.27076,1763
36261,271180,DBB710D279E76C79F1E4B0766F579F8A,31945,14,15,1,109.58021,18.29403,1817
36276,271259,000584B3023702F3E9DDF521B1C35B1A,31071,1,6,5,109.58257,18.28458,1815
36277,271260,000584B3023702F3E9DDF521B1C35B1A,30854,8,10,2,109.56889,18.27076,1763
36278,271261,000584B3023702F3E9DDF521B1C35B1A,31945,12,23,11,109.58021,18.29403,1817
36311,271470,51061B3DE820AF1C1C713EF684728003,31071,2,6,4,109.58257,18.28458,1815
36312,271471,51061B3DE820AF1C1C713EF684728003,30854,9,10,1,109.56889,18.27076,1763
36313,271472,51061B3DE820AF1C1C713EF684728003,31071,13,14,1,109.58257,18.28458,1815
36314,271473,51061B3DE820AF1C1C713EF684728003,30854,14,21,7,109.56889,18.27076,1763
36327,271563,73FC49A89676FB4107071248ADBDF948,31561,0,2,2,109.56792,18.28479,1765
36328,271564,73FC49A89676FB4107071248ADBDF948,39183,6,9,3,109.55542,18.28208,1715
36329,271565,73FC49A89676FB4107071248ADBDF948,30851,9,15,6,109.5616,18.27396,1713
36330,271566,73FC49A89676FB4107071248ADBDF948,39183,17,18,1,109.55542,18.28208,1715
36345,271671,F3EA4B3DF8A619A30272A53ECD9E968F,30461,0,11,11,109.5116,18.26313,1562
36346,271672,F3EA4B3DF8A619A30272A53ECD9E968F,30711,11,14,3,109.50271,18.25347,1510
36347,271673,F3EA4B3DF8A619A30272A53ECD9E968F,31351,19,20,1,109.4959,18.28417,1465
36348,271727,92E14A6094471B9C1A50CE8585136EC6,30211,0,2,2,109.49882,18.23931,1508
36349,271728,92E14A6094471B9C1A50CE8585136EC6,60087,5,7,2,109.50688,18.22299,1505
36350,271730,92E14A6094471B9C1A50CE8585136EC6,30731,16,23,7,109.50944,18.22306,1555
36351,271771,DC9973204E62AA99FA79F0696CF6C0F6,30854,1,10,9,109.56889,18.27076,1763
36352,271772,DC9973204E62AA99FA79F0696CF6C0F6,31945,15,16,1,109.58021,18.29403,1817
36353,271773,DC9973204E62AA99FA79F0696CF6C0F6,30854,19,23,4,109.56889,18.27076,1763
36364,271860,37657A593A7A700C5ECCE5BB0AAAABA7,31931,0,6,6,109.54771,18.29403,1667
36365,271861,37657A593A7A700C5ECCE5BB0AAAABA7,39181,7,8,1,109.55153,18.28035,1715
36366,271862,37657A593A7A700C5ECCE5BB0AAAABA7,31931,9,19,10,109.54771,18.29403,1667
36378,271909,9AA959ED87D1ECC3053DED17290EFCBD,31561,0,4,4,109.56792,18.28479,1765
36379,271910,9AA959ED87D1ECC3053DED17290EFCBD,39183,7,8,1,109.55542,18.28208,1715
36380,271911,9AA959ED87D1ECC3053DED17290EFCBD,31561,9,22,13,109.56792,18.28479,1765
36381,271936,FA724E83D7D22E41E07D0D2550D22166,30854,0,5,5,109.56889,18.27076,1763
36382,271937,FA724E83D7D22E41E07D0D2550D22166,31031,7,8,1,109.49979,18.25382,1510
36383,271938,FA724E83D7D22E41E07D0D2550D22166,30854,12,21,9,109.56889,18.27076,1763
36405,272119,9E8746086915F9D4A063A74CF0B5B7AB,31561,1,14,13,109.56792,18.28479,1765
36406,272120,9E8746086915F9D4A063A74CF0B5B7AB,31931,14,15,1,109.54771,18.29403,1667
36407,272121,9E8746086915F9D4A063A74CF0B5B7AB,30854,18,19,1,109.56889,18.27076,1763
36424,272245,1419F2503130508E06D5FA0D4A5CF329,31261,0,1,1,109.51174,18.2466,1559
36425,272246,1419F2503130508E06D5FA0D4A5CF329,31031,1,18,17,109.49979,18.25382,1510
36426,272247,1419F2503130508E06D5FA0D4A5CF329,31461,18,20,2,109.5091,18.25389,1510
36427,272248,1419F2503130508E06D5FA0D4A5CF329,31031,21,22,1,109.49979,18.25382,1510
36428,272249,31C925B9876FE9FFC3F673B5040150FB,39111,0,4,4,109.5191,18.22597,1555
36429,272250,31C925B9876FE9FFC3F673B5040150FB,31521,5,18,13,109.51458,18.22542,1555
36430,272251,31C925B9876FE9FFC3F673B5040150FB,31521,20,21,1,109.51458,18.22542,1555
36431,272252,31C925B9876FE9FFC3F673B5040150FB,31521,22,23,1,109.51458,18.22542,1555
36438,272294,52D077B19C6C1BD347E6DC20309A3DC3,31071,0,14,14,109.58257,18.28458,1815
36439,272295,52D077B19C6C1BD347E6DC20309A3DC3,31071,16,21,5,109.58257,18.28458,1815
36440,272296,52D077B19C6C1BD347E6DC20309A3DC3,30854,21,23,2,109.56889,18.27076,1763
36441,272306,E75CF54BA14775FEDD26504F9F6B7365,31945,0,6,6,109.58021,18.29403,1817
36442,272307,E75CF54BA14775FEDD26504F9F6B7365,31561,6,16,10,109.56792,18.28479,1765
36443,272308,E75CF54BA14775FEDD26504F9F6B7365,30854,17,18,1,109.56889,18.27076,1763
36450,272388,39F25FE146A03325C93C111F2A943B6C,31945,0,17,17,109.58021,18.29403,1817
36451,272389,39F25FE146A03325C93C111F2A943B6C,31071,19,20,1,109.58257,18.28458,1815
36452,272390,39F25FE146A03325C93C111F2A943B6C,31945,21,22,1,109.58021,18.29403,1817
36469,272480,B34415F599F0ED7D1A073EE314A60B9B,31671,0,6,6,109.38965,18.29813,1068
36470,272481,B34415F599F0ED7D1A073EE314A60B9B,60041,6,9,3,109.39889,18.31944,1121
36471,272482,B34415F599F0ED7D1A073EE314A60B9B,31671,11,17,6,109.38965,18.29813,1068
36472,272483,B34415F599F0ED7D1A073EE314A60B9B,60041,17,19,2,109.39889,18.31944,1121
36476,272526,70655AD92B06CDB42EC8BC912F906F64,39091,1,5,4,109.50097,18.25222,1510
36477,272527,70655AD92B06CDB42EC8BC912F906F64,60131,8,9,1,109.49819,18.24778,1509
36478,272528,70655AD92B06CDB42EC8BC912F906F64,60231,9,12,3,109.49903,18.21972,1504
36479,272529,70655AD92B06CDB42EC8BC912F906F64,30051,13,18,5,109.48917,18.21215,1453
36488,272602,F25C237DB3948CAE74585CD60FBB2501,39183,0,11,11,109.55542,18.28208,1715
36489,272603,F25C237DB3948CAE74585CD60FBB2501,39181,13,15,2,109.55153,18.28035,1715
36490,272604,F25C237DB3948CAE74585CD60FBB2501,31561,15,16,1,109.56792,18.28479,1765
36491,272620,1D60D001EBDC67D77E1C6037DB507422,31561,0,7,7,109.56792,18.28479,1765
36492,272621,1D60D001EBDC67D77E1C6037DB507422,30854,8,16,8,109.56889,18.27076,1763
36493,272622,1D60D001EBDC67D77E1C6037DB507422,31561,21,23,2,109.56792,18.28479,1765
36503,272736,03CEC0FDDD5484124514C6D24A63D4DD,31561,0,7,7,109.56792,18.28479,1765
36504,272737,03CEC0FDDD5484124514C6D24A63D4DD,39183,9,11,2,109.55542,18.28208,1715
36505,272738,03CEC0FDDD5484124514C6D24A63D4DD,31561,13,15,2,109.56792,18.28479,1765
36509,272798,967E548F53382C36FB0D7FF12F6A99E7,31531,0,6,6,109.49583,18.25972,1461
36510,272799,967E548F53382C36FB0D7FF12F6A99E7,60131,7,9,2,109.49819,18.24778,1509
36511,272800,967E548F53382C36FB0D7FF12F6A99E7,31531,9,23,14,109.49583,18.25972,1461
36519,272852,3FB32E010B50E0771D17FFE0A2CC7BCE,30854,0,14,14,109.56889,18.27076,1763
36520,272853,3FB32E010B50E0771D17FFE0A2CC7BCE,60221,15,18,3,109.52569,18.29188,1616
36521,272854,3FB32E010B50E0771D17FFE0A2CC7BCE,31071,18,19,1,109.58257,18.28458,1815
36522,272855,3FB32E010B50E0771D17FFE0A2CC7BCE,30854,20,21,1,109.56889,18.27076,1763
36568,273281,D313F95AC05082149211CB8CD175B418,31071,0,6,6,109.58257,18.28458,1815
36569,273282,D313F95AC05082149211CB8CD175B418,30854,7,8,1,109.56889,18.27076,1763
36570,273283,D313F95AC05082149211CB8CD175B418,31071,12,22,10,109.58257,18.28458,1815
36573,273368,8153BB62691548A16A2644B188DEA105,31561,0,9,9,109.56792,18.28479,1765
36574,273369,8153BB62691548A16A2644B188DEA105,31071,9,12,3,109.58257,18.28458,1815
36575,273370,8153BB62691548A16A2644B188DEA105,30854,13,17,4,109.56889,18.27076,1763
36576,273371,8153BB62691548A16A2644B188DEA105,31561,22,23,1,109.56792,18.28479,1765
36585,273402,8F6EA1C108FADA76A214A7ED71ECE3D1,30891,4,5,1,109.59431,18.28389,1865
36586,273403,8F6EA1C108FADA76A214A7ED71ECE3D1,30851,6,7,1,109.5616,18.27396,1713
36587,273404,8F6EA1C108FADA76A214A7ED71ECE3D1,30854,10,18,8,109.56889,18.27076,1763
36588,273405,39D4F14340B4650E084697607335F122,30161,0,9,9,109.50042,18.24389,1508
36589,273406,39D4F14340B4650E084697607335F122,30281,13,17,4,109.50597,18.27583,1514
36590,273407,39D4F14340B4650E084697607335F122,30911,19,20,1,109.50493,18.26181,1511
36593,273517,CFFDD1BF3134B9FDD71614F40E1DE0FD,31071,0,2,2,109.58257,18.28458,1815
36594,273518,CFFDD1BF3134B9FDD71614F40E1DE0FD,31561,4,6,2,109.56792,18.28479,1765
36595,273519,CFFDD1BF3134B9FDD71614F40E1DE0FD,31071,7,21,14,109.58257,18.28458,1815
36622,273919,EC89B2FFE00F967E6D0A3B697A6D636D,31071,0,17,17,109.58257,18.28458,1815
36623,273920,EC89B2FFE00F967E6D0A3B697A6D636D,39181,19,21,2,109.55153,18.28035,1715
36624,273921,EC89B2FFE00F967E6D0A3B697A6D636D,60631,21,23,2,109.57778,18.27583,1814
36671,274209,A795428793D2273B4ACFDADC5E61AEC2,60661,0,5,5,109.548,18.2377,1657
36672,274210,A795428793D2273B4ACFDADC5E61AEC2,31421,6,8,2,109.55382,18.22347,1705
36673,274211,A795428793D2273B4ACFDADC5E61AEC2,60641,12,13,1,109.53854,18.2359,1657
36674,274212,A795428793D2273B4ACFDADC5E61AEC2,60381,16,17,1,109.5241,18.22458,1605
36681,274238,EA4EEEA6F324C3F08DBAE63BA2B33BB6,30084,0,7,7,109.50118,18.26972,1513
36682,274239,EA4EEEA6F324C3F08DBAE63BA2B33BB6,31391,8,9,1,109.50382,18.24285,1508
36683,274240,EA4EEEA6F324C3F08DBAE63BA2B33BB6,30084,10,17,7,109.50118,18.26972,1513
36684,274241,EA4EEEA6F324C3F08DBAE63BA2B33BB6,60291,20,22,2,109.50826,18.24639,1509
36687,274247,14DD9E5DCCEFE8BE7425556E4E04FC9A,31071,0,4,4,109.58257,18.28458,1815
36688,274248,14DD9E5DCCEFE8BE7425556E4E04FC9A,30681,8,9,1,109.48493,18.26917,1463
36689,274249,14DD9E5DCCEFE8BE7425556E4E04FC9A,31071,11,12,1,109.58257,18.28458,1815
36696,274325,30CCDA3A282DA68630C9C45738B256B1,60631,1,2,1,109.57778,18.27583,1814
36697,274326,30CCDA3A282DA68630C9C45738B256B1,39371,2,3,1,109.56627,18.2646,1762
36698,274327,30CCDA3A282DA68630C9C45738B256B1,60631,4,5,1,109.57778,18.27583,1814
36718,274651,D2D609608AA1D4DD8E18DD3745793D0D,31071,0,10,10,109.58257,18.28458,1815
36719,274652,D2D609608AA1D4DD8E18DD3745793D0D,30854,11,12,1,109.56889,18.27076,1763
36720,274653,D2D609608AA1D4DD8E18DD3745793D0D,31071,17,21,4,109.58257,18.28458,1815
36725,274690,81BB8442D113627FA1326BEB8BF192ED,31071,2,4,2,109.58257,18.28458,1815
36726,274691,81BB8442D113627FA1326BEB8BF192ED,60631,5,6,1,109.57778,18.27583,1814
36727,274692,81BB8442D113627FA1326BEB8BF192ED,60354,7,8,1,109.58701,18.28521,1815
36757,275128,EB316856896788EC8FD871E122E95728,31811,0,6,6,109.54201,18.31806,1671
36758,275129,EB316856896788EC8FD871E122E95728,30701,9,10,1,109.59313,18.32007,1871
36759,275130,EB316856896788EC8FD871E122E95728,30931,11,12,1,109.55653,18.32722,1722
36760,275131,EB316856896788EC8FD871E122E95728,30701,12,14,2,109.59313,18.32007,1871
36766,275162,878FC5EBB1B28FAABA6E6BFD01664318,30251,0,7,7,109.50611,18.26653,1512
36767,275163,878FC5EBB1B28FAABA6E6BFD01664318,30161,10,12,2,109.50042,18.24389,1508
36768,275164,878FC5EBB1B28FAABA6E6BFD01664318,30251,16,23,7,109.50611,18.26653,1512
36775,275237,58DE8A719D3ADBEDAE163213845B460A,31071,1,9,8,109.58257,18.28458,1815
36776,275238,58DE8A719D3ADBEDAE163213845B460A,30854,10,12,2,109.56889,18.27076,1763
36777,275239,58DE8A719D3ADBEDAE163213845B460A,31071,12,21,9,109.58257,18.28458,1815
36778,275242,9DE8C13901CC7D63E2F1A6CC92603604,30854,0,16,16,109.56889,18.27076,1763
36779,275243,9DE8C13901CC7D63E2F1A6CC92603604,31561,19,21,2,109.56792,18.28479,1765
36780,275244,9DE8C13901CC7D63E2F1A6CC92603604,30854,21,22,1,109.56889,18.27076,1763
36787,275364,AE6DC7ACB81DB5F351E45AC25E5F5A3B,60234,0,1,1,109.49577,18.2096,1453
36788,275365,AE6DC7ACB81DB5F351E45AC25E5F5A3B,38297,3,13,10,109.52576,18.24965,1609
36789,275366,AE6DC7ACB81DB5F351E45AC25E5F5A3B,31031,13,15,2,109.49979,18.25382,1510
36790,275384,2F440A235E684ECEDD042B3100A4AE95,31071,0,7,7,109.58257,18.28458,1815
36791,275385,2F440A235E684ECEDD042B3100A4AE95,30854,9,11,2,109.56889,18.27076,1763
36792,275386,2F440A235E684ECEDD042B3100A4AE95,31561,11,13,2,109.56792,18.28479,1765
36793,275387,2F440A235E684ECEDD042B3100A4AE95,30854,16,18,2,109.56889,18.27076,1763
36810,275426,3B6FF1F8D896A0A62DC7E65967011999,39183,1,7,6,109.55542,18.28208,1715
36811,275427,3B6FF1F8D896A0A62DC7E65967011999,31561,8,9,1,109.56792,18.28479,1765
36812,275428,3B6FF1F8D896A0A62DC7E65967011999,39183,10,22,12,109.55542,18.28208,1715
36823,275485,8BA35998A9CE7C24B2B6807A6971F954,31071,0,6,6,109.58257,18.28458,1815
36824,275486,8BA35998A9CE7C24B2B6807A6971F954,30854,8,13,5,109.56889,18.27076,1763
36825,275487,8BA35998A9CE7C24B2B6807A6971F954,31071,18,19,1,109.58257,18.28458,1815
36826,275544,5CC1762A5E087A77C8027D2CC6A16A88,30071,0,7,7,109.52819,18.30472,1619
36827,275545,5CC1762A5E087A77C8027D2CC6A16A88,30741,11,14,3,109.49833,18.28681,1516
36828,275546,5CC1762A5E087A77C8027D2CC6A16A88,30071,15,16,1,109.52819,18.30472,1619
36829,275569,179FD4660C817BD29234A518F00339D3,60231,0,10,10,109.49903,18.21972,1504
36830,275570,179FD4660C817BD29234A518F00339D3,60161,12,18,6,109.49174,18.26181,1461
36831,275571,179FD4660C817BD29234A518F00339D3,60231,21,23,2,109.49903,18.21972,1504
36836,275669,8265A029C672FE0377EF574CC3ADF2A8,30851,2,4,2,109.5616,18.27396,1713
36837,275670,8265A029C672FE0377EF574CC3ADF2A8,31561,4,6,2,109.56792,18.28479,1765
36838,275671,8265A029C672FE0377EF574CC3ADF2A8,30854,8,10,2,109.56889,18.27076,1763
36839,275672,8265A029C672FE0377EF574CC3ADF2A8,39183,12,15,3,109.55542,18.28208,1715
36848,275700,0F98E37DE1961685D13076F13D009CFF,31231,0,8,8,109.42597,18.29292,1217
36849,275701,0F98E37DE1961685D13076F13D009CFF,31471,9,12,3,109.34583,18.29563,917
36850,275702,0F98E37DE1961685D13076F13D009CFF,30354,16,23,7,109.42813,18.29076,1216
36851,275707,F40D9EDCF61ACD3AD16762F84000E564,30171,0,4,4,109.48458,18.27139,1463
36852,275708,F40D9EDCF61ACD3AD16762F84000E564,30171,4,7,3,109.48458,18.27139,1463
36853,275711,F40D9EDCF61ACD3AD16762F84000E564,31031,18,21,3,109.49979,18.25382,1510
36870,275852,BD36B617B5735ECF01B192DD8C734880,60661,0,6,6,109.548,18.2377,1657
36871,275853,BD36B617B5735ECF01B192DD8C734880,60381,11,13,2,109.5241,18.22458,1605
36872,275854,BD36B617B5735ECF01B192DD8C734880,31061,13,15,2,109.53333,18.23257,1607
36873,275855,BD36B617B5735ECF01B192DD8C734880,31421,19,22,3,109.55382,18.22347,1705
36879,275887,C93386A9D86FE22A1FD4E5116045DD8D,31561,0,12,12,109.56792,18.28479,1765
36880,275888,C93386A9D86FE22A1FD4E5116045DD8D,39183,14,16,2,109.55542,18.28208,1715
36881,275889,C93386A9D86FE22A1FD4E5116045DD8D,31561,17,19,2,109.56792,18.28479,1765
36882,275890,C93386A9D86FE22A1FD4E5116045DD8D,30854,19,20,1,109.56889,18.27076,1763
36883,275911,2B8C748A18FA7D08D4335AD7C9DEF01B,31761,0,6,6,109.60521,18.27965,1914
36884,275912,2B8C748A18FA7D08D4335AD7C9DEF01B,30851,8,10,2,109.5616,18.27396,1713
36885,275913,2B8C748A18FA7D08D4335AD7C9DEF01B,30951,12,13,1,109.56208,18.25667,1761
36886,275920,48EC852B1939DE9DE8D67EA49BF6D736,30201,0,8,8,109.4909,18.26465,1462
36887,275921,48EC852B1939DE9DE8D67EA49BF6D736,30251,12,13,1,109.50611,18.26653,1512
36888,275922,48EC852B1939DE9DE8D67EA49BF6D736,30201,16,17,1,109.4909,18.26465,1462
36889,275923,48EC852B1939DE9DE8D67EA49BF6D736,60401,21,22,1,109.47444,18.27583,1414
36896,275968,EFDE35289FEC1E13D6F34EFEE66A8AD2,60631,0,7,7,109.57778,18.27583,1814
36897,275969,EFDE35289FEC1E13D6F34EFEE66A8AD2,31071,11,13,2,109.58257,18.28458,1815
36898,275970,EFDE35289FEC1E13D6F34EFEE66A8AD2,60631,18,23,5,109.57778,18.27583,1814
36899,275989,BE74D5A2C373F8231889AF03B59762B2,30854,0,5,5,109.56889,18.27076,1763
36900,275990,BE74D5A2C373F8231889AF03B59762B2,60631,7,8,1,109.57778,18.27583,1814
36901,275991,BE74D5A2C373F8231889AF03B59762B2,30854,10,11,1,109.56889,18.27076,1763
36902,276008,3977578BE56276DA0700B04B81DC1356,30851,0,1,1,109.5616,18.27396,1713
36903,276009,3977578BE56276DA0700B04B81DC1356,31561,2,3,1,109.56792,18.28479,1765
36904,276010,3977578BE56276DA0700B04B81DC1356,30851,3,20,17,109.5616,18.27396,1713
36905,276011,3977578BE56276DA0700B04B81DC1356,31561,21,23,2,109.56792,18.28479,1765
36913,276095,24892DF473AC6ED4692FBD552CF21D37,60381,1,10,9,109.5241,18.22458,1605
36914,276096,24892DF473AC6ED4692FBD552CF21D37,30711,14,16,2,109.50271,18.25347,1510
36915,276097,24892DF473AC6ED4692FBD552CF21D37,60381,16,23,7,109.5241,18.22458,1605
36919,276162,56C8C781972E8BFAF8A768A19AD7F590,31861,0,1,1,109.49042,18.27549,1464
36920,276163,56C8C781972E8BFAF8A768A19AD7F590,30281,2,7,5,109.50597,18.27583,1514
36921,276165,56C8C781972E8BFAF8A768A19AD7F590,30281,19,23,4,109.50597,18.27583,1514
36922,276185,C709D01469E0800AF998DFAF42105CDC,60631,0,5,5,109.57778,18.27583,1814
36923,276186,C709D01469E0800AF998DFAF42105CDC,31561,5,16,11,109.56792,18.28479,1765
36924,276187,C709D01469E0800AF998DFAF42105CDC,30854,18,20,2,109.56889,18.27076,1763
36925,276188,C709D01469E0800AF998DFAF42105CDC,60631,21,23,2,109.57778,18.27583,1814
36932,276206,8A0382A2385C362EFE2664E8795F133E,31561,0,3,3,109.56792,18.28479,1765
36933,276207,8A0382A2385C362EFE2664E8795F133E,39183,4,5,1,109.55542,18.28208,1715
36934,276208,8A0382A2385C362EFE2664E8795F133E,31561,7,23,16,109.56792,18.28479,1765
36935,276209,3160CBE2F0CDCB610575CDC881D9968C,38297,0,8,8,109.52576,18.24965,1609
36936,276210,3160CBE2F0CDCB610575CDC881D9968C,39154,10,11,1,109.50201,18.25681,1511
36937,276211,3160CBE2F0CDCB610575CDC881D9968C,30421,12,16,4,109.50021,18.25861,1511
36948,276327,5E8FF49D1CCDA711846608608C7FAE0D,31071,0,6,6,109.58257,18.28458,1815
36949,276328,5E8FF49D1CCDA711846608608C7FAE0D,30854,7,20,13,109.56889,18.27076,1763
36950,276329,5E8FF49D1CCDA711846608608C7FAE0D,31071,20,23,3,109.58257,18.28458,1815
37000,276679,38373FB2D234CBFB5EC902C1D6C5AD6D,31864,0,9,9,109.49014,18.28333,1465
37001,276680,38373FB2D234CBFB5EC902C1D6C5AD6D,30361,12,14,2,109.50347,18.24,1508
37002,276681,38373FB2D234CBFB5EC902C1D6C5AD6D,30211,16,17,1,109.49882,18.23931,1508
37003,276682,38373FB2D234CBFB5EC902C1D6C5AD6D,31864,21,23,2,109.49014,18.28333,1465
37004,276696,DF296B63A64E364FCDA4C38B0935EEEE,30511,0,1,1,109.51069,18.24208,1558
37005,276697,DF296B63A64E364FCDA4C38B0935EEEE,30151,4,11,7,109.50986,18.25083,1560
37006,276698,DF296B63A64E364FCDA4C38B0935EEEE,30511,11,23,12,109.51069,18.24208,1558
37029,277033,DD056101D68CBFC24096E8F587CC747C,30071,1,19,18,109.52819,18.30472,1619
37030,277034,DD056101D68CBFC24096E8F587CC747C,31931,20,22,2,109.54771,18.29403,1667
37031,277035,DD056101D68CBFC24096E8F587CC747C,30921,22,23,1,109.53903,18.29451,1667
37032,277040,423E2A7AD06C927EE0BD23EE3AB605E3,30854,0,6,6,109.56889,18.27076,1763
37033,277041,423E2A7AD06C927EE0BD23EE3AB605E3,30171,9,12,3,109.48458,18.27139,1463
37034,277042,423E2A7AD06C927EE0BD23EE3AB605E3,30854,15,23,8,109.56889,18.27076,1763
37039,277093,97C31877CA4226D0F1BA1C0E12066B56,60331,0,6,6,109.505,18.26507,1512
37040,277094,97C31877CA4226D0F1BA1C0E12066B56,30854,10,18,8,109.56889,18.27076,1763
37041,277095,97C31877CA4226D0F1BA1C0E12066B56,30251,19,22,3,109.50611,18.26653,1512
37063,277169,86435198F57620D5DAC23B4A4DA78009,39183,2,4,2,109.55542,18.28208,1715
37064,277170,86435198F57620D5DAC23B4A4DA78009,31931,4,6,2,109.54771,18.29403,1667
37065,277171,86435198F57620D5DAC23B4A4DA78009,39183,8,14,6,109.55542,18.28208,1715
37066,277172,86435198F57620D5DAC23B4A4DA78009,31931,16,20,4,109.54771,18.29403,1667
37067,277179,D090D23BEAB243AAF74CB3648E81F65B,30851,0,4,4,109.5616,18.27396,1713
37068,277180,D090D23BEAB243AAF74CB3648E81F65B,30854,4,5,1,109.56889,18.27076,1763
37069,277181,D090D23BEAB243AAF74CB3648E81F65B,31561,8,19,11,109.56792,18.28479,1765
37081,277285,546C572FC49C780F9A9AF62ED98666DF,30351,1,6,5,109.41701,18.29292,1217
37082,277286,546C572FC49C780F9A9AF62ED98666DF,30681,8,20,12,109.48493,18.26917,1463
37083,277287,546C572FC49C780F9A9AF62ED98666DF,30351,21,23,2,109.41701,18.29292,1217
37109,277475,FD383D619F571E97F6F509FAB965E5A5,31461,0,7,7,109.5091,18.25389,1510
37110,277476,FD383D619F571E97F6F509FAB965E5A5,60201,9,11,2,109.5041,18.2509,1510
37111,277477,FD383D619F571E97F6F509FAB965E5A5,30861,13,14,1,109.52722,18.22743,1606
37112,277480,37DC2EF674B0D61C6D10D120CF46E31D,60221,0,9,9,109.52569,18.29188,1616
37113,277481,37DC2EF674B0D61C6D10D120CF46E31D,30151,12,17,5,109.50986,18.25083,1560
37114,277482,37DC2EF674B0D61C6D10D120CF46E31D,60221,18,23,5,109.52569,18.29188,1616
37138,277540,D70D11871FB47AB4743A9AB8A25E5AA8,38241,1,6,5,109.54111,18.30542,1669
37139,277541,D70D11871FB47AB4743A9AB8A25E5AA8,60241,6,18,12,109.53319,18.28667,1616
37140,277542,D70D11871FB47AB4743A9AB8A25E5AA8,38241,19,22,3,109.54111,18.30542,1669
37167,277749,8DD23AA43C0F7967C45F7488D66F9159,30854,0,1,1,109.56889,18.27076,1763
37168,277750,8DD23AA43C0F7967C45F7488D66F9159,31945,2,6,4,109.58021,18.29403,1817
37169,277751,8DD23AA43C0F7967C45F7488D66F9159,30854,6,12,6,109.56889,18.27076,1763
37173,277762,147470AD3D3B8724582C30D5F244A8B6,60421,0,6,6,109.46333,18.31743,1371
37174,277763,147470AD3D3B8724582C30D5F244A8B6,30111,7,14,7,109.47583,18.30542,1419
37175,277764,147470AD3D3B8724582C30D5F244A8B6,60421,18,23,5,109.46333,18.31743,1371
37185,277830,6128117B6C62D97BBF6E959D2F3E0A2E,39181,0,6,6,109.55153,18.28035,1715
37186,277831,6128117B6C62D97BBF6E959D2F3E0A2E,31931,8,9,1,109.54771,18.29403,1667
37187,277832,6128117B6C62D97BBF6E959D2F3E0A2E,39181,10,23,13,109.55153,18.28035,1715
37188,277862,C85D0B931BEF54F05B9ABBBB03212DB7,30854,0,10,10,109.56889,18.27076,1763
37189,277863,C85D0B931BEF54F05B9ABBBB03212DB7,31561,15,16,1,109.56792,18.28479,1765
37190,277864,C85D0B931BEF54F05B9ABBBB03212DB7,30854,16,23,7,109.56889,18.27076,1763
37202,278039,8BB15E7C959475309A269AAF24FD7109,31521,3,8,5,109.51458,18.22542,1555
37203,278040,8BB15E7C959475309A269AAF24FD7109,31521,9,17,8,109.51458,18.22542,1555
37204,278041,8BB15E7C959475309A269AAF24FD7109,60381,18,22,4,109.5241,18.22458,1605
37205,278050,75817DB682187A07461734D66E1E6492,60631,0,5,5,109.57778,18.27583,1814
37206,278051,75817DB682187A07461734D66E1E6492,30854,6,16,10,109.56889,18.27076,1763
37207,278052,75817DB682187A07461734D66E1E6492,60631,18,23,5,109.57778,18.27583,1814
37223,278134,F57902A58026464B5BDED6D5CB0C8C35,30081,0,12,12,109.50243,18.26632,1512
37224,278135,F57902A58026464B5BDED6D5CB0C8C35,31461,12,15,3,109.5091,18.25389,1510
37225,278136,F57902A58026464B5BDED6D5CB0C8C35,30721,19,20,1,109.51597,18.28257,1565
37233,278269,88DEAC5AA353692421954529EB8C6F32,30854,0,17,17,109.56889,18.27076,1763
37234,278270,88DEAC5AA353692421954529EB8C6F32,60631,18,20,2,109.57778,18.27583,1814
37235,278271,88DEAC5AA353692421954529EB8C6F32,30854,21,23,2,109.56889,18.27076,1763
37242,278300,CE70D3AAC3EF6B01DB8A5F34BD94E77D,30821,0,7,7,109.43681,18.33639,1274
37243,278301,CE70D3AAC3EF6B01DB8A5F34BD94E77D,30651,8,9,1,109.42611,18.385,1232
37244,278302,CE70D3AAC3EF6B01DB8A5F34BD94E77D,30821,11,22,11,109.43681,18.33639,1274
37254,278370,27BCEF3137923B84211F08830816C810,30851,1,12,11,109.5616,18.27396,1713
37255,278371,27BCEF3137923B84211F08830816C810,31561,13,21,8,109.56792,18.28479,1765
37256,278372,27BCEF3137923B84211F08830816C810,30851,21,23,2,109.5616,18.27396,1713
37275,278592,C860767955774E3494068CF38C009FB6,60391,0,10,10,109.47667,18.28757,1416
37276,278593,C860767955774E3494068CF38C009FB6,60131,13,14,1,109.49819,18.24778,1509
37277,278594,C860767955774E3494068CF38C009FB6,60391,14,17,3,109.47667,18.28757,1416
37278,278595,C860767955774E3494068CF38C009FB6,39101,19,21,2,109.50132,18.24931,1509
37304,278768,770A00BDAFE9BCA8C9E9FA68066EED7D,31071,0,5,5,109.58257,18.28458,1815
37305,278769,770A00BDAFE9BCA8C9E9FA68066EED7D,30851,8,12,4,109.5616,18.27396,1713
37306,278770,770A00BDAFE9BCA8C9E9FA68066EED7D,31561,13,20,7,109.56792,18.28479,1765
37307,278771,770A00BDAFE9BCA8C9E9FA68066EED7D,31071,20,23,3,109.58257,18.28458,1815
37308,278811,F5FE23BF42FC224C310CD42E08B0B950,31431,0,6,6,109.44639,18.29042,1316
37309,278812,F5FE23BF42FC224C310CD42E08B0B950,38094,6,19,13,109.45403,18.28778,1316
37310,278813,F5FE23BF42FC224C310CD42E08B0B950,31431,20,22,2,109.44639,18.29042,1316
37322,278925,46D3900FF4CD0CE137E6DB2E5BBC5B87,39183,0,9,9,109.55542,18.28208,1715
37323,278926,46D3900FF4CD0CE137E6DB2E5BBC5B87,30071,10,11,1,109.52819,18.30472,1619
37324,278927,46D3900FF4CD0CE137E6DB2E5BBC5B87,39183,12,23,11,109.55542,18.28208,1715
37330,278961,1CD4AA669B0A97C5CF3E3A003BF9AB81,31231,0,9,9,109.42597,18.29292,1217
37331,278962,1CD4AA669B0A97C5CF3E3A003BF9AB81,31471,13,14,1,109.34583,18.29563,917
37332,278963,1CD4AA669B0A97C5CF3E3A003BF9AB81,31021,19,21,2,109.49021,18.27,1463
37333,278964,1CD4AA669B0A97C5CF3E3A003BF9AB81,31231,22,23,1,109.42597,18.29292,1217
37342,278999,B81DEDE33B0853E35D97557F334A4861,60361,0,6,6,109.51938,18.29681,1567
37343,279000,B81DEDE33B0853E35D97557F334A4861,31931,6,16,10,109.54771,18.29403,1667
37344,279001,B81DEDE33B0853E35D97557F334A4861,60361,20,23,3,109.51938,18.29681,1567
37352,279043,E8D51F8B53F290BFD73338AD2AD8C728,31561,0,6,6,109.56792,18.28479,1765
37353,279044,E8D51F8B53F290BFD73338AD2AD8C728,39183,9,18,9,109.55542,18.28208,1715
37354,279045,E8D51F8B53F290BFD73338AD2AD8C728,31561,19,22,3,109.56792,18.28479,1765
37360,279060,D77A5C2E97A74D805A87772560CE2BFF,39321,0,7,7,109.529,18.2167,1604
37361,279061,D77A5C2E97A74D805A87772560CE2BFF,31421,9,11,2,109.55382,18.22347,1705
37362,279062,D77A5C2E97A74D805A87772560CE2BFF,60381,14,16,2,109.5241,18.22458,1605
37363,279063,D77A5C2E97A74D805A87772560CE2BFF,31421,16,22,6,109.55382,18.22347,1705
37417,279565,54132720A6D7917CD1D26C61724AD075,30581,0,4,4,109.62257,18.24951,1959
37418,279566,54132720A6D7917CD1D26C61724AD075,31571,5,8,3,109.61563,18.23326,1957
37419,279567,54132720A6D7917CD1D26C61724AD075,30441,12,13,1,109.64021,18.25424,2010
37420,279582,32CEFCA8095A5A58595694856C75C07A,30721,0,1,1,109.51597,18.28257,1565
37421,279583,32CEFCA8095A5A58595694856C75C07A,30121,1,7,6,109.52861,18.27222,1613
37422,279584,32CEFCA8095A5A58595694856C75C07A,39183,10,11,1,109.55542,18.28208,1715
37425,279636,A10AD66CE81CDFBC974C36FAC5FE4CAA,31071,1,7,6,109.58257,18.28458,1815
37426,279637,A10AD66CE81CDFBC974C36FAC5FE4CAA,31931,9,11,2,109.54771,18.29403,1667
37427,279638,A10AD66CE81CDFBC974C36FAC5FE4CAA,31071,13,16,3,109.58257,18.28458,1815
37442,279721,121138E269BBF0B506FA8CE6CEB3BF52,31931,0,12,12,109.54771,18.29403,1667
37443,279722,121138E269BBF0B506FA8CE6CEB3BF52,39181,12,13,1,109.55153,18.28035,1715
37444,279723,121138E269BBF0B506FA8CE6CEB3BF52,31931,18,23,5,109.54771,18.29403,1667
37445,279726,CD77A45360FB53F816FCE62F008EEE28,30071,2,8,6,109.52819,18.30472,1619
37446,279727,CD77A45360FB53F816FCE62F008EEE28,31931,8,21,13,109.54771,18.29403,1667
37447,279728,CD77A45360FB53F816FCE62F008EEE28,30071,21,22,1,109.52819,18.30472,1619
37448,279731,9C1407835BC54BEBDB541F52E1DA1820,61011,1,3,2,109.60653,18.19076,1900
37449,279733,9C1407835BC54BEBDB541F52E1DA1820,61011,12,15,3,109.60653,18.19076,1900
37450,279735,9C1407835BC54BEBDB541F52E1DA1820,61011,20,23,3,109.60653,18.19076,1900
37451,279763,116A680F1141CB1D640294F052372134,60671,0,6,6,109.52979,18.31757,1621
37452,279764,116A680F1141CB1D640294F052372134,38241,7,11,4,109.54111,18.30542,1669
37453,279765,116A680F1141CB1D640294F052372134,38484,12,14,2,109.53028,18.31528,1620
37474,279918,73EAC1341C5005A58B26B1A52457F38B,31181,0,15,15,109.50382,18.24813,1509
37475,279919,73EAC1341C5005A58B26B1A52457F38B,30361,19,21,2,109.50347,18.24,1508
37476,279920,73EAC1341C5005A58B26B1A52457F38B,30854,21,22,1,109.56889,18.27076,1763
37499,280028,8278E6B2BC83F1CA1F3DD55E2DC0100F,31071,0,11,11,109.58257,18.28458,1815
37500,280029,8278E6B2BC83F1CA1F3DD55E2DC0100F,31931,13,16,3,109.54771,18.29403,1667
37501,280030,8278E6B2BC83F1CA1F3DD55E2DC0100F,60371,16,17,1,109.53063,18.30056,1618
37526,280411,6ADBEFDC21CA46F051933BF984A8E255,31071,0,9,9,109.58257,18.28458,1815
37527,280412,6ADBEFDC21CA46F051933BF984A8E255,30854,11,12,1,109.56889,18.27076,1763
37528,280413,6ADBEFDC21CA46F051933BF984A8E255,31071,15,17,2,109.58257,18.28458,1815
37529,280414,6ADBEFDC21CA46F051933BF984A8E255,30854,20,21,1,109.56889,18.27076,1763
37544,280591,1412BA3B65BC1A2354CCBE297098A0E1,31071,0,10,10,109.58257,18.28458,1815
37545,280592,1412BA3B65BC1A2354CCBE297098A0E1,31071,14,15,1,109.58257,18.28458,1815
37546,280593,1412BA3B65BC1A2354CCBE297098A0E1,31071,18,20,2,109.58257,18.28458,1815
37556,280673,C6FE4CF0CD47303AD7F7EC5A71315B10,30854,2,5,3,109.56889,18.27076,1763
37557,280674,C6FE4CF0CD47303AD7F7EC5A71315B10,30851,7,8,1,109.5616,18.27396,1713
37558,280675,C6FE4CF0CD47303AD7F7EC5A71315B10,30854,9,10,1,109.56889,18.27076,1763
37561,280678,7084657DF30063A945AAA5EF4742695F,39183,0,6,6,109.55542,18.28208,1715
37562,280679,7084657DF30063A945AAA5EF4742695F,31931,7,8,1,109.54771,18.29403,1667
37563,280680,7084657DF30063A945AAA5EF4742695F,39183,12,19,7,109.55542,18.28208,1715
37564,280681,7084657DF30063A945AAA5EF4742695F,31931,20,22,2,109.54771,18.29403,1667
37574,280852,7D1ED6067ECBD941EFC43CE0A6ADAE71,30854,0,11,11,109.56889,18.27076,1763
37575,280853,7D1ED6067ECBD941EFC43CE0A6ADAE71,31071,12,21,9,109.58257,18.28458,1815
37576,280854,7D1ED6067ECBD941EFC43CE0A6ADAE71,30854,21,23,2,109.56889,18.27076,1763
37581,280893,64C0BD6213CCF662EB0E37CD02355D5C,31251,0,4,4,109.18528,18.2975,317
37582,280895,64C0BD6213CCF662EB0E37CD02355D5C,31251,11,12,1,109.18528,18.2975,317
37583,280897,64C0BD6213CCF662EB0E37CD02355D5C,31251,17,23,6,109.18528,18.2975,317
37591,280950,033CEEC20746801745CF4A53CD517C31,31181,0,8,8,109.50382,18.24813,1509
37592,280951,033CEEC20746801745CF4A53CD517C31,31181,10,11,1,109.50382,18.24813,1509
37593,280952,033CEEC20746801745CF4A53CD517C31,30251,16,18,2,109.50611,18.26653,1512
37594,280953,033CEEC20746801745CF4A53CD517C31,60291,20,22,2,109.50826,18.24639,1509
37595,281007,E9E473F09C342630187345312F4A31D8,39181,0,15,15,109.55153,18.28035,1715
37596,281008,E9E473F09C342630187345312F4A31D8,31931,15,17,2,109.54771,18.29403,1667
37597,281009,E9E473F09C342630187345312F4A31D8,39181,17,23,6,109.55153,18.28035,1715
37601,281022,F18D277C130EC23D01064797EE5A0B58,30051,0,10,10,109.48917,18.21215,1453
37602,281023,F18D277C130EC23D01064797EE5A0B58,31031,11,13,2,109.49979,18.25382,1510
37603,281024,F18D277C130EC23D01064797EE5A0B58,30271,18,19,1,109.49132,18.23153,1456
37604,281025,F18D277C130EC23D01064797EE5A0B58,30051,19,23,4,109.48917,18.21215,1453
37605,281028,08A066736557478B1013C0CF834491DF,30921,0,11,11,109.53903,18.29451,1667
37606,281029,08A066736557478B1013C0CF834491DF,31931,13,15,2,109.54771,18.29403,1667
37607,281030,08A066736557478B1013C0CF834491DF,30921,17,20,3,109.53903,18.29451,1667
37610,281068,52D077B19C6C1BD347E6DC20309A3DC3,31071,2,4,2,109.58257,18.28458,1815
37611,281069,52D077B19C6C1BD347E6DC20309A3DC3,30681,8,10,2,109.48493,18.26917,1463
37612,281070,52D077B19C6C1BD347E6DC20309A3DC3,30854,11,14,3,109.56889,18.27076,1763
37613,281071,52D077B19C6C1BD347E6DC20309A3DC3,31071,14,22,8,109.58257,18.28458,1815
37616,281092,00FC332040A284DA251A8D0705989FE9,31071,0,7,7,109.58257,18.28458,1815
37617,281093,00FC332040A284DA251A8D0705989FE9,30854,10,15,5,109.56889,18.27076,1763
37618,281094,00FC332040A284DA251A8D0705989FE9,31071,15,17,2,109.58257,18.28458,1815
37619,281095,00FC332040A284DA251A8D0705989FE9,30854,21,23,2,109.56889,18.27076,1763
37620,281096,96C474E5BFF92BC21432A4ADDD7A543D,30854,0,18,18,109.56889,18.27076,1763
37621,281097,96C474E5BFF92BC21432A4ADDD7A543D,31071,19,20,1,109.58257,18.28458,1815
37622,281098,96C474E5BFF92BC21432A4ADDD7A543D,30854,20,23,3,109.56889,18.27076,1763
37628,281162,D46DE9169E4BACF1D272EA5E0FDEF68F,31561,2,13,11,109.56792,18.28479,1765
37629,281163,D46DE9169E4BACF1D272EA5E0FDEF68F,30851,15,16,1,109.5616,18.27396,1713
37630,281164,D46DE9169E4BACF1D272EA5E0FDEF68F,31561,18,23,5,109.56792,18.28479,1765
37645,281302,DFFF17B7FE30E79B8AABBB5CE171272F,39183,1,3,2,109.55542,18.28208,1715
37646,281303,DFFF17B7FE30E79B8AABBB5CE171272F,31561,7,16,9,109.56792,18.28479,1765
37647,281304,DFFF17B7FE30E79B8AABBB5CE171272F,39183,17,19,2,109.55542,18.28208,1715
37648,281305,DFFF17B7FE30E79B8AABBB5CE171272F,39091,19,21,2,109.50097,18.25222,1510
37653,281317,6C243B11A8093A8CA55CA33CE09BE6E2,39371,0,5,5,109.56627,18.2646,1762
37654,281318,6C243B11A8093A8CA55CA33CE09BE6E2,30854,6,14,8,109.56889,18.27076,1763
37655,281319,6C243B11A8093A8CA55CA33CE09BE6E2,39371,19,23,4,109.56627,18.2646,1762
37656,281332,11B1BD8CD0E682165FFA7E6380846252,60411,0,2,2,109.32514,18.30854,869
37657,281333,11B1BD8CD0E682165FFA7E6380846252,31471,6,10,4,109.34583,18.29563,917
37658,281334,11B1BD8CD0E682165FFA7E6380846252,31471,13,14,1,109.34583,18.29563,917
37659,281335,11B1BD8CD0E682165FFA7E6380846252,31471,16,17,1,109.34583,18.29563,917
37675,281492,C6579823835B85A254880E72927E82BB,30891,0,6,6,109.59431,18.28389,1865
37676,281493,C6579823835B85A254880E72927E82BB,30854,8,10,2,109.56889,18.27076,1763
37677,281494,C6579823835B85A254880E72927E82BB,39371,11,13,2,109.56627,18.2646,1762
37684,281584,08F184A038B7B2BA9AC1C33CF8004A7B,39183,0,13,13,109.55542,18.28208,1715
37685,281585,08F184A038B7B2BA9AC1C33CF8004A7B,31561,16,17,1,109.56792,18.28479,1765
37686,281586,08F184A038B7B2BA9AC1C33CF8004A7B,39183,19,23,4,109.55542,18.28208,1715
37707,281877,CD294E0B65E7686283441C2C69DAEEE1,60311,1,2,1,109.52097,18.24319,1558
37708,281878,CD294E0B65E7686283441C2C69DAEEE1,38911,3,5,2,109.51674,18.24965,1559
37709,281879,CD294E0B65E7686283441C2C69DAEEE1,31261,7,23,16,109.51174,18.2466,1559
37710,281887,C4D501C387DD23DCF31DA55A1EE88121,31431,2,8,6,109.44639,18.29042,1316
37711,281888,C4D501C387DD23DCF31DA55A1EE88121,38094,9,10,1,109.45403,18.28778,1316
37712,281889,C4D501C387DD23DCF31DA55A1EE88121,60501,11,14,3,109.48701,18.29021,1466
37737,282086,8BDE8C6966F9C7122ABA59EA6C195945,60421,1,7,6,109.46333,18.31743,1371
37738,282087,8BDE8C6966F9C7122ABA59EA6C195945,30741,8,9,1,109.49833,18.28681,1516
37739,282088,8BDE8C6966F9C7122ABA59EA6C195945,31081,12,23,11,109.44639,18.30181,1318
37752,282310,6C0260646767B781577B5B8CE2471E51,38484,4,9,5,109.53028,18.31528,1620
37753,282311,6C0260646767B781577B5B8CE2471E51,38484,12,17,5,109.53028,18.31528,1620
37754,282312,6C0260646767B781577B5B8CE2471E51,30321,18,20,2,109.49563,18.29611,1467
37776,282505,A4D782DD7C0CB1B25E56BFC209FED42C,30921,0,6,6,109.53903,18.29451,1667
37777,282506,A4D782DD7C0CB1B25E56BFC209FED42C,31931,8,15,7,109.54771,18.29403,1667
37778,282507,A4D782DD7C0CB1B25E56BFC209FED42C,30921,15,22,7,109.53903,18.29451,1667
37795,282621,64FF3E93355E6DCA29977E04D316EABA,30151,0,2,2,109.50986,18.25083,1560
37796,282622,64FF3E93355E6DCA29977E04D316EABA,30151,4,14,10,109.50986,18.25083,1560
37797,282623,64FF3E93355E6DCA29977E04D316EABA,38973,16,20,4,109.51097,18.25389,1560
37831,282871,C1F100A79C441D3FFDBAE922D32DC8D2,30854,0,6,6,109.56889,18.27076,1763
37832,282872,C1F100A79C441D3FFDBAE922D32DC8D2,31945,10,19,9,109.58021,18.29403,1817
37833,282873,C1F100A79C441D3FFDBAE922D32DC8D2,30854,20,23,3,109.56889,18.27076,1763
37840,282907,EC89B2FFE00F967E6D0A3B697A6D636D,60631,0,1,1,109.57778,18.27583,1814
37841,282908,EC89B2FFE00F967E6D0A3B697A6D636D,31071,5,10,5,109.58257,18.28458,1815
37842,282909,EC89B2FFE00F967E6D0A3B697A6D636D,30854,14,15,1,109.56889,18.27076,1763
37843,282910,EC89B2FFE00F967E6D0A3B697A6D636D,31561,20,23,3,109.56792,18.28479,1765
37845,282945,2D7C2B0308FF40B49F9D8D3F0878C284,39111,0,1,1,109.5191,18.22597,1555
37846,282946,2D7C2B0308FF40B49F9D8D3F0878C284,31521,2,7,5,109.51458,18.22542,1555
37847,282948,2D7C2B0308FF40B49F9D8D3F0878C284,31521,17,18,1,109.51458,18.22542,1555
37848,282949,2D7C2B0308FF40B49F9D8D3F0878C284,60381,20,22,2,109.5241,18.22458,1605
37851,282966,68DBE0B52FD0AB95F1DD47068FD7847F,30181,0,14,14,109.51597,18.23313,1557
37852,282967,68DBE0B52FD0AB95F1DD47068FD7847F,31521,14,16,2,109.51458,18.22542,1555
37853,282968,68DBE0B52FD0AB95F1DD47068FD7847F,30181,18,22,4,109.51597,18.23313,1557
37879,283126,066CC6CBB5ADF978A93AF5D0C3292806,30071,0,7,7,109.52819,18.30472,1619
37880,283127,066CC6CBB5ADF978A93AF5D0C3292806,31931,8,10,2,109.54771,18.29403,1667
37881,283128,066CC6CBB5ADF978A93AF5D0C3292806,60581,12,14,2,109.59785,18.29931,1868
37893,283192,8C28D637CC74662A6171660AC17A06B6,38241,1,7,6,109.54111,18.30542,1669
37894,283193,8C28D637CC74662A6171660AC17A06B6,30071,8,13,5,109.52819,18.30472,1619
37895,283194,8C28D637CC74662A6171660AC17A06B6,30854,14,18,4,109.56889,18.27076,1763
37896,283195,8C28D637CC74662A6171660AC17A06B6,30071,22,23,1,109.52819,18.30472,1619
37912,283335,7171A8398911756415ECFCDCF96F249B,39371,0,14,14,109.56627,18.2646,1762
37913,283336,7171A8398911756415ECFCDCF96F249B,31421,17,20,3,109.55382,18.22347,1705
37914,283337,7171A8398911756415ECFCDCF96F249B,30851,21,22,1,109.5616,18.27396,1713
37933,283554,D4EE8E1A4C04A1FF0596E4221D0B8B42,31071,0,8,8,109.58257,18.28458,1815
37934,283555,D4EE8E1A4C04A1FF0596E4221D0B8B42,30854,11,18,7,109.56889,18.27076,1763
37935,283556,D4EE8E1A4C04A1FF0596E4221D0B8B42,31071,18,19,1,109.58257,18.28458,1815
37936,283557,D4EE8E1A4C04A1FF0596E4221D0B8B42,30854,20,22,2,109.56889,18.27076,1763
37940,283702,7A214C2AB4CE0E87DF8DB230B9F95561,30101,0,14,14,109.57299,18.33333,1773
37941,283703,7A214C2AB4CE0E87DF8DB230B9F95561,31631,14,15,1,109.59542,18.36826,1879
37942,283704,7A214C2AB4CE0E87DF8DB230B9F95561,30101,15,23,8,109.57299,18.33333,1773
37966,283885,8D3B10FD4DBC46DB93DA60040668F697,30854,0,6,6,109.56889,18.27076,1763
37967,283886,8D3B10FD4DBC46DB93DA60040668F697,31561,6,8,2,109.56792,18.28479,1765
37968,283887,8D3B10FD4DBC46DB93DA60040668F697,30854,12,23,11,109.56889,18.27076,1763
37969,283929,1E1181D91A7FDEE2449092386CA6A77C,60041,0,6,6,109.39889,18.31944,1121
37970,283930,1E1181D91A7FDEE2449092386CA6A77C,60552,8,10,2,109.41729,18.30014,1218
37971,283931,1E1181D91A7FDEE2449092386CA6A77C,60041,11,22,11,109.39889,18.31944,1121
37988,284023,F7F33BB1C68494D5DA2069CBA2A8F745,31071,0,1,1,109.58257,18.28458,1815
37989,284024,F7F33BB1C68494D5DA2069CBA2A8F745,30854,2,9,7,109.56889,18.27076,1763
37990,284025,F7F33BB1C68494D5DA2069CBA2A8F745,31071,12,23,11,109.58257,18.28458,1815
37996,284047,78E76A57E920142E7532CF78E58080EE,31021,1,4,3,109.49021,18.27,1463
37997,284048,78E76A57E920142E7532CF78E58080EE,30201,6,9,3,109.4909,18.26465,1462
37998,284049,78E76A57E920142E7532CF78E58080EE,30921,11,12,1,109.53903,18.29451,1667
37999,284050,78E76A57E920142E7532CF78E58080EE,31931,12,23,11,109.54771,18.29403,1667
38031,284307,706B8E0F0F5D1C9FC2F8EBB2574EE89F,30711,0,7,7,109.50271,18.25347,1510
38032,284308,706B8E0F0F5D1C9FC2F8EBB2574EE89F,31461,7,9,2,109.5091,18.25389,1510
38033,284309,706B8E0F0F5D1C9FC2F8EBB2574EE89F,30711,10,13,3,109.50271,18.25347,1510
38034,284310,706B8E0F0F5D1C9FC2F8EBB2574EE89F,30711,14,23,9,109.50271,18.25347,1510
38068,284468,0402BD114B7D5E20705E302B756CD062,60631,0,5,5,109.57778,18.27583,1814
38069,284469,0402BD114B7D5E20705E302B756CD062,30854,10,12,2,109.56889,18.27076,1763
38070,284470,0402BD114B7D5E20705E302B756CD062,31071,16,17,1,109.58257,18.28458,1815
38071,284471,0402BD114B7D5E20705E302B756CD062,30854,17,21,4,109.56889,18.27076,1763
38072,284472,261915B8DB7EA33A6A8394E897EC6B41,31071,0,11,11,109.58257,18.28458,1815
38073,284473,261915B8DB7EA33A6A8394E897EC6B41,30854,14,15,1,109.56889,18.27076,1763
38074,284474,261915B8DB7EA33A6A8394E897EC6B41,31071,19,21,2,109.58257,18.28458,1815
38096,284554,DB4DF566D4757FF3BB488F82DE126248,30854,0,6,6,109.56889,18.27076,1763
38097,284555,DB4DF566D4757FF3BB488F82DE126248,31561,6,14,8,109.56792,18.28479,1765
38098,284556,DB4DF566D4757FF3BB488F82DE126248,30851,16,19,3,109.5616,18.27396,1713
38099,284557,DB4DF566D4757FF3BB488F82DE126248,31561,19,22,3,109.56792,18.28479,1765
38100,284558,2F217282255B5DE51322458E6E0E5862,38023,0,11,11,109.37132,18.28993,1016
38101,284559,2F217282255B5DE51322458E6E0E5862,31471,12,16,4,109.34583,18.29563,917
38102,284560,2F217282255B5DE51322458E6E0E5862,38023,19,23,4,109.37132,18.28993,1016
38103,284565,0312B43ACF9ED1D8304E325E851AEE29,30851,0,10,10,109.5616,18.27396,1713
38104,284566,0312B43ACF9ED1D8304E325E851AEE29,31561,12,16,4,109.56792,18.28479,1765
38105,284567,0312B43ACF9ED1D8304E325E851AEE29,30851,16,23,7,109.5616,18.27396,1713
38111,284597,16E640D9FA5593E85AD54BDFBAF952D8,31561,0,3,3,109.56792,18.28479,1765
38112,284598,16E640D9FA5593E85AD54BDFBAF952D8,30854,6,8,2,109.56889,18.27076,1763
38113,284599,16E640D9FA5593E85AD54BDFBAF952D8,31071,8,17,9,109.58257,18.28458,1815
38114,284600,16E640D9FA5593E85AD54BDFBAF952D8,31561,18,19,1,109.56792,18.28479,1765
38130,284770,3227997FE4FFED311C63A72B8544879D,30071,0,5,5,109.52819,18.30472,1619
38131,284771,3227997FE4FFED311C63A72B8544879D,31931,6,21,15,109.54771,18.29403,1667
38132,284772,3227997FE4FFED311C63A72B8544879D,30921,22,23,1,109.53903,18.29451,1667
38145,284847,6B806948BC9187A91D033B4096721B00,31561,2,4,2,109.56792,18.28479,1765
38146,284848,6B806948BC9187A91D033B4096721B00,30854,6,8,2,109.56889,18.27076,1763
38147,284849,6B806948BC9187A91D033B4096721B00,31071,10,19,9,109.58257,18.28458,1815
38148,284850,DE5024DB59D5BF6AE5857A85EB7680EA,31071,0,5,5,109.58257,18.28458,1815
38149,284851,DE5024DB59D5BF6AE5857A85EB7680EA,30854,9,11,2,109.56889,18.27076,1763
38150,284852,DE5024DB59D5BF6AE5857A85EB7680EA,31071,12,13,1,109.58257,18.28458,1815
38189,285346,C709D01469E0800AF998DFAF42105CDC,60631,0,5,5,109.57778,18.27583,1814
38190,285347,C709D01469E0800AF998DFAF42105CDC,31561,6,15,9,109.56792,18.28479,1765
38191,285348,C709D01469E0800AF998DFAF42105CDC,30854,19,22,3,109.56889,18.27076,1763
38200,285412,D4EC608FEFB7E2A068D5777F091AD4C5,31345,0,10,10,109.39,18.29,1066
38201,285413,D4EC608FEFB7E2A068D5777F091AD4C5,31471,12,14,2,109.34583,18.29563,917
38202,285414,D4EC608FEFB7E2A068D5777F091AD4C5,31345,17,23,6,109.39,18.29,1066
38207,285470,DDE77D3A656666992FC3458B84010D43,39183,0,1,1,109.55542,18.28208,1715
38208,285471,DDE77D3A656666992FC3458B84010D43,31561,5,11,6,109.56792,18.28479,1765
38209,285472,DDE77D3A656666992FC3458B84010D43,39183,11,13,2,109.55542,18.28208,1715
38210,285473,DDE77D3A656666992FC3458B84010D43,31561,15,21,6,109.56792,18.28479,1765
38215,285499,CD01A34A2CB88E9393C292828422A88B,31071,0,8,8,109.58257,18.28458,1815
38216,285500,CD01A34A2CB88E9393C292828422A88B,39183,8,10,2,109.55542,18.28208,1715
38217,285501,CD01A34A2CB88E9393C292828422A88B,31561,15,17,2,109.56792,18.28479,1765
38220,285507,2C3BD53A8702A47FB82F05FB4993B683,31561,0,1,1,109.56792,18.28479,1765
38221,285508,2C3BD53A8702A47FB82F05FB4993B683,30851,4,5,1,109.5616,18.27396,1713
38222,285509,2C3BD53A8702A47FB82F05FB4993B683,30854,7,8,1,109.56889,18.27076,1763
38225,285536,F6A1EBB84FE583E84185C423218578F5,31561,0,5,5,109.56792,18.28479,1765
38226,285537,F6A1EBB84FE583E84185C423218578F5,39183,8,9,1,109.55542,18.28208,1715
38227,285538,F6A1EBB84FE583E84185C423218578F5,39181,13,17,4,109.55153,18.28035,1715
38247,285652,202870BA524F8D7E9C1B66336BF1F034,30071,0,5,5,109.52819,18.30472,1619
38248,285653,202870BA524F8D7E9C1B66336BF1F034,30854,6,14,8,109.56889,18.27076,1763
38249,285654,202870BA524F8D7E9C1B66336BF1F034,31951,19,21,2,109.52174,18.30299,1568
38286,285848,0695D4E7B3E726CA09D841B87798B560,30854,2,5,3,109.56889,18.27076,1763
38287,285849,0695D4E7B3E726CA09D841B87798B560,60354,6,7,1,109.58701,18.28521,1815
38288,285850,0695D4E7B3E726CA09D841B87798B560,30854,7,12,5,109.56889,18.27076,1763
38289,285853,B712327B6033C61F37801CFD6DAC08AD,38484,5,8,3,109.53028,18.31528,1620
38290,285854,B712327B6033C61F37801CFD6DAC08AD,38484,8,10,2,109.53028,18.31528,1620
38291,285855,B712327B6033C61F37801CFD6DAC08AD,38484,12,22,10,109.53028,18.31528,1620
38294,285884,B7911D9D9A3AB9DF64A3B23E6A7B118E,60201,0,3,3,109.5041,18.2509,1510
38295,285885,B7911D9D9A3AB9DF64A3B23E6A7B118E,60291,3,6,3,109.50826,18.24639,1509
38296,285886,B7911D9D9A3AB9DF64A3B23E6A7B118E,60201,8,10,2,109.5041,18.2509,1510
38304,285924,8EF00336DF81276A821E166696CFF524,30721,3,6,3,109.51597,18.28257,1565
38305,285925,8EF00336DF81276A821E166696CFF524,31931,6,7,1,109.54771,18.29403,1667
38306,285926,8EF00336DF81276A821E166696CFF524,30721,8,16,8,109.51597,18.28257,1565
38307,285927,8EF00336DF81276A821E166696CFF524,30771,18,20,2,109.49938,18.26042,1511
38308,285928,6A8BCB0608F5D72D88191DC3AF22DB09,38321,0,9,9,109.39854,18.29132,1116
38309,285929,6A8BCB0608F5D72D88191DC3AF22DB09,38325,13,16,3,109.39792,18.2909,1116
38310,285930,6A8BCB0608F5D72D88191DC3AF22DB09,38321,17,21,4,109.39854,18.29132,1116
38321,286066,B78E7295CB13532B4E2C30EF158E297F,31931,0,3,3,109.54771,18.29403,1667
38322,286067,B78E7295CB13532B4E2C30EF158E297F,30854,5,6,1,109.56889,18.27076,1763
38323,286068,B78E7295CB13532B4E2C30EF158E297F,39183,10,11,1,109.55542,18.28208,1715
38324,286069,B78E7295CB13532B4E2C30EF158E297F,30854,13,14,1,109.56889,18.27076,1763
38341,286319,97C31877CA4226D0F1BA1C0E12066B56,60331,1,3,2,109.505,18.26507,1512
38342,286320,97C31877CA4226D0F1BA1C0E12066B56,39053,3,6,3,109.511,18.2771,1564
38343,286321,97C31877CA4226D0F1BA1C0E12066B56,30854,7,17,10,109.56889,18.27076,1763
38344,286322,97C31877CA4226D0F1BA1C0E12066B56,60331,19,22,3,109.505,18.26507,1512
38345,286335,A549C024E6F63EDBD3DC866F10DB11CE,30234,0,1,1,109.60681,18.29979,1918
38346,286336,A549C024E6F63EDBD3DC866F10DB11CE,31945,2,5,3,109.58021,18.29403,1817
38347,286337,A549C024E6F63EDBD3DC866F10DB11CE,30854,8,22,14,109.56889,18.27076,1763
38353,286378,E4B522EF4348156010E5C578EC13D60F,30234,0,7,7,109.60681,18.29979,1918
38354,286379,E4B522EF4348156010E5C578EC13D60F,30854,8,17,9,109.56889,18.27076,1763
38355,286380,E4B522EF4348156010E5C578EC13D60F,60371,18,20,2,109.53063,18.30056,1618
38361,286386,560794A44CA17A43FA34D0FA6C339747,30854,1,11,10,109.56889,18.27076,1763
38362,286387,560794A44CA17A43FA34D0FA6C339747,39091,14,17,3,109.50097,18.25222,1510
38363,286388,560794A44CA17A43FA34D0FA6C339747,30854,20,21,1,109.56889,18.27076,1763
38395,286681,37DC2EF674B0D61C6D10D120CF46E31D,60221,0,10,10,109.52569,18.29188,1616
38396,286682,37DC2EF674B0D61C6D10D120CF46E31D,31461,10,14,4,109.5091,18.25389,1510
38397,286683,37DC2EF674B0D61C6D10D120CF46E31D,31461,15,17,2,109.5091,18.25389,1510
38398,286684,37DC2EF674B0D61C6D10D120CF46E31D,31031,19,21,2,109.49979,18.25382,1510
38434,286862,AAD294F97E8F953422B544ED61B36D13,31071,0,7,7,109.58257,18.28458,1815
38435,286863,AAD294F97E8F953422B544ED61B36D13,31551,8,9,1,109.55868,18.24222,1708
38436,286864,AAD294F97E8F953422B544ED61B36D13,30851,12,17,5,109.5616,18.27396,1713
38437,286865,AAD294F97E8F953422B544ED61B36D13,31071,18,22,4,109.58257,18.28458,1815
38451,286963,C1602FB5A20BD98313F7CC13F431D061,30271,0,7,7,109.49132,18.23153,1456
38452,286964,C1602FB5A20BD98313F7CC13F431D061,30771,8,9,1,109.49938,18.26042,1511
38453,286965,C1602FB5A20BD98313F7CC13F431D061,30201,12,13,1,109.4909,18.26465,1462
38454,286966,C1602FB5A20BD98313F7CC13F431D061,31271,18,22,4,109.48958,18.26257,1462
38463,287022,D6B14C7387647D8C883334DAFB518257,31071,0,7,7,109.58257,18.28458,1815
38464,287023,D6B14C7387647D8C883334DAFB518257,30854,8,9,1,109.56889,18.27076,1763
38465,287024,D6B14C7387647D8C883334DAFB518257,31071,14,15,1,109.58257,18.28458,1815
38480,287092,9C52FC38B7F498775E1F72BEBF4C0CB1,30084,0,6,6,109.50118,18.26972,1513
38481,287093,9C52FC38B7F498775E1F72BEBF4C0CB1,31931,7,18,11,109.54771,18.29403,1667
38482,287094,9C52FC38B7F498775E1F72BEBF4C0CB1,30084,18,23,5,109.50118,18.26972,1513
38483,287102,C85D0B931BEF54F05B9ABBBB03212DB7,30854,0,9,9,109.56889,18.27076,1763
38484,287103,C85D0B931BEF54F05B9ABBBB03212DB7,31561,14,15,1,109.56792,18.28479,1765
38485,287104,C85D0B931BEF54F05B9ABBBB03212DB7,30854,18,20,2,109.56889,18.27076,1763
38492,287178,410D55EA73A3884577B7B9B7E86B067E,30081,0,7,7,109.50243,18.26632,1512
38493,287179,410D55EA73A3884577B7B9B7E86B067E,30084,8,10,2,109.50118,18.26972,1513
38494,287180,410D55EA73A3884577B7B9B7E86B067E,30161,12,13,1,109.50042,18.24389,1508
38495,287181,410D55EA73A3884577B7B9B7E86B067E,31205,17,18,1,109.51111,18.23736,1557
38528,287390,ABCD0851CC1C78BCD7AF6DBDF2F5DE49,60552,1,16,15,109.41729,18.30014,1218
38529,287391,ABCD0851CC1C78BCD7AF6DBDF2F5DE49,60401,17,19,2,109.47444,18.27583,1414
38530,287392,ABCD0851CC1C78BCD7AF6DBDF2F5DE49,60552,19,20,1,109.41729,18.30014,1218
38534,287404,C19430CE8DF26BDEF43903E57E682236,31561,0,6,6,109.56792,18.28479,1765
38535,287405,C19430CE8DF26BDEF43903E57E682236,30854,9,11,2,109.56889,18.27076,1763
38536,287406,C19430CE8DF26BDEF43903E57E682236,31561,11,23,12,109.56792,18.28479,1765
38548,287498,DF5EBFA9D0614A60E8475DE83F0E910D,30151,0,7,7,109.50986,18.25083,1560
38549,287499,DF5EBFA9D0614A60E8475DE83F0E910D,60201,8,9,1,109.5041,18.2509,1510
38550,287500,DF5EBFA9D0614A60E8475DE83F0E910D,30711,12,13,1,109.50271,18.25347,1510
38551,287501,DF5EBFA9D0614A60E8475DE83F0E910D,60201,18,19,1,109.5041,18.2509,1510
38570,287646,22DF08AB8625FB5CE36A655BC50A3649,30711,0,7,7,109.50271,18.25347,1510
38571,287647,22DF08AB8625FB5CE36A655BC50A3649,60281,8,9,1,109.51743,18.25924,1561
38572,287648,22DF08AB8625FB5CE36A655BC50A3649,38911,11,13,2,109.51674,18.24965,1559
38588,287791,1D2F8DB1F8B6A2081E1A43DDF558491D,31951,0,9,9,109.52174,18.30299,1568
38589,287792,1D2F8DB1F8B6A2081E1A43DDF558491D,48631,9,11,2,109.52903,18.31743,1621
38590,287793,1D2F8DB1F8B6A2081E1A43DDF558491D,31951,11,23,12,109.52174,18.30299,1568
38591,287794,8C5A16299A6D294198C90C34C25C5949,39183,0,2,2,109.55542,18.28208,1715
38592,287795,8C5A16299A6D294198C90C34C25C5949,31561,3,4,1,109.56792,18.28479,1765
38593,287796,8C5A16299A6D294198C90C34C25C5949,39183,4,14,10,109.55542,18.28208,1715
38594,287797,8C5A16299A6D294198C90C34C25C5949,31561,18,19,1,109.56792,18.28479,1765
38609,287901,A61982B5678761D61EEF61A4FD8E4247,31431,0,6,6,109.44639,18.29042,1316
38610,287903,A61982B5678761D61EEF61A4FD8E4247,31701,17,19,2,109.44132,18.28833,1266
38611,287904,A61982B5678761D61EEF61A4FD8E4247,31431,19,23,4,109.44639,18.29042,1316
38614,287921,2D39AE6120F2674000C6DBB8A6E572A0,31945,0,7,7,109.58021,18.29403,1817
38615,287922,2D39AE6120F2674000C6DBB8A6E572A0,30854,7,9,2,109.56889,18.27076,1763
38616,287923,2D39AE6120F2674000C6DBB8A6E572A0,31945,12,13,1,109.58021,18.29403,1817
38618,287961,9E18E9F8FEDC97A4CAA2EEEA25DFDB75,38251,0,7,7,109.49618,18.25493,1510
38619,287964,9E18E9F8FEDC97A4CAA2EEEA25DFDB75,31031,17,19,2,109.49979,18.25382,1510
38620,287965,9E18E9F8FEDC97A4CAA2EEEA25DFDB75,31031,19,23,4,109.49979,18.25382,1510
38621,287976,770A00BDAFE9BCA8C9E9FA68066EED7D,31071,0,6,6,109.58257,18.28458,1815
38622,287977,770A00BDAFE9BCA8C9E9FA68066EED7D,31561,10,15,5,109.56792,18.28479,1765
38623,287978,770A00BDAFE9BCA8C9E9FA68066EED7D,30851,15,18,3,109.5616,18.27396,1713
38624,287979,770A00BDAFE9BCA8C9E9FA68066EED7D,31071,20,23,3,109.58257,18.28458,1815
38625,287983,C1F9914EF577AE2A8300B1A3945A50FF,31561,0,1,1,109.56792,18.28479,1765
38626,287984,C1F9914EF577AE2A8300B1A3945A50FF,30851,3,6,3,109.5616,18.27396,1713
38627,287985,C1F9914EF577AE2A8300B1A3945A50FF,31561,8,10,2,109.56792,18.28479,1765
38632,288018,F5FE23BF42FC224C310CD42E08B0B950,31431,0,6,6,109.44639,18.29042,1316
38633,288019,F5FE23BF42FC224C310CD42E08B0B950,38094,6,17,11,109.45403,18.28778,1316
38634,288020,F5FE23BF42FC224C310CD42E08B0B950,31431,20,23,3,109.44639,18.29042,1316
38638,288082,FFFC0994E5C15BDB165344716912442C,31554,0,1,1,109.55521,18.2459,1709
38639,288083,FFFC0994E5C15BDB165344716912442C,30854,1,4,3,109.56889,18.27076,1763
38640,288084,FFFC0994E5C15BDB165344716912442C,31554,7,19,12,109.55521,18.2459,1709
38641,288085,FFFC0994E5C15BDB165344716912442C,30854,22,23,1,109.56889,18.27076,1763
38643,288141,3604A30B97765FCF194506153EE8C0D9,30854,0,8,8,109.56889,18.27076,1763
38644,288142,3604A30B97765FCF194506153EE8C0D9,31945,12,14,2,109.58021,18.29403,1817
38645,288143,3604A30B97765FCF194506153EE8C0D9,39371,14,16,2,109.56627,18.2646,1762
38646,288144,3604A30B97765FCF194506153EE8C0D9,30854,16,23,7,109.56889,18.27076,1763
38657,288214,9FC721E86703223349C05C95FE4BBB6F,31521,0,14,14,109.51458,18.22542,1555
38658,288215,9FC721E86703223349C05C95FE4BBB6F,60381,14,19,5,109.5241,18.22458,1605
38659,288216,9FC721E86703223349C05C95FE4BBB6F,60087,20,23,3,109.50688,18.22299,1505
38660,288221,B81DEDE33B0853E35D97557F334A4861,60361,0,6,6,109.51938,18.29681,1567
38661,288222,B81DEDE33B0853E35D97557F334A4861,31931,6,17,11,109.54771,18.29403,1667
38662,288223,B81DEDE33B0853E35D97557F334A4861,60361,18,23,5,109.51938,18.29681,1567
38663,288231,A68637AA89BD62624E677D9E66C32FAD,30361,0,1,1,109.50347,18.24,1508
38664,288232,A68637AA89BD62624E677D9E66C32FAD,30161,3,11,8,109.50042,18.24389,1508
38665,288233,A68637AA89BD62624E677D9E66C32FAD,30161,11,22,11,109.50042,18.24389,1508
38674,288276,D77A5C2E97A74D805A87772560CE2BFF,31421,1,9,8,109.55382,18.22347,1705
38675,288277,D77A5C2E97A74D805A87772560CE2BFF,60381,9,11,2,109.5241,18.22458,1605
38676,288278,D77A5C2E97A74D805A87772560CE2BFF,31421,11,22,11,109.55382,18.22347,1705
38683,288369,EE1DC3D3663945EFC02BAB5EE6A065E9,31071,0,7,7,109.58257,18.28458,1815
38684,288370,EE1DC3D3663945EFC02BAB5EE6A065E9,30854,9,12,3,109.56889,18.27076,1763
38685,288371,EE1DC3D3663945EFC02BAB5EE6A065E9,31071,12,21,9,109.58257,18.28458,1815
38695,288473,0D3DA8126B134D203BB35373EAFFB116,31071,4,11,7,109.58257,18.28458,1815
38696,288474,0D3DA8126B134D203BB35373EAFFB116,30854,16,17,1,109.56889,18.27076,1763
38697,288475,0D3DA8126B134D203BB35373EAFFB116,31071,19,21,2,109.58257,18.28458,1815
38704,288568,36CB9BFBE6722CF45733B1AB5C92EBF8,30854,0,7,7,109.56889,18.27076,1763
38705,288569,36CB9BFBE6722CF45733B1AB5C92EBF8,60631,9,16,7,109.57778,18.27583,1814
38706,288570,36CB9BFBE6722CF45733B1AB5C92EBF8,30854,16,22,6,109.56889,18.27076,1763
38715,288612,43DCA4A54D551EB9E56C0160DC714BC6,31561,0,3,3,109.56792,18.28479,1765
38716,288613,43DCA4A54D551EB9E56C0160DC714BC6,30854,3,12,9,109.56889,18.27076,1763
38717,288615,43DCA4A54D551EB9E56C0160DC714BC6,30741,20,21,1,109.49833,18.28681,1516
38718,288616,43DCA4A54D551EB9E56C0160DC714BC6,30854,21,23,2,109.56889,18.27076,1763
38727,288694,E8E05D2BF37E5522AAFF8446679CEF53,30921,4,5,1,109.53903,18.29451,1667
38728,288695,E8E05D2BF37E5522AAFF8446679CEF53,31931,5,8,3,109.54771,18.29403,1667
38729,288696,E8E05D2BF37E5522AAFF8446679CEF53,30921,8,10,2,109.53903,18.29451,1667
38730,288697,E8E05D2BF37E5522AAFF8446679CEF53,31931,11,14,3,109.54771,18.29403,1667
38738,288760,867CD177C4F4B0DA2800BA7613DC965C,31061,0,11,11,109.53333,18.23257,1607
38739,288761,867CD177C4F4B0DA2800BA7613DC965C,30381,14,16,2,109.52521,18.24507,1609
38740,288762,867CD177C4F4B0DA2800BA7613DC965C,30161,19,20,1,109.50042,18.24389,1508
38741,288763,867CD177C4F4B0DA2800BA7613DC965C,31061,21,23,2,109.53333,18.23257,1607
38754,288797,4D98CC6A841E32F3CEA568916A53D5E4,31521,0,16,16,109.51458,18.22542,1555
38755,288798,4D98CC6A841E32F3CEA568916A53D5E4,60381,16,18,2,109.5241,18.22458,1605
38756,288799,4D98CC6A841E32F3CEA568916A53D5E4,31521,18,23,5,109.51458,18.22542,1555
38758,288906,D73D0E1690714CD7F442C709F67E4771,60361,0,7,7,109.51938,18.29681,1567
38759,288907,D73D0E1690714CD7F442C709F67E4771,39371,11,15,4,109.56627,18.2646,1762
38760,288908,D73D0E1690714CD7F442C709F67E4771,60221,19,20,1,109.52569,18.29188,1616
38761,288909,D73D0E1690714CD7F442C709F67E4771,60361,21,23,2,109.51938,18.29681,1567
38765,288960,6EF68F35CE79552C1164E70C67C72C02,30121,0,8,8,109.52861,18.27222,1613
38766,288961,6EF68F35CE79552C1164E70C67C72C02,30854,11,15,4,109.56889,18.27076,1763
38767,288962,6EF68F35CE79552C1164E70C67C72C02,30121,19,23,4,109.52861,18.27222,1613
38770,288972,C173E680DFAEC165B5B7AE7346539D93,38291,0,9,9,109.51618,18.24313,1558
38771,288973,C173E680DFAEC165B5B7AE7346539D93,30711,12,13,1,109.50271,18.25347,1510
38772,288974,C173E680DFAEC165B5B7AE7346539D93,30511,14,16,2,109.51069,18.24208,1558
38785,289067,8A15E279A515FBB85B3FA2E35BACCD57,31431,0,6,6,109.44639,18.29042,1316
38786,289069,8A15E279A515FBB85B3FA2E35BACCD57,38094,17,19,2,109.45403,18.28778,1316
38787,289070,8A15E279A515FBB85B3FA2E35BACCD57,31431,20,23,3,109.44639,18.29042,1316
38788,289129,FE4417CAF3A5150C206378A6D3A89051,30201,0,10,10,109.4909,18.26465,1462
38789,289130,FE4417CAF3A5150C206378A6D3A89051,31931,12,17,5,109.54771,18.29403,1667
38790,289131,FE4417CAF3A5150C206378A6D3A89051,60371,18,19,1,109.53063,18.30056,1618
38791,289132,FE4417CAF3A5150C206378A6D3A89051,31931,21,23,2,109.54771,18.29403,1667
38804,289187,D9689370CD6256E9753C2B0B13067E2B,30854,0,14,14,109.56889,18.27076,1763
38805,289188,D9689370CD6256E9753C2B0B13067E2B,30581,15,16,1,109.62257,18.24951,1959
38806,289189,D9689370CD6256E9753C2B0B13067E2B,30071,19,20,1,109.52819,18.30472,1619
38807,289190,D9689370CD6256E9753C2B0B13067E2B,30854,22,23,1,109.56889,18.27076,1763
38808,289199,92A852F4802D3D92C195A90A9645A57F,38141,0,13,13,109.39479,18.2916,1116
38809,289200,92A852F4802D3D92C195A90A9645A57F,38325,18,19,1,109.39792,18.2909,1116
38810,289201,92A852F4802D3D92C195A90A9645A57F,38903,19,23,4,109.39229,18.29243,1117
38811,289208,DBB710D279E76C79F1E4B0766F579F8A,31071,0,8,8,109.58257,18.28458,1815
38812,289209,DBB710D279E76C79F1E4B0766F579F8A,30854,11,12,1,109.56889,18.27076,1763
38813,289210,DBB710D279E76C79F1E4B0766F579F8A,31071,12,13,1,109.58257,18.28458,1815
38814,289211,DBB710D279E76C79F1E4B0766F579F8A,30854,18,19,1,109.56889,18.27076,1763
38820,289217,3A484AED43EBFC77572B117C1C49420B,31081,0,6,6,109.44639,18.30181,1318
38821,289218,3A484AED43EBFC77572B117C1C49420B,31471,7,17,10,109.34583,18.29563,917
38822,289219,3A484AED43EBFC77572B117C1C49420B,31081,19,23,4,109.44639,18.30181,1318
38825,289303,A2DBFF4E352E7B7C1EE25431C02FC741,31931,0,13,13,109.54771,18.29403,1667
38826,289304,A2DBFF4E352E7B7C1EE25431C02FC741,39181,17,18,1,109.55153,18.28035,1715
38827,289305,A2DBFF4E352E7B7C1EE25431C02FC741,31931,21,23,2,109.54771,18.29403,1667
38858,289424,7784022BDEFABB0258B32ABBB5E13027,30251,2,8,6,109.50611,18.26653,1512
38859,289425,7784022BDEFABB0258B32ABBB5E13027,30461,8,12,4,109.5116,18.26313,1562
38860,289426,7784022BDEFABB0258B32ABBB5E13027,30151,12,14,2,109.50986,18.25083,1560
38864,289482,1122041491C04B199A15F6E1E401D68F,60281,3,6,3,109.51743,18.25924,1561
38865,289483,1122041491C04B199A15F6E1E401D68F,30461,7,8,1,109.5116,18.26313,1562
38866,289484,1122041491C04B199A15F6E1E401D68F,30461,10,12,2,109.5116,18.26313,1562
38867,289485,1122041491C04B199A15F6E1E401D68F,60281,13,14,1,109.51743,18.25924,1561
38876,289584,A8E9C7BB918ADAD29A3EA7ACDDCD32D7,38951,0,2,2,109.48097,18.28868,1416
38877,289585,A8E9C7BB918ADAD29A3EA7ACDDCD32D7,38951,2,17,15,109.48097,18.28868,1416
38878,289586,A8E9C7BB918ADAD29A3EA7ACDDCD32D7,38951,17,22,5,109.48097,18.28868,1416
38889,289670,BEE3A0C9BB09D7F210E3490BED90A1BE,30071,0,8,8,109.52819,18.30472,1619
38890,289671,BEE3A0C9BB09D7F210E3490BED90A1BE,60371,9,11,2,109.53063,18.30056,1618
38891,289672,BEE3A0C9BB09D7F210E3490BED90A1BE,30071,13,21,8,109.52819,18.30472,1619
38892,289673,BEE3A0C9BB09D7F210E3490BED90A1BE,60371,21,23,2,109.53063,18.30056,1618
38893,289678,D9AE11CD16B231308C3F0FB3F53BC3E9,31071,0,16,16,109.58257,18.28458,1815
38894,289679,D9AE11CD16B231308C3F0FB3F53BC3E9,30854,16,17,1,109.56889,18.27076,1763
38895,289680,D9AE11CD16B231308C3F0FB3F53BC3E9,31071,21,23,2,109.58257,18.28458,1815
38912,289842,C983E73D646629A775690ECA8920EB29,30101,0,6,6,109.57299,18.33333,1773
38913,289843,C983E73D646629A775690ECA8920EB29,31631,6,7,1,109.59542,18.36826,1879
38914,289844,C983E73D646629A775690ECA8920EB29,30101,9,10,1,109.57299,18.33333,1773
38915,289901,D343F732190993CDF15741F730CFB38E,31761,0,1,1,109.60521,18.27965,1914
38916,289902,D343F732190993CDF15741F730CFB38E,31071,1,2,1,109.58257,18.28458,1815
38917,289903,D343F732190993CDF15741F730CFB38E,31761,5,7,2,109.60521,18.27965,1914
38919,289936,F1114751990E9EE36CDB7660EAA9CD6F,31071,0,5,5,109.58257,18.28458,1815
38920,289937,F1114751990E9EE36CDB7660EAA9CD6F,30854,5,7,2,109.56889,18.27076,1763
38921,289938,F1114751990E9EE36CDB7660EAA9CD6F,31071,11,15,4,109.58257,18.28458,1815
38926,289966,1412BA3B65BC1A2354CCBE297098A0E1,31071,0,8,8,109.58257,18.28458,1815
38927,289967,1412BA3B65BC1A2354CCBE297098A0E1,30581,9,10,1,109.62257,18.24951,1959
38928,289968,1412BA3B65BC1A2354CCBE297098A0E1,30854,14,19,5,109.56889,18.27076,1763
38929,289969,1412BA3B65BC1A2354CCBE297098A0E1,31071,19,21,2,109.58257,18.28458,1815
38931,290004,9AA959ED87D1ECC3053DED17290EFCBD,30854,1,3,2,109.56889,18.27076,1763
38932,290005,9AA959ED87D1ECC3053DED17290EFCBD,31561,5,7,2,109.56792,18.28479,1765
38933,290006,9AA959ED87D1ECC3053DED17290EFCBD,39181,7,10,3,109.55153,18.28035,1715
38934,290007,9AA959ED87D1ECC3053DED17290EFCBD,31561,12,20,8,109.56792,18.28479,1765
38950,290244,124E60C0315346A1F7A9CD897F13605E,48601,0,9,9,109.51694,18.22514,1555
38951,290245,124E60C0315346A1F7A9CD897F13605E,60231,12,14,2,109.49903,18.21972,1504
38952,290246,124E60C0315346A1F7A9CD897F13605E,31521,17,23,6,109.51458,18.22542,1555
38953,290250,2B60907F04C29DE058B3E64B1D3B4100,31561,1,3,2,109.56792,18.28479,1765
38954,290251,2B60907F04C29DE058B3E64B1D3B4100,30854,6,8,2,109.56889,18.27076,1763
38955,290252,2B60907F04C29DE058B3E64B1D3B4100,31561,11,13,2,109.56792,18.28479,1765
38956,290253,2B60907F04C29DE058B3E64B1D3B4100,30854,18,19,1,109.56889,18.27076,1763
38985,290428,D04CD9DD8CE80FB000DDFF2A9F0DD83D,60131,0,6,6,109.49819,18.24778,1509
38986,290429,D04CD9DD8CE80FB000DDFF2A9F0DD83D,30771,9,16,7,109.49938,18.26042,1511
38987,290430,D04CD9DD8CE80FB000DDFF2A9F0DD83D,30391,18,19,1,109.4975,18.27118,1513
39000,290555,6C243B11A8093A8CA55CA33CE09BE6E2,39371,0,6,6,109.56627,18.2646,1762
39001,290556,6C243B11A8093A8CA55CA33CE09BE6E2,30854,7,8,1,109.56889,18.27076,1763
39002,290557,6C243B11A8093A8CA55CA33CE09BE6E2,39371,9,14,5,109.56627,18.2646,1762
39003,290558,6C243B11A8093A8CA55CA33CE09BE6E2,30854,15,23,8,109.56889,18.27076,1763
39004,290574,B34415F599F0ED7D1A073EE314A60B9B,31671,0,14,14,109.38965,18.29813,1068
39005,290575,B34415F599F0ED7D1A073EE314A60B9B,60041,16,17,1,109.39889,18.31944,1121
39006,290576,B34415F599F0ED7D1A073EE314A60B9B,31671,20,22,2,109.38965,18.29813,1068
39015,290640,CB2BC2C9454DCC9EC157173C1331852D,39371,1,3,2,109.56627,18.2646,1762
39016,290641,CB2BC2C9454DCC9EC157173C1331852D,31071,5,6,1,109.58257,18.28458,1815
39017,290642,CB2BC2C9454DCC9EC157173C1331852D,39091,11,14,3,109.50097,18.25222,1510
39018,290643,CB2BC2C9454DCC9EC157173C1331852D,30854,16,23,7,109.56889,18.27076,1763
39025,290780,689528D5C129D1703EF90D6CD5795B66,30421,0,11,11,109.50021,18.25861,1511
39026,290781,689528D5C129D1703EF90D6CD5795B66,60441,14,16,2,109.46792,18.28604,1366
39027,290782,689528D5C129D1703EF90D6CD5795B66,30771,18,23,5,109.49938,18.26042,1511
39028,290797,622234A65D292D040A9E438A2770674C,30851,0,7,7,109.5616,18.27396,1713
39029,290798,622234A65D292D040A9E438A2770674C,31561,7,9,2,109.56792,18.28479,1765
39030,290799,622234A65D292D040A9E438A2770674C,30851,11,14,3,109.5616,18.27396,1713
39031,290800,622234A65D292D040A9E438A2770674C,31561,15,16,1,109.56792,18.28479,1765
39040,290966,61367143AF9E920D00E08697C8407C3F,38331,0,6,6,109.62465,18.22736,1956
39041,290967,61367143AF9E920D00E08697C8407C3F,38052,6,14,8,109.62618,18.23042,1956
39042,290968,61367143AF9E920D00E08697C8407C3F,30581,16,18,2,109.62257,18.24951,1959
39043,290969,61367143AF9E920D00E08697C8407C3F,38052,18,20,2,109.62618,18.23042,1956
39050,291042,13A6EDC75AEBF90A555AE4ABEB3F9FCC,30851,1,5,4,109.5616,18.27396,1713
39051,291043,13A6EDC75AEBF90A555AE4ABEB3F9FCC,39181,6,11,5,109.55153,18.28035,1715
39052,291044,13A6EDC75AEBF90A555AE4ABEB3F9FCC,39181,11,17,6,109.55153,18.28035,1715
39053,291045,13A6EDC75AEBF90A555AE4ABEB3F9FCC,39183,19,20,1,109.55542,18.28208,1715
39054,291080,79CCA269D4D1544F735C077DABC1670F,39111,2,4,2,109.5191,18.22597,1555
39055,291081,79CCA269D4D1544F735C077DABC1670F,31521,5,7,2,109.51458,18.22542,1555
39056,291083,79CCA269D4D1544F735C077DABC1670F,31031,17,18,1,109.49979,18.25382,1510
39057,291089,CD294E0B65E7686283441C2C69DAEEE1,31261,0,1,1,109.51174,18.2466,1559
39058,291090,CD294E0B65E7686283441C2C69DAEEE1,31261,3,9,6,109.51174,18.2466,1559
39059,291091,CD294E0B65E7686283441C2C69DAEEE1,31261,13,16,3,109.51174,18.2466,1559
39069,291259,F8D799D9161B0143E0D71C40472A357E,30071,0,14,14,109.52819,18.30472,1619
39070,291260,F8D799D9161B0143E0D71C40472A357E,30071,15,20,5,109.52819,18.30472,1619
39071,291261,F8D799D9161B0143E0D71C40472A357E,30071,21,23,2,109.52819,18.30472,1619
39072,291262,8BDE8C6966F9C7122ABA59EA6C195945,31081,0,6,6,109.44639,18.30181,1318
39073,291263,8BDE8C6966F9C7122ABA59EA6C195945,60501,8,10,2,109.48701,18.29021,1466
39074,291264,8BDE8C6966F9C7122ABA59EA6C195945,30671,13,14,1,109.43611,18.30139,1268
39092,291472,CFE676DCCC4DE2A148E7352FA77322DF,30511,0,8,8,109.51069,18.24208,1558
39093,291473,CFE676DCCC4DE2A148E7352FA77322DF,38891,10,13,3,109.51486,18.24118,1558
39094,291474,CFE676DCCC4DE2A148E7352FA77322DF,30854,14,19,5,109.56889,18.27076,1763
39095,291475,CFE676DCCC4DE2A148E7352FA77322DF,38891,20,23,3,109.51486,18.24118,1558
39096,291483,6C0260646767B781577B5B8CE2471E51,30321,2,4,2,109.49563,18.29611,1467
39097,291484,6C0260646767B781577B5B8CE2471E51,38484,7,9,2,109.53028,18.31528,1620
39098,291485,6C0260646767B781577B5B8CE2471E51,30561,9,12,3,109.52778,18.31938,1621
39099,291486,6C0260646767B781577B5B8CE2471E51,38484,12,22,10,109.53028,18.31528,1620
39133,291804,30CE72A519D49881F23B8123486E3A02,60411,0,9,9,109.32514,18.30854,869
39134,291805,30CE72A519D49881F23B8123486E3A02,31471,9,11,2,109.34583,18.29563,917
39135,291806,30CE72A519D49881F23B8123486E3A02,60411,15,22,7,109.32514,18.30854,869
39136,291823,BD9C21E94538AA6D21377B9EF57647D7,31071,1,6,5,109.58257,18.28458,1815
39137,291824,BD9C21E94538AA6D21377B9EF57647D7,30854,7,8,1,109.56889,18.27076,1763
39138,291825,BD9C21E94538AA6D21377B9EF57647D7,31071,8,10,2,109.58257,18.28458,1815
39139,291826,BD9C21E94538AA6D21377B9EF57647D7,30854,11,17,6,109.56889,18.27076,1763
39157,291907,798BF3B08F72A16A6DEAAA235F1899BB,61011,0,1,1,109.60653,18.19076,1900
39158,291909,798BF3B08F72A16A6DEAAA235F1899BB,61011,8,13,5,109.60653,18.19076,1900
39159,291911,798BF3B08F72A16A6DEAAA235F1899BB,61011,15,17,2,109.60653,18.19076,1900
39164,291945,1F0A56540E2B5CE086CFC4F7E4349D63,31345,0,10,10,109.39,18.29,1066
39165,291946,1F0A56540E2B5CE086CFC4F7E4349D63,31471,11,15,4,109.34583,18.29563,917
39166,291947,1F0A56540E2B5CE086CFC4F7E4349D63,31345,17,23,6,109.39,18.29,1066
39196,292171,4D4289AE0DFBF4B5C79A47559DC2EBDD,31071,0,8,8,109.58257,18.28458,1815
39197,292172,4D4289AE0DFBF4B5C79A47559DC2EBDD,30854,13,15,2,109.56889,18.27076,1763
39198,292173,4D4289AE0DFBF4B5C79A47559DC2EBDD,31071,15,18,3,109.58257,18.28458,1815
39202,292177,68DBE0B52FD0AB95F1DD47068FD7847F,30181,0,15,15,109.51597,18.23313,1557
39203,292178,68DBE0B52FD0AB95F1DD47068FD7847F,31521,15,16,1,109.51458,18.22542,1555
39204,292179,68DBE0B52FD0AB95F1DD47068FD7847F,30181,17,19,2,109.51597,18.23313,1557
39241,292403,A795428793D2273B4ACFDADC5E61AEC2,60661,0,6,6,109.548,18.2377,1657
39242,292404,A795428793D2273B4ACFDADC5E61AEC2,31421,6,8,2,109.55382,18.22347,1705
39243,292405,A795428793D2273B4ACFDADC5E61AEC2,60381,8,10,2,109.5241,18.22458,1605
39254,292482,C58B2D758E557F71813EE954DB9BA52F,31521,1,10,9,109.51458,18.22542,1555
39255,292483,C58B2D758E557F71813EE954DB9BA52F,31521,12,17,5,109.51458,18.22542,1555
39256,292484,C58B2D758E557F71813EE954DB9BA52F,30711,18,19,1,109.50271,18.25347,1510
39257,292485,C58B2D758E557F71813EE954DB9BA52F,30731,20,21,1,109.50944,18.22306,1555
39262,292516,5780A06EB6BF6F352EB7920D095F7D55,30854,0,3,3,109.56889,18.27076,1763
39263,292517,5780A06EB6BF6F352EB7920D095F7D55,60331,5,9,4,109.505,18.26507,1512
39264,292518,5780A06EB6BF6F352EB7920D095F7D55,60201,10,20,10,109.5041,18.2509,1510
39265,292519,5780A06EB6BF6F352EB7920D095F7D55,60291,21,22,1,109.50826,18.24639,1509
39270,292584,65AD296DD65C9EEA3C22EA02904A768E,31561,0,8,8,109.56792,18.28479,1765
39271,292585,65AD296DD65C9EEA3C22EA02904A768E,30854,10,18,8,109.56889,18.27076,1763
39272,292586,65AD296DD65C9EEA3C22EA02904A768E,31561,21,23,2,109.56792,18.28479,1765
39276,292629,C925EDC1C2C39BAEC75090090BF059D6,30741,0,13,13,109.49833,18.28681,1516
39277,292630,C925EDC1C2C39BAEC75090090BF059D6,60201,15,17,2,109.5041,18.2509,1510
39278,292631,C925EDC1C2C39BAEC75090090BF059D6,30741,21,23,2,109.49833,18.28681,1516
39287,292767,26D16255CFD5E27173D1487C4D561ADC,30731,0,10,10,109.50944,18.22306,1555
39288,292768,26D16255CFD5E27173D1487C4D561ADC,31521,13,15,2,109.51458,18.22542,1555
39289,292769,26D16255CFD5E27173D1487C4D561ADC,30731,16,22,6,109.50944,18.22306,1555
39303,292856,17D13F6A66037B54FAB5668CDC734401,30721,0,10,10,109.51597,18.28257,1565
39304,292857,17D13F6A66037B54FAB5668CDC734401,31931,15,16,1,109.54771,18.29403,1667
39305,292858,17D13F6A66037B54FAB5668CDC734401,30721,19,23,4,109.51597,18.28257,1565
39318,292939,1E1181D91A7FDEE2449092386CA6A77C,60041,0,6,6,109.39889,18.31944,1121
39319,292940,1E1181D91A7FDEE2449092386CA6A77C,31671,6,8,2,109.38965,18.29813,1068
39320,292941,1E1181D91A7FDEE2449092386CA6A77C,60041,11,14,3,109.39889,18.31944,1121
39321,292942,1E1181D91A7FDEE2449092386CA6A77C,60552,19,20,1,109.41729,18.30014,1218
39330,292986,BE7763F8096EB5A037146E1CC4190538,30854,0,1,1,109.56889,18.27076,1763
39331,292987,BE7763F8096EB5A037146E1CC4190538,31561,5,8,3,109.56792,18.28479,1765
39332,292988,BE7763F8096EB5A037146E1CC4190538,31931,10,15,5,109.54771,18.29403,1667
39333,292994,65DCC597AECA35C4AE4D4EA8A3F39D90,31561,0,7,7,109.56792,18.28479,1765
39334,292995,65DCC597AECA35C4AE4D4EA8A3F39D90,39183,7,10,3,109.55542,18.28208,1715
39335,292996,65DCC597AECA35C4AE4D4EA8A3F39D90,31561,12,14,2,109.56792,18.28479,1765
39336,292997,65DCC597AECA35C4AE4D4EA8A3F39D90,39183,16,18,2,109.55542,18.28208,1715
39337,293050,3B37E4844A39E6F1818E1379BCCB47C1,38951,0,9,9,109.48097,18.28868,1416
39338,293051,3B37E4844A39E6F1818E1379BCCB47C1,38951,9,14,5,109.48097,18.28868,1416
39339,293052,3B37E4844A39E6F1818E1379BCCB47C1,38951,18,19,1,109.48097,18.28868,1416
39340,293053,3B37E4844A39E6F1818E1379BCCB47C1,38071,21,22,1,109.40722,18.30938,1169
39351,293179,62CBF94D737D513D371567F698917827,31561,0,2,2,109.56792,18.28479,1765
39352,293180,62CBF94D737D513D371567F698917827,30854,3,17,14,109.56889,18.27076,1763
39353,293181,62CBF94D737D513D371567F698917827,31561,18,19,1,109.56792,18.28479,1765
39385,293333,3B6FF1F8D896A0A62DC7E65967011999,39183,0,14,14,109.55542,18.28208,1715
39386,293334,3B6FF1F8D896A0A62DC7E65967011999,31931,14,16,2,109.54771,18.29403,1667
39387,293335,3B6FF1F8D896A0A62DC7E65967011999,30854,18,19,1,109.56889,18.27076,1763
39394,293364,DB4DF566D4757FF3BB488F82DE126248,31561,1,6,5,109.56792,18.28479,1765
39395,293365,DB4DF566D4757FF3BB488F82DE126248,30851,8,10,2,109.5616,18.27396,1713
39396,293366,DB4DF566D4757FF3BB488F82DE126248,31561,13,22,9,109.56792,18.28479,1765
39400,293391,16E640D9FA5593E85AD54BDFBAF952D8,31561,1,4,3,109.56792,18.28479,1765
39401,293392,16E640D9FA5593E85AD54BDFBAF952D8,30854,6,8,2,109.56889,18.27076,1763
39402,293393,16E640D9FA5593E85AD54BDFBAF952D8,60354,9,16,7,109.58701,18.28521,1815
39405,293490,179FD4660C817BD29234A518F00339D3,60231,1,2,1,109.49903,18.21972,1504
39406,293491,179FD4660C817BD29234A518F00339D3,39151,5,6,1,109.49875,18.25097,1510
39407,293492,179FD4660C817BD29234A518F00339D3,60231,9,22,13,109.49903,18.21972,1504
39418,293528,41D4EB5552A7A416EEB26FAA30F55A4B,39183,0,14,14,109.55542,18.28208,1715
39419,293529,41D4EB5552A7A416EEB26FAA30F55A4B,31561,16,17,1,109.56792,18.28479,1765
39420,293530,41D4EB5552A7A416EEB26FAA30F55A4B,39183,17,19,2,109.55542,18.28208,1715
39426,293695,E292D83051830D054E89D209EEABA4B9,31071,0,8,8,109.58257,18.28458,1815
39427,293696,E292D83051830D054E89D209EEABA4B9,31561,9,11,2,109.56792,18.28479,1765
39428,293697,E292D83051830D054E89D209EEABA4B9,31931,14,15,1,109.54771,18.29403,1667
39429,293698,E292D83051830D054E89D209EEABA4B9,31561,19,20,1,109.56792,18.28479,1765
39442,293827,19D15D3F765DDFCECEA9906D7BF44977,60291,0,7,7,109.50826,18.24639,1509
39443,293828,19D15D3F765DDFCECEA9906D7BF44977,38891,9,12,3,109.51486,18.24118,1558
39444,293829,19D15D3F765DDFCECEA9906D7BF44977,31201,16,18,2,109.51042,18.23819,1558
39445,293837,3977578BE56276DA0700B04B81DC1356,30851,0,6,6,109.5616,18.27396,1713
39446,293838,3977578BE56276DA0700B04B81DC1356,31561,6,9,3,109.56792,18.28479,1765
39447,293839,3977578BE56276DA0700B04B81DC1356,30851,11,14,3,109.5616,18.27396,1713
39454,293883,070A398F07C013242CC3447B66DFACBF,39183,0,5,5,109.55542,18.28208,1715
39455,293884,070A398F07C013242CC3447B66DFACBF,30071,8,9,1,109.52819,18.30472,1619
39456,293885,070A398F07C013242CC3447B66DFACBF,31931,9,11,2,109.54771,18.29403,1667
39457,293886,070A398F07C013242CC3447B66DFACBF,39183,11,23,12,109.55542,18.28208,1715
39463,293965,65DB2325B6E1E7A0D88A5D2D920F9EA1,31431,0,9,9,109.44639,18.29042,1316
39464,293966,65DB2325B6E1E7A0D88A5D2D920F9EA1,60472,10,11,1,109.46625,18.29542,1367
39465,293967,65DB2325B6E1E7A0D88A5D2D920F9EA1,31271,11,12,1,109.48958,18.26257,1462
39469,293995,C709D01469E0800AF998DFAF42105CDC,60631,3,5,2,109.57778,18.27583,1814
39470,293996,C709D01469E0800AF998DFAF42105CDC,31561,6,15,9,109.56792,18.28479,1765
39471,293997,C709D01469E0800AF998DFAF42105CDC,30854,15,22,7,109.56889,18.27076,1763
39485,294071,2C4460320CA36DFBF289BCF74C69B0D0,38903,0,7,7,109.39229,18.29243,1117
39486,294072,2C4460320CA36DFBF289BCF74C69B0D0,38162,8,10,2,109.43944,18.28889,1266
39487,294073,2C4460320CA36DFBF289BCF74C69B0D0,31701,12,18,6,109.44132,18.28833,1266
39488,294089,DDE77D3A656666992FC3458B84010D43,39181,0,4,4,109.55153,18.28035,1715
39489,294090,DDE77D3A656666992FC3458B84010D43,31561,5,8,3,109.56792,18.28479,1765
39490,294091,DDE77D3A656666992FC3458B84010D43,39183,11,13,2,109.55542,18.28208,1715
39491,294092,DDE77D3A656666992FC3458B84010D43,31561,14,15,1,109.56792,18.28479,1765
39492,294105,E65B17C657BA16C2533DB76C0BC3AB34,30671,0,9,9,109.43611,18.30139,1268
39493,294106,E65B17C657BA16C2533DB76C0BC3AB34,31351,9,11,2,109.4959,18.28417,1465
39494,294107,E65B17C657BA16C2533DB76C0BC3AB34,30671,15,19,4,109.43611,18.30139,1268
39503,294152,F6A1EBB84FE583E84185C423218578F5,39183,1,3,2,109.55542,18.28208,1715
39504,294153,F6A1EBB84FE583E84185C423218578F5,31561,4,5,1,109.56792,18.28479,1765
39505,294154,F6A1EBB84FE583E84185C423218578F5,39183,6,9,3,109.55542,18.28208,1715
39506,294155,F6A1EBB84FE583E84185C423218578F5,31561,12,13,1,109.56792,18.28479,1765
39519,294197,283001ED673D8EDBEF7EEB00BDB31533,31231,0,5,5,109.42597,18.29292,1217
39520,294198,283001ED673D8EDBEF7EEB00BDB31533,30351,5,10,5,109.41701,18.29292,1217
39521,294199,283001ED673D8EDBEF7EEB00BDB31533,31231,13,14,1,109.42597,18.29292,1217
39522,294200,283001ED673D8EDBEF7EEB00BDB31533,30351,14,16,2,109.41701,18.29292,1217
39527,294266,40C57F24FE0409ABB752B2031C349577,38951,0,4,4,109.48097,18.28868,1416
39528,294267,40C57F24FE0409ABB752B2031C349577,38951,4,8,4,109.48097,18.28868,1416
39529,294268,40C57F24FE0409ABB752B2031C349577,38951,8,10,2,109.48097,18.28868,1416
39536,294363,0D61EA75C03A93303AE1706E6D1B22F4,30201,0,7,7,109.4909,18.26465,1462
39537,294364,0D61EA75C03A93303AE1706E6D1B22F4,38153,9,11,2,109.51819,18.25736,1561
39538,294365,0D61EA75C03A93303AE1706E6D1B22F4,30201,12,18,6,109.4909,18.26465,1462
39547,294396,63FBAC0202144B00077561285E6A7F87,30821,0,8,8,109.43681,18.33639,1274
39548,294397,63FBAC0202144B00077561285E6A7F87,30651,8,11,3,109.42611,18.385,1232
39549,294398,63FBAC0202144B00077561285E6A7F87,30821,12,16,4,109.43681,18.33639,1274
39550,294413,DF296B63A64E364FCDA4C38B0935EEEE,30511,0,7,7,109.51069,18.24208,1558
39551,294414,DF296B63A64E364FCDA4C38B0935EEEE,60201,7,8,1,109.5041,18.2509,1510
39552,294415,DF296B63A64E364FCDA4C38B0935EEEE,30511,8,22,14,109.51069,18.24208,1558
39553,294416,DF296B63A64E364FCDA4C38B0935EEEE,38891,22,23,1,109.51486,18.24118,1558
39565,294629,18073AD9E71B8DFC1E520C5E3653B1BD,30721,0,7,7,109.51597,18.28257,1565
39566,294630,18073AD9E71B8DFC1E520C5E3653B1BD,31951,11,12,1,109.52174,18.30299,1568
39567,294631,18073AD9E71B8DFC1E520C5E3653B1BD,38881,14,15,1,109.51618,18.26431,1562
39581,294748,807332CEC38772FA8DF98C48FBD8DD1E,31561,0,6,6,109.56792,18.28479,1765
39582,294749,807332CEC38772FA8DF98C48FBD8DD1E,39183,6,8,2,109.55542,18.28208,1715
39583,294750,807332CEC38772FA8DF98C48FBD8DD1E,31561,8,23,15,109.56792,18.28479,1765
39584,294755,A549C024E6F63EDBD3DC866F10DB11CE,31945,0,2,2,109.58021,18.29403,1817
39585,294756,A549C024E6F63EDBD3DC866F10DB11CE,30854,5,10,5,109.56889,18.27076,1763
39586,294757,A549C024E6F63EDBD3DC866F10DB11CE,30234,12,13,1,109.60681,18.29979,1918
39597,294803,608A55C14BAB2A5B627ACC1F39B89FB6,31945,0,7,7,109.58021,18.29403,1817
39598,294804,608A55C14BAB2A5B627ACC1F39B89FB6,30854,7,15,8,109.56889,18.27076,1763
39599,294805,608A55C14BAB2A5B627ACC1F39B89FB6,31945,18,22,4,109.58021,18.29403,1817
39610,294973,2C5F898948A2B7909519666936FBF333,38707,0,10,10,109.73778,18.35368,2427
39611,294974,2C5F898948A2B7909519666936FBF333,38707,13,14,1,109.73778,18.35368,2427
39612,294975,2C5F898948A2B7909519666936FBF333,60117,19,23,4,109.73604,18.35681,2427
39619,295015,37DC2EF674B0D61C6D10D120CF46E31D,60221,0,9,9,109.52569,18.29188,1616
39620,295016,37DC2EF674B0D61C6D10D120CF46E31D,31461,11,17,6,109.5091,18.25389,1510
39621,295017,37DC2EF674B0D61C6D10D120CF46E31D,60221,19,23,4,109.52569,18.29188,1616
39624,295020,89A01963B06628A3D6B13DA41FA507D1,31561,0,11,11,109.56792,18.28479,1765
39625,295021,89A01963B06628A3D6B13DA41FA507D1,30854,13,14,1,109.56889,18.27076,1763
39626,295022,89A01963B06628A3D6B13DA41FA507D1,31561,17,18,1,109.56792,18.28479,1765
39631,295050,A01B4012B619D942E7CC3AC9B78722B4,31561,0,2,2,109.56792,18.28479,1765
39632,295051,A01B4012B619D942E7CC3AC9B78722B4,30854,2,7,5,109.56889,18.27076,1763
39633,295052,A01B4012B619D942E7CC3AC9B78722B4,31561,7,21,14,109.56792,18.28479,1765
39636,295067,C153552CEA2677B0FF473AE565EA979E,30821,0,9,9,109.43681,18.33639,1274
39637,295068,C153552CEA2677B0FF473AE565EA979E,30651,10,11,1,109.42611,18.385,1232
39638,295069,C153552CEA2677B0FF473AE565EA979E,30821,12,15,3,109.43681,18.33639,1274
39639,295073,417408FFDA93B177641D270D3A5C4B2D,31071,0,5,5,109.58257,18.28458,1815
39640,295074,417408FFDA93B177641D270D3A5C4B2D,30854,7,16,9,109.56889,18.27076,1763
39641,295075,417408FFDA93B177641D270D3A5C4B2D,31071,20,21,1,109.58257,18.28458,1815
39649,295248,BD4652414D5C17466BA36FD4BD943A94,30721,1,2,1,109.51597,18.28257,1565
39650,295249,BD4652414D5C17466BA36FD4BD943A94,60221,2,6,4,109.52569,18.29188,1616
39651,295250,BD4652414D5C17466BA36FD4BD943A94,31931,10,12,2,109.54771,18.29403,1667
39652,295308,528F99F7FD8CA49B85B45B64A5D784BA,39181,0,1,1,109.55153,18.28035,1715
39653,295309,528F99F7FD8CA49B85B45B64A5D784BA,39183,3,10,7,109.55542,18.28208,1715
39654,295310,528F99F7FD8CA49B85B45B64A5D784BA,30851,12,21,9,109.5616,18.27396,1713
39655,295322,AF8B86B0B083254392EBA97EA612D81F,60371,1,5,4,109.53063,18.30056,1618
39656,295323,AF8B86B0B083254392EBA97EA612D81F,31931,6,7,1,109.54771,18.29403,1667
39657,295324,AF8B86B0B083254392EBA97EA612D81F,31951,8,12,4,109.52174,18.30299,1568
39658,295325,AF8B86B0B083254392EBA97EA612D81F,31931,12,13,1,109.54771,18.29403,1667
39664,295406,F09FA024A3E2DFBDA7DF33869DEBF9A1,30271,0,8,8,109.49132,18.23153,1456
39665,295407,F09FA024A3E2DFBDA7DF33869DEBF9A1,30171,9,11,2,109.48458,18.27139,1463
39666,295408,F09FA024A3E2DFBDA7DF33869DEBF9A1,60084,12,14,2,109.4984,18.2334,1507
39669,295446,75817DB682187A07461734D66E1E6492,60631,0,4,4,109.57778,18.27583,1814
39670,295447,75817DB682187A07461734D66E1E6492,30854,5,20,15,109.56889,18.27076,1763
39671,295448,75817DB682187A07461734D66E1E6492,60631,21,22,1,109.57778,18.27583,1814
39682,295496,C13109DDB34AB39863FA7554436B5462,38291,0,5,5,109.51618,18.24313,1558
39683,295497,C13109DDB34AB39863FA7554436B5462,31261,8,10,2,109.51174,18.2466,1559
39684,295498,C13109DDB34AB39863FA7554436B5462,30051,14,17,3,109.48917,18.21215,1453
39697,295562,C19430CE8DF26BDEF43903E57E682236,31561,0,7,7,109.56792,18.28479,1765
39698,295563,C19430CE8DF26BDEF43903E57E682236,30854,11,21,10,109.56889,18.27076,1763
39699,295564,C19430CE8DF26BDEF43903E57E682236,31561,21,23,2,109.56792,18.28479,1765
39700,295572,E6541B4F346982101D887BAAF0315541,30854,0,7,7,109.56889,18.27076,1763
39701,295573,E6541B4F346982101D887BAAF0315541,31561,10,17,7,109.56792,18.28479,1765
39702,295574,E6541B4F346982101D887BAAF0315541,30854,20,23,3,109.56889,18.27076,1763
39703,295590,AB6EA8E0EB921375D4ACF50883707DA2,30081,0,6,6,109.50243,18.26632,1512
39704,295591,AB6EA8E0EB921375D4ACF50883707DA2,30084,6,8,2,109.50118,18.26972,1513
39705,295592,AB6EA8E0EB921375D4ACF50883707DA2,30511,10,11,1,109.51069,18.24208,1558
39706,295593,AB6EA8E0EB921375D4ACF50883707DA2,30281,13,14,1,109.50597,18.27583,1514
39711,295614,CE70D3AAC3EF6B01DB8A5F34BD94E77D,30821,1,2,1,109.43681,18.33639,1274
39712,295615,CE70D3AAC3EF6B01DB8A5F34BD94E77D,30651,3,5,2,109.42611,18.385,1232
39713,295616,CE70D3AAC3EF6B01DB8A5F34BD94E77D,30821,5,22,17,109.43681,18.33639,1274
39716,295700,B3B9E7CAA281FDC11E6B1AB8159D5D86,31201,5,8,3,109.51042,18.23819,1558
39717,295701,B3B9E7CAA281FDC11E6B1AB8159D5D86,30511,8,10,2,109.51069,18.24208,1558
39718,295702,B3B9E7CAA281FDC11E6B1AB8159D5D86,31201,12,23,11,109.51042,18.23819,1558
39734,295821,4EFA26B7BBE10FFA0F7013E0F210FD9B,38903,1,8,7,109.39229,18.29243,1117
39735,295822,4EFA26B7BBE10FFA0F7013E0F210FD9B,38325,12,14,2,109.39792,18.2909,1116
39736,295823,4EFA26B7BBE10FFA0F7013E0F210FD9B,31671,14,15,1,109.38965,18.29813,1068
39737,295824,E987CA4A1E047E111B5BA701616DDAD3,31931,0,1,1,109.54771,18.29403,1667
39738,295825,E987CA4A1E047E111B5BA701616DDAD3,31071,1,8,7,109.58257,18.28458,1815
39739,295826,E987CA4A1E047E111B5BA701616DDAD3,31071,10,11,1,109.58257,18.28458,1815
39740,295827,E987CA4A1E047E111B5BA701616DDAD3,30851,12,13,1,109.5616,18.27396,1713
39745,295841,874B1DEE34891BC74B0E782C57027407,60281,0,6,6,109.51743,18.25924,1561
39746,295842,874B1DEE34891BC74B0E782C57027407,30421,7,10,3,109.50021,18.25861,1511
39747,295843,874B1DEE34891BC74B0E782C57027407,30361,14,20,6,109.50347,18.24,1508
39748,295844,874B1DEE34891BC74B0E782C57027407,30171,22,23,1,109.48458,18.27139,1463
39749,295845,CE2F4784729107FCC048F6386F4B6BD2,31861,1,2,1,109.49042,18.27549,1464
39750,295846,CE2F4784729107FCC048F6386F4B6BD2,31021,3,4,1,109.49021,18.27,1463
39751,295847,CE2F4784729107FCC048F6386F4B6BD2,31861,4,6,2,109.49042,18.27549,1464
39752,295848,CE2F4784729107FCC048F6386F4B6BD2,31864,7,8,1,109.49014,18.28333,1465
39778,296094,46D3900FF4CD0CE137E6DB2E5BBC5B87,39183,0,5,5,109.55542,18.28208,1715
39779,296095,46D3900FF4CD0CE137E6DB2E5BBC5B87,31931,6,7,1,109.54771,18.29403,1667
39780,296096,46D3900FF4CD0CE137E6DB2E5BBC5B87,39183,12,23,11,109.55542,18.28208,1715
39800,296173,279E4B9468E6485253E3AD5AB807E2AE,31071,1,8,7,109.58257,18.28458,1815
39801,296174,279E4B9468E6485253E3AD5AB807E2AE,30854,12,14,2,109.56889,18.27076,1763
39802,296175,279E4B9468E6485253E3AD5AB807E2AE,31071,18,23,5,109.58257,18.28458,1815
39827,296278,C73F853CCBF7708CEEEDE5C7FB7E0D81,60201,0,3,3,109.5041,18.2509,1510
39828,296279,C73F853CCBF7708CEEEDE5C7FB7E0D81,30711,4,6,2,109.50271,18.25347,1510
39829,296280,C73F853CCBF7708CEEEDE5C7FB7E0D81,30711,6,8,2,109.50271,18.25347,1510
39841,296387,85D2E0E28FB58C7F8A0D7BC94160D3DD,31561,0,7,7,109.56792,18.28479,1765
39842,296388,85D2E0E28FB58C7F8A0D7BC94160D3DD,30854,7,17,10,109.56889,18.27076,1763
39843,296389,85D2E0E28FB58C7F8A0D7BC94160D3DD,31561,19,22,3,109.56792,18.28479,1765
39844,296390,A989E432A34968A6D5E2DE0CFBC28422,30051,2,7,5,109.48917,18.21215,1453
39845,296391,A989E432A34968A6D5E2DE0CFBC28422,39321,9,13,4,109.529,18.2167,1604
39846,296392,A989E432A34968A6D5E2DE0CFBC28422,30051,14,15,1,109.48917,18.21215,1453
39847,296393,A989E432A34968A6D5E2DE0CFBC28422,39321,16,22,6,109.529,18.2167,1604
39855,296474,201045A9C980BD8E53B16B9129DFE596,31071,0,5,5,109.58257,18.28458,1815
39856,296475,201045A9C980BD8E53B16B9129DFE596,30854,6,7,1,109.56889,18.27076,1763
39857,296476,201045A9C980BD8E53B16B9129DFE596,31561,8,16,8,109.56792,18.28479,1765
39858,296477,201045A9C980BD8E53B16B9129DFE596,31071,20,22,2,109.58257,18.28458,1815
39868,296515,7024F3A14F6F554DC6E80063E30315F0,31561,1,4,3,109.56792,18.28479,1765
39869,296516,7024F3A14F6F554DC6E80063E30315F0,39183,8,16,8,109.55542,18.28208,1715
39870,296517,7024F3A14F6F554DC6E80063E30315F0,31561,20,23,3,109.56792,18.28479,1765
39893,296781,98BC08E1CDA3F375385918E822A1184B,31931,0,14,14,109.54771,18.29403,1667
39894,296782,98BC08E1CDA3F375385918E822A1184B,30071,14,16,2,109.52819,18.30472,1619
39895,296783,98BC08E1CDA3F375385918E822A1184B,31931,20,23,3,109.54771,18.29403,1667
39900,296819,3BD201CEDCBB0C6283517FCB62C04811,30181,0,12,12,109.51597,18.23313,1557
39901,296820,3BD201CEDCBB0C6283517FCB62C04811,38961,15,16,1,109.50847,18.23514,1507
39902,296821,3BD201CEDCBB0C6283517FCB62C04811,60081,16,17,1,109.51097,18.22639,1556
39903,296822,3BD201CEDCBB0C6283517FCB62C04811,38961,20,23,3,109.50847,18.23514,1507
39904,296843,B80D4B4CDBD08237A9C4254F8883AEF4,39151,0,7,7,109.49875,18.25097,1510
39905,296844,B80D4B4CDBD08237A9C4254F8883AEF4,31181,7,9,2,109.50382,18.24813,1509
39906,296845,B80D4B4CDBD08237A9C4254F8883AEF4,30711,10,11,1,109.50271,18.25347,1510
39907,296846,B80D4B4CDBD08237A9C4254F8883AEF4,39091,13,15,2,109.50097,18.25222,1510
39916,296867,CCCD2290FB632A48009771412BE68ADD,31561,0,11,11,109.56792,18.28479,1765
39917,296868,CCCD2290FB632A48009771412BE68ADD,39183,14,16,2,109.55542,18.28208,1715
39918,296869,CCCD2290FB632A48009771412BE68ADD,31561,19,21,2,109.56792,18.28479,1765
39922,296905,99CBAA6A65A50998F0A10B72B36210E4,60231,0,1,1,109.49903,18.21972,1504
39923,296906,99CBAA6A65A50998F0A10B72B36210E4,39151,3,5,2,109.49875,18.25097,1510
39924,296907,99CBAA6A65A50998F0A10B72B36210E4,60231,7,22,15,109.49903,18.21972,1504
39932,296960,37D38EF0062E64D55C94EB554B76F9EE,31071,1,2,1,109.58257,18.28458,1815
39933,296961,37D38EF0062E64D55C94EB554B76F9EE,31945,4,6,2,109.58021,18.29403,1817
39934,296962,37D38EF0062E64D55C94EB554B76F9EE,30854,8,9,1,109.56889,18.27076,1763
39935,296963,37D38EF0062E64D55C94EB554B76F9EE,30281,12,13,1,109.50597,18.27583,1514
39936,297003,F5E480BCE870DAE347CB60AA32F4CA1B,31071,0,6,6,109.58257,18.28458,1815
39937,297004,F5E480BCE870DAE347CB60AA32F4CA1B,30854,10,11,1,109.56889,18.27076,1763
39938,297005,F5E480BCE870DAE347CB60AA32F4CA1B,31071,13,23,10,109.58257,18.28458,1815
39939,297016,020753EF78F0A0C39658113A3377EA1E,31561,0,7,7,109.56792,18.28479,1765
39940,297017,020753EF78F0A0C39658113A3377EA1E,39183,7,10,3,109.55542,18.28208,1715
39941,297018,020753EF78F0A0C39658113A3377EA1E,31931,11,12,1,109.54771,18.29403,1667
39942,297019,020753EF78F0A0C39658113A3377EA1E,39183,15,16,1,109.55542,18.28208,1715
39943,297037,1122041491C04B199A15F6E1E401D68F,60281,0,4,4,109.51743,18.25924,1561
39944,297038,1122041491C04B199A15F6E1E401D68F,30461,4,7,3,109.5116,18.26313,1562
39945,297039,1122041491C04B199A15F6E1E401D68F,60281,7,14,7,109.51743,18.25924,1561
39946,297040,1122041491C04B199A15F6E1E401D68F,30461,18,23,5,109.5116,18.26313,1562
39960,297172,1980C8D409DE9551539224B3D393CDAA,30071,1,12,11,109.52819,18.30472,1619
39961,297173,1980C8D409DE9551539224B3D393CDAA,31951,12,16,4,109.52174,18.30299,1568
39962,297174,1980C8D409DE9551539224B3D393CDAA,30071,19,23,4,109.52819,18.30472,1619
39977,297273,F3EA4B3DF8A619A30272A53ECD9E968F,30461,0,2,2,109.5116,18.26313,1562
39978,297274,F3EA4B3DF8A619A30272A53ECD9E968F,38185,3,6,3,109.51333,18.27347,1563
39979,297275,F3EA4B3DF8A619A30272A53ECD9E968F,30251,9,10,1,109.50611,18.26653,1512
39980,297276,F3EA4B3DF8A619A30272A53ECD9E968F,30711,13,15,2,109.50271,18.25347,1510
39986,297344,08077B5D5F0A9938A81D328635D03C8B,30854,0,15,15,109.56889,18.27076,1763
39987,297345,08077B5D5F0A9938A81D328635D03C8B,31071,15,16,1,109.58257,18.28458,1815
39988,297346,08077B5D5F0A9938A81D328635D03C8B,30854,18,20,2,109.56889,18.27076,1763
39989,297347,189633BA4D39EBA8A203BC9E364D4B1F,30381,1,7,6,109.52521,18.24507,1609
39990,297348,189633BA4D39EBA8A203BC9E364D4B1F,30051,8,15,7,109.48917,18.21215,1453
39991,297349,189633BA4D39EBA8A203BC9E364D4B1F,38013,17,21,4,109.49514,18.21951,1454
40024,297591,40285EE8CCE25C38988EC087545664EC,31071,4,7,3,109.58257,18.28458,1815
40025,297592,40285EE8CCE25C38988EC087545664EC,30854,9,10,1,109.56889,18.27076,1763
40026,297593,40285EE8CCE25C38988EC087545664EC,31071,15,16,1,109.58257,18.28458,1815
40027,297594,40285EE8CCE25C38988EC087545664EC,30854,17,19,2,109.56889,18.27076,1763
40046,297680,033CEEC20746801745CF4A53CD517C31,31171,1,7,6,109.50938,18.24917,1559
40047,297681,033CEEC20746801745CF4A53CD517C31,60291,11,14,3,109.50826,18.24639,1509
40048,297682,033CEEC20746801745CF4A53CD517C31,30421,15,16,1,109.50021,18.25861,1511
40049,297683,033CEEC20746801745CF4A53CD517C31,60201,19,23,4,109.5041,18.2509,1510
40058,297829,D46DE9169E4BACF1D272EA5E0FDEF68F,39181,5,10,5,109.55153,18.28035,1715
40059,297830,D46DE9169E4BACF1D272EA5E0FDEF68F,31561,10,11,1,109.56792,18.28479,1765
40060,297831,D46DE9169E4BACF1D272EA5E0FDEF68F,39183,14,20,6,109.55542,18.28208,1715
40061,297845,39F25FE146A03325C93C111F2A943B6C,31945,0,13,13,109.58021,18.29403,1817
40062,297846,39F25FE146A03325C93C111F2A943B6C,31071,15,17,2,109.58257,18.28458,1815
40063,297847,39F25FE146A03325C93C111F2A943B6C,31945,20,23,3,109.58021,18.29403,1817
40072,297945,443D183C692C6C6B0CFC9BE76827D81A,31521,0,7,7,109.51458,18.22542,1555
40073,297947,443D183C692C6C6B0CFC9BE76827D81A,30181,17,18,1,109.51597,18.23313,1557
40074,297948,443D183C692C6C6B0CFC9BE76827D81A,31521,19,23,4,109.51458,18.22542,1555
40080,298037,1D60D001EBDC67D77E1C6037DB507422,31561,0,8,8,109.56792,18.28479,1765
40081,298038,1D60D001EBDC67D77E1C6037DB507422,30854,8,10,2,109.56889,18.27076,1763
40082,298039,1D60D001EBDC67D77E1C6037DB507422,31561,10,11,1,109.56792,18.28479,1765
40083,298040,1D60D001EBDC67D77E1C6037DB507422,30854,13,21,8,109.56889,18.27076,1763
40088,298085,C6579823835B85A254880E72927E82BB,30891,0,1,1,109.59431,18.28389,1865
40089,298086,C6579823835B85A254880E72927E82BB,30854,4,6,2,109.56889,18.27076,1763
40090,298087,C6579823835B85A254880E72927E82BB,39371,10,21,11,109.56627,18.2646,1762
40091,298180,14F1CC63CDA098F9694EAC8584B9C7A5,31071,0,5,5,109.58257,18.28458,1815
40092,298181,14F1CC63CDA098F9694EAC8584B9C7A5,31561,9,10,1,109.56792,18.28479,1765
40093,298182,14F1CC63CDA098F9694EAC8584B9C7A5,30854,10,18,8,109.56889,18.27076,1763
40094,298183,14F1CC63CDA098F9694EAC8584B9C7A5,31561,19,20,1,109.56792,18.28479,1765
40098,298269,13A6EDC75AEBF90A555AE4ABEB3F9FCC,30851,1,4,3,109.5616,18.27396,1713
40099,298270,13A6EDC75AEBF90A555AE4ABEB3F9FCC,39181,6,11,5,109.55153,18.28035,1715
40100,298271,13A6EDC75AEBF90A555AE4ABEB3F9FCC,39181,12,17,5,109.55153,18.28035,1715
40101,298272,13A6EDC75AEBF90A555AE4ABEB3F9FCC,30851,22,23,1,109.5616,18.27396,1713
40110,298410,23019CE071DC0B0CEC6E78ADA422CE57,60201,0,5,5,109.5041,18.2509,1510
40111,298411,23019CE071DC0B0CEC6E78ADA422CE57,31461,6,9,3,109.5091,18.25389,1510
40112,298412,23019CE071DC0B0CEC6E78ADA422CE57,38973,11,13,2,109.51097,18.25389,1560
40113,298413,23019CE071DC0B0CEC6E78ADA422CE57,38127,18,21,3,109.50833,18.27222,1513
40118,298473,7BF65E5054DA81A230AB5423620158E1,60631,2,7,5,109.57778,18.27583,1814
40119,298474,7BF65E5054DA81A230AB5423620158E1,30854,9,10,1,109.56889,18.27076,1763
40120,298475,7BF65E5054DA81A230AB5423620158E1,60631,12,13,1,109.57778,18.27583,1814
40121,298517,746CE65E441D0A7A7BB255CDAAD7360A,30854,5,6,1,109.56889,18.27076,1763
40122,298518,746CE65E441D0A7A7BB255CDAAD7360A,31071,10,13,3,109.58257,18.28458,1815
40123,298519,746CE65E441D0A7A7BB255CDAAD7360A,30854,14,20,6,109.56889,18.27076,1763
40133,298631,8F6EA1C108FADA76A214A7ED71ECE3D1,30891,0,7,7,109.59431,18.28389,1865
40134,298632,8F6EA1C108FADA76A214A7ED71ECE3D1,30854,10,12,2,109.56889,18.27076,1763
40135,298633,8F6EA1C108FADA76A214A7ED71ECE3D1,30891,16,18,2,109.59431,18.28389,1865
40139,298700,EF7DCA5602FCDF14AF156D676A8ED902,31561,0,1,1,109.56792,18.28479,1765
40140,298701,EF7DCA5602FCDF14AF156D676A8ED902,30854,1,5,4,109.56889,18.27076,1763
40141,298702,EF7DCA5602FCDF14AF156D676A8ED902,31561,7,9,2,109.56792,18.28479,1765
40142,298703,EF7DCA5602FCDF14AF156D676A8ED902,39183,9,11,2,109.55542,18.28208,1715
40143,298741,8AABF5FDF2B06EB445749240A3894969,30854,0,1,1,109.56889,18.27076,1763
40144,298742,8AABF5FDF2B06EB445749240A3894969,31071,2,11,9,109.58257,18.28458,1815
40145,298743,8AABF5FDF2B06EB445749240A3894969,30854,13,23,10,109.56889,18.27076,1763
40146,298765,162C9DF38B34BB5029840E39407B0BD5,31201,0,2,2,109.51042,18.23819,1558
40147,298766,162C9DF38B34BB5029840E39407B0BD5,39191,3,8,5,109.51493,18.23472,1557
40148,298767,162C9DF38B34BB5029840E39407B0BD5,31041,12,13,1,109.50278,18.23701,1507
40173,298858,9A1D1AA5EE2CD156CC396C667ED8C5B9,30854,2,7,5,109.56889,18.27076,1763
40174,298859,9A1D1AA5EE2CD156CC396C667ED8C5B9,31071,7,14,7,109.58257,18.28458,1815
40175,298860,9A1D1AA5EE2CD156CC396C667ED8C5B9,30854,16,17,1,109.56889,18.27076,1763
40178,298886,AE15DCAE42DF0D3349548C07BEAC73FD,38951,0,1,1,109.48097,18.28868,1416
40179,298887,AE15DCAE42DF0D3349548C07BEAC73FD,60401,1,2,1,109.47444,18.27583,1414
40180,298888,AE15DCAE42DF0D3349548C07BEAC73FD,38951,3,22,19,109.48097,18.28868,1416
40185,298930,306C6C6EB560D035853CD87DDFB51F50,31071,3,5,2,109.58257,18.28458,1815
40186,298931,306C6C6EB560D035853CD87DDFB51F50,60631,10,11,1,109.57778,18.27583,1814
40187,298932,306C6C6EB560D035853CD87DDFB51F50,30854,12,23,11,109.56889,18.27076,1763
