,id,grid,start_hour,end_hour,duration,lon,lat,gps2id
0,2F1CD98DD5F5A4A3E6D47AB706E19DF1,38154,4,6,2,109.5266,18.28278,1615
1,2F1CD98DD5F5A4A3E6D47AB706E19DF1,30151,6,15,9,109.50986,18.25083,1560
2,2F1CD98DD5F5A4A3E6D47AB706E19DF1,60641,15,17,2,109.53854,18.2359,1657
3,2F1CD98DD5F5A4A3E6D47AB706E19DF1,31551,18,19,1,109.55868,18.24222,1708
4,2F1CD98DD5F5A4A3E6D47AB706E19DF1,31171,20,21,1,109.50938,18.24917,1559
5,2F1CD98DD5F5A4A3E6D47AB706E19DF1,38154,21,22,1,109.5266,18.28278,1615
11,8CD2F16F090DFFBF34897CAC847CB1B1,38991,0,8,8,109.52681,18.30368,1618
12,8CD2F16F090DFFBF34897CAC847CB1B1,30071,12,13,1,109.52819,18.30472,1619
13,8CD2F16F090DFFBF34897CAC847CB1B1,31145,14,16,2,109.20431,18.30479,369
14,8CD2F16F090DFFBF34897CAC847CB1B1,38991,19,23,4,109.52681,18.30368,1618
62,3BB24F8BCA3E0C99C850EC3AEEBC46A9,31411,19,21,2,109.5016,18.23576,1507
74,59F29435D748531F416A4F1636997ECF,31071,0,5,5,109.58257,18.28458,1815
75,59F29435D748531F416A4F1636997ECF,30221,7,8,1,109.57833,18.20222,1802
76,59F29435D748531F416A4F1636997ECF,30854,12,22,10,109.56889,18.27076,1763
81,68DBE0B52FD0AB95F1DD47068FD7847F,39111,0,6,6,109.5191,18.22597,1555
82,68DBE0B52FD0AB95F1DD47068FD7847F,30181,6,12,6,109.51597,18.23313,1557
83,68DBE0B52FD0AB95F1DD47068FD7847F,30381,14,16,2,109.52521,18.24507,1609
84,68DBE0B52FD0AB95F1DD47068FD7847F,38291,21,22,1,109.51618,18.24313,1558
94,A8ABE4987042D12DD458C81CFD9663F5,30771,0,15,15,109.49938,18.26042,1511
95,A8ABE4987042D12DD458C81CFD9663F5,30971,20,21,1,109.48708,18.29319,1467
112,29064106BAD1EF15D718EE782B958C59,30854,16,17,1,109.56889,18.27076,1763
113,29064106BAD1EF15D718EE782B958C59,39111,19,23,4,109.5191,18.22597,1555
124,22CF7007721E0F1D863F25E4633BE1AD,60311,0,7,7,109.52097,18.24319,1558
125,22CF7007721E0F1D863F25E4633BE1AD,31521,12,13,1,109.51458,18.22542,1555
126,22CF7007721E0F1D863F25E4633BE1AD,31864,14,15,1,109.49014,18.28333,1465
197,066CC6CBB5ADF978A93AF5D0C3292806,60501,13,14,1,109.48701,18.29021,1466
198,066CC6CBB5ADF978A93AF5D0C3292806,60031,15,17,2,109.49694,18.31632,1521
219,8F33595CCA53EF587ED1CFDC11EABCC3,60381,17,18,1,109.5241,18.22458,1605
220,8F33595CCA53EF587ED1CFDC11EABCC3,38251,19,20,1,109.49618,18.25493,1510
241,222E0B6922623CE9FBB280F81068D40E,38291,1,2,1,109.51618,18.24313,1558
242,222E0B6922623CE9FBB280F81068D40E,30571,4,6,2,109.50243,18.21861,1504
243,222E0B6922623CE9FBB280F81068D40E,39321,10,23,13,109.529,18.2167,1604
269,656B9E927798C6351C23CE193C829143,30171,9,20,11,109.48458,18.27139,1463
272,D359BF2318E0673A42DA16770C88CC4A,31145,13,15,2,109.20431,18.30479,369
273,D359BF2318E0673A42DA16770C88CC4A,31471,16,17,1,109.34583,18.29563,917
274,D359BF2318E0673A42DA16770C88CC4A,30341,18,20,2,109.3625,18.29167,966
288,90D91A493F9482486DCC3B27CF3F61EE,30854,6,8,2,109.56889,18.27076,1763
289,90D91A493F9482486DCC3B27CF3F61EE,31071,11,12,1,109.58257,18.28458,1815
290,90D91A493F9482486DCC3B27CF3F61EE,30854,12,17,5,109.56889,18.27076,1763
304,9BD095517798346F169AD6D898CA1A42,60361,0,12,12,109.51938,18.29681,1567
305,9BD095517798346F169AD6D898CA1A42,38154,14,15,1,109.5266,18.28278,1615
306,9BD095517798346F169AD6D898CA1A42,60361,18,23,5,109.51938,18.29681,1567
323,51A31646817F28C39250F582919BD19D,30111,1,7,6,109.47583,18.30542,1419
324,51A31646817F28C39250F582919BD19D,31431,7,9,2,109.44639,18.29042,1316
335,299AC9422F298CCC4ED16594B565B2CA,31864,19,20,1,109.49014,18.28333,1465
336,299AC9422F298CCC4ED16594B565B2CA,31861,20,22,2,109.49042,18.27549,1464
360,6BEBB9BBE9F4AFE976BF8920DDE09F08,31521,0,12,12,109.51458,18.22542,1555
361,6BEBB9BBE9F4AFE976BF8920DDE09F08,60054,13,17,4,109.3016,18.31229,770
362,6BEBB9BBE9F4AFE976BF8920DDE09F08,31031,18,20,2,109.49979,18.25382,1510
363,6BEBB9BBE9F4AFE976BF8920DDE09F08,31521,21,23,2,109.51458,18.22542,1555
383,FBD16F71D823E84C51D72176C3087A7E,30051,0,20,20,109.48917,18.21215,1453
384,FBD16F71D823E84C51D72176C3087A7E,31031,20,21,1,109.49979,18.25382,1510
423,68B7F3DB5AE2950AAD1040D6DBF076CF,30921,11,18,7,109.53903,18.29451,1667
424,68B7F3DB5AE2950AAD1040D6DBF076CF,38017,21,22,1,109.49729,18.21424,1504
433,104D50A9C0319F25E132948E6191A1E5,30271,9,11,2,109.49132,18.23153,1456
434,104D50A9C0319F25E132948E6191A1E5,30211,12,22,10,109.49882,18.23931,1508
540,46DF6D1FF2BE866E5B4B2D35C5373299,30854,7,15,8,109.56889,18.27076,1763
541,46DF6D1FF2BE866E5B4B2D35C5373299,60221,18,20,2,109.52569,18.29188,1616
553,13104A6A71A054F852B52BB76993ADB2,30851,0,17,17,109.5616,18.27396,1713
554,13104A6A71A054F852B52BB76993ADB2,30951,19,20,1,109.56208,18.25667,1761
555,13104A6A71A054F852B52BB76993ADB2,30854,21,23,2,109.56889,18.27076,1763
576,D4EE8E1A4C04A1FF0596E4221D0B8B42,30854,13,16,3,109.56889,18.27076,1763
577,D4EE8E1A4C04A1FF0596E4221D0B8B42,39111,21,22,1,109.5191,18.22597,1555
578,7803AECF4FFC2BF233E3B7ACD0D2E9F8,39181,0,13,13,109.55153,18.28035,1715
579,7803AECF4FFC2BF233E3B7ACD0D2E9F8,39183,15,16,1,109.55542,18.28208,1715
580,7803AECF4FFC2BF233E3B7ACD0D2E9F8,39181,18,22,4,109.55153,18.28035,1715
598,5A888DC7A3AA300CC584D9862C5384A1,30721,0,7,7,109.51597,18.28257,1565
599,5A888DC7A3AA300CC584D9862C5384A1,39183,9,16,7,109.55542,18.28208,1715
684,1EB913BACF9C05B44A304AC858725E50,30421,19,21,2,109.50021,18.25861,1511
685,1EB913BACF9C05B44A304AC858725E50,30809,21,23,2,109.4891,18.28229,1465
795,3D8ADE80304FD3207128013D43F1118A,31861,0,12,12,109.49042,18.27549,1464
796,3D8ADE80304FD3207128013D43F1118A,30111,14,16,2,109.47583,18.30542,1419
797,3D8ADE80304FD3207128013D43F1118A,60472,17,18,1,109.46625,18.29542,1367
885,33D03C41649B47EDC5176C93FF6F1D8D,60411,0,8,8,109.32514,18.30854,869
886,33D03C41649B47EDC5176C93FF6F1D8D,31471,9,11,2,109.34583,18.29563,917
887,33D03C41649B47EDC5176C93FF6F1D8D,30661,12,14,2,109.37028,18.24361,1008
888,33D03C41649B47EDC5176C93FF6F1D8D,31251,19,20,1,109.18528,18.2975,317
889,33D03C41649B47EDC5176C93FF6F1D8D,31471,22,23,1,109.34583,18.29563,917
903,AECF79630BEEC0EA88FD59B92FCAE378,30854,0,4,4,109.56889,18.27076,1763
904,AECF79630BEEC0EA88FD59B92FCAE378,30891,5,6,1,109.59431,18.28389,1865
909,34C10AAA4D010054D06315D944876FA4,30451,12,15,3,109.1791,18.36229,278
916,36BCA39777B9D1E703C1404CDA6A45E7,30511,0,12,12,109.51069,18.24208,1558
917,36BCA39777B9D1E703C1404CDA6A45E7,30511,12,14,2,109.51069,18.24208,1558
918,36BCA39777B9D1E703C1404CDA6A45E7,30511,16,18,2,109.51069,18.24208,1558
919,36BCA39777B9D1E703C1404CDA6A45E7,60081,21,23,2,109.51097,18.22639,1556
995,8621CFDF1B89A83351494618C53D033F,31071,0,11,11,109.58257,18.28458,1815
996,8621CFDF1B89A83351494618C53D033F,39181,11,14,3,109.55153,18.28035,1715
997,8621CFDF1B89A83351494618C53D033F,39181,16,21,5,109.55153,18.28035,1715
1059,B76381FBDC68F2B2041DDEC63195F0A7,39181,0,3,3,109.55153,18.28035,1715
1060,B76381FBDC68F2B2041DDEC63195F0A7,31931,5,15,10,109.54771,18.29403,1667
1061,B76381FBDC68F2B2041DDEC63195F0A7,39181,17,22,5,109.55153,18.28035,1715
1092,4D190727D19452A2A511EC780EEEE090,31931,0,1,1,109.54771,18.29403,1667
1093,4D190727D19452A2A511EC780EEEE090,30921,1,11,10,109.53903,18.29451,1667
1094,4D190727D19452A2A511EC780EEEE090,31931,11,12,1,109.54771,18.29403,1667
1131,2191B2AD5C915B8862D4C345F0A13CFB,60351,0,1,1,109.58403,18.28958,1816
1132,2191B2AD5C915B8862D4C345F0A13CFB,31071,2,12,10,109.58257,18.28458,1815
1133,2191B2AD5C915B8862D4C345F0A13CFB,60351,15,18,3,109.58403,18.28958,1816
1199,B95895328C22197B47AD92C8267A3C6A,60371,3,5,2,109.53063,18.30056,1618
1200,B95895328C22197B47AD92C8267A3C6A,30921,5,7,2,109.53903,18.29451,1667
1201,B95895328C22197B47AD92C8267A3C6A,60171,11,17,6,109.51292,18.30694,1569
1202,B95895328C22197B47AD92C8267A3C6A,31931,21,23,2,109.54771,18.29403,1667
1207,EB316856896788EC8FD871E122E95728,30931,0,7,7,109.55653,18.32722,1722
1208,EB316856896788EC8FD871E122E95728,31811,9,11,2,109.54201,18.31806,1671
1209,EB316856896788EC8FD871E122E95728,30701,12,13,1,109.59313,18.32007,1871
1210,EB316856896788EC8FD871E122E95728,31811,14,17,3,109.54201,18.31806,1671
1211,EB316856896788EC8FD871E122E95728,30701,18,23,5,109.59313,18.32007,1871
1258,CD3BCBAB8571FB81953C842A434E5DB8,31071,1,5,4,109.58257,18.28458,1815
1259,CD3BCBAB8571FB81953C842A434E5DB8,30854,6,8,2,109.56889,18.27076,1763
1260,CD3BCBAB8571FB81953C842A434E5DB8,31071,13,15,2,109.58257,18.28458,1815
1261,CD3BCBAB8571FB81953C842A434E5DB8,30854,16,17,1,109.56889,18.27076,1763
1262,CD3BCBAB8571FB81953C842A434E5DB8,30771,21,23,2,109.49938,18.26042,1511
1319,42D399F7EB31A1EB2D2AA44B247ACDAA,38331,14,19,5,109.62465,18.22736,1956
1320,42D399F7EB31A1EB2D2AA44B247ACDAA,30421,20,22,2,109.50021,18.25861,1511
1326,38F4BE4A665B515DC81C1A78A906BDC2,60371,0,14,14,109.53063,18.30056,1618
1327,38F4BE4A665B515DC81C1A78A906BDC2,31931,19,21,2,109.54771,18.29403,1667
1390,706B8E0F0F5D1C9FC2F8EBB2574EE89F,30151,0,1,1,109.50986,18.25083,1560
1391,706B8E0F0F5D1C9FC2F8EBB2574EE89F,60201,2,6,4,109.5041,18.2509,1510
1392,706B8E0F0F5D1C9FC2F8EBB2574EE89F,30711,7,15,8,109.50271,18.25347,1510
1393,706B8E0F0F5D1C9FC2F8EBB2574EE89F,30711,18,23,5,109.50271,18.25347,1510
1398,D8898064D7FB8C9B8CE800B6EE2F87B6,30854,12,13,1,109.56889,18.27076,1763
1399,D8898064D7FB8C9B8CE800B6EE2F87B6,31071,14,15,1,109.58257,18.28458,1815
1400,D8898064D7FB8C9B8CE800B6EE2F87B6,30951,19,20,1,109.56208,18.25667,1761
1401,C8A5539982743C3D86E28F8FF2DA3472,30951,0,7,7,109.56208,18.25667,1761
1402,C8A5539982743C3D86E28F8FF2DA3472,31421,7,9,2,109.55382,18.22347,1705
1403,C8A5539982743C3D86E28F8FF2DA3472,30951,10,15,5,109.56208,18.25667,1761
1404,C8A5539982743C3D86E28F8FF2DA3472,31421,18,22,4,109.55382,18.22347,1705
1419,EBD16061EA20EE33D9344D33735E5205,38891,0,7,7,109.51486,18.24118,1558
1420,EBD16061EA20EE33D9344D33735E5205,31441,7,10,3,109.51181,18.24424,1559
1421,EBD16061EA20EE33D9344D33735E5205,38153,10,12,2,109.51819,18.25736,1561
1422,EBD16061EA20EE33D9344D33735E5205,38291,15,17,2,109.51618,18.24313,1558
1423,EBD16061EA20EE33D9344D33735E5205,38891,21,22,1,109.51486,18.24118,1558
1443,DFD0F9616A7053955CDD5FA57FDB4A55,30291,0,7,7,109.50403,18.27028,1513
1444,DFD0F9616A7053955CDD5FA57FDB4A55,31931,8,11,3,109.54771,18.29403,1667
1445,DFD0F9616A7053955CDD5FA57FDB4A55,30271,14,15,1,109.49132,18.23153,1456
1446,DFD0F9616A7053955CDD5FA57FDB4A55,30291,19,23,4,109.50403,18.27028,1513
1477,ADAB51A6D99BADC8222FC392D72ADA01,60281,0,15,15,109.51743,18.25924,1561
1478,ADAB51A6D99BADC8222FC392D72ADA01,30251,16,19,3,109.50611,18.26653,1512
1479,ADAB51A6D99BADC8222FC392D72ADA01,60281,19,23,4,109.51743,18.25924,1561
1482,2F440A235E684ECEDD042B3100A4AE95,31071,0,7,7,109.58257,18.28458,1815
1483,2F440A235E684ECEDD042B3100A4AE95,30854,7,18,11,109.56889,18.27076,1763
1484,2F440A235E684ECEDD042B3100A4AE95,31071,18,23,5,109.58257,18.28458,1815
1506,B4323D9C4164A7FE0A6F3CFD303FFF9A,31821,8,9,1,109.51181,18.24924,1559
1507,B4323D9C4164A7FE0A6F3CFD303FFF9A,30854,12,15,3,109.56889,18.27076,1763
1508,B4323D9C4164A7FE0A6F3CFD303FFF9A,60281,16,23,7,109.51743,18.25924,1561
1512,5EBEA276FCB4A19AC5C987F5C7CC8908,38361,0,6,6,109.43667,18.29201,1267
1513,5EBEA276FCB4A19AC5C987F5C7CC8908,60504,8,9,1,109.47917,18.28903,1416
1523,A1E318C80BE4457762B208DEDA1DAC8C,30151,0,3,3,109.50986,18.25083,1560
1524,A1E318C80BE4457762B208DEDA1DAC8C,60281,7,23,16,109.51743,18.25924,1561
1549,45086BC0869D90A8E8F669EDA6561CFA,31071,0,12,12,109.58257,18.28458,1815
1550,45086BC0869D90A8E8F669EDA6561CFA,31945,13,14,1,109.58021,18.29403,1817
1551,45086BC0869D90A8E8F669EDA6561CFA,39151,19,20,1,109.49875,18.25097,1510
1555,DB4DF566D4757FF3BB488F82DE126248,31561,6,21,15,109.56792,18.28479,1765
1556,DB4DF566D4757FF3BB488F82DE126248,30851,22,23,1,109.5616,18.27396,1713
1588,0312B43ACF9ED1D8304E325E851AEE29,31561,10,11,1,109.56792,18.28479,1765
1589,0312B43ACF9ED1D8304E325E851AEE29,30851,12,14,2,109.5616,18.27396,1713
1590,0312B43ACF9ED1D8304E325E851AEE29,31561,15,17,2,109.56792,18.28479,1765
1591,0312B43ACF9ED1D8304E325E851AEE29,30851,17,18,1,109.5616,18.27396,1713
1592,0312B43ACF9ED1D8304E325E851AEE29,31561,19,20,1,109.56792,18.28479,1765
1602,B55959B64746A18ECF5077B5F7359221,31561,0,13,13,109.56792,18.28479,1765
1603,B55959B64746A18ECF5077B5F7359221,39183,15,16,1,109.55542,18.28208,1715
1604,B55959B64746A18ECF5077B5F7359221,31561,19,23,4,109.56792,18.28479,1765
1676,7B2CDE963911F93596D04C9325284620,38154,0,5,5,109.5266,18.28278,1615
1677,7B2CDE963911F93596D04C9325284620,60221,5,8,3,109.52569,18.29188,1616
1678,7B2CDE963911F93596D04C9325284620,38154,9,11,2,109.5266,18.28278,1615
1679,7B2CDE963911F93596D04C9325284620,31811,14,17,3,109.54201,18.31806,1671
1710,1A0300554B3838A02F1EC14AF8F37391,31945,0,7,7,109.58021,18.29403,1817
1711,1A0300554B3838A02F1EC14AF8F37391,30581,9,10,1,109.62257,18.24951,1959
1712,1A0300554B3838A02F1EC14AF8F37391,31221,11,12,1,109.61333,18.26833,1913
1713,1A0300554B3838A02F1EC14AF8F37391,30581,13,15,2,109.62257,18.24951,1959
1714,1A0300554B3838A02F1EC14AF8F37391,30854,16,20,4,109.56889,18.27076,1763
1754,41D4EB5552A7A416EEB26FAA30F55A4B,39183,0,15,15,109.55542,18.28208,1715
1755,41D4EB5552A7A416EEB26FAA30F55A4B,39181,18,20,2,109.55153,18.28035,1715
1756,41D4EB5552A7A416EEB26FAA30F55A4B,39183,21,23,2,109.55542,18.28208,1715
1801,0C8D15C0488D521680F0DE3A28CFE111,31811,0,11,11,109.54201,18.31806,1671
1802,0C8D15C0488D521680F0DE3A28CFE111,30701,11,18,7,109.59313,18.32007,1871
1834,64F4CDF664AA04E7B79DE93C57128CF6,39183,8,10,2,109.55542,18.28208,1715
1835,64F4CDF664AA04E7B79DE93C57128CF6,39181,11,12,1,109.55153,18.28035,1715
1836,64F4CDF664AA04E7B79DE93C57128CF6,39181,14,18,4,109.55153,18.28035,1715
1837,64F4CDF664AA04E7B79DE93C57128CF6,31931,19,20,1,109.54771,18.29403,1667
1874,DE5024DB59D5BF6AE5857A85EB7680EA,31071,0,7,7,109.58257,18.28458,1815
1875,DE5024DB59D5BF6AE5857A85EB7680EA,30854,11,22,11,109.56889,18.27076,1763
1882,5ACB2494699EB2F10AA3427B417842C4,60614,10,11,1,109.48799,18.29521,1467
1883,5ACB2494699EB2F10AA3427B417842C4,39151,15,16,1,109.49875,18.25097,1510
1901,40E7F0D633192F9BEA9F194F24931F67,30854,0,2,2,109.56889,18.27076,1763
1902,40E7F0D633192F9BEA9F194F24931F67,31071,2,9,7,109.58257,18.28458,1815
1903,40E7F0D633192F9BEA9F194F24931F67,30854,11,12,1,109.56889,18.27076,1763
1904,40E7F0D633192F9BEA9F194F24931F67,38111,13,19,6,109.52007,18.22403,1555
1905,40E7F0D633192F9BEA9F194F24931F67,38111,19,23,4,109.52007,18.22403,1555
1906,5BC4B4AAE031D7EDA11762088F9D6C7A,31271,18,20,2,109.48958,18.26257,1462
1907,5BC4B4AAE031D7EDA11762088F9D6C7A,31271,21,23,2,109.48958,18.26257,1462
2009,FACE88BC4E42BD847E718B0C0EE3CB9B,30251,0,8,8,109.50611,18.26653,1512
2010,FACE88BC4E42BD847E718B0C0EE3CB9B,38185,9,23,14,109.51333,18.27347,1563
2058,D59A2A795558AA457F13EDE8D62837D5,31821,0,9,9,109.51181,18.24924,1559
2083,4824E5A5A5B573D071F1BB5C48030BEE,30181,0,12,12,109.51597,18.23313,1557
2084,4824E5A5A5B573D071F1BB5C48030BEE,31521,14,15,1,109.51458,18.22542,1555
2085,4824E5A5A5B573D071F1BB5C48030BEE,31521,16,18,2,109.51458,18.22542,1555
2090,F0F944706382F0443615560FA328E069,38754,12,14,2,109.74667,18.37382,2430
2091,F0F944706382F0443615560FA328E069,30341,19,21,2,109.3625,18.29167,966
2101,249541951E1FA75CAD2B8C3DC95305E9,31181,0,11,11,109.50382,18.24813,1509
2102,249541951E1FA75CAD2B8C3DC95305E9,60011,14,16,2,109.48965,18.30222,1468
2103,249541951E1FA75CAD2B8C3DC95305E9,31031,18,19,1,109.49979,18.25382,1510
2104,249541951E1FA75CAD2B8C3DC95305E9,31181,19,23,4,109.50382,18.24813,1509
2147,6587551DA47309E484D1302521C8D417,30854,10,12,2,109.56889,18.27076,1763
2148,6587551DA47309E484D1302521C8D417,30361,15,17,2,109.50347,18.24,1508
2185,3977578BE56276DA0700B04B81DC1356,30851,0,11,11,109.5616,18.27396,1713
2186,3977578BE56276DA0700B04B81DC1356,31561,11,23,12,109.56792,18.28479,1765
2211,57B6DD4E285A51425E04EA17431CFA29,30211,0,8,8,109.49882,18.23931,1508
2212,57B6DD4E285A51425E04EA17431CFA29,31145,10,13,3,109.20431,18.30479,369
2213,57B6DD4E285A51425E04EA17431CFA29,38754,14,19,5,109.74667,18.37382,2430
2248,44A75810FF8F9221047E9675BDBF60A2,31561,0,15,15,109.56792,18.28479,1765
2249,44A75810FF8F9221047E9675BDBF60A2,30854,15,23,8,109.56889,18.27076,1763
2351,C709D01469E0800AF998DFAF42105CDC,31561,6,8,2,109.56792,18.28479,1765
2352,C709D01469E0800AF998DFAF42105CDC,30851,8,10,2,109.5616,18.27396,1713
2353,C709D01469E0800AF998DFAF42105CDC,31561,13,16,3,109.56792,18.28479,1765
2354,C709D01469E0800AF998DFAF42105CDC,30854,19,21,2,109.56889,18.27076,1763
2382,451E2BF48CD7B253EB0892324E679BCC,38291,1,3,2,109.51618,18.24313,1558
2383,451E2BF48CD7B253EB0892324E679BCC,60281,7,10,3,109.51743,18.25924,1561
2384,451E2BF48CD7B253EB0892324E679BCC,38297,11,12,1,109.52576,18.24965,1609
2385,451E2BF48CD7B253EB0892324E679BCC,60281,14,17,3,109.51743,18.25924,1561
2386,451E2BF48CD7B253EB0892324E679BCC,38291,18,22,4,109.51618,18.24313,1558
2387,173CD7A2B7B334BC53A50A1D248FBCFE,31071,0,6,6,109.58257,18.28458,1815
2388,173CD7A2B7B334BC53A50A1D248FBCFE,30854,8,11,3,109.56889,18.27076,1763
2389,173CD7A2B7B334BC53A50A1D248FBCFE,31071,11,13,2,109.58257,18.28458,1815
2390,173CD7A2B7B334BC53A50A1D248FBCFE,30854,15,16,1,109.56889,18.27076,1763
2394,4DB778A581941E2A7955D8DA3B7ADAFE,38185,0,6,6,109.51333,18.27347,1563
2395,4DB778A581941E2A7955D8DA3B7ADAFE,31931,7,9,2,109.54771,18.29403,1667
2396,4DB778A581941E2A7955D8DA3B7ADAFE,60121,10,12,2,109.74507,18.37472,2430
2397,4DB778A581941E2A7955D8DA3B7ADAFE,60114,13,15,2,109.73028,18.33847,2374
2398,4DB778A581941E2A7955D8DA3B7ADAFE,30921,19,20,1,109.53903,18.29451,1667
2405,8A0382A2385C362EFE2664E8795F133E,39183,15,17,2,109.55542,18.28208,1715
2406,8A0382A2385C362EFE2664E8795F133E,31561,21,23,2,109.56792,18.28479,1765
2407,8E6B76C12940F9EC43BDEAF6EF9A8328,31061,0,1,1,109.53333,18.23257,1607
2408,8E6B76C12940F9EC43BDEAF6EF9A8328,31421,4,6,2,109.55382,18.22347,1705
2409,8E6B76C12940F9EC43BDEAF6EF9A8328,31061,6,9,3,109.53333,18.23257,1607
2410,8E6B76C12940F9EC43BDEAF6EF9A8328,31101,13,14,1,109.65389,18.23403,2057
2411,8E6B76C12940F9EC43BDEAF6EF9A8328,30361,19,21,2,109.50347,18.24,1508
2435,93715618B304E009FF2F157425BB5843,30771,19,21,2,109.49938,18.26042,1511
2436,93715618B304E009FF2F157425BB5843,60504,21,23,2,109.47917,18.28903,1416
2472,DDE77D3A656666992FC3458B84010D43,39183,0,14,14,109.55542,18.28208,1715
2473,DDE77D3A656666992FC3458B84010D43,31561,15,17,2,109.56792,18.28479,1765
2479,07FD145FE6C81328C98C6C5C8452E794,30854,0,9,9,109.56889,18.27076,1763
2480,07FD145FE6C81328C98C6C5C8452E794,30232,9,17,8,109.6191,18.31701,1971
2481,07FD145FE6C81328C98C6C5C8452E794,30854,18,23,5,109.56889,18.27076,1763
2572,283001ED673D8EDBEF7EEB00BDB31533,30571,1,3,2,109.50243,18.21861,1504
2573,283001ED673D8EDBEF7EEB00BDB31533,38017,3,4,1,109.49729,18.21424,1504
2574,283001ED673D8EDBEF7EEB00BDB31533,31181,9,16,7,109.50382,18.24813,1509
2575,283001ED673D8EDBEF7EEB00BDB31533,60131,17,18,1,109.49819,18.24778,1509
2621,9743FAD06BC4515BFDF8E186D0A37E74,38951,11,17,6,109.48097,18.28868,1416
2622,9743FAD06BC4515BFDF8E186D0A37E74,31351,19,23,4,109.4959,18.28417,1465
2710,A96BFAAC9CC1774B195362BA60EA846D,31071,0,8,8,109.58257,18.28458,1815
2711,A96BFAAC9CC1774B195362BA60EA846D,30854,10,19,9,109.56889,18.27076,1763
2715,40C57F24FE0409ABB752B2031C349577,38951,0,7,7,109.48097,18.28868,1416
2716,40C57F24FE0409ABB752B2031C349577,60041,8,16,8,109.39889,18.31944,1121
2717,40C57F24FE0409ABB752B2031C349577,38951,17,22,5,109.48097,18.28868,1416
2738,B494C063E7230AFA1BB1CFB38DCE979E,60054,1,4,3,109.3016,18.31229,770
2739,B494C063E7230AFA1BB1CFB38DCE979E,30661,4,9,5,109.37028,18.24361,1008
2740,B494C063E7230AFA1BB1CFB38DCE979E,60411,13,15,2,109.32514,18.30854,869
2741,B494C063E7230AFA1BB1CFB38DCE979E,30661,16,18,2,109.37028,18.24361,1008
2742,B494C063E7230AFA1BB1CFB38DCE979E,60411,21,23,2,109.32514,18.30854,869
2788,1FE2866848043A2C10AD87212485FE15,31071,3,6,3,109.58257,18.28458,1815
2789,1FE2866848043A2C10AD87212485FE15,30854,7,21,14,109.56889,18.27076,1763
2800,82591CF1D9AFC5ADCA95A1BAF87D07E3,31161,14,16,2,109.70229,18.31361,2270
2846,CD576F1C1CDFB89E6A99A20E65927346,31071,0,2,2,109.58257,18.28458,1815
2847,CD576F1C1CDFB89E6A99A20E65927346,30854,6,21,15,109.56889,18.27076,1763
2867,412879740E648AE1B2C1A60DD3B08C37,30111,5,8,3,109.47583,18.30542,1419
2868,412879740E648AE1B2C1A60DD3B08C37,60501,12,14,2,109.48701,18.29021,1466
2869,412879740E648AE1B2C1A60DD3B08C37,60221,16,17,1,109.52569,18.29188,1616
2870,412879740E648AE1B2C1A60DD3B08C37,30201,20,21,1,109.4909,18.26465,1462
2871,412879740E648AE1B2C1A60DD3B08C37,30111,22,23,1,109.47583,18.30542,1419
2893,63FBAC0202144B00077561285E6A7F87,30821,3,14,11,109.43681,18.33639,1274
2894,63FBAC0202144B00077561285E6A7F87,30651,16,17,1,109.42611,18.385,1232
2895,63FBAC0202144B00077561285E6A7F87,30821,21,23,2,109.43681,18.33639,1274
2901,070984703178D21DC5287E457C03691A,39181,0,6,6,109.55153,18.28035,1715
2902,070984703178D21DC5287E457C03691A,39181,10,16,6,109.55153,18.28035,1715
2903,070984703178D21DC5287E457C03691A,31561,18,19,1,109.56792,18.28479,1765
2904,070984703178D21DC5287E457C03691A,39181,20,22,2,109.55153,18.28035,1715
2909,79AB721DDB2EAA1CD0308535004E6A67,31071,0,8,8,109.58257,18.28458,1815
2910,79AB721DDB2EAA1CD0308535004E6A67,30854,8,10,2,109.56889,18.27076,1763
2911,79AB721DDB2EAA1CD0308535004E6A67,31071,12,13,1,109.58257,18.28458,1815
2912,79AB721DDB2EAA1CD0308535004E6A67,30854,14,16,2,109.56889,18.27076,1763
2913,79AB721DDB2EAA1CD0308535004E6A67,31071,20,23,3,109.58257,18.28458,1815
2945,3397CDF1AF021D9811232E8E7A104352,31521,0,9,9,109.51458,18.22542,1555
2946,3397CDF1AF021D9811232E8E7A104352,31781,12,14,2,109.19847,18.2975,367
2947,3397CDF1AF021D9811232E8E7A104352,39081,14,15,1,109.19382,18.29111,366
2948,3397CDF1AF021D9811232E8E7A104352,30361,17,21,4,109.50347,18.24,1508
2949,3397CDF1AF021D9811232E8E7A104352,31521,21,23,2,109.51458,18.22542,1555
3009,B26DD5C650BE7CEA4DB62E608BAE05C3,30361,19,20,1,109.50347,18.24,1508
3010,B26DD5C650BE7CEA4DB62E608BAE05C3,30931,21,23,2,109.55653,18.32722,1722
3011,B9591D667BD29C99F03D89422A405684,60084,0,1,1,109.4984,18.2334,1507
3012,B9591D667BD29C99F03D89422A405684,60161,2,8,6,109.49174,18.26181,1461
3013,B9591D667BD29C99F03D89422A405684,60401,9,10,1,109.47444,18.27583,1414
3014,B9591D667BD29C99F03D89422A405684,38484,18,20,2,109.53028,18.31528,1620
3015,B9591D667BD29C99F03D89422A405684,60281,21,23,2,109.51743,18.25924,1561
3033,E46795A590C643FCDE6B993B35621D2F,31931,0,14,14,109.54771,18.29403,1667
3034,E46795A590C643FCDE6B993B35621D2F,30921,17,18,1,109.53903,18.29451,1667
3035,B78E7295CB13532B4E2C30EF158E297F,31931,1,8,7,109.54771,18.29403,1667
3036,B78E7295CB13532B4E2C30EF158E297F,39183,10,16,6,109.55542,18.28208,1715
3037,B78E7295CB13532B4E2C30EF158E297F,30854,21,22,1,109.56889,18.27076,1763
3047,066E3B290AAC556F650E56DD0F693AB2,60401,1,2,1,109.47444,18.27583,1414
3048,066E3B290AAC556F650E56DD0F693AB2,38251,5,6,1,109.49618,18.25493,1510
3049,066E3B290AAC556F650E56DD0F693AB2,33481,10,15,5,109.67278,18.41278,2187
3059,F47C4E1E39056C43B0AD32AC994AB7C0,31931,0,8,8,109.54771,18.29403,1667
3060,F47C4E1E39056C43B0AD32AC994AB7C0,60361,12,16,4,109.51938,18.29681,1567
3061,F47C4E1E39056C43B0AD32AC994AB7C0,31931,18,21,3,109.54771,18.29403,1667
3099,4DD578E2E3AB8705D8DDD716449001B9,30921,10,12,2,109.53903,18.29451,1667
3100,4DD578E2E3AB8705D8DDD716449001B9,31931,15,16,1,109.54771,18.29403,1667
3101,4DD578E2E3AB8705D8DDD716449001B9,60361,19,22,3,109.51938,18.29681,1567
3182,5535A1723CC527F3594ACA1502453D67,31471,13,15,2,109.34583,18.29563,917
3183,5535A1723CC527F3594ACA1502453D67,30354,18,23,5,109.42813,18.29076,1216
3220,42158B50A96F4BB50162AD5AAF8D7E2D,31201,0,8,8,109.51042,18.23819,1558
3221,42158B50A96F4BB50162AD5AAF8D7E2D,30741,12,13,1,109.49833,18.28681,1516
3222,42158B50A96F4BB50162AD5AAF8D7E2D,31181,17,21,4,109.50382,18.24813,1509
3223,42158B50A96F4BB50162AD5AAF8D7E2D,38911,21,23,2,109.51674,18.24965,1559
3248,70A62761FE79F922D082380DA7747243,30854,4,16,12,109.56889,18.27076,1763
3249,70A62761FE79F922D082380DA7747243,30861,18,22,4,109.52722,18.22743,1606
3256,E1108DE9382EA6DD2052A0875C7E83C6,31161,12,13,1,109.70229,18.31361,2270
3257,E1108DE9382EA6DD2052A0875C7E83C6,60111,14,19,5,109.72556,18.31924,2371
3258,E1108DE9382EA6DD2052A0875C7E83C6,31861,21,23,2,109.49042,18.27549,1464
3266,560794A44CA17A43FA34D0FA6C339747,30854,0,15,15,109.56889,18.27076,1763
3267,560794A44CA17A43FA34D0FA6C339747,31071,17,18,1,109.58257,18.28458,1815
3268,560794A44CA17A43FA34D0FA6C339747,30854,20,23,3,109.56889,18.27076,1763
3288,608A55C14BAB2A5B627ACC1F39B89FB6,31945,0,7,7,109.58021,18.29403,1817
3289,608A55C14BAB2A5B627ACC1F39B89FB6,30854,8,20,12,109.56889,18.27076,1763
3290,608A55C14BAB2A5B627ACC1F39B89FB6,31945,20,23,3,109.58021,18.29403,1817
3332,362A5B9B34971851814BD592D30A5666,30854,4,13,9,109.56889,18.27076,1763
3333,362A5B9B34971851814BD592D30A5666,38241,15,16,1,109.54111,18.30542,1669
3380,10EBF762D28520B09848288F7052CFDE,30854,0,6,6,109.56889,18.27076,1763
3381,10EBF762D28520B09848288F7052CFDE,39101,8,18,10,109.50132,18.24931,1509
3382,10EBF762D28520B09848288F7052CFDE,30854,19,21,2,109.56889,18.27076,1763
3394,6E6193514D8E876D83956A94AD4F3FB1,31931,0,6,6,109.54771,18.29403,1667
3395,6E6193514D8E876D83956A94AD4F3FB1,31951,9,10,1,109.52174,18.30299,1568
3396,6E6193514D8E876D83956A94AD4F3FB1,31931,11,13,2,109.54771,18.29403,1667
3397,6E6193514D8E876D83956A94AD4F3FB1,30071,14,15,1,109.52819,18.30472,1619
3516,5EE8D9F14A8252BCCE8FF36AFB4B75F8,31521,13,14,1,109.51458,18.22542,1555
3517,5EE8D9F14A8252BCCE8FF36AFB4B75F8,30731,15,18,3,109.50944,18.22306,1555
3518,5EE8D9F14A8252BCCE8FF36AFB4B75F8,31521,18,22,4,109.51458,18.22542,1555
3532,E605B26D53F08A0D3360A4541E09F4E2,38283,0,14,14,109.62229,18.22618,1956
3533,E605B26D53F08A0D3360A4541E09F4E2,38283,17,18,1,109.62229,18.22618,1956
3534,E605B26D53F08A0D3360A4541E09F4E2,38283,20,23,3,109.62229,18.22618,1956
3535,6DF7485545B790F22810B0EDD8F1B356,31945,0,14,14,109.58021,18.29403,1817
3536,6DF7485545B790F22810B0EDD8F1B356,30854,15,16,1,109.56889,18.27076,1763
3567,0641FC44BB6634907F408B361FAAE705,30721,11,19,8,109.51597,18.28257,1565
3568,0641FC44BB6634907F408B361FAAE705,60221,21,22,1,109.52569,18.29188,1616
3574,6D02659C8AB6FF777A098A468ACF74DA,39091,16,19,3,109.50097,18.25222,1510
3575,6D02659C8AB6FF777A098A468ACF74DA,38102,21,23,2,109.40875,18.29111,1166
3631,0F558B6653C655C7F0BAEA9D66B33F57,31071,3,8,5,109.58257,18.28458,1815
3632,0F558B6653C655C7F0BAEA9D66B33F57,30854,9,10,1,109.56889,18.27076,1763
3635,1026894DC5FF9A7FAF3A2EE28B95E239,30891,0,8,8,109.59431,18.28389,1865
3636,1026894DC5FF9A7FAF3A2EE28B95E239,30854,12,22,10,109.56889,18.27076,1763
3662,7421066246AAD1C230E7E2A7ADF06E9D,60631,0,7,7,109.57778,18.27583,1814
3663,7421066246AAD1C230E7E2A7ADF06E9D,30854,7,17,10,109.56889,18.27076,1763
3664,7421066246AAD1C230E7E2A7ADF06E9D,31461,19,22,3,109.5091,18.25389,1510
3695,A01B4012B619D942E7CC3AC9B78722B4,30854,0,2,2,109.56889,18.27076,1763
3696,A01B4012B619D942E7CC3AC9B78722B4,31561,5,10,5,109.56792,18.28479,1765
3697,A01B4012B619D942E7CC3AC9B78722B4,39183,14,16,2,109.55542,18.28208,1715
3698,A01B4012B619D942E7CC3AC9B78722B4,31561,16,22,6,109.56792,18.28479,1765
3699,C153552CEA2677B0FF473AE565EA979E,30821,0,14,14,109.43681,18.33639,1274
3700,C153552CEA2677B0FF473AE565EA979E,30651,18,19,1,109.42611,18.385,1232
3721,417408FFDA93B177641D270D3A5C4B2D,31071,0,5,5,109.58257,18.28458,1815
3722,417408FFDA93B177641D270D3A5C4B2D,30854,6,13,7,109.56889,18.27076,1763
3723,417408FFDA93B177641D270D3A5C4B2D,60631,15,16,1,109.57778,18.27583,1814
3724,417408FFDA93B177641D270D3A5C4B2D,31071,19,23,4,109.58257,18.28458,1815
3842,6ABCA112AF80119A11E9BA7816F26F03,60381,0,8,8,109.5241,18.22458,1605
3851,99EAB49EE8968B052E448932BFC0D516,38052,0,11,11,109.62618,18.23042,1956
3852,99EAB49EE8968B052E448932BFC0D516,60594,12,15,3,109.62694,18.22799,1956
3853,99EAB49EE8968B052E448932BFC0D516,38052,15,16,1,109.62618,18.23042,1956
3854,99EAB49EE8968B052E448932BFC0D516,38052,19,20,1,109.62618,18.23042,1956
3888,D2A5F87218CF25385163A2F3C4229CB8,31561,0,5,5,109.56792,18.28479,1765
3889,D2A5F87218CF25385163A2F3C4229CB8,30851,5,9,4,109.5616,18.27396,1713
3890,D2A5F87218CF25385163A2F3C4229CB8,31561,10,20,10,109.56792,18.28479,1765
3913,8DD23AA43C0F7967C45F7488D66F9159,31945,0,2,2,109.58021,18.29403,1817
3914,8DD23AA43C0F7967C45F7488D66F9159,30854,2,4,2,109.56889,18.27076,1763
3915,8DD23AA43C0F7967C45F7488D66F9159,31945,6,7,1,109.58021,18.29403,1817
3916,8DD23AA43C0F7967C45F7488D66F9159,60631,10,11,1,109.57778,18.27583,1814
3917,8DD23AA43C0F7967C45F7488D66F9159,31945,13,14,1,109.58021,18.29403,1817
3926,BD4652414D5C17466BA36FD4BD943A94,30721,1,6,5,109.51597,18.28257,1565
3927,BD4652414D5C17466BA36FD4BD943A94,39183,11,12,1,109.55542,18.28208,1715
3928,BD4652414D5C17466BA36FD4BD943A94,31931,13,16,3,109.54771,18.29403,1667
3929,BD4652414D5C17466BA36FD4BD943A94,38291,20,21,1,109.51618,18.24313,1558
3973,598A5BC9BEA86E74379689160E91B24E,30854,0,12,12,109.56889,18.27076,1763
3974,598A5BC9BEA86E74379689160E91B24E,31071,15,16,1,109.58257,18.28458,1815
3975,598A5BC9BEA86E74379689160E91B24E,30854,18,19,1,109.56889,18.27076,1763
4004,4B0AADB3989E3C45AA834D87FDC75667,31181,0,11,11,109.50382,18.24813,1509
4005,4B0AADB3989E3C45AA834D87FDC75667,60011,14,15,1,109.48965,18.30222,1468
4006,4B0AADB3989E3C45AA834D87FDC75667,31031,18,19,1,109.49979,18.25382,1510
4007,4B0AADB3989E3C45AA834D87FDC75667,39101,20,23,3,109.50132,18.24931,1509
4025,8A01C766ABD659C6DF7A6AE90AA81678,60291,0,8,8,109.50826,18.24639,1509
4026,8A01C766ABD659C6DF7A6AE90AA81678,31521,9,23,14,109.51458,18.22542,1555
4066,CDA1EB7B89E47C48A7CAC823B0773234,31701,15,16,1,109.44132,18.28833,1266
4067,CDA1EB7B89E47C48A7CAC823B0773234,30831,18,19,1,109.69813,18.32076,2271
4096,B37777551ADDE84A1FDFE1FF465C24DC,31931,0,15,15,109.54771,18.29403,1667
4097,B37777551ADDE84A1FDFE1FF465C24DC,30921,15,20,5,109.53903,18.29451,1667
4145,FBDACEF8C95F9F2B8E3E865976CD03F5,31561,2,14,12,109.56792,18.28479,1765
4146,FBDACEF8C95F9F2B8E3E865976CD03F5,30854,17,18,1,109.56889,18.27076,1763
4207,2A6BA0678DDF16AF08BAC9E3FA3C9391,31561,0,8,8,109.56792,18.28479,1765
4208,2A6BA0678DDF16AF08BAC9E3FA3C9391,30854,9,12,3,109.56889,18.27076,1763
4209,2A6BA0678DDF16AF08BAC9E3FA3C9391,31561,13,14,1,109.56792,18.28479,1765
4210,2A6BA0678DDF16AF08BAC9E3FA3C9391,30854,15,19,4,109.56889,18.27076,1763
4227,928DF0385E8541CFD2F5858501C04155,30234,0,7,7,109.60681,18.29979,1918
4228,928DF0385E8541CFD2F5858501C04155,30854,7,23,16,109.56889,18.27076,1763
4272,75817DB682187A07461734D66E1E6492,31061,0,1,1,109.53333,18.23257,1607
4273,75817DB682187A07461734D66E1E6492,30854,2,16,14,109.56889,18.27076,1763
4274,75817DB682187A07461734D66E1E6492,60631,18,23,5,109.57778,18.27583,1814
4282,E5B7DF0BD5F9C6028960F1174FAA2027,60084,0,11,11,109.4984,18.2334,1507
4283,E5B7DF0BD5F9C6028960F1174FAA2027,38754,14,15,1,109.74667,18.37382,2430
4284,E5B7DF0BD5F9C6028960F1174FAA2027,30161,18,19,1,109.50042,18.24389,1508
4285,E5B7DF0BD5F9C6028960F1174FAA2027,30271,20,21,1,109.49132,18.23153,1456
4302,1952B2BB316D2BB82BFA729C9CE4CADA,31431,0,5,5,109.44639,18.29042,1316
4303,1952B2BB316D2BB82BFA729C9CE4CADA,31431,7,17,10,109.44639,18.29042,1316
4304,1952B2BB316D2BB82BFA729C9CE4CADA,30201,20,21,1,109.4909,18.26465,1462
4307,005F3AEFE6DBF371ED1FD57736434098,30854,14,17,3,109.56889,18.27076,1763
4308,005F3AEFE6DBF371ED1FD57736434098,31461,19,22,3,109.5091,18.25389,1510
4330,94976FAA0C4E2BB13E4130A03A47F4ED,60631,3,9,6,109.57778,18.27583,1814
4331,94976FAA0C4E2BB13E4130A03A47F4ED,30854,9,22,13,109.56889,18.27076,1763
4337,D4EDFC03E7ED63DAAF98D926C98FC74F,38754,13,14,1,109.74667,18.37382,2430
4338,D4EDFC03E7ED63DAAF98D926C98FC74F,30511,16,17,1,109.51069,18.24208,1558
4339,EC70F9D6B8EC4124E51EFCFD87BAFA84,38361,2,3,1,109.43667,18.29201,1267
4340,EC70F9D6B8EC4124E51EFCFD87BAFA84,31671,4,6,2,109.38965,18.29813,1068
4341,EC70F9D6B8EC4124E51EFCFD87BAFA84,38027,7,9,2,109.38833,18.2909,1066
4342,EC70F9D6B8EC4124E51EFCFD87BAFA84,38027,14,19,5,109.38833,18.2909,1066
4343,EC70F9D6B8EC4124E51EFCFD87BAFA84,38141,19,20,1,109.39479,18.2916,1116
4344,EC70F9D6B8EC4124E51EFCFD87BAFA84,38903,21,23,2,109.39229,18.29243,1117
4345,8D8AA41210FC9E2D5DD4D81CF4DB18D7,38991,0,7,7,109.52681,18.30368,1618
4346,8D8AA41210FC9E2D5DD4D81CF4DB18D7,39151,8,10,2,109.49875,18.25097,1510
4347,8D8AA41210FC9E2D5DD4D81CF4DB18D7,30271,11,12,1,109.49132,18.23153,1456
4348,8D8AA41210FC9E2D5DD4D81CF4DB18D7,30084,12,15,3,109.50118,18.26972,1513
4349,8D8AA41210FC9E2D5DD4D81CF4DB18D7,31521,19,20,1,109.51458,18.22542,1555
4350,8D8AA41210FC9E2D5DD4D81CF4DB18D7,38991,22,23,1,109.52681,18.30368,1618
4372,ABCD0851CC1C78BCD7AF6DBDF2F5DE49,60524,0,5,5,109.42951,18.28993,1216
4373,ABCD0851CC1C78BCD7AF6DBDF2F5DE49,60552,7,11,4,109.41729,18.30014,1218
4374,ABCD0851CC1C78BCD7AF6DBDF2F5DE49,60524,11,12,1,109.42951,18.28993,1216
4375,ABCD0851CC1C78BCD7AF6DBDF2F5DE49,60401,14,16,2,109.47444,18.27583,1414
4387,5E97A4561E11AAC4FBC53FD068EAA52B,30854,1,6,5,109.56889,18.27076,1763
4388,5E97A4561E11AAC4FBC53FD068EAA52B,30531,9,18,9,109.53271,18.21472,1604
4389,5E97A4561E11AAC4FBC53FD068EAA52B,30854,21,23,2,109.56889,18.27076,1763
4390,85E9F50B5ABCB1024F25DC89F0D41C6E,60201,0,2,2,109.5041,18.2509,1510
4391,85E9F50B5ABCB1024F25DC89F0D41C6E,60281,3,7,4,109.51743,18.25924,1561
4392,85E9F50B5ABCB1024F25DC89F0D41C6E,31041,7,9,2,109.50278,18.23701,1507
4393,85E9F50B5ABCB1024F25DC89F0D41C6E,31261,12,15,3,109.51174,18.2466,1559
4394,85E9F50B5ABCB1024F25DC89F0D41C6E,60281,19,23,4,109.51743,18.25924,1561
4409,E6541B4F346982101D887BAAF0315541,31931,0,6,6,109.54771,18.29403,1667
4410,E6541B4F346982101D887BAAF0315541,30854,6,13,7,109.56889,18.27076,1763
4411,E6541B4F346982101D887BAAF0315541,30851,15,16,1,109.5616,18.27396,1713
4412,E6541B4F346982101D887BAAF0315541,30854,18,23,5,109.56889,18.27076,1763
4465,B643AC77F8D8498A9694D45BA8B0F75F,60631,0,16,16,109.57778,18.27583,1814
4466,B643AC77F8D8498A9694D45BA8B0F75F,30851,17,18,1,109.5616,18.27396,1713
4467,B643AC77F8D8498A9694D45BA8B0F75F,31561,19,21,2,109.56792,18.28479,1765
4567,6F25B46DE233F84CBE88187DB2427FA9,30201,0,6,6,109.4909,18.26465,1462
4568,6F25B46DE233F84CBE88187DB2427FA9,30201,8,9,1,109.4909,18.26465,1462
4569,6F25B46DE233F84CBE88187DB2427FA9,31021,10,12,2,109.49021,18.27,1463
4570,6F25B46DE233F84CBE88187DB2427FA9,30201,12,14,2,109.4909,18.26465,1462
4571,6F25B46DE233F84CBE88187DB2427FA9,31021,17,19,2,109.49021,18.27,1463
4572,6F25B46DE233F84CBE88187DB2427FA9,30201,19,23,4,109.4909,18.26465,1462
4573,5EAEAB611440D169B1CE8706AE16111E,31521,2,4,2,109.51458,18.22542,1555
4574,5EAEAB611440D169B1CE8706AE16111E,30511,5,11,6,109.51069,18.24208,1558
4575,5EAEAB611440D169B1CE8706AE16111E,38251,12,13,1,109.49618,18.25493,1510
4576,5EAEAB611440D169B1CE8706AE16111E,30511,15,16,1,109.51069,18.24208,1558
4577,5EAEAB611440D169B1CE8706AE16111E,38127,19,22,3,109.50833,18.27222,1513
4578,27BCEF3137923B84211F08830816C810,61011,12,13,1,109.60653,18.19076,1900
4580,27BCEF3137923B84211F08830816C810,61011,16,18,2,109.60653,18.19076,1900
4612,E7A64185897DA568208C43A23DB11EB2,30854,13,15,2,109.56889,18.27076,1763
4613,E7A64185897DA568208C43A23DB11EB2,30861,18,22,4,109.52722,18.22743,1606
4621,4D944399BAAD1AD37CC1D68A51FA53FD,30161,0,7,7,109.50042,18.24389,1508
4622,4D944399BAAD1AD37CC1D68A51FA53FD,31021,8,10,2,109.49021,18.27,1463
4623,4D944399BAAD1AD37CC1D68A51FA53FD,30161,12,13,1,109.50042,18.24389,1508
4640,4995463B780282C9C030A19D9F49AEAC,31071,3,7,4,109.58257,18.28458,1815
4641,4995463B780282C9C030A19D9F49AEAC,30854,10,17,7,109.56889,18.27076,1763
4642,4995463B780282C9C030A19D9F49AEAC,31071,22,23,1,109.58257,18.28458,1815
4682,1065A9749A8F2A571941F492CF248982,30341,0,6,6,109.3625,18.29167,966
4683,1065A9749A8F2A571941F492CF248982,31781,9,13,4,109.19847,18.2975,367
4684,1065A9749A8F2A571941F492CF248982,60054,14,16,2,109.3016,18.31229,770
4685,1065A9749A8F2A571941F492CF248982,30711,18,19,1,109.50271,18.25347,1510
4686,1065A9749A8F2A571941F492CF248982,30341,20,22,2,109.3625,18.29167,966
4691,3D408742D0773F860BA62D41C728BA97,30711,15,16,1,109.50271,18.25347,1510
4692,3D408742D0773F860BA62D41C728BA97,39091,17,20,3,109.50097,18.25222,1510
4725,00FD2268DE6E83934D2916174E81532F,60472,3,4,1,109.46625,18.29542,1367
4726,00FD2268DE6E83934D2916174E81532F,30111,7,18,11,109.47583,18.30542,1419
4727,00FD2268DE6E83934D2916174E81532F,30761,21,23,2,109.45201,18.3,1318
4761,45A4BBA7E29D98A1407820384344799B,38951,2,11,9,109.48097,18.28868,1416
4762,45A4BBA7E29D98A1407820384344799B,33481,13,15,2,109.67278,18.41278,2187
4763,45A4BBA7E29D98A1407820384344799B,60221,20,21,1,109.52569,18.29188,1616
4764,45A4BBA7E29D98A1407820384344799B,60614,22,23,1,109.48799,18.29521,1467
4783,B340EDEF4A878E8DF5CBEC25E465EACE,30854,0,7,7,109.56889,18.27076,1763
4784,B340EDEF4A878E8DF5CBEC25E465EACE,31071,7,9,2,109.58257,18.28458,1815
4785,B340EDEF4A878E8DF5CBEC25E465EACE,30854,9,11,2,109.56889,18.27076,1763
4786,B340EDEF4A878E8DF5CBEC25E465EACE,31071,13,14,1,109.58257,18.28458,1815
4787,B340EDEF4A878E8DF5CBEC25E465EACE,30854,14,16,2,109.56889,18.27076,1763
4810,F198CAA1F49ACA5D003FD8F8473B3798,30581,17,20,3,109.62257,18.24951,1959
4811,F198CAA1F49ACA5D003FD8F8473B3798,30854,20,21,1,109.56889,18.27076,1763
4823,9FD9B533440DEDA093A3D6D9A5E4AA42,60361,0,14,14,109.51938,18.29681,1567
4824,9FD9B533440DEDA093A3D6D9A5E4AA42,30854,14,15,1,109.56889,18.27076,1763
4837,B73C72A488430C5DAE1758758E9D50EF,30951,0,1,1,109.56208,18.25667,1761
4838,B73C72A488430C5DAE1758758E9D50EF,31561,2,3,1,109.56792,18.28479,1765
4871,9CA3E2C253A813AF94072459FC979221,38321,0,11,11,109.39854,18.29132,1116
4872,9CA3E2C253A813AF94072459FC979221,31781,12,13,1,109.19847,18.2975,367
4873,9CA3E2C253A813AF94072459FC979221,31145,14,15,1,109.20431,18.30479,369
4874,9CA3E2C253A813AF94072459FC979221,31781,15,17,2,109.19847,18.2975,367
4875,9CA3E2C253A813AF94072459FC979221,38105,18,23,5,109.40299,18.29229,1117
4885,F6BB537A775832A45DF7D139A32B29FF,30711,2,7,5,109.50271,18.25347,1510
4886,F6BB537A775832A45DF7D139A32B29FF,31851,11,14,3,109.71736,18.29007,2316
4887,F6BB537A775832A45DF7D139A32B29FF,30711,17,19,2,109.50271,18.25347,1510
4888,F6BB537A775832A45DF7D139A32B29FF,60221,19,20,1,109.52569,18.29188,1616
4889,F6BB537A775832A45DF7D139A32B29FF,31851,22,23,1,109.71736,18.29007,2316
4893,662D882A6A10D0E6C3566690F0A40636,30854,0,17,17,109.56889,18.27076,1763
4894,662D882A6A10D0E6C3566690F0A40636,31071,20,21,1,109.58257,18.28458,1815
4895,662D882A6A10D0E6C3566690F0A40636,30854,22,23,1,109.56889,18.27076,1763
4972,64160F75E74E2B48DE6EBBED499A7424,31431,0,7,7,109.44639,18.29042,1316
4973,64160F75E74E2B48DE6EBBED499A7424,38361,9,14,5,109.43667,18.29201,1267
4974,64160F75E74E2B48DE6EBBED499A7424,30771,17,19,2,109.49938,18.26042,1511
4975,64160F75E74E2B48DE6EBBED499A7424,31431,20,21,1,109.44639,18.29042,1316
4991,FB69127E95B4D9EC5AF61282F8D7EEB7,30854,9,15,6,109.56889,18.27076,1763
4992,FB69127E95B4D9EC5AF61282F8D7EEB7,30861,17,21,4,109.52722,18.22743,1606
5000,8CBDC50DA35EAA1BF96B888A29A6656F,30351,18,22,4,109.41701,18.29292,1217
5006,2D39AE6120F2674000C6DBB8A6E572A0,31945,0,13,13,109.58021,18.29403,1817
5007,2D39AE6120F2674000C6DBB8A6E572A0,30854,14,23,9,109.56889,18.27076,1763
5014,E5E20C78783BEE4FE22BF6D264C660C6,31071,1,6,5,109.58257,18.28458,1815
5015,E5E20C78783BEE4FE22BF6D264C660C6,30854,9,18,9,109.56889,18.27076,1763
5050,C1F9914EF577AE2A8300B1A3945A50FF,31561,1,18,17,109.56792,18.28479,1765
5051,C1F9914EF577AE2A8300B1A3945A50FF,31071,20,21,1,109.58257,18.28458,1815
5052,C1F9914EF577AE2A8300B1A3945A50FF,30851,22,23,1,109.5616,18.27396,1713
5188,EC3508E6C408281EA2938EED62E1A6CB,31071,3,5,2,109.58257,18.28458,1815
5189,EC3508E6C408281EA2938EED62E1A6CB,30951,8,18,10,109.56208,18.25667,1761
5190,EC3508E6C408281EA2938EED62E1A6CB,30232,20,23,3,109.6191,18.31701,1971
5221,AAE004FC512551834D40DDD86F1BD5D3,60161,1,3,2,109.49174,18.26181,1461
5222,AAE004FC512551834D40DDD86F1BD5D3,60041,4,11,7,109.39889,18.31944,1121
5223,AAE004FC512551834D40DDD86F1BD5D3,60161,15,16,1,109.49174,18.26181,1461
5224,AAE004FC512551834D40DDD86F1BD5D3,60231,17,19,2,109.49903,18.21972,1504
5225,AAE004FC512551834D40DDD86F1BD5D3,60161,21,22,1,109.49174,18.26181,1461
5259,462D8D1C789FC84A63DF1607C3EC93C5,60631,0,7,7,109.57778,18.27583,1814
5260,462D8D1C789FC84A63DF1607C3EC93C5,30854,8,11,3,109.56889,18.27076,1763
5263,E191BF114A3C2277CB7C3323BAA13F43,39151,18,19,1,109.49875,18.25097,1510
5264,E191BF114A3C2277CB7C3323BAA13F43,30854,21,22,1,109.56889,18.27076,1763
5298,A68637AA89BD62624E677D9E66C32FAD,39101,0,5,5,109.50132,18.24931,1509
5299,A68637AA89BD62624E677D9E66C32FAD,30161,5,10,5,109.50042,18.24389,1508
5300,A68637AA89BD62624E677D9E66C32FAD,30361,10,11,1,109.50347,18.24,1508
5301,A68637AA89BD62624E677D9E66C32FAD,30161,12,15,3,109.50042,18.24389,1508
5352,A8CC84F6441C04DAF82A74609E587ED2,30561,0,7,7,109.52778,18.31938,1621
5353,A8CC84F6441C04DAF82A74609E587ED2,39181,7,8,1,109.55153,18.28035,1715
5354,A8CC84F6441C04DAF82A74609E587ED2,30561,12,13,1,109.52778,18.31938,1621
5355,A8CC84F6441C04DAF82A74609E587ED2,39181,14,15,1,109.55153,18.28035,1715
5396,2576A40187A845D7B849E820F16B3DB1,30854,1,6,5,109.56889,18.27076,1763
5397,2576A40187A845D7B849E820F16B3DB1,31071,6,8,2,109.58257,18.28458,1815
5398,2576A40187A845D7B849E820F16B3DB1,30854,10,11,1,109.56889,18.27076,1763
5402,90B0A60855A43B2DB99A0964CE51D3AF,31071,1,7,6,109.58257,18.28458,1815
5403,90B0A60855A43B2DB99A0964CE51D3AF,30854,11,23,12,109.56889,18.27076,1763
5425,3D39BFF619D555933510C63A4C03CAF1,60221,20,23,3,109.52569,18.29188,1616
5439,EF6EAAF19212F026BFFCE69929597502,31931,12,18,6,109.54771,18.29403,1667
5440,EF6EAAF19212F026BFFCE69929597502,31181,20,22,2,109.50382,18.24813,1509
5442,7AEDF35A88732925ED623E93535ACF94,31351,22,23,1,109.4959,18.28417,1465
5477,122D07F80E4FAC68FAE7EDBB2DF1AFA3,31071,0,8,8,109.58257,18.28458,1815
5478,122D07F80E4FAC68FAE7EDBB2DF1AFA3,30854,10,11,1,109.56889,18.27076,1763
5479,122D07F80E4FAC68FAE7EDBB2DF1AFA3,31071,13,14,1,109.58257,18.28458,1815
5480,122D07F80E4FAC68FAE7EDBB2DF1AFA3,30854,16,17,1,109.56889,18.27076,1763
5508,B3EF0679F09F3DEC127B54C54EEBFAA7,31071,3,4,1,109.58257,18.28458,1815
5509,B3EF0679F09F3DEC127B54C54EEBFAA7,30854,7,9,2,109.56889,18.27076,1763
5510,B3EF0679F09F3DEC127B54C54EEBFAA7,31071,12,13,1,109.58257,18.28458,1815
5511,B3EF0679F09F3DEC127B54C54EEBFAA7,30854,13,23,10,109.56889,18.27076,1763
5574,33E1BB37556BA5DDC29CF09F78EA92CE,60641,0,7,7,109.53854,18.2359,1657
5575,33E1BB37556BA5DDC29CF09F78EA92CE,60381,10,11,1,109.5241,18.22458,1605
5576,33E1BB37556BA5DDC29CF09F78EA92CE,30854,13,15,2,109.56889,18.27076,1763
5577,33E1BB37556BA5DDC29CF09F78EA92CE,60381,17,21,4,109.5241,18.22458,1605
5578,33E1BB37556BA5DDC29CF09F78EA92CE,60641,21,23,2,109.53854,18.2359,1657
5601,A9FCE0049DB44FE004EAFBF5B783F4A5,31945,0,6,6,109.58021,18.29403,1817
5602,A9FCE0049DB44FE004EAFBF5B783F4A5,30854,9,17,8,109.56889,18.27076,1763
5607,B663EE883B81AEB709AC84DCCEC3D38E,31945,0,7,7,109.58021,18.29403,1817
5608,B663EE883B81AEB709AC84DCCEC3D38E,30854,9,11,2,109.56889,18.27076,1763
5609,B663EE883B81AEB709AC84DCCEC3D38E,31945,13,14,1,109.58021,18.29403,1817
5610,B663EE883B81AEB709AC84DCCEC3D38E,30854,15,23,8,109.56889,18.27076,1763
5635,A64494D6F3A0AF8BF93D9FAA1169011A,31521,0,7,7,109.51458,18.22542,1555
5636,A64494D6F3A0AF8BF93D9FAA1169011A,38811,8,16,8,109.50875,18.2175,1504
5637,A64494D6F3A0AF8BF93D9FAA1169011A,39111,18,20,2,109.5191,18.22597,1555
5638,A64494D6F3A0AF8BF93D9FAA1169011A,60381,20,22,2,109.5241,18.22458,1605
5673,84DF4A7C208235D171EF56473BCCF210,30851,0,3,3,109.5616,18.27396,1713
5674,84DF4A7C208235D171EF56473BCCF210,30361,7,9,2,109.50347,18.24,1508
5675,84DF4A7C208235D171EF56473BCCF210,60631,9,18,9,109.57778,18.27583,1814
5676,C0D9A8D1FC57A96EA766A127A0E8EAAC,30854,0,10,10,109.56889,18.27076,1763
5677,C0D9A8D1FC57A96EA766A127A0E8EAAC,60631,10,11,1,109.57778,18.27583,1814
5678,C0D9A8D1FC57A96EA766A127A0E8EAAC,30854,13,14,1,109.56889,18.27076,1763
5679,C0D9A8D1FC57A96EA766A127A0E8EAAC,60631,15,21,6,109.57778,18.27583,1814
5680,C0D9A8D1FC57A96EA766A127A0E8EAAC,30854,21,23,2,109.56889,18.27076,1763
5690,015CDEB9169BCE5537ABAE49B6A63F2B,39111,0,5,5,109.5191,18.22597,1555
5691,015CDEB9169BCE5537ABAE49B6A63F2B,30854,9,10,1,109.56889,18.27076,1763
5692,015CDEB9169BCE5537ABAE49B6A63F2B,31071,11,13,2,109.58257,18.28458,1815
5693,015CDEB9169BCE5537ABAE49B6A63F2B,30854,14,16,2,109.56889,18.27076,1763
5694,015CDEB9169BCE5537ABAE49B6A63F2B,31071,17,19,2,109.58257,18.28458,1815
5711,31812AB81FCECCF927F1F278190E0A39,60631,0,6,6,109.57778,18.27583,1814
5712,31812AB81FCECCF927F1F278190E0A39,31931,7,8,1,109.54771,18.29403,1667
5713,31812AB81FCECCF927F1F278190E0A39,60631,12,13,1,109.57778,18.27583,1814
5714,31812AB81FCECCF927F1F278190E0A39,31931,14,15,1,109.54771,18.29403,1667
5715,31812AB81FCECCF927F1F278190E0A39,60631,19,23,4,109.57778,18.27583,1814
5716,83F8DEFB45E9970F803B6E01CF53475C,31021,0,13,13,109.49021,18.27,1463
5717,83F8DEFB45E9970F803B6E01CF53475C,31206,18,20,2,109.50819,18.23549,1507
5718,83F8DEFB45E9970F803B6E01CF53475C,30421,20,22,2,109.50021,18.25861,1511
5759,BE586ACB441383CC10D7CF3923850B73,60371,11,12,1,109.53063,18.30056,1618
5760,BE586ACB441383CC10D7CF3923850B73,31931,13,16,3,109.54771,18.29403,1667
5761,BE586ACB441383CC10D7CF3923850B73,31271,20,21,1,109.48958,18.26257,1462
5762,BE586ACB441383CC10D7CF3923850B73,31931,22,23,1,109.54771,18.29403,1667
5836,F00821368F615DCDAF214035D8EC4A44,31945,1,2,1,109.58021,18.29403,1817
5837,F00821368F615DCDAF214035D8EC4A44,31071,5,13,8,109.58257,18.28458,1815
5838,F00821368F615DCDAF214035D8EC4A44,30854,13,22,9,109.56889,18.27076,1763
5839,FCB3111133B2F972ED78C764490210E1,30854,0,6,6,109.56889,18.27076,1763
5840,FCB3111133B2F972ED78C764490210E1,31071,8,17,9,109.58257,18.28458,1815
5874,3D8D036A35BC58F8F36AEB163DF7D2CC,30181,1,11,10,109.51597,18.23313,1557
5875,3D8D036A35BC58F8F36AEB163DF7D2CC,31145,15,16,1,109.20431,18.30479,369
5876,3D8D036A35BC58F8F36AEB163DF7D2CC,30361,19,21,2,109.50347,18.24,1508
5877,3D8D036A35BC58F8F36AEB163DF7D2CC,30181,21,22,1,109.51597,18.23313,1557
5878,934029FB5F97BCE114EDCE88F0393A63,31071,2,19,17,109.58257,18.28458,1815
5879,934029FB5F97BCE114EDCE88F0393A63,30854,21,23,2,109.56889,18.27076,1763
5897,96F98526707B06BE1263CCD4F72E07A1,31071,2,9,7,109.58257,18.28458,1815
5898,96F98526707B06BE1263CCD4F72E07A1,31945,13,17,4,109.58021,18.29403,1817
5899,96F98526707B06BE1263CCD4F72E07A1,30854,22,23,1,109.56889,18.27076,1763
5909,335A7B1DE8538918FDA774EE3E402A76,30191,0,7,7,109.50361,18.22701,1506
5910,335A7B1DE8538918FDA774EE3E402A76,60381,9,10,1,109.5241,18.22458,1605
5911,335A7B1DE8538918FDA774EE3E402A76,33481,13,16,3,109.67278,18.41278,2187
5912,335A7B1DE8538918FDA774EE3E402A76,30191,18,23,5,109.50361,18.22701,1506
5939,AA17C9279A63248D7DCDF49F93EB8817,39183,3,4,1,109.55542,18.28208,1715
5940,AA17C9279A63248D7DCDF49F93EB8817,38275,8,18,10,109.62875,18.22938,2006
5941,AA17C9279A63248D7DCDF49F93EB8817,30854,19,23,4,109.56889,18.27076,1763
5988,F84D949DDCBF25D5530F771BC55E0B9D,61011,0,18,18,109.60653,18.19076,1900
5989,F84D949DDCBF25D5530F771BC55E0B9D,31321,20,22,2,109.63799,18.23201,2007
6007,53490AD77ACCA93C3ED0F3DE79CA488B,31071,4,6,2,109.58257,18.28458,1815
6008,53490AD77ACCA93C3ED0F3DE79CA488B,30854,10,11,1,109.56889,18.27076,1763
6009,53490AD77ACCA93C3ED0F3DE79CA488B,31071,15,16,1,109.58257,18.28458,1815
6010,53490AD77ACCA93C3ED0F3DE79CA488B,30854,17,19,2,109.56889,18.27076,1763
6013,6E2021B014C4D0B652A2E4FE8D2CF038,31071,0,7,7,109.58257,18.28458,1815
6014,6E2021B014C4D0B652A2E4FE8D2CF038,30854,10,11,1,109.56889,18.27076,1763
6015,6E2021B014C4D0B652A2E4FE8D2CF038,31071,13,14,1,109.58257,18.28458,1815
6016,6E2021B014C4D0B652A2E4FE8D2CF038,30854,17,18,1,109.56889,18.27076,1763
6022,7369BED4E2FC40D6F6B26C6889CDEE8A,31205,14,16,2,109.51111,18.23736,1557
6023,7369BED4E2FC40D6F6B26C6889CDEE8A,31206,20,23,3,109.50819,18.23549,1507
6055,EB99FEF99139730D7C75B28A9DFBB9BC,60631,0,2,2,109.57778,18.27583,1814
6056,EB99FEF99139730D7C75B28A9DFBB9BC,31071,3,23,20,109.58257,18.28458,1815
6084,9C1407835BC54BEBDB541F52E1DA1820,61011,0,4,4,109.60653,18.19076,1900
6086,9C1407835BC54BEBDB541F52E1DA1820,61011,12,13,1,109.60653,18.19076,1900
6104,3C25AA28A73DA6B8FA6F4FFBF4B84B84,38754,14,16,2,109.74667,18.37382,2430
6105,3C25AA28A73DA6B8FA6F4FFBF4B84B84,30181,16,18,2,109.51597,18.23313,1557
6106,3C25AA28A73DA6B8FA6F4FFBF4B84B84,31521,18,21,3,109.51458,18.22542,1555
6132,52C15F07544D9CC60D46BD6BA2551891,60631,2,3,1,109.57778,18.27583,1814
6133,52C15F07544D9CC60D46BD6BA2551891,30854,6,17,11,109.56889,18.27076,1763
6175,5FB9536C7DD9A23FF858DBBDE43D97B4,60361,0,8,8,109.51938,18.29681,1567
6176,5FB9536C7DD9A23FF858DBBDE43D97B4,31471,12,14,2,109.34583,18.29563,917
6177,5FB9536C7DD9A23FF858DBBDE43D97B4,60411,14,15,1,109.32514,18.30854,869
6178,5FB9536C7DD9A23FF858DBBDE43D97B4,60361,19,23,4,109.51938,18.29681,1567
6179,87C93C09107C554DB19E0C119A198391,30581,0,6,6,109.62257,18.24951,1959
6180,87C93C09107C554DB19E0C119A198391,33481,10,13,3,109.67278,18.41278,2187
6181,6A638A7D814A6949897842F2EB3E49DC,31521,0,7,7,109.51458,18.22542,1555
6182,6A638A7D814A6949897842F2EB3E49DC,31521,9,23,14,109.51458,18.22542,1555
6185,50C94A5D81902FD587CF080801CF1E9B,30661,19,20,1,109.37028,18.24361,1008
6186,50C94A5D81902FD587CF080801CF1E9B,60411,21,22,1,109.32514,18.30854,869
6210,DBB710D279E76C79F1E4B0766F579F8A,30441,0,6,6,109.64021,18.25424,2010
6211,DBB710D279E76C79F1E4B0766F579F8A,30854,7,8,1,109.56889,18.27076,1763
6227,CCCD2290FB632A48009771412BE68ADD,31561,0,6,6,109.56792,18.28479,1765
6228,CCCD2290FB632A48009771412BE68ADD,39183,9,11,2,109.55542,18.28208,1715
6229,CCCD2290FB632A48009771412BE68ADD,31561,14,21,7,109.56792,18.28479,1765
6230,8799356B7181F28146A203E5F86C52F0,31351,0,7,7,109.4959,18.28417,1465
6231,8799356B7181F28146A203E5F86C52F0,38834,8,18,10,109.47639,18.21146,1403
6232,8799356B7181F28146A203E5F86C52F0,31351,19,23,4,109.4959,18.28417,1465
6259,DCAA44BA6595CC23E827221393F8A6D6,31521,0,8,8,109.51458,18.22542,1555
6260,DCAA44BA6595CC23E827221393F8A6D6,30361,12,14,2,109.50347,18.24,1508
6261,DCAA44BA6595CC23E827221393F8A6D6,60381,16,18,2,109.5241,18.22458,1605
6262,DCAA44BA6595CC23E827221393F8A6D6,31521,18,23,5,109.51458,18.22542,1555
6266,0BABF9C6516F437130A3DD3C99553A57,31206,0,1,1,109.50819,18.23549,1507
6267,0BABF9C6516F437130A3DD3C99553A57,39191,1,13,12,109.51493,18.23472,1557
6268,0BABF9C6516F437130A3DD3C99553A57,31861,15,17,2,109.49042,18.27549,1464
6269,0BABF9C6516F437130A3DD3C99553A57,60291,19,22,3,109.50826,18.24639,1509
6338,17B36FE04A8DB99ADD8F8C217141C7D9,60251,0,7,7,109.51229,18.325,1572
6339,17B36FE04A8DB99ADD8F8C217141C7D9,30854,9,10,1,109.56889,18.27076,1763
6340,17B36FE04A8DB99ADD8F8C217141C7D9,38484,11,12,1,109.53028,18.31528,1620
6341,17B36FE04A8DB99ADD8F8C217141C7D9,60251,12,23,11,109.51229,18.325,1572
6347,DF1914B7230B32BA806E8A8749CAD846,60261,18,20,2,109.44326,18.3075,1319
6348,DF1914B7230B32BA806E8A8749CAD846,60201,21,23,2,109.5041,18.2509,1510
6386,E5E2DA460104E389257158E8D8C9FBDA,60281,0,6,6,109.51743,18.25924,1561
6387,E5E2DA460104E389257158E8D8C9FBDA,30251,7,8,1,109.50611,18.26653,1512
6388,E5E2DA460104E389257158E8D8C9FBDA,38291,9,11,2,109.51618,18.24313,1558
6389,E5E2DA460104E389257158E8D8C9FBDA,60291,13,17,4,109.50826,18.24639,1509
6390,E5E2DA460104E389257158E8D8C9FBDA,60281,18,22,4,109.51743,18.25924,1561
6477,3FD52FC00A20F224738DE2A9BE8088FD,38911,0,8,8,109.51674,18.24965,1559
6478,3FD52FC00A20F224738DE2A9BE8088FD,30151,10,12,2,109.50986,18.25083,1560
6479,3FD52FC00A20F224738DE2A9BE8088FD,60281,14,16,2,109.51743,18.25924,1561
6489,A79D6124A17B67306E527E63C62B840F,31521,15,18,3,109.51458,18.22542,1555
6490,A79D6124A17B67306E527E63C62B840F,30181,21,23,2,109.51597,18.23313,1557
6550,A8E9C7BB918ADAD29A3EA7ACDDCD32D7,38951,0,8,8,109.48097,18.28868,1416
6551,A8E9C7BB918ADAD29A3EA7ACDDCD32D7,60041,8,14,6,109.39889,18.31944,1121
6552,A8E9C7BB918ADAD29A3EA7ACDDCD32D7,38951,17,23,6,109.48097,18.28868,1416
6566,317835A2F11D93D7A28D8E4620886D95,31071,1,2,1,109.58257,18.28458,1815
6567,317835A2F11D93D7A28D8E4620886D95,30854,3,10,7,109.56889,18.27076,1763
6568,317835A2F11D93D7A28D8E4620886D95,31071,10,16,6,109.58257,18.28458,1815
6569,317835A2F11D93D7A28D8E4620886D95,30854,16,17,1,109.56889,18.27076,1763
6572,F3652FF504BC297E68234A33C1877043,30854,1,10,9,109.56889,18.27076,1763
6573,F3652FF504BC297E68234A33C1877043,31945,12,14,2,109.58021,18.29403,1817
6574,F3652FF504BC297E68234A33C1877043,31071,15,16,1,109.58257,18.28458,1815
6590,1980C8D409DE9551539224B3D393CDAA,30071,12,21,9,109.52819,18.30472,1619
6591,1980C8D409DE9551539224B3D393CDAA,31951,21,23,2,109.52174,18.30299,1568
6616,7CF61852566EFB50DFB9BA6236C84059,30181,0,7,7,109.51597,18.23313,1557
6617,7CF61852566EFB50DFB9BA6236C84059,60552,9,10,1,109.41729,18.30014,1218
6618,7CF61852566EFB50DFB9BA6236C84059,30581,13,14,1,109.62257,18.24951,1959
6629,89401E44267DEEF27DB3B95FF5F81B3E,30951,2,7,5,109.56208,18.25667,1761
6630,89401E44267DEEF27DB3B95FF5F81B3E,31421,10,14,4,109.55382,18.22347,1705
6631,89401E44267DEEF27DB3B95FF5F81B3E,30951,15,20,5,109.56208,18.25667,1761
6683,FA0EB766C44C307B69FC2247C53C674E,60131,0,7,7,109.49819,18.24778,1509
6684,FA0EB766C44C307B69FC2247C53C674E,30711,9,12,3,109.50271,18.25347,1510
6685,FA0EB766C44C307B69FC2247C53C674E,30941,13,14,1,109.5559,18.33938,1724
6686,FA0EB766C44C307B69FC2247C53C674E,39151,18,23,5,109.49875,18.25097,1510
6693,F017FF3142A71039848F82213CC35CB8,38052,5,11,6,109.62618,18.23042,1956
6694,F017FF3142A71039848F82213CC35CB8,38331,12,14,2,109.62465,18.22736,1956
6695,F017FF3142A71039848F82213CC35CB8,60594,14,15,1,109.62694,18.22799,1956
6696,F017FF3142A71039848F82213CC35CB8,38052,16,18,2,109.62618,18.23042,1956
6697,F017FF3142A71039848F82213CC35CB8,31031,18,20,2,109.49979,18.25382,1510
6698,F017FF3142A71039848F82213CC35CB8,60594,21,23,2,109.62694,18.22799,1956
6788,8752BC71725B50257436D50C6598F252,31071,0,7,7,109.58257,18.28458,1815
6789,8752BC71725B50257436D50C6598F252,30854,9,22,13,109.56889,18.27076,1763
6805,12D8E06C2EC8C969710FB791DF137B2B,31071,0,13,13,109.58257,18.28458,1815
6806,12D8E06C2EC8C969710FB791DF137B2B,30854,14,16,2,109.56889,18.27076,1763
6807,12D8E06C2EC8C969710FB791DF137B2B,31071,18,20,2,109.58257,18.28458,1815
6808,12D8E06C2EC8C969710FB791DF137B2B,30854,21,23,2,109.56889,18.27076,1763
6814,13CB28894FE9758E951221ECF7C4C4A1,30201,0,7,7,109.4909,18.26465,1462
6818,13CB28894FE9758E951221ECF7C4C4A1,31291,19,23,4,109.30375,18.40729,786
6841,08077B5D5F0A9938A81D328635D03C8B,31071,14,16,2,109.58257,18.28458,1815
6842,08077B5D5F0A9938A81D328635D03C8B,30854,17,19,2,109.56889,18.27076,1763
6843,08077B5D5F0A9938A81D328635D03C8B,31071,20,21,1,109.58257,18.28458,1815
6844,08077B5D5F0A9938A81D328635D03C8B,30854,21,23,2,109.56889,18.27076,1763
6860,4EE3541571833D45849F06D38E34641F,30854,2,13,11,109.56889,18.27076,1763
6861,4EE3541571833D45849F06D38E34641F,39091,14,15,1,109.50097,18.25222,1510
6862,4EE3541571833D45849F06D38E34641F,38251,16,19,3,109.49618,18.25493,1510
6863,34879982D44451BF0E6B0E476F030D2C,60084,0,7,7,109.4984,18.2334,1507
6864,34879982D44451BF0E6B0E476F030D2C,31781,12,13,1,109.19847,18.2975,367
6865,34879982D44451BF0E6B0E476F030D2C,31471,15,16,1,109.34583,18.29563,917
6866,34879982D44451BF0E6B0E476F030D2C,60084,21,23,2,109.4984,18.2334,1507
6875,C983E73D646629A775690ECA8920EB29,31631,0,8,8,109.59542,18.36826,1879
6876,C983E73D646629A775690ECA8920EB29,30101,11,12,1,109.57299,18.33333,1773
6877,C983E73D646629A775690ECA8920EB29,38251,14,15,1,109.49618,18.25493,1510
6902,3EAE2CCEF780CC2E20C47963EA2CF3C6,30854,2,11,9,109.56889,18.27076,1763
6903,3EAE2CCEF780CC2E20C47963EA2CF3C6,38251,14,15,1,109.49618,18.25493,1510
6904,3EAE2CCEF780CC2E20C47963EA2CF3C6,30854,16,18,2,109.56889,18.27076,1763
6905,D4AA3869830031578B573FD0033C24A8,30921,3,4,1,109.53903,18.29451,1667
6906,D4AA3869830031578B573FD0033C24A8,31931,4,23,19,109.54771,18.29403,1667
6912,8FE97C1052D63DE830211C405D8F5442,60631,0,6,6,109.57778,18.27583,1814
6913,8FE97C1052D63DE830211C405D8F5442,30854,6,8,2,109.56889,18.27076,1763
6914,8FE97C1052D63DE830211C405D8F5442,60631,12,13,1,109.57778,18.27583,1814
6915,8FE97C1052D63DE830211C405D8F5442,30854,13,22,9,109.56889,18.27076,1763
6976,6422CB87ACC55DDEF6EBE8946593C808,30281,0,1,1,109.50597,18.27583,1514
6977,6422CB87ACC55DDEF6EBE8946593C808,30201,1,5,4,109.4909,18.26465,1462
6979,6422CB87ACC55DDEF6EBE8946593C808,38834,15,20,5,109.47639,18.21146,1403
6980,6422CB87ACC55DDEF6EBE8946593C808,31351,22,23,1,109.4959,18.28417,1465
7004,68503E543A99EE2DC3294A01A2A414B7,38871,2,4,2,109.44681,18.28625,1316
7005,68503E543A99EE2DC3294A01A2A414B7,30111,5,7,2,109.47583,18.30542,1419
7006,68503E543A99EE2DC3294A01A2A414B7,38871,11,14,3,109.44681,18.28625,1316
7007,68503E543A99EE2DC3294A01A2A414B7,31431,18,20,2,109.44639,18.29042,1316
7008,68503E543A99EE2DC3294A01A2A414B7,30201,21,23,2,109.4909,18.26465,1462
7011,1412BA3B65BC1A2354CCBE297098A0E1,31071,0,14,14,109.58257,18.28458,1815
7012,1412BA3B65BC1A2354CCBE297098A0E1,30854,15,19,4,109.56889,18.27076,1763
7013,1412BA3B65BC1A2354CCBE297098A0E1,31071,19,21,2,109.58257,18.28458,1815
7036,16BD55F34E997950AC3D027030FD92BC,30921,0,6,6,109.53903,18.29451,1667
7037,16BD55F34E997950AC3D027030FD92BC,31931,10,22,12,109.54771,18.29403,1667
7042,10C6D0E1E57880F0DC4DD15E8732EE08,30121,9,12,3,109.52861,18.27222,1613
7045,9AA959ED87D1ECC3053DED17290EFCBD,30854,10,12,2,109.56889,18.27076,1763
7046,9AA959ED87D1ECC3053DED17290EFCBD,39183,13,16,3,109.55542,18.28208,1715
7047,9AA959ED87D1ECC3053DED17290EFCBD,31561,17,23,6,109.56792,18.28479,1765
7091,D96E01B8E0F0DE9C160C9FEAFDCFDB6D,31071,0,9,9,109.58257,18.28458,1815
7092,D96E01B8E0F0DE9C160C9FEAFDCFDB6D,30854,9,19,10,109.56889,18.27076,1763
7093,D96E01B8E0F0DE9C160C9FEAFDCFDB6D,31071,20,21,1,109.58257,18.28458,1815
7126,C6FE4CF0CD47303AD7F7EC5A71315B10,30854,6,7,1,109.56889,18.27076,1763
7127,C6FE4CF0CD47303AD7F7EC5A71315B10,38205,10,22,12,109.62743,18.23139,1956
7132,32D0EBFA645FCE8DAD65D018847E5043,30232,0,5,5,109.6191,18.31701,1971
7133,32D0EBFA645FCE8DAD65D018847E5043,30854,8,12,4,109.56889,18.27076,1763
7134,32D0EBFA645FCE8DAD65D018847E5043,30232,12,14,2,109.6191,18.31701,1971
7135,32D0EBFA645FCE8DAD65D018847E5043,30854,14,16,2,109.56889,18.27076,1763
7145,A3DA1BE8D565CA010F364D67C383BE19,30161,15,16,1,109.50042,18.24389,1508
7190,8693FEE8E02E59F02AA0D7E67DE9383E,31031,0,10,10,109.49979,18.25382,1510
7191,8693FEE8E02E59F02AA0D7E67DE9383E,31561,14,15,1,109.56792,18.28479,1765
7192,8693FEE8E02E59F02AA0D7E67DE9383E,31031,16,22,6,109.49979,18.25382,1510
7236,C8922FAF66F21ECAECB6B717FCD5A53B,60614,0,13,13,109.48799,18.29521,1467
7237,C8922FAF66F21ECAECB6B717FCD5A53B,60391,16,17,1,109.47667,18.28757,1416
7238,C8922FAF66F21ECAECB6B717FCD5A53B,60614,18,23,5,109.48799,18.29521,1467
7266,9E8746086915F9D4A063A74CF0B5B7AB,39183,14,18,4,109.55542,18.28208,1715
7267,9E8746086915F9D4A063A74CF0B5B7AB,31561,20,22,2,109.56792,18.28479,1765
7289,DCD1B69C002595BDB52E9CC1F8BAAE8A,38831,0,8,8,109.4916,18.20938,1453
7290,DCD1B69C002595BDB52E9CC1F8BAAE8A,38251,11,12,1,109.49618,18.25493,1510
7292,DCD1B69C002595BDB52E9CC1F8BAAE8A,31941,20,22,2,109.62451,18.31222,1970
7295,A503639E15A0B5D04B0130D882921438,30711,0,13,13,109.50271,18.25347,1510
7296,A503639E15A0B5D04B0130D882921438,31031,14,19,5,109.49979,18.25382,1510
7297,A503639E15A0B5D04B0130D882921438,31031,19,23,4,109.49979,18.25382,1510
7318,FD5B9AB034F15F72E8BEF02193669238,60241,0,6,6,109.53319,18.28667,1616
7319,FD5B9AB034F15F72E8BEF02193669238,31931,8,10,2,109.54771,18.29403,1667
7320,FD5B9AB034F15F72E8BEF02193669238,60241,12,13,1,109.53319,18.28667,1616
7321,FD5B9AB034F15F72E8BEF02193669238,31931,14,15,1,109.54771,18.29403,1667
7322,FD5B9AB034F15F72E8BEF02193669238,60241,19,21,2,109.53319,18.28667,1616
7323,FD5B9AB034F15F72E8BEF02193669238,60371,22,23,1,109.53063,18.30056,1618
7352,8B67CA01C44A0A9FF0492771727FF584,30854,1,13,12,109.56889,18.27076,1763
7353,8B67CA01C44A0A9FF0492771727FF584,38241,14,17,3,109.54111,18.30542,1669
7354,8B67CA01C44A0A9FF0492771727FF584,31621,18,19,1,109.51035,18.29826,1568
7355,8B67CA01C44A0A9FF0492771727FF584,30854,22,23,1,109.56889,18.27076,1763
7358,033CEEC20746801745CF4A53CD517C31,31821,17,18,1,109.51181,18.24924,1559
7359,033CEEC20746801745CF4A53CD517C31,31391,18,20,2,109.50382,18.24285,1508
7360,033CEEC20746801745CF4A53CD517C31,31181,20,23,3,109.50382,18.24813,1509
7361,E9FE314BF6BA7C40D9DECC5BB702593F,31071,12,14,2,109.58257,18.28458,1815
7362,E9FE314BF6BA7C40D9DECC5BB702593F,30854,15,22,7,109.56889,18.27076,1763
7384,1419F2503130508E06D5FA0D4A5CF329,31031,0,9,9,109.49979,18.25382,1510
7385,1419F2503130508E06D5FA0D4A5CF329,31031,11,13,2,109.49979,18.25382,1510
7386,1419F2503130508E06D5FA0D4A5CF329,60291,15,16,1,109.50826,18.24639,1509
7387,1419F2503130508E06D5FA0D4A5CF329,31261,17,21,4,109.51174,18.2466,1559
7388,1419F2503130508E06D5FA0D4A5CF329,31031,21,23,2,109.49979,18.25382,1510
7399,E9E473F09C342630187345312F4A31D8,39181,0,17,17,109.55153,18.28035,1715
7400,E9E473F09C342630187345312F4A31D8,31931,17,18,1,109.54771,18.29403,1667
7401,E9E473F09C342630187345312F4A31D8,39181,19,23,4,109.55153,18.28035,1715
7405,D4F66FB71406E4E38A7A105B0CD3164D,30711,0,4,4,109.50271,18.25347,1510
7406,D4F66FB71406E4E38A7A105B0CD3164D,30711,4,21,17,109.50271,18.25347,1510
7455,00FC332040A284DA251A8D0705989FE9,31071,0,7,7,109.58257,18.28458,1815
7456,00FC332040A284DA251A8D0705989FE9,30854,9,11,2,109.56889,18.27076,1763
7457,00FC332040A284DA251A8D0705989FE9,31071,12,15,3,109.58257,18.28458,1815
7458,00FC332040A284DA251A8D0705989FE9,30854,19,20,1,109.56889,18.27076,1763
7485,60C76AD19DF8888A84F620E94C92FF2B,30571,4,5,1,109.50243,18.21861,1504
7486,60C76AD19DF8888A84F620E94C92FF2B,60231,7,8,1,109.49903,18.21972,1504
7487,60C76AD19DF8888A84F620E94C92FF2B,60161,12,15,3,109.49174,18.26181,1461
7488,60C76AD19DF8888A84F620E94C92FF2B,30341,18,19,1,109.3625,18.29167,966
7489,60C76AD19DF8888A84F620E94C92FF2B,38325,20,22,2,109.39792,18.2909,1116
7517,2981C8B3C1AD0C63670497656AA260BB,30151,20,22,2,109.50986,18.25083,1560
7518,2981C8B3C1AD0C63670497656AA260BB,30721,22,23,1,109.51597,18.28257,1565
7546,39F25FE146A03325C93C111F2A943B6C,31945,0,7,7,109.58021,18.29403,1817
7547,39F25FE146A03325C93C111F2A943B6C,31071,10,12,2,109.58257,18.28458,1815
7548,39F25FE146A03325C93C111F2A943B6C,31945,12,13,1,109.58021,18.29403,1817
7549,39F25FE146A03325C93C111F2A943B6C,30854,13,23,10,109.56889,18.27076,1763
7596,9D5FE3225DA80BAE67F5E52EB432B0A5,31351,11,12,1,109.4959,18.28417,1465
7597,9D5FE3225DA80BAE67F5E52EB432B0A5,60551,14,16,2,109.42722,18.30111,1218
7604,5F70E6EFF50C46A1203DB5C4C03B4FD3,31701,2,12,10,109.44132,18.28833,1266
7605,5F70E6EFF50C46A1203DB5C4C03B4FD3,38754,16,18,2,109.74667,18.37382,2430
7606,5F70E6EFF50C46A1203DB5C4C03B4FD3,31701,21,23,2,109.44132,18.28833,1266
7629,14AE6C820CE45F96077630992CABD33D,30951,0,12,12,109.56208,18.25667,1761
7630,14AE6C820CE45F96077630992CABD33D,31551,12,14,2,109.55868,18.24222,1708
7631,14AE6C820CE45F96077630992CABD33D,30951,14,23,9,109.56208,18.25667,1761
7658,DFFF17B7FE30E79B8AABBB5CE171272F,31561,13,14,1,109.56792,18.28479,1765
7659,DFFF17B7FE30E79B8AABBB5CE171272F,39183,15,17,2,109.55542,18.28208,1715
7660,DFFF17B7FE30E79B8AABBB5CE171272F,31561,21,22,1,109.56792,18.28479,1765
7678,B34415F599F0ED7D1A073EE314A60B9B,60041,3,7,4,109.39889,18.31944,1121
7679,B34415F599F0ED7D1A073EE314A60B9B,31671,7,23,16,109.38965,18.29813,1068
7724,EC4B90EDBF35256FDB4D4F8B87DB8A04,31071,0,8,8,109.58257,18.28458,1815
7725,EC4B90EDBF35256FDB4D4F8B87DB8A04,30854,10,11,1,109.56889,18.27076,1763
7726,EC4B90EDBF35256FDB4D4F8B87DB8A04,31071,12,16,4,109.58257,18.28458,1815
7727,EC4B90EDBF35256FDB4D4F8B87DB8A04,30721,18,20,2,109.51597,18.28257,1565
7734,36240C8151C140450D90485BA4232298,30861,0,7,7,109.52722,18.22743,1606
7735,36240C8151C140450D90485BA4232298,31145,12,14,2,109.20431,18.30479,369
7742,E0A24740E2C54F3B77DB561A91D2BED7,31821,0,8,8,109.51181,18.24924,1559
7743,E0A24740E2C54F3B77DB561A91D2BED7,30251,8,17,9,109.50611,18.26653,1512
7744,E0A24740E2C54F3B77DB561A91D2BED7,30371,18,22,4,109.51,18.24771,1559
7752,DFEFB1CD7965FB8E2BDF1B532ED92233,30854,16,17,1,109.56889,18.27076,1763
7753,DFEFB1CD7965FB8E2BDF1B532ED92233,31931,19,21,2,109.54771,18.29403,1667
7788,28C2CCAEBA502B987F7F8A800965B87A,31521,7,11,4,109.51458,18.22542,1555
7789,28C2CCAEBA502B987F7F8A800965B87A,31521,13,14,1,109.51458,18.22542,1555
7790,28C2CCAEBA502B987F7F8A800965B87A,60221,17,20,3,109.52569,18.29188,1616
7791,28C2CCAEBA502B987F7F8A800965B87A,60381,21,22,1,109.5241,18.22458,1605
7831,90AC20E6CC0B4ABA3A4EAC5C3086C030,30201,0,8,8,109.4909,18.26465,1462
7832,90AC20E6CC0B4ABA3A4EAC5C3086C030,31031,12,15,3,109.49979,18.25382,1510
7833,90AC20E6CC0B4ABA3A4EAC5C3086C030,30171,16,17,1,109.48458,18.27139,1463
7940,5994FF6B1B98D57BC00DD456224D499E,31521,19,20,1,109.51458,18.22542,1555
7941,5994FF6B1B98D57BC00DD456224D499E,30271,22,23,1,109.49132,18.23153,1456
7971,967E548F53382C36FB0D7FF12F6A99E7,31531,0,6,6,109.49583,18.25972,1461
7972,967E548F53382C36FB0D7FF12F6A99E7,60331,6,8,2,109.505,18.26507,1512
7973,967E548F53382C36FB0D7FF12F6A99E7,31531,8,11,3,109.49583,18.25972,1461
7974,967E548F53382C36FB0D7FF12F6A99E7,60131,13,15,2,109.49819,18.24778,1509
7975,967E548F53382C36FB0D7FF12F6A99E7,60331,17,18,1,109.505,18.26507,1512
7976,967E548F53382C36FB0D7FF12F6A99E7,30201,18,19,1,109.4909,18.26465,1462
7977,967E548F53382C36FB0D7FF12F6A99E7,31531,21,22,1,109.49583,18.25972,1461
8046,E218C587552A5DADC05C4E69685FE374,30854,0,11,11,109.56889,18.27076,1763
8047,E218C587552A5DADC05C4E69685FE374,31561,15,16,1,109.56792,18.28479,1765
8048,E218C587552A5DADC05C4E69685FE374,30854,20,22,2,109.56889,18.27076,1763
8053,4C7F249ED8CAEDF4D8459D40AD053582,60631,18,19,1,109.57778,18.27583,1814
8054,4C7F249ED8CAEDF4D8459D40AD053582,30854,20,22,2,109.56889,18.27076,1763
8064,45A05D92AE671B83CC23996132794DAB,30854,1,6,5,109.56889,18.27076,1763
8065,45A05D92AE671B83CC23996132794DAB,31071,8,9,1,109.58257,18.28458,1815
8066,45A05D92AE671B83CC23996132794DAB,30854,11,15,4,109.56889,18.27076,1763
8067,45A05D92AE671B83CC23996132794DAB,31071,16,21,5,109.58257,18.28458,1815
8095,1D8B814EC83D52D7C5F3FED99C129EE0,30854,0,7,7,109.56889,18.27076,1763
8096,1D8B814EC83D52D7C5F3FED99C129EE0,38283,10,13,3,109.62229,18.22618,1956
8097,1D8B814EC83D52D7C5F3FED99C129EE0,38271,17,19,2,109.62632,18.23049,1956
8098,1D8B814EC83D52D7C5F3FED99C129EE0,30854,22,23,1,109.56889,18.27076,1763
8156,B855550E4CC0B884D3E498DD555D8030,60541,0,8,8,109.4084,18.29208,1167
8157,B855550E4CC0B884D3E498DD555D8030,38102,9,10,1,109.40875,18.29111,1166
8158,B855550E4CC0B884D3E498DD555D8030,31031,13,15,2,109.49979,18.25382,1510
8159,B855550E4CC0B884D3E498DD555D8030,38102,16,19,3,109.40875,18.29111,1166
8160,B855550E4CC0B884D3E498DD555D8030,60541,22,23,1,109.4084,18.29208,1167
8212,2C71D4EA311A341740E13C6213E06050,30361,17,19,2,109.50347,18.24,1508
8213,2C71D4EA311A341740E13C6213E06050,30861,19,22,3,109.52722,18.22743,1606
8331,452F0FF6BC36839041DCBEF2292D6E55,30861,0,10,10,109.52722,18.22743,1606
8359,C462628FF36F8FF2D0B7493E6DDA38BB,30661,4,12,8,109.37028,18.24361,1008
8360,C462628FF36F8FF2D0B7493E6DDA38BB,60411,15,17,2,109.32514,18.30854,869
8361,C462628FF36F8FF2D0B7493E6DDA38BB,30661,19,23,4,109.37028,18.24361,1008
8384,72839B8F6256E6FF641405D4832BF569,31071,0,14,14,109.58257,18.28458,1815
8385,72839B8F6256E6FF641405D4832BF569,30854,14,18,4,109.56889,18.27076,1763
8386,72839B8F6256E6FF641405D4832BF569,31561,18,20,2,109.56792,18.28479,1765
8387,F8D799D9161B0143E0D71C40472A357E,30071,1,15,14,109.52819,18.30472,1619
8388,F8D799D9161B0143E0D71C40472A357E,30071,16,23,7,109.52819,18.30472,1619
8395,599AFAF71D30C85AA4E0085C43FF5E03,30051,14,15,1,109.48917,18.21215,1453
8396,599AFAF71D30C85AA4E0085C43FF5E03,31041,15,18,3,109.50278,18.23701,1507
8397,599AFAF71D30C85AA4E0085C43FF5E03,38891,18,20,2,109.51486,18.24118,1558
8407,C0CA4E58B15F58D7F48B8BEF10CEB35A,30854,0,6,6,109.56889,18.27076,1763
8408,C0CA4E58B15F58D7F48B8BEF10CEB35A,60631,8,9,1,109.57778,18.27583,1814
8414,E7DB0F55EDE33BB4C08C98B80B7173BF,30921,0,6,6,109.53903,18.29451,1667
8416,E7DB0F55EDE33BB4C08C98B80B7173BF,60371,13,15,2,109.53063,18.30056,1618
8417,E7DB0F55EDE33BB4C08C98B80B7173BF,31181,19,20,1,109.50382,18.24813,1509
8418,E7DB0F55EDE33BB4C08C98B80B7173BF,60371,20,22,2,109.53063,18.30056,1618
8419,7BF65E5054DA81A230AB5423620158E1,60631,1,7,6,109.57778,18.27583,1814
8420,7BF65E5054DA81A230AB5423620158E1,30854,7,22,15,109.56889,18.27076,1763
8530,D26DFF9CD872B22A8694735583552102,30201,17,23,6,109.4909,18.26465,1462
8577,C6C3BC01E542B810EF853FEEB6C81198,31206,0,2,2,109.50819,18.23549,1507
8578,C6C3BC01E542B810EF853FEEB6C81198,60361,4,17,13,109.51938,18.29681,1567
8579,C6C3BC01E542B810EF853FEEB6C81198,31561,20,21,1,109.56792,18.28479,1765
8602,E298B72756164833AF59D588A2ED08C0,30854,8,10,2,109.56889,18.27076,1763
8603,E298B72756164833AF59D588A2ED08C0,31945,10,12,2,109.58021,18.29403,1817
8604,E298B72756164833AF59D588A2ED08C0,30854,15,16,1,109.56889,18.27076,1763
8605,E298B72756164833AF59D588A2ED08C0,60631,16,17,1,109.57778,18.27583,1814
8606,E298B72756164833AF59D588A2ED08C0,30371,19,21,2,109.51,18.24771,1559
8610,6C0260646767B781577B5B8CE2471E51,38484,0,2,2,109.53028,18.31528,1620
8611,6C0260646767B781577B5B8CE2471E51,30561,6,12,6,109.52778,18.31938,1621
8612,6C0260646767B781577B5B8CE2471E51,38484,12,22,10,109.53028,18.31528,1620
8625,52626520133C58C019E9712FB19D3224,39091,14,15,1,109.50097,18.25222,1510
8626,52626520133C58C019E9712FB19D3224,38171,19,23,4,109.50799,18.28139,1515
8629,D372DBE97920212E2B5B6136E2BCFBCE,60161,0,11,11,109.49174,18.26181,1461
8630,D372DBE97920212E2B5B6136E2BCFBCE,30341,12,13,1,109.3625,18.29167,966
8631,D372DBE97920212E2B5B6136E2BCFBCE,61011,18,19,1,109.60653,18.19076,1900
8632,D372DBE97920212E2B5B6136E2BCFBCE,31421,22,23,1,109.55382,18.22347,1705
8633,39D4F14340B4650E084697607335F122,30161,0,1,1,109.50042,18.24389,1508
8634,39D4F14340B4650E084697607335F122,39101,1,6,5,109.50132,18.24931,1509
8635,39D4F14340B4650E084697607335F122,31031,9,10,1,109.49979,18.25382,1510
8660,63B5E489F3503F8EC6E40A38F9D2117C,60241,3,7,4,109.53319,18.28667,1616
8661,63B5E489F3503F8EC6E40A38F9D2117C,60171,9,14,5,109.51292,18.30694,1569
8695,8DEBA8F3DD446F0F0680296AB7E73431,30764,6,11,5,109.45806,18.29486,1367
8696,8DEBA8F3DD446F0F0680296AB7E73431,60441,12,23,11,109.46792,18.28604,1366
8734,8AABF5FDF2B06EB445749240A3894969,31071,3,13,10,109.58257,18.28458,1815
8735,8AABF5FDF2B06EB445749240A3894969,31851,15,17,2,109.71736,18.29007,2316
8736,8AABF5FDF2B06EB445749240A3894969,39181,20,22,2,109.55153,18.28035,1715
8772,3F197D0DAA06984EE5CE0801FD1B5C1F,30351,7,10,3,109.41701,18.29292,1217
8773,3F197D0DAA06984EE5CE0801FD1B5C1F,31201,12,13,1,109.51042,18.23819,1558
8774,3F197D0DAA06984EE5CE0801FD1B5C1F,60381,14,17,3,109.5241,18.22458,1605
8775,3F197D0DAA06984EE5CE0801FD1B5C1F,30361,17,20,3,109.50347,18.24,1508
8792,A0D67E4ED0CFB18CCA0714B3A5A7DEED,30711,15,18,3,109.50271,18.25347,1510
8818,CA373FFAFD7EFAD5EEFC32965095EB00,39151,3,6,3,109.49875,18.25097,1510
8819,CA373FFAFD7EFAD5EEFC32965095EB00,60201,6,8,2,109.5041,18.2509,1510
8820,CA373FFAFD7EFAD5EEFC32965095EB00,30561,9,11,2,109.52778,18.31938,1621
8821,CA373FFAFD7EFAD5EEFC32965095EB00,30711,12,15,3,109.50271,18.25347,1510
8822,CA373FFAFD7EFAD5EEFC32965095EB00,38241,15,16,1,109.54111,18.30542,1669
8823,CA373FFAFD7EFAD5EEFC32965095EB00,31061,19,20,1,109.53333,18.23257,1607
8827,E8BAAF476E8FE57075BAB1A8D4FF1780,30891,0,1,1,109.59431,18.28389,1865
8828,E8BAAF476E8FE57075BAB1A8D4FF1780,31945,1,4,3,109.58021,18.29403,1817
8829,E8BAAF476E8FE57075BAB1A8D4FF1780,31071,5,6,1,109.58257,18.28458,1815
8830,E8BAAF476E8FE57075BAB1A8D4FF1780,30854,15,17,2,109.56889,18.27076,1763
8831,E8BAAF476E8FE57075BAB1A8D4FF1780,30951,17,18,1,109.56208,18.25667,1761
8832,E8BAAF476E8FE57075BAB1A8D4FF1780,30181,19,21,2,109.51597,18.23313,1557
8833,BC4D9B63CA4001C365CE5CB9219EAEA2,30711,18,20,2,109.50271,18.25347,1510
8834,BC4D9B63CA4001C365CE5CB9219EAEA2,30051,22,23,1,109.48917,18.21215,1453
8835,EBB8C4DC19F3856E93F775E3331F31B3,30081,14,17,3,109.50243,18.26632,1512
8836,EBB8C4DC19F3856E93F775E3331F31B3,38291,18,19,1,109.51618,18.24313,1558
8837,EBB8C4DC19F3856E93F775E3331F31B3,31171,19,21,2,109.50938,18.24917,1559
8838,EBB8C4DC19F3856E93F775E3331F31B3,60331,21,22,1,109.505,18.26507,1512
8839,B1CA398CBCC08726B10214389CB30840,48574,17,20,3,109.48931,18.28458,1465
8840,B1CA398CBCC08726B10214389CB30840,60501,21,22,1,109.48701,18.29021,1466
8849,30CE72A519D49881F23B8123486E3A02,30661,2,7,5,109.37028,18.24361,1008
8850,30CE72A519D49881F23B8123486E3A02,60411,7,8,1,109.32514,18.30854,869
8851,30CE72A519D49881F23B8123486E3A02,31471,11,12,1,109.34583,18.29563,917
8852,30CE72A519D49881F23B8123486E3A02,60411,12,13,1,109.32514,18.30854,869
8898,DF46068B3DCC89EB9FA3327E53A99A8C,39101,0,1,1,109.50132,18.24931,1509
8899,DF46068B3DCC89EB9FA3327E53A99A8C,30161,1,6,5,109.50042,18.24389,1508
8900,DF46068B3DCC89EB9FA3327E53A99A8C,31031,6,8,2,109.49979,18.25382,1510
8901,DF46068B3DCC89EB9FA3327E53A99A8C,30361,9,10,1,109.50347,18.24,1508
8902,DF46068B3DCC89EB9FA3327E53A99A8C,30361,12,13,1,109.50347,18.24,1508
8903,DF46068B3DCC89EB9FA3327E53A99A8C,31851,17,23,6,109.71736,18.29007,2316
8929,134447BAF73045598D228AAEE014B4B8,30854,1,15,14,109.56889,18.27076,1763
8930,134447BAF73045598D228AAEE014B4B8,60221,16,20,4,109.52569,18.29188,1616
8931,134447BAF73045598D228AAEE014B4B8,30854,21,23,2,109.56889,18.27076,1763
8951,2E6ECF3A2D9F0F99E9DEBA2062D89A0D,31071,14,18,4,109.58257,18.28458,1815
8952,2E6ECF3A2D9F0F99E9DEBA2062D89A0D,39183,20,21,1,109.55542,18.28208,1715
8999,AEA7DA64082D7A925B68DE7CFFD60270,30854,0,7,7,109.56889,18.27076,1763
9000,AEA7DA64082D7A925B68DE7CFFD60270,38085,10,21,11,109.6291,18.23625,2007
9017,0E0F371A7D8562A765810CFB477294DF,30951,0,5,5,109.56208,18.25667,1761
9018,0E0F371A7D8562A765810CFB477294DF,30851,7,8,1,109.5616,18.27396,1713
9019,0E0F371A7D8562A765810CFB477294DF,30951,10,11,1,109.56208,18.25667,1761
9020,0E0F371A7D8562A765810CFB477294DF,30851,13,15,2,109.5616,18.27396,1713
9021,0E0F371A7D8562A765810CFB477294DF,30861,18,20,2,109.52722,18.22743,1606
9022,FC9B7FD2465F862BBF1D529A5948B21C,60161,0,7,7,109.49174,18.26181,1461
9023,FC9B7FD2465F862BBF1D529A5948B21C,38291,8,9,1,109.51618,18.24313,1558
9033,E4C7AB656E412C7E33554D18277C9478,30711,20,21,1,109.50271,18.25347,1510
9034,E4C7AB656E412C7E33554D18277C9478,60291,22,23,1,109.50826,18.24639,1509
9082,B8E910702A81A5AB2DDCDCC354E4FC08,38162,0,9,9,109.43944,18.28889,1266
9083,B8E910702A81A5AB2DDCDCC354E4FC08,31701,9,11,2,109.44132,18.28833,1266
9084,B8E910702A81A5AB2DDCDCC354E4FC08,38361,13,22,9,109.43667,18.29201,1267
9104,0ECAA77148BC3CC3B9A4A65F40F94BCA,30711,12,18,6,109.50271,18.25347,1510
9137,1B6EBBFF3B9D8A3E18753343B6A29EAE,31071,0,8,8,109.58257,18.28458,1815
9138,1B6EBBFF3B9D8A3E18753343B6A29EAE,31561,9,10,1,109.56792,18.28479,1765
9139,1B6EBBFF3B9D8A3E18753343B6A29EAE,30851,10,11,1,109.5616,18.27396,1713
9140,1B6EBBFF3B9D8A3E18753343B6A29EAE,31071,11,14,3,109.58257,18.28458,1815
9141,1B6EBBFF3B9D8A3E18753343B6A29EAE,30851,15,17,2,109.5616,18.27396,1713
9142,1B6EBBFF3B9D8A3E18753343B6A29EAE,31071,19,23,4,109.58257,18.28458,1815
9171,519F735EBD513C9F3D65CD2441510E18,31421,18,20,2,109.55382,18.22347,1705
9172,519F735EBD513C9F3D65CD2441510E18,30181,20,22,2,109.51597,18.23313,1557
9194,4D4289AE0DFBF4B5C79A47559DC2EBDD,30854,3,17,14,109.56889,18.27076,1763
9195,4D4289AE0DFBF4B5C79A47559DC2EBDD,60381,21,22,1,109.5241,18.22458,1605
9209,68DBE0B52FD0AB95F1DD47068FD7847F,39111,0,5,5,109.5191,18.22597,1555
9210,68DBE0B52FD0AB95F1DD47068FD7847F,31521,7,9,2,109.51458,18.22542,1555
9211,68DBE0B52FD0AB95F1DD47068FD7847F,38291,10,12,2,109.51618,18.24313,1558
9212,68DBE0B52FD0AB95F1DD47068FD7847F,31521,13,14,1,109.51458,18.22542,1555
9213,68DBE0B52FD0AB95F1DD47068FD7847F,60311,17,23,6,109.52097,18.24319,1558
9232,A8ABE4987042D12DD458C81CFD9663F5,38127,0,7,7,109.50833,18.27222,1513
9233,A8ABE4987042D12DD458C81CFD9663F5,30771,9,10,1,109.49938,18.26042,1511
9234,A8ABE4987042D12DD458C81CFD9663F5,30421,12,14,2,109.50021,18.25861,1511
9235,A8ABE4987042D12DD458C81CFD9663F5,30771,16,23,7,109.49938,18.26042,1511
9248,29064106BAD1EF15D718EE782B958C59,31071,0,6,6,109.58257,18.28458,1815
9249,29064106BAD1EF15D718EE782B958C59,30854,11,20,9,109.56889,18.27076,1763
9331,6AE576B33B9BEDB98E30FC866EE1D31C,30421,18,20,2,109.50021,18.25861,1511
9332,6AE576B33B9BEDB98E30FC866EE1D31C,31861,20,22,2,109.49042,18.27549,1464
9346,066CC6CBB5ADF978A93AF5D0C3292806,30071,0,5,5,109.52819,18.30472,1619
9347,066CC6CBB5ADF978A93AF5D0C3292806,31931,6,7,1,109.54771,18.29403,1667
9348,066CC6CBB5ADF978A93AF5D0C3292806,60211,8,9,1,109.63549,18.26049,2011
9349,066CC6CBB5ADF978A93AF5D0C3292806,31931,12,14,2,109.54771,18.29403,1667
9374,CDB953050813C58D32D89D5658BB96B4,30071,19,20,1,109.52819,18.30472,1619
9375,CDB953050813C58D32D89D5658BB96B4,30071,21,23,2,109.52819,18.30472,1619
9412,F8D86007BFB39D8467310AC174395069,30721,0,10,10,109.51597,18.28257,1565
9413,F8D86007BFB39D8467310AC174395069,30854,13,15,2,109.56889,18.27076,1763
9414,F8D86007BFB39D8467310AC174395069,30721,19,21,2,109.51597,18.28257,1565
9428,B175A0347ABEEA30E818C5CCD25E280F,30821,12,17,5,109.43681,18.33639,1274
9429,B175A0347ABEEA30E818C5CCD25E280F,60011,20,22,2,109.48965,18.30222,1468
9450,46D10B971C10D2856504DC61068F66E7,30071,0,8,8,109.52819,18.30472,1619
9451,46D10B971C10D2856504DC61068F66E7,31091,9,11,2,109.41201,18.31222,1170
9452,46D10B971C10D2856504DC61068F66E7,30071,13,15,2,109.52819,18.30472,1619
9480,90D91A493F9482486DCC3B27CF3F61EE,30854,6,8,2,109.56889,18.27076,1763
9481,90D91A493F9482486DCC3B27CF3F61EE,31071,8,9,1,109.58257,18.28458,1815
9482,90D91A493F9482486DCC3B27CF3F61EE,30854,13,14,1,109.56889,18.27076,1763
9493,EA4EEEA6F324C3F08DBAE63BA2B33BB6,60131,14,16,2,109.49819,18.24778,1509
9494,EA4EEEA6F324C3F08DBAE63BA2B33BB6,30084,18,22,4,109.50118,18.26972,1513
9522,299AC9422F298CCC4ED16594B565B2CA,30711,15,16,1,109.50271,18.25347,1510
9542,BD5D5103B08534F20AF53FB58E9A43CA,38241,2,8,6,109.54111,18.30542,1669
9543,BD5D5103B08534F20AF53FB58E9A43CA,31931,9,10,1,109.54771,18.29403,1667
9544,BD5D5103B08534F20AF53FB58E9A43CA,38171,14,16,2,109.50799,18.28139,1515
9545,BD5D5103B08534F20AF53FB58E9A43CA,30281,16,18,2,109.50597,18.27583,1514
9546,BD5D5103B08534F20AF53FB58E9A43CA,31931,21,23,2,109.54771,18.29403,1667
9630,5A4EB554D34C333CED1A7004ABAA2EDE,60401,18,19,1,109.47444,18.27583,1414
9631,5A4EB554D34C333CED1A7004ABAA2EDE,38903,21,23,2,109.39229,18.29243,1117
9681,4A6E6277F47F7550E2618B9C1ADC3166,30361,14,15,1,109.50347,18.24,1508
9682,4A6E6277F47F7550E2618B9C1ADC3166,30361,19,23,4,109.50347,18.24,1508
9732,D4EE8E1A4C04A1FF0596E4221D0B8B42,31071,1,8,7,109.58257,18.28458,1815
9733,D4EE8E1A4C04A1FF0596E4221D0B8B42,30854,8,18,10,109.56889,18.27076,1763
9734,D4EE8E1A4C04A1FF0596E4221D0B8B42,31421,19,21,2,109.55382,18.22347,1705
9741,AB9A3BD8E440D93680572376579E34E6,38154,0,6,6,109.5266,18.28278,1615
9742,AB9A3BD8E440D93680572376579E34E6,31201,10,15,5,109.51042,18.23819,1558
9743,AB9A3BD8E440D93680572376579E34E6,38154,18,22,4,109.5266,18.28278,1615
9764,5A888DC7A3AA300CC584D9862C5384A1,60361,0,2,2,109.51938,18.29681,1567
9765,5A888DC7A3AA300CC584D9862C5384A1,60221,2,4,2,109.52569,18.29188,1616
9766,5A888DC7A3AA300CC584D9862C5384A1,60361,6,7,1,109.51938,18.29681,1567
9767,5A888DC7A3AA300CC584D9862C5384A1,39181,9,10,1,109.55153,18.28035,1715
9768,5A888DC7A3AA300CC584D9862C5384A1,39183,12,14,2,109.55542,18.28208,1715
9769,5A888DC7A3AA300CC584D9862C5384A1,38127,18,20,2,109.50833,18.27222,1513
9770,5A888DC7A3AA300CC584D9862C5384A1,30421,21,23,2,109.50021,18.25861,1511
9784,875F4B80762D0E664890361D764F907D,60081,0,7,7,109.51097,18.22639,1556
9785,875F4B80762D0E664890361D764F907D,30571,8,18,10,109.50243,18.21861,1504
9786,875F4B80762D0E664890361D764F907D,60081,20,23,3,109.51097,18.22639,1556
9863,1EB913BACF9C05B44A304AC858725E50,31864,0,9,9,109.49014,18.28333,1465
9864,1EB913BACF9C05B44A304AC858725E50,30421,12,13,1,109.50021,18.25861,1511
9865,1EB913BACF9C05B44A304AC858725E50,31206,14,15,1,109.50819,18.23549,1507
9866,1EB913BACF9C05B44A304AC858725E50,30151,17,19,2,109.50986,18.25083,1560
9867,1EB913BACF9C05B44A304AC858725E50,31864,21,23,2,109.49014,18.28333,1465
9903,5334281F127888E8146BE3F4F35A8EA8,30351,0,11,11,109.41701,18.29292,1217
9994,8E244E94833DBF281BCBFE2F4A36E102,60641,0,8,8,109.53854,18.2359,1657
9995,8E244E94833DBF281BCBFE2F4A36E102,31671,9,10,1,109.38965,18.29813,1068
9996,8E244E94833DBF281BCBFE2F4A36E102,60641,11,23,12,109.53854,18.2359,1657
10007,17D13F6A66037B54FAB5668CDC734401,60311,11,16,5,109.52097,18.24319,1558
10038,2C222853895C7F3CD32A59ECC6E42FBB,30251,15,21,6,109.50611,18.26653,1512
10039,2C222853895C7F3CD32A59ECC6E42FBB,31864,21,23,2,109.49014,18.28333,1465
10063,AECF79630BEEC0EA88FD59B92FCAE378,30854,2,4,2,109.56889,18.27076,1763
10064,AECF79630BEEC0EA88FD59B92FCAE378,30891,4,5,1,109.59431,18.28389,1865
10065,AECF79630BEEC0EA88FD59B92FCAE378,30854,6,7,1,109.56889,18.27076,1763
10066,3A145BF69DF902E1EF820C356086EF54,60381,0,7,7,109.5241,18.22458,1605
10067,3A145BF69DF902E1EF820C356086EF54,38071,8,9,1,109.40722,18.30938,1169
10068,3A145BF69DF902E1EF820C356086EF54,60631,10,13,3,109.57778,18.27583,1814
10069,3A145BF69DF902E1EF820C356086EF54,30854,13,15,2,109.56889,18.27076,1763
10070,8F82FA1F1481A587FFA3C3105705BF6F,60631,0,7,7,109.57778,18.27583,1814
10071,8F82FA1F1481A587FFA3C3105705BF6F,30854,9,10,1,109.56889,18.27076,1763
10079,36BCA39777B9D1E703C1404CDA6A45E7,30511,1,8,7,109.51069,18.24208,1558
10080,36BCA39777B9D1E703C1404CDA6A45E7,30511,9,15,6,109.51069,18.24208,1558
10081,36BCA39777B9D1E703C1404CDA6A45E7,38153,15,18,3,109.51819,18.25736,1561
10082,36BCA39777B9D1E703C1404CDA6A45E7,30511,19,21,2,109.51069,18.24208,1558
10093,EE20B3A69AE234B0D2D16E1DB1ACB48E,30111,0,9,9,109.47583,18.30542,1419
10094,EE20B3A69AE234B0D2D16E1DB1ACB48E,31471,10,13,3,109.34583,18.29563,917
10095,EE20B3A69AE234B0D2D16E1DB1ACB48E,31781,15,16,1,109.19847,18.2975,367
10096,EE20B3A69AE234B0D2D16E1DB1ACB48E,60641,19,20,1,109.53854,18.2359,1657
10148,9F491EEC0F2450C8C4B42D79DC4B8D6F,60381,14,15,1,109.5241,18.22458,1605
10149,9F491EEC0F2450C8C4B42D79DC4B8D6F,31521,18,22,4,109.51458,18.22542,1555
10188,8621CFDF1B89A83351494618C53D033F,30851,1,6,5,109.5616,18.27396,1713
10189,8621CFDF1B89A83351494618C53D033F,31071,6,7,1,109.58257,18.28458,1815
10190,8621CFDF1B89A83351494618C53D033F,39181,8,15,7,109.55153,18.28035,1715
10191,8621CFDF1B89A83351494618C53D033F,31071,15,16,1,109.58257,18.28458,1815
10192,8621CFDF1B89A83351494618C53D033F,39181,18,21,3,109.55153,18.28035,1715
10194,CCAE44B3710517001962C25A64C7F320,30161,7,8,1,109.50042,18.24389,1508
10284,4D190727D19452A2A511EC780EEEE090,30921,1,8,7,109.53903,18.29451,1667
10285,4D190727D19452A2A511EC780EEEE090,31931,10,22,12,109.54771,18.29403,1667
10295,2CCD2660E589B7FF2F231B9957C903F7,31571,0,10,10,109.61563,18.23326,1957
10313,8B3125BACE32612AE7F9DC5599DC75E6,60081,0,7,7,109.51097,18.22639,1556
10314,8B3125BACE32612AE7F9DC5599DC75E6,60054,9,10,1,109.3016,18.31229,770
10315,8B3125BACE32612AE7F9DC5599DC75E6,30661,15,17,2,109.37028,18.24361,1008
10316,8B3125BACE32612AE7F9DC5599DC75E6,30731,20,23,3,109.50944,18.22306,1555
10397,EB316856896788EC8FD871E122E95728,30931,0,6,6,109.55653,18.32722,1722
10398,EB316856896788EC8FD871E122E95728,31811,9,16,7,109.54201,18.31806,1671
10399,EB316856896788EC8FD871E122E95728,30701,16,23,7,109.59313,18.32007,1871
10400,74A9CCA48CD6C2DA9FC7DFDB8817D50B,31945,0,3,3,109.58021,18.29403,1817
10401,74A9CCA48CD6C2DA9FC7DFDB8817D50B,31071,3,6,3,109.58257,18.28458,1815
10476,CD3BCBAB8571FB81953C842A434E5DB8,30771,0,4,4,109.49938,18.26042,1511
10477,CD3BCBAB8571FB81953C842A434E5DB8,30854,7,12,5,109.56889,18.27076,1763
10537,38F4BE4A665B515DC81C1A78A906BDC2,60371,2,11,9,109.53063,18.30056,1618
10538,38F4BE4A665B515DC81C1A78A906BDC2,31931,12,19,7,109.54771,18.29403,1667
10539,38F4BE4A665B515DC81C1A78A906BDC2,60371,21,23,2,109.53063,18.30056,1618
10550,632A9EB46E40EB8DE8C99AAD5A0CDFB2,31181,0,2,2,109.50382,18.24813,1509
10551,632A9EB46E40EB8DE8C99AAD5A0CDFB2,30711,2,13,11,109.50271,18.25347,1510
10569,1D22B80919ED7BC636AC7BE0DCB27647,31021,0,7,7,109.49021,18.27,1463
10570,1D22B80919ED7BC636AC7BE0DCB27647,60411,11,12,1,109.32514,18.30854,869
10571,1D22B80919ED7BC636AC7BE0DCB27647,31471,17,19,2,109.34583,18.29563,917
10572,1D22B80919ED7BC636AC7BE0DCB27647,30661,20,21,1,109.37028,18.24361,1008
10601,706B8E0F0F5D1C9FC2F8EBB2574EE89F,31461,0,3,3,109.5091,18.25389,1510
10602,706B8E0F0F5D1C9FC2F8EBB2574EE89F,30711,3,5,2,109.50271,18.25347,1510
10603,706B8E0F0F5D1C9FC2F8EBB2574EE89F,31461,5,8,3,109.5091,18.25389,1510
10604,706B8E0F0F5D1C9FC2F8EBB2574EE89F,30711,8,11,3,109.50271,18.25347,1510
10605,706B8E0F0F5D1C9FC2F8EBB2574EE89F,38297,11,13,2,109.52576,18.24965,1609
10606,706B8E0F0F5D1C9FC2F8EBB2574EE89F,30711,14,23,9,109.50271,18.25347,1510
10617,EBD16061EA20EE33D9344D33735E5205,38891,0,7,7,109.51486,18.24118,1558
10618,EBD16061EA20EE33D9344D33735E5205,38291,7,19,12,109.51618,18.24313,1558
10619,EBD16061EA20EE33D9344D33735E5205,60371,19,22,3,109.53063,18.30056,1618
10631,34A1BA5A97F90C4ABB34EDC7004774A9,30851,7,12,5,109.5616,18.27396,1713
10632,34A1BA5A97F90C4ABB34EDC7004774A9,31071,13,15,2,109.58257,18.28458,1815
10633,34A1BA5A97F90C4ABB34EDC7004774A9,30851,20,23,3,109.5616,18.27396,1713
10634,D00EAD9144E7A4027F84D32EB5112DB4,31931,2,16,14,109.54771,18.29403,1667
10635,D00EAD9144E7A4027F84D32EB5112DB4,30921,17,18,1,109.53903,18.29451,1667
10636,D00EAD9144E7A4027F84D32EB5112DB4,31931,19,22,3,109.54771,18.29403,1667
10637,3C6B416FA80A7A03E14FC0317D60CB00,31071,2,7,5,109.58257,18.28458,1815
10638,3C6B416FA80A7A03E14FC0317D60CB00,30854,10,23,13,109.56889,18.27076,1763
10689,5264833F0013AE6B294396000613EF89,60201,0,9,9,109.5041,18.2509,1510
10690,5264833F0013AE6B294396000613EF89,30901,12,13,1,109.27597,18.3134,670
10691,5264833F0013AE6B294396000613EF89,60581,14,16,2,109.59785,18.29931,1868
10702,2122DEFC32157A6D7A592FF94F389FA0,30391,0,7,7,109.4975,18.27118,1513
10703,2122DEFC32157A6D7A592FF94F389FA0,31021,8,9,1,109.49021,18.27,1463
10704,2122DEFC32157A6D7A592FF94F389FA0,30391,13,14,1,109.4975,18.27118,1513
10705,2122DEFC32157A6D7A592FF94F389FA0,31351,18,19,1,109.4959,18.28417,1465
10706,2122DEFC32157A6D7A592FF94F389FA0,30391,20,23,3,109.4975,18.27118,1513
10714,ADAB51A6D99BADC8222FC392D72ADA01,60281,0,19,19,109.51743,18.25924,1561
10715,ADAB51A6D99BADC8222FC392D72ADA01,31261,21,23,2,109.51174,18.2466,1559
10716,D9AB4DDFD70E0B215B409CCDE9543997,31101,0,3,3,109.65389,18.23403,2057
10717,D9AB4DDFD70E0B215B409CCDE9543997,38052,3,11,8,109.62618,18.23042,1956
10718,D9AB4DDFD70E0B215B409CCDE9543997,60594,15,17,2,109.62694,18.22799,1956
10733,0547C7536E43628EF24935F0C2BF5E2C,31931,7,10,3,109.54771,18.29403,1667
10734,0547C7536E43628EF24935F0C2BF5E2C,30921,11,20,9,109.53903,18.29451,1667
10745,ACDEAAF45B65DE48CF80A48DBD3C775E,31071,1,5,4,109.58257,18.28458,1815
10746,ACDEAAF45B65DE48CF80A48DBD3C775E,30854,7,22,15,109.56889,18.27076,1763
10794,DB4DF566D4757FF3BB488F82DE126248,30851,9,10,1,109.5616,18.27396,1713
10795,DB4DF566D4757FF3BB488F82DE126248,31561,13,15,2,109.56792,18.28479,1765
10796,DB4DF566D4757FF3BB488F82DE126248,60351,19,23,4,109.58403,18.28958,1816
10800,A4132C7C24D4F6CFBC6C091695995585,30631,0,7,7,109.34382,18.32778,922
10801,A4132C7C24D4F6CFBC6C091695995585,30341,8,9,1,109.3625,18.29167,966
10802,A4132C7C24D4F6CFBC6C091695995585,30631,11,14,3,109.34382,18.32778,922
10803,A4132C7C24D4F6CFBC6C091695995585,31691,14,17,3,109.36604,18.3075,1019
10804,A4132C7C24D4F6CFBC6C091695995585,30631,19,23,4,109.34382,18.32778,922
10816,61737F015E2BA5FF98146651AD724408,30341,9,11,2,109.3625,18.29167,966
10817,61737F015E2BA5FF98146651AD724408,30661,11,15,4,109.37028,18.24361,1008
10818,61737F015E2BA5FF98146651AD724408,31271,18,20,2,109.48958,18.26257,1462
10828,CB44FE843228066922623C4A2B161A4C,60504,1,9,8,109.47917,18.28903,1416
10829,CB44FE843228066922623C4A2B161A4C,30081,13,15,2,109.50243,18.26632,1512
10837,0312B43ACF9ED1D8304E325E851AEE29,39181,9,11,2,109.55153,18.28035,1715
10838,0312B43ACF9ED1D8304E325E851AEE29,30851,12,14,2,109.5616,18.27396,1713
10839,0312B43ACF9ED1D8304E325E851AEE29,31561,15,16,1,109.56792,18.28479,1765
10840,0312B43ACF9ED1D8304E325E851AEE29,30851,17,23,6,109.5616,18.27396,1713
10862,4BA143AD44480D9BEACA2836C34FF531,60401,4,5,1,109.47444,18.27583,1414
10863,4BA143AD44480D9BEACA2836C34FF531,60231,7,11,4,109.49903,18.21972,1504
10886,33F9415FD6B58B5A945236B41FCD67FA,60381,0,13,13,109.5241,18.22458,1605
10887,33F9415FD6B58B5A945236B41FCD67FA,31521,14,23,9,109.51458,18.22542,1555
10903,1A1509AC6E667B603EE3773D1273B7B0,38541,15,19,4,109.73715,18.34875,2426
10904,1A1509AC6E667B603EE3773D1273B7B0,60121,19,20,1,109.74507,18.37472,2430
10950,C8135D3E403B7CC96352A41CBCD291A7,38241,1,15,14,109.54111,18.30542,1669
10951,C8135D3E403B7CC96352A41CBCD291A7,31861,18,20,2,109.49042,18.27549,1464
10983,9BB6AFF9C9C200381B5723FC341A4F0D,60121,19,21,2,109.74507,18.37472,2430
10996,41D4EB5552A7A416EEB26FAA30F55A4B,39183,0,7,7,109.55542,18.28208,1715
10997,41D4EB5552A7A416EEB26FAA30F55A4B,31931,8,9,1,109.54771,18.29403,1667
10998,41D4EB5552A7A416EEB26FAA30F55A4B,39183,9,14,5,109.55542,18.28208,1715
10999,41D4EB5552A7A416EEB26FAA30F55A4B,39181,16,17,1,109.55153,18.28035,1715
11000,41D4EB5552A7A416EEB26FAA30F55A4B,39183,17,23,6,109.55542,18.28208,1715
11071,64F4CDF664AA04E7B79DE93C57128CF6,31931,0,8,8,109.54771,18.29403,1667
11072,64F4CDF664AA04E7B79DE93C57128CF6,39181,8,18,10,109.55153,18.28035,1715
11073,64F4CDF664AA04E7B79DE93C57128CF6,31931,19,20,1,109.54771,18.29403,1667
11074,A992D60126719EF3134D37993767E1EF,30611,0,2,2,109.74958,18.40188,2485
11079,45CCFCD3EBDF941E1C92B70ED06E8B5E,30854,1,10,9,109.56889,18.27076,1763
11080,45CCFCD3EBDF941E1C92B70ED06E8B5E,31071,12,13,1,109.58257,18.28458,1815
11081,45CCFCD3EBDF941E1C92B70ED06E8B5E,30854,15,16,1,109.56889,18.27076,1763
11114,6B806948BC9187A91D033B4096721B00,31561,0,1,1,109.56792,18.28479,1765
11115,6B806948BC9187A91D033B4096721B00,31071,5,15,10,109.58257,18.28458,1815
11116,6B806948BC9187A91D033B4096721B00,31561,19,21,2,109.56792,18.28479,1765
11119,DE5024DB59D5BF6AE5857A85EB7680EA,30854,16,17,1,109.56889,18.27076,1763
11120,DE5024DB59D5BF6AE5857A85EB7680EA,60381,20,21,1,109.5241,18.22458,1605
11251,E292D83051830D054E89D209EEABA4B9,31561,18,20,2,109.56792,18.28479,1765
11252,E292D83051830D054E89D209EEABA4B9,39183,21,22,1,109.55542,18.28208,1715
11268,D0258183D3EC0F3CFFD9389BCF92CEA0,31261,0,1,1,109.51174,18.2466,1559
11269,D0258183D3EC0F3CFFD9389BCF92CEA0,60381,1,14,13,109.5241,18.22458,1605
11270,D0258183D3EC0F3CFFD9389BCF92CEA0,31521,14,19,5,109.51458,18.22542,1555
11271,D0258183D3EC0F3CFFD9389BCF92CEA0,60281,19,21,2,109.51743,18.25924,1561
11295,8376D19E65EF2C30F16F6D8DCBD4B812,38261,0,7,7,109.50361,18.28153,1515
11296,8376D19E65EF2C30F16F6D8DCBD4B812,30281,8,11,3,109.50597,18.27583,1514
11389,CA9DF84C64B1C31A61B42BDFD659A4B0,31071,17,18,1,109.58257,18.28458,1815
11390,CA9DF84C64B1C31A61B42BDFD659A4B0,30854,20,21,1,109.56889,18.27076,1763
11455,3977578BE56276DA0700B04B81DC1356,31071,12,14,2,109.58257,18.28458,1815
11456,3977578BE56276DA0700B04B81DC1356,31561,18,21,3,109.56792,18.28479,1765
11502,2027AA9558BB48F6DAA6F83AE664254B,31071,1,7,6,109.58257,18.28458,1815
11503,2027AA9558BB48F6DAA6F83AE664254B,30854,7,8,1,109.56889,18.27076,1763
11513,0133DDFFB5CECBB261CEDEF10A82D50B,31561,0,10,10,109.56792,18.28479,1765
11514,0133DDFFB5CECBB261CEDEF10A82D50B,30441,12,13,1,109.64021,18.25424,2010
11515,0133DDFFB5CECBB261CEDEF10A82D50B,31561,16,17,1,109.56792,18.28479,1765
11516,0133DDFFB5CECBB261CEDEF10A82D50B,30854,21,22,1,109.56889,18.27076,1763
11517,44A75810FF8F9221047E9675BDBF60A2,30854,0,10,10,109.56889,18.27076,1763
11518,44A75810FF8F9221047E9675BDBF60A2,31071,10,18,8,109.58257,18.28458,1815
11519,44A75810FF8F9221047E9675BDBF60A2,31561,20,23,3,109.56792,18.28479,1765
11574,0E129C09250C0D46273B4BD7E5225556,30151,0,6,6,109.50986,18.25083,1560
11575,0E129C09250C0D46273B4BD7E5225556,60201,6,9,3,109.5041,18.2509,1510
11576,0E129C09250C0D46273B4BD7E5225556,60441,9,11,2,109.46792,18.28604,1366
11577,0E129C09250C0D46273B4BD7E5225556,31851,12,18,6,109.71736,18.29007,2316
11578,0E129C09250C0D46273B4BD7E5225556,60281,20,21,1,109.51743,18.25924,1561
11579,0E129C09250C0D46273B4BD7E5225556,30151,21,23,2,109.50986,18.25083,1560
11638,C709D01469E0800AF998DFAF42105CDC,60631,0,5,5,109.57778,18.27583,1814
11639,C709D01469E0800AF998DFAF42105CDC,31561,7,14,7,109.56792,18.28479,1765
11640,C709D01469E0800AF998DFAF42105CDC,30854,15,20,5,109.56889,18.27076,1763
11641,C709D01469E0800AF998DFAF42105CDC,60631,22,23,1,109.57778,18.27583,1814
11664,451E2BF48CD7B253EB0892324E679BCC,38297,0,6,6,109.52576,18.24965,1609
11665,451E2BF48CD7B253EB0892324E679BCC,60281,7,17,10,109.51743,18.25924,1561
11666,451E2BF48CD7B253EB0892324E679BCC,38291,18,21,3,109.51618,18.24313,1558
11667,173CD7A2B7B334BC53A50A1D248FBCFE,31071,3,7,4,109.58257,18.28458,1815
11668,173CD7A2B7B334BC53A50A1D248FBCFE,30854,7,20,13,109.56889,18.27076,1763
11697,8883DF5E66B5FC284A8EF97DE8EAAAB3,30581,14,15,1,109.62257,18.24951,1959
11698,8883DF5E66B5FC284A8EF97DE8EAAAB3,30854,17,19,2,109.56889,18.27076,1763
11699,8883DF5E66B5FC284A8EF97DE8EAAAB3,60631,19,21,2,109.57778,18.27583,1814
11703,E90F25B3D4E3C87347B14227D807559F,31101,0,8,8,109.65389,18.23403,2057
11704,E90F25B3D4E3C87347B14227D807559F,60631,12,23,11,109.57778,18.27583,1814
11705,93715618B304E009FF2F157425BB5843,30421,17,21,4,109.50021,18.25861,1511
11706,93715618B304E009FF2F157425BB5843,60504,21,23,2,109.47917,18.28903,1416
11720,0E00D7E0174B24239144B08D52B998E8,31931,0,10,10,109.54771,18.29403,1667
11721,0E00D7E0174B24239144B08D52B998E8,31124,14,17,3,109.17069,18.35,276
11733,0E5593A90D661690BE3DAAA17AD936E2,38127,0,7,7,109.50833,18.27222,1513
11734,0E5593A90D661690BE3DAAA17AD936E2,31761,8,9,1,109.60521,18.27965,1914
11735,0E5593A90D661690BE3DAAA17AD936E2,38073,11,14,3,109.40813,18.30958,1169
11736,0E5593A90D661690BE3DAAA17AD936E2,38127,16,18,2,109.50833,18.27222,1513
11737,0E5593A90D661690BE3DAAA17AD936E2,30504,22,23,1,109.705,18.35368,2277
11744,DDE77D3A656666992FC3458B84010D43,30854,2,4,2,109.56889,18.27076,1763
11745,DDE77D3A656666992FC3458B84010D43,39183,4,10,6,109.55542,18.28208,1715
11749,07FD145FE6C81328C98C6C5C8452E794,30232,0,3,3,109.6191,18.31701,1971
11750,07FD145FE6C81328C98C6C5C8452E794,30854,3,6,3,109.56889,18.27076,1763
11751,07FD145FE6C81328C98C6C5C8452E794,30232,6,11,5,109.6191,18.31701,1971
11752,07FD145FE6C81328C98C6C5C8452E794,30854,12,22,10,109.56889,18.27076,1763
11760,9F62B931A9E30D8BD766712CF9C5E867,31021,15,16,1,109.49021,18.27,1463
11789,807F73DE76DFE56E472FA61396F0887C,60371,18,19,1,109.53063,18.30056,1618
11799,866460FA5062A635337B6369BB2AADDA,30854,3,10,7,109.56889,18.27076,1763
11800,866460FA5062A635337B6369BB2AADDA,30581,14,16,2,109.62257,18.24951,1959
11801,866460FA5062A635337B6369BB2AADDA,60631,20,22,2,109.57778,18.27583,1814
11817,CD2724D853B922EC14C4E5BF560D0D4F,39063,1,5,4,109.386,18.2919,1066
11818,CD2724D853B922EC14C4E5BF560D0D4F,31345,5,7,2,109.39,18.29,1066
11819,CD2724D853B922EC14C4E5BF560D0D4F,31031,8,9,1,109.49979,18.25382,1510
11820,CD2724D853B922EC14C4E5BF560D0D4F,31345,9,13,4,109.39,18.29,1066
11821,CD2724D853B922EC14C4E5BF560D0D4F,60561,19,20,1,109.38229,18.29785,1067
11822,CD2724D853B922EC14C4E5BF560D0D4F,31345,21,23,2,109.39,18.29,1066
11833,283001ED673D8EDBEF7EEB00BDB31533,60201,13,16,3,109.5041,18.2509,1510
11834,283001ED673D8EDBEF7EEB00BDB31533,31181,16,18,2,109.50382,18.24813,1509
11858,2D819E49BADBA83BD227E1A0B23BE3D8,30421,0,6,6,109.50021,18.25861,1511
11859,2D819E49BADBA83BD227E1A0B23BE3D8,31461,6,8,2,109.5091,18.25389,1510
11861,2D819E49BADBA83BD227E1A0B23BE3D8,31471,13,14,1,109.34583,18.29563,917
11862,2D819E49BADBA83BD227E1A0B23BE3D8,60641,19,23,4,109.53854,18.2359,1657
11864,02F7708F1CFAC98CD0B107132A271A25,48574,15,21,6,109.48931,18.28458,1465
11869,B5D5F035B558647FF9F44A76F16A1183,31206,0,9,9,109.50819,18.23549,1507
11870,B5D5F035B558647FF9F44A76F16A1183,60344,14,15,1,109.68847,18.31931,2221
11871,B5D5F035B558647FF9F44A76F16A1183,31271,19,21,2,109.48958,18.26257,1462
11971,D39D64452E6BBEF7B3056CA239E1B86E,30854,0,7,7,109.56889,18.27076,1763
11972,D39D64452E6BBEF7B3056CA239E1B86E,31561,8,10,2,109.56792,18.28479,1765
11973,D39D64452E6BBEF7B3056CA239E1B86E,30854,11,14,3,109.56889,18.27076,1763
11974,D39D64452E6BBEF7B3056CA239E1B86E,31561,14,19,5,109.56792,18.28479,1765
11975,D39D64452E6BBEF7B3056CA239E1B86E,30854,19,21,2,109.56889,18.27076,1763
11976,D39D64452E6BBEF7B3056CA239E1B86E,30851,21,23,2,109.5616,18.27396,1713
12034,E92C4377A82D1512C2FDA9EFCDAFE67D,30351,0,6,6,109.41701,18.29292,1217
12035,E92C4377A82D1512C2FDA9EFCDAFE67D,30354,7,8,1,109.42813,18.29076,1216
12036,E92C4377A82D1512C2FDA9EFCDAFE67D,31781,12,14,2,109.19847,18.2975,367
12037,E92C4377A82D1512C2FDA9EFCDAFE67D,30821,19,21,2,109.43681,18.33639,1274
12053,1FE2866848043A2C10AD87212485FE15,31071,3,7,4,109.58257,18.28458,1815
12054,1FE2866848043A2C10AD87212485FE15,30854,7,11,4,109.56889,18.27076,1763
12055,1FE2866848043A2C10AD87212485FE15,31071,11,23,12,109.58257,18.28458,1815
12058,34AB502A442AA8EA4A7FB30471B204DB,38325,4,6,2,109.39792,18.2909,1116
12059,34AB502A442AA8EA4A7FB30471B204DB,31431,7,9,2,109.44639,18.29042,1316
12060,34AB502A442AA8EA4A7FB30471B204DB,60441,13,14,1,109.46792,18.28604,1366
12061,34AB502A442AA8EA4A7FB30471B204DB,30341,17,19,2,109.3625,18.29167,966
12066,003C6689B311B427695E6FEF3BF3C281,31221,19,21,2,109.61333,18.26833,1913
12067,003C6689B311B427695E6FEF3BF3C281,38331,22,23,1,109.62465,18.22736,1956
12100,0FD4C9952BC5BC89BEB28CD193C21322,30081,0,8,8,109.50243,18.26632,1512
12101,0FD4C9952BC5BC89BEB28CD193C21322,39154,12,13,1,109.50201,18.25681,1511
12102,0FD4C9952BC5BC89BEB28CD193C21322,30081,16,19,3,109.50243,18.26632,1512
12107,CD576F1C1CDFB89E6A99A20E65927346,31561,1,2,1,109.56792,18.28479,1765
12108,CD576F1C1CDFB89E6A99A20E65927346,30854,7,22,15,109.56889,18.27076,1763
12123,EFBA9F65D905E3E75BCCC831CAFA27CF,60084,0,7,7,109.4984,18.2334,1507
12124,EFBA9F65D905E3E75BCCC831CAFA27CF,60552,9,10,1,109.41729,18.30014,1218
12141,412879740E648AE1B2C1A60DD3B08C37,30111,0,7,7,109.47583,18.30542,1419
12143,412879740E648AE1B2C1A60DD3B08C37,30711,18,19,1,109.50271,18.25347,1510
12144,412879740E648AE1B2C1A60DD3B08C37,31391,19,20,1,109.50382,18.24285,1508
12172,87ADC98470D754E65D1F229228B379D5,30851,0,3,3,109.5616,18.27396,1713
12173,87ADC98470D754E65D1F229228B379D5,30854,4,5,1,109.56889,18.27076,1763
12174,87ADC98470D754E65D1F229228B379D5,30201,10,12,2,109.4909,18.26465,1462
12202,00FB7756B5203374969A661782D36967,30071,0,18,18,109.52819,18.30472,1619
12203,00FB7756B5203374969A661782D36967,30561,18,19,1,109.52778,18.31938,1621
12204,00FB7756B5203374969A661782D36967,30071,21,23,2,109.52819,18.30472,1619
12255,E32F04C32D00AF60E04FA89AD4525A3E,39111,0,8,8,109.5191,18.22597,1555
12256,E32F04C32D00AF60E04FA89AD4525A3E,31521,8,10,2,109.51458,18.22542,1555
12257,E32F04C32D00AF60E04FA89AD4525A3E,31781,12,13,1,109.19847,18.2975,367
12270,D1238E1360D3AC93342B86056AD44C9C,39154,2,6,4,109.50201,18.25681,1511
12271,D1238E1360D3AC93342B86056AD44C9C,30711,7,9,2,109.50271,18.25347,1510
12272,D1238E1360D3AC93342B86056AD44C9C,31781,10,14,4,109.19847,18.2975,367
12273,D1238E1360D3AC93342B86056AD44C9C,30201,19,20,1,109.4909,18.26465,1462
12281,33D0BAF81064BA9871C044941C4D0C71,30361,15,18,3,109.50347,18.24,1508
12282,33D0BAF81064BA9871C044941C4D0C71,38251,20,21,1,109.49618,18.25493,1510
12313,B26DD5C650BE7CEA4DB62E608BAE05C3,30931,1,10,9,109.55653,18.32722,1722
12314,B26DD5C650BE7CEA4DB62E608BAE05C3,31031,14,15,1,109.49979,18.25382,1510
12315,B26DD5C650BE7CEA4DB62E608BAE05C3,30931,17,23,6,109.55653,18.32722,1722
12362,F47C4E1E39056C43B0AD32AC994AB7C0,60361,14,16,2,109.51938,18.29681,1567
12363,F47C4E1E39056C43B0AD32AC994AB7C0,31931,17,22,5,109.54771,18.29403,1667
12414,3738BCD5F22BB841A8E524306ADFE0A0,38171,1,8,7,109.50799,18.28139,1515
12415,3738BCD5F22BB841A8E524306ADFE0A0,38751,9,10,1,109.74903,18.37639,2481
12416,3738BCD5F22BB841A8E524306ADFE0A0,60231,12,23,11,109.49903,18.21972,1504
12480,31BAA46A2F25AC63D78E0ACA44BF0FE9,39181,0,8,8,109.55153,18.28035,1715
12481,31BAA46A2F25AC63D78E0ACA44BF0FE9,31931,8,10,2,109.54771,18.29403,1667
12482,31BAA46A2F25AC63D78E0ACA44BF0FE9,39181,11,20,9,109.55153,18.28035,1715
12501,A6AC80D1B196B7846A22B3CFEA4051A4,60661,0,7,7,109.548,18.2377,1657
12503,A6AC80D1B196B7846A22B3CFEA4051A4,38061,16,18,2,109.50597,18.23118,1506
12504,A6AC80D1B196B7846A22B3CFEA4051A4,60661,19,21,2,109.548,18.2377,1657
12515,A928E9F6C796FE1A60807BA003DE87BB,39183,14,16,2,109.55542,18.28208,1715
12516,A928E9F6C796FE1A60807BA003DE87BB,30854,17,20,3,109.56889,18.27076,1763
12564,42158B50A96F4BB50162AD5AAF8D7E2D,38911,0,1,1,109.51674,18.24965,1559
12565,42158B50A96F4BB50162AD5AAF8D7E2D,38891,2,5,3,109.51486,18.24118,1558
12566,42158B50A96F4BB50162AD5AAF8D7E2D,31201,5,11,6,109.51042,18.23819,1558
12567,42158B50A96F4BB50162AD5AAF8D7E2D,30211,15,17,2,109.49882,18.23931,1508
12568,42158B50A96F4BB50162AD5AAF8D7E2D,30324,19,20,1,109.50326,18.29257,1517
12569,42158B50A96F4BB50162AD5AAF8D7E2D,31201,21,23,2,109.51042,18.23819,1558
12611,CC4662D0AB761935A19DD4261E4FE213,31561,1,5,4,109.56792,18.28479,1765
12612,CC4662D0AB761935A19DD4261E4FE213,30851,8,9,1,109.5616,18.27396,1713
12613,CC4662D0AB761935A19DD4261E4FE213,31561,10,22,12,109.56792,18.28479,1765
12643,86435198F57620D5DAC23B4A4DA78009,39183,17,20,3,109.55542,18.28208,1715
12673,608A55C14BAB2A5B627ACC1F39B89FB6,31945,0,5,5,109.58021,18.29403,1817
12674,608A55C14BAB2A5B627ACC1F39B89FB6,31071,5,6,1,109.58257,18.28458,1815
12675,608A55C14BAB2A5B627ACC1F39B89FB6,30854,9,10,1,109.56889,18.27076,1763
12676,608A55C14BAB2A5B627ACC1F39B89FB6,31071,11,12,1,109.58257,18.28458,1815
12677,608A55C14BAB2A5B627ACC1F39B89FB6,30854,13,18,5,109.56889,18.27076,1763
12678,608A55C14BAB2A5B627ACC1F39B89FB6,31071,18,20,2,109.58257,18.28458,1815
12731,E887C057B111AD6EF085C23E238E5BF5,31031,0,9,9,109.49979,18.25382,1510
12732,E887C057B111AD6EF085C23E238E5BF5,33051,12,14,2,109.6475,18.46618,2096
12733,E887C057B111AD6EF085C23E238E5BF5,31031,17,23,6,109.49979,18.25382,1510
12840,C40018C062136AA3E05F546791CEC6AA,30854,0,5,5,109.56889,18.27076,1763
12841,C40018C062136AA3E05F546791CEC6AA,31931,7,9,2,109.54771,18.29403,1667
12842,C40018C062136AA3E05F546791CEC6AA,30854,11,13,2,109.56889,18.27076,1763
12843,C40018C062136AA3E05F546791CEC6AA,31931,13,16,3,109.54771,18.29403,1667
12844,C40018C062136AA3E05F546791CEC6AA,30854,16,23,7,109.56889,18.27076,1763
12859,13166628932DF36C0AD7B1DB5811240A,60591,0,6,6,109.61118,18.21715,1904
12860,13166628932DF36C0AD7B1DB5811240A,30854,8,18,10,109.56889,18.27076,1763
12861,13166628932DF36C0AD7B1DB5811240A,60591,19,22,3,109.61118,18.21715,1904
12878,B621E9075674E792CCB217233825F9D1,30851,2,7,5,109.5616,18.27396,1713
12879,B621E9075674E792CCB217233825F9D1,60591,10,13,3,109.61118,18.21715,1904
12880,B621E9075674E792CCB217233825F9D1,30854,15,16,1,109.56889,18.27076,1763
12884,6DF7485545B790F22810B0EDD8F1B356,31945,0,7,7,109.58021,18.29403,1817
12885,6DF7485545B790F22810B0EDD8F1B356,30854,7,12,5,109.56889,18.27076,1763
12886,6DF7485545B790F22810B0EDD8F1B356,31071,12,15,3,109.58257,18.28458,1815
12887,6DF7485545B790F22810B0EDD8F1B356,31945,20,22,2,109.58021,18.29403,1817
12964,0F558B6653C655C7F0BAEA9D66B33F57,31071,1,7,6,109.58257,18.28458,1815
12965,0F558B6653C655C7F0BAEA9D66B33F57,30854,7,17,10,109.56889,18.27076,1763
12966,0F558B6653C655C7F0BAEA9D66B33F57,60381,20,21,1,109.5241,18.22458,1605
13003,7421066246AAD1C230E7E2A7ADF06E9D,30721,1,4,3,109.51597,18.28257,1565
13004,7421066246AAD1C230E7E2A7ADF06E9D,60631,4,7,3,109.57778,18.27583,1814
13005,7421066246AAD1C230E7E2A7ADF06E9D,30854,8,10,2,109.56889,18.27076,1763
13006,7421066246AAD1C230E7E2A7ADF06E9D,31071,11,12,1,109.58257,18.28458,1815
13007,7421066246AAD1C230E7E2A7ADF06E9D,30854,13,17,4,109.56889,18.27076,1763
13008,7421066246AAD1C230E7E2A7ADF06E9D,31071,21,23,2,109.58257,18.28458,1815
13009,A4823EEC9A8E697E80697432C029B488,30391,10,13,3,109.4975,18.27118,1513
13010,A4823EEC9A8E697E80697432C029B488,30771,15,16,1,109.49938,18.26042,1511
13011,A4823EEC9A8E697E80697432C029B488,30391,17,19,2,109.4975,18.27118,1513
13012,A4823EEC9A8E697E80697432C029B488,31561,20,22,2,109.56792,18.28479,1765
13017,17CC4D48447B18FFE0C5E2D7115F70E9,60131,13,14,1,109.49819,18.24778,1509
13018,17CC4D48447B18FFE0C5E2D7115F70E9,60161,15,17,2,109.49174,18.26181,1461
13019,17CC4D48447B18FFE0C5E2D7115F70E9,60381,20,21,1,109.5241,18.22458,1605
13034,6E580E35F1856BA2850385BDFB597BF5,60472,12,13,1,109.46625,18.29542,1367
13035,6E580E35F1856BA2850385BDFB597BF5,30891,13,15,2,109.59431,18.28389,1865
13036,6E580E35F1856BA2850385BDFB597BF5,30854,15,20,5,109.56889,18.27076,1763
13037,6E580E35F1856BA2850385BDFB597BF5,30891,20,21,1,109.59431,18.28389,1865
13050,417408FFDA93B177641D270D3A5C4B2D,60631,15,18,3,109.57778,18.27583,1814
13051,417408FFDA93B177641D270D3A5C4B2D,30854,19,20,1,109.56889,18.27076,1763
13052,417408FFDA93B177641D270D3A5C4B2D,31071,21,23,2,109.58257,18.28458,1815
13060,B64867C82EE7534D608484389B1D83C4,30771,14,16,2,109.49938,18.26042,1511
13114,F84877D6657D72CDECA7D4A68D33C8CE,31071,0,6,6,109.58257,18.28458,1815
13115,F84877D6657D72CDECA7D4A68D33C8CE,30854,9,22,13,109.56889,18.27076,1763
13116,F84877D6657D72CDECA7D4A68D33C8CE,31071,22,23,1,109.58257,18.28458,1815
13192,D2A5F87218CF25385163A2F3C4229CB8,30851,15,17,2,109.5616,18.27396,1713
13193,D2A5F87218CF25385163A2F3C4229CB8,31561,18,21,3,109.56792,18.28479,1765
13214,C1602FB5A20BD98313F7CC13F431D061,30271,0,7,7,109.49132,18.23153,1456
13215,C1602FB5A20BD98313F7CC13F431D061,30421,11,14,3,109.50021,18.25861,1511
13216,C1602FB5A20BD98313F7CC13F431D061,38127,18,19,1,109.50833,18.27222,1513
13217,C1602FB5A20BD98313F7CC13F431D061,30361,21,23,2,109.50347,18.24,1508
13221,8DD23AA43C0F7967C45F7488D66F9159,30854,12,15,3,109.56889,18.27076,1763
13222,8DD23AA43C0F7967C45F7488D66F9159,31945,16,18,2,109.58021,18.29403,1817
13223,8DD23AA43C0F7967C45F7488D66F9159,30854,20,21,1,109.56889,18.27076,1763
13237,BD4652414D5C17466BA36FD4BD943A94,30721,2,8,6,109.51597,18.28257,1565
13238,BD4652414D5C17466BA36FD4BD943A94,39183,11,12,1,109.55542,18.28208,1715
13239,BD4652414D5C17466BA36FD4BD943A94,31931,12,14,2,109.54771,18.29403,1667
13240,BD4652414D5C17466BA36FD4BD943A94,39183,14,16,2,109.55542,18.28208,1715
13293,1BB9B63ACB6167FB07445AABC3759692,38881,0,10,10,109.51618,18.26431,1562
13308,D517610C2076C41FED0ED80CB6FFB44C,60631,0,6,6,109.57778,18.27583,1814
13309,D517610C2076C41FED0ED80CB6FFB44C,30851,7,23,16,109.5616,18.27396,1713
13328,9BD0746EAD915C7FE62E448DC71186FA,31071,0,7,7,109.58257,18.28458,1815
13329,9BD0746EAD915C7FE62E448DC71186FA,30854,8,9,1,109.56889,18.27076,1763
13330,9BD0746EAD915C7FE62E448DC71186FA,30711,10,14,4,109.50271,18.25347,1510
13331,9BD0746EAD915C7FE62E448DC71186FA,30854,18,21,3,109.56889,18.27076,1763
13380,90B8061AE1F491815A6E5F31CEB31F04,31411,0,4,4,109.5016,18.23576,1507
13381,90B8061AE1F491815A6E5F31CEB31F04,60361,4,19,15,109.51938,18.29681,1567
13382,90B8061AE1F491815A6E5F31CEB31F04,31041,21,22,1,109.50278,18.23701,1507
13411,EDD211647BCC1D3CABF473CB2801C791,31041,1,10,9,109.50278,18.23701,1507
13412,EDD211647BCC1D3CABF473CB2801C791,30161,11,12,1,109.50042,18.24389,1508
13413,EDD211647BCC1D3CABF473CB2801C791,31181,12,13,1,109.50382,18.24813,1509
13414,EDD211647BCC1D3CABF473CB2801C791,30161,14,23,9,109.50042,18.24389,1508
13431,7CAEC865F307698D027CF1E4BD3354EF,30271,3,4,1,109.49132,18.23153,1456
13432,7CAEC865F307698D027CF1E4BD3354EF,39061,5,6,1,109.38222,18.28958,1066
13433,7CAEC865F307698D027CF1E4BD3354EF,30051,6,9,3,109.48917,18.21215,1453
13474,EBF906C5498076BCFA3E97DF6001B4F3,60631,13,14,1,109.57778,18.27583,1814
13475,EBF906C5498076BCFA3E97DF6001B4F3,30854,15,23,8,109.56889,18.27076,1763
13501,2575DC0A6ACDD25FC20DB5874F9656C2,38127,15,23,8,109.50833,18.27222,1513
13519,7AD77D97FC73EB9AE75B3794F240C672,31041,0,7,7,109.50278,18.23701,1507
13525,4896D3267708A1E47DCC054292145AD0,30051,20,21,1,109.48917,18.21215,1453
13526,4896D3267708A1E47DCC054292145AD0,60084,22,23,1,109.4984,18.2334,1507
13539,E50C3F5EAF024523809A782B7E9AE8AE,60524,0,8,8,109.42951,18.28993,1216
13540,E50C3F5EAF024523809A782B7E9AE8AE,38251,11,13,2,109.49618,18.25493,1510
13541,E50C3F5EAF024523809A782B7E9AE8AE,31031,15,17,2,109.49979,18.25382,1510
13542,E50C3F5EAF024523809A782B7E9AE8AE,60524,18,20,2,109.42951,18.28993,1216
13562,18EE47452FD5BE7C01D5DBC710576D9F,60291,15,16,1,109.50826,18.24639,1509
13563,18EE47452FD5BE7C01D5DBC710576D9F,39136,19,23,4,109.20861,18.30014,418
13566,75817DB682187A07461734D66E1E6492,60631,0,4,4,109.57778,18.27583,1814
13567,75817DB682187A07461734D66E1E6492,30854,5,14,9,109.56889,18.27076,1763
13568,75817DB682187A07461734D66E1E6492,31061,18,20,2,109.53333,18.23257,1607
13569,75817DB682187A07461734D66E1E6492,60631,21,23,2,109.57778,18.27583,1814
13582,E5B7DF0BD5F9C6028960F1174FAA2027,30271,1,6,5,109.49132,18.23153,1456
13583,E5B7DF0BD5F9C6028960F1174FAA2027,60084,7,8,1,109.4984,18.2334,1507
13584,E5B7DF0BD5F9C6028960F1174FAA2027,30211,11,15,4,109.49882,18.23931,1508
13618,005F3AEFE6DBF371ED1FD57736434098,30721,0,1,1,109.51597,18.28257,1565
13619,005F3AEFE6DBF371ED1FD57736434098,31071,2,7,5,109.58257,18.28458,1815
13620,005F3AEFE6DBF371ED1FD57736434098,30854,7,19,12,109.56889,18.27076,1763
13632,F7A05B3FECD253C9C578617425D22E9D,38754,14,15,1,109.74667,18.37382,2430
13650,ECCCA5770AD6AA7162B63EC395B55856,60631,0,7,7,109.57778,18.27583,1814
13651,ECCCA5770AD6AA7162B63EC395B55856,30951,9,15,6,109.56208,18.25667,1761
13652,ECCCA5770AD6AA7162B63EC395B55856,31945,19,20,1,109.58021,18.29403,1817
13657,53875E69050EC42E511A64D3211FA7B3,60631,0,6,6,109.57778,18.27583,1814
13658,53875E69050EC42E511A64D3211FA7B3,30854,9,20,11,109.56889,18.27076,1763
13668,4EA9CCC3AA7079FA0621BD2D5CA90A77,60401,16,19,3,109.47444,18.27583,1414
13669,4EA9CCC3AA7079FA0621BD2D5CA90A77,60291,20,22,2,109.50826,18.24639,1509
13670,1877AE3F054132FD529E292AD524A6EA,30854,0,12,12,109.56889,18.27076,1763
13671,1877AE3F054132FD529E292AD524A6EA,60381,13,14,1,109.5241,18.22458,1605
13672,1877AE3F054132FD529E292AD524A6EA,30854,16,17,1,109.56889,18.27076,1763
13673,1877AE3F054132FD529E292AD524A6EA,38291,19,20,1,109.51618,18.24313,1558
13691,D4EDFC03E7ED63DAAF98D926C98FC74F,31181,8,9,1,109.50382,18.24813,1509
13692,D4EDFC03E7ED63DAAF98D926C98FC74F,33051,13,14,1,109.6475,18.46618,2096
13693,D4EDFC03E7ED63DAAF98D926C98FC74F,30511,18,19,1,109.51069,18.24208,1558
13694,D4EDFC03E7ED63DAAF98D926C98FC74F,31181,19,21,2,109.50382,18.24813,1509
13725,A952750F25C558E5C17B3EB7DD935431,31931,1,2,1,109.54771,18.29403,1667
13726,A952750F25C558E5C17B3EB7DD935431,60371,2,11,9,109.53063,18.30056,1618
13727,A952750F25C558E5C17B3EB7DD935431,31931,15,17,2,109.54771,18.29403,1667
13732,075EA8BE53B43CC5FEFFAE0960577C3C,60671,0,3,3,109.52979,18.31757,1621
13733,075EA8BE53B43CC5FEFFAE0960577C3C,38241,3,5,2,109.54111,18.30542,1669
13734,075EA8BE53B43CC5FEFFAE0960577C3C,30561,6,7,1,109.52778,18.31938,1621
13735,075EA8BE53B43CC5FEFFAE0960577C3C,30561,12,14,2,109.52778,18.31938,1621
13736,075EA8BE53B43CC5FEFFAE0960577C3C,38157,16,17,1,109.51483,18.26958,1563
13737,075EA8BE53B43CC5FEFFAE0960577C3C,60671,18,21,3,109.52979,18.31757,1621
13738,ABCD0851CC1C78BCD7AF6DBDF2F5DE49,60041,0,2,2,109.39889,18.31944,1121
13739,ABCD0851CC1C78BCD7AF6DBDF2F5DE49,60552,3,8,5,109.41729,18.30014,1218
13740,ABCD0851CC1C78BCD7AF6DBDF2F5DE49,60401,8,10,2,109.47444,18.27583,1414
13741,ABCD0851CC1C78BCD7AF6DBDF2F5DE49,60552,11,22,11,109.41729,18.30014,1218
13788,E6541B4F346982101D887BAAF0315541,31931,1,7,6,109.54771,18.29403,1667
13789,E6541B4F346982101D887BAAF0315541,30854,11,14,3,109.56889,18.27076,1763
13800,9EB99F27F9127F01C16DB7BA7D10B6E0,30854,18,20,2,109.56889,18.27076,1763
13801,9EB99F27F9127F01C16DB7BA7D10B6E0,31071,20,21,1,109.58257,18.28458,1815
13831,5130F8AFB1F97479AEA6CBCEC229D9D4,39111,0,6,6,109.5191,18.22597,1555
13832,5130F8AFB1F97479AEA6CBCEC229D9D4,31521,8,9,1,109.51458,18.22542,1555
13833,5130F8AFB1F97479AEA6CBCEC229D9D4,30661,11,12,1,109.37028,18.24361,1008
13834,5130F8AFB1F97479AEA6CBCEC229D9D4,31521,14,17,3,109.51458,18.22542,1555
13835,5130F8AFB1F97479AEA6CBCEC229D9D4,31521,17,23,6,109.51458,18.22542,1555
13836,B643AC77F8D8498A9694D45BA8B0F75F,60631,0,6,6,109.57778,18.27583,1814
13837,B643AC77F8D8498A9694D45BA8B0F75F,31561,7,8,1,109.56792,18.28479,1765
13838,B643AC77F8D8498A9694D45BA8B0F75F,60631,9,17,8,109.57778,18.27583,1814
13839,B643AC77F8D8498A9694D45BA8B0F75F,31561,18,19,1,109.56792,18.28479,1765
13840,B643AC77F8D8498A9694D45BA8B0F75F,30854,20,21,1,109.56889,18.27076,1763
13882,DF5EBFA9D0614A60E8475DE83F0E910D,30151,0,7,7,109.50986,18.25083,1560
13883,DF5EBFA9D0614A60E8475DE83F0E910D,60201,8,9,1,109.5041,18.2509,1510
13884,DF5EBFA9D0614A60E8475DE83F0E910D,30711,12,15,3,109.50271,18.25347,1510
13935,6F25B46DE233F84CBE88187DB2427FA9,30201,0,11,11,109.4909,18.26465,1462
13936,6F25B46DE233F84CBE88187DB2427FA9,60131,14,15,1,109.49819,18.24778,1509
13937,6F25B46DE233F84CBE88187DB2427FA9,31021,15,17,2,109.49021,18.27,1463
13938,6F25B46DE233F84CBE88187DB2427FA9,30201,18,23,5,109.4909,18.26465,1462
13942,5EAEAB611440D169B1CE8706AE16111E,31521,0,1,1,109.51458,18.22542,1555
13943,5EAEAB611440D169B1CE8706AE16111E,30511,1,6,5,109.51069,18.24208,1558
13945,27BCEF3137923B84211F08830816C810,30851,2,4,2,109.5616,18.27396,1713
13946,27BCEF3137923B84211F08830816C810,31561,7,9,2,109.56792,18.28479,1765
13947,27BCEF3137923B84211F08830816C810,30851,9,10,1,109.5616,18.27396,1713
13948,27BCEF3137923B84211F08830816C810,30821,11,14,3,109.43681,18.33639,1274
13949,27BCEF3137923B84211F08830816C810,30851,15,16,1,109.5616,18.27396,1713
13950,27BCEF3137923B84211F08830816C810,31561,18,20,2,109.56792,18.28479,1765
13957,5426296000364EE32711CD0E73D782C8,31561,12,17,5,109.56792,18.28479,1765
13958,5426296000364EE32711CD0E73D782C8,30854,20,21,1,109.56889,18.27076,1763
13968,439C404954398764464D854D76F475D8,38281,0,11,11,109.6525,18.23403,2057
13970,439C404954398764464D854D76F475D8,38754,19,21,2,109.74667,18.37382,2430
13998,91EC74D2B208A10BECBB101C6735C578,38484,0,1,1,109.53028,18.31528,1620
13999,91EC74D2B208A10BECBB101C6735C578,31864,1,8,7,109.49014,18.28333,1465
14000,91EC74D2B208A10BECBB101C6735C578,60171,10,11,1,109.51292,18.30694,1569
14001,91EC74D2B208A10BECBB101C6735C578,60131,18,20,2,109.49819,18.24778,1509
14002,91EC74D2B208A10BECBB101C6735C578,60281,21,22,1,109.51743,18.25924,1561
14014,4995463B780282C9C030A19D9F49AEAC,31206,1,2,1,109.50819,18.23549,1507
14015,4995463B780282C9C030A19D9F49AEAC,31071,3,7,4,109.58257,18.28458,1815
14016,4995463B780282C9C030A19D9F49AEAC,30854,9,20,11,109.56889,18.27076,1763
14054,937F0B31443CC6355891AA9D2DB0C670,31561,0,18,18,109.56792,18.28479,1765
14055,937F0B31443CC6355891AA9D2DB0C670,30854,19,20,1,109.56889,18.27076,1763
14056,937F0B31443CC6355891AA9D2DB0C670,31561,21,22,1,109.56792,18.28479,1765
14064,1065A9749A8F2A571941F492CF248982,38145,3,6,3,109.378,18.2912,1066
14065,1065A9749A8F2A571941F492CF248982,30341,6,8,2,109.3625,18.29167,966
14066,1065A9749A8F2A571941F492CF248982,30731,10,11,1,109.50944,18.22306,1555
14067,1065A9749A8F2A571941F492CF248982,38145,15,16,1,109.378,18.2912,1066
14068,1065A9749A8F2A571941F492CF248982,30341,17,18,1,109.3625,18.29167,966
14069,1065A9749A8F2A571941F492CF248982,60221,20,21,1,109.52569,18.29188,1616
14124,B4398296165C17394538440AD55C60F2,60631,0,2,2,109.57778,18.27583,1814
14125,B4398296165C17394538440AD55C60F2,31071,2,5,3,109.58257,18.28458,1815
14126,B4398296165C17394538440AD55C60F2,60631,5,6,1,109.57778,18.27583,1814
14127,B4398296165C17394538440AD55C60F2,60552,9,10,1,109.41729,18.30014,1218
14132,996C0D9500BF90CC0E7F5A04C49A464B,30921,0,5,5,109.53903,18.29451,1667
14133,996C0D9500BF90CC0E7F5A04C49A464B,31931,5,22,17,109.54771,18.29403,1667
14140,B340EDEF4A878E8DF5CBEC25E465EACE,30854,6,10,4,109.56889,18.27076,1763
14141,B340EDEF4A878E8DF5CBEC25E465EACE,31071,13,14,1,109.58257,18.28458,1815
14142,B340EDEF4A878E8DF5CBEC25E465EACE,30854,15,17,2,109.56889,18.27076,1763
14143,B340EDEF4A878E8DF5CBEC25E465EACE,31071,18,21,3,109.58257,18.28458,1815
14151,F198CAA1F49ACA5D003FD8F8473B3798,30854,0,6,6,109.56889,18.27076,1763
14152,F198CAA1F49ACA5D003FD8F8473B3798,31071,7,8,1,109.58257,18.28458,1815
14153,F198CAA1F49ACA5D003FD8F8473B3798,30854,8,20,12,109.56889,18.27076,1763
14154,F198CAA1F49ACA5D003FD8F8473B3798,60371,22,23,1,109.53063,18.30056,1618
14180,DDFC31B0586E2DBCED7345CFA87818AD,30771,2,8,6,109.49938,18.26042,1511
14182,DDFC31B0586E2DBCED7345CFA87818AD,30771,18,23,5,109.49938,18.26042,1511
14187,B73C72A488430C5DAE1758758E9D50EF,30951,0,3,3,109.56208,18.25667,1761
14188,B73C72A488430C5DAE1758758E9D50EF,30851,3,6,3,109.5616,18.27396,1713
14189,B73C72A488430C5DAE1758758E9D50EF,30221,8,10,2,109.57833,18.20222,1802
14192,C860767955774E3494068CF38C009FB6,30191,15,17,2,109.50361,18.22701,1506
14193,C860767955774E3494068CF38C009FB6,31031,19,20,1,109.49979,18.25382,1510
14194,C860767955774E3494068CF38C009FB6,60391,21,23,2,109.47667,18.28757,1416
14238,5585250DBD68ABC768E4FEDB3CFC1D84,31471,13,14,1,109.34583,18.29563,917
14239,5585250DBD68ABC768E4FEDB3CFC1D84,30354,17,19,2,109.42813,18.29076,1216
14240,662D882A6A10D0E6C3566690F0A40636,30854,0,17,17,109.56889,18.27076,1763
14241,662D882A6A10D0E6C3566690F0A40636,31071,19,20,1,109.58257,18.28458,1815
14242,662D882A6A10D0E6C3566690F0A40636,30921,21,23,2,109.53903,18.29451,1667
14246,35C6EDC8AAC6B5ABA770190223528BA2,30861,18,19,1,109.52722,18.22743,1606
14247,35C6EDC8AAC6B5ABA770190223528BA2,31061,21,23,2,109.53333,18.23257,1607
14248,8C5A16299A6D294198C90C34C25C5949,30854,3,4,1,109.56889,18.27076,1763
14249,8C5A16299A6D294198C90C34C25C5949,31561,7,9,2,109.56792,18.28479,1765
14250,8C5A16299A6D294198C90C34C25C5949,31071,11,12,1,109.58257,18.28458,1815
14251,8C5A16299A6D294198C90C34C25C5949,39183,14,17,3,109.55542,18.28208,1715
14252,8C5A16299A6D294198C90C34C25C5949,30854,20,21,1,109.56889,18.27076,1763
14253,8C5A16299A6D294198C90C34C25C5949,39183,22,23,1,109.55542,18.28208,1715
14285,686506971A60578CA4060BE72A9FBFEA,31701,19,22,3,109.44132,18.28833,1266
14297,B43DB539B5964E15F0064080164C40C1,60631,1,7,6,109.57778,18.27583,1814
14298,B43DB539B5964E15F0064080164C40C1,38052,10,17,7,109.62618,18.23042,1956
14299,B43DB539B5964E15F0064080164C40C1,60631,21,22,1,109.57778,18.27583,1814
14346,77E0479537D8350123531CE1FA2E6649,31561,18,20,2,109.56792,18.28479,1765
14347,77E0479537D8350123531CE1FA2E6649,30854,20,21,1,109.56889,18.27076,1763
14352,FB69127E95B4D9EC5AF61282F8D7EEB7,30854,0,1,1,109.56889,18.27076,1763
14353,FB69127E95B4D9EC5AF61282F8D7EEB7,31071,5,6,1,109.58257,18.28458,1815
14354,FB69127E95B4D9EC5AF61282F8D7EEB7,30854,11,23,12,109.56889,18.27076,1763
14380,E5E20C78783BEE4FE22BF6D264C660C6,31071,0,9,9,109.58257,18.28458,1815
14381,E5E20C78783BEE4FE22BF6D264C660C6,30854,11,13,2,109.56889,18.27076,1763
14388,7C4555390A772AFC617B693DE91FE9EE,60371,0,7,7,109.53063,18.30056,1618
14389,7C4555390A772AFC617B693DE91FE9EE,39181,8,11,3,109.55153,18.28035,1715
14390,7C4555390A772AFC617B693DE91FE9EE,60371,11,12,1,109.53063,18.30056,1618
14410,C1F9914EF577AE2A8300B1A3945A50FF,31561,2,7,5,109.56792,18.28479,1765
14411,C1F9914EF577AE2A8300B1A3945A50FF,31071,8,9,1,109.58257,18.28458,1815
14480,1F1673F70557E9225354F49F96F77617,30271,19,21,2,109.49132,18.23153,1456
14496,02506B144784C40A5C40BFE18DC84DB8,31561,2,17,15,109.56792,18.28479,1765
14497,02506B144784C40A5C40BFE18DC84DB8,30854,17,18,1,109.56889,18.27076,1763
14498,02506B144784C40A5C40BFE18DC84DB8,31561,19,21,2,109.56792,18.28479,1765
14534,89A3D380798A385AE8DF1304AC1B4E0B,31931,0,16,16,109.54771,18.29403,1667
14535,89A3D380798A385AE8DF1304AC1B4E0B,38171,20,21,1,109.50799,18.28139,1515
14536,89A3D380798A385AE8DF1304AC1B4E0B,31931,21,23,2,109.54771,18.29403,1667
14631,3D6D7E38DA6A03DDB2ACEC009234F360,31041,11,13,2,109.50278,18.23701,1507
14640,BCEE5AD02B2E24116CD9422ACE964174,60381,11,12,1,109.5241,18.22458,1605
14641,BCEE5AD02B2E24116CD9422ACE964174,30361,12,14,2,109.50347,18.24,1508
14642,BCEE5AD02B2E24116CD9422ACE964174,60381,15,23,8,109.5241,18.22458,1605
14662,47AFFCF7456D0B900AE2B4ED9BB222C6,31221,0,4,4,109.61333,18.26833,1913
14663,47AFFCF7456D0B900AE2B4ED9BB222C6,60594,4,9,5,109.62694,18.22799,1956
14664,47AFFCF7456D0B900AE2B4ED9BB222C6,31471,13,14,1,109.34583,18.29563,917
14665,47AFFCF7456D0B900AE2B4ED9BB222C6,30361,16,18,2,109.50347,18.24,1508
14666,47AFFCF7456D0B900AE2B4ED9BB222C6,31571,20,23,3,109.61563,18.23326,1957
14667,8AD9F37216B2D3FCE05CA77434307672,30741,0,14,14,109.49833,18.28681,1516
14668,8AD9F37216B2D3FCE05CA77434307672,30361,15,19,4,109.50347,18.24,1508
14669,E191BF114A3C2277CB7C3323BAA13F43,30854,0,1,1,109.56889,18.27076,1763
14670,E191BF114A3C2277CB7C3323BAA13F43,31561,5,6,1,109.56792,18.28479,1765
14671,E191BF114A3C2277CB7C3323BAA13F43,30854,6,7,1,109.56889,18.27076,1763
14672,E191BF114A3C2277CB7C3323BAA13F43,30211,12,13,1,109.49882,18.23931,1508
14675,9FC721E86703223349C05C95FE4BBB6F,60081,0,2,2,109.51097,18.22639,1556
14676,9FC721E86703223349C05C95FE4BBB6F,31521,4,20,16,109.51458,18.22542,1555
14677,9FC721E86703223349C05C95FE4BBB6F,60087,20,23,3,109.50688,18.22299,1505
14680,30407A7D3E455A7731D8523C4C83EC11,60552,1,7,6,109.41729,18.30014,1218
14681,30407A7D3E455A7731D8523C4C83EC11,38073,8,9,1,109.40813,18.30958,1169
14682,30407A7D3E455A7731D8523C4C83EC11,31471,12,13,1,109.34583,18.29563,917
14683,30407A7D3E455A7731D8523C4C83EC11,30661,15,17,2,109.37028,18.24361,1008
14684,30407A7D3E455A7731D8523C4C83EC11,60411,19,21,2,109.32514,18.30854,869
14714,8004316015532C0761573F4B267C6FE4,30441,0,11,11,109.64021,18.25424,2010
14715,8004316015532C0761573F4B267C6FE4,39151,13,14,1,109.49875,18.25097,1510
14716,8004316015532C0761573F4B267C6FE4,30211,16,18,2,109.49882,18.23931,1508
14717,8004316015532C0761573F4B267C6FE4,60291,19,21,2,109.50826,18.24639,1509
14778,2E31826F518B91677E3401BE3F9A1AF2,60221,0,7,7,109.52569,18.29188,1616
14779,2E31826F518B91677E3401BE3F9A1AF2,60361,11,16,5,109.51938,18.29681,1567
14806,34211070C0856836040CA55D5A0FB3C4,38251,16,18,2,109.49618,18.25493,1510
14807,34211070C0856836040CA55D5A0FB3C4,60084,19,20,1,109.4984,18.2334,1507
14817,E504C7D2F929BB396CEA3A3E20B74D1F,31521,0,9,9,109.51458,18.22542,1555
14818,E504C7D2F929BB396CEA3A3E20B74D1F,33481,10,13,3,109.67278,18.41278,2187
14819,E504C7D2F929BB396CEA3A3E20B74D1F,31521,14,22,8,109.51458,18.22542,1555
14823,90B0A60855A43B2DB99A0964CE51D3AF,31071,0,6,6,109.58257,18.28458,1815
14824,90B0A60855A43B2DB99A0964CE51D3AF,30854,8,10,2,109.56889,18.27076,1763
14829,59D035BE3D59A55EC6EA89871E8778D5,39151,11,14,3,109.49875,18.25097,1510
14830,59D035BE3D59A55EC6EA89871E8778D5,31121,18,23,5,109.16292,18.37063,230
14831,41BFDF202AA15C7D0EC7487840A4D094,30851,4,5,1,109.5616,18.27396,1713
14832,41BFDF202AA15C7D0EC7487840A4D094,30854,6,23,17,109.56889,18.27076,1763
14837,DBCB3A87F89C2AC16ED8152735BE6F75,38251,0,1,1,109.49618,18.25493,1510
14838,DBCB3A87F89C2AC16ED8152735BE6F75,60401,1,4,3,109.47444,18.27583,1414
14839,DBCB3A87F89C2AC16ED8152735BE6F75,31031,5,10,5,109.49979,18.25382,1510
14840,DBCB3A87F89C2AC16ED8152735BE6F75,60411,14,15,1,109.32514,18.30854,869
14841,DBCB3A87F89C2AC16ED8152735BE6F75,31031,16,23,7,109.49979,18.25382,1510
14842,05F9648883BF713D4E846B58647DFC7D,60401,0,8,8,109.47444,18.27583,1414
14843,05F9648883BF713D4E846B58647DFC7D,60524,8,9,1,109.42951,18.28993,1216
14871,4B7C998F79696CE662F2E58BD2418D12,30711,0,14,14,109.50271,18.25347,1510
14872,4B7C998F79696CE662F2E58BD2418D12,60281,14,16,2,109.51743,18.25924,1561
14873,4B7C998F79696CE662F2E58BD2418D12,31171,16,17,1,109.50938,18.24917,1559
14874,4B7C998F79696CE662F2E58BD2418D12,31101,21,23,2,109.65389,18.23403,2057
14885,122D07F80E4FAC68FAE7EDBB2DF1AFA3,31071,0,9,9,109.58257,18.28458,1815
14886,122D07F80E4FAC68FAE7EDBB2DF1AFA3,30854,10,11,1,109.56889,18.27076,1763
14887,122D07F80E4FAC68FAE7EDBB2DF1AFA3,31071,14,16,2,109.58257,18.28458,1815
14888,122D07F80E4FAC68FAE7EDBB2DF1AFA3,30854,17,18,1,109.56889,18.27076,1763
14889,122D07F80E4FAC68FAE7EDBB2DF1AFA3,31071,21,22,1,109.58257,18.28458,1815
14890,AC0473CD58A736C6A311A0DEEA929506,38023,1,10,9,109.37132,18.28993,1016
14891,AC0473CD58A736C6A311A0DEEA929506,60054,14,15,1,109.3016,18.31229,770
14892,AC0473CD58A736C6A311A0DEEA929506,31221,20,21,1,109.61333,18.26833,1913
14893,AC0473CD58A736C6A311A0DEEA929506,31571,22,23,1,109.61563,18.23326,1957
14923,B3EF0679F09F3DEC127B54C54EEBFAA7,31071,2,7,5,109.58257,18.28458,1815
14924,B3EF0679F09F3DEC127B54C54EEBFAA7,30854,11,14,3,109.56889,18.27076,1763
14925,0D3DA8126B134D203BB35373EAFFB116,30854,15,16,1,109.56889,18.27076,1763
14926,0D3DA8126B134D203BB35373EAFFB116,31071,19,23,4,109.58257,18.28458,1815
14927,A31156C6519BD5D8AB23829D811E9C63,38157,1,16,15,109.51483,18.26958,1563
14928,A31156C6519BD5D8AB23829D811E9C63,30361,17,18,1,109.50347,18.24,1508
14929,A31156C6519BD5D8AB23829D811E9C63,38903,20,22,2,109.39229,18.29243,1117
14941,40B64400C6DDE5B4C041DD8F12A72251,38251,0,9,9,109.49618,18.25493,1510
14942,40B64400C6DDE5B4C041DD8F12A72251,60054,13,14,1,109.3016,18.31229,770
14943,40B64400C6DDE5B4C041DD8F12A72251,30421,17,19,2,109.50021,18.25861,1511
14944,40B64400C6DDE5B4C041DD8F12A72251,38251,20,23,3,109.49618,18.25493,1510
15092,84DF4A7C208235D171EF56473BCCF210,30851,0,1,1,109.5616,18.27396,1713
15093,84DF4A7C208235D171EF56473BCCF210,31561,4,8,4,109.56792,18.28479,1765
15094,84DF4A7C208235D171EF56473BCCF210,60631,9,18,9,109.57778,18.27583,1814
15102,68CD8D5D4C42D0506F4B33008FB98D15,31521,0,7,7,109.51458,18.22542,1555
15103,68CD8D5D4C42D0506F4B33008FB98D15,30661,11,14,3,109.37028,18.24361,1008
15104,68CD8D5D4C42D0506F4B33008FB98D15,31521,16,23,7,109.51458,18.22542,1555
15117,015CDEB9169BCE5537ABAE49B6A63F2B,31071,1,5,4,109.58257,18.28458,1815
15118,015CDEB9169BCE5537ABAE49B6A63F2B,30854,5,18,13,109.56889,18.27076,1763
15119,015CDEB9169BCE5537ABAE49B6A63F2B,31071,19,20,1,109.58257,18.28458,1815
15120,015CDEB9169BCE5537ABAE49B6A63F2B,60631,21,22,1,109.57778,18.27583,1814
15152,9905C3E423D151CCE1280F3A1732CE90,30854,0,6,6,109.56889,18.27076,1763
15153,9905C3E423D151CCE1280F3A1732CE90,30851,8,17,9,109.5616,18.27396,1713
15154,9905C3E423D151CCE1280F3A1732CE90,30854,20,23,3,109.56889,18.27076,1763
15158,E5A3ABAC97D4B4693E578C38076A1DC3,39321,1,3,2,109.529,18.2167,1604
15159,E5A3ABAC97D4B4693E578C38076A1DC3,30731,5,7,2,109.50944,18.22306,1555
15160,E5A3ABAC97D4B4693E578C38076A1DC3,31521,7,9,2,109.51458,18.22542,1555
15162,E5A3ABAC97D4B4693E578C38076A1DC3,31521,18,23,5,109.51458,18.22542,1555
15219,40D62DAB923B148A7A4FFB3BCA6C7343,31271,14,15,1,109.48958,18.26257,1462
15220,40D62DAB923B148A7A4FFB3BCA6C7343,38951,17,18,1,109.48097,18.28868,1416
15221,E42A094C724E592924F39C0439AFCA4D,39151,19,21,2,109.49875,18.25097,1510
15222,E42A094C724E592924F39C0439AFCA4D,60201,22,23,1,109.5041,18.2509,1510
15226,74E7349CD1421F64667681F5A2E38EAE,30421,0,8,8,109.50021,18.25861,1511
15227,74E7349CD1421F64667681F5A2E38EAE,30741,12,16,4,109.49833,18.28681,1516
15228,74E7349CD1421F64667681F5A2E38EAE,31031,17,18,1,109.49979,18.25382,1510
15229,74E7349CD1421F64667681F5A2E38EAE,30421,19,23,4,109.50021,18.25861,1511
15251,E479C02F0DB5BD6494F47697E43E2BA3,30441,1,2,1,109.64021,18.25424,2010
15252,E479C02F0DB5BD6494F47697E43E2BA3,38054,4,5,1,109.63479,18.23097,2006
15253,E479C02F0DB5BD6494F47697E43E2BA3,30441,6,8,2,109.64021,18.25424,2010
15254,E479C02F0DB5BD6494F47697E43E2BA3,39321,13,16,3,109.529,18.2167,1604
15255,E479C02F0DB5BD6494F47697E43E2BA3,30361,16,18,2,109.50347,18.24,1508
15256,E479C02F0DB5BD6494F47697E43E2BA3,39321,20,22,2,109.529,18.2167,1604
15257,567BF1868FBA42FA9B3B29F2CA13F65D,31931,4,15,11,109.54771,18.29403,1667
15258,567BF1868FBA42FA9B3B29F2CA13F65D,30221,19,21,2,109.57833,18.20222,1802
15270,F00821368F615DCDAF214035D8EC4A44,31071,2,14,12,109.58257,18.28458,1815
15271,F00821368F615DCDAF214035D8EC4A44,30854,14,17,3,109.56889,18.27076,1763
15275,0B2CDE43D7DE290E07FF365A2D22E5DE,30854,16,18,2,109.56889,18.27076,1763
15287,AFFFF065007C995513D9884CB60C17FD,60381,0,1,1,109.5241,18.22458,1605
15288,AFFFF065007C995513D9884CB60C17FD,31031,2,5,3,109.49979,18.25382,1510
15289,AFFFF065007C995513D9884CB60C17FD,60381,5,9,4,109.5241,18.22458,1605
15290,AFFFF065007C995513D9884CB60C17FD,31071,17,18,1,109.58257,18.28458,1815
15291,AFFFF065007C995513D9884CB60C17FD,31031,20,21,1,109.49979,18.25382,1510
15292,AFFFF065007C995513D9884CB60C17FD,60381,22,23,1,109.5241,18.22458,1605
15297,EB0479048CEC4253CB4301400973BCD9,31071,13,14,1,109.58257,18.28458,1815
15298,EB0479048CEC4253CB4301400973BCD9,60381,14,15,1,109.5241,18.22458,1605
15312,335A7B1DE8538918FDA774EE3E402A76,30191,0,7,7,109.50361,18.22701,1506
15313,335A7B1DE8538918FDA774EE3E402A76,60381,7,11,4,109.5241,18.22458,1605
15314,335A7B1DE8538918FDA774EE3E402A76,31521,15,16,1,109.51458,18.22542,1555
15315,335A7B1DE8538918FDA774EE3E402A76,30191,16,23,7,109.50361,18.22701,1506
15316,2F6B5C7AA084DDA6FD780C1010658B83,31391,0,4,4,109.50382,18.24285,1508
15317,2F6B5C7AA084DDA6FD780C1010658B83,31521,4,9,5,109.51458,18.22542,1555
15318,2F6B5C7AA084DDA6FD780C1010658B83,60381,9,10,1,109.5241,18.22458,1605
15319,2F6B5C7AA084DDA6FD780C1010658B83,31521,11,14,3,109.51458,18.22542,1555
15320,2F6B5C7AA084DDA6FD780C1010658B83,31521,17,19,2,109.51458,18.22542,1555
15341,24B9CD23EC5587BA3102D06F602ACE38,60171,5,11,6,109.51292,18.30694,1569
15342,24B9CD23EC5587BA3102D06F602ACE38,60501,14,15,1,109.48701,18.29021,1466
15343,24B9CD23EC5587BA3102D06F602ACE38,60171,18,22,4,109.51292,18.30694,1569
15350,4290A01FCBC2456E9D2F061E9D5E5D68,60371,0,21,21,109.53063,18.30056,1618
15351,4290A01FCBC2456E9D2F061E9D5E5D68,30854,21,23,2,109.56889,18.27076,1763
15387,E43A8F31A67CD411544F9CC89C636B06,60381,1,8,7,109.5241,18.22458,1605
15388,E43A8F31A67CD411544F9CC89C636B06,31061,12,16,4,109.53333,18.23257,1607
15389,E43A8F31A67CD411544F9CC89C636B06,31071,19,20,1,109.58257,18.28458,1815
15402,316EB27B7555943C1D6557CD7E5A08F6,38341,15,19,4,109.49965,18.21299,1503
15433,AD39A6F857F8E578E6A2D9E072C4613F,39061,2,6,4,109.38222,18.28958,1066
15434,AD39A6F857F8E578E6A2D9E072C4613F,30681,6,8,2,109.48493,18.26917,1463
15435,AD39A6F857F8E578E6A2D9E072C4613F,30361,12,13,1,109.50347,18.24,1508
15436,AD39A6F857F8E578E6A2D9E072C4613F,60221,15,20,5,109.52569,18.29188,1616
15437,9FB9A7A4E811D65655B56CAECAAFDC8A,60381,0,10,10,109.5241,18.22458,1605
15438,9FB9A7A4E811D65655B56CAECAAFDC8A,31521,10,22,12,109.51458,18.22542,1555
15446,53490AD77ACCA93C3ED0F3DE79CA488B,31071,0,5,5,109.58257,18.28458,1815
15447,53490AD77ACCA93C3ED0F3DE79CA488B,30854,9,21,12,109.56889,18.27076,1763
15448,7D4B1DE20B00A786CE6215B7EF74F331,31561,0,7,7,109.56792,18.28479,1765
15449,7D4B1DE20B00A786CE6215B7EF74F331,30854,12,14,2,109.56889,18.27076,1763
15450,7D4B1DE20B00A786CE6215B7EF74F331,31561,15,23,8,109.56792,18.28479,1765
15521,B1CCD68E3CC8A7232EF2DE7E986C4789,38017,0,10,10,109.49729,18.21424,1504
15522,B1CCD68E3CC8A7232EF2DE7E986C4789,60084,11,13,2,109.4984,18.2334,1507
15523,B1CCD68E3CC8A7232EF2DE7E986C4789,38017,14,18,4,109.49729,18.21424,1504
15524,B1CCD68E3CC8A7232EF2DE7E986C4789,60121,19,20,1,109.74507,18.37472,2430
15525,B1CCD68E3CC8A7232EF2DE7E986C4789,38017,21,23,2,109.49729,18.21424,1504
15533,9C1407835BC54BEBDB541F52E1DA1820,61011,0,6,6,109.60653,18.19076,1900
15576,5E28EAB5F2E807365535BF3233D32C9B,38017,16,18,2,109.49729,18.21424,1504
15577,5E28EAB5F2E807365535BF3233D32C9B,31521,19,23,4,109.51458,18.22542,1555
15588,C1C0BE3268A989F4F57CDD79CA1A84CD,30271,19,21,2,109.49132,18.23153,1456
15589,C1C0BE3268A989F4F57CDD79CA1A84CD,31271,21,23,2,109.48958,18.26257,1462
15606,2875EEABF8ED00FBC275508759985153,31521,0,4,4,109.51458,18.22542,1555
15607,2875EEABF8ED00FBC275508759985153,31391,5,6,1,109.50382,18.24285,1508
15608,2875EEABF8ED00FBC275508759985153,31521,6,9,3,109.51458,18.22542,1555
15609,2875EEABF8ED00FBC275508759985153,31521,10,13,3,109.51458,18.22542,1555
15610,2875EEABF8ED00FBC275508759985153,31521,17,19,2,109.51458,18.22542,1555
15611,2875EEABF8ED00FBC275508759985153,38071,20,22,2,109.40722,18.30938,1169
15678,B80D4B4CDBD08237A9C4254F8883AEF4,30771,0,7,7,109.49938,18.26042,1511
15679,B80D4B4CDBD08237A9C4254F8883AEF4,60201,8,11,3,109.5041,18.2509,1510
15680,B80D4B4CDBD08237A9C4254F8883AEF4,39151,12,14,2,109.49875,18.25097,1510
15681,B80D4B4CDBD08237A9C4254F8883AEF4,31171,15,18,3,109.50938,18.24917,1559
15682,B80D4B4CDBD08237A9C4254F8883AEF4,30421,18,20,2,109.50021,18.25861,1511
15683,B80D4B4CDBD08237A9C4254F8883AEF4,31041,20,23,3,109.50278,18.23701,1507
15693,CCCD2290FB632A48009771412BE68ADD,31561,0,8,8,109.56792,18.28479,1765
15694,CCCD2290FB632A48009771412BE68ADD,39183,8,10,2,109.55542,18.28208,1715
15695,CCCD2290FB632A48009771412BE68ADD,31561,11,15,4,109.56792,18.28479,1765
15696,CCCD2290FB632A48009771412BE68ADD,39183,16,18,2,109.55542,18.28208,1715
15697,CCCD2290FB632A48009771412BE68ADD,31561,22,23,1,109.56792,18.28479,1765
15701,8799356B7181F28146A203E5F86C52F0,31351,0,7,7,109.4959,18.28417,1465
15702,8799356B7181F28146A203E5F86C52F0,38834,8,14,6,109.47639,18.21146,1403
15703,8799356B7181F28146A203E5F86C52F0,31351,19,22,3,109.4959,18.28417,1465
15704,41F3C3B484933318A782EA0B7EF5AC36,31071,0,8,8,109.58257,18.28458,1815
15705,41F3C3B484933318A782EA0B7EF5AC36,30854,8,10,2,109.56889,18.27076,1763
15706,41F3C3B484933318A782EA0B7EF5AC36,31071,11,14,3,109.58257,18.28458,1815
15721,73EAC1341C5005A58B26B1A52457F38B,39101,2,18,16,109.50132,18.24931,1509
15722,73EAC1341C5005A58B26B1A52457F38B,60121,18,21,3,109.74507,18.37472,2430
15755,0BABF9C6516F437130A3DD3C99553A57,31206,0,4,4,109.50819,18.23549,1507
15756,0BABF9C6516F437130A3DD3C99553A57,31205,5,13,8,109.51111,18.23736,1557
15757,0BABF9C6516F437130A3DD3C99553A57,38157,14,15,1,109.51483,18.26958,1563
15766,000584B3023702F3E9DDF521B1C35B1A,31071,1,13,12,109.58257,18.28458,1815
15767,000584B3023702F3E9DDF521B1C35B1A,30232,17,19,2,109.6191,18.31701,1971
15768,000584B3023702F3E9DDF521B1C35B1A,31945,21,23,2,109.58021,18.29403,1817
15801,37D38EF0062E64D55C94EB554B76F9EE,30854,14,16,2,109.56889,18.27076,1763
15802,37D38EF0062E64D55C94EB554B76F9EE,31071,17,18,1,109.58257,18.28458,1815
15803,37D38EF0062E64D55C94EB554B76F9EE,30854,20,21,1,109.56889,18.27076,1763
15812,E00EF22F493557E868E52C93194870CF,60631,0,7,7,109.57778,18.27583,1814
15813,E00EF22F493557E868E52C93194870CF,30854,8,12,4,109.56889,18.27076,1763
15814,E00EF22F493557E868E52C93194870CF,31071,16,17,1,109.58257,18.28458,1815
15815,3C5AEA306E8A69C707195C4150E77D90,31931,0,10,10,109.54771,18.29403,1667
15816,3C5AEA306E8A69C707195C4150E77D90,30071,10,12,2,109.52819,18.30472,1619
15817,3C5AEA306E8A69C707195C4150E77D90,31931,14,18,4,109.54771,18.29403,1667
15867,B5F757525A1D4CCFC85B8B869B252C51,60411,2,6,4,109.32514,18.30854,869
15868,B5F757525A1D4CCFC85B8B869B252C51,30661,7,8,1,109.37028,18.24361,1008
15875,E5E2DA460104E389257158E8D8C9FBDA,60281,0,5,5,109.51743,18.25924,1561
15876,E5E2DA460104E389257158E8D8C9FBDA,30511,6,8,2,109.51069,18.24208,1558
15877,E5E2DA460104E389257158E8D8C9FBDA,60281,11,12,1,109.51743,18.25924,1561
15878,E5E2DA460104E389257158E8D8C9FBDA,31261,13,17,4,109.51174,18.2466,1559
15879,E5E2DA460104E389257158E8D8C9FBDA,60281,18,23,5,109.51743,18.25924,1561
15925,70E36A4B82878626B569C66E46C7827C,60241,19,20,1,109.53319,18.28667,1616
15926,70E36A4B82878626B569C66E46C7827C,39091,21,23,2,109.50097,18.25222,1510
15980,FFF78F4198B8925E2094E7DEEAA9FD4B,60231,0,7,7,109.49903,18.21972,1504
15981,FFF78F4198B8925E2094E7DEEAA9FD4B,38105,7,9,2,109.40299,18.29229,1117
16013,012ABD06F231728C214A4BA917E75B1C,31561,0,8,8,109.56792,18.28479,1765
16014,012ABD06F231728C214A4BA917E75B1C,30851,8,10,2,109.5616,18.27396,1713
16015,012ABD06F231728C214A4BA917E75B1C,31561,10,11,1,109.56792,18.28479,1765
16016,012ABD06F231728C214A4BA917E75B1C,30851,12,18,6,109.5616,18.27396,1713
16017,012ABD06F231728C214A4BA917E75B1C,31561,18,21,3,109.56792,18.28479,1765
16018,51061B3DE820AF1C1C713EF684728003,31071,1,6,5,109.58257,18.28458,1815
16019,51061B3DE820AF1C1C713EF684728003,30854,7,11,4,109.56889,18.27076,1763
16020,51061B3DE820AF1C1C713EF684728003,31071,11,13,2,109.58257,18.28458,1815
16021,51061B3DE820AF1C1C713EF684728003,30854,14,20,6,109.56889,18.27076,1763
16074,1980C8D409DE9551539224B3D393CDAA,31951,3,8,5,109.52174,18.30299,1568
16075,1980C8D409DE9551539224B3D393CDAA,30071,12,15,3,109.52819,18.30472,1619
16076,1980C8D409DE9551539224B3D393CDAA,30071,15,23,8,109.52819,18.30472,1619
16079,8DDAC29F1E8D0CBA7C68BCF69300ACB7,38157,19,21,2,109.51483,18.26958,1563
16080,8DDAC29F1E8D0CBA7C68BCF69300ACB7,60084,22,23,1,109.4984,18.2334,1507
16100,635914FBAF9BDB855B8CB450E2AE782A,30571,1,3,2,109.50243,18.21861,1504
16101,635914FBAF9BDB855B8CB450E2AE782A,30051,7,11,4,109.48917,18.21215,1453
16102,635914FBAF9BDB855B8CB450E2AE782A,38834,12,14,2,109.47639,18.21146,1403
16103,635914FBAF9BDB855B8CB450E2AE782A,30051,14,18,4,109.48917,18.21215,1453
16108,D9AE11CD16B231308C3F0FB3F53BC3E9,31071,0,7,7,109.58257,18.28458,1815
16109,D9AE11CD16B231308C3F0FB3F53BC3E9,30854,9,10,1,109.56889,18.27076,1763
16110,D9AE11CD16B231308C3F0FB3F53BC3E9,31071,12,13,1,109.58257,18.28458,1815
16111,D9AE11CD16B231308C3F0FB3F53BC3E9,30854,16,17,1,109.56889,18.27076,1763
16143,FA0EB766C44C307B69FC2247C53C674E,60131,0,7,7,109.49819,18.24778,1509
16144,FA0EB766C44C307B69FC2247C53C674E,60321,11,12,1,109.63611,18.24306,2008
16145,FA0EB766C44C307B69FC2247C53C674E,31031,13,16,3,109.49979,18.25382,1510
16146,FA0EB766C44C307B69FC2247C53C674E,39154,20,21,1,109.50201,18.25681,1511
16166,9B36D53A2DB7FECD4570227EC8F2E0E7,31781,14,15,1,109.19847,18.2975,367
16167,9B36D53A2DB7FECD4570227EC8F2E0E7,60551,19,20,1,109.42722,18.30111,1218
16168,9B36D53A2DB7FECD4570227EC8F2E0E7,31031,21,22,1,109.49979,18.25382,1510
16172,733574DC984D9A31BC05EAD957FD2697,31101,17,19,2,109.65389,18.23403,2057
16183,43E035AE85036EBD9891453E9567CB81,30151,0,15,15,109.50986,18.25083,1560
16184,43E035AE85036EBD9891453E9567CB81,30151,19,23,4,109.50986,18.25083,1560
16206,BD2C08FAEF5FEEC783652D604747CF6D,33481,13,16,3,109.67278,18.41278,2187
16207,BD2C08FAEF5FEEC783652D604747CF6D,31521,20,21,1,109.51458,18.22542,1555
16208,BD2C08FAEF5FEEC783652D604747CF6D,31521,22,23,1,109.51458,18.22542,1555
16228,2371AF49C13083A9B56BAFD9F258B46A,30861,0,10,10,109.52722,18.22743,1606
16229,2371AF49C13083A9B56BAFD9F258B46A,30171,12,14,2,109.48458,18.27139,1463
16230,2371AF49C13083A9B56BAFD9F258B46A,30341,16,18,2,109.3625,18.29167,966
16231,2371AF49C13083A9B56BAFD9F258B46A,30721,19,23,4,109.51597,18.28257,1565
16232,C304B7CAC34AD51294A1441D84A8C903,30351,0,8,8,109.41701,18.29292,1217
16233,C304B7CAC34AD51294A1441D84A8C903,38111,11,12,1,109.52007,18.22403,1555
16234,C304B7CAC34AD51294A1441D84A8C903,30351,17,19,2,109.41701,18.29292,1217
16235,C304B7CAC34AD51294A1441D84A8C903,31271,20,21,1,109.48958,18.26257,1462
16248,8752BC71725B50257436D50C6598F252,31071,2,4,2,109.58257,18.28458,1815
16249,8752BC71725B50257436D50C6598F252,30854,7,20,13,109.56889,18.27076,1763
16254,92E14A6094471B9C1A50CE8585136EC6,60087,3,13,10,109.50688,18.22299,1505
16255,92E14A6094471B9C1A50CE8585136EC6,38754,17,18,1,109.74667,18.37382,2430
16256,92E14A6094471B9C1A50CE8585136EC6,30731,19,21,2,109.50944,18.22306,1555
16277,B65A42EE158A1686688454429BA4F642,31521,0,15,15,109.51458,18.22542,1555
16278,B65A42EE158A1686688454429BA4F642,60221,18,21,3,109.52569,18.29188,1616
16309,DC9973204E62AA99FA79F0696CF6C0F6,30851,0,6,6,109.5616,18.27396,1713
16310,DC9973204E62AA99FA79F0696CF6C0F6,30854,9,23,14,109.56889,18.27076,1763
16324,7BBB2DDEDB0AE43F8CE7FBD1FCB52741,31071,0,6,6,109.58257,18.28458,1815
16325,7BBB2DDEDB0AE43F8CE7FBD1FCB52741,30854,10,23,13,109.56889,18.27076,1763
16341,EF9F15FAFA5926C5B853D240732ABDEA,60524,16,19,3,109.42951,18.28993,1216
16342,EF9F15FAFA5926C5B853D240732ABDEA,30161,20,22,2,109.50042,18.24389,1508
16366,3EAE2CCEF780CC2E20C47963EA2CF3C6,30851,19,20,1,109.5616,18.27396,1713
16367,3EAE2CCEF780CC2E20C47963EA2CF3C6,31561,21,23,2,109.56792,18.28479,1765
16411,6422CB87ACC55DDEF6EBE8946593C808,31351,0,7,7,109.4959,18.28417,1465
16412,6422CB87ACC55DDEF6EBE8946593C808,30571,11,15,4,109.50243,18.21861,1504
16413,6422CB87ACC55DDEF6EBE8946593C808,38834,16,21,5,109.47639,18.21146,1403
16453,9AA959ED87D1ECC3053DED17290EFCBD,30854,0,1,1,109.56889,18.27076,1763
16454,9AA959ED87D1ECC3053DED17290EFCBD,31561,1,5,4,109.56792,18.28479,1765
16455,9AA959ED87D1ECC3053DED17290EFCBD,39183,9,18,9,109.55542,18.28208,1715
16456,9AA959ED87D1ECC3053DED17290EFCBD,31561,18,23,5,109.56792,18.28479,1765
16488,7890099D98AA300C5BF12527E7372DB0,60631,0,7,7,109.57778,18.27583,1814
16489,7890099D98AA300C5BF12527E7372DB0,30854,8,11,3,109.56889,18.27076,1763
16490,7890099D98AA300C5BF12527E7372DB0,60631,12,14,2,109.57778,18.27583,1814
16491,7890099D98AA300C5BF12527E7372DB0,30854,15,17,2,109.56889,18.27076,1763
16492,7890099D98AA300C5BF12527E7372DB0,60631,18,23,5,109.57778,18.27583,1814
16507,B874EAC8926625C0D1165CC1283F451E,31061,0,7,7,109.53333,18.23257,1607
16508,B874EAC8926625C0D1165CC1283F451E,30661,9,10,1,109.37028,18.24361,1008
16509,B874EAC8926625C0D1165CC1283F451E,31781,12,13,1,109.19847,18.2975,367
16510,B874EAC8926625C0D1165CC1283F451E,30191,18,19,1,109.50361,18.22701,1506
16511,B874EAC8926625C0D1165CC1283F451E,31061,22,23,1,109.53333,18.23257,1607
16546,F9999B4E962B5C7572ECDB36029BBDC9,30854,2,3,1,109.56889,18.27076,1763
16547,F9999B4E962B5C7572ECDB36029BBDC9,31071,6,8,2,109.58257,18.28458,1815
16548,F9999B4E962B5C7572ECDB36029BBDC9,30854,12,15,3,109.56889,18.27076,1763
16562,C6FE4CF0CD47303AD7F7EC5A71315B10,31561,18,19,1,109.56792,18.28479,1765
16563,C6FE4CF0CD47303AD7F7EC5A71315B10,60631,21,22,1,109.57778,18.27583,1814
16571,32D0EBFA645FCE8DAD65D018847E5043,30232,0,7,7,109.6191,18.31701,1971
16572,32D0EBFA645FCE8DAD65D018847E5043,30854,8,23,15,109.56889,18.27076,1763
16584,7084657DF30063A945AAA5EF4742695F,39183,14,19,5,109.55542,18.28208,1715
16585,7084657DF30063A945AAA5EF4742695F,31071,20,23,3,109.58257,18.28458,1815
16614,0036A867CCF4154EF4E16AF8E847E92C,38251,16,17,1,109.49618,18.25493,1510
16615,0036A867CCF4154EF4E16AF8E847E92C,60084,19,20,1,109.4984,18.2334,1507
16622,C1A86408F22C4A96CA9DED3C9439B426,31145,15,16,1,109.20431,18.30479,369
16623,C1A86408F22C4A96CA9DED3C9439B426,30861,18,23,5,109.52722,18.22743,1606
16656,566423B784470FF1F6B17BF1D21CA750,38171,0,2,2,109.50799,18.28139,1515
16657,566423B784470FF1F6B17BF1D21CA750,38171,4,12,8,109.50799,18.28139,1515
16658,566423B784470FF1F6B17BF1D21CA750,38094,16,17,1,109.45403,18.28778,1316
16659,566423B784470FF1F6B17BF1D21CA750,38903,18,20,2,109.39229,18.29243,1117
16660,566423B784470FF1F6B17BF1D21CA750,38171,20,23,3,109.50799,18.28139,1515
16696,C8922FAF66F21ECAECB6B717FCD5A53B,60391,9,17,8,109.47667,18.28757,1416
16697,C8922FAF66F21ECAECB6B717FCD5A53B,60614,19,23,4,109.48799,18.29521,1467
16713,9E8746086915F9D4A063A74CF0B5B7AB,31561,0,6,6,109.56792,18.28479,1765
16714,9E8746086915F9D4A063A74CF0B5B7AB,39183,7,8,1,109.55542,18.28208,1715
16726,D200070A291DD799906C2E0FB6841C80,38271,0,8,8,109.62632,18.23049,1956
16727,D200070A291DD799906C2E0FB6841C80,31801,11,12,1,109.20417,18.32118,371
16728,D200070A291DD799906C2E0FB6841C80,31471,12,14,2,109.34583,18.29563,917
16729,D200070A291DD799906C2E0FB6841C80,31205,15,16,1,109.51111,18.23736,1557
16730,D200070A291DD799906C2E0FB6841C80,38271,19,23,4,109.62632,18.23049,1956
16745,A503639E15A0B5D04B0130D882921438,31031,0,16,16,109.49979,18.25382,1510
16746,A503639E15A0B5D04B0130D882921438,30711,16,21,5,109.50271,18.25347,1510
16802,8B67CA01C44A0A9FF0492771727FF584,30281,18,20,2,109.50597,18.27583,1514
16803,8B67CA01C44A0A9FF0492771727FF584,38241,20,22,2,109.54111,18.30542,1669
16838,1419F2503130508E06D5FA0D4A5CF329,30711,0,8,8,109.50271,18.25347,1510
16839,1419F2503130508E06D5FA0D4A5CF329,31261,11,13,2,109.51174,18.2466,1559
16840,1419F2503130508E06D5FA0D4A5CF329,31031,16,23,7,109.49979,18.25382,1510
16853,64C897065E9EDCA8A69F38A94EFB9055,31181,13,16,3,109.50382,18.24813,1509
16855,E9E473F09C342630187345312F4A31D8,39181,0,8,8,109.55153,18.28035,1715
16856,E9E473F09C342630187345312F4A31D8,39181,10,17,7,109.55153,18.28035,1715
16857,E9E473F09C342630187345312F4A31D8,39181,17,23,6,109.55153,18.28035,1715
16878,A4120452FF09D9783BEC38585F9D2055,31321,15,16,1,109.63799,18.23201,2007
16879,A4120452FF09D9783BEC38585F9D2055,31321,18,19,1,109.63799,18.23201,2007
16880,A4120452FF09D9783BEC38585F9D2055,38134,21,23,2,109.63931,18.23451,2007
16901,AD0A1E1F1E587F1E96859B31EF886F77,60084,19,20,1,109.4984,18.2334,1507
16902,AD0A1E1F1E587F1E96859B31EF886F77,38361,21,23,2,109.43667,18.29201,1267
16915,00FC332040A284DA251A8D0705989FE9,31071,0,7,7,109.58257,18.28458,1815
16916,00FC332040A284DA251A8D0705989FE9,30854,8,10,2,109.56889,18.27076,1763
16917,00FC332040A284DA251A8D0705989FE9,31071,12,16,4,109.58257,18.28458,1815
16918,00FC332040A284DA251A8D0705989FE9,30854,19,21,2,109.56889,18.27076,1763
16940,56DFEAF03DB999C001DE943D9823E4CB,60161,13,14,1,109.49174,18.26181,1461
16941,56DFEAF03DB999C001DE943D9823E4CB,31531,16,19,3,109.49583,18.25972,1461
16942,56DFEAF03DB999C001DE943D9823E4CB,60401,21,23,2,109.47444,18.27583,1414
16976,D832D0A98B7486BD43D374BC2EF00900,30441,12,14,2,109.64021,18.25424,2010
16977,D832D0A98B7486BD43D374BC2EF00900,31031,16,17,1,109.49979,18.25382,1510
16978,D832D0A98B7486BD43D374BC2EF00900,38251,18,20,2,109.49618,18.25493,1510
16979,D832D0A98B7486BD43D374BC2EF00900,30161,20,23,3,109.50042,18.24389,1508
16980,8DA877D3A30401F86E81FB7BC1CA2A00,30854,2,6,4,109.56889,18.27076,1763
16981,8DA877D3A30401F86E81FB7BC1CA2A00,31071,8,9,1,109.58257,18.28458,1815
16984,2AE38FAF341950B0B91404FFCE5A0F3E,39181,19,21,2,109.55153,18.28035,1715
16985,2AE38FAF341950B0B91404FFCE5A0F3E,39183,21,23,2,109.55542,18.28208,1715
16994,39F25FE146A03325C93C111F2A943B6C,31945,0,13,13,109.58021,18.29403,1817
16995,39F25FE146A03325C93C111F2A943B6C,30854,13,14,1,109.56889,18.27076,1763
16996,39F25FE146A03325C93C111F2A943B6C,31071,16,20,4,109.58257,18.28458,1815
16997,39F25FE146A03325C93C111F2A943B6C,31945,21,23,2,109.58021,18.29403,1817
17029,5F70E6EFF50C46A1203DB5C4C03B4FD3,31701,1,11,10,109.44132,18.28833,1266
17030,5F70E6EFF50C46A1203DB5C4C03B4FD3,30361,12,14,2,109.50347,18.24,1508
17031,5F70E6EFF50C46A1203DB5C4C03B4FD3,31701,16,17,1,109.44132,18.28833,1266
17049,C41922360615B6B6DBE9569122B980B9,30291,0,7,7,109.50403,18.27028,1513
17050,C41922360615B6B6DBE9569122B980B9,38291,11,12,1,109.51618,18.24313,1558
17051,C41922360615B6B6DBE9569122B980B9,30084,12,23,11,109.50118,18.26972,1513
17076,DFFF17B7FE30E79B8AABBB5CE171272F,31561,0,3,3,109.56792,18.28479,1765
17077,DFFF17B7FE30E79B8AABBB5CE171272F,39183,4,6,2,109.55542,18.28208,1715
17078,DFFF17B7FE30E79B8AABBB5CE171272F,31561,6,7,1,109.56792,18.28479,1765
17079,DFFF17B7FE30E79B8AABBB5CE171272F,39183,20,22,2,109.55542,18.28208,1715
17080,DFFF17B7FE30E79B8AABBB5CE171272F,31561,22,23,1,109.56792,18.28479,1765
17096,B34415F599F0ED7D1A073EE314A60B9B,60041,2,5,3,109.39889,18.31944,1121
17097,B34415F599F0ED7D1A073EE314A60B9B,31671,7,19,12,109.38965,18.29813,1068
17118,0792180C7D67367A30DA0E9989B71457,60291,0,1,1,109.50826,18.24639,1509
17119,0792180C7D67367A30DA0E9989B71457,60381,2,17,15,109.5241,18.22458,1605
17120,0792180C7D67367A30DA0E9989B71457,60641,18,19,1,109.53854,18.2359,1657
17121,0792180C7D67367A30DA0E9989B71457,30861,19,21,2,109.52722,18.22743,1606
17122,0792180C7D67367A30DA0E9989B71457,31091,22,23,1,109.41201,18.31222,1170
17153,EC4B90EDBF35256FDB4D4F8B87DB8A04,31071,1,11,10,109.58257,18.28458,1815
17154,EC4B90EDBF35256FDB4D4F8B87DB8A04,30854,14,20,6,109.56889,18.27076,1763
17168,E0A24740E2C54F3B77DB561A91D2BED7,30151,0,7,7,109.50986,18.25083,1560
17169,E0A24740E2C54F3B77DB561A91D2BED7,30251,8,11,3,109.50611,18.26653,1512
17170,E0A24740E2C54F3B77DB561A91D2BED7,30251,12,18,6,109.50611,18.26653,1512
17171,E0A24740E2C54F3B77DB561A91D2BED7,30371,18,23,5,109.51,18.24771,1559
17172,248CE0B148D688C343222BB27AEE2380,60631,0,7,7,109.57778,18.27583,1814
17173,248CE0B148D688C343222BB27AEE2380,30854,7,8,1,109.56889,18.27076,1763
17174,248CE0B148D688C343222BB27AEE2380,31071,8,10,2,109.58257,18.28458,1815
17175,248CE0B148D688C343222BB27AEE2380,60631,12,13,1,109.57778,18.27583,1814
17176,248CE0B148D688C343222BB27AEE2380,30854,14,19,5,109.56889,18.27076,1763
17177,248CE0B148D688C343222BB27AEE2380,60631,19,22,3,109.57778,18.27583,1814
17198,ED90ACC7338DC6DF91BAC96D9385175E,31531,13,14,1,109.49583,18.25972,1461
17199,ED90ACC7338DC6DF91BAC96D9385175E,60621,18,20,2,109.48354,18.27451,1464
17200,ED90ACC7338DC6DF91BAC96D9385175E,31531,21,23,2,109.49583,18.25972,1461
17248,79552C9BA7D6D0482C348613B3829C6B,31181,0,18,18,109.50382,18.24813,1509
17249,79552C9BA7D6D0482C348613B3829C6B,60131,18,19,1,109.49819,18.24778,1509
17250,79552C9BA7D6D0482C348613B3829C6B,39151,19,23,4,109.49875,18.25097,1510
17298,18B397C6C5E352538250AEDC640C72E3,30581,16,19,3,109.62257,18.24951,1959
17299,18B397C6C5E352538250AEDC640C72E3,30232,20,21,1,109.6191,18.31701,1971
17300,18B397C6C5E352538250AEDC640C72E3,31941,22,23,1,109.62451,18.31222,1970
17333,EA446444DFE25212830F95291C13D19D,31931,0,8,8,109.54771,18.29403,1667
17334,EA446444DFE25212830F95291C13D19D,39181,10,12,2,109.55153,18.28035,1715
17335,EA446444DFE25212830F95291C13D19D,31931,13,23,10,109.54771,18.29403,1667
17346,B46B1495EF30AEB09B62A86592EC76F4,38251,12,15,3,109.49618,18.25493,1510
17347,B46B1495EF30AEB09B62A86592EC76F4,30361,16,18,2,109.50347,18.24,1508
17348,B46B1495EF30AEB09B62A86592EC76F4,38251,19,21,2,109.49618,18.25493,1510
17349,B46B1495EF30AEB09B62A86592EC76F4,60131,21,23,2,109.49819,18.24778,1509
17374,967E548F53382C36FB0D7FF12F6A99E7,30201,0,8,8,109.4909,18.26465,1462
17375,967E548F53382C36FB0D7FF12F6A99E7,60131,13,14,1,109.49819,18.24778,1509
17376,967E548F53382C36FB0D7FF12F6A99E7,60331,17,18,1,109.505,18.26507,1512
17377,967E548F53382C36FB0D7FF12F6A99E7,31531,19,23,4,109.49583,18.25972,1461
17400,27229B6D41BD7CDDDAA38911093865DB,30854,1,3,2,109.56889,18.27076,1763
17401,27229B6D41BD7CDDDAA38911093865DB,38085,5,13,8,109.6291,18.23625,2007
17402,27229B6D41BD7CDDDAA38911093865DB,30854,18,19,1,109.56889,18.27076,1763
17403,27229B6D41BD7CDDDAA38911093865DB,31071,20,23,3,109.58257,18.28458,1815
17419,14F1CC63CDA098F9694EAC8584B9C7A5,31071,0,2,2,109.58257,18.28458,1815
17420,14F1CC63CDA098F9694EAC8584B9C7A5,31561,5,14,9,109.56792,18.28479,1765
17421,14F1CC63CDA098F9694EAC8584B9C7A5,60221,15,17,2,109.52569,18.29188,1616
17456,68E0EBFAA45AF77E4FC7ED3FB8F5EC2D,38331,17,18,1,109.62465,18.22736,1956
17457,68E0EBFAA45AF77E4FC7ED3FB8F5EC2D,30581,19,20,1,109.62257,18.24951,1959
17458,68E0EBFAA45AF77E4FC7ED3FB8F5EC2D,38331,21,23,2,109.62465,18.22736,1956
17487,1D8B814EC83D52D7C5F3FED99C129EE0,60631,0,1,1,109.57778,18.27583,1814
17488,1D8B814EC83D52D7C5F3FED99C129EE0,30854,2,9,7,109.56889,18.27076,1763
17489,1D8B814EC83D52D7C5F3FED99C129EE0,38271,12,18,6,109.62632,18.23049,1956
17490,1D8B814EC83D52D7C5F3FED99C129EE0,60631,19,21,2,109.57778,18.27583,1814
17632,1B3E8931F1FF667205B6505EE53C6E2C,31071,1,7,6,109.58257,18.28458,1815
17633,1B3E8931F1FF667205B6505EE53C6E2C,30854,9,11,2,109.56889,18.27076,1763
17634,1B3E8931F1FF667205B6505EE53C6E2C,31071,14,18,4,109.58257,18.28458,1815
17663,94C6B6D07606799F9DD78C376ADCB85C,38911,8,9,1,109.51674,18.24965,1559
17664,94C6B6D07606799F9DD78C376ADCB85C,38291,9,14,5,109.51618,18.24313,1558
17665,94C6B6D07606799F9DD78C376ADCB85C,31461,16,17,1,109.5091,18.25389,1510
17666,94C6B6D07606799F9DD78C376ADCB85C,38911,20,22,2,109.51674,18.24965,1559
17680,26320D482FA7887F152191DD18B790C6,30854,0,2,2,109.56889,18.27076,1763
17681,26320D482FA7887F152191DD18B790C6,31071,5,15,10,109.58257,18.28458,1815
17747,C462628FF36F8FF2D0B7493E6DDA38BB,60411,1,2,1,109.32514,18.30854,869
17748,C462628FF36F8FF2D0B7493E6DDA38BB,30661,2,9,7,109.37028,18.24361,1008
17749,C462628FF36F8FF2D0B7493E6DDA38BB,60411,9,11,2,109.32514,18.30854,869
17750,C462628FF36F8FF2D0B7493E6DDA38BB,30661,11,12,1,109.37028,18.24361,1008
17751,C462628FF36F8FF2D0B7493E6DDA38BB,60411,13,23,10,109.32514,18.30854,869
17789,44950E3F507F69B4213B7A47ACD45534,39111,11,14,3,109.5191,18.22597,1555
17790,44950E3F507F69B4213B7A47ACD45534,31061,15,16,1,109.53333,18.23257,1607
17791,72839B8F6256E6FF641405D4832BF569,31071,1,2,1,109.58257,18.28458,1815
17792,72839B8F6256E6FF641405D4832BF569,30854,4,15,11,109.56889,18.27076,1763
17800,599AFAF71D30C85AA4E0085C43FF5E03,39091,15,16,1,109.50097,18.25222,1510
17801,599AFAF71D30C85AA4E0085C43FF5E03,30161,18,19,1,109.50042,18.24389,1508
17808,F8D799D9161B0143E0D71C40472A357E,38991,0,3,3,109.52681,18.30368,1618
17809,F8D799D9161B0143E0D71C40472A357E,31951,3,5,2,109.52174,18.30299,1568
17810,F8D799D9161B0143E0D71C40472A357E,30071,6,15,9,109.52819,18.30472,1619
17811,F8D799D9161B0143E0D71C40472A357E,30071,17,21,4,109.52819,18.30472,1619
17831,7BF65E5054DA81A230AB5423620158E1,31071,3,4,1,109.58257,18.28458,1815
17832,7BF65E5054DA81A230AB5423620158E1,30854,7,16,9,109.56889,18.27076,1763
17833,7BF65E5054DA81A230AB5423620158E1,31071,16,17,1,109.58257,18.28458,1815
17834,7BF65E5054DA81A230AB5423620158E1,30854,19,23,4,109.56889,18.27076,1763
17892,E6651E3C6D8FEA2077D9EFC6D097D06C,38251,0,21,21,109.49618,18.25493,1510
17893,E6651E3C6D8FEA2077D9EFC6D097D06C,30581,22,23,1,109.62257,18.24951,1959
17961,52DF9393BC04EE7B5E83988CA7733BE9,31071,4,13,9,109.58257,18.28458,1815
17962,52DF9393BC04EE7B5E83988CA7733BE9,30854,13,14,1,109.56889,18.27076,1763
17995,A46BA306DAEA889FAC7ACE9E5FD6A1FF,60331,0,7,7,109.505,18.26507,1512
17996,A46BA306DAEA889FAC7ACE9E5FD6A1FF,31461,8,9,1,109.5091,18.25389,1510
17997,A46BA306DAEA889FAC7ACE9E5FD6A1FF,30911,13,16,3,109.50493,18.26181,1511
17998,A46BA306DAEA889FAC7ACE9E5FD6A1FF,31171,18,19,1,109.50938,18.24917,1559
17999,A46BA306DAEA889FAC7ACE9E5FD6A1FF,30511,19,22,3,109.51069,18.24208,1558
18000,E649CF84A26278291AA1A5B5C5D01FCA,31561,0,6,6,109.56792,18.28479,1765
18001,E649CF84A26278291AA1A5B5C5D01FCA,30854,6,23,17,109.56889,18.27076,1763
18002,E5DF04F59E5D9E111B652A8582821044,38911,0,1,1,109.51674,18.24965,1559
18003,E5DF04F59E5D9E111B652A8582821044,38291,1,3,2,109.51618,18.24313,1558
18004,E5DF04F59E5D9E111B652A8582821044,38911,3,5,2,109.51674,18.24965,1559
18005,E5DF04F59E5D9E111B652A8582821044,60281,6,9,3,109.51743,18.25924,1561
18019,68254E0B24F7E3AA28CA608A59CAC78B,31221,0,6,6,109.61333,18.26833,1913
18020,68254E0B24F7E3AA28CA608A59CAC78B,60594,6,17,11,109.62694,18.22799,1956
18023,B84B247FA61A8C12DFCCCF3C2D72006D,31071,3,4,1,109.58257,18.28458,1815
18024,B84B247FA61A8C12DFCCCF3C2D72006D,31945,5,6,1,109.58021,18.29403,1817
18025,B84B247FA61A8C12DFCCCF3C2D72006D,30854,8,9,1,109.56889,18.27076,1763
18026,B84B247FA61A8C12DFCCCF3C2D72006D,31071,9,11,2,109.58257,18.28458,1815
18054,6C0260646767B781577B5B8CE2471E51,38484,9,20,11,109.53028,18.31528,1620
18055,6C0260646767B781577B5B8CE2471E51,30071,21,23,2,109.52819,18.30472,1619
18076,060A07AE17806CC79BB6F45DB4C73F3F,30821,0,20,20,109.43681,18.33639,1274
18077,060A07AE17806CC79BB6F45DB4C73F3F,39151,21,23,2,109.49875,18.25097,1510
18107,C1C69C0EAD4ABEFD1467543102429D9B,31861,0,1,1,109.49042,18.27549,1464
18108,C1C69C0EAD4ABEFD1467543102429D9B,39183,2,6,4,109.55542,18.28208,1715
18109,C1C69C0EAD4ABEFD1467543102429D9B,31561,7,8,1,109.56792,18.28479,1765
18139,8DEBA8F3DD446F0F0680296AB7E73431,60472,9,11,2,109.46625,18.29542,1367
18140,8DEBA8F3DD446F0F0680296AB7E73431,60011,15,19,4,109.48965,18.30222,1468
18160,9D95A3171C1BE00DB2BC8E0B4B7E1AC6,60621,0,7,7,109.48354,18.27451,1464
18161,9D95A3171C1BE00DB2BC8E0B4B7E1AC6,30061,9,11,2,109.29257,18.47521,747
18162,9D95A3171C1BE00DB2BC8E0B4B7E1AC6,30171,15,16,1,109.48458,18.27139,1463
18163,9D95A3171C1BE00DB2BC8E0B4B7E1AC6,30251,18,20,2,109.50611,18.26653,1512
18164,9D95A3171C1BE00DB2BC8E0B4B7E1AC6,30171,21,23,2,109.48458,18.27139,1463
18165,6CBD210FE212796CEDBD8FF4BC0A58A4,30854,1,3,2,109.56889,18.27076,1763
18166,6CBD210FE212796CEDBD8FF4BC0A58A4,39183,4,5,1,109.55542,18.28208,1715
18167,6CBD210FE212796CEDBD8FF4BC0A58A4,31931,6,8,2,109.54771,18.29403,1667
18168,6CBD210FE212796CEDBD8FF4BC0A58A4,39183,11,20,9,109.55542,18.28208,1715
18194,8AABF5FDF2B06EB445749240A3894969,31071,0,8,8,109.58257,18.28458,1815
18195,8AABF5FDF2B06EB445749240A3894969,30854,10,11,1,109.56889,18.27076,1763
18196,8AABF5FDF2B06EB445749240A3894969,31071,11,13,2,109.58257,18.28458,1815
18197,8AABF5FDF2B06EB445749240A3894969,31851,14,18,4,109.71736,18.29007,2316
18198,8AABF5FDF2B06EB445749240A3894969,30101,20,22,2,109.57299,18.33333,1773
18239,1EC959553638CEC3C2D1606E92235CDE,60631,0,3,3,109.57778,18.27583,1814
18240,1EC959553638CEC3C2D1606E92235CDE,31071,4,6,2,109.58257,18.28458,1815
18241,1EC959553638CEC3C2D1606E92235CDE,30854,7,15,8,109.56889,18.27076,1763
18285,FC8552628F8A5A5219C1C30314657039,60661,0,20,20,109.548,18.2377,1657
18286,FC8552628F8A5A5219C1C30314657039,31021,22,23,1,109.49021,18.27,1463
18296,CA373FFAFD7EFAD5EEFC32965095EB00,60201,0,6,6,109.5041,18.2509,1510
18297,CA373FFAFD7EFAD5EEFC32965095EB00,38251,6,11,5,109.49618,18.25493,1510
18298,CA373FFAFD7EFAD5EEFC32965095EB00,60201,12,14,2,109.5041,18.2509,1510
18299,CA373FFAFD7EFAD5EEFC32965095EB00,38484,20,21,1,109.53028,18.31528,1620
18300,CA373FFAFD7EFAD5EEFC32965095EB00,31031,22,23,1,109.49979,18.25382,1510
18306,E8BAAF476E8FE57075BAB1A8D4FF1780,30232,0,12,12,109.6191,18.31701,1971
18307,E8BAAF476E8FE57075BAB1A8D4FF1780,30854,15,16,1,109.56889,18.27076,1763
18308,E8BAAF476E8FE57075BAB1A8D4FF1780,30232,21,22,1,109.6191,18.31701,1971
18311,EBB8C4DC19F3856E93F775E3331F31B3,31201,6,8,2,109.51042,18.23819,1558
18312,EBB8C4DC19F3856E93F775E3331F31B3,30081,11,17,6,109.50243,18.26632,1512
18313,EBB8C4DC19F3856E93F775E3331F31B3,31521,18,20,2,109.51458,18.22542,1555
18314,EBB8C4DC19F3856E93F775E3331F31B3,31521,20,23,3,109.51458,18.22542,1555
18342,30CE72A519D49881F23B8123486E3A02,60054,3,9,6,109.3016,18.31229,770
18343,30CE72A519D49881F23B8123486E3A02,60411,11,14,3,109.32514,18.30854,869
18344,30CE72A519D49881F23B8123486E3A02,31471,15,16,1,109.34583,18.29563,917
18345,30CE72A519D49881F23B8123486E3A02,60411,18,20,2,109.32514,18.30854,869
18364,9A1D1AA5EE2CD156CC396C667ED8C5B9,31071,0,8,8,109.58257,18.28458,1815
18365,9A1D1AA5EE2CD156CC396C667ED8C5B9,30854,10,20,10,109.56889,18.27076,1763
18395,408C4FED868686E7B96333835F4C4205,60631,0,8,8,109.57778,18.27583,1814
18396,408C4FED868686E7B96333835F4C4205,30581,8,11,3,109.62257,18.24951,1959
18397,408C4FED868686E7B96333835F4C4205,30854,12,14,2,109.56889,18.27076,1763
18398,408C4FED868686E7B96333835F4C4205,60381,19,21,2,109.5241,18.22458,1605
18399,408C4FED868686E7B96333835F4C4205,31071,22,23,1,109.58257,18.28458,1815
18411,7C16827D646BDC874DE2BD7EE32189C5,30854,7,18,11,109.56889,18.27076,1763
18412,7C16827D646BDC874DE2BD7EE32189C5,60631,18,21,3,109.57778,18.27583,1814
18413,7C16827D646BDC874DE2BD7EE32189C5,30854,22,23,1,109.56889,18.27076,1763
18436,134447BAF73045598D228AAEE014B4B8,30854,1,5,4,109.56889,18.27076,1763
18491,8FB6E68E5A6CC62C91B8CA5F70C97052,60381,17,19,2,109.5241,18.22458,1605
18492,8FB6E68E5A6CC62C91B8CA5F70C97052,60661,20,23,3,109.548,18.2377,1657
18516,79C0E9CB0924537F3660125B77C46B0B,30321,0,11,11,109.49563,18.29611,1467
18517,79C0E9CB0924537F3660125B77C46B0B,60171,14,18,4,109.51292,18.30694,1569
18525,8FF2A1D1DB84D4F2908F8F04D1C87C16,30291,0,6,6,109.50403,18.27028,1513
18526,8FF2A1D1DB84D4F2908F8F04D1C87C16,31561,7,11,4,109.56792,18.28479,1765
18527,8FF2A1D1DB84D4F2908F8F04D1C87C16,30291,11,13,2,109.50403,18.27028,1513
18528,8FF2A1D1DB84D4F2908F8F04D1C87C16,31561,15,16,1,109.56792,18.28479,1765
18529,8FF2A1D1DB84D4F2908F8F04D1C87C16,30291,18,23,5,109.50403,18.27028,1513
18549,FEF1B208BFBEDDE7B3E7A77BB07513A4,38271,15,23,8,109.62632,18.23049,1956
18605,BF3873D6BE87123B5F43F4E3ACCB9795,30181,16,18,2,109.51597,18.23313,1557
18606,BF3873D6BE87123B5F43F4E3ACCB9795,30854,21,22,1,109.56889,18.27076,1763
18607,029C4A94CFCDA183C21AA100BC002A17,60054,1,2,1,109.3016,18.31229,770
18608,029C4A94CFCDA183C21AA100BC002A17,60411,4,6,2,109.32514,18.30854,869
18609,029C4A94CFCDA183C21AA100BC002A17,30661,8,23,15,109.37028,18.24361,1008
18642,7F632B4875B2736225CD6D350CD25670,30854,7,11,4,109.56889,18.27076,1763
18643,7F632B4875B2736225CD6D350CD25670,31071,11,12,1,109.58257,18.28458,1815
18644,7F632B4875B2736225CD6D350CD25670,30854,14,20,6,109.56889,18.27076,1763
18663,8CD2F16F090DFFBF34897CAC847CB1B1,39151,0,8,8,109.49875,18.25097,1510
18664,8CD2F16F090DFFBF34897CAC847CB1B1,60131,10,14,4,109.49819,18.24778,1509
18665,8CD2F16F090DFFBF34897CAC847CB1B1,60054,16,17,1,109.3016,18.31229,770
18666,8CD2F16F090DFFBF34897CAC847CB1B1,39151,18,23,5,109.49875,18.25097,1510
18716,D879D98E97B1702A34A3B26E676AE92F,30201,0,1,1,109.4909,18.26465,1462
18717,D879D98E97B1702A34A3B26E676AE92F,31271,2,5,3,109.48958,18.26257,1462
18718,D879D98E97B1702A34A3B26E676AE92F,30201,8,9,1,109.4909,18.26465,1462
18719,D879D98E97B1702A34A3B26E676AE92F,30171,12,13,1,109.48458,18.27139,1463
18720,D879D98E97B1702A34A3B26E676AE92F,60401,15,17,2,109.47444,18.27583,1414
18721,D879D98E97B1702A34A3B26E676AE92F,60441,17,18,1,109.46792,18.28604,1366
18722,D879D98E97B1702A34A3B26E676AE92F,31021,19,20,1,109.49021,18.27,1463
18737,1C4E4A12A4530E1BF0A8E58C02423D58,30421,0,8,8,109.50021,18.25861,1511
18738,1C4E4A12A4530E1BF0A8E58C02423D58,31301,11,12,1,109.14493,18.31222,170
18739,1C4E4A12A4530E1BF0A8E58C02423D58,31471,16,18,2,109.34583,18.29563,917
18740,1C4E4A12A4530E1BF0A8E58C02423D58,30201,19,20,1,109.4909,18.26465,1462
18741,1C4E4A12A4530E1BF0A8E58C02423D58,30771,20,23,3,109.49938,18.26042,1511
18771,172CB232BBE684655CFBDFD055BB1CB5,60491,2,15,13,109.43354,18.30847,1269
18772,172CB232BBE684655CFBDFD055BB1CB5,38251,19,21,2,109.49618,18.25493,1510
18773,172CB232BBE684655CFBDFD055BB1CB5,60491,22,23,1,109.43354,18.30847,1269
18784,066CC6CBB5ADF978A93AF5D0C3292806,30071,0,6,6,109.52819,18.30472,1619
18785,066CC6CBB5ADF978A93AF5D0C3292806,31931,7,8,1,109.54771,18.29403,1667
18786,066CC6CBB5ADF978A93AF5D0C3292806,30221,8,10,2,109.57833,18.20222,1802
18794,0EA31DC24D5B7028E03AA286B0DB11EF,31071,3,7,4,109.58257,18.28458,1815
18795,0EA31DC24D5B7028E03AA286B0DB11EF,30854,8,9,1,109.56889,18.27076,1763
18796,0EA31DC24D5B7028E03AA286B0DB11EF,31071,12,23,11,109.58257,18.28458,1815
18811,222E0B6922623CE9FBB280F81068D40E,60201,0,1,1,109.5041,18.2509,1510
18812,222E0B6922623CE9FBB280F81068D40E,30571,3,8,5,109.50243,18.21861,1504
18813,222E0B6922623CE9FBB280F81068D40E,30854,10,11,1,109.56889,18.27076,1763
18814,222E0B6922623CE9FBB280F81068D40E,39321,11,16,5,109.529,18.2167,1604
18815,222E0B6922623CE9FBB280F81068D40E,30361,17,18,1,109.50347,18.24,1508
18816,222E0B6922623CE9FBB280F81068D40E,31071,18,20,2,109.58257,18.28458,1815
18817,222E0B6922623CE9FBB280F81068D40E,30861,20,21,1,109.52722,18.22743,1606
18846,FA3AD6E291717591632932F7645364C4,60381,16,17,1,109.5241,18.22458,1605
18847,FA3AD6E291717591632932F7645364C4,31201,19,22,3,109.51042,18.23819,1558
18857,90D91A493F9482486DCC3B27CF3F61EE,30854,0,11,11,109.56889,18.27076,1763
18858,90D91A493F9482486DCC3B27CF3F61EE,31071,11,13,2,109.58257,18.28458,1815
18859,90D91A493F9482486DCC3B27CF3F61EE,60011,14,16,2,109.48965,18.30222,1468
18870,C5420A088102AB6EF96693A81B24F272,30161,0,14,14,109.50042,18.24389,1508
18893,16E7FE2323920519CAE8DE58935CE9E2,31021,0,1,1,109.49021,18.27,1463
18894,16E7FE2323920519CAE8DE58935CE9E2,30171,2,3,1,109.48458,18.27139,1463
18895,16E7FE2323920519CAE8DE58935CE9E2,31021,5,12,7,109.49021,18.27,1463
18896,16E7FE2323920519CAE8DE58935CE9E2,31521,13,15,2,109.51458,18.22542,1555
18902,7F6E66BC10419161F6457A6D79258EDB,31431,8,12,4,109.44639,18.29042,1316
18903,7F6E66BC10419161F6457A6D79258EDB,38094,12,13,1,109.45403,18.28778,1316
18904,7F6E66BC10419161F6457A6D79258EDB,38251,13,15,2,109.49618,18.25493,1510
18905,7F6E66BC10419161F6457A6D79258EDB,38094,15,16,1,109.45403,18.28778,1316
18906,7F6E66BC10419161F6457A6D79258EDB,30341,17,19,2,109.3625,18.29167,966
18907,7F6E66BC10419161F6457A6D79258EDB,31431,19,21,2,109.44639,18.29042,1316
18908,7F6E66BC10419161F6457A6D79258EDB,60621,22,23,1,109.48354,18.27451,1464
18912,ADF0A7CED2B8DFD757D8FCA8B507C37E,31561,8,12,4,109.56792,18.28479,1765
18913,ADF0A7CED2B8DFD757D8FCA8B507C37E,30854,16,17,1,109.56889,18.27076,1763
18925,19F803FB996471824A8A9928BBFAB433,39181,0,2,2,109.55153,18.28035,1715
18926,19F803FB996471824A8A9928BBFAB433,39181,3,5,2,109.55153,18.28035,1715
18927,19F803FB996471824A8A9928BBFAB433,31931,6,17,11,109.54771,18.29403,1667
18928,19F803FB996471824A8A9928BBFAB433,39181,21,23,2,109.55153,18.28035,1715
18971,6815588633DF1E7C6974D1816808CD27,30711,14,15,1,109.50271,18.25347,1510
18972,6815588633DF1E7C6974D1816808CD27,60214,17,23,6,109.63104,18.24493,2009
18994,C925EDC1C2C39BAEC75090090BF059D6,30741,0,8,8,109.49833,18.28681,1516
18995,C925EDC1C2C39BAEC75090090BF059D6,31621,9,11,2,109.51035,18.29826,1568
18996,C925EDC1C2C39BAEC75090090BF059D6,31031,12,13,1,109.49979,18.25382,1510
19002,13104A6A71A054F852B52BB76993ADB2,30854,2,4,2,109.56889,18.27076,1763
19003,13104A6A71A054F852B52BB76993ADB2,30851,6,17,11,109.5616,18.27396,1713
19004,13104A6A71A054F852B52BB76993ADB2,30854,18,22,4,109.56889,18.27076,1763
19017,72DB83A0C264C593519E48D6DF804A0A,38145,1,7,6,109.378,18.2912,1066
19018,72DB83A0C264C593519E48D6DF804A0A,38023,8,9,1,109.37132,18.28993,1016
19019,72DB83A0C264C593519E48D6DF804A0A,38754,11,14,3,109.74667,18.37382,2430
19026,7BDC7962058E5B3507F7C37155585188,30121,0,5,5,109.52861,18.27222,1613
19027,7BDC7962058E5B3507F7C37155585188,38157,5,10,5,109.51483,18.26958,1563
19028,7BDC7962058E5B3507F7C37155585188,30121,11,12,1,109.52861,18.27222,1613
19029,D4EE8E1A4C04A1FF0596E4221D0B8B42,31071,0,8,8,109.58257,18.28458,1815
19030,D4EE8E1A4C04A1FF0596E4221D0B8B42,30854,8,19,11,109.56889,18.27076,1763
19038,7803AECF4FFC2BF233E3B7ACD0D2E9F8,39181,0,6,6,109.55153,18.28035,1715
19039,7803AECF4FFC2BF233E3B7ACD0D2E9F8,31931,9,10,1,109.54771,18.29403,1667
19040,7803AECF4FFC2BF233E3B7ACD0D2E9F8,39181,12,13,1,109.55153,18.28035,1715
19041,7803AECF4FFC2BF233E3B7ACD0D2E9F8,31931,14,19,5,109.54771,18.29403,1667
19042,7803AECF4FFC2BF233E3B7ACD0D2E9F8,39181,19,23,4,109.55153,18.28035,1715
19043,21C41A61C814FFC904BE2F7898C083F4,39181,14,17,3,109.55153,18.28035,1715
19044,21C41A61C814FFC904BE2F7898C083F4,30854,19,23,4,109.56889,18.27076,1763
19048,32F65A20D32806FF353EB969C069139F,60131,0,7,7,109.49819,18.24778,1509
19049,32F65A20D32806FF353EB969C069139F,38251,7,9,2,109.49618,18.25493,1510
19050,32F65A20D32806FF353EB969C069139F,31781,11,15,4,109.19847,18.2975,367
19051,32F65A20D32806FF353EB969C069139F,31031,19,23,4,109.49979,18.25382,1510
19103,803884DAE228D36B780CDE250AFE5FD1,31145,10,13,3,109.20431,18.30479,369
19114,8F7D135BB250B868AED050A8A87B3A62,60381,14,20,6,109.5241,18.22458,1605
19115,8F7D135BB250B868AED050A8A87B3A62,31031,21,23,2,109.49979,18.25382,1510
19132,5D13B9AAC9BCDFE76312470DC16FC54B,30821,16,17,1,109.43681,18.33639,1274
19133,5D13B9AAC9BCDFE76312470DC16FC54B,38951,18,23,5,109.48097,18.28868,1416
19140,9B389AE8E9B004176803CCEAFF69104A,30361,15,16,1,109.50347,18.24,1508
19141,9B389AE8E9B004176803CCEAFF69104A,30854,17,18,1,109.56889,18.27076,1763
19157,5334281F127888E8146BE3F4F35A8EA8,38105,10,14,4,109.40299,18.29229,1117
19158,5334281F127888E8146BE3F4F35A8EA8,38105,17,23,6,109.40299,18.29229,1117
19181,607C0807B1A95FC610C778BBD11B692C,60401,2,6,4,109.47444,18.27583,1414
19182,607C0807B1A95FC610C778BBD11B692C,31471,10,12,2,109.34583,18.29563,917
19183,607C0807B1A95FC610C778BBD11B692C,31471,13,15,2,109.34583,18.29563,917
19184,607C0807B1A95FC610C778BBD11B692C,30361,16,17,1,109.50347,18.24,1508
19234,7112BF910BB8852FB892FD72D6683B89,31231,0,2,2,109.42597,18.29292,1217
19239,1C67859AC074D33800F75471EB5E573E,31071,0,4,4,109.58257,18.28458,1815
19240,1C67859AC074D33800F75471EB5E573E,60631,4,6,2,109.57778,18.27583,1814
19241,1C67859AC074D33800F75471EB5E573E,30854,6,7,1,109.56889,18.27076,1763
19242,1C67859AC074D33800F75471EB5E573E,60631,10,12,2,109.57778,18.27583,1814
19320,C53DCD50B35716D9CDF363C094C744D7,60381,16,17,1,109.5241,18.22458,1605
19351,6BB4E2A5DCDB0456DBD1871F654F3F5B,31551,0,9,9,109.55868,18.24222,1708
19352,6BB4E2A5DCDB0456DBD1871F654F3F5B,31554,10,11,1,109.55521,18.2459,1709
19353,6BB4E2A5DCDB0456DBD1871F654F3F5B,31781,14,15,1,109.19847,18.2975,367
19354,6BB4E2A5DCDB0456DBD1871F654F3F5B,31471,17,18,1,109.34583,18.29563,917
19355,6BB4E2A5DCDB0456DBD1871F654F3F5B,30421,19,21,2,109.50021,18.25861,1511
19365,4AA92C2276692190731459431C798101,31945,0,7,7,109.58021,18.29403,1817
19366,4AA92C2276692190731459431C798101,31071,9,12,3,109.58257,18.28458,1815
19367,4AA92C2276692190731459431C798101,31945,12,15,3,109.58021,18.29403,1817
19510,3B665E166952840930754F2FE1E3A505,30211,0,8,8,109.49882,18.23931,1508
19511,3B665E166952840930754F2FE1E3A505,30961,8,15,7,109.74042,18.37903,2431
19512,3B665E166952840930754F2FE1E3A505,31511,20,23,3,109.26326,18.40521,635
19528,38F4BE4A665B515DC81C1A78A906BDC2,60371,0,6,6,109.53063,18.30056,1618
19537,632A9EB46E40EB8DE8C99AAD5A0CDFB2,60231,12,13,1,109.49903,18.21972,1504
19538,632A9EB46E40EB8DE8C99AAD5A0CDFB2,30341,14,15,1,109.3625,18.29167,966
19539,632A9EB46E40EB8DE8C99AAD5A0CDFB2,30661,15,19,4,109.37028,18.24361,1008
19540,FB16AA24AD94D8CC7E1110E44BD68910,31945,0,7,7,109.58021,18.29403,1817
19541,FB16AA24AD94D8CC7E1110E44BD68910,30854,9,11,2,109.56889,18.27076,1763
19542,FB16AA24AD94D8CC7E1110E44BD68910,31945,12,14,2,109.58021,18.29403,1817
19543,FB16AA24AD94D8CC7E1110E44BD68910,30854,14,19,5,109.56889,18.27076,1763
19554,D3004C26B73D96A247072F770E084D3C,31021,2,5,3,109.49021,18.27,1463
19555,D3004C26B73D96A247072F770E084D3C,31061,6,7,1,109.53333,18.23257,1607
19556,D3004C26B73D96A247072F770E084D3C,31021,9,23,14,109.49021,18.27,1463
19569,706B8E0F0F5D1C9FC2F8EBB2574EE89F,30711,0,9,9,109.50271,18.25347,1510
19570,706B8E0F0F5D1C9FC2F8EBB2574EE89F,31461,11,14,3,109.5091,18.25389,1510
19571,706B8E0F0F5D1C9FC2F8EBB2574EE89F,60201,14,22,8,109.5041,18.2509,1510
19577,EBD16061EA20EE33D9344D33735E5205,31261,13,15,2,109.51174,18.2466,1559
19578,EBD16061EA20EE33D9344D33735E5205,31201,18,21,3,109.51042,18.23819,1558
19579,EBD16061EA20EE33D9344D33735E5205,31391,22,23,1,109.50382,18.24285,1508
19580,DAD41A08139183F422619BE0E02762D2,31781,12,14,2,109.19847,18.2975,367
19581,DAD41A08139183F422619BE0E02762D2,31471,15,17,2,109.34583,18.29563,917
19582,DAD41A08139183F422619BE0E02762D2,60631,21,23,2,109.57778,18.27583,1814
19583,3C6B416FA80A7A03E14FC0317D60CB00,60631,16,18,2,109.57778,18.27583,1814
19584,3C6B416FA80A7A03E14FC0317D60CB00,30854,22,23,1,109.56889,18.27076,1763
19647,B12433B5B11FA73A44C6D6FB9BE61089,60401,0,3,3,109.47444,18.27583,1414
19648,B12433B5B11FA73A44C6D6FB9BE61089,31531,5,7,2,109.49583,18.25972,1461
19649,B12433B5B11FA73A44C6D6FB9BE61089,60401,8,10,2,109.47444,18.27583,1414
19650,B12433B5B11FA73A44C6D6FB9BE61089,60161,11,12,1,109.49174,18.26181,1461
19651,B12433B5B11FA73A44C6D6FB9BE61089,38251,13,16,3,109.49618,18.25493,1510
19652,B12433B5B11FA73A44C6D6FB9BE61089,30161,17,18,1,109.50042,18.24389,1508
19667,ACDEAAF45B65DE48CF80A48DBD3C775E,31071,1,6,5,109.58257,18.28458,1815
19668,ACDEAAF45B65DE48CF80A48DBD3C775E,30854,8,9,1,109.56889,18.27076,1763
19669,ACDEAAF45B65DE48CF80A48DBD3C775E,31071,9,18,9,109.58257,18.28458,1815
19670,ACDEAAF45B65DE48CF80A48DBD3C775E,31061,18,20,2,109.53333,18.23257,1607
19694,F3EA7BB85A440E2BE2D597787EA5279B,60235,0,3,3,109.49269,18.2253,1455
19695,F3EA7BB85A440E2BE2D597787EA5279B,30051,4,11,7,109.48917,18.21215,1453
19696,F3EA7BB85A440E2BE2D597787EA5279B,38834,12,14,2,109.47639,18.21146,1403
19697,F3EA7BB85A440E2BE2D597787EA5279B,30051,14,22,8,109.48917,18.21215,1453
19722,6B6A1D2EB88367239FCB3C8A121F0BB1,39091,20,21,1,109.50097,18.25222,1510
19726,77C40EC0900CEBC61DCB060F03E5C749,30661,0,8,8,109.37028,18.24361,1008
19727,77C40EC0900CEBC61DCB060F03E5C749,30711,10,11,1,109.50271,18.25347,1510
19728,77C40EC0900CEBC61DCB060F03E5C749,30281,11,13,2,109.50597,18.27583,1514
19729,77C40EC0900CEBC61DCB060F03E5C749,30661,14,23,9,109.37028,18.24361,1008
19745,FBC323A047041F71D8997C22FDE88F17,30181,0,10,10,109.51597,18.23313,1557
19758,B55959B64746A18ECF5077B5F7359221,31561,0,18,18,109.56792,18.28479,1765
19759,B55959B64746A18ECF5077B5F7359221,30851,20,21,1,109.5616,18.27396,1713
19760,B55959B64746A18ECF5077B5F7359221,31561,21,23,2,109.56792,18.28479,1765
19773,CE17A391725DA64890DF44713AF877C7,31864,0,9,9,109.49014,18.28333,1465
19774,CE17A391725DA64890DF44713AF877C7,31145,10,12,2,109.20431,18.30479,369
19779,33F9415FD6B58B5A945236B41FCD67FA,60381,8,9,1,109.5241,18.22458,1605
19780,33F9415FD6B58B5A945236B41FCD67FA,31521,10,11,1,109.51458,18.22542,1555
19781,33F9415FD6B58B5A945236B41FCD67FA,33481,12,15,3,109.67278,18.41278,2187
19782,33F9415FD6B58B5A945236B41FCD67FA,60381,17,20,3,109.5241,18.22458,1605
19790,1A1509AC6E667B603EE3773D1273B7B0,38541,0,11,11,109.73715,18.34875,2426
19791,1A1509AC6E667B603EE3773D1273B7B0,38145,15,18,3,109.378,18.2912,1066
19792,1A1509AC6E667B603EE3773D1273B7B0,30191,21,22,1,109.50361,18.22701,1506
19844,DEF4648D3893FF8E920C5B6471338CA5,38111,0,7,7,109.52007,18.22403,1555
19845,DEF4648D3893FF8E920C5B6471338CA5,38111,7,15,8,109.52007,18.22403,1555
19846,DEF4648D3893FF8E920C5B6471338CA5,30361,18,20,2,109.50347,18.24,1508
19877,D2BE734582180DAAF2896780F67C646E,38251,12,13,1,109.49618,18.25493,1510
19878,D2BE734582180DAAF2896780F67C646E,31345,14,17,3,109.39,18.29,1066
19879,D2BE734582180DAAF2896780F67C646E,60241,18,21,3,109.53319,18.28667,1616
19880,D2BE734582180DAAF2896780F67C646E,31345,22,23,1,109.39,18.29,1066
19961,6B806948BC9187A91D033B4096721B00,31561,3,4,1,109.56792,18.28479,1765
19962,6B806948BC9187A91D033B4096721B00,31071,6,14,8,109.58257,18.28458,1815
19963,6B806948BC9187A91D033B4096721B00,30961,15,17,2,109.74042,18.37903,2431
19964,818E265DAAF91F82D1A6FBD8988FB914,38271,0,12,12,109.62632,18.23049,1956
19965,818E265DAAF91F82D1A6FBD8988FB914,31521,14,16,2,109.51458,18.22542,1555
19966,818E265DAAF91F82D1A6FBD8988FB914,60381,16,18,2,109.5241,18.22458,1605
19967,818E265DAAF91F82D1A6FBD8988FB914,31521,19,22,3,109.51458,18.22542,1555
19990,01282A80CFB4D1A01E953241ACFECD26,30232,0,7,7,109.6191,18.31701,1971
19991,01282A80CFB4D1A01E953241ACFECD26,30854,10,23,13,109.56889,18.27076,1763
20001,596B04889B7189F5A19701A1FADC1CE1,60441,0,3,3,109.46792,18.28604,1366
20002,596B04889B7189F5A19701A1FADC1CE1,60501,3,6,3,109.48701,18.29021,1466
20003,596B04889B7189F5A19701A1FADC1CE1,31471,10,12,2,109.34583,18.29563,917
20004,596B04889B7189F5A19701A1FADC1CE1,31471,13,15,2,109.34583,18.29563,917
20005,596B04889B7189F5A19701A1FADC1CE1,30361,16,18,2,109.50347,18.24,1508
20033,149F44702DEC8C73589BE6524F0A1FFD,30854,1,12,11,109.56889,18.27076,1763
20034,149F44702DEC8C73589BE6524F0A1FFD,38085,15,23,8,109.6291,18.23625,2007
20069,11150C7195A88F4196F1FFE1C448FD6F,39191,17,18,1,109.51493,18.23472,1557
20070,11150C7195A88F4196F1FFE1C448FD6F,31521,19,23,4,109.51458,18.22542,1555
20091,249541951E1FA75CAD2B8C3DC95305E9,31181,0,13,13,109.50382,18.24813,1509
20092,249541951E1FA75CAD2B8C3DC95305E9,60381,17,18,1,109.5241,18.22458,1605
20093,249541951E1FA75CAD2B8C3DC95305E9,31521,21,22,1,109.51458,18.22542,1555
20104,CA9DF84C64B1C31A61B42BDFD659A4B0,39111,8,10,2,109.5191,18.22597,1555
20105,CA9DF84C64B1C31A61B42BDFD659A4B0,38111,11,12,1,109.52007,18.22403,1555
20106,CA9DF84C64B1C31A61B42BDFD659A4B0,30581,15,17,2,109.62257,18.24951,1959
20107,CA9DF84C64B1C31A61B42BDFD659A4B0,31061,19,20,1,109.53333,18.23257,1607
20108,CA9DF84C64B1C31A61B42BDFD659A4B0,30854,21,23,2,109.56889,18.27076,1763
20128,4E8D704BCF620F593D2EDF35593B050F,60221,0,2,2,109.52569,18.29188,1616
20129,4E8D704BCF620F593D2EDF35593B050F,30121,3,13,10,109.52861,18.27222,1613
20141,3977578BE56276DA0700B04B81DC1356,30851,0,5,5,109.5616,18.27396,1713
20142,3977578BE56276DA0700B04B81DC1356,31561,8,21,13,109.56792,18.28479,1765
20174,44A75810FF8F9221047E9675BDBF60A2,31561,0,10,10,109.56792,18.28479,1765
20175,44A75810FF8F9221047E9675BDBF60A2,30854,11,13,2,109.56889,18.27076,1763
20176,44A75810FF8F9221047E9675BDBF60A2,31071,13,16,3,109.58257,18.28458,1815
20177,44A75810FF8F9221047E9675BDBF60A2,30854,16,19,3,109.56889,18.27076,1763
20188,24892DF473AC6ED4692FBD552CF21D37,60381,0,13,13,109.5241,18.22458,1605
20189,24892DF473AC6ED4692FBD552CF21D37,38291,14,16,2,109.51618,18.24313,1558
20190,24892DF473AC6ED4692FBD552CF21D37,60381,17,23,6,109.5241,18.22458,1605
20203,C46791F8A63EAA182DA8476F552E0783,30571,0,6,6,109.50243,18.21861,1504
20204,C46791F8A63EAA182DA8476F552E0783,30051,6,8,2,109.48917,18.21215,1453
20205,C46791F8A63EAA182DA8476F552E0783,30571,9,11,2,109.50243,18.21861,1504
20206,C46791F8A63EAA182DA8476F552E0783,30051,12,18,6,109.48917,18.21215,1453
20207,C46791F8A63EAA182DA8476F552E0783,30571,18,21,3,109.50243,18.21861,1504
20242,65DB2325B6E1E7A0D88A5D2D920F9EA1,30671,17,19,2,109.43611,18.30139,1268
20243,65DB2325B6E1E7A0D88A5D2D920F9EA1,30711,20,21,1,109.50271,18.25347,1510
20251,6214A0F588192A4454E59CAEC65A5FD3,31091,9,11,2,109.41201,18.31222,1170
20252,6214A0F588192A4454E59CAEC65A5FD3,30761,12,14,2,109.45201,18.3,1318
20271,451E2BF48CD7B253EB0892324E679BCC,38297,1,5,4,109.52576,18.24965,1609
20272,451E2BF48CD7B253EB0892324E679BCC,38291,10,18,8,109.51618,18.24313,1558
20273,451E2BF48CD7B253EB0892324E679BCC,31461,18,20,2,109.5091,18.25389,1510
20274,451E2BF48CD7B253EB0892324E679BCC,38297,21,22,1,109.52576,18.24965,1609
20280,4DB778A581941E2A7955D8DA3B7ADAFE,31931,1,6,5,109.54771,18.29403,1667
20281,4DB778A581941E2A7955D8DA3B7ADAFE,60114,8,16,8,109.73028,18.33847,2374
20282,4DB778A581941E2A7955D8DA3B7ADAFE,31931,20,22,2,109.54771,18.29403,1667
20283,8A0382A2385C362EFE2664E8795F133E,31561,0,5,5,109.56792,18.28479,1765
20284,8A0382A2385C362EFE2664E8795F133E,39183,7,23,16,109.55542,18.28208,1715
20291,E190DB99CF7C69343ED6E8D0E6D1804C,30181,17,19,2,109.51597,18.23313,1557
20292,E190DB99CF7C69343ED6E8D0E6D1804C,60081,20,21,1,109.51097,18.22639,1556
20293,E190DB99CF7C69343ED6E8D0E6D1804C,30191,22,23,1,109.50361,18.22701,1506
20296,FF82E60C3B0E4D2A80EC02E3FA5D30BF,31421,0,1,1,109.55382,18.22347,1705
20297,FF82E60C3B0E4D2A80EC02E3FA5D30BF,30854,4,11,7,109.56889,18.27076,1763
20298,FF82E60C3B0E4D2A80EC02E3FA5D30BF,31071,15,23,8,109.58257,18.28458,1815
20314,DDE77D3A656666992FC3458B84010D43,31561,6,9,3,109.56792,18.28479,1765
20315,DDE77D3A656666992FC3458B84010D43,39183,11,13,2,109.55542,18.28208,1715
20316,DDE77D3A656666992FC3458B84010D43,31561,16,17,1,109.56792,18.28479,1765
20325,07FD145FE6C81328C98C6C5C8452E794,30232,1,3,2,109.6191,18.31701,1971
20326,07FD145FE6C81328C98C6C5C8452E794,30854,5,15,10,109.56889,18.27076,1763
20327,07FD145FE6C81328C98C6C5C8452E794,30232,16,18,2,109.6191,18.31701,1971
20328,07FD145FE6C81328C98C6C5C8452E794,30854,18,23,5,109.56889,18.27076,1763
20352,8FAAC7EA21AE7BB6F52A4D0F285944CD,38721,0,8,8,109.50368,18.27542,1514
20353,8FAAC7EA21AE7BB6F52A4D0F285944CD,60201,9,12,3,109.5041,18.2509,1510
20355,18794851E86EA8BA29FCF821CF1F07C3,60631,0,7,7,109.57778,18.27583,1814
20356,18794851E86EA8BA29FCF821CF1F07C3,31071,7,8,1,109.58257,18.28458,1815
20357,18794851E86EA8BA29FCF821CF1F07C3,30854,9,16,7,109.56889,18.27076,1763
20358,18794851E86EA8BA29FCF821CF1F07C3,39111,21,23,2,109.5191,18.22597,1555
20373,286D46B25329E5094759120B95EE260C,31471,14,18,4,109.34583,18.29563,917
20374,286D46B25329E5094759120B95EE260C,60401,19,23,4,109.47444,18.27583,1414
20391,860D8FD1FD466E2189F245D42B766A0C,30271,0,8,8,109.49132,18.23153,1456
20392,860D8FD1FD466E2189F245D42B766A0C,31145,12,14,2,109.20431,18.30479,369
20393,860D8FD1FD466E2189F245D42B766A0C,31471,15,16,1,109.34583,18.29563,917
20398,283001ED673D8EDBEF7EEB00BDB31533,38017,2,3,1,109.49729,18.21424,1504
20399,283001ED673D8EDBEF7EEB00BDB31533,31181,7,12,5,109.50382,18.24813,1509
20400,283001ED673D8EDBEF7EEB00BDB31533,60201,13,18,5,109.5041,18.2509,1510
20401,283001ED673D8EDBEF7EEB00BDB31533,30571,20,22,2,109.50243,18.21861,1504
20402,7FB788587E50C54855D5FD7A453A7032,31491,11,12,1,109.73042,18.38771,2382
20403,7FB788587E50C54855D5FD7A453A7032,60381,14,16,2,109.5241,18.22458,1605
20404,7FB788587E50C54855D5FD7A453A7032,31521,19,22,3,109.51458,18.22542,1555
20416,B0D3EC92066D758E0973317388F707DC,38251,0,7,7,109.49618,18.25493,1510
20418,B0D3EC92066D758E0973317388F707DC,30711,14,23,9,109.50271,18.25347,1510
20440,202870BA524F8D7E9C1B66336BF1F034,38991,0,5,5,109.52681,18.30368,1618
20441,202870BA524F8D7E9C1B66336BF1F034,30854,6,17,11,109.56889,18.27076,1763
20442,202870BA524F8D7E9C1B66336BF1F034,31951,18,20,2,109.52174,18.30299,1568
20500,ADDDEBD546B43FF699A163EB1EA5FE50,30721,0,10,10,109.51597,18.28257,1565
20501,ADDDEBD546B43FF699A163EB1EA5FE50,60501,13,14,1,109.48701,18.29021,1466
20502,ADDDEBD546B43FF699A163EB1EA5FE50,31145,15,17,2,109.20431,18.30479,369
20545,34AB502A442AA8EA4A7FB30471B204DB,60621,0,7,7,109.48354,18.27451,1464
20546,34AB502A442AA8EA4A7FB30471B204DB,31431,8,10,2,109.44639,18.29042,1316
20547,34AB502A442AA8EA4A7FB30471B204DB,38094,11,14,3,109.45403,18.28778,1316
20548,34AB502A442AA8EA4A7FB30471B204DB,31431,14,21,7,109.44639,18.29042,1316
20564,A97645679390087E090050CF3F130352,31931,0,15,15,109.54771,18.29403,1667
20565,A97645679390087E090050CF3F130352,60361,19,21,2,109.51938,18.29681,1567
20566,A97645679390087E090050CF3F130352,31931,21,23,2,109.54771,18.29403,1667
20579,5EB757C8918F704B5295B0BDE01D6841,60371,1,7,6,109.53063,18.30056,1618
20580,5EB757C8918F704B5295B0BDE01D6841,60524,8,16,8,109.42951,18.28993,1216
20581,5EB757C8918F704B5295B0BDE01D6841,38165,17,20,3,109.44847,18.28896,1316
20582,5EB757C8918F704B5295B0BDE01D6841,31701,22,23,1,109.44132,18.28833,1266
20599,CD576F1C1CDFB89E6A99A20E65927346,31561,0,7,7,109.56792,18.28479,1765
20600,CD576F1C1CDFB89E6A99A20E65927346,30854,8,23,15,109.56889,18.27076,1763
20629,3B9061AE88ADC0D0A5DE900FE25015E0,30421,17,20,3,109.50021,18.25861,1511
20630,3B9061AE88ADC0D0A5DE900FE25015E0,30201,20,23,3,109.4909,18.26465,1462
20642,0695D4E7B3E726CA09D841B87798B560,31561,0,6,6,109.56792,18.28479,1765
20643,0695D4E7B3E726CA09D841B87798B560,30854,9,11,2,109.56889,18.27076,1763
20675,9D46ADF861D5CE19E2EA4CF9567B5E97,31021,0,10,10,109.49021,18.27,1463
20676,9D46ADF861D5CE19E2EA4CF9567B5E97,60411,14,22,8,109.32514,18.30854,869
20677,63FBAC0202144B00077561285E6A7F87,30821,0,21,21,109.43681,18.33639,1274
20678,63FBAC0202144B00077561285E6A7F87,30651,22,23,1,109.42611,18.385,1232
20718,E32F04C32D00AF60E04FA89AD4525A3E,39111,0,7,7,109.5191,18.22597,1555
20719,E32F04C32D00AF60E04FA89AD4525A3E,31521,8,17,9,109.51458,18.22542,1555
20720,E32F04C32D00AF60E04FA89AD4525A3E,30361,17,20,3,109.50347,18.24,1508
20721,E32F04C32D00AF60E04FA89AD4525A3E,60381,21,22,1,109.5241,18.22458,1605
20724,AEA3E45BA06B234C15322E381D44AC89,60361,0,1,1,109.51938,18.29681,1567
20725,AEA3E45BA06B234C15322E381D44AC89,30031,1,8,7,109.53681,18.33313,1673
20726,AEA3E45BA06B234C15322E381D44AC89,38484,8,10,2,109.53028,18.31528,1620
20727,AEA3E45BA06B234C15322E381D44AC89,31731,12,17,5,109.15583,18.41208,237
20733,6CC17B7330C92688489D8257513BBA0C,38951,18,20,2,109.48097,18.28868,1416
20734,6CC17B7330C92688489D8257513BBA0C,38951,20,22,2,109.48097,18.28868,1416
20742,33D0BAF81064BA9871C044941C4D0C71,31531,0,1,1,109.49583,18.25972,1461
20743,33D0BAF81064BA9871C044941C4D0C71,30051,2,8,6,109.48917,18.21215,1453
20744,33D0BAF81064BA9871C044941C4D0C71,30211,9,10,1,109.49882,18.23931,1508
20745,33D0BAF81064BA9871C044941C4D0C71,60161,11,13,2,109.49174,18.26181,1461
20746,33D0BAF81064BA9871C044941C4D0C71,38251,13,14,1,109.49618,18.25493,1510
20747,33D0BAF81064BA9871C044941C4D0C71,30161,17,18,1,109.50042,18.24389,1508
20748,33D0BAF81064BA9871C044941C4D0C71,31031,18,19,1,109.49979,18.25382,1510
20749,33D0BAF81064BA9871C044941C4D0C71,30161,20,21,1,109.50042,18.24389,1508
20835,D75685FDDCAB468D56B1A74F09B1658B,30421,19,20,1,109.50021,18.25861,1511
20836,D75685FDDCAB468D56B1A74F09B1658B,30171,21,22,1,109.48458,18.27139,1463
20872,98E9CA76753F47429976B759A0E81031,30854,16,17,1,109.56889,18.27076,1763
20873,98E9CA76753F47429976B759A0E81031,30361,17,19,2,109.50347,18.24,1508
20874,31BAA46A2F25AC63D78E0ACA44BF0FE9,39181,0,7,7,109.55153,18.28035,1715
20875,31BAA46A2F25AC63D78E0ACA44BF0FE9,31931,10,11,1,109.54771,18.29403,1667
20876,31BAA46A2F25AC63D78E0ACA44BF0FE9,39181,12,23,11,109.55153,18.28035,1715
20885,876477FD9DD46FF97674E612DA6296D8,38251,0,1,1,109.49618,18.25493,1510
20886,876477FD9DD46FF97674E612DA6296D8,30051,2,9,7,109.48917,18.21215,1453
20887,876477FD9DD46FF97674E612DA6296D8,30211,10,11,1,109.49882,18.23931,1508
20888,876477FD9DD46FF97674E612DA6296D8,31531,11,23,12,109.49583,18.25972,1461
20910,C0854C822B195FB48BF4D1F38FA62F37,60501,17,18,1,109.48701,18.29021,1466
20939,D080330F46FFE140C3D67F6850CA9E9D,38251,1,2,1,109.49618,18.25493,1510
20940,D080330F46FFE140C3D67F6850CA9E9D,31531,3,11,8,109.49583,18.25972,1461
20941,D080330F46FFE140C3D67F6850CA9E9D,38251,12,13,1,109.49618,18.25493,1510
20942,D080330F46FFE140C3D67F6850CA9E9D,31531,16,23,7,109.49583,18.25972,1461
20943,8586C09CC5E6256A8D795F3F0A4D8307,31071,0,12,12,109.58257,18.28458,1815
20944,8586C09CC5E6256A8D795F3F0A4D8307,31761,13,14,1,109.60521,18.27965,1914
20945,8586C09CC5E6256A8D795F3F0A4D8307,31931,15,20,5,109.54771,18.29403,1667
20955,CC4662D0AB761935A19DD4261E4FE213,30854,17,18,1,109.56889,18.27076,1763
20956,CC4662D0AB761935A19DD4261E4FE213,31561,19,23,4,109.56792,18.28479,1765
20957,70A62761FE79F922D082380DA7747243,30854,0,6,6,109.56889,18.27076,1763
20958,70A62761FE79F922D082380DA7747243,31071,6,7,1,109.58257,18.28458,1815
20959,70A62761FE79F922D082380DA7747243,30854,9,21,12,109.56889,18.27076,1763
20965,380545BA5319E58C5CB79C70AD75585C,30241,10,11,1,109.26174,18.3275,622
20966,380545BA5319E58C5CB79C70AD75585C,38251,15,19,4,109.49618,18.25493,1510
20967,380545BA5319E58C5CB79C70AD75585C,31031,20,23,3,109.49979,18.25382,1510
20981,560794A44CA17A43FA34D0FA6C339747,31071,0,1,1,109.58257,18.28458,1815
20982,560794A44CA17A43FA34D0FA6C339747,30854,3,23,20,109.56889,18.27076,1763
21002,48DFD1831E15E711158295290AA7084B,60121,18,23,5,109.74507,18.37472,2430
21037,85586D73EA48B4F4D520D899B0BE0554,30291,0,5,5,109.50403,18.27028,1513
21038,85586D73EA48B4F4D520D899B0BE0554,30854,7,8,1,109.56889,18.27076,1763
21039,85586D73EA48B4F4D520D899B0BE0554,31071,8,10,2,109.58257,18.28458,1815
21040,85586D73EA48B4F4D520D899B0BE0554,30851,13,15,2,109.5616,18.27396,1713
21041,85586D73EA48B4F4D520D899B0BE0554,30291,20,23,3,109.50403,18.27028,1513
21077,6E6193514D8E876D83956A94AD4F3FB1,31931,0,17,17,109.54771,18.29403,1667
21078,6E6193514D8E876D83956A94AD4F3FB1,30071,17,19,2,109.52819,18.30472,1619
21079,6E6193514D8E876D83956A94AD4F3FB1,31931,20,21,1,109.54771,18.29403,1667
21098,3C162B8B833533A8C79FA08500420144,30711,16,17,1,109.50271,18.25347,1510
21099,3C162B8B833533A8C79FA08500420144,60571,18,19,1,109.50722,18.25056,1510
21100,3C162B8B833533A8C79FA08500420144,30711,20,23,3,109.50271,18.25347,1510
21103,BE84D9BAD945F657EF3BFD7A07C2842B,39154,0,7,7,109.50201,18.25681,1511
21104,BE84D9BAD945F657EF3BFD7A07C2842B,60211,8,17,9,109.63549,18.26049,2011
21106,AAB3DCB18BAF89954DC0C8A658A6D766,60161,0,5,5,109.49174,18.26181,1461
21107,AAB3DCB18BAF89954DC0C8A658A6D766,30051,7,9,2,109.48917,18.21215,1453
21108,AAB3DCB18BAF89954DC0C8A658A6D766,38251,11,12,1,109.49618,18.25493,1510
21109,AAB3DCB18BAF89954DC0C8A658A6D766,30051,16,17,1,109.48917,18.21215,1453
21116,CAE196EC03060C8EDEBE686324EFE5C1,30271,15,16,1,109.49132,18.23153,1456
21117,CAE196EC03060C8EDEBE686324EFE5C1,60084,16,18,2,109.4984,18.2334,1507
21118,CAE196EC03060C8EDEBE686324EFE5C1,60231,20,21,1,109.49903,18.21972,1504
21130,13166628932DF36C0AD7B1DB5811240A,60591,0,6,6,109.61118,18.21715,1904
21131,13166628932DF36C0AD7B1DB5811240A,30854,6,8,2,109.56889,18.27076,1763
21132,13166628932DF36C0AD7B1DB5811240A,60631,12,13,1,109.57778,18.27583,1814
21133,13166628932DF36C0AD7B1DB5811240A,30854,14,17,3,109.56889,18.27076,1763
21134,13166628932DF36C0AD7B1DB5811240A,60591,19,23,4,109.61118,18.21715,1904
21140,B61666307486DD531F980787F0F8A7B7,60631,1,15,14,109.57778,18.27583,1814
21141,B61666307486DD531F980787F0F8A7B7,30854,20,23,3,109.56889,18.27076,1763
21155,99EC19A65A2EA4B9365521157FB29A4F,60381,0,8,8,109.5241,18.22458,1605
21157,99EC19A65A2EA4B9365521157FB29A4F,31521,17,22,5,109.51458,18.22542,1555
21169,2C5F898948A2B7909519666936FBF333,31145,15,17,2,109.20431,18.30479,369
21170,2C5F898948A2B7909519666936FBF333,38707,18,23,5,109.73778,18.35368,2427
21174,15A2A8790389D1537721C21B141A7A31,61011,1,5,4,109.60653,18.19076,1900
21175,15A2A8790389D1537721C21B141A7A31,60591,7,14,7,109.61118,18.21715,1904
21176,15A2A8790389D1537721C21B141A7A31,61011,19,23,4,109.60653,18.19076,1900
21187,238F3B85BB94B3797E72C402C6567588,38017,0,11,11,109.49729,18.21424,1504
21188,238F3B85BB94B3797E72C402C6567588,31521,13,15,2,109.51458,18.22542,1555
21189,238F3B85BB94B3797E72C402C6567588,38017,17,21,4,109.49729,18.21424,1504
21190,238F3B85BB94B3797E72C402C6567588,30571,21,22,1,109.50243,18.21861,1504
21215,1026894DC5FF9A7FAF3A2EE28B95E239,30854,0,7,7,109.56889,18.27076,1763
21216,1026894DC5FF9A7FAF3A2EE28B95E239,30891,12,14,2,109.59431,18.28389,1865
21217,1026894DC5FF9A7FAF3A2EE28B95E239,30854,15,23,8,109.56889,18.27076,1763
21235,7421066246AAD1C230E7E2A7ADF06E9D,31071,0,5,5,109.58257,18.28458,1815
21236,7421066246AAD1C230E7E2A7ADF06E9D,60631,6,14,8,109.57778,18.27583,1814
21237,7421066246AAD1C230E7E2A7ADF06E9D,31031,17,19,2,109.49979,18.25382,1510
21238,7421066246AAD1C230E7E2A7ADF06E9D,60631,21,22,1,109.57778,18.27583,1814
21266,417408FFDA93B177641D270D3A5C4B2D,31071,0,14,14,109.58257,18.28458,1815
21267,417408FFDA93B177641D270D3A5C4B2D,60631,15,17,2,109.57778,18.27583,1814
21268,417408FFDA93B177641D270D3A5C4B2D,30854,18,19,1,109.56889,18.27076,1763
21269,417408FFDA93B177641D270D3A5C4B2D,31071,20,23,3,109.58257,18.28458,1815
21270,A01E2FD84FFE4D782E40311D1ABC1ECB,31221,0,11,11,109.61333,18.26833,1913
21271,A01E2FD84FFE4D782E40311D1ABC1ECB,31031,13,14,1,109.49979,18.25382,1510
21272,A01E2FD84FFE4D782E40311D1ABC1ECB,38754,15,17,2,109.74667,18.37382,2430
21273,A01E2FD84FFE4D782E40311D1ABC1ECB,30441,22,23,1,109.64021,18.25424,2010
21274,B1BCC89C2F3E15CBE4070B0B890371C7,60631,3,4,1,109.57778,18.27583,1814
21275,B1BCC89C2F3E15CBE4070B0B890371C7,31101,8,10,2,109.65389,18.23403,2057
21276,B1BCC89C2F3E15CBE4070B0B890371C7,30581,10,11,1,109.62257,18.24951,1959
21284,6862E1409834047709EBD3185EEA79B3,38141,8,19,11,109.39479,18.2916,1116
21285,6862E1409834047709EBD3185EEA79B3,38141,19,23,4,109.39479,18.2916,1116
21334,8B7C10EDB3885C1AA91B5F5776CD55A0,30031,0,12,12,109.53681,18.33313,1673
21337,8B7C10EDB3885C1AA91B5F5776CD55A0,30031,21,23,2,109.53681,18.33313,1673
21364,213DAB3EDFD90975944C0716CF1617C5,38541,17,19,2,109.73715,18.34875,2426
21365,213DAB3EDFD90975944C0716CF1617C5,60381,21,22,1,109.5241,18.22458,1605
21366,C1602FB5A20BD98313F7CC13F431D061,30361,0,4,4,109.50347,18.24,1508
21367,C1602FB5A20BD98313F7CC13F431D061,60084,4,9,5,109.4984,18.2334,1507
21368,C1602FB5A20BD98313F7CC13F431D061,60504,9,11,2,109.47917,18.28903,1416
21369,C1602FB5A20BD98313F7CC13F431D061,30361,11,21,10,109.50347,18.24,1508
21402,1D10133A3A6B6A1226F963E2F33A13EC,38707,0,13,13,109.73778,18.35368,2427
21419,489A7E41DEF66D4D4586FE690272FF2B,31781,13,15,2,109.19847,18.2975,367
21420,489A7E41DEF66D4D4586FE690272FF2B,60054,16,17,1,109.3016,18.31229,770
21421,489A7E41DEF66D4D4586FE690272FF2B,60084,19,22,3,109.4984,18.2334,1507
21436,5AB036BD4852DC840A52FF542200B93C,31461,0,9,9,109.5091,18.25389,1510
21437,5AB036BD4852DC840A52FF542200B93C,60221,9,11,2,109.52569,18.29188,1616
21438,5AB036BD4852DC840A52FF542200B93C,31851,14,18,4,109.71736,18.29007,2316
21439,5AB036BD4852DC840A52FF542200B93C,31461,20,23,3,109.5091,18.25389,1510
21440,8A01C766ABD659C6DF7A6AE90AA81678,31521,0,7,7,109.51458,18.22542,1555
21441,8A01C766ABD659C6DF7A6AE90AA81678,31521,8,15,7,109.51458,18.22542,1555
21463,B37777551ADDE84A1FDFE1FF465C24DC,30921,3,6,3,109.53903,18.29451,1667
21464,B37777551ADDE84A1FDFE1FF465C24DC,31931,7,22,15,109.54771,18.29403,1667
21497,E6006DC9696B1830A4C76DE6D9370D13,31531,15,19,4,109.49583,18.25972,1461
21498,E6006DC9696B1830A4C76DE6D9370D13,38251,19,21,2,109.49618,18.25493,1510
21499,E6006DC9696B1830A4C76DE6D9370D13,31531,21,23,2,109.49583,18.25972,1461
21544,D1827685A895D0D5AAA2F3359D099E94,31521,0,8,8,109.51458,18.22542,1555
21545,D1827685A895D0D5AAA2F3359D099E94,60541,11,13,2,109.4084,18.29208,1167
21546,D1827685A895D0D5AAA2F3359D099E94,31521,16,17,1,109.51458,18.22542,1555
21547,D1827685A895D0D5AAA2F3359D099E94,60381,18,20,2,109.5241,18.22458,1605
21548,D1827685A895D0D5AAA2F3359D099E94,31521,21,23,2,109.51458,18.22542,1555
21615,F46FDDC29A8850C2C04367141B6440B6,30854,1,8,7,109.56889,18.27076,1763
21616,F46FDDC29A8850C2C04367141B6440B6,31071,11,12,1,109.58257,18.28458,1815
21617,F46FDDC29A8850C2C04367141B6440B6,30854,13,14,1,109.56889,18.27076,1763
21618,F46FDDC29A8850C2C04367141B6440B6,31101,16,18,2,109.65389,18.23403,2057
21619,F46FDDC29A8850C2C04367141B6440B6,30421,19,20,1,109.50021,18.25861,1511
21626,1952B2BB316D2BB82BFA729C9CE4CADA,39183,17,19,2,109.55542,18.28208,1715
21627,1952B2BB316D2BB82BFA729C9CE4CADA,30111,21,22,1,109.47583,18.30542,1419
21631,005F3AEFE6DBF371ED1FD57736434098,31761,1,6,5,109.60521,18.27965,1914
21632,005F3AEFE6DBF371ED1FD57736434098,30854,7,12,5,109.56889,18.27076,1763
21633,005F3AEFE6DBF371ED1FD57736434098,31071,12,13,1,109.58257,18.28458,1815
21634,005F3AEFE6DBF371ED1FD57736434098,30854,14,15,1,109.56889,18.27076,1763
21658,34F3D64B41C252481F72E5CF931AC833,30854,0,9,9,109.56889,18.27076,1763
21659,34F3D64B41C252481F72E5CF931AC833,30851,14,18,4,109.5616,18.27396,1713
21660,34F3D64B41C252481F72E5CF931AC833,31071,22,23,1,109.58257,18.28458,1815
21674,1877AE3F054132FD529E292AD524A6EA,30854,16,17,1,109.56889,18.27076,1763
21675,1877AE3F054132FD529E292AD524A6EA,30731,19,20,1,109.50944,18.22306,1555
21676,1877AE3F054132FD529E292AD524A6EA,30854,20,22,2,109.56889,18.27076,1763
21768,6CD060321C42DD7917A0544141DE86DE,30111,0,8,8,109.47583,18.30542,1419
21769,6CD060321C42DD7917A0544141DE86DE,31471,9,10,1,109.34583,18.29563,917
21770,6CD060321C42DD7917A0544141DE86DE,30731,15,17,2,109.50944,18.22306,1555
21826,EF727BDF3D7B6D877CF0038228740019,30161,0,6,6,109.50042,18.24389,1508
21827,EF727BDF3D7B6D877CF0038228740019,38251,8,15,7,109.49618,18.25493,1510
21828,EF727BDF3D7B6D877CF0038228740019,60161,17,19,2,109.49174,18.26181,1461
21829,75103A7721D2350907ADF04820429536,38706,0,10,10,109.74625,18.37097,2430
21830,75103A7721D2350907ADF04820429536,31471,13,15,2,109.34583,18.29563,917
21831,75103A7721D2350907ADF04820429536,60121,17,23,6,109.74507,18.37472,2430
21833,A0592EF33D66B7A76C86B07EBD78C8A3,60614,12,13,1,109.48799,18.29521,1467
21834,A0592EF33D66B7A76C86B07EBD78C8A3,38707,14,22,8,109.73778,18.35368,2427
21836,5ED5DC921249A25E4C2998A56E67A3A8,31534,11,12,1,109.49368,18.25806,1461
21837,5ED5DC921249A25E4C2998A56E67A3A8,31471,14,16,2,109.34583,18.29563,917
21838,5ED5DC921249A25E4C2998A56E67A3A8,31531,18,19,1,109.49583,18.25972,1461
21839,5ED5DC921249A25E4C2998A56E67A3A8,30681,20,21,1,109.48493,18.26917,1463
21848,E01AE51461B7CBCB8D8E0EDABDD6770A,38154,16,17,1,109.5266,18.28278,1615
21849,E01AE51461B7CBCB8D8E0EDABDD6770A,30071,17,20,3,109.52819,18.30472,1619
21850,E01AE51461B7CBCB8D8E0EDABDD6770A,60371,20,22,2,109.53063,18.30056,1618
21859,6F25B46DE233F84CBE88187DB2427FA9,30201,0,6,6,109.4909,18.26465,1462
21860,6F25B46DE233F84CBE88187DB2427FA9,31021,8,10,2,109.49021,18.27,1463
21861,6F25B46DE233F84CBE88187DB2427FA9,31861,10,12,2,109.49042,18.27549,1464
21862,6F25B46DE233F84CBE88187DB2427FA9,31021,12,16,4,109.49021,18.27,1463
21863,6F25B46DE233F84CBE88187DB2427FA9,30201,17,23,6,109.4909,18.26465,1462
21864,5EAEAB611440D169B1CE8706AE16111E,31521,1,3,2,109.51458,18.22542,1555
21865,5EAEAB611440D169B1CE8706AE16111E,30511,6,8,2,109.51069,18.24208,1558
21866,5EAEAB611440D169B1CE8706AE16111E,30511,10,13,3,109.51069,18.24208,1558
21867,27BCEF3137923B84211F08830816C810,30851,0,7,7,109.5616,18.27396,1713
21868,27BCEF3137923B84211F08830816C810,61011,9,14,5,109.60653,18.19076,1900
21870,27BCEF3137923B84211F08830816C810,30851,21,23,2,109.5616,18.27396,1713
21886,5426296000364EE32711CD0E73D782C8,31851,16,17,1,109.71736,18.29007,2316
21887,5426296000364EE32711CD0E73D782C8,31031,20,21,1,109.49979,18.25382,1510
21929,357A311CCD3254D76B63BF85FD2D2D37,60371,0,12,12,109.53063,18.30056,1618
21930,357A311CCD3254D76B63BF85FD2D2D37,60591,12,18,6,109.61118,18.21715,1904
21997,3D408742D0773F860BA62D41C728BA97,31071,0,7,7,109.58257,18.28458,1815
21998,3D408742D0773F860BA62D41C728BA97,30854,10,12,2,109.56889,18.27076,1763
21999,3D408742D0773F860BA62D41C728BA97,38821,13,16,3,109.50354,18.25243,1510
22039,B340EDEF4A878E8DF5CBEC25E465EACE,30854,0,10,10,109.56889,18.27076,1763
22040,B340EDEF4A878E8DF5CBEC25E465EACE,31071,12,13,1,109.58257,18.28458,1815
22041,B340EDEF4A878E8DF5CBEC25E465EACE,30854,14,20,6,109.56889,18.27076,1763
22042,9FD9B533440DEDA093A3D6D9A5E4AA42,60361,0,14,14,109.51938,18.29681,1567
22043,9FD9B533440DEDA093A3D6D9A5E4AA42,30854,15,17,2,109.56889,18.27076,1763
22044,9FD9B533440DEDA093A3D6D9A5E4AA42,31071,18,23,5,109.58257,18.28458,1815
22050,B4C8402AE2B2A41C5967767B834E807A,31251,0,7,7,109.18528,18.2975,317
22051,B4C8402AE2B2A41C5967767B834E807A,30661,9,12,3,109.37028,18.24361,1008
22052,B4C8402AE2B2A41C5967767B834E807A,31471,12,14,2,109.34583,18.29563,917
22053,B4C8402AE2B2A41C5967767B834E807A,30741,15,23,8,109.49833,18.28681,1516
22059,D646833EE14E86C476A372E72E00A3F6,31561,0,7,7,109.56792,18.28479,1765
22060,D646833EE14E86C476A372E72E00A3F6,31071,8,19,11,109.58257,18.28458,1815
22061,D646833EE14E86C476A372E72E00A3F6,31561,22,23,1,109.56792,18.28479,1765
22065,8A2602EE97ED1F19C3F8048B259C52D2,60381,8,10,2,109.5241,18.22458,1605
22066,8A2602EE97ED1F19C3F8048B259C52D2,31521,11,16,5,109.51458,18.22542,1555
22067,8A2602EE97ED1F19C3F8048B259C52D2,60381,19,20,1,109.5241,18.22458,1605
22086,F6BB537A775832A45DF7D139A32B29FF,31851,0,12,12,109.71736,18.29007,2316
22087,F6BB537A775832A45DF7D139A32B29FF,38754,13,18,5,109.74667,18.37382,2430
22152,6F991F6415332A5D020632F1E0FDD144,60301,16,23,7,109.60715,18.30993,1919
22167,8CBDC50DA35EAA1BF96B888A29A6656F,60552,0,11,11,109.41729,18.30014,1218
22168,8CBDC50DA35EAA1BF96B888A29A6656F,60551,11,12,1,109.42722,18.30111,1218
22169,8CBDC50DA35EAA1BF96B888A29A6656F,30351,13,14,1,109.41701,18.29292,1217
22170,8CBDC50DA35EAA1BF96B888A29A6656F,31236,15,16,1,109.42965,18.29111,1216
22174,2D39AE6120F2674000C6DBB8A6E572A0,30854,18,20,2,109.56889,18.27076,1763
22175,2D39AE6120F2674000C6DBB8A6E572A0,31945,21,23,2,109.58021,18.29403,1817
22181,7C4555390A772AFC617B693DE91FE9EE,60371,0,6,6,109.53063,18.30056,1618
22182,7C4555390A772AFC617B693DE91FE9EE,31931,9,15,6,109.54771,18.29403,1667
22183,7C4555390A772AFC617B693DE91FE9EE,60371,17,18,1,109.53063,18.30056,1618
22184,7C4555390A772AFC617B693DE91FE9EE,31931,22,23,1,109.54771,18.29403,1667
22192,07E52E5D3C425C98B9D60E80ED39E24E,30721,0,11,11,109.51597,18.28257,1565
22193,07E52E5D3C425C98B9D60E80ED39E24E,39191,12,13,1,109.51493,18.23472,1557
22194,07E52E5D3C425C98B9D60E80ED39E24E,30721,14,17,3,109.51597,18.28257,1565
22195,07E52E5D3C425C98B9D60E80ED39E24E,39111,17,19,2,109.5191,18.22597,1555
22196,07E52E5D3C425C98B9D60E80ED39E24E,30201,21,23,2,109.4909,18.26465,1462
22197,B90183D15168F89346BBFB7C18178548,31201,0,6,6,109.51042,18.23819,1558
22198,B90183D15168F89346BBFB7C18178548,30281,7,9,2,109.50597,18.27583,1514
22199,B90183D15168F89346BBFB7C18178548,30191,12,13,1,109.50361,18.22701,1506
22223,AC608530E4648D24FD5F9C3D1465376C,30854,0,1,1,109.56889,18.27076,1763
22224,AC608530E4648D24FD5F9C3D1465376C,31945,6,8,2,109.58021,18.29403,1817
22225,AC608530E4648D24FD5F9C3D1465376C,30854,11,18,7,109.56889,18.27076,1763
22243,533C598FBE9A80A69F24B4E517B0CF08,30741,0,8,8,109.49833,18.28681,1516
22245,533C598FBE9A80A69F24B4E517B0CF08,31351,21,22,1,109.4959,18.28417,1465
22277,F605546ADA1ADB3E2AF3E74D19682812,31931,2,7,5,109.54771,18.29403,1667
22278,F605546ADA1ADB3E2AF3E74D19682812,60221,9,19,10,109.52569,18.29188,1616
22297,EE9DF0DA6560AA8A0EC24726BBEB6A9A,31741,16,18,2,109.10229,18.37271,30
22339,94C4D5691F7DFC1AB38806AFFAC1389E,31931,14,15,1,109.54771,18.29403,1667
22340,94C4D5691F7DFC1AB38806AFFAC1389E,30921,18,23,5,109.53903,18.29451,1667
22358,B9D2B06CFEEA354176E1B3D8B1E20D67,31205,1,2,1,109.51111,18.23736,1557
22359,B9D2B06CFEEA354176E1B3D8B1E20D67,30271,3,9,6,109.49132,18.23153,1456
22360,B9D2B06CFEEA354176E1B3D8B1E20D67,60041,13,15,2,109.39889,18.31944,1121
22361,B9D2B06CFEEA354176E1B3D8B1E20D67,30201,18,19,1,109.4909,18.26465,1462
22362,B9D2B06CFEEA354176E1B3D8B1E20D67,31221,22,23,1,109.61333,18.26833,1913
22374,9FC721E86703223349C05C95FE4BBB6F,60087,0,2,2,109.50688,18.22299,1505
22375,9FC721E86703223349C05C95FE4BBB6F,60081,3,11,8,109.51097,18.22639,1556
22376,9FC721E86703223349C05C95FE4BBB6F,60381,11,14,3,109.5241,18.22458,1605
22377,9FC721E86703223349C05C95FE4BBB6F,31521,14,20,6,109.51458,18.22542,1555
22378,9FC721E86703223349C05C95FE4BBB6F,60087,21,23,2,109.50688,18.22299,1505
22385,B616D64706FE00CB4CDA3E3D124853B8,31671,1,7,6,109.38965,18.29813,1068
22386,B616D64706FE00CB4CDA3E3D124853B8,33481,9,12,3,109.67278,18.41278,2187
22387,B616D64706FE00CB4CDA3E3D124853B8,31671,15,22,7,109.38965,18.29813,1068
22407,3C7B93BB0A27C1CE56C61B7C28661B4D,30151,2,4,2,109.50986,18.25083,1560
22408,3C7B93BB0A27C1CE56C61B7C28661B4D,31521,5,19,14,109.51458,18.22542,1555
22409,3C7B93BB0A27C1CE56C61B7C28661B4D,31171,20,22,2,109.50938,18.24917,1559
22415,B4C8A8F357A5CDF8BB918E4017446951,39181,1,14,13,109.55153,18.28035,1715
22416,B4C8A8F357A5CDF8BB918E4017446951,31931,14,16,2,109.54771,18.29403,1667
22462,E504C7D2F929BB396CEA3A3E20B74D1F,38111,19,21,2,109.52007,18.22403,1555
22463,E504C7D2F929BB396CEA3A3E20B74D1F,31521,21,23,2,109.51458,18.22542,1555
22480,DBCB3A87F89C2AC16ED8152735BE6F75,30271,8,12,4,109.49132,18.23153,1456
22481,DBCB3A87F89C2AC16ED8152735BE6F75,30161,13,15,2,109.50042,18.24389,1508
22482,DBCB3A87F89C2AC16ED8152735BE6F75,38251,17,19,2,109.49618,18.25493,1510
22483,DBCB3A87F89C2AC16ED8152735BE6F75,30271,22,23,1,109.49132,18.23153,1456
22502,E741472B5FE1391FC41630B6DBF2DFDE,31351,0,10,10,109.4959,18.28417,1465
22503,E741472B5FE1391FC41630B6DBF2DFDE,31471,13,14,1,109.34583,18.29563,917
22504,E741472B5FE1391FC41630B6DBF2DFDE,31471,15,18,3,109.34583,18.29563,917
22505,E741472B5FE1391FC41630B6DBF2DFDE,60541,21,23,2,109.4084,18.29208,1167
22509,AE1C9860915542FE7A0A03D0A133503E,30854,0,14,14,109.56889,18.27076,1763
22510,AE1C9860915542FE7A0A03D0A133503E,30232,15,16,1,109.6191,18.31701,1971
22511,AE1C9860915542FE7A0A03D0A133503E,31071,19,20,1,109.58257,18.28458,1815
22512,AE1C9860915542FE7A0A03D0A133503E,30854,20,22,2,109.56889,18.27076,1763
22533,122D07F80E4FAC68FAE7EDBB2DF1AFA3,30854,1,7,6,109.56889,18.27076,1763
22534,122D07F80E4FAC68FAE7EDBB2DF1AFA3,31071,8,15,7,109.58257,18.28458,1815
22537,AC0473CD58A736C6A311A0DEEA929506,60161,20,22,2,109.49174,18.26181,1461
22538,AC0473CD58A736C6A311A0DEEA929506,38251,22,23,1,109.49618,18.25493,1510
22553,85113926FD58DF2481DE297BC312E23D,38094,18,22,4,109.45403,18.28778,1316
22554,8DED3AF2A13BD7FD99C437CF1C11E83B,31021,0,14,14,109.49021,18.27,1463
22589,5274FB91D917823AD6AE120EE7F21099,31931,0,7,7,109.54771,18.29403,1667
22590,5274FB91D917823AD6AE120EE7F21099,60591,7,18,11,109.61118,18.21715,1904
22591,5274FB91D917823AD6AE120EE7F21099,31931,18,23,5,109.54771,18.29403,1667
22633,A9FCE0049DB44FE004EAFBF5B783F4A5,31945,15,18,3,109.58021,18.29403,1817
22634,A9FCE0049DB44FE004EAFBF5B783F4A5,30854,19,20,1,109.56889,18.27076,1763
22635,A9FCE0049DB44FE004EAFBF5B783F4A5,30921,21,23,2,109.53903,18.29451,1667
22696,19A604DB8FB3E88699C325DC4D336D53,30121,0,10,10,109.52861,18.27222,1613
22697,19A604DB8FB3E88699C325DC4D336D53,31821,11,15,4,109.51181,18.24924,1559
22698,19A604DB8FB3E88699C325DC4D336D53,30121,16,19,3,109.52861,18.27222,1613
22701,83F8DEFB45E9970F803B6E01CF53475C,38961,2,15,13,109.50847,18.23514,1507
22702,83F8DEFB45E9970F803B6E01CF53475C,31021,18,20,2,109.49021,18.27,1463
22717,BE586ACB441383CC10D7CF3923850B73,31931,0,21,21,109.54771,18.29403,1667
22718,BE586ACB441383CC10D7CF3923850B73,60371,22,23,1,109.53063,18.30056,1618
22719,68D17CEA0DFC47DDDEC25D4A4CC5A3DB,31181,0,1,1,109.50382,18.24813,1509
22720,68D17CEA0DFC47DDDEC25D4A4CC5A3DB,30151,1,11,10,109.50986,18.25083,1560
22721,68D17CEA0DFC47DDDEC25D4A4CC5A3DB,31261,11,13,2,109.51174,18.2466,1559
22754,0D00E0CA974DDA00224ACCD00B993468,30851,0,6,6,109.5616,18.27396,1713
22755,0D00E0CA974DDA00224ACCD00B993468,30854,9,17,8,109.56889,18.27076,1763
22756,0D00E0CA974DDA00224ACCD00B993468,31071,19,22,3,109.58257,18.28458,1815
22764,E18D9C831A7994692184CCEFAFB97A2D,31521,0,12,12,109.51458,18.22542,1555
22765,E18D9C831A7994692184CCEFAFB97A2D,31101,14,16,2,109.65389,18.23403,2057
22766,E18D9C831A7994692184CCEFAFB97A2D,60381,18,20,2,109.5241,18.22458,1605
22767,E18D9C831A7994692184CCEFAFB97A2D,31521,20,23,3,109.51458,18.22542,1555
22791,29C07CFFD8A4887F4FBEBB6647F0059A,30291,0,9,9,109.50403,18.27028,1513
22805,96F98526707B06BE1263CCD4F72E07A1,31071,1,8,7,109.58257,18.28458,1815
22806,96F98526707B06BE1263CCD4F72E07A1,30854,12,16,4,109.56889,18.27076,1763
22834,E24A5B42239D002A0BE02B9D8DF63D1B,30731,2,6,4,109.50944,18.22306,1555
22835,E24A5B42239D002A0BE02B9D8DF63D1B,30341,7,8,1,109.3625,18.29167,966
22836,E24A5B42239D002A0BE02B9D8DF63D1B,30661,9,12,3,109.37028,18.24361,1008
22837,E24A5B42239D002A0BE02B9D8DF63D1B,31471,14,15,1,109.34583,18.29563,917
22838,2655BE064A1397AB1A41DE42D8C35874,60054,15,16,1,109.3016,18.31229,770
22839,2655BE064A1397AB1A41DE42D8C35874,30201,20,21,1,109.4909,18.26465,1462
22856,71048DA762610C5657DD6D8242833DC9,30234,0,7,7,109.60681,18.29979,1918
22857,71048DA762610C5657DD6D8242833DC9,30854,8,10,2,109.56889,18.27076,1763
22865,B93185B4820D7E0DEE74EBEA00941D15,30371,0,13,13,109.51,18.24771,1559
22866,B93185B4820D7E0DEE74EBEA00941D15,60201,13,15,2,109.5041,18.2509,1510
22867,B93185B4820D7E0DEE74EBEA00941D15,60331,15,17,2,109.505,18.26507,1512
22868,B93185B4820D7E0DEE74EBEA00941D15,60201,17,23,6,109.5041,18.2509,1510
22893,409F5E8F01172D32BBE91132149C037E,31205,0,12,12,109.51111,18.23736,1557
22894,409F5E8F01172D32BBE91132149C037E,38371,14,15,1,109.50972,18.23924,1558
22895,409F5E8F01172D32BBE91132149C037E,30421,16,18,2,109.50021,18.25861,1511
22896,409F5E8F01172D32BBE91132149C037E,30361,18,20,2,109.50347,18.24,1508
22897,409F5E8F01172D32BBE91132149C037E,38127,20,22,2,109.50833,18.27222,1513
22918,5D9D6200DB70228B7F96ACE5A37B7578,31931,2,8,6,109.54771,18.29403,1667
22919,5D9D6200DB70228B7F96ACE5A37B7578,60361,11,22,11,109.51938,18.29681,1567
22942,3963776B8D4E0FE3D76B833D367A499E,31231,0,10,10,109.42597,18.29292,1217
22943,3963776B8D4E0FE3D76B833D367A499E,30581,13,15,2,109.62257,18.24951,1959
22944,3963776B8D4E0FE3D76B833D367A499E,30441,17,18,1,109.64021,18.25424,2010
22945,3963776B8D4E0FE3D76B833D367A499E,31231,19,23,4,109.42597,18.29292,1217
22957,028D8E55D4EA2BBCD89011B5A8443A67,31471,15,16,1,109.34583,18.29563,917
22958,028D8E55D4EA2BBCD89011B5A8443A67,60411,17,21,4,109.32514,18.30854,869
23007,ECB0D6F4F8CE3A022BB643A50974CBE5,30121,0,13,13,109.52861,18.27222,1613
23040,DBB710D279E76C79F1E4B0766F579F8A,31071,0,5,5,109.58257,18.28458,1815
23041,DBB710D279E76C79F1E4B0766F579F8A,30854,7,17,10,109.56889,18.27076,1763
23062,AF7BD38BAFE82C31043D932015C23584,38251,0,8,8,109.49618,18.25493,1510
23063,AF7BD38BAFE82C31043D932015C23584,31781,12,13,1,109.19847,18.2975,367
23071,73EAC1341C5005A58B26B1A52457F38B,31181,0,15,15,109.50382,18.24813,1509
23072,73EAC1341C5005A58B26B1A52457F38B,31471,17,18,1,109.34583,18.29563,917
23077,BE1BF0E0C00568838DBD1FF7CA7ADE1C,31561,0,7,7,109.56792,18.28479,1765
23078,BE1BF0E0C00568838DBD1FF7CA7ADE1C,31071,7,11,4,109.58257,18.28458,1815
23079,BE1BF0E0C00568838DBD1FF7CA7ADE1C,30854,12,21,9,109.56889,18.27076,1763
23120,0D9082BEF5A52C17C659BB5099A114E7,60411,0,13,13,109.32514,18.30854,869
23121,0D9082BEF5A52C17C659BB5099A114E7,31471,15,16,1,109.34583,18.29563,917
23122,0D9082BEF5A52C17C659BB5099A114E7,30661,16,18,2,109.37028,18.24361,1008
23123,0D9082BEF5A52C17C659BB5099A114E7,60411,18,23,5,109.32514,18.30854,869
23143,E34FF61340C5B86CF9FD0AD454D26266,60331,0,6,6,109.505,18.26507,1512
23144,E34FF61340C5B86CF9FD0AD454D26266,60221,7,10,3,109.52569,18.29188,1616
23145,E34FF61340C5B86CF9FD0AD454D26266,30911,12,13,1,109.50493,18.26181,1511
23146,E34FF61340C5B86CF9FD0AD454D26266,60221,14,16,2,109.52569,18.29188,1616
23147,E34FF61340C5B86CF9FD0AD454D26266,30911,18,20,2,109.50493,18.26181,1511
23148,E34FF61340C5B86CF9FD0AD454D26266,60331,21,23,2,109.505,18.26507,1512
23202,70E36A4B82878626B569C66E46C7827C,39091,0,8,8,109.50097,18.25222,1510
23203,70E36A4B82878626B569C66E46C7827C,38754,13,16,3,109.74667,18.37382,2430
23239,76F6A54588C8DF7DDADFC50CAA11D44C,39101,16,17,1,109.50132,18.24931,1509
23240,76F6A54588C8DF7DDADFC50CAA11D44C,30361,19,20,1,109.50347,18.24,1508
23268,680051EC44844DA68AE2B74B206794D6,38751,0,7,7,109.74903,18.37639,2481
23269,680051EC44844DA68AE2B74B206794D6,31781,9,11,2,109.19847,18.2975,367
23270,680051EC44844DA68AE2B74B206794D6,31471,12,13,1,109.34583,18.29563,917
23271,680051EC44844DA68AE2B74B206794D6,31521,14,16,2,109.51458,18.22542,1555
23272,680051EC44844DA68AE2B74B206794D6,30961,21,22,1,109.74042,18.37903,2431
23273,017B0507B62FB4DD164A656551AFBA4F,38094,16,19,3,109.45403,18.28778,1316
23274,017B0507B62FB4DD164A656551AFBA4F,60401,21,22,1,109.47444,18.27583,1414
23284,51061B3DE820AF1C1C713EF684728003,30854,1,3,2,109.56889,18.27076,1763
23285,51061B3DE820AF1C1C713EF684728003,31071,4,6,2,109.58257,18.28458,1815
23286,51061B3DE820AF1C1C713EF684728003,30854,8,9,1,109.56889,18.27076,1763
23287,51061B3DE820AF1C1C713EF684728003,60631,10,12,2,109.57778,18.27583,1814
23288,51061B3DE820AF1C1C713EF684728003,31071,12,14,2,109.58257,18.28458,1815
23289,51061B3DE820AF1C1C713EF684728003,30854,14,16,2,109.56889,18.27076,1763
23290,51061B3DE820AF1C1C713EF684728003,31071,18,21,3,109.58257,18.28458,1815
23293,7235447B1B76CF7498ADD1835D8DDC17,38111,0,3,3,109.52007,18.22403,1555
23294,7235447B1B76CF7498ADD1835D8DDC17,39321,3,4,1,109.529,18.2167,1604
23295,7235447B1B76CF7498ADD1835D8DDC17,38111,6,9,3,109.52007,18.22403,1555
23296,7235447B1B76CF7498ADD1835D8DDC17,30661,14,17,3,109.37028,18.24361,1008
23297,7235447B1B76CF7498ADD1835D8DDC17,31031,18,19,1,109.49979,18.25382,1510
23298,7235447B1B76CF7498ADD1835D8DDC17,38111,21,22,1,109.52007,18.22403,1555
23364,5D56123A0C68AD72DA20EA4585A51B48,60381,0,8,8,109.5241,18.22458,1605
23365,5D56123A0C68AD72DA20EA4585A51B48,30861,9,14,5,109.52722,18.22743,1606
23366,5D56123A0C68AD72DA20EA4585A51B48,31473,15,17,2,109.34792,18.29465,917
23367,5D56123A0C68AD72DA20EA4585A51B48,31521,19,20,1,109.51458,18.22542,1555
23368,5D56123A0C68AD72DA20EA4585A51B48,30861,20,22,2,109.52722,18.22743,1606
23381,ACC390C77025BECAF4CD259D41E8F314,30232,1,9,8,109.6191,18.31701,1971
23382,ACC390C77025BECAF4CD259D41E8F314,30854,9,13,4,109.56889,18.27076,1763
23383,ACC390C77025BECAF4CD259D41E8F314,30232,14,16,2,109.6191,18.31701,1971
23384,ACC390C77025BECAF4CD259D41E8F314,30854,16,20,4,109.56889,18.27076,1763
23385,ACC390C77025BECAF4CD259D41E8F314,30232,21,23,2,109.6191,18.31701,1971
23414,8EE2B55B9C0133D9EB3C4198C24C9CD9,30201,18,20,2,109.4909,18.26465,1462
23415,8EE2B55B9C0133D9EB3C4198C24C9CD9,30361,21,22,1,109.50347,18.24,1508
23442,2FCE41507104FDFA70291772784A7A89,31201,0,9,9,109.51042,18.23819,1558
23443,2FCE41507104FDFA70291772784A7A89,31521,11,14,3,109.51458,18.22542,1555
23444,2FCE41507104FDFA70291772784A7A89,60241,14,16,2,109.53319,18.28667,1616
23445,2FCE41507104FDFA70291772784A7A89,31041,19,20,1,109.50278,18.23701,1507
23501,300A1885BA30CEEF17B7B730D91F8A14,60571,17,23,6,109.50722,18.25056,1510
23502,DC9973204E62AA99FA79F0696CF6C0F6,30854,11,13,2,109.56889,18.27076,1763
23503,DC9973204E62AA99FA79F0696CF6C0F6,39151,16,18,2,109.49875,18.25097,1510
23504,DC9973204E62AA99FA79F0696CF6C0F6,30854,19,22,3,109.56889,18.27076,1763
23508,7BBB2DDEDB0AE43F8CE7FBD1FCB52741,30854,0,2,2,109.56889,18.27076,1763
23509,7BBB2DDEDB0AE43F8CE7FBD1FCB52741,31071,3,5,2,109.58257,18.28458,1815
23510,7BBB2DDEDB0AE43F8CE7FBD1FCB52741,30854,10,12,2,109.56889,18.27076,1763
23511,7BBB2DDEDB0AE43F8CE7FBD1FCB52741,31071,15,22,7,109.58257,18.28458,1815
23536,D4AA3869830031578B573FD0033C24A8,31931,0,1,1,109.54771,18.29403,1667
23537,D4AA3869830031578B573FD0033C24A8,60371,1,7,6,109.53063,18.30056,1618
23538,D4AA3869830031578B573FD0033C24A8,31931,7,15,8,109.54771,18.29403,1667
23547,8FE97C1052D63DE830211C405D8F5442,30854,8,9,1,109.56889,18.27076,1763
23548,8FE97C1052D63DE830211C405D8F5442,39183,14,17,3,109.55542,18.28208,1715
23549,8FE97C1052D63DE830211C405D8F5442,60631,17,19,2,109.57778,18.27583,1814
23550,8FE97C1052D63DE830211C405D8F5442,30854,20,21,1,109.56889,18.27076,1763
23551,683051AEA9BDC540FAFA471A20E3F6EF,31531,0,6,6,109.49583,18.25972,1461
23557,377A324496E54511961704972731A3D5,38121,13,14,1,109.51361,18.27813,1564
23558,377A324496E54511961704972731A3D5,31521,17,19,2,109.51458,18.22542,1555
23643,117CDF2D41FFFF099F62724091D8605A,60631,7,14,7,109.57778,18.27583,1814
23644,117CDF2D41FFFF099F62724091D8605A,30861,16,17,1,109.52722,18.22743,1606
23645,117CDF2D41FFFF099F62724091D8605A,60631,19,20,1,109.57778,18.27583,1814
23653,0E4E3873A84F880D37A184F5409B3BB0,31531,19,20,1,109.49583,18.25972,1461
23654,0E4E3873A84F880D37A184F5409B3BB0,38826,21,23,2,109.50326,18.25514,1510
23742,4CC3058F56A42FB99DF66B1D4EA3395F,30771,0,8,8,109.49938,18.26042,1511
23743,4CC3058F56A42FB99DF66B1D4EA3395F,60641,8,9,1,109.53854,18.2359,1657
23744,4CC3058F56A42FB99DF66B1D4EA3395F,30771,11,14,3,109.49938,18.26042,1511
23745,4CC3058F56A42FB99DF66B1D4EA3395F,30771,17,21,4,109.49938,18.26042,1511
23748,0036A867CCF4154EF4E16AF8E847E92C,38251,18,19,1,109.49618,18.25493,1510
23749,0036A867CCF4154EF4E16AF8E847E92C,60551,22,23,1,109.42722,18.30111,1218
23752,B67683EC50B392E6E6AD95EC7DF23326,38094,1,12,11,109.45403,18.28778,1316
23753,B67683EC50B392E6E6AD95EC7DF23326,60201,13,16,3,109.5041,18.2509,1510
23754,B67683EC50B392E6E6AD95EC7DF23326,31861,16,17,1,109.49042,18.27549,1464
23755,B67683EC50B392E6E6AD95EC7DF23326,30171,18,22,4,109.48458,18.27139,1463
23767,C1A86408F22C4A96CA9DED3C9439B426,30861,0,11,11,109.52722,18.22743,1606
23768,C1A86408F22C4A96CA9DED3C9439B426,31061,12,13,1,109.53333,18.23257,1607
23774,C2964FCBFAEAE420B9E51BE5763EEB7D,38251,0,9,9,109.49618,18.25493,1510
23775,C2964FCBFAEAE420B9E51BE5763EEB7D,31781,13,15,2,109.19847,18.2975,367
23776,C2964FCBFAEAE420B9E51BE5763EEB7D,38251,19,23,4,109.49618,18.25493,1510
23831,09154FF8CE563729A318D07DF701B4BA,31071,2,7,5,109.58257,18.28458,1815
23832,09154FF8CE563729A318D07DF701B4BA,30854,10,22,12,109.56889,18.27076,1763
23856,C8922FAF66F21ECAECB6B717FCD5A53B,60614,0,6,6,109.48799,18.29521,1467
23857,C8922FAF66F21ECAECB6B717FCD5A53B,60391,9,10,1,109.47667,18.28757,1416
23858,C8922FAF66F21ECAECB6B717FCD5A53B,60614,10,23,13,109.48799,18.29521,1467
23860,CFF4943452741BA085C68AD1AAC66347,60571,18,20,2,109.50722,18.25056,1510
23898,99E1CC6671A3F5CA76BAB1455D5F851F,30771,22,23,1,109.49938,18.26042,1511
23904,2B60907F04C29DE058B3E64B1D3B4100,30854,9,18,9,109.56889,18.27076,1763
23905,2B60907F04C29DE058B3E64B1D3B4100,31561,21,23,2,109.56792,18.28479,1765
23931,8A19D38C67DEBBE2072401E23B2467C5,31801,15,16,1,109.20417,18.32118,371
23932,8A19D38C67DEBBE2072401E23B2467C5,31161,20,23,3,109.70229,18.31361,2270
23958,1419F2503130508E06D5FA0D4A5CF329,31031,0,7,7,109.49979,18.25382,1510
23959,1419F2503130508E06D5FA0D4A5CF329,31261,8,14,6,109.51174,18.2466,1559
23960,1419F2503130508E06D5FA0D4A5CF329,31031,15,16,1,109.49979,18.25382,1510
23961,1419F2503130508E06D5FA0D4A5CF329,31164,18,19,1,109.69993,18.27215,2263
23966,AC0E940CA4876D60068799AC7DD06B30,31391,0,7,7,109.50382,18.24285,1508
23967,AC0E940CA4876D60068799AC7DD06B30,33481,8,13,5,109.67278,18.41278,2187
23968,AC0E940CA4876D60068799AC7DD06B30,33051,14,16,2,109.6475,18.46618,2096
23969,AC0E940CA4876D60068799AC7DD06B30,33521,17,18,1,109.66313,18.45174,2143
23970,AC0E940CA4876D60068799AC7DD06B30,31391,19,23,4,109.50382,18.24285,1508
24023,6DF0E96353EFA5D45613487A662BB748,60221,0,9,9,109.52569,18.29188,1616
24024,6DF0E96353EFA5D45613487A662BB748,31031,11,15,4,109.49979,18.25382,1510
24074,7C53E1516813111F7584C70DC82C3E1E,31031,0,14,14,109.49979,18.25382,1510
24075,7C53E1516813111F7584C70DC82C3E1E,30711,17,20,3,109.50271,18.25347,1510
24076,7C53E1516813111F7584C70DC82C3E1E,30191,20,22,2,109.50361,18.22701,1506
24088,F6CCF646674665C449464A30D23BCEEF,60231,0,1,1,109.49903,18.21972,1504
24089,F6CCF646674665C449464A30D23BCEEF,60054,2,5,3,109.3016,18.31229,770
24090,8DA877D3A30401F86E81FB7BC1CA2A00,30854,0,3,3,109.56889,18.27076,1763
24091,8DA877D3A30401F86E81FB7BC1CA2A00,31071,4,20,16,109.58257,18.28458,1815
24092,8DA877D3A30401F86E81FB7BC1CA2A00,30854,22,23,1,109.56889,18.27076,1763
24099,39F25FE146A03325C93C111F2A943B6C,31945,2,9,7,109.58021,18.29403,1817
24100,39F25FE146A03325C93C111F2A943B6C,30854,9,12,3,109.56889,18.27076,1763
24101,39F25FE146A03325C93C111F2A943B6C,31945,13,17,4,109.58021,18.29403,1817
24102,39F25FE146A03325C93C111F2A943B6C,31041,19,20,1,109.50278,18.23701,1507
24103,39F25FE146A03325C93C111F2A943B6C,31945,21,23,2,109.58021,18.29403,1817
24135,9F5F8E6110AC554161BA0F6410145CFE,60441,0,7,7,109.46792,18.28604,1366
24136,9F5F8E6110AC554161BA0F6410145CFE,30764,7,10,3,109.45806,18.29486,1367
24137,9F5F8E6110AC554161BA0F6410145CFE,31231,14,15,1,109.42597,18.29292,1217
24138,9F5F8E6110AC554161BA0F6410145CFE,60441,18,23,5,109.46792,18.28604,1366
24145,14AE6C820CE45F96077630992CABD33D,31551,0,21,21,109.55868,18.24222,1708
24146,14AE6C820CE45F96077630992CABD33D,30951,22,23,1,109.56208,18.25667,1761
24159,90794B929F1EAD21564A5BB205588FE7,60054,16,17,1,109.3016,18.31229,770
24160,90794B929F1EAD21564A5BB205588FE7,30354,18,19,1,109.42813,18.29076,1216
24161,90794B929F1EAD21564A5BB205588FE7,31431,21,23,2,109.44639,18.29042,1316
24171,B34415F599F0ED7D1A073EE314A60B9B,31671,0,18,18,109.38965,18.29813,1068
24172,B34415F599F0ED7D1A073EE314A60B9B,60041,20,22,2,109.39889,18.31944,1121
24214,E0A24740E2C54F3B77DB561A91D2BED7,31821,0,6,6,109.51181,18.24924,1559
24215,E0A24740E2C54F3B77DB561A91D2BED7,30251,8,18,10,109.50611,18.26653,1512
24216,E0A24740E2C54F3B77DB561A91D2BED7,30151,18,23,5,109.50986,18.25083,1560
24222,DFEFB1CD7965FB8E2BDF1B532ED92233,31931,0,9,9,109.54771,18.29403,1667
24223,DFEFB1CD7965FB8E2BDF1B532ED92233,30921,11,13,2,109.53903,18.29451,1667
24224,DFEFB1CD7965FB8E2BDF1B532ED92233,31931,13,14,1,109.54771,18.29403,1667
24225,DFEFB1CD7965FB8E2BDF1B532ED92233,60631,18,20,2,109.57778,18.27583,1814
24226,DFEFB1CD7965FB8E2BDF1B532ED92233,31931,21,23,2,109.54771,18.29403,1667
24283,79552C9BA7D6D0482C348613B3829C6B,31181,6,15,9,109.50382,18.24813,1509
24284,79552C9BA7D6D0482C348613B3829C6B,60131,15,17,2,109.49819,18.24778,1509
24285,79552C9BA7D6D0482C348613B3829C6B,31181,18,22,4,109.50382,18.24813,1509
24299,7094512B15E4EF60EF67A3E6DEAF677A,60594,0,6,6,109.62694,18.22799,1956
24300,7094512B15E4EF60EF67A3E6DEAF677A,38052,6,9,3,109.62618,18.23042,1956
24301,7094512B15E4EF60EF67A3E6DEAF677A,38754,11,15,4,109.74667,18.37382,2430
24302,7094512B15E4EF60EF67A3E6DEAF677A,60594,16,17,1,109.62694,18.22799,1956
24303,7094512B15E4EF60EF67A3E6DEAF677A,30441,18,19,1,109.64021,18.25424,2010
24304,7094512B15E4EF60EF67A3E6DEAF677A,30581,19,20,1,109.62257,18.24951,1959
24305,7094512B15E4EF60EF67A3E6DEAF677A,38052,21,22,1,109.62618,18.23042,1956
24306,5B84036FDCD203AB893EE6C99EA52401,30741,13,14,1,109.49833,18.28681,1516
24307,5B84036FDCD203AB893EE6C99EA52401,30821,17,19,2,109.43681,18.33639,1274
24308,5B84036FDCD203AB893EE6C99EA52401,30741,20,23,3,109.49833,18.28681,1516
24343,3AFE4807E5358850C8027BF9B4CCCFB5,30291,0,8,8,109.50403,18.27028,1513
24344,3AFE4807E5358850C8027BF9B4CCCFB5,30391,8,11,3,109.4975,18.27118,1513
24345,3AFE4807E5358850C8027BF9B4CCCFB5,31931,11,14,3,109.54771,18.29403,1667
24346,3AFE4807E5358850C8027BF9B4CCCFB5,31701,16,18,2,109.44132,18.28833,1266
24347,3AFE4807E5358850C8027BF9B4CCCFB5,30291,19,23,4,109.50403,18.27028,1513
24381,F258281576DAF0135C7F7FAA24A5C069,38073,12,13,1,109.40813,18.30958,1169
24403,14F1CC63CDA098F9694EAC8584B9C7A5,31071,2,5,3,109.58257,18.28458,1815
24404,14F1CC63CDA098F9694EAC8584B9C7A5,31561,5,10,5,109.56792,18.28479,1765
24405,14F1CC63CDA098F9694EAC8584B9C7A5,30854,12,13,1,109.56889,18.27076,1763
24406,14F1CC63CDA098F9694EAC8584B9C7A5,31071,19,21,2,109.58257,18.28458,1815
24407,14F1CC63CDA098F9694EAC8584B9C7A5,31561,21,23,2,109.56792,18.28479,1765
24408,72DCCAC1A2B013E19459B9B611396AC3,30461,15,17,2,109.5116,18.26313,1562
24409,72DCCAC1A2B013E19459B9B611396AC3,30171,21,23,2,109.48458,18.27139,1463
24423,E218C587552A5DADC05C4E69685FE374,39183,5,18,13,109.55542,18.28208,1715
24424,E218C587552A5DADC05C4E69685FE374,30854,18,20,2,109.56889,18.27076,1763
24425,E218C587552A5DADC05C4E69685FE374,39183,20,23,3,109.55542,18.28208,1715
24535,24482AD2B7C9FD3282939A5A40C27817,31471,15,18,3,109.34583,18.29563,917
24536,24482AD2B7C9FD3282939A5A40C27817,31143,19,23,4,109.19986,18.29875,368
24605,2D115D52FDAB55086A12D742071FDFC9,30232,1,4,3,109.6191,18.31701,1971
24606,2D115D52FDAB55086A12D742071FDFC9,30854,7,15,8,109.56889,18.27076,1763
24607,2D115D52FDAB55086A12D742071FDFC9,30232,15,16,1,109.6191,18.31701,1971
24608,2D115D52FDAB55086A12D742071FDFC9,30854,19,22,3,109.56889,18.27076,1763
24609,94C6B6D07606799F9DD78C376ADCB85C,38911,0,8,8,109.51674,18.24965,1559
24610,94C6B6D07606799F9DD78C376ADCB85C,38291,8,12,4,109.51618,18.24313,1558
24611,94C6B6D07606799F9DD78C376ADCB85C,31821,12,14,2,109.51181,18.24924,1559
24612,94C6B6D07606799F9DD78C376ADCB85C,60221,17,18,1,109.52569,18.29188,1616
24613,94C6B6D07606799F9DD78C376ADCB85C,38331,20,21,1,109.62465,18.22736,1956
24614,94C6B6D07606799F9DD78C376ADCB85C,60281,22,23,1,109.51743,18.25924,1561
24620,B63C7A38380DE4C1CBF93159ABD5ACDF,30354,0,7,7,109.42813,18.29076,1216
24621,B63C7A38380DE4C1CBF93159ABD5ACDF,60054,8,9,1,109.3016,18.31229,770
24622,B63C7A38380DE4C1CBF93159ABD5ACDF,31781,13,15,2,109.19847,18.2975,367
24623,D90E492BAFD3B5C326CF35A94ED803F0,31781,15,17,2,109.19847,18.2975,367
24624,D90E492BAFD3B5C326CF35A94ED803F0,38754,20,21,1,109.74667,18.37382,2430
24661,AB43182259122294244C13D6FC66D4A1,31071,0,4,4,109.58257,18.28458,1815
24662,AB43182259122294244C13D6FC66D4A1,60631,5,6,1,109.57778,18.27583,1814
24663,AB43182259122294244C13D6FC66D4A1,31071,7,8,1,109.58257,18.28458,1815
24664,AB43182259122294244C13D6FC66D4A1,31561,14,16,2,109.56792,18.28479,1765
24665,AB43182259122294244C13D6FC66D4A1,60631,20,22,2,109.57778,18.27583,1814
24668,C462628FF36F8FF2D0B7493E6DDA38BB,60411,0,8,8,109.32514,18.30854,869
24669,C462628FF36F8FF2D0B7493E6DDA38BB,30661,9,14,5,109.37028,18.24361,1008
24670,C462628FF36F8FF2D0B7493E6DDA38BB,60411,14,15,1,109.32514,18.30854,869
24683,B29F33564DDA3CFA905BF42633BA4302,39101,16,17,1,109.50132,18.24931,1509
24684,B29F33564DDA3CFA905BF42633BA4302,38291,21,22,1,109.51618,18.24313,1558
24689,F8D799D9161B0143E0D71C40472A357E,30071,0,8,8,109.52819,18.30472,1619
24690,F8D799D9161B0143E0D71C40472A357E,38991,10,12,2,109.52681,18.30368,1618
24691,F8D799D9161B0143E0D71C40472A357E,30071,14,15,1,109.52819,18.30472,1619
24692,F8D799D9161B0143E0D71C40472A357E,30711,17,21,4,109.50271,18.25347,1510
24693,8BDE8C6966F9C7122ABA59EA6C195945,31081,0,6,6,109.44639,18.30181,1318
24694,8BDE8C6966F9C7122ABA59EA6C195945,60552,9,10,1,109.41729,18.30014,1218
24695,8BDE8C6966F9C7122ABA59EA6C195945,31081,10,13,3,109.44639,18.30181,1318
24748,C0A7F668E276299BE027E18D29E450FF,30854,15,16,1,109.56889,18.27076,1763
24755,728159D623DE360E7CBC8AEEC345E2FF,60661,0,13,13,109.548,18.2377,1657
24756,728159D623DE360E7CBC8AEEC345E2FF,31091,14,18,4,109.41201,18.31222,1170
24757,728159D623DE360E7CBC8AEEC345E2FF,60661,20,23,3,109.548,18.2377,1657
24768,E62DBF6E801A10F11FF8E6C479369844,30711,13,15,2,109.50271,18.25347,1510
24769,E62DBF6E801A10F11FF8E6C479369844,38754,17,18,1,109.74667,18.37382,2430
24774,D0397702CD04E389C6CD3782DE9B02F8,38157,1,8,7,109.51483,18.26958,1563
24775,D0397702CD04E389C6CD3782DE9B02F8,31521,8,10,2,109.51458,18.22542,1555
24776,D0397702CD04E389C6CD3782DE9B02F8,60381,10,11,1,109.5241,18.22458,1605
24777,D0397702CD04E389C6CD3782DE9B02F8,31521,12,19,7,109.51458,18.22542,1555
24778,D0397702CD04E389C6CD3782DE9B02F8,60201,19,22,3,109.5041,18.2509,1510
24813,A46BA306DAEA889FAC7ACE9E5FD6A1FF,39154,1,7,6,109.50201,18.25681,1511
24814,A46BA306DAEA889FAC7ACE9E5FD6A1FF,30911,7,18,11,109.50493,18.26181,1511
24815,A46BA306DAEA889FAC7ACE9E5FD6A1FF,30511,21,22,1,109.51069,18.24208,1558
24831,C6C3BC01E542B810EF853FEEB6C81198,60361,3,19,16,109.51938,18.29681,1567
24832,C6C3BC01E542B810EF853FEEB6C81198,30854,19,21,2,109.56889,18.27076,1763
24888,8F6EA1C108FADA76A214A7ED71ECE3D1,30891,1,3,2,109.59431,18.28389,1865
24889,8F6EA1C108FADA76A214A7ED71ECE3D1,39183,6,7,1,109.55542,18.28208,1715
24890,8F6EA1C108FADA76A214A7ED71ECE3D1,30854,12,20,8,109.56889,18.27076,1763
24891,39D4F14340B4650E084697607335F122,30161,0,9,9,109.50042,18.24389,1508
24892,39D4F14340B4650E084697607335F122,39101,14,20,6,109.50132,18.24931,1509
24939,C4619CDCDA2CE4B57ED8A6EA3F70D9D0,31351,0,2,2,109.4959,18.28417,1465
24940,C4619CDCDA2CE4B57ED8A6EA3F70D9D0,38157,2,8,6,109.51483,18.26958,1563
24987,8AABF5FDF2B06EB445749240A3894969,30854,17,18,1,109.56889,18.27076,1763
24988,8AABF5FDF2B06EB445749240A3894969,31071,18,20,2,109.58257,18.28458,1815
24994,9372C6333F63FA61AD9230AC50796D39,38951,0,7,7,109.48097,18.28868,1416
24995,9372C6333F63FA61AD9230AC50796D39,30581,12,13,1,109.62257,18.24951,1959
25015,F2E4A1707C14AD7AF444AE9628A7C8BD,30081,9,14,5,109.50243,18.26632,1512
25016,F2E4A1707C14AD7AF444AE9628A7C8BD,60381,17,19,2,109.5241,18.22458,1605
25054,FD9120CA3F85D3F015CEFB66B9BF2F3D,30721,0,13,13,109.51597,18.28257,1565
25055,FD9120CA3F85D3F015CEFB66B9BF2F3D,60301,15,16,1,109.60715,18.30993,1919
25056,FD9120CA3F85D3F015CEFB66B9BF2F3D,30711,18,19,1,109.50271,18.25347,1510
25057,FD9120CA3F85D3F015CEFB66B9BF2F3D,38891,20,21,1,109.51486,18.24118,1558
25058,FD9120CA3F85D3F015CEFB66B9BF2F3D,30721,21,23,2,109.51597,18.28257,1565
25085,E8BAAF476E8FE57075BAB1A8D4FF1780,60631,0,6,6,109.57778,18.27583,1814
25086,E8BAAF476E8FE57075BAB1A8D4FF1780,30854,8,11,3,109.56889,18.27076,1763
25087,E8BAAF476E8FE57075BAB1A8D4FF1780,60381,12,14,2,109.5241,18.22458,1605
25088,E8BAAF476E8FE57075BAB1A8D4FF1780,60281,18,19,1,109.51743,18.25924,1561
25097,30CE72A519D49881F23B8123486E3A02,60054,0,1,1,109.3016,18.31229,770
25098,30CE72A519D49881F23B8123486E3A02,60411,2,3,1,109.32514,18.30854,869
25099,30CE72A519D49881F23B8123486E3A02,60054,3,7,4,109.3016,18.31229,770
25100,30CE72A519D49881F23B8123486E3A02,60411,8,11,3,109.32514,18.30854,869
25101,30CE72A519D49881F23B8123486E3A02,31471,13,16,3,109.34583,18.29563,917
25158,7C16827D646BDC874DE2BD7EE32189C5,30891,0,6,6,109.59431,18.28389,1865
25159,7C16827D646BDC874DE2BD7EE32189C5,30854,10,15,5,109.56889,18.27076,1763
25160,7C16827D646BDC874DE2BD7EE32189C5,60631,18,20,2,109.57778,18.27583,1814
25161,7C16827D646BDC874DE2BD7EE32189C5,30854,21,22,1,109.56889,18.27076,1763
25162,A8FD541EBDB8E347ADD4F948A70B6831,31561,0,10,10,109.56792,18.28479,1765
25163,A8FD541EBDB8E347ADD4F948A70B6831,30111,12,15,3,109.47583,18.30542,1419
25212,5204DBE7E9916DC793C5F718C71EB270,30671,5,7,2,109.43611,18.30139,1268
25213,5204DBE7E9916DC793C5F718C71EB270,31781,9,10,1,109.19847,18.2975,367
25220,CC7872BC5B2873CE85E7AB82CF2C3275,30221,0,8,8,109.57833,18.20222,1802
25221,CC7872BC5B2873CE85E7AB82CF2C3275,31071,12,13,1,109.58257,18.28458,1815
25222,CC7872BC5B2873CE85E7AB82CF2C3275,30221,15,22,7,109.57833,18.20222,1802
25260,9D84057972B69A5E23018ED19BFE5178,38171,0,7,7,109.50799,18.28139,1515
25261,9D84057972B69A5E23018ED19BFE5178,31231,7,14,7,109.42597,18.29292,1217
25262,9D84057972B69A5E23018ED19BFE5178,60117,16,20,4,109.73604,18.35681,2427
25263,9D84057972B69A5E23018ED19BFE5178,38171,22,23,1,109.50799,18.28139,1515
25297,2F1CD98DD5F5A4A3E6D47AB706E19DF1,38154,3,5,2,109.5266,18.28278,1615
25298,2F1CD98DD5F5A4A3E6D47AB706E19DF1,38094,6,7,1,109.45403,18.28778,1316
25299,2F1CD98DD5F5A4A3E6D47AB706E19DF1,30151,10,17,7,109.50986,18.25083,1560
25300,2F1CD98DD5F5A4A3E6D47AB706E19DF1,31821,18,22,4,109.51181,18.24924,1559
25310,4678B343B4005F2EC771E77847482CF4,60381,14,15,1,109.5241,18.22458,1605
25311,4678B343B4005F2EC771E77847482CF4,31521,18,19,1,109.51458,18.22542,1555
25312,4678B343B4005F2EC771E77847482CF4,38111,20,21,1,109.52007,18.22403,1555
25329,AD5B50011AF724A93ED322CEECA0B566,31101,0,9,9,109.65389,18.23403,2057
25330,AD5B50011AF724A93ED322CEECA0B566,38105,14,18,4,109.40299,18.29229,1117
25331,AD5B50011AF724A93ED322CEECA0B566,31041,20,22,2,109.50278,18.23701,1507
25336,59F29435D748531F416A4F1636997ECF,31071,1,7,6,109.58257,18.28458,1815
25337,59F29435D748531F416A4F1636997ECF,30854,9,14,5,109.56889,18.27076,1763
25338,59F29435D748531F416A4F1636997ECF,60631,18,21,3,109.57778,18.27583,1814
25339,59F29435D748531F416A4F1636997ECF,30854,21,23,2,109.56889,18.27076,1763
25359,BAC047B6079E6BEA7B1F8943C9D7A733,30854,0,8,8,109.56889,18.27076,1763
25360,BAC047B6079E6BEA7B1F8943C9D7A733,31071,8,9,1,109.58257,18.28458,1815
25361,BAC047B6079E6BEA7B1F8943C9D7A733,30854,13,15,2,109.56889,18.27076,1763
25362,BAC047B6079E6BEA7B1F8943C9D7A733,30361,19,21,2,109.50347,18.24,1508
25378,EF301AE8623EA991A7DABB108C1B6E04,30854,0,11,11,109.56889,18.27076,1763
25379,EF301AE8623EA991A7DABB108C1B6E04,30891,12,13,1,109.59431,18.28389,1865
25380,EF301AE8623EA991A7DABB108C1B6E04,30854,14,16,2,109.56889,18.27076,1763
25391,FA750B530766C5EAE284F9BC6C3A94BD,60221,18,20,2,109.52569,18.29188,1616
25392,FA750B530766C5EAE284F9BC6C3A94BD,38171,21,23,2,109.50799,18.28139,1515
25406,AC13994AA2AD3BE953B786F57E282F5B,30854,14,18,4,109.56889,18.27076,1763
25407,AC13994AA2AD3BE953B786F57E282F5B,31071,22,23,1,109.58257,18.28458,1815
25459,019CCF25DBCE9B21B5D2698F82FCE788,30234,0,7,7,109.60681,18.29979,1918
25460,019CCF25DBCE9B21B5D2698F82FCE788,30854,11,16,5,109.56889,18.27076,1763
25504,B175A0347ABEEA30E818C5CCD25E280F,30821,13,15,2,109.43681,18.33639,1274
25505,B175A0347ABEEA30E818C5CCD25E280F,60361,16,17,1,109.51938,18.29681,1567
25506,B175A0347ABEEA30E818C5CCD25E280F,30821,19,20,1,109.43681,18.33639,1274
25507,7CE2B4E9E3FFA67A4ED2B81C8BF2496C,31521,0,20,20,109.51458,18.22542,1555
25508,7CE2B4E9E3FFA67A4ED2B81C8BF2496C,39111,21,22,1,109.5191,18.22597,1555
25530,40E328762DBD80BABC8A5581C57ED5C7,30111,1,6,5,109.47583,18.30542,1419
25531,40E328762DBD80BABC8A5581C57ED5C7,60054,10,12,2,109.3016,18.31229,770
25532,40E328762DBD80BABC8A5581C57ED5C7,30731,15,16,1,109.50944,18.22306,1555
25533,40E328762DBD80BABC8A5581C57ED5C7,60541,21,22,1,109.4084,18.29208,1167
25584,DD8DCE806AFFEAC5D779812E5F8F2B3D,31561,7,14,7,109.56792,18.28479,1765
25585,DD8DCE806AFFEAC5D779812E5F8F2B3D,31071,14,16,2,109.58257,18.28458,1815
25628,B2F3687F06BC9BF7431C8843AA2E4113,38754,15,16,1,109.74667,18.37382,2430
25629,B2F3687F06BC9BF7431C8843AA2E4113,30361,19,21,2,109.50347,18.24,1508
25630,B2F3687F06BC9BF7431C8843AA2E4113,38017,21,23,2,109.49729,18.21424,1504
25660,48909A32A67BC05C61E91CFDEA889BCD,38271,11,12,1,109.62632,18.23049,1956
25661,48909A32A67BC05C61E91CFDEA889BCD,30581,13,15,2,109.62257,18.24951,1959
25665,7787090BDC7F8BDD60446754BDF84D74,30711,14,22,8,109.50271,18.25347,1510
25696,50B65AC8D2C37EA95C5135CC7670F4EA,38331,19,21,2,109.62465,18.22736,1956
25697,50B65AC8D2C37EA95C5135CC7670F4EA,39181,21,23,2,109.55153,18.28035,1715
25719,ECABE2F9F259F45EBF68156196EE19D5,30854,0,6,6,109.56889,18.27076,1763
25720,ECABE2F9F259F45EBF68156196EE19D5,31471,9,11,2,109.34583,18.29563,917
25732,875F4B80762D0E664890361D764F907D,60081,0,7,7,109.51097,18.22639,1556
25733,875F4B80762D0E664890361D764F907D,30571,7,20,13,109.50243,18.21861,1504
25734,875F4B80762D0E664890361D764F907D,60081,21,23,2,109.51097,18.22639,1556
25760,28FD729A56A38491CC99ABB23711BC1C,39181,11,13,2,109.55153,18.28035,1715
25761,28FD729A56A38491CC99ABB23711BC1C,31931,15,16,1,109.54771,18.29403,1667
25762,28FD729A56A38491CC99ABB23711BC1C,39181,18,23,5,109.55153,18.28035,1715
25780,1B378B100EB2E1F18A0E8906C6FD4DA1,61011,12,13,1,109.60653,18.19076,1900
25782,1B378B100EB2E1F18A0E8906C6FD4DA1,61011,18,21,3,109.60653,18.19076,1900
25846,41E327357BD523862BD5781EC1B279C7,38251,18,19,1,109.49618,18.25493,1510
25847,41E327357BD523862BD5781EC1B279C7,31531,20,23,3,109.49583,18.25972,1461
25880,3D8ADE80304FD3207128013D43F1118A,60421,0,11,11,109.46333,18.31743,1371
25881,3D8ADE80304FD3207128013D43F1118A,60361,13,16,3,109.51938,18.29681,1567
25882,3D8ADE80304FD3207128013D43F1118A,30711,16,18,2,109.50271,18.25347,1510
25883,3D8ADE80304FD3207128013D43F1118A,38291,19,20,1,109.51618,18.24313,1558
25887,AD37BCE39484633C97CEA12395E22DCE,38127,17,18,1,109.50833,18.27222,1513
25888,AD37BCE39484633C97CEA12395E22DCE,38291,18,20,2,109.51618,18.24313,1558
25896,17D13F6A66037B54FAB5668CDC734401,60311,0,9,9,109.52097,18.24319,1558
25897,17D13F6A66037B54FAB5668CDC734401,31931,9,23,14,109.54771,18.29403,1667
25957,1AFB73CFA15D49BFA2ECE037EF4A3987,31031,17,18,1,109.49979,18.25382,1510
25958,1AFB73CFA15D49BFA2ECE037EF4A3987,30854,19,20,1,109.56889,18.27076,1763
25992,D2006452460D74E19DE71BCDEF4A0E0E,31473,9,10,1,109.34792,18.29465,917
25993,D2006452460D74E19DE71BCDEF4A0E0E,31471,11,12,1,109.34583,18.29563,917
25994,D2006452460D74E19DE71BCDEF4A0E0E,31021,15,21,6,109.49021,18.27,1463
25995,D2006452460D74E19DE71BCDEF4A0E0E,30171,22,23,1,109.48458,18.27139,1463
26011,8621CFDF1B89A83351494618C53D033F,31071,0,6,6,109.58257,18.28458,1815
26012,8621CFDF1B89A83351494618C53D033F,39181,7,17,10,109.55153,18.28035,1715
26013,8621CFDF1B89A83351494618C53D033F,31071,18,20,2,109.58257,18.28458,1815
26014,8621CFDF1B89A83351494618C53D033F,39181,20,23,3,109.55153,18.28035,1715
26047,64BA6A8DED043A8A643982CE0E68A1E7,31101,0,12,12,109.65389,18.23403,2057
26048,64BA6A8DED043A8A643982CE0E68A1E7,60401,14,17,3,109.47444,18.27583,1414
26049,64BA6A8DED043A8A643982CE0E68A1E7,38071,19,20,1,109.40722,18.30938,1169
26071,BE7763F8096EB5A037146E1CC4190538,30451,0,1,1,109.1791,18.36229,278
26072,BE7763F8096EB5A037146E1CC4190538,31541,2,3,1,109.1809,18.36722,329
26073,BE7763F8096EB5A037146E1CC4190538,30451,4,6,2,109.1791,18.36229,278
26074,BE7763F8096EB5A037146E1CC4190538,31124,7,11,4,109.17069,18.35,276
26077,5A1C4533F331B639AE5D3D6E2930E30B,31945,0,13,13,109.58021,18.29403,1817
26078,5A1C4533F331B639AE5D3D6E2930E30B,30854,18,19,1,109.56889,18.27076,1763
26079,5A1C4533F331B639AE5D3D6E2930E30B,31071,19,20,1,109.58257,18.28458,1815
26080,5A1C4533F331B639AE5D3D6E2930E30B,31945,20,22,2,109.58021,18.29403,1817
26083,6DEC2B406A61120AE250440814CD16C2,30441,5,7,2,109.64021,18.25424,2010
26084,6DEC2B406A61120AE250440814CD16C2,30854,10,11,1,109.56889,18.27076,1763
26085,6DEC2B406A61120AE250440814CD16C2,31071,13,23,10,109.58257,18.28458,1815
26116,E5BFC902C69425C6766465DD76F010C9,30201,0,8,8,109.4909,18.26465,1462
26117,E5BFC902C69425C6766465DD76F010C9,60421,10,12,2,109.46333,18.31743,1371
26118,E5BFC902C69425C6766465DD76F010C9,39321,15,16,1,109.529,18.2167,1604
26119,E5BFC902C69425C6766465DD76F010C9,38111,18,21,3,109.52007,18.22403,1555
26125,BBD4284E8E1F188C2BAB74412D589E87,31311,11,13,2,109.72299,18.27438,2364
26126,BBD4284E8E1F188C2BAB74412D589E87,31471,16,18,2,109.34583,18.29563,917
26127,BBD4284E8E1F188C2BAB74412D589E87,60381,19,21,2,109.5241,18.22458,1605
26145,47361F17195D15CB84288794245FD3CE,38903,0,8,8,109.39229,18.29243,1117
26146,47361F17195D15CB84288794245FD3CE,30661,11,14,3,109.37028,18.24361,1008
26182,EB316856896788EC8FD871E122E95728,30701,12,14,2,109.59313,18.32007,1871
26183,EB316856896788EC8FD871E122E95728,31811,14,18,4,109.54201,18.31806,1671
26184,EB316856896788EC8FD871E122E95728,30701,20,22,2,109.59313,18.32007,1871
26185,74A9CCA48CD6C2DA9FC7DFDB8817D50B,31071,16,17,1,109.58257,18.28458,1815
26186,74A9CCA48CD6C2DA9FC7DFDB8817D50B,30854,20,21,1,109.56889,18.27076,1763
26260,7C1FA61B704108BBA1EA794ABADA6D1C,38241,0,9,9,109.54111,18.30542,1669
26261,7C1FA61B704108BBA1EA794ABADA6D1C,31471,10,11,1,109.34583,18.29563,917
26262,7C1FA61B704108BBA1EA794ABADA6D1C,31471,12,13,1,109.34583,18.29563,917
26263,7C1FA61B704108BBA1EA794ABADA6D1C,38241,17,18,1,109.54111,18.30542,1669
26264,7C1FA61B704108BBA1EA794ABADA6D1C,31031,19,20,1,109.49979,18.25382,1510
26265,7C1FA61B704108BBA1EA794ABADA6D1C,38241,21,22,1,109.54111,18.30542,1669
26286,D5ED0B56415F07DD214B0DC3E9293672,31071,0,8,8,109.58257,18.28458,1815
26287,D5ED0B56415F07DD214B0DC3E9293672,38157,9,11,2,109.51483,18.26958,1563
26288,D5ED0B56415F07DD214B0DC3E9293672,30232,13,14,1,109.6191,18.31701,1971
26289,D5ED0B56415F07DD214B0DC3E9293672,30151,18,19,1,109.50986,18.25083,1560
26290,D5ED0B56415F07DD214B0DC3E9293672,30854,21,23,2,109.56889,18.27076,1763
26359,4E6B305321F88D7C96BB8FE6495D1FE3,30121,14,18,4,109.52861,18.27222,1613
26360,4E6B305321F88D7C96BB8FE6495D1FE3,30854,19,20,1,109.56889,18.27076,1763
26382,6F2A2E5942A760BD44A11BEC746849C8,31941,0,6,6,109.62451,18.31222,1970
26400,0547C7536E43628EF24935F0C2BF5E2C,60241,0,6,6,109.53319,18.28667,1616
26401,0547C7536E43628EF24935F0C2BF5E2C,31931,6,11,5,109.54771,18.29403,1667
26430,00479D226C4FEC7FFC8500505DCBA62B,31471,16,17,1,109.34583,18.29563,917
26431,00479D226C4FEC7FFC8500505DCBA62B,30341,18,19,1,109.3625,18.29167,966
26432,00479D226C4FEC7FFC8500505DCBA62B,60381,21,23,2,109.5241,18.22458,1605
26444,A4132C7C24D4F6CFBC6C091695995585,30631,0,18,18,109.34382,18.32778,922
26445,A4132C7C24D4F6CFBC6C091695995585,31691,18,19,1,109.36604,18.3075,1019
26446,A4132C7C24D4F6CFBC6C091695995585,30631,19,23,4,109.34382,18.32778,922
26447,DB4DF566D4757FF3BB488F82DE126248,60351,0,6,6,109.58403,18.28958,1816
26448,DB4DF566D4757FF3BB488F82DE126248,31561,11,18,7,109.56792,18.28479,1765
26449,DB4DF566D4757FF3BB488F82DE126248,38121,19,20,1,109.51361,18.27813,1564
26450,DB4DF566D4757FF3BB488F82DE126248,31561,22,23,1,109.56792,18.28479,1765
26468,0312B43ACF9ED1D8304E325E851AEE29,39183,0,6,6,109.55542,18.28208,1715
26469,0312B43ACF9ED1D8304E325E851AEE29,30851,6,11,5,109.5616,18.27396,1713
26470,0312B43ACF9ED1D8304E325E851AEE29,39183,13,14,1,109.55542,18.28208,1715
26473,EEAA904909853FCE4C1006E1C626BEA2,60231,0,11,11,109.49903,18.21972,1504
26474,EEAA904909853FCE4C1006E1C626BEA2,31864,12,13,1,109.49014,18.28333,1465
26475,EEAA904909853FCE4C1006E1C626BEA2,30571,15,16,1,109.50243,18.21861,1504
26476,EEAA904909853FCE4C1006E1C626BEA2,60621,17,20,3,109.48354,18.27451,1464
26477,EEAA904909853FCE4C1006E1C626BEA2,30571,21,23,2,109.50243,18.21861,1504
26494,C834EF1A38F263607CE4942426932ED6,38171,0,1,1,109.50799,18.28139,1515
26495,C834EF1A38F263607CE4942426932ED6,30081,2,12,10,109.50243,18.26632,1512
26496,C834EF1A38F263607CE4942426932ED6,60291,16,17,1,109.50826,18.24639,1509
26497,C834EF1A38F263607CE4942426932ED6,31041,19,21,2,109.50278,18.23701,1507
26498,BAEC5DBAF6DB81E2367A0A6FEDA43BD9,31701,15,16,1,109.44132,18.28833,1266
26499,BAEC5DBAF6DB81E2367A0A6FEDA43BD9,30721,17,19,2,109.51597,18.28257,1565
26500,BAEC5DBAF6DB81E2367A0A6FEDA43BD9,30161,20,21,1,109.50042,18.24389,1508
26501,BAEC5DBAF6DB81E2367A0A6FEDA43BD9,39101,22,23,1,109.50132,18.24931,1509
26502,4BA143AD44480D9BEACA2836C34FF531,60161,9,10,1,109.49174,18.26181,1461
26503,4BA143AD44480D9BEACA2836C34FF531,60084,11,21,10,109.4984,18.2334,1507
26529,C8135D3E403B7CC96352A41CBCD291A7,30921,1,7,6,109.53903,18.29451,1667
26530,C8135D3E403B7CC96352A41CBCD291A7,31571,11,12,1,109.61563,18.23326,1957
26531,C8135D3E403B7CC96352A41CBCD291A7,38241,13,19,6,109.54111,18.30542,1669
26605,64F4CDF664AA04E7B79DE93C57128CF6,31931,2,13,11,109.54771,18.29403,1667
26606,64F4CDF664AA04E7B79DE93C57128CF6,60361,15,18,3,109.51938,18.29681,1567
26627,56ACD6E124DDA410369E9C6960DD08BD,31231,14,18,4,109.42597,18.29292,1217
26628,56ACD6E124DDA410369E9C6960DD08BD,31031,18,20,2,109.49979,18.25382,1510
26640,933C30058B1CA246EC59609197D7CAAB,31071,0,12,12,109.58257,18.28458,1815
26641,933C30058B1CA246EC59609197D7CAAB,60472,14,18,4,109.46625,18.29542,1367
26642,933C30058B1CA246EC59609197D7CAAB,39091,19,20,1,109.50097,18.25222,1510
26643,933C30058B1CA246EC59609197D7CAAB,31071,20,23,3,109.58257,18.28458,1815
26673,2AE5E6210CA3737C538797D0A34CA04C,38336,0,4,4,109.61111,18.21806,1904
26674,2AE5E6210CA3737C538797D0A34CA04C,31345,6,7,1,109.39,18.29,1066
26675,2AE5E6210CA3737C538797D0A34CA04C,38251,8,10,2,109.49618,18.25493,1510
26676,2AE5E6210CA3737C538797D0A34CA04C,31345,10,21,11,109.39,18.29,1066
26703,D0258183D3EC0F3CFFD9389BCF92CEA0,39111,3,5,2,109.5191,18.22597,1555
26704,D0258183D3EC0F3CFFD9389BCF92CEA0,31521,6,10,4,109.51458,18.22542,1555
26705,D0258183D3EC0F3CFFD9389BCF92CEA0,31781,13,15,2,109.19847,18.2975,367
26706,D0258183D3EC0F3CFFD9389BCF92CEA0,31821,17,20,3,109.51181,18.24924,1559
26707,D0258183D3EC0F3CFFD9389BCF92CEA0,60281,20,22,2,109.51743,18.25924,1561
26708,D0258183D3EC0F3CFFD9389BCF92CEA0,31821,22,23,1,109.51181,18.24924,1559
26759,4DC9641A33591180E796A7F08C635775,31951,14,17,3,109.52174,18.30299,1568
26762,16EF8003C4CB7FA32A71712A2EB072A5,60054,14,15,1,109.3016,18.31229,770
26763,16EF8003C4CB7FA32A71712A2EB072A5,60621,16,23,7,109.48354,18.27451,1464
26795,6587551DA47309E484D1302521C8D417,60631,1,3,2,109.57778,18.27583,1814
26796,6587551DA47309E484D1302521C8D417,38275,7,12,5,109.62875,18.22938,2006
26797,6587551DA47309E484D1302521C8D417,60631,15,16,1,109.57778,18.27583,1814
26798,6587551DA47309E484D1302521C8D417,38275,17,22,5,109.62875,18.22938,2006
26854,AB39E4D55C64D507788EA390DFD1227B,38283,0,8,8,109.62229,18.22618,1956
26855,AB39E4D55C64D507788EA390DFD1227B,60054,13,14,1,109.3016,18.31229,770
26856,AB39E4D55C64D507788EA390DFD1227B,38283,17,22,5,109.62229,18.22618,1956
26868,35BCF778DA6962D8791BBC3D2E760483,39041,16,19,3,109.40021,18.29278,1117
26869,35BCF778DA6962D8791BBC3D2E760483,39091,20,21,1,109.50097,18.25222,1510
26915,0E129C09250C0D46273B4BD7E5225556,30151,0,7,7,109.50986,18.25083,1560
26916,0E129C09250C0D46273B4BD7E5225556,60504,10,12,2,109.47917,18.28903,1416
26917,0E129C09250C0D46273B4BD7E5225556,31251,14,15,1,109.18528,18.2975,317
26918,0E129C09250C0D46273B4BD7E5225556,30151,20,22,2,109.50986,18.25083,1560
26919,0E129C09250C0D46273B4BD7E5225556,30421,22,23,1,109.50021,18.25861,1511
26942,08DC3612B41F2768444E0E17E11D8899,31521,0,12,12,109.51458,18.22542,1555
26943,08DC3612B41F2768444E0E17E11D8899,60381,12,14,2,109.5241,18.22458,1605
26944,08DC3612B41F2768444E0E17E11D8899,31521,14,16,2,109.51458,18.22542,1555
26945,08DC3612B41F2768444E0E17E11D8899,30201,18,19,1,109.4909,18.26465,1462
26946,08DC3612B41F2768444E0E17E11D8899,38111,20,21,1,109.52007,18.22403,1555
26947,08DC3612B41F2768444E0E17E11D8899,31521,22,23,1,109.51458,18.22542,1555
26948,56C8C781972E8BFAF8A768A19AD7F590,38261,0,11,11,109.50361,18.28153,1515
26949,56C8C781972E8BFAF8A768A19AD7F590,38157,12,13,1,109.51483,18.26958,1563
26950,56C8C781972E8BFAF8A768A19AD7F590,38261,15,23,8,109.50361,18.28153,1515
26959,C9FB371FC8ECA365AFEE785254927F8D,30854,16,17,1,109.56889,18.27076,1763
26976,F8B87E5729F408BD0003FC75DE302186,38951,0,4,4,109.48097,18.28868,1416
26977,F8B87E5729F408BD0003FC75DE302186,38951,5,7,2,109.48097,18.28868,1416
26978,F8B87E5729F408BD0003FC75DE302186,31471,9,10,1,109.34583,18.29563,917
26979,F8B87E5729F408BD0003FC75DE302186,30821,16,17,1,109.43681,18.33639,1274
26980,F8B87E5729F408BD0003FC75DE302186,38951,18,21,3,109.48097,18.28868,1416
26981,C709D01469E0800AF998DFAF42105CDC,60631,0,6,6,109.57778,18.27583,1814
26982,C709D01469E0800AF998DFAF42105CDC,31561,6,17,11,109.56792,18.28479,1765
26983,C709D01469E0800AF998DFAF42105CDC,30854,19,21,2,109.56889,18.27076,1763
26991,173CD7A2B7B334BC53A50A1D248FBCFE,31071,0,9,9,109.58257,18.28458,1815
26992,173CD7A2B7B334BC53A50A1D248FBCFE,30854,9,12,3,109.56889,18.27076,1763
26993,173CD7A2B7B334BC53A50A1D248FBCFE,60381,16,21,5,109.5241,18.22458,1605
27011,3BD6874462BCE49FA953391885E8CA15,31021,1,6,5,109.49021,18.27,1463
27012,3BD6874462BCE49FA953391885E8CA15,31271,6,8,2,109.48958,18.26257,1462
27013,3BD6874462BCE49FA953391885E8CA15,31021,9,10,1,109.49021,18.27,1463
27014,3BD6874462BCE49FA953391885E8CA15,30201,14,16,2,109.4909,18.26465,1462
27015,3BD6874462BCE49FA953391885E8CA15,30421,17,22,5,109.50021,18.25861,1511
27033,0E00D7E0174B24239144B08D52B998E8,31931,0,16,16,109.54771,18.29403,1667
27034,0E00D7E0174B24239144B08D52B998E8,31351,17,21,4,109.4959,18.28417,1465
27039,0E5593A90D661690BE3DAAA17AD936E2,38127,0,6,6,109.50833,18.27222,1513
27041,0E5593A90D661690BE3DAAA17AD936E2,31021,14,15,1,109.49021,18.27,1463
27042,0E5593A90D661690BE3DAAA17AD936E2,38127,15,23,8,109.50833,18.27222,1513
27049,F9B50F8C0BC548F341BD45D3142A9731,31461,15,17,2,109.5091,18.25389,1510
27050,F9B50F8C0BC548F341BD45D3142A9731,60281,19,20,1,109.51743,18.25924,1561
27051,F9B50F8C0BC548F341BD45D3142A9731,30711,20,23,3,109.50271,18.25347,1510
27075,6EA58F7924D334CE2A56B731883B1B80,39091,13,15,2,109.50097,18.25222,1510
27099,2C3BD53A8702A47FB82F05FB4993B683,30851,2,3,1,109.5616,18.27396,1713
27100,2C3BD53A8702A47FB82F05FB4993B683,31561,3,6,3,109.56792,18.28479,1765
27101,2C3BD53A8702A47FB82F05FB4993B683,39183,6,8,2,109.55542,18.28208,1715
27102,2C3BD53A8702A47FB82F05FB4993B683,31561,12,23,11,109.56792,18.28479,1765
27109,78161B2FCA02FEE18F8EB6C8D5CE9387,31031,17,20,3,109.49979,18.25382,1510
27110,78161B2FCA02FEE18F8EB6C8D5CE9387,38251,22,23,1,109.49618,18.25493,1510
27112,807F73DE76DFE56E472FA61396F0887C,31851,6,8,2,109.71736,18.29007,2316
27121,007CE09D95F7D7AB1CB08DCE3F879C89,38052,0,9,9,109.62618,18.23042,1956
27122,007CE09D95F7D7AB1CB08DCE3F879C89,31561,10,12,2,109.56792,18.28479,1765
27123,007CE09D95F7D7AB1CB08DCE3F879C89,38052,12,18,6,109.62618,18.23042,1956
27166,0E1B3CFC64EBB658DA96D0DCA834701E,61011,0,2,2,109.60653,18.19076,1900
27168,0E1B3CFC64EBB658DA96D0DCA834701E,61011,3,8,5,109.60653,18.19076,1900
27170,0E1B3CFC64EBB658DA96D0DCA834701E,61011,15,23,8,109.60653,18.19076,1900
27175,1C9C2039AD83BAADE716F80BF1B3E54D,30851,0,4,4,109.5616,18.27396,1713
27181,CB1C8502149DACE0B32B2F7416279EF2,31071,1,9,8,109.58257,18.28458,1815
27182,CB1C8502149DACE0B32B2F7416279EF2,30854,9,11,2,109.56889,18.27076,1763
27183,CB1C8502149DACE0B32B2F7416279EF2,31071,15,17,2,109.58257,18.28458,1815
27184,CB1C8502149DACE0B32B2F7416279EF2,30854,17,18,1,109.56889,18.27076,1763
27185,CB1C8502149DACE0B32B2F7416279EF2,31071,21,23,2,109.58257,18.28458,1815
27222,D39D64452E6BBEF7B3056CA239E1B86E,30851,0,6,6,109.5616,18.27396,1713
27223,D39D64452E6BBEF7B3056CA239E1B86E,31561,6,7,1,109.56792,18.28479,1765
27224,D39D64452E6BBEF7B3056CA239E1B86E,30854,7,14,7,109.56889,18.27076,1763
27225,D39D64452E6BBEF7B3056CA239E1B86E,31561,14,15,1,109.56792,18.28479,1765
27226,D39D64452E6BBEF7B3056CA239E1B86E,30854,15,23,8,109.56889,18.27076,1763
27237,40C57F24FE0409ABB752B2031C349577,38951,0,18,18,109.48097,18.28868,1416
27238,40C57F24FE0409ABB752B2031C349577,31461,20,21,1,109.5091,18.25389,1510
27239,40C57F24FE0409ABB752B2031C349577,39154,22,23,1,109.50201,18.25681,1511
27245,6F45817D7C192D004E915F474595B546,30201,0,9,9,109.4909,18.26465,1462
27246,6F45817D7C192D004E915F474595B546,31471,13,14,1,109.34583,18.29563,917
27247,6F45817D7C192D004E915F474595B546,30661,15,16,1,109.37028,18.24361,1008
27248,6F45817D7C192D004E915F474595B546,30201,18,21,3,109.4909,18.26465,1462
27264,E92C4377A82D1512C2FDA9EFCDAFE67D,60381,17,18,1,109.5241,18.22458,1605
27265,E92C4377A82D1512C2FDA9EFCDAFE67D,30354,21,22,1,109.42813,18.29076,1216
27279,F6EF600D772A11A06069101B0AB9C4EC,31101,17,23,6,109.65389,18.23403,2057
27280,1FE2866848043A2C10AD87212485FE15,31071,2,4,2,109.58257,18.28458,1815
27281,1FE2866848043A2C10AD87212485FE15,30854,9,14,5,109.56889,18.27076,1763
27282,1FE2866848043A2C10AD87212485FE15,31071,14,15,1,109.58257,18.28458,1815
27283,1FE2866848043A2C10AD87212485FE15,30854,17,19,2,109.56889,18.27076,1763
27284,1FE2866848043A2C10AD87212485FE15,31861,21,23,2,109.49042,18.27549,1464
27295,003C6689B311B427695E6FEF3BF3C281,38331,0,7,7,109.62465,18.22736,1956
27341,E9DC5E3F06A9FBF162477C6043E75224,30851,1,5,4,109.5616,18.27396,1713
27342,E9DC5E3F06A9FBF162477C6043E75224,30201,9,10,1,109.4909,18.26465,1462
27358,070984703178D21DC5287E457C03691A,39181,13,15,2,109.55153,18.28035,1715
27359,070984703178D21DC5287E457C03691A,39181,18,23,5,109.55153,18.28035,1715
27366,00064C0E4651B29FBEAE6571FC000567,30571,11,14,3,109.50243,18.21861,1504
27367,00064C0E4651B29FBEAE6571FC000567,60291,18,19,1,109.50826,18.24639,1509
27388,AEBBFCD9EF38894E25854AE43E8486E8,31431,0,14,14,109.44639,18.29042,1316
27389,AEBBFCD9EF38894E25854AE43E8486E8,31431,18,21,3,109.44639,18.29042,1316
27390,AEBBFCD9EF38894E25854AE43E8486E8,31431,21,23,2,109.44639,18.29042,1316
27399,1E0EA1E4B61DDC44157F7F6809A12188,60381,16,17,1,109.5241,18.22458,1605
27400,1E0EA1E4B61DDC44157F7F6809A12188,31554,17,19,2,109.55521,18.2459,1709
27401,1E0EA1E4B61DDC44157F7F6809A12188,31521,19,22,3,109.51458,18.22542,1555
27420,5533066D8871087CCD481B88DD73EF7D,31361,0,7,7,109.47417,18.28292,1415
27421,5533066D8871087CCD481B88DD73EF7D,38094,8,10,2,109.45403,18.28778,1316
27422,5533066D8871087CCD481B88DD73EF7D,60401,10,16,6,109.47444,18.27583,1414
27423,5533066D8871087CCD481B88DD73EF7D,31361,21,23,2,109.47417,18.28292,1415
27456,ED36F1C6D51C5483990D27F2F51080D2,38134,0,7,7,109.63931,18.23451,2007
27457,ED36F1C6D51C5483990D27F2F51080D2,38271,8,13,5,109.62632,18.23049,1956
27458,ED36F1C6D51C5483990D27F2F51080D2,31271,17,18,1,109.48958,18.26257,1462
27461,FF389E4ACCCAE9E25F55121145744220,31421,0,15,15,109.55382,18.22347,1705
27462,FF389E4ACCCAE9E25F55121145744220,30421,18,19,1,109.50021,18.25861,1511
27463,FF389E4ACCCAE9E25F55121145744220,31421,22,23,1,109.55382,18.22347,1705
27504,64EA917EAAD3EB55DA2ABB227203C131,60631,7,8,1,109.57778,18.27583,1814
27505,64EA917EAAD3EB55DA2ABB227203C131,30854,9,10,1,109.56889,18.27076,1763
27535,14F4ACAD1B4C4B8CE52F7EFB2E582792,31031,0,10,10,109.49979,18.25382,1510
27536,14F4ACAD1B4C4B8CE52F7EFB2E582792,31031,11,20,9,109.49979,18.25382,1510
27537,14F4ACAD1B4C4B8CE52F7EFB2E582792,31031,22,23,1,109.49979,18.25382,1510
27546,60FF9F8DF12E8BA35F74BE17AE5D7388,60524,13,14,1,109.42951,18.28993,1216
27612,54CB15055EFF66319A7EAB3FC49E46B1,30911,1,10,9,109.50493,18.26181,1511
27613,54CB15055EFF66319A7EAB3FC49E46B1,30281,10,15,5,109.50597,18.27583,1514
27614,54CB15055EFF66319A7EAB3FC49E46B1,38127,17,20,3,109.50833,18.27222,1513
27615,54CB15055EFF66319A7EAB3FC49E46B1,30421,21,23,2,109.50021,18.25861,1511
27629,5B93149195498C1BB1324829076057CC,31271,11,13,2,109.48958,18.26257,1462
27630,5B93149195498C1BB1324829076057CC,31471,15,16,1,109.34583,18.29563,917
27631,5B93149195498C1BB1324829076057CC,31271,20,23,3,109.48958,18.26257,1462
27652,E4B522EF4348156010E5C578EC13D60F,30854,0,17,17,109.56889,18.27076,1763
27653,E4B522EF4348156010E5C578EC13D60F,38171,17,20,3,109.50799,18.28139,1515
27658,C5B2C146A715B405C4C002F4F3423FFB,31931,0,11,11,109.54771,18.29403,1667
27659,C5B2C146A715B405C4C002F4F3423FFB,30861,12,15,3,109.52722,18.22743,1606
27660,C5B2C146A715B405C4C002F4F3423FFB,31931,17,18,1,109.54771,18.29403,1667
27661,C5B2C146A715B405C4C002F4F3423FFB,60371,19,20,1,109.53063,18.30056,1618
27662,9AB2A4C72D46DE0CAA5DEDB31E046940,31061,0,8,8,109.53333,18.23257,1607
27663,9AB2A4C72D46DE0CAA5DEDB31E046940,30731,9,10,1,109.50944,18.22306,1555
27664,9AB2A4C72D46DE0CAA5DEDB31E046940,31781,13,15,2,109.19847,18.2975,367
27665,9AB2A4C72D46DE0CAA5DEDB31E046940,60381,19,20,1,109.5241,18.22458,1605
27672,D984F4ED609CD4BB7417303EF42B896E,38751,0,8,8,109.74903,18.37639,2481
27673,D984F4ED609CD4BB7417303EF42B896E,31145,9,11,2,109.20431,18.30479,369
27674,D984F4ED609CD4BB7417303EF42B896E,31471,11,13,2,109.34583,18.29563,917
27675,D984F4ED609CD4BB7417303EF42B896E,31521,15,16,1,109.51458,18.22542,1555
27676,D984F4ED609CD4BB7417303EF42B896E,38751,18,23,5,109.74903,18.37639,2481
27684,90F8D99B000FA30044B427533078E04F,30809,0,10,10,109.4891,18.28229,1465
27685,90F8D99B000FA30044B427533078E04F,31471,14,16,2,109.34583,18.29563,917
27686,90F8D99B000FA30044B427533078E04F,30741,18,20,2,109.49833,18.28681,1516
27687,90F8D99B000FA30044B427533078E04F,30809,21,23,2,109.4891,18.28229,1465
27693,DA5F3652A4E23CF3043432DC065F58A9,38361,0,8,8,109.43667,18.29201,1267
27694,DA5F3652A4E23CF3043432DC065F58A9,30661,10,12,2,109.37028,18.24361,1008
27695,DA5F3652A4E23CF3043432DC065F58A9,38361,13,17,4,109.43667,18.29201,1267
27696,608A55C14BAB2A5B627ACC1F39B89FB6,31945,0,7,7,109.58021,18.29403,1817
27697,608A55C14BAB2A5B627ACC1F39B89FB6,30854,9,12,3,109.56889,18.27076,1763
27698,608A55C14BAB2A5B627ACC1F39B89FB6,31945,12,22,10,109.58021,18.29403,1817
27715,DCB860DE1ABF6C6DC7663667BFE0A93E,38707,0,10,10,109.73778,18.35368,2427
27716,DCB860DE1ABF6C6DC7663667BFE0A93E,38754,11,12,1,109.74667,18.37382,2430
27717,DCB860DE1ABF6C6DC7663667BFE0A93E,30421,14,15,1,109.50021,18.25861,1511
27718,DCB860DE1ABF6C6DC7663667BFE0A93E,30741,18,21,3,109.49833,18.28681,1516
27721,5E6BED6B24013599647F8A86A362B027,30181,18,20,2,109.51597,18.23313,1557
27722,5E6BED6B24013599647F8A86A362B027,30671,22,23,1,109.43611,18.30139,1268
27751,E887C057B111AD6EF085C23E238E5BF5,31031,0,6,6,109.49979,18.25382,1510
27752,E887C057B111AD6EF085C23E238E5BF5,31031,7,9,2,109.49979,18.25382,1510
27753,E887C057B111AD6EF085C23E238E5BF5,30711,10,14,4,109.50271,18.25347,1510
27754,E887C057B111AD6EF085C23E238E5BF5,30111,15,16,1,109.47583,18.30542,1419
27755,E887C057B111AD6EF085C23E238E5BF5,31031,19,22,3,109.49979,18.25382,1510
27764,10EBF762D28520B09848288F7052CFDE,30854,1,2,1,109.56889,18.27076,1763
27765,10EBF762D28520B09848288F7052CFDE,39101,6,18,12,109.50132,18.24931,1509
27766,10EBF762D28520B09848288F7052CFDE,31561,18,19,1,109.56792,18.28479,1765
27767,10EBF762D28520B09848288F7052CFDE,30854,21,23,2,109.56889,18.27076,1763
27788,09B8D144BA6DE5FAC678EA5795D3C895,30351,17,18,1,109.41701,18.29292,1217
27789,09B8D144BA6DE5FAC678EA5795D3C895,31431,21,23,2,109.44639,18.29042,1316
27790,B84894621C2CCD16DD835408A69C7E48,60524,0,15,15,109.42951,18.28993,1216
27791,B84894621C2CCD16DD835408A69C7E48,31421,18,19,1,109.55382,18.22347,1705
27792,B84894621C2CCD16DD835408A69C7E48,31231,21,22,1,109.42597,18.29292,1217
27867,7260738E9AF8A6F148DEA7642BD04088,30711,12,13,1,109.50271,18.25347,1510
27868,7260738E9AF8A6F148DEA7642BD04088,31521,13,15,2,109.51458,18.22542,1555
27869,7260738E9AF8A6F148DEA7642BD04088,60441,17,18,1,109.46792,18.28604,1366
27870,7260738E9AF8A6F148DEA7642BD04088,31164,19,20,1,109.69993,18.27215,2263
27871,7260738E9AF8A6F148DEA7642BD04088,31521,21,23,2,109.51458,18.22542,1555
27877,B621E9075674E792CCB217233825F9D1,30232,1,6,5,109.6191,18.31701,1971
27878,B621E9075674E792CCB217233825F9D1,60591,11,19,8,109.61118,18.21715,1904
27879,B621E9075674E792CCB217233825F9D1,60631,20,22,2,109.57778,18.27583,1814
27880,E605B26D53F08A0D3360A4541E09F4E2,38283,0,19,19,109.62229,18.22618,1956
27881,E605B26D53F08A0D3360A4541E09F4E2,30721,21,23,2,109.51597,18.28257,1565
27907,7E826D5B1F16716D0276910DC964328A,60594,0,9,9,109.62694,18.22799,1956
27908,7E826D5B1F16716D0276910DC964328A,38052,11,12,1,109.62618,18.23042,1956
27909,7E826D5B1F16716D0276910DC964328A,38754,14,15,1,109.74667,18.37382,2430
27910,7E826D5B1F16716D0276910DC964328A,31221,20,21,1,109.61333,18.26833,1913
27911,7E826D5B1F16716D0276910DC964328A,60594,22,23,1,109.62694,18.22799,1956
27915,6D02659C8AB6FF777A098A468ACF74DA,39154,18,19,1,109.50201,18.25681,1511
27916,6D02659C8AB6FF777A098A468ACF74DA,60541,21,23,2,109.4084,18.29208,1167
27936,0773FF31104402E113D05BA6BA68ACF8,38251,0,6,6,109.49618,18.25493,1510
27937,0773FF31104402E113D05BA6BA68ACF8,31781,8,12,4,109.19847,18.2975,367
27938,0773FF31104402E113D05BA6BA68ACF8,31471,15,16,1,109.34583,18.29563,917
27939,0773FF31104402E113D05BA6BA68ACF8,38251,20,22,2,109.49618,18.25493,1510
27950,39FE922EC788ADA47774DA1BA6D14BA8,30911,0,9,9,109.50493,18.26181,1511
27952,39FE922EC788ADA47774DA1BA6D14BA8,30911,16,23,7,109.50493,18.26181,1511
27957,EB57B1FA26A4B27E3FDFDA03A983298F,31471,14,15,1,109.34583,18.29563,917
27958,EB57B1FA26A4B27E3FDFDA03A983298F,31351,18,20,2,109.4959,18.28417,1465
27959,EB57B1FA26A4B27E3FDFDA03A983298F,31864,20,22,2,109.49014,18.28333,1465
27963,76718E7453F1870CDE0710FB6FA84DEF,30861,0,9,9,109.52722,18.22743,1606
27982,17CC4D48447B18FFE0C5E2D7115F70E9,60161,1,6,5,109.49174,18.26181,1461
27983,17CC4D48447B18FFE0C5E2D7115F70E9,38251,6,8,2,109.49618,18.25493,1510
27984,17CC4D48447B18FFE0C5E2D7115F70E9,60161,10,12,2,109.49174,18.26181,1461
27985,17CC4D48447B18FFE0C5E2D7115F70E9,39151,15,16,1,109.49875,18.25097,1510
27986,17CC4D48447B18FFE0C5E2D7115F70E9,60161,18,21,3,109.49174,18.26181,1461
27990,99356E8E9107D8CC5F639D94C8455F88,38052,1,8,7,109.62618,18.23042,1956
27991,99356E8E9107D8CC5F639D94C8455F88,60594,9,10,1,109.62694,18.22799,1956
27992,99356E8E9107D8CC5F639D94C8455F88,30441,11,13,2,109.64021,18.25424,2010
27993,99356E8E9107D8CC5F639D94C8455F88,31321,13,14,1,109.63799,18.23201,2007
27994,99356E8E9107D8CC5F639D94C8455F88,60594,14,17,3,109.62694,18.22799,1956
27995,99356E8E9107D8CC5F639D94C8455F88,38052,21,23,2,109.62618,18.23042,1956
28026,C5CABECFD4367CE586A1356E70EEB174,38291,12,13,1,109.51618,18.24313,1558
28027,C5CABECFD4367CE586A1356E70EEB174,30571,14,17,3,109.50243,18.21861,1504
28028,C5CABECFD4367CE586A1356E70EEB174,30271,21,23,2,109.49132,18.23153,1456
28038,8D0A4EF6BB9DEDE12E59D3FEDBD17479,30111,14,17,3,109.47583,18.30542,1419
28039,8D0A4EF6BB9DEDE12E59D3FEDBD17479,31345,19,23,4,109.39,18.29,1066
28116,D517610C2076C41FED0ED80CB6FFB44C,31561,0,5,5,109.56792,18.28479,1765
28117,D517610C2076C41FED0ED80CB6FFB44C,30851,6,21,15,109.5616,18.27396,1713
28128,4B0AADB3989E3C45AA834D87FDC75667,31181,0,12,12,109.50382,18.24813,1509
28129,4B0AADB3989E3C45AA834D87FDC75667,30711,12,14,2,109.50271,18.25347,1510
28130,4B0AADB3989E3C45AA834D87FDC75667,31181,19,20,1,109.50382,18.24813,1509
28131,4B0AADB3989E3C45AA834D87FDC75667,31521,21,22,1,109.51458,18.22542,1555
28157,C85D0B931BEF54F05B9ABBBB03212DB7,30854,0,6,6,109.56889,18.27076,1763
28158,C85D0B931BEF54F05B9ABBBB03212DB7,31561,8,17,9,109.56792,18.28479,1765
28159,C85D0B931BEF54F05B9ABBBB03212DB7,30854,19,23,4,109.56889,18.27076,1763
28199,A64F0864B99B42C4602C17C645042912,30921,0,9,9,109.53903,18.29451,1667
28200,A64F0864B99B42C4602C17C645042912,31931,10,16,6,109.54771,18.29403,1667
28201,A64F0864B99B42C4602C17C645042912,30921,18,23,5,109.53903,18.29451,1667
28229,7B2AEE2086698683607EDDDB4B678234,38154,2,6,4,109.5266,18.28278,1615
28230,7B2AEE2086698683607EDDDB4B678234,60221,7,9,2,109.52569,18.29188,1616
28231,7B2AEE2086698683607EDDDB4B678234,60201,11,17,6,109.5041,18.2509,1510
28232,7B2AEE2086698683607EDDDB4B678234,38154,20,23,3,109.5266,18.28278,1615
28236,72A9161A6BA570E7D89DA2361688C0AC,60081,0,1,1,109.51097,18.22639,1556
28237,72A9161A6BA570E7D89DA2361688C0AC,30271,2,7,5,109.49132,18.23153,1456
28238,72A9161A6BA570E7D89DA2361688C0AC,30051,9,10,1,109.48917,18.21215,1453
28241,0520DF82F6737D601C0552DC0C1A8F1E,31431,5,7,2,109.44639,18.29042,1316
28242,0520DF82F6737D601C0552DC0C1A8F1E,31781,12,13,1,109.19847,18.2975,367
28277,2A6BA0678DDF16AF08BAC9E3FA3C9391,30854,0,4,4,109.56889,18.27076,1763
28278,2A6BA0678DDF16AF08BAC9E3FA3C9391,31561,4,8,4,109.56792,18.28479,1765
28279,2A6BA0678DDF16AF08BAC9E3FA3C9391,30854,8,20,12,109.56889,18.27076,1763
28280,2A6BA0678DDF16AF08BAC9E3FA3C9391,31561,21,23,2,109.56792,18.28479,1765
28298,B0B0164974C62F379D91F845F4C0BE0F,31471,0,11,11,109.34583,18.29563,917
28299,B0B0164974C62F379D91F845F4C0BE0F,38271,14,16,2,109.62632,18.23049,1956
28300,B0B0164974C62F379D91F845F4C0BE0F,60321,17,23,6,109.63611,18.24306,2008
28305,D78D90B541213AC9F2AA85F657BE1C24,31391,0,10,10,109.50382,18.24285,1508
28306,D78D90B541213AC9F2AA85F657BE1C24,31031,10,13,3,109.49979,18.25382,1510
28307,D78D90B541213AC9F2AA85F657BE1C24,30361,13,15,2,109.50347,18.24,1508
28308,D78D90B541213AC9F2AA85F657BE1C24,38271,19,23,4,109.62632,18.23049,1956
28314,75817DB682187A07461734D66E1E6492,60631,0,4,4,109.57778,18.27583,1814
28315,75817DB682187A07461734D66E1E6492,30854,7,17,10,109.56889,18.27076,1763
28316,75817DB682187A07461734D66E1E6492,60631,22,23,1,109.57778,18.27583,1814
28353,06FCF67485A2B44C8ABC96FDB92547C5,61011,1,2,1,109.60653,18.19076,1900
28355,06FCF67485A2B44C8ABC96FDB92547C5,61011,8,15,7,109.60653,18.19076,1900
28362,53875E69050EC42E511A64D3211FA7B3,30854,9,10,1,109.56889,18.27076,1763
28363,53875E69050EC42E511A64D3211FA7B3,31071,13,14,1,109.58257,18.28458,1815
28364,53875E69050EC42E511A64D3211FA7B3,30854,16,17,1,109.56889,18.27076,1763
28365,53875E69050EC42E511A64D3211FA7B3,60631,21,23,2,109.57778,18.27583,1814
28371,41C7AB3466DC83ECF2F7D17909D01D78,38754,16,17,1,109.74667,18.37382,2430
28391,ABCD0851CC1C78BCD7AF6DBDF2F5DE49,60552,4,7,3,109.41729,18.30014,1218
28392,ABCD0851CC1C78BCD7AF6DBDF2F5DE49,30211,7,14,7,109.49882,18.23931,1508
28393,ABCD0851CC1C78BCD7AF6DBDF2F5DE49,60552,15,17,2,109.41729,18.30014,1218
28394,ABCD0851CC1C78BCD7AF6DBDF2F5DE49,30211,18,20,2,109.49882,18.23931,1508
28396,9B8B54E350D3B9115A38576A3DFFEADD,31801,10,14,4,109.20417,18.32118,371
28401,5E97A4561E11AAC4FBC53FD068EAA52B,30854,0,14,14,109.56889,18.27076,1763
28402,5E97A4561E11AAC4FBC53FD068EAA52B,30861,18,20,2,109.52722,18.22743,1606
28403,5E97A4561E11AAC4FBC53FD068EAA52B,30854,22,23,1,109.56889,18.27076,1763
28426,DE13C3C5F535C73FEAA4828FD0224890,60161,3,6,3,109.49174,18.26181,1461
28427,DE13C3C5F535C73FEAA4828FD0224890,60131,6,8,2,109.49819,18.24778,1509
28428,DE13C3C5F535C73FEAA4828FD0224890,31471,12,13,1,109.34583,18.29563,917
28429,DE13C3C5F535C73FEAA4828FD0224890,38754,14,17,3,109.74667,18.37382,2430
28430,DE13C3C5F535C73FEAA4828FD0224890,30201,18,19,1,109.4909,18.26465,1462
28431,DE13C3C5F535C73FEAA4828FD0224890,60131,20,21,1,109.49819,18.24778,1509
28432,DE13C3C5F535C73FEAA4828FD0224890,30771,22,23,1,109.49938,18.26042,1511
28503,E83EEC0EDEADBA548B114EA601516E47,38291,19,20,1,109.51618,18.24313,1558
28504,E83EEC0EDEADBA548B114EA601516E47,60291,22,23,1,109.50826,18.24639,1509
28509,B643AC77F8D8498A9694D45BA8B0F75F,60631,0,5,5,109.57778,18.27583,1814
28510,B643AC77F8D8498A9694D45BA8B0F75F,30854,7,9,2,109.56889,18.27076,1763
28511,B643AC77F8D8498A9694D45BA8B0F75F,33481,10,12,2,109.67278,18.41278,2187
28512,B643AC77F8D8498A9694D45BA8B0F75F,30854,13,23,10,109.56889,18.27076,1763
28520,0398D207FA452E02863057A6622936B4,31091,0,7,7,109.41201,18.31222,1170
28521,0398D207FA452E02863057A6622936B4,60541,9,10,1,109.4084,18.29208,1167
28522,0398D207FA452E02863057A6622936B4,30561,13,14,1,109.52778,18.31938,1621
28523,0398D207FA452E02863057A6622936B4,31101,15,18,3,109.65389,18.23403,2057
28524,0398D207FA452E02863057A6622936B4,30201,19,20,1,109.4909,18.26465,1462
28525,0398D207FA452E02863057A6622936B4,60171,22,23,1,109.51292,18.30694,1569
28540,E5D9C2E63CCE9D1234DB3809C4F11F20,38291,0,9,9,109.51618,18.24313,1558
28541,E5D9C2E63CCE9D1234DB3809C4F11F20,31671,10,11,1,109.38965,18.29813,1068
28542,E5D9C2E63CCE9D1234DB3809C4F11F20,30051,14,15,1,109.48917,18.21215,1453
28543,E5D9C2E63CCE9D1234DB3809C4F11F20,30721,18,22,4,109.51597,18.28257,1565
28603,4995463B780282C9C030A19D9F49AEAC,31071,0,6,6,109.58257,18.28458,1815
28604,4995463B780282C9C030A19D9F49AEAC,30854,9,12,3,109.56889,18.27076,1763
28605,4995463B780282C9C030A19D9F49AEAC,31071,13,16,3,109.58257,18.28458,1815
28615,486A78088314F236B361634EA8E4A8C3,60054,14,16,2,109.3016,18.31229,770
28616,486A78088314F236B361634EA8E4A8C3,30821,18,19,1,109.43681,18.33639,1274
28648,4668E301B162346AD4FA0011F3180AB0,60235,0,5,5,109.49269,18.2253,1455
28649,4668E301B162346AD4FA0011F3180AB0,30571,5,17,12,109.50243,18.21861,1504
28650,4668E301B162346AD4FA0011F3180AB0,60231,20,21,1,109.49903,18.21972,1504
28692,1B440859AEF8AC43F8A5EC98A36E6227,31571,0,7,7,109.61563,18.23326,1957
28693,1B440859AEF8AC43F8A5EC98A36E6227,31421,7,23,16,109.55382,18.22347,1705
28699,0C16D819785C0566D50CC6C5E7058EF2,30571,0,20,20,109.50243,18.21861,1504
28700,0C16D819785C0566D50CC6C5E7058EF2,30571,21,23,2,109.50243,18.21861,1504
28728,F198CAA1F49ACA5D003FD8F8473B3798,31071,14,17,3,109.58257,18.28458,1815
28729,F198CAA1F49ACA5D003FD8F8473B3798,30854,17,20,3,109.56889,18.27076,1763
28779,8C5A16299A6D294198C90C34C25C5949,31561,0,1,1,109.56792,18.28479,1765
28780,8C5A16299A6D294198C90C34C25C5949,30854,3,17,14,109.56889,18.27076,1763
28781,8C5A16299A6D294198C90C34C25C5949,31561,19,21,2,109.56792,18.28479,1765
28782,662D882A6A10D0E6C3566690F0A40636,30854,1,14,13,109.56889,18.27076,1763
28783,662D882A6A10D0E6C3566690F0A40636,31071,17,21,4,109.58257,18.28458,1815
28784,662D882A6A10D0E6C3566690F0A40636,30854,21,22,1,109.56889,18.27076,1763
28790,552B98A65A23DB4CD390E78F3246E9C5,30921,0,7,7,109.53903,18.29451,1667
28791,552B98A65A23DB4CD390E78F3246E9C5,60251,9,10,1,109.51229,18.325,1572
28792,552B98A65A23DB4CD390E78F3246E9C5,31931,11,12,1,109.54771,18.29403,1667
28793,552B98A65A23DB4CD390E78F3246E9C5,30921,13,18,5,109.53903,18.29451,1667
28794,BE44C2D8594D42B84C16E0E81B3F6120,30971,0,6,6,109.48708,18.29319,1467
28795,BE44C2D8594D42B84C16E0E81B3F6120,31101,11,13,2,109.65389,18.23403,2057
28796,BE44C2D8594D42B84C16E0E81B3F6120,31031,14,16,2,109.49979,18.25382,1510
28797,BE44C2D8594D42B84C16E0E81B3F6120,30971,18,20,2,109.48708,18.29319,1467
28798,BE44C2D8594D42B84C16E0E81B3F6120,31351,21,23,2,109.4959,18.28417,1465
28825,B43DB539B5964E15F0064080164C40C1,60631,0,7,7,109.57778,18.27583,1814
28826,B43DB539B5964E15F0064080164C40C1,38085,8,9,1,109.6291,18.23625,2007
28827,B43DB539B5964E15F0064080164C40C1,38052,10,16,6,109.62618,18.23042,1956
28840,4B683433D97E5741B264EA56EEB5A278,39151,14,16,2,109.49875,18.25097,1510
28841,4B683433D97E5741B264EA56EEB5A278,31031,20,21,1,109.49979,18.25382,1510
28842,4B683433D97E5741B264EA56EEB5A278,60131,22,23,1,109.49819,18.24778,1509
28863,E0C692116FEED9FE20A5CF7D2F4944B1,60241,14,16,2,109.53319,18.28667,1616
28864,E0C692116FEED9FE20A5CF7D2F4944B1,60401,19,20,1,109.47444,18.27583,1414
28865,3A5827A88DC93A9B58B304F6E1017BB8,60161,10,12,2,109.49174,18.26181,1461
28866,3A5827A88DC93A9B58B304F6E1017BB8,38251,13,14,1,109.49618,18.25493,1510
28867,3A5827A88DC93A9B58B304F6E1017BB8,30361,18,20,2,109.50347,18.24,1508
28868,3A5827A88DC93A9B58B304F6E1017BB8,60401,21,22,1,109.47444,18.27583,1414
28978,34EBFD58B61AA75C4B7A19FD8B59EBD4,31864,12,13,1,109.49014,18.28333,1465
28979,34EBFD58B61AA75C4B7A19FD8B59EBD4,30171,15,17,2,109.48458,18.27139,1463
28980,34EBFD58B61AA75C4B7A19FD8B59EBD4,30771,19,21,2,109.49938,18.26042,1511
28981,34EBFD58B61AA75C4B7A19FD8B59EBD4,31864,21,23,2,109.49014,18.28333,1465
28982,9FEA4B85EAE4FAEE1CAF0EABFF2FAEA1,39183,17,18,1,109.55542,18.28208,1715
28983,9FEA4B85EAE4FAEE1CAF0EABFF2FAEA1,30854,19,21,2,109.56889,18.27076,1763
28984,9FEA4B85EAE4FAEE1CAF0EABFF2FAEA1,31561,22,23,1,109.56792,18.28479,1765
28999,89A3D380798A385AE8DF1304AC1B4E0B,31931,0,15,15,109.54771,18.29403,1667
29000,89A3D380798A385AE8DF1304AC1B4E0B,39183,16,17,1,109.55542,18.28208,1715
29001,89A3D380798A385AE8DF1304AC1B4E0B,31931,17,23,6,109.54771,18.29403,1667
29002,B2F5783D04A876F88E32A31C35DBACDE,30764,1,8,7,109.45806,18.29486,1367
29003,B2F5783D04A876F88E32A31C35DBACDE,31471,11,12,1,109.34583,18.29563,917
29020,EF428BA2D8FF285B80F14CDB1F80FC95,31841,3,13,10,109.73201,18.33382,2373
29022,EF428BA2D8FF285B80F14CDB1F80FC95,60381,20,21,1,109.5241,18.22458,1605
29089,6AEAAC41A7CA163913D92BB931215E92,31781,14,15,1,109.19847,18.2975,367
29090,6AEAAC41A7CA163913D92BB931215E92,31471,16,18,2,109.34583,18.29563,917
29091,6AEAAC41A7CA163913D92BB931215E92,38251,21,23,2,109.49618,18.25493,1510
29136,37064F9BC763FD0F497B111F9661D621,30711,0,14,14,109.50271,18.25347,1510
29137,37064F9BC763FD0F497B111F9661D621,31121,16,17,1,109.16292,18.37063,230
29138,37064F9BC763FD0F497B111F9661D621,39091,19,23,4,109.50097,18.25222,1510
29160,5C958E9FBADCA0FB00CA547ED9076A9C,30421,18,20,2,109.50021,18.25861,1511
29181,34211070C0856836040CA55D5A0FB3C4,60491,1,6,5,109.43354,18.30847,1269
29182,34211070C0856836040CA55D5A0FB3C4,30341,7,8,1,109.3625,18.29167,966
29183,34211070C0856836040CA55D5A0FB3C4,30661,9,12,3,109.37028,18.24361,1008
29195,05F9648883BF713D4E846B58647DFC7D,60524,0,7,7,109.42951,18.28993,1216
29196,05F9648883BF713D4E846B58647DFC7D,60552,7,9,2,109.41729,18.30014,1218
29197,05F9648883BF713D4E846B58647DFC7D,31091,13,15,2,109.41201,18.31222,1170
29198,05F9648883BF713D4E846B58647DFC7D,60552,18,23,5,109.41729,18.30014,1218
29201,76F8F71E1A0B4A83674B128BDF4E5B21,31471,17,18,1,109.34583,18.29563,917
29202,76F8F71E1A0B4A83674B128BDF4E5B21,30791,21,23,2,109.72333,18.40889,2386
29213,F5B7F5C404245BA9BE51737FA0FA3FAB,38707,12,13,1,109.73778,18.35368,2427
29214,F5B7F5C404245BA9BE51737FA0FA3FAB,38754,14,16,2,109.74667,18.37382,2430
29232,344269AF3A98B26B4D929AD801D6CB3E,31031,12,13,1,109.49979,18.25382,1510
29248,0D3DA8126B134D203BB35373EAFFB116,31071,1,7,6,109.58257,18.28458,1815
29249,0D3DA8126B134D203BB35373EAFFB116,30854,10,13,3,109.56889,18.27076,1763
29250,0D3DA8126B134D203BB35373EAFFB116,31071,16,23,7,109.58257,18.28458,1815
29268,85D2E0E28FB58C7F8A0D7BC94160D3DD,30861,16,17,1,109.52722,18.22743,1606
29269,85D2E0E28FB58C7F8A0D7BC94160D3DD,30851,22,23,1,109.5616,18.27396,1713
29302,36CB9BFBE6722CF45733B1AB5C92EBF8,30854,0,17,17,109.56889,18.27076,1763
29303,36CB9BFBE6722CF45733B1AB5C92EBF8,60631,21,23,2,109.57778,18.27583,1814
29304,2181C8620FF53874795AD3D65A9D5C0A,30854,0,2,2,109.56889,18.27076,1763
29305,2181C8620FF53874795AD3D65A9D5C0A,60504,6,7,1,109.47917,18.28903,1416
29306,2181C8620FF53874795AD3D65A9D5C0A,30854,12,13,1,109.56889,18.27076,1763
29308,2181C8620FF53874795AD3D65A9D5C0A,30854,18,22,4,109.56889,18.27076,1763
29318,74AD1AF2EA5153BD40BCF9A3F3F2C4E3,30854,9,16,7,109.56889,18.27076,1763
29319,74AD1AF2EA5153BD40BCF9A3F3F2C4E3,30191,21,23,2,109.50361,18.22701,1506
29363,A69D60E4C46A973519D52B01D44B91F0,31701,10,11,1,109.44132,18.28833,1266
29364,A69D60E4C46A973519D52B01D44B91F0,31671,11,12,1,109.38965,18.29813,1068
29374,8FD14163A768E4253DDACA49F82AA67E,31041,15,17,2,109.50278,18.23701,1507
29375,8FD14163A768E4253DDACA49F82AA67E,30361,18,21,3,109.50347,18.24,1508
29377,4DEA461E038CB97C304B1C8C76D68215,31521,13,18,5,109.51458,18.22542,1555
29378,4DEA461E038CB97C304B1C8C76D68215,39321,21,23,2,109.529,18.2167,1604
29394,84DF4A7C208235D171EF56473BCCF210,30851,0,2,2,109.5616,18.27396,1713
29395,84DF4A7C208235D171EF56473BCCF210,31561,4,7,3,109.56792,18.28479,1765
29396,84DF4A7C208235D171EF56473BCCF210,60631,7,18,11,109.57778,18.27583,1814
29410,0B9CDE8BB5F2B882023703530E5D7EF8,30731,14,15,1,109.50944,18.22306,1555
29411,0B9CDE8BB5F2B882023703530E5D7EF8,30361,17,18,1,109.50347,18.24,1508
29442,BCE29A3A46F5A479B3F0FA50B11216DE,31071,2,8,6,109.58257,18.28458,1815
29443,BCE29A3A46F5A479B3F0FA50B11216DE,60631,11,12,1,109.57778,18.27583,1814
29444,BCE29A3A46F5A479B3F0FA50B11216DE,31071,16,20,4,109.58257,18.28458,1815
29448,A94F66C88B84FF0658441320CD9F667C,31071,1,6,5,109.58257,18.28458,1815
29449,A94F66C88B84FF0658441320CD9F667C,30854,9,23,14,109.56889,18.27076,1763
29453,E5A3ABAC97D4B4693E578C38076A1DC3,30731,0,6,6,109.50944,18.22306,1555
29454,E5A3ABAC97D4B4693E578C38076A1DC3,31521,7,9,2,109.51458,18.22542,1555
29455,E5A3ABAC97D4B4693E578C38076A1DC3,30791,12,16,4,109.72333,18.40889,2386
29456,E5A3ABAC97D4B4693E578C38076A1DC3,38111,17,18,1,109.52007,18.22403,1555
29457,E5A3ABAC97D4B4693E578C38076A1DC3,31521,18,22,4,109.51458,18.22542,1555
29492,8CE55AC8BC984D52D16D6CE4872EB6FC,31391,0,19,19,109.50382,18.24285,1508
29562,40D62DAB923B148A7A4FFB3BCA6C7343,60501,1,12,11,109.48701,18.29021,1466
29563,40D62DAB923B148A7A4FFB3BCA6C7343,31351,16,18,2,109.4959,18.28417,1465
29564,40D62DAB923B148A7A4FFB3BCA6C7343,60501,21,22,1,109.48701,18.29021,1466
29565,6363BCFC385B99D6DCC7B37759A60837,30434,14,15,1,109.17083,18.35861,278
29566,6363BCFC385B99D6DCC7B37759A60837,30451,16,17,1,109.1791,18.36229,278
29567,6363BCFC385B99D6DCC7B37759A60837,31121,18,19,1,109.16292,18.37063,230
29568,6363BCFC385B99D6DCC7B37759A60837,30434,20,22,2,109.17083,18.35861,278
29576,8B167331F8E78254A4CBA6A89A1236BC,60401,15,17,2,109.47444,18.27583,1414
29577,8B167331F8E78254A4CBA6A89A1236BC,60524,20,23,3,109.42951,18.28993,1216
29582,567BF1868FBA42FA9B3B29F2CA13F65D,30221,0,1,1,109.57833,18.20222,1802
29583,567BF1868FBA42FA9B3B29F2CA13F65D,31931,4,17,13,109.54771,18.29403,1667
29609,934029FB5F97BCE114EDCE88F0393A63,30854,0,9,9,109.56889,18.27076,1763
29610,934029FB5F97BCE114EDCE88F0393A63,30421,14,18,4,109.50021,18.25861,1511
29611,934029FB5F97BCE114EDCE88F0393A63,31031,18,20,2,109.49979,18.25382,1510
29612,934029FB5F97BCE114EDCE88F0393A63,30854,21,23,2,109.56889,18.27076,1763
29613,8D7B9451E0189947198D6AC9CE51CFEE,31091,0,7,7,109.41201,18.31222,1170
29614,8D7B9451E0189947198D6AC9CE51CFEE,30661,9,11,2,109.37028,18.24361,1008
29615,8D7B9451E0189947198D6AC9CE51CFEE,31091,13,19,6,109.41201,18.31222,1170
29616,8D7B9451E0189947198D6AC9CE51CFEE,30111,20,22,2,109.47583,18.30542,1419
29634,1E6314831320135D70F9B2103732B381,39151,11,12,1,109.49875,18.25097,1510
29635,1E6314831320135D70F9B2103732B381,31031,12,15,3,109.49979,18.25382,1510
29641,D947D8D9432E18EA6A214259B6E2987E,60411,0,7,7,109.32514,18.30854,869
29642,D947D8D9432E18EA6A214259B6E2987E,30661,8,13,5,109.37028,18.24361,1008
29643,D947D8D9432E18EA6A214259B6E2987E,60411,14,23,9,109.32514,18.30854,869
29644,335A7B1DE8538918FDA774EE3E402A76,30191,0,7,7,109.50361,18.22701,1506
29645,335A7B1DE8538918FDA774EE3E402A76,31521,8,11,3,109.51458,18.22542,1555
29646,335A7B1DE8538918FDA774EE3E402A76,30191,12,23,11,109.50361,18.22701,1506
29651,BF8433CB102DC5403FA3CD5A55490BD8,31521,0,9,9,109.51458,18.22542,1555
29652,BF8433CB102DC5403FA3CD5A55490BD8,30861,9,11,2,109.52722,18.22743,1606
29653,BF8433CB102DC5403FA3CD5A55490BD8,60054,14,15,1,109.3016,18.31229,770
29654,BF8433CB102DC5403FA3CD5A55490BD8,31521,17,19,2,109.51458,18.22542,1555
29655,BF8433CB102DC5403FA3CD5A55490BD8,60381,22,23,1,109.5241,18.22458,1605
29665,D2062F9F4167AD0C830A785B4B823E0C,38801,0,6,6,109.51472,18.2584,1561
29666,D2062F9F4167AD0C830A785B4B823E0C,38801,7,14,7,109.51472,18.2584,1561
29667,D2062F9F4167AD0C830A785B4B823E0C,60381,18,19,1,109.5241,18.22458,1605
29668,D2062F9F4167AD0C830A785B4B823E0C,38801,19,23,4,109.51472,18.2584,1561
29695,19313A561FA1DB3650F358264FB3F752,38951,18,19,1,109.48097,18.28868,1416
29696,19313A561FA1DB3650F358264FB3F752,38951,20,23,3,109.48097,18.28868,1416
29719,F84D949DDCBF25D5530F771BC55E0B9D,61011,2,5,3,109.60653,18.19076,1900
29721,F84D949DDCBF25D5530F771BC55E0B9D,61011,20,23,3,109.60653,18.19076,1900
29744,B8989CFFC223BB64D623BE9489BA8A6F,38706,0,9,9,109.74625,18.37097,2430
29745,B8989CFFC223BB64D623BE9489BA8A6F,31145,11,15,4,109.20431,18.30479,369
29746,B8989CFFC223BB64D623BE9489BA8A6F,39101,17,18,1,109.50132,18.24931,1509
29747,B8989CFFC223BB64D623BE9489BA8A6F,60121,21,23,2,109.74507,18.37472,2430
29752,55F576946F2DD2E74BBCE8583E769B71,30581,0,6,6,109.62257,18.24951,1959
29753,55F576946F2DD2E74BBCE8583E769B71,31221,6,14,8,109.61333,18.26833,1913
29754,55F576946F2DD2E74BBCE8583E769B71,30854,17,18,1,109.56889,18.27076,1763
29771,9C1407835BC54BEBDB541F52E1DA1820,61011,0,1,1,109.60653,18.19076,1900
29773,9C1407835BC54BEBDB541F52E1DA1820,61011,6,12,6,109.60653,18.19076,1900
29775,9C1407835BC54BEBDB541F52E1DA1820,61011,16,18,2,109.60653,18.19076,1900
29796,3520FED22A4D572CBFE1B08BD2743E22,31461,1,12,11,109.5091,18.25389,1510
29797,3520FED22A4D572CBFE1B08BD2743E22,31041,14,15,1,109.50278,18.23701,1507
29798,3520FED22A4D572CBFE1B08BD2743E22,38316,17,19,2,109.48542,18.27424,1464
29799,3520FED22A4D572CBFE1B08BD2743E22,30511,20,22,2,109.51069,18.24208,1558
29801,EBCB949B72E5CE9FCA5E9C7D3826BEF9,30361,15,16,1,109.50347,18.24,1508
29802,EBCB949B72E5CE9FCA5E9C7D3826BEF9,60201,17,20,3,109.5041,18.2509,1510
29803,EBCB949B72E5CE9FCA5E9C7D3826BEF9,31206,20,22,2,109.50819,18.23549,1507
29814,5E28EAB5F2E807365535BF3233D32C9B,31521,0,13,13,109.51458,18.22542,1555
29815,5E28EAB5F2E807365535BF3233D32C9B,38017,13,14,1,109.49729,18.21424,1504
29835,C162E20472DBB598395501A28AA53C86,31671,0,7,7,109.38965,18.29813,1068
29836,C162E20472DBB598395501A28AA53C86,31861,7,9,2,109.49042,18.27549,1464
29837,C162E20472DBB598395501A28AA53C86,30161,13,14,1,109.50042,18.24389,1508
29838,C162E20472DBB598395501A28AA53C86,38185,15,18,3,109.51333,18.27347,1563
29839,C162E20472DBB598395501A28AA53C86,60261,20,23,3,109.44326,18.3075,1319
29890,41F3C3B484933318A782EA0B7EF5AC36,31071,0,9,9,109.58257,18.28458,1815
29891,41F3C3B484933318A782EA0B7EF5AC36,30854,9,12,3,109.56889,18.27076,1763
29892,41F3C3B484933318A782EA0B7EF5AC36,31071,13,23,10,109.58257,18.28458,1815
29923,0BABF9C6516F437130A3DD3C99553A57,31261,0,1,1,109.51174,18.2466,1559
29924,0BABF9C6516F437130A3DD3C99553A57,31206,2,7,5,109.50819,18.23549,1507
29925,0BABF9C6516F437130A3DD3C99553A57,39191,8,17,9,109.51493,18.23472,1557
29944,37D38EF0062E64D55C94EB554B76F9EE,31945,0,8,8,109.58021,18.29403,1817
29945,37D38EF0062E64D55C94EB554B76F9EE,60361,10,11,1,109.51938,18.29681,1567
29946,37D38EF0062E64D55C94EB554B76F9EE,30854,16,17,1,109.56889,18.27076,1763
29947,37D38EF0062E64D55C94EB554B76F9EE,38171,18,19,1,109.50799,18.28139,1515
29965,E00EF22F493557E868E52C93194870CF,31071,0,6,6,109.58257,18.28458,1815
29966,E00EF22F493557E868E52C93194870CF,30854,10,11,1,109.56889,18.27076,1763
29980,DDF6BFAF733FBE3256FA7987742F55BA,39321,0,3,3,109.529,18.2167,1604
29981,DDF6BFAF733FBE3256FA7987742F55BA,31421,3,7,4,109.55382,18.22347,1705
29982,DDF6BFAF733FBE3256FA7987742F55BA,31301,9,11,2,109.14493,18.31222,170
29983,DDF6BFAF733FBE3256FA7987742F55BA,31471,13,14,1,109.34583,18.29563,917
29984,DDF6BFAF733FBE3256FA7987742F55BA,30351,16,17,1,109.41701,18.29292,1217
29985,DDF6BFAF733FBE3256FA7987742F55BA,31061,18,19,1,109.53333,18.23257,1607
29986,DDF6BFAF733FBE3256FA7987742F55BA,31421,20,23,3,109.55382,18.22347,1705
30000,E5E2DA460104E389257158E8D8C9FBDA,60281,0,6,6,109.51743,18.25924,1561
30001,E5E2DA460104E389257158E8D8C9FBDA,30251,6,11,5,109.50611,18.26653,1512
30002,E5E2DA460104E389257158E8D8C9FBDA,31261,12,13,1,109.51174,18.2466,1559
30003,E5E2DA460104E389257158E8D8C9FBDA,30251,14,17,3,109.50611,18.26653,1512
30004,E5E2DA460104E389257158E8D8C9FBDA,60281,18,23,5,109.51743,18.25924,1561
30016,415231A057DA1965AE18633C79DF4000,60614,3,5,2,109.48799,18.29521,1467
30017,415231A057DA1965AE18633C79DF4000,60501,9,10,1,109.48701,18.29021,1466
30039,1AE87A1A31A67C66BE8B0545FB82EAD0,30854,3,7,4,109.56889,18.27076,1763
30040,1AE87A1A31A67C66BE8B0545FB82EAD0,31101,10,14,4,109.65389,18.23403,2057
30041,1AE87A1A31A67C66BE8B0545FB82EAD0,31321,17,19,2,109.63799,18.23201,2007
30073,4B4DB8C4ECEDAFF99158AB3CD1CD626F,31031,0,5,5,109.49979,18.25382,1510
30074,4B4DB8C4ECEDAFF99158AB3CD1CD626F,31031,6,7,1,109.49979,18.25382,1510
30076,4B4DB8C4ECEDAFF99158AB3CD1CD626F,31031,17,23,6,109.49979,18.25382,1510
30099,768772075CF0012C3AC9B6461FB816C4,31231,0,8,8,109.42597,18.29292,1217
30100,768772075CF0012C3AC9B6461FB816C4,60231,10,12,2,109.49903,18.21972,1504
30101,768772075CF0012C3AC9B6461FB816C4,31471,14,16,2,109.34583,18.29563,917
30102,768772075CF0012C3AC9B6461FB816C4,31231,18,20,2,109.42597,18.29292,1217
30130,012ABD06F231728C214A4BA917E75B1C,30851,9,15,6,109.5616,18.27396,1713
30131,012ABD06F231728C214A4BA917E75B1C,31561,16,23,7,109.56792,18.28479,1765
30132,6541238A8C58DB37BA1296ADDD670E65,31471,13,16,3,109.34583,18.29563,917
30133,6541238A8C58DB37BA1296ADDD670E65,31351,18,20,2,109.4959,18.28417,1465
30134,A938D17B78A9CC3BBA601ADC3528D1E9,31521,0,1,1,109.51458,18.22542,1555
30135,A938D17B78A9CC3BBA601ADC3528D1E9,39111,2,4,2,109.5191,18.22597,1555
30136,A938D17B78A9CC3BBA601ADC3528D1E9,39321,5,15,10,109.529,18.2167,1604
30137,A938D17B78A9CC3BBA601ADC3528D1E9,60381,16,19,3,109.5241,18.22458,1605
30138,A938D17B78A9CC3BBA601ADC3528D1E9,39321,20,22,2,109.529,18.2167,1604
30163,F3652FF504BC297E68234A33C1877043,31945,0,7,7,109.58021,18.29403,1817
30164,F3652FF504BC297E68234A33C1877043,30854,8,10,2,109.56889,18.27076,1763
30165,F3652FF504BC297E68234A33C1877043,31945,13,14,1,109.58021,18.29403,1817
30185,1980C8D409DE9551539224B3D393CDAA,38991,1,2,1,109.52681,18.30368,1618
30186,1980C8D409DE9551539224B3D393CDAA,30071,2,3,1,109.52819,18.30472,1619
30187,1980C8D409DE9551539224B3D393CDAA,30071,7,14,7,109.52819,18.30472,1619
30188,1980C8D409DE9551539224B3D393CDAA,30071,16,20,4,109.52819,18.30472,1619
30189,1980C8D409DE9551539224B3D393CDAA,31951,22,23,1,109.52174,18.30299,1568
30213,635914FBAF9BDB855B8CB450E2AE782A,38834,1,2,1,109.47639,18.21146,1403
30214,635914FBAF9BDB855B8CB450E2AE782A,30051,6,13,7,109.48917,18.21215,1453
30215,635914FBAF9BDB855B8CB450E2AE782A,30711,14,15,1,109.50271,18.25347,1510
30227,D9AE11CD16B231308C3F0FB3F53BC3E9,31071,1,8,7,109.58257,18.28458,1815
30228,D9AE11CD16B231308C3F0FB3F53BC3E9,30854,9,11,2,109.56889,18.27076,1763
30229,D9AE11CD16B231308C3F0FB3F53BC3E9,31071,12,13,1,109.58257,18.28458,1815
30230,D9AE11CD16B231308C3F0FB3F53BC3E9,30854,14,23,9,109.56889,18.27076,1763
30247,D2C6FC87582B8AF9FC2A25EE621715E3,30111,0,10,10,109.47583,18.30542,1419
30248,D2C6FC87582B8AF9FC2A25EE621715E3,30681,11,12,1,109.48493,18.26917,1463
30249,D2C6FC87582B8AF9FC2A25EE621715E3,38094,17,18,1,109.45403,18.28778,1316
30250,D2C6FC87582B8AF9FC2A25EE621715E3,30201,19,20,1,109.4909,18.26465,1462
30251,D2C6FC87582B8AF9FC2A25EE621715E3,30111,21,23,2,109.47583,18.30542,1419
30255,983D4F389BF2B6DDDB09B0049946D36C,60614,0,9,9,109.48799,18.29521,1467
30256,983D4F389BF2B6DDDB09B0049946D36C,38951,9,11,2,109.48097,18.28868,1416
30257,983D4F389BF2B6DDDB09B0049946D36C,30971,11,12,1,109.48708,18.29319,1467
30258,983D4F389BF2B6DDDB09B0049946D36C,38951,14,19,5,109.48097,18.28868,1416
30259,983D4F389BF2B6DDDB09B0049946D36C,38951,22,23,1,109.48097,18.28868,1416
30279,43E035AE85036EBD9891453E9567CB81,30151,0,8,8,109.50986,18.25083,1560
30280,43E035AE85036EBD9891453E9567CB81,30321,10,11,1,109.49563,18.29611,1467
30281,43E035AE85036EBD9891453E9567CB81,60291,12,13,1,109.50826,18.24639,1509
30282,43E035AE85036EBD9891453E9567CB81,30151,15,23,8,109.50986,18.25083,1560
30283,3DAF31DB1DFDD7FA7EE0727CC0FC2507,31571,5,8,3,109.61563,18.23326,1957
30300,37385E5852F0E8B9BD379DD12A67AD23,31351,17,18,1,109.4959,18.28417,1465
30301,37385E5852F0E8B9BD379DD12A67AD23,30151,18,21,3,109.50986,18.25083,1560
30302,37385E5852F0E8B9BD379DD12A67AD23,31864,21,23,2,109.49014,18.28333,1465
30347,8752BC71725B50257436D50C6598F252,31071,0,11,11,109.58257,18.28458,1815
30348,8752BC71725B50257436D50C6598F252,30854,12,14,2,109.56889,18.27076,1763
30353,653802FBFFAEB319D5E2987830A7AC5C,60281,0,9,9,109.51743,18.25924,1561
30354,653802FBFFAEB319D5E2987830A7AC5C,30741,11,13,2,109.49833,18.28681,1516
30355,653802FBFFAEB319D5E2987830A7AC5C,60491,13,14,1,109.43354,18.30847,1269
30360,12D8E06C2EC8C969710FB791DF137B2B,31071,1,7,6,109.58257,18.28458,1815
30361,12D8E06C2EC8C969710FB791DF137B2B,30854,9,11,2,109.56889,18.27076,1763
30362,12D8E06C2EC8C969710FB791DF137B2B,31071,15,16,1,109.58257,18.28458,1815
30363,12D8E06C2EC8C969710FB791DF137B2B,30854,20,22,2,109.56889,18.27076,1763
30401,5332105DB723D1E9073D15BB8FF1303A,60041,0,11,11,109.39889,18.31944,1121
30402,5332105DB723D1E9073D15BB8FF1303A,30581,16,20,4,109.62257,18.24951,1959
30403,5332105DB723D1E9073D15BB8FF1303A,38275,20,22,2,109.62875,18.22938,2006
30486,4E71431CA64A26F33A810235C31BD9CB,31781,14,16,2,109.19847,18.2975,367
30487,4E71431CA64A26F33A810235C31BD9CB,31231,21,22,1,109.42597,18.29292,1217
30488,104EFBF239A23046252D07031DBBF3A9,30361,18,19,1,109.50347,18.24,1508
30489,104EFBF239A23046252D07031DBBF3A9,60231,20,22,2,109.49903,18.21972,1504
30515,9AA959ED87D1ECC3053DED17290EFCBD,31561,1,4,3,109.56792,18.28479,1765
30516,9AA959ED87D1ECC3053DED17290EFCBD,39183,7,9,2,109.55542,18.28208,1715
30517,9AA959ED87D1ECC3053DED17290EFCBD,31561,10,21,11,109.56792,18.28479,1765
30518,9AA959ED87D1ECC3053DED17290EFCBD,30854,22,23,1,109.56889,18.27076,1763
30537,D96E01B8E0F0DE9C160C9FEAFDCFDB6D,31071,2,7,5,109.58257,18.28458,1815
30538,D96E01B8E0F0DE9C160C9FEAFDCFDB6D,30854,8,18,10,109.56889,18.27076,1763
30564,32D0EBFA645FCE8DAD65D018847E5043,30232,0,6,6,109.6191,18.31701,1971
30565,32D0EBFA645FCE8DAD65D018847E5043,30854,7,9,2,109.56889,18.27076,1763
30566,32D0EBFA645FCE8DAD65D018847E5043,30232,10,12,2,109.6191,18.31701,1971
30567,32D0EBFA645FCE8DAD65D018847E5043,30854,15,23,8,109.56889,18.27076,1763
30576,5B5FB16F9BE2A1826D497C2695908410,31561,1,5,4,109.56792,18.28479,1765
30577,5B5FB16F9BE2A1826D497C2695908410,31071,5,6,1,109.58257,18.28458,1815
30578,5B5FB16F9BE2A1826D497C2695908410,31561,8,16,8,109.56792,18.28479,1765
30619,70101050DBAAA058104471D2D2A0BE56,31521,0,7,7,109.51458,18.22542,1555
30621,70101050DBAAA058104471D2D2A0BE56,31781,12,14,2,109.19847,18.2975,367
30622,70101050DBAAA058104471D2D2A0BE56,60551,18,20,2,109.42722,18.30111,1218
30624,E4F1C82E597EBE1C472A3BECEA4ABECB,38094,11,13,2,109.45403,18.28778,1316
30625,E4F1C82E597EBE1C472A3BECEA4ABECB,30361,17,19,2,109.50347,18.24,1508
30626,E4F1C82E597EBE1C472A3BECEA4ABECB,38094,20,23,3,109.45403,18.28778,1316
30641,7D1ED6067ECBD941EFC43CE0A6ADAE71,31945,0,5,5,109.58021,18.29403,1817
30642,7D1ED6067ECBD941EFC43CE0A6ADAE71,30854,6,14,8,109.56889,18.27076,1763
30661,04791679D14F3A9B55A1CA70D7059A86,30241,9,11,2,109.26174,18.3275,622
30662,04791679D14F3A9B55A1CA70D7059A86,31471,15,16,1,109.34583,18.29563,917
30663,04791679D14F3A9B55A1CA70D7059A86,60551,19,20,1,109.42722,18.30111,1218
30664,04791679D14F3A9B55A1CA70D7059A86,31671,21,23,2,109.38965,18.29813,1068
30679,FD5B9AB034F15F72E8BEF02193669238,31931,8,10,2,109.54771,18.29403,1667
30680,FD5B9AB034F15F72E8BEF02193669238,60241,12,13,1,109.53319,18.28667,1616
30681,FD5B9AB034F15F72E8BEF02193669238,31931,14,15,1,109.54771,18.29403,1667
30725,4028903DDD08DD112881FE1C80374A0D,31071,0,2,2,109.58257,18.28458,1815
30726,4028903DDD08DD112881FE1C80374A0D,30854,5,14,9,109.56889,18.27076,1763
30732,B4D280332D4864EE44777CDB8551463D,31461,1,8,7,109.5091,18.25389,1510
30733,B4D280332D4864EE44777CDB8551463D,38154,9,10,1,109.5266,18.28278,1615
30734,B4D280332D4864EE44777CDB8551463D,31461,12,23,11,109.5091,18.25389,1510
30743,08A066736557478B1013C0CF834491DF,30921,0,6,6,109.53903,18.29451,1667
30744,08A066736557478B1013C0CF834491DF,31931,8,22,14,109.54771,18.29403,1667
30748,A4120452FF09D9783BEC38585F9D2055,38134,0,5,5,109.63931,18.23451,2007
30749,A4120452FF09D9783BEC38585F9D2055,60321,8,10,2,109.63611,18.24306,2008
30750,A4120452FF09D9783BEC38585F9D2055,30581,11,13,2,109.62257,18.24951,1959
30751,A4120452FF09D9783BEC38585F9D2055,31781,14,16,2,109.19847,18.2975,367
30760,AB51E4EDC409816E27BE55C280A4BEBE,60552,0,10,10,109.41729,18.30014,1218
30761,AB51E4EDC409816E27BE55C280A4BEBE,31231,10,11,1,109.42597,18.29292,1217
30762,AB51E4EDC409816E27BE55C280A4BEBE,60552,12,13,1,109.41729,18.30014,1218
30763,AB51E4EDC409816E27BE55C280A4BEBE,31231,14,17,3,109.42597,18.29292,1217
30764,AB51E4EDC409816E27BE55C280A4BEBE,60552,20,23,3,109.41729,18.30014,1218
30771,AD0A1E1F1E587F1E96859B31EF886F77,30341,7,8,1,109.3625,18.29167,966
30772,AD0A1E1F1E587F1E96859B31EF886F77,30661,8,11,3,109.37028,18.24361,1008
30773,AD0A1E1F1E587F1E96859B31EF886F77,31471,14,15,1,109.34583,18.29563,917
30774,4C01ADD3007A66495A13EABB73C61928,31561,10,12,2,109.56792,18.28479,1765
30779,00FC332040A284DA251A8D0705989FE9,31071,0,7,7,109.58257,18.28458,1815
30780,00FC332040A284DA251A8D0705989FE9,30854,8,16,8,109.56889,18.27076,1763
30781,00FC332040A284DA251A8D0705989FE9,30151,18,20,2,109.50986,18.25083,1560
30799,56DFEAF03DB999C001DE943D9823E4CB,31231,12,16,4,109.42597,18.29292,1217
30800,56DFEAF03DB999C001DE943D9823E4CB,30211,17,19,2,109.49882,18.23931,1508
30801,56DFEAF03DB999C001DE943D9823E4CB,30211,19,21,2,109.49882,18.23931,1508
30802,60C76AD19DF8888A84F620E94C92FF2B,30571,11,13,2,109.50243,18.21861,1504
30803,60C76AD19DF8888A84F620E94C92FF2B,60231,13,22,9,109.49903,18.21972,1504
30804,7787049F99708250268B39FE13E299CD,38361,0,9,9,109.43667,18.29201,1267
30805,7787049F99708250268B39FE13E299CD,31781,11,14,3,109.19847,18.2975,367
30806,7787049F99708250268B39FE13E299CD,31471,16,17,1,109.34583,18.29563,917
30807,7787049F99708250268B39FE13E299CD,30671,18,21,3,109.43611,18.30139,1268
30855,2AE38FAF341950B0B91404FFCE5A0F3E,31931,0,6,6,109.54771,18.29403,1667
30856,2AE38FAF341950B0B91404FFCE5A0F3E,30921,6,17,11,109.53903,18.29451,1667
30857,2AE38FAF341950B0B91404FFCE5A0F3E,31931,22,23,1,109.54771,18.29403,1667
30861,A0DF8CD46D095FD0BDC705548C0AFCD7,30581,12,14,2,109.62257,18.24951,1959
30862,A0DF8CD46D095FD0BDC705548C0AFCD7,31145,16,17,1,109.20431,18.30479,369
30901,5F70E6EFF50C46A1203DB5C4C03B4FD3,31701,0,7,7,109.44132,18.28833,1266
30902,5F70E6EFF50C46A1203DB5C4C03B4FD3,31431,8,11,3,109.44639,18.29042,1316
30903,5F70E6EFF50C46A1203DB5C4C03B4FD3,31311,15,17,2,109.72299,18.27438,2364
30928,51144F334134DECCE0E931E2D7A07D76,30921,7,8,1,109.53903,18.29451,1667
30929,51144F334134DECCE0E931E2D7A07D76,30711,13,14,1,109.50271,18.25347,1510
30930,51144F334134DECCE0E931E2D7A07D76,39091,19,23,4,109.50097,18.25222,1510
30943,DFFF17B7FE30E79B8AABBB5CE171272F,30854,11,12,1,109.56889,18.27076,1763
30944,DFFF17B7FE30E79B8AABBB5CE171272F,31561,12,14,2,109.56792,18.28479,1765
30945,DFFF17B7FE30E79B8AABBB5CE171272F,31931,15,16,1,109.54771,18.29403,1667
30946,DFFF17B7FE30E79B8AABBB5CE171272F,39183,18,19,1,109.55542,18.28208,1715
30947,DFFF17B7FE30E79B8AABBB5CE171272F,31561,20,23,3,109.56792,18.28479,1765
30991,EC4B90EDBF35256FDB4D4F8B87DB8A04,31071,0,7,7,109.58257,18.28458,1815
30992,EC4B90EDBF35256FDB4D4F8B87DB8A04,30854,8,12,4,109.56889,18.27076,1763
30993,EC4B90EDBF35256FDB4D4F8B87DB8A04,31071,13,16,3,109.58257,18.28458,1815
30994,EC4B90EDBF35256FDB4D4F8B87DB8A04,30854,16,17,1,109.56889,18.27076,1763
30998,8CD15CF6B5FB4821940FF9AFE6D6CB84,31931,0,6,6,109.54771,18.29403,1667
30999,8CD15CF6B5FB4821940FF9AFE6D6CB84,30071,6,10,4,109.52819,18.30472,1619
31000,8CD15CF6B5FB4821940FF9AFE6D6CB84,31931,15,17,2,109.54771,18.29403,1667
31001,8CD15CF6B5FB4821940FF9AFE6D6CB84,30071,19,20,1,109.52819,18.30472,1619
31002,8CD15CF6B5FB4821940FF9AFE6D6CB84,31931,22,23,1,109.54771,18.29403,1667
31008,248CE0B148D688C343222BB27AEE2380,31071,0,1,1,109.58257,18.28458,1815
31009,248CE0B148D688C343222BB27AEE2380,60631,1,3,2,109.57778,18.27583,1814
31010,248CE0B148D688C343222BB27AEE2380,31071,4,5,1,109.58257,18.28458,1815
31011,248CE0B148D688C343222BB27AEE2380,60631,5,7,2,109.57778,18.27583,1814
31012,248CE0B148D688C343222BB27AEE2380,30854,8,10,2,109.56889,18.27076,1763
31013,248CE0B148D688C343222BB27AEE2380,60631,13,15,2,109.57778,18.27583,1814
31014,248CE0B148D688C343222BB27AEE2380,31071,16,17,1,109.58257,18.28458,1815
31015,248CE0B148D688C343222BB27AEE2380,31041,19,20,1,109.50278,18.23701,1507
31016,248CE0B148D688C343222BB27AEE2380,31071,21,22,1,109.58257,18.28458,1815
31023,F113DDC78FC5471ED8A23532B5EF78E0,30181,0,17,17,109.51597,18.23313,1557
31024,F113DDC78FC5471ED8A23532B5EF78E0,30711,20,23,3,109.50271,18.25347,1510
31043,44BEBA2727205520AE9AF3AB76A75967,38251,17,20,3,109.49618,18.25493,1510
31044,44BEBA2727205520AE9AF3AB76A75967,31231,20,21,1,109.42597,18.29292,1217
31045,44BEBA2727205520AE9AF3AB76A75967,31231,22,23,1,109.42597,18.29292,1217
31101,2B37ECAF93E1D338CBB5FDF40ACD1C13,30854,0,15,15,109.56889,18.27076,1763
31102,2B37ECAF93E1D338CBB5FDF40ACD1C13,30891,18,19,1,109.59431,18.28389,1865
31108,622234A65D292D040A9E438A2770674C,30851,0,15,15,109.5616,18.27396,1713
31109,622234A65D292D040A9E438A2770674C,31561,16,17,1,109.56792,18.28479,1765
31110,622234A65D292D040A9E438A2770674C,30851,18,23,5,109.5616,18.27396,1713
31138,EA446444DFE25212830F95291C13D19D,31931,0,10,10,109.54771,18.29403,1667
31139,EA446444DFE25212830F95291C13D19D,39183,10,11,1,109.55542,18.28208,1715
31140,EA446444DFE25212830F95291C13D19D,39181,11,14,3,109.55153,18.28035,1715
31141,EA446444DFE25212830F95291C13D19D,31931,14,16,2,109.54771,18.29403,1667
31142,EA446444DFE25212830F95291C13D19D,39181,17,18,1,109.55153,18.28035,1715
31143,EA446444DFE25212830F95291C13D19D,31931,18,21,3,109.54771,18.29403,1667
31181,27229B6D41BD7CDDDAA38911093865DB,31071,0,4,4,109.58257,18.28458,1815
31182,27229B6D41BD7CDDDAA38911093865DB,38085,5,16,11,109.6291,18.23625,2007
31183,27229B6D41BD7CDDDAA38911093865DB,30854,17,19,2,109.56889,18.27076,1763
31184,27229B6D41BD7CDDDAA38911093865DB,31071,21,23,2,109.58257,18.28458,1815
31219,12E8A5F9EEE6066A08670ACFE5B51517,30441,6,7,1,109.64021,18.25424,2010
31220,12E8A5F9EEE6066A08670ACFE5B51517,30854,9,19,10,109.56889,18.27076,1763
31250,95B5A6EC0B066FA043A37532D8BE9FCC,31471,14,16,2,109.34583,18.29563,917
31251,95B5A6EC0B066FA043A37532D8BE9FCC,31471,16,18,2,109.34583,18.29563,917
31252,95B5A6EC0B066FA043A37532D8BE9FCC,31031,20,21,1,109.49979,18.25382,1510
31366,745EF9B4BED0129E763F1AECF7B45AF5,38331,0,1,1,109.62465,18.22736,1956
31367,745EF9B4BED0129E763F1AECF7B45AF5,31571,2,9,7,109.61563,18.23326,1957
31368,745EF9B4BED0129E763F1AECF7B45AF5,60071,12,13,1,109.75674,18.31583,2470
31370,745EF9B4BED0129E763F1AECF7B45AF5,60161,18,23,5,109.49174,18.26181,1461
31384,4378D285803CD07A5CF2CE0DBD8B3B3A,60081,0,1,1,109.51097,18.22639,1556
31385,4378D285803CD07A5CF2CE0DBD8B3B3A,60084,3,9,6,109.4984,18.2334,1507
31386,4378D285803CD07A5CF2CE0DBD8B3B3A,31145,11,15,4,109.20431,18.30479,369
31387,4378D285803CD07A5CF2CE0DBD8B3B3A,30421,16,18,2,109.50021,18.25861,1511
31388,4378D285803CD07A5CF2CE0DBD8B3B3A,31321,18,23,5,109.63799,18.23201,2007
31389,75844BC188A37949D63EE7DEE6219ABA,60594,1,6,5,109.62694,18.22799,1956
31390,75844BC188A37949D63EE7DEE6219ABA,38052,6,10,4,109.62618,18.23042,1956
31391,75844BC188A37949D63EE7DEE6219ABA,60594,14,23,9,109.62694,18.22799,1956
31392,3887FF64832E3EF638532F1D2F2E4297,30271,2,3,1,109.49132,18.23153,1456
31393,3887FF64832E3EF638532F1D2F2E4297,60231,4,6,2,109.49903,18.21972,1504
31394,3887FF64832E3EF638532F1D2F2E4297,30271,6,7,1,109.49132,18.23153,1456
31395,3887FF64832E3EF638532F1D2F2E4297,60231,7,21,14,109.49903,18.21972,1504
31396,3887FF64832E3EF638532F1D2F2E4297,30271,22,23,1,109.49132,18.23153,1456
31400,539BEEF0B0699C76362F0AD205B9C94E,38315,12,13,1,109.48979,18.29764,1467
31401,539BEEF0B0699C76362F0AD205B9C94E,38707,15,23,8,109.73778,18.35368,2427
31419,452F0FF6BC36839041DCBEF2292D6E55,30111,15,17,2,109.47583,18.30542,1419
31420,452F0FF6BC36839041DCBEF2292D6E55,60381,19,20,1,109.5241,18.22458,1605
31421,452F0FF6BC36839041DCBEF2292D6E55,30281,21,23,2,109.50597,18.27583,1514
31446,60BBA5D95C900EDF11961F708AA4ED70,30831,18,19,1,109.69813,18.32076,2271
31447,60BBA5D95C900EDF11961F708AA4ED70,31841,20,23,3,109.73201,18.33382,2373
31476,7BF65E5054DA81A230AB5423620158E1,30854,10,11,1,109.56889,18.27076,1763
31477,7BF65E5054DA81A230AB5423620158E1,60631,13,14,1,109.57778,18.27583,1814
31478,7BF65E5054DA81A230AB5423620158E1,38157,18,20,2,109.51483,18.26958,1563
31491,77FFBAF92CA650C238A1DDB50567A1CF,60524,0,4,4,109.42951,18.28993,1216
31492,77FFBAF92CA650C238A1DDB50567A1CF,30351,6,10,4,109.41701,18.29292,1217
31504,E9CDFE5A4E319AABCB1BB5066094528A,31471,17,18,1,109.34583,18.29563,917
31505,E9CDFE5A4E319AABCB1BB5066094528A,30361,19,21,2,109.50347,18.24,1508
31506,E9CDFE5A4E319AABCB1BB5066094528A,60084,22,23,1,109.4984,18.2334,1507
31512,6747589BFB0A700EA355F21AA59F102D,31521,0,8,8,109.51458,18.22542,1555
31513,6747589BFB0A700EA355F21AA59F102D,31471,10,13,3,109.34583,18.29563,917
31514,6747589BFB0A700EA355F21AA59F102D,30421,14,16,2,109.50021,18.25861,1511
31515,6747589BFB0A700EA355F21AA59F102D,31521,19,23,4,109.51458,18.22542,1555
31542,24E94C322C21864A44D8B04F37BB2EEC,30201,18,20,2,109.4909,18.26465,1462
31543,24E94C322C21864A44D8B04F37BB2EEC,30361,21,22,1,109.50347,18.24,1508
31567,83924EE67EAF45029C324F02270BCB05,30854,13,14,1,109.56889,18.27076,1763
31568,83924EE67EAF45029C324F02270BCB05,31071,17,18,1,109.58257,18.28458,1815
31569,83924EE67EAF45029C324F02270BCB05,39111,19,20,1,109.5191,18.22597,1555
31578,2115670ECBCEFE4CA16C55F5204DF607,31761,2,4,2,109.60521,18.27965,1914
31579,2115670ECBCEFE4CA16C55F5204DF607,31071,4,6,2,109.58257,18.28458,1815
31580,2115670ECBCEFE4CA16C55F5204DF607,30854,10,18,8,109.56889,18.27076,1763
31581,2115670ECBCEFE4CA16C55F5204DF607,30181,18,20,2,109.51597,18.23313,1557
31608,5C6DA42AA960EA24C721C08C5847A20C,30761,0,6,6,109.45201,18.3,1318
31609,5C6DA42AA960EA24C721C08C5847A20C,31781,7,8,1,109.19847,18.2975,367
31610,5C6DA42AA960EA24C721C08C5847A20C,30671,12,13,1,109.43611,18.30139,1268
31658,6C0260646767B781577B5B8CE2471E51,38991,0,2,2,109.52681,18.30368,1618
31659,6C0260646767B781577B5B8CE2471E51,38484,2,12,10,109.53028,18.31528,1620
31660,6C0260646767B781577B5B8CE2471E51,38484,16,17,1,109.53028,18.31528,1620
31661,6C0260646767B781577B5B8CE2471E51,38484,19,23,4,109.53028,18.31528,1620
31665,20C15B76A1E0DF79D86EDEAC7BC3D7B7,31071,0,15,15,109.58257,18.28458,1815
31666,20C15B76A1E0DF79D86EDEAC7BC3D7B7,30854,16,17,1,109.56889,18.27076,1763
31667,20C15B76A1E0DF79D86EDEAC7BC3D7B7,31461,18,20,2,109.5091,18.25389,1510
31668,20C15B76A1E0DF79D86EDEAC7BC3D7B7,31945,22,23,1,109.58021,18.29403,1817
31698,63B5E489F3503F8EC6E40A38F9D2117C,60241,6,7,1,109.53319,18.28667,1616
31699,63B5E489F3503F8EC6E40A38F9D2117C,60171,9,10,1,109.51292,18.30694,1569
31700,63B5E489F3503F8EC6E40A38F9D2117C,31951,13,16,3,109.52174,18.30299,1568
31701,63B5E489F3503F8EC6E40A38F9D2117C,31206,20,22,2,109.50819,18.23549,1507
31709,E5B8920F3E3691BAA92FB7B056CFD690,31231,18,21,3,109.42597,18.29292,1217
31710,E5B8920F3E3691BAA92FB7B056CFD690,31345,21,23,2,109.39,18.29,1066
31719,6CBD210FE212796CEDBD8FF4BC0A58A4,39183,0,13,13,109.55542,18.28208,1715
31720,6CBD210FE212796CEDBD8FF4BC0A58A4,31931,14,15,1,109.54771,18.29403,1667
31724,CFFDD1BF3134B9FDD71614F40E1DE0FD,31561,3,5,2,109.56792,18.28479,1765
31725,CFFDD1BF3134B9FDD71614F40E1DE0FD,31071,6,14,8,109.58257,18.28458,1815
31726,CFFDD1BF3134B9FDD71614F40E1DE0FD,60463,17,18,1,109.52507,18.22438,1605
31727,CFFDD1BF3134B9FDD71614F40E1DE0FD,31071,19,23,4,109.58257,18.28458,1815
31795,1EC959553638CEC3C2D1606E92235CDE,30854,13,20,7,109.56889,18.27076,1763
31796,1EC959553638CEC3C2D1606E92235CDE,39111,21,23,2,109.5191,18.22597,1555
31797,FE95B3A32EFBC2838F293DF38F55FDD1,39183,0,1,1,109.55542,18.28208,1715
31798,FE95B3A32EFBC2838F293DF38F55FDD1,31931,2,5,3,109.54771,18.29403,1667
31799,FE95B3A32EFBC2838F293DF38F55FDD1,31561,6,17,11,109.56792,18.28479,1765
31800,FE95B3A32EFBC2838F293DF38F55FDD1,31931,20,21,1,109.54771,18.29403,1667
31811,0C12679B52C25C8A094B9B69D277B0C8,31071,0,6,6,109.58257,18.28458,1815
31812,0C12679B52C25C8A094B9B69D277B0C8,30854,9,10,1,109.56889,18.27076,1763
31813,0C12679B52C25C8A094B9B69D277B0C8,31071,11,23,12,109.58257,18.28458,1815
31880,5F14E1A15EFA1C13F8B10CBC543F107C,31701,22,23,1,109.44132,18.28833,1266
31897,9A1D1AA5EE2CD156CC396C667ED8C5B9,31071,2,10,8,109.58257,18.28458,1815
31898,9A1D1AA5EE2CD156CC396C667ED8C5B9,30854,11,23,12,109.56889,18.27076,1763
31903,324B1E458381D97CBAB467F6710BB6F8,30421,18,20,2,109.50021,18.25861,1511
31904,324B1E458381D97CBAB467F6710BB6F8,39151,22,23,1,109.49875,18.25097,1510
31996,E7A46627189B4AA0843E68EB21C731B1,31561,11,13,2,109.56792,18.28479,1765
31997,E7A46627189B4AA0843E68EB21C731B1,30324,16,20,4,109.50326,18.29257,1517
31998,E7A46627189B4AA0843E68EB21C731B1,38171,20,22,2,109.50799,18.28139,1515
32021,CEB7EA5D037E7DFD2A157DEECC6ACC53,31121,0,16,16,109.16292,18.37063,230
32022,CEB7EA5D037E7DFD2A157DEECC6ACC53,60463,18,19,1,109.52507,18.22438,1605
32023,CEB7EA5D037E7DFD2A157DEECC6ACC53,31381,22,23,1,109.1375,18.36833,129
32046,3CD8C574CE7F02C34BEF4EF870B371AB,31471,14,15,1,109.34583,18.29563,917
32047,3CD8C574CE7F02C34BEF4EF870B371AB,30361,18,20,2,109.50347,18.24,1508
32048,3CD8C574CE7F02C34BEF4EF870B371AB,30581,21,23,2,109.62257,18.24951,1959
32053,91F59FD84A5A011AF1877621EDB85B69,31071,0,12,12,109.58257,18.28458,1815
32054,91F59FD84A5A011AF1877621EDB85B69,60121,15,18,3,109.74507,18.37472,2430
32055,91F59FD84A5A011AF1877621EDB85B69,60381,19,20,1,109.5241,18.22458,1605
32056,91F59FD84A5A011AF1877621EDB85B69,38706,22,23,1,109.74625,18.37097,2430
32059,92AA74C025DCC8E1B6F69E40B85D2713,31841,15,17,2,109.73201,18.33382,2373
32060,92AA74C025DCC8E1B6F69E40B85D2713,60111,20,23,3,109.72556,18.31924,2371
32082,00A58A36A98278EF81924778C39790CF,60171,0,8,8,109.51292,18.30694,1569
32083,00A58A36A98278EF81924778C39790CF,60661,9,12,3,109.548,18.2377,1657
32107,281B6372FFA07802CACB0B657A6F5DF6,30741,14,15,1,109.49833,18.28681,1516
32122,530ABDCB6E5C0FF39924B84145065468,31101,12,14,2,109.65389,18.23403,2057
32123,530ABDCB6E5C0FF39924B84145065468,30361,16,18,2,109.50347,18.24,1508
32147,7F632B4875B2736225CD6D350CD25670,30854,8,13,5,109.56889,18.27076,1763
32148,7F632B4875B2736225CD6D350CD25670,31561,14,15,1,109.56792,18.28479,1765
32149,7F632B4875B2736225CD6D350CD25670,38251,16,18,2,109.49618,18.25493,1510
32150,7F632B4875B2736225CD6D350CD25670,31461,18,20,2,109.5091,18.25389,1510
32151,7F632B4875B2736225CD6D350CD25670,60381,20,22,2,109.5241,18.22458,1605
32189,4294195F192797A89367A7AA50405953,31091,0,6,6,109.41201,18.31222,1170
32190,4294195F192797A89367A7AA50405953,30201,8,9,1,109.4909,18.26465,1462
32191,4294195F192797A89367A7AA50405953,31181,9,11,2,109.50382,18.24813,1509
32192,4294195F192797A89367A7AA50405953,30201,11,13,2,109.4909,18.26465,1462
32193,4294195F192797A89367A7AA50405953,30201,17,19,2,109.4909,18.26465,1462
32194,4294195F192797A89367A7AA50405953,60551,22,23,1,109.42722,18.30111,1218
32195,1B6EBBFF3B9D8A3E18753343B6A29EAE,31071,0,6,6,109.58257,18.28458,1815
32196,1B6EBBFF3B9D8A3E18753343B6A29EAE,31561,7,9,2,109.56792,18.28479,1765
32197,1B6EBBFF3B9D8A3E18753343B6A29EAE,30851,9,11,2,109.5616,18.27396,1713
32198,1B6EBBFF3B9D8A3E18753343B6A29EAE,31071,12,13,1,109.58257,18.28458,1815
32199,1B6EBBFF3B9D8A3E18753343B6A29EAE,31561,16,18,2,109.56792,18.28479,1765
32200,1B6EBBFF3B9D8A3E18753343B6A29EAE,31071,19,21,2,109.58257,18.28458,1815
32209,004C4A1986E184D2F11887515F258CC6,31931,6,9,3,109.54771,18.29403,1667
32210,004C4A1986E184D2F11887515F258CC6,30921,11,12,1,109.53903,18.29451,1667
32211,004C4A1986E184D2F11887515F258CC6,30671,16,17,1,109.43611,18.30139,1268
32255,4D4289AE0DFBF4B5C79A47559DC2EBDD,30854,2,7,5,109.56889,18.27076,1763
32256,4D4289AE0DFBF4B5C79A47559DC2EBDD,31071,7,8,1,109.58257,18.28458,1815
32257,4D4289AE0DFBF4B5C79A47559DC2EBDD,30854,11,13,2,109.56889,18.27076,1763
32277,68DBE0B52FD0AB95F1DD47068FD7847F,60311,0,8,8,109.52097,18.24319,1558
32278,68DBE0B52FD0AB95F1DD47068FD7847F,30381,8,10,2,109.52521,18.24507,1609
32279,68DBE0B52FD0AB95F1DD47068FD7847F,30161,10,12,2,109.50042,18.24389,1508
32280,68DBE0B52FD0AB95F1DD47068FD7847F,30181,13,15,2,109.51597,18.23313,1557
32281,68DBE0B52FD0AB95F1DD47068FD7847F,30161,15,16,1,109.50042,18.24389,1508
32282,68DBE0B52FD0AB95F1DD47068FD7847F,38291,16,18,2,109.51618,18.24313,1558
32285,59562AEEA1EC6BCB6F4C7AC842D59FB8,38154,19,20,1,109.5266,18.28278,1615
32286,59562AEEA1EC6BCB6F4C7AC842D59FB8,31864,20,23,3,109.49014,18.28333,1465
32305,E29E6421617D17896F31CB4BE6821CC0,31361,17,18,1,109.47417,18.28292,1415
32306,E29E6421617D17896F31CB4BE6821CC0,30171,19,23,4,109.48458,18.27139,1463
32312,AD5B50011AF724A93ED322CEECA0B566,60541,0,11,11,109.4084,18.29208,1167
32313,AD5B50011AF724A93ED322CEECA0B566,30341,12,16,4,109.3625,18.29167,966
32334,0B67294FA9DBD53325D63EA36C1B8784,30271,0,14,14,109.49132,18.23153,1456
32335,0B67294FA9DBD53325D63EA36C1B8784,30771,15,17,2,109.49938,18.26042,1511
32336,0B67294FA9DBD53325D63EA36C1B8784,31411,19,20,1,109.5016,18.23576,1507
32344,C370675BE5878FE166F9AA4715A021CA,60381,0,12,12,109.5241,18.22458,1605
32345,C370675BE5878FE166F9AA4715A021CA,60054,15,17,2,109.3016,18.31229,770
32346,C370675BE5878FE166F9AA4715A021CA,30361,19,23,4,109.50347,18.24,1508
32382,FBD855000564CE6EC034501219E56C85,60281,0,2,2,109.51743,18.25924,1561
32383,FBD855000564CE6EC034501219E56C85,30741,3,7,4,109.49833,18.28681,1516
32384,FBD855000564CE6EC034501219E56C85,31781,9,15,6,109.19847,18.2975,367
32451,6121384AF418DBB207AE4840DB5A99D0,30511,1,3,2,109.51069,18.24208,1558
32452,6121384AF418DBB207AE4840DB5A99D0,60081,3,6,3,109.51097,18.22639,1556
32453,6121384AF418DBB207AE4840DB5A99D0,30191,6,7,1,109.50361,18.22701,1506
32455,6121384AF418DBB207AE4840DB5A99D0,31471,16,17,1,109.34583,18.29563,917
32456,6121384AF418DBB207AE4840DB5A99D0,60081,20,21,1,109.51097,18.22639,1556
32462,2A683F66041B1386AB7A83A8383E4C68,30361,12,15,3,109.50347,18.24,1508
32463,2A683F66041B1386AB7A83A8383E4C68,31101,17,18,1,109.65389,18.23403,2057
32464,2A683F66041B1386AB7A83A8383E4C68,38334,19,23,4,109.65035,18.23785,2057
32470,512C24BB1457413A6C40E61834013B76,31841,0,11,11,109.73201,18.33382,2373
32471,512C24BB1457413A6C40E61834013B76,38315,13,14,1,109.48979,18.29764,1467
32480,9F725703122C1475EAB02BE07EC8AAEA,31021,18,20,2,109.49021,18.27,1463
32481,9F725703122C1475EAB02BE07EC8AAEA,30391,21,22,1,109.4975,18.27118,1513
32504,5D5B29A994BBA3635D38463A75BE58F6,31021,0,9,9,109.49021,18.27,1463
32505,5D5B29A994BBA3635D38463A75BE58F6,60131,10,11,1,109.49819,18.24778,1509
32506,5D5B29A994BBA3635D38463A75BE58F6,30201,15,17,2,109.4909,18.26465,1462
32507,5D5B29A994BBA3635D38463A75BE58F6,31021,20,22,2,109.49021,18.27,1463
32519,CDB953050813C58D32D89D5658BB96B4,30071,0,6,6,109.52819,18.30472,1619
32520,CDB953050813C58D32D89D5658BB96B4,31561,8,10,2,109.56792,18.28479,1765
32521,CDB953050813C58D32D89D5658BB96B4,30071,12,13,1,109.52819,18.30472,1619
32522,CDB953050813C58D32D89D5658BB96B4,30921,15,17,2,109.53903,18.29451,1667
32571,222E0B6922623CE9FBB280F81068D40E,60661,18,20,2,109.548,18.2377,1657
32572,222E0B6922623CE9FBB280F81068D40E,31061,20,23,3,109.53333,18.23257,1607
32585,FA3AD6E291717591632932F7645364C4,39191,0,3,3,109.51493,18.23472,1557
32586,FA3AD6E291717591632932F7645364C4,31521,4,7,3,109.51458,18.22542,1555
32587,FA3AD6E291717591632932F7645364C4,31201,7,9,2,109.51042,18.23819,1558
32588,FA3AD6E291717591632932F7645364C4,31101,10,12,2,109.65389,18.23403,2057
32589,FA3AD6E291717591632932F7645364C4,31201,14,15,1,109.51042,18.23819,1558
32590,FA3AD6E291717591632932F7645364C4,31206,19,20,1,109.50819,18.23549,1507
32591,FA3AD6E291717591632932F7645364C4,31201,21,23,2,109.51042,18.23819,1558
32610,46D10B971C10D2856504DC61068F66E7,31091,14,17,3,109.41201,18.31222,1170
32611,46D10B971C10D2856504DC61068F66E7,60361,20,23,3,109.51938,18.29681,1567
32649,7C68E1F4B8B2F3CBBD5427BF66BF9C2E,31571,10,11,1,109.61563,18.23326,1957
32650,7C68E1F4B8B2F3CBBD5427BF66BF9C2E,60591,13,16,3,109.61118,18.21715,1904
32665,3E502E0A3912A138848033C0D98673D5,31231,10,12,2,109.42597,18.29292,1217
32666,3E502E0A3912A138848033C0D98673D5,30571,14,16,2,109.50243,18.21861,1504
32667,3E502E0A3912A138848033C0D98673D5,38251,17,18,1,109.49618,18.25493,1510
32672,FCD31F22AA8554809D4B91E6FFCB54BE,30851,12,19,7,109.5616,18.27396,1713
32728,B7C5BB0BB1A7BB13983C520370B8471E,38251,0,10,10,109.49618,18.25493,1510
32729,B7C5BB0BB1A7BB13983C520370B8471E,31471,14,15,1,109.34583,18.29563,917
32730,B7C5BB0BB1A7BB13983C520370B8471E,38251,20,22,2,109.49618,18.25493,1510
32731,061A86146605D753C12EC5BC04F2EF03,30381,0,6,6,109.52521,18.24507,1609
32732,061A86146605D753C12EC5BC04F2EF03,31741,9,15,6,109.10229,18.37271,30
32733,061A86146605D753C12EC5BC04F2EF03,30381,17,23,6,109.52521,18.24507,1609
32755,ADF0A7CED2B8DFD757D8FCA8B507C37E,30854,14,16,2,109.56889,18.27076,1763
32756,ADF0A7CED2B8DFD757D8FCA8B507C37E,31561,16,17,1,109.56792,18.28479,1765
32757,ADF0A7CED2B8DFD757D8FCA8B507C37E,30854,19,21,2,109.56889,18.27076,1763
32802,104D50A9C0319F25E132948E6191A1E5,30271,1,4,3,109.49132,18.23153,1456
32803,104D50A9C0319F25E132948E6191A1E5,60161,6,11,5,109.49174,18.26181,1461
32804,104D50A9C0319F25E132948E6191A1E5,30271,14,17,3,109.49132,18.23153,1456
32805,104D50A9C0319F25E132948E6191A1E5,60161,19,23,4,109.49174,18.26181,1461
32874,F568EAB7DFDD5D41E19A6F375B979656,60361,0,12,12,109.51938,18.29681,1567
32875,F568EAB7DFDD5D41E19A6F375B979656,30201,16,17,1,109.4909,18.26465,1462
32880,B2F3687F06BC9BF7431C8843AA2E4113,60234,13,14,1,109.49577,18.2096,1453
32881,B2F3687F06BC9BF7431C8843AA2E4113,38017,15,20,5,109.49729,18.21424,1504
32882,B2F3687F06BC9BF7431C8843AA2E4113,38017,22,23,1,109.49729,18.21424,1504
32892,B023927CBEC0A8053CBDF64A5B76E367,30571,0,6,6,109.50243,18.21861,1504
32893,B023927CBEC0A8053CBDF64A5B76E367,31931,7,9,2,109.54771,18.29403,1667
32894,B023927CBEC0A8053CBDF64A5B76E367,30921,14,15,1,109.53903,18.29451,1667
32935,C5F520449EBC5BB529DC1F3F22008D6A,31431,0,7,7,109.44639,18.29042,1316
32938,C5F520449EBC5BB529DC1F3F22008D6A,30361,19,21,2,109.50347,18.24,1508
32939,C5F520449EBC5BB529DC1F3F22008D6A,31431,21,23,2,109.44639,18.29042,1316
32943,097736CC65CDCC4ACF05842432CBC496,60291,0,10,10,109.50826,18.24639,1509
32944,097736CC65CDCC4ACF05842432CBC496,38275,15,16,1,109.62875,18.22938,2006
32955,AB87DA8A24EEE7231EA58FCCDC7600DC,60641,0,6,6,109.53854,18.2359,1657
32989,C925EDC1C2C39BAEC75090090BF059D6,30741,0,10,10,109.49833,18.28681,1516
32990,C925EDC1C2C39BAEC75090090BF059D6,30721,10,12,2,109.51597,18.28257,1565
32991,C925EDC1C2C39BAEC75090090BF059D6,30741,12,14,2,109.49833,18.28681,1516
32992,C925EDC1C2C39BAEC75090090BF059D6,30111,18,20,2,109.47583,18.30542,1419
33000,4DE71CE1D98B4BE73B9507B19A1BFD20,39081,16,23,7,109.19382,18.29111,366
33001,13104A6A71A054F852B52BB76993ADB2,30854,0,8,8,109.56889,18.27076,1763
33002,13104A6A71A054F852B52BB76993ADB2,30851,10,17,7,109.5616,18.27396,1713
33057,1E4EB590D9A7F8271855EC61FF090359,30711,15,17,2,109.50271,18.25347,1510
33058,1E4EB590D9A7F8271855EC61FF090359,30711,19,23,4,109.50271,18.25347,1510
33068,58A6EA13AE1B5EC7733B5B9E4D600F6F,39131,0,3,3,109.2066,18.29639,417
33069,58A6EA13AE1B5EC7733B5B9E4D600F6F,39131,5,8,3,109.2066,18.29639,417
33071,58A6EA13AE1B5EC7733B5B9E4D600F6F,60054,14,15,1,109.3016,18.31229,770
33096,D4EE8E1A4C04A1FF0596E4221D0B8B42,31071,3,6,3,109.58257,18.28458,1815
33097,D4EE8E1A4C04A1FF0596E4221D0B8B42,30854,6,9,3,109.56889,18.27076,1763
33098,D4EE8E1A4C04A1FF0596E4221D0B8B42,31071,10,13,3,109.58257,18.28458,1815
33118,32F65A20D32806FF353EB969C069139F,31031,0,7,7,109.49979,18.25382,1510
33121,32F65A20D32806FF353EB969C069139F,31031,16,21,5,109.49979,18.25382,1510
33122,32F65A20D32806FF353EB969C069139F,31031,21,23,2,109.49979,18.25382,1510
33161,875F4B80762D0E664890361D764F907D,60081,0,7,7,109.51097,18.22639,1556
33162,875F4B80762D0E664890361D764F907D,30571,7,18,11,109.50243,18.21861,1504
33163,875F4B80762D0E664890361D764F907D,60081,19,22,3,109.51097,18.22639,1556
33170,45FC4D7B7AEB1BB8222449DDC064C06B,31945,0,18,18,109.58021,18.29403,1817
33171,45FC4D7B7AEB1BB8222449DDC064C06B,30854,19,20,1,109.56889,18.27076,1763
33202,1FD05A9E99D3A8B48E9543287CC9F67A,31101,0,5,5,109.65389,18.23403,2057
33203,1FD05A9E99D3A8B48E9543287CC9F67A,30581,8,9,1,109.62257,18.24951,1959
33204,1FD05A9E99D3A8B48E9543287CC9F67A,60211,11,13,2,109.63549,18.26049,2011
33205,386F7E2A07BE399DCB2707EFFCEA6EF0,31221,0,2,2,109.61333,18.26833,1913
33206,386F7E2A07BE399DCB2707EFFCEA6EF0,38331,3,10,7,109.62465,18.22736,1956
33207,386F7E2A07BE399DCB2707EFFCEA6EF0,30441,15,16,1,109.64021,18.25424,2010
33208,386F7E2A07BE399DCB2707EFFCEA6EF0,60594,16,18,2,109.62694,18.22799,1956
33240,C53359D886B7B5AFF68C8D065C0B3F4F,31041,0,10,10,109.50278,18.23701,1507
33241,C53359D886B7B5AFF68C8D065C0B3F4F,60381,12,13,1,109.5241,18.22458,1605
33242,C53359D886B7B5AFF68C8D065C0B3F4F,31041,16,21,5,109.50278,18.23701,1507
33257,578D6C2F8B353A0A6B51E609EBAAB9E1,31071,0,11,11,109.58257,18.28458,1815
33258,578D6C2F8B353A0A6B51E609EBAAB9E1,30854,11,18,7,109.56889,18.27076,1763
33259,578D6C2F8B353A0A6B51E609EBAAB9E1,60631,21,22,1,109.57778,18.27583,1814
33263,9B389AE8E9B004176803CCEAFF69104A,31071,2,6,4,109.58257,18.28458,1815
33264,9B389AE8E9B004176803CCEAFF69104A,60631,7,22,15,109.57778,18.27583,1814
33314,92D84094136F2FB8B7D41AECD69A79AD,30511,17,23,6,109.51069,18.24208,1558
33369,DE9D7565F2919D8BB9F03ACFED85BB11,39131,0,7,7,109.2066,18.29639,417
33377,C17F2EF1DEA79C8C951E3013EE071B2C,30741,0,2,2,109.49833,18.28681,1516
33378,C17F2EF1DEA79C8C951E3013EE071B2C,31071,2,14,12,109.58257,18.28458,1815
33379,C17F2EF1DEA79C8C951E3013EE071B2C,31391,16,17,1,109.50382,18.24285,1508
33380,60BD0B451F2F456B931E74539A61B576,30581,0,7,7,109.62257,18.24951,1959
33381,60BD0B451F2F456B931E74539A61B576,31571,7,9,2,109.61563,18.23326,1957
33382,60BD0B451F2F456B931E74539A61B576,60054,13,14,1,109.3016,18.31229,770
33383,60BD0B451F2F456B931E74539A61B576,38315,17,19,2,109.48979,18.29764,1467
33396,3D8ADE80304FD3207128013D43F1118A,60472,0,2,2,109.46625,18.29542,1367
33397,3D8ADE80304FD3207128013D43F1118A,60421,3,14,11,109.46333,18.31743,1371
33398,3D8ADE80304FD3207128013D43F1118A,31551,16,17,1,109.55868,18.24222,1708
33399,3D8ADE80304FD3207128013D43F1118A,31031,20,21,1,109.49979,18.25382,1510
33420,17D13F6A66037B54FAB5668CDC734401,60671,2,5,3,109.52979,18.31757,1621
33421,17D13F6A66037B54FAB5668CDC734401,31931,9,17,8,109.54771,18.29403,1667
33422,17D13F6A66037B54FAB5668CDC734401,30201,20,21,1,109.4909,18.26465,1462
33464,918CA9A7084F993FB16E3BC0238F013F,38141,0,9,9,109.39479,18.2916,1116
33465,918CA9A7084F993FB16E3BC0238F013F,38027,9,11,2,109.38833,18.2909,1066
33466,918CA9A7084F993FB16E3BC0238F013F,30661,11,16,5,109.37028,18.24361,1008
33467,918CA9A7084F993FB16E3BC0238F013F,38141,17,23,6,109.39479,18.2916,1116
33468,4B5715B52BEE7053A5D5FB0753903282,31864,0,3,3,109.49014,18.28333,1465
33469,4B5715B52BEE7053A5D5FB0753903282,31351,4,6,2,109.4959,18.28417,1465
33470,4B5715B52BEE7053A5D5FB0753903282,60401,9,11,2,109.47444,18.27583,1414
33516,1C67859AC074D33800F75471EB5E573E,30854,0,7,7,109.56889,18.27076,1763
33517,1C67859AC074D33800F75471EB5E573E,31071,10,11,1,109.58257,18.28458,1815
33518,1C67859AC074D33800F75471EB5E573E,30854,12,21,9,109.56889,18.27076,1763
33519,1C67859AC074D33800F75471EB5E573E,60631,22,23,1,109.57778,18.27583,1814
33527,AECF79630BEEC0EA88FD59B92FCAE378,30891,2,13,11,109.59431,18.28389,1865
33528,AECF79630BEEC0EA88FD59B92FCAE378,30854,14,22,8,109.56889,18.27076,1763
33529,3A145BF69DF902E1EF820C356086EF54,60401,1,2,1,109.47444,18.27583,1414
33530,3A145BF69DF902E1EF820C356086EF54,31391,4,6,2,109.50382,18.24285,1508
33531,3A145BF69DF902E1EF820C356086EF54,31561,10,11,1,109.56792,18.28479,1765
33532,3A145BF69DF902E1EF820C356086EF54,30854,12,14,2,109.56889,18.27076,1763
33533,3A145BF69DF902E1EF820C356086EF54,30731,15,17,2,109.50944,18.22306,1555
33534,3A145BF69DF902E1EF820C356086EF54,60054,18,19,1,109.3016,18.31229,770
33535,3A145BF69DF902E1EF820C356086EF54,60234,20,22,2,109.49577,18.2096,1453
33547,1AFB73CFA15D49BFA2ECE037EF4A3987,33051,10,12,2,109.6475,18.46618,2096
33548,1AFB73CFA15D49BFA2ECE037EF4A3987,30854,14,20,6,109.56889,18.27076,1763
33549,1AFB73CFA15D49BFA2ECE037EF4A3987,31071,20,21,1,109.58257,18.28458,1815
33564,C358285726113434A30FBBA8DED710E7,30711,20,21,1,109.50271,18.25347,1510
33565,C358285726113434A30FBBA8DED710E7,60371,22,23,1,109.53063,18.30056,1618
33567,275770A477CB8A98DE699BAE7694B84A,31471,11,13,2,109.34583,18.29563,917
33568,275770A477CB8A98DE699BAE7694B84A,31531,18,23,5,109.49583,18.25972,1461
33569,96740EA54DE1F338A180C12CF430841E,38052,9,11,2,109.62618,18.23042,1956
33570,96740EA54DE1F338A180C12CF430841E,31321,13,14,1,109.63799,18.23201,2007
33571,96740EA54DE1F338A180C12CF430841E,38275,19,20,1,109.62875,18.22938,2006
33572,2593966F0C8425B380675DCEA23788BE,39181,0,8,8,109.55153,18.28035,1715
33573,2593966F0C8425B380675DCEA23788BE,39181,8,9,1,109.55153,18.28035,1715
33574,2593966F0C8425B380675DCEA23788BE,39181,10,23,13,109.55153,18.28035,1715
33611,D2006452460D74E19DE71BCDEF4A0E0E,30171,0,8,8,109.48458,18.27139,1463
33612,D2006452460D74E19DE71BCDEF4A0E0E,31781,10,13,3,109.19847,18.2975,367
33613,D2006452460D74E19DE71BCDEF4A0E0E,30171,15,18,3,109.48458,18.27139,1463
33614,D2006452460D74E19DE71BCDEF4A0E0E,31021,21,23,2,109.49021,18.27,1463
33649,91BBA859510138E2A3B6234A0D61C803,30191,19,21,2,109.50361,18.22701,1506
33650,91BBA859510138E2A3B6234A0D61C803,60381,21,23,2,109.5241,18.22458,1605
33663,8621CFDF1B89A83351494618C53D033F,31071,1,5,4,109.58257,18.28458,1815
33664,8621CFDF1B89A83351494618C53D033F,39181,7,8,1,109.55153,18.28035,1715
33665,8621CFDF1B89A83351494618C53D033F,39181,10,12,2,109.55153,18.28035,1715
33666,8621CFDF1B89A83351494618C53D033F,31071,14,15,1,109.58257,18.28458,1815
33667,8621CFDF1B89A83351494618C53D033F,39181,18,23,5,109.55153,18.28035,1715
33688,B133114A8ECB59B8316DD4DF63AEB9F8,30861,0,11,11,109.52722,18.22743,1606
33689,B133114A8ECB59B8316DD4DF63AEB9F8,31471,14,17,3,109.34583,18.29563,917
33690,B133114A8ECB59B8316DD4DF63AEB9F8,30361,19,21,2,109.50347,18.24,1508
33724,22B987DE38F8C4435934FE5E6190C4A2,30854,0,4,4,109.56889,18.27076,1763
33725,22B987DE38F8C4435934FE5E6190C4A2,60631,4,8,4,109.57778,18.27583,1814
33726,22B987DE38F8C4435934FE5E6190C4A2,30581,11,12,1,109.62257,18.24951,1959
33727,22B987DE38F8C4435934FE5E6190C4A2,30854,15,16,1,109.56889,18.27076,1763
33728,22B987DE38F8C4435934FE5E6190C4A2,60631,20,22,2,109.57778,18.27583,1814
33735,BE7763F8096EB5A037146E1CC4190538,30854,0,10,10,109.56889,18.27076,1763
33736,BE7763F8096EB5A037146E1CC4190538,31561,11,12,1,109.56792,18.28479,1765
33737,BE7763F8096EB5A037146E1CC4190538,30854,13,14,1,109.56889,18.27076,1763
33750,E8BE10EF1C0A6A216F7B6C008ED029A8,60371,0,8,8,109.53063,18.30056,1618
33751,E8BE10EF1C0A6A216F7B6C008ED029A8,31571,8,10,2,109.61563,18.23326,1957
33752,E8BE10EF1C0A6A216F7B6C008ED029A8,60226,12,15,3,109.5175,18.28778,1566
33762,B76381FBDC68F2B2041DDEC63195F0A7,31391,10,16,6,109.50382,18.24285,1508
33763,B76381FBDC68F2B2041DDEC63195F0A7,39181,20,21,1,109.55153,18.28035,1715
33795,DF8F1564B6874B5D4156BD7EDF97726C,33354,0,13,13,109.67465,18.44583,2192
33796,DF8F1564B6874B5D4156BD7EDF97726C,30421,16,19,3,109.50021,18.25861,1511
33797,DF8F1564B6874B5D4156BD7EDF97726C,33354,21,23,2,109.67465,18.44583,2192
33809,34015BC7674A7CCEE2F07FE91B0DCE26,31221,0,9,9,109.61333,18.26833,1913
33810,34015BC7674A7CCEE2F07FE91B0DCE26,30234,10,11,1,109.60681,18.29979,1918
33831,2191B2AD5C915B8862D4C345F0A13CFB,60351,21,22,1,109.58403,18.28958,1816
33832,2191B2AD5C915B8862D4C345F0A13CFB,30851,22,23,1,109.5616,18.27396,1713
33849,E9F64FD67E39C3E2C15C20715338A941,31931,18,19,1,109.54771,18.29403,1667
33850,E9F64FD67E39C3E2C15C20715338A941,30921,21,23,2,109.53903,18.29451,1667
33912,13C882817D5EF3329D8612AEE7E0F34D,31864,1,7,6,109.49014,18.28333,1465
33917,EB316856896788EC8FD871E122E95728,30931,0,6,6,109.55653,18.32722,1722
33918,EB316856896788EC8FD871E122E95728,31811,7,12,5,109.54201,18.31806,1671
33919,EB316856896788EC8FD871E122E95728,30701,12,14,2,109.59313,18.32007,1871
33920,EB316856896788EC8FD871E122E95728,31811,14,16,2,109.54201,18.31806,1671
33921,EB316856896788EC8FD871E122E95728,30701,16,18,2,109.59313,18.32007,1871
33922,EB316856896788EC8FD871E122E95728,60361,19,20,1,109.51938,18.29681,1567
33923,EB316856896788EC8FD871E122E95728,30701,21,22,1,109.59313,18.32007,1871
33929,74A9CCA48CD6C2DA9FC7DFDB8817D50B,31071,9,11,2,109.58257,18.28458,1815
33941,9E33CDC1D50278864BA2D5B1B9BF7797,38834,0,8,8,109.47639,18.21146,1403
33942,9E33CDC1D50278864BA2D5B1B9BF7797,31781,12,13,1,109.19847,18.2975,367
33943,9E33CDC1D50278864BA2D5B1B9BF7797,38291,18,19,1,109.51618,18.24313,1558
33944,9E33CDC1D50278864BA2D5B1B9BF7797,38834,21,22,1,109.47639,18.21146,1403
33948,58979C567AA82D4656FBA764FCCBAA6B,30911,19,20,1,109.50493,18.26181,1511
33949,58979C567AA82D4656FBA764FCCBAA6B,38094,20,23,3,109.45403,18.28778,1316
33975,971FAC974FC919EB70A5D4943C3307C0,60594,14,15,1,109.62694,18.22799,1956
33976,971FAC974FC919EB70A5D4943C3307C0,38052,18,21,3,109.62618,18.23042,1956
34005,8FC35EA2DA8D121B314742A5B151E4A5,31071,0,12,12,109.58257,18.28458,1815
34034,584F5E043DB077A77C792CD4DDE826F7,38811,0,8,8,109.50875,18.2175,1504
34035,584F5E043DB077A77C792CD4DDE826F7,31521,8,10,2,109.51458,18.22542,1555
34036,584F5E043DB077A77C792CD4DDE826F7,38017,10,17,7,109.49729,18.21424,1504
34037,584F5E043DB077A77C792CD4DDE826F7,30361,18,21,3,109.50347,18.24,1508
34038,584F5E043DB077A77C792CD4DDE826F7,38811,22,23,1,109.50875,18.2175,1504
34066,FB16AA24AD94D8CC7E1110E44BD68910,31945,0,7,7,109.58021,18.29403,1817
34067,FB16AA24AD94D8CC7E1110E44BD68910,30854,8,10,2,109.56889,18.27076,1763
34068,FB16AA24AD94D8CC7E1110E44BD68910,31945,12,14,2,109.58021,18.29403,1817
34069,FB16AA24AD94D8CC7E1110E44BD68910,30854,18,19,1,109.56889,18.27076,1763
34070,FB16AA24AD94D8CC7E1110E44BD68910,31945,20,22,2,109.58021,18.29403,1817
34108,2DDF3A993BD69F79020EB97CF3A71819,38171,0,7,7,109.50799,18.28139,1515
34109,2DDF3A993BD69F79020EB97CF3A71819,30161,8,14,6,109.50042,18.24389,1508
34110,2DDF3A993BD69F79020EB97CF3A71819,30161,16,20,4,109.50042,18.24389,1508
34114,D5ED0B56415F07DD214B0DC3E9293672,30232,0,2,2,109.6191,18.31701,1971
34115,D5ED0B56415F07DD214B0DC3E9293672,60631,4,8,4,109.57778,18.27583,1814
34154,EBD16061EA20EE33D9344D33735E5205,38891,1,4,3,109.51486,18.24118,1558
34155,EBD16061EA20EE33D9344D33735E5205,38291,7,8,1,109.51618,18.24313,1558
34156,EBD16061EA20EE33D9344D33735E5205,60291,8,10,2,109.50826,18.24639,1509
34157,EBD16061EA20EE33D9344D33735E5205,31441,14,16,2,109.51181,18.24424,1559
34158,EBD16061EA20EE33D9344D33735E5205,30071,19,23,4,109.52819,18.30472,1619
34176,34A1BA5A97F90C4ABB34EDC7004774A9,31071,4,5,1,109.58257,18.28458,1815
34177,34A1BA5A97F90C4ABB34EDC7004774A9,30851,8,22,14,109.5616,18.27396,1713
34178,D00EAD9144E7A4027F84D32EB5112DB4,30921,1,2,1,109.53903,18.29451,1667
34179,D00EAD9144E7A4027F84D32EB5112DB4,31931,2,20,18,109.54771,18.29403,1667
34234,ECA37B99D2E4FEE602303DB4AB25AB77,30721,0,11,11,109.51597,18.28257,1565
34235,ECA37B99D2E4FEE602303DB4AB25AB77,31231,15,16,1,109.42597,18.29292,1217
34236,ECA37B99D2E4FEE602303DB4AB25AB77,30721,17,23,6,109.51597,18.28257,1565
34242,5264833F0013AE6B294396000613EF89,60201,0,10,10,109.5041,18.2509,1510
34243,5264833F0013AE6B294396000613EF89,60581,13,15,2,109.59785,18.29931,1868
34244,5264833F0013AE6B294396000613EF89,31031,16,18,2,109.49979,18.25382,1510
34245,5264833F0013AE6B294396000613EF89,31041,19,21,2,109.50278,18.23701,1507
34246,5264833F0013AE6B294396000613EF89,30281,22,23,1,109.50597,18.27583,1514
34253,8F86A56802DD74BA7D5D01773E49D5A4,31471,16,18,2,109.34583,18.29563,917
34254,8F86A56802DD74BA7D5D01773E49D5A4,30201,19,23,4,109.4909,18.26465,1462
34270,B12433B5B11FA73A44C6D6FB9BE61089,31531,0,9,9,109.49583,18.25972,1461
34271,B12433B5B11FA73A44C6D6FB9BE61089,31181,10,17,7,109.50382,18.24813,1509
34272,B12433B5B11FA73A44C6D6FB9BE61089,60161,19,21,2,109.49174,18.26181,1461
34273,B12433B5B11FA73A44C6D6FB9BE61089,31531,22,23,1,109.49583,18.25972,1461
34277,ADAB51A6D99BADC8222FC392D72ADA01,60281,0,12,12,109.51743,18.25924,1561
34278,ADAB51A6D99BADC8222FC392D72ADA01,30251,12,13,1,109.50611,18.26653,1512
34279,ADAB51A6D99BADC8222FC392D72ADA01,60281,15,23,8,109.51743,18.25924,1561
34287,2F440A235E684ECEDD042B3100A4AE95,31071,0,7,7,109.58257,18.28458,1815
34288,2F440A235E684ECEDD042B3100A4AE95,30854,7,8,1,109.56889,18.27076,1763
34289,2F440A235E684ECEDD042B3100A4AE95,30101,9,12,3,109.57299,18.33333,1773
34290,2F440A235E684ECEDD042B3100A4AE95,30854,17,18,1,109.56889,18.27076,1763
34291,2F440A235E684ECEDD042B3100A4AE95,60331,20,22,2,109.505,18.26507,1512
34297,0547C7536E43628EF24935F0C2BF5E2C,60241,1,2,1,109.53319,18.28667,1616
34298,0547C7536E43628EF24935F0C2BF5E2C,30921,3,5,2,109.53903,18.29451,1667
34299,0547C7536E43628EF24935F0C2BF5E2C,31931,7,10,3,109.54771,18.29403,1667
34300,0547C7536E43628EF24935F0C2BF5E2C,30921,11,12,1,109.53903,18.29451,1667
34301,0547C7536E43628EF24935F0C2BF5E2C,60241,12,13,1,109.53319,18.28667,1616
34302,0547C7536E43628EF24935F0C2BF5E2C,31931,16,18,2,109.54771,18.29403,1667
34308,B64B26F4850FADD461899F7BC9C7F6FF,31181,0,11,11,109.50382,18.24813,1509
34309,B64B26F4850FADD461899F7BC9C7F6FF,38094,15,16,1,109.45403,18.28778,1316
34310,B64B26F4850FADD461899F7BC9C7F6FF,60441,17,19,2,109.46792,18.28604,1366
34311,B64B26F4850FADD461899F7BC9C7F6FF,30711,20,22,2,109.50271,18.25347,1510
34319,ACDEAAF45B65DE48CF80A48DBD3C775E,30854,0,20,20,109.56889,18.27076,1763
34320,ACDEAAF45B65DE48CF80A48DBD3C775E,31071,20,22,2,109.58257,18.28458,1815
34329,F7BA6D8C151E59668884F79A30525DF6,60411,12,13,1,109.32514,18.30854,869
34330,F7BA6D8C151E59668884F79A30525DF6,31471,13,16,3,109.34583,18.29563,917
34351,5EBEA276FCB4A19AC5C987F5C7CC8908,60504,0,5,5,109.47917,18.28903,1416
34352,5EBEA276FCB4A19AC5C987F5C7CC8908,38361,7,10,3,109.43667,18.29201,1267
34353,5EBEA276FCB4A19AC5C987F5C7CC8908,60401,11,12,1,109.47444,18.27583,1414
34354,5EBEA276FCB4A19AC5C987F5C7CC8908,60552,14,17,3,109.41729,18.30014,1218
34355,5EBEA276FCB4A19AC5C987F5C7CC8908,38361,17,18,1,109.43667,18.29201,1267
34396,DB4DF566D4757FF3BB488F82DE126248,31561,0,12,12,109.56792,18.28479,1765
34397,DB4DF566D4757FF3BB488F82DE126248,30851,16,19,3,109.5616,18.27396,1713
34430,B55959B64746A18ECF5077B5F7359221,31561,0,13,13,109.56792,18.28479,1765
34431,B55959B64746A18ECF5077B5F7359221,39183,14,15,1,109.55542,18.28208,1715
34432,B55959B64746A18ECF5077B5F7359221,31561,17,18,1,109.56792,18.28479,1765
34445,9A1BAE903EE169A024CCCFBC47CFC6CC,31701,18,19,1,109.44132,18.28833,1266
34446,9A1BAE903EE169A024CCCFBC47CFC6CC,60161,22,23,1,109.49174,18.26181,1461
34453,4BA143AD44480D9BEACA2836C34FF531,60231,4,5,1,109.49903,18.21972,1504
34454,4BA143AD44480D9BEACA2836C34FF531,39151,5,11,6,109.49875,18.25097,1510
34455,4BA143AD44480D9BEACA2836C34FF531,30211,12,17,5,109.49882,18.23931,1508
34456,4BA143AD44480D9BEACA2836C34FF531,30161,17,19,2,109.50042,18.24389,1508
34457,4BA143AD44480D9BEACA2836C34FF531,31411,21,22,1,109.5016,18.23576,1507
34470,C425D181738CCF9419F024C82994FF27,39181,7,10,3,109.55153,18.28035,1715
34471,C425D181738CCF9419F024C82994FF27,30854,10,12,2,109.56889,18.27076,1763
34478,1C86CB6916B0CD729122DB8E9BB7D66C,31781,15,16,1,109.19847,18.2975,367
34479,1C86CB6916B0CD729122DB8E9BB7D66C,30571,19,20,1,109.50243,18.21861,1504
34489,1A1509AC6E667B603EE3773D1273B7B0,38145,0,10,10,109.378,18.2912,1066
34490,1A1509AC6E667B603EE3773D1273B7B0,31811,12,13,1,109.54201,18.31806,1671
34497,01F0083CC81D0009F9AAB8F7CAA0C106,30771,1,10,9,109.49938,18.26042,1511
34498,01F0083CC81D0009F9AAB8F7CAA0C106,31071,12,18,6,109.58257,18.28458,1815
34499,01F0083CC81D0009F9AAB8F7CAA0C106,30854,18,19,1,109.56889,18.27076,1763
34504,257D40176640D23F8414BA4F22C51BD7,60211,13,15,2,109.63549,18.26049,2011
34531,06E9C92049CDEC98363A970C654C7779,31471,14,16,2,109.34583,18.29563,917
34532,06E9C92049CDEC98363A970C654C7779,60381,18,19,1,109.5241,18.22458,1605
34542,E0223036572082E83876AFB7D72B2DD2,30921,2,14,12,109.53903,18.29451,1667
34543,E0223036572082E83876AFB7D72B2DD2,31931,15,18,3,109.54771,18.29403,1667
34645,B7A2800FDF738E1064EAD2A5E58F7A3C,61011,1,13,12,109.60653,18.19076,1900
34675,4F877A4B395C9E22C3B85958392F2EAB,31181,0,1,1,109.50382,18.24813,1509
34676,4F877A4B395C9E22C3B85958392F2EAB,39151,4,5,1,109.49875,18.25097,1510
34677,4F877A4B395C9E22C3B85958392F2EAB,31181,6,9,3,109.50382,18.24813,1509
34678,4F877A4B395C9E22C3B85958392F2EAB,38297,11,15,4,109.52576,18.24965,1609
34679,4F877A4B395C9E22C3B85958392F2EAB,31261,17,19,2,109.51174,18.2466,1559
34680,4F877A4B395C9E22C3B85958392F2EAB,31181,20,23,3,109.50382,18.24813,1509
34690,0C8D15C0488D521680F0DE3A28CFE111,31811,2,3,1,109.54201,18.31806,1671
34691,0C8D15C0488D521680F0DE3A28CFE111,30701,4,16,12,109.59313,18.32007,1871
34692,0C8D15C0488D521680F0DE3A28CFE111,31811,18,20,2,109.54201,18.31806,1671
34693,0C8D15C0488D521680F0DE3A28CFE111,30701,20,23,3,109.59313,18.32007,1871
34702,CA3896FB33E9BC68E91955EDFF5D709B,31071,0,3,3,109.58257,18.28458,1815
34703,CA3896FB33E9BC68E91955EDFF5D709B,30854,3,5,2,109.56889,18.27076,1763
34704,CA3896FB33E9BC68E91955EDFF5D709B,31071,6,8,2,109.58257,18.28458,1815
34705,CA3896FB33E9BC68E91955EDFF5D709B,60631,11,13,2,109.57778,18.27583,1814
34706,CA3896FB33E9BC68E91955EDFF5D709B,31945,14,17,3,109.58021,18.29403,1817
34707,CA3896FB33E9BC68E91955EDFF5D709B,30854,18,21,3,109.56889,18.27076,1763
34710,EFD740F6F5021C6811A10021B4C14BD7,30361,2,3,1,109.50347,18.24,1508
34711,EFD740F6F5021C6811A10021B4C14BD7,38376,4,9,5,109.50924,18.24,1558
34712,EFD740F6F5021C6811A10021B4C14BD7,30511,11,13,2,109.51069,18.24208,1558
34713,EFD740F6F5021C6811A10021B4C14BD7,30361,14,16,2,109.50347,18.24,1508
34714,EFD740F6F5021C6811A10021B4C14BD7,30421,16,19,3,109.50021,18.25861,1511
34715,EFD740F6F5021C6811A10021B4C14BD7,30361,19,21,2,109.50347,18.24,1508
34719,64F4CDF664AA04E7B79DE93C57128CF6,31931,0,5,5,109.54771,18.29403,1667
34720,64F4CDF664AA04E7B79DE93C57128CF6,39183,8,10,2,109.55542,18.28208,1715
34721,64F4CDF664AA04E7B79DE93C57128CF6,39181,12,18,6,109.55153,18.28035,1715
34722,64F4CDF664AA04E7B79DE93C57128CF6,31931,20,21,1,109.54771,18.29403,1667
34732,45CCFCD3EBDF941E1C92B70ED06E8B5E,31561,1,4,3,109.56792,18.28479,1765
34733,45CCFCD3EBDF941E1C92B70ED06E8B5E,30854,5,6,1,109.56889,18.27076,1763
34734,45CCFCD3EBDF941E1C92B70ED06E8B5E,31945,9,10,1,109.58021,18.29403,1817
34735,45CCFCD3EBDF941E1C92B70ED06E8B5E,30854,12,23,11,109.56889,18.27076,1763
34736,D4FD7DF925A6D0B68D7C0C172D666450,38903,0,7,7,109.39229,18.29243,1117
34737,D4FD7DF925A6D0B68D7C0C172D666450,38141,8,9,1,109.39479,18.2916,1116
34738,D4FD7DF925A6D0B68D7C0C172D666450,31145,10,11,1,109.20431,18.30479,369
34739,D4FD7DF925A6D0B68D7C0C172D666450,31781,11,14,3,109.19847,18.2975,367
34740,D4FD7DF925A6D0B68D7C0C172D666450,38903,18,23,5,109.39229,18.29243,1117
34745,50B5C4E29EC349E4A9B5B91DC4E97A4E,60221,15,18,3,109.52569,18.29188,1616
34746,50B5C4E29EC349E4A9B5B91DC4E97A4E,60371,18,20,2,109.53063,18.30056,1618
34773,1C22636E4C8CF1C3C148EF1B7DDEF937,31521,0,10,10,109.51458,18.22542,1555
34774,1C22636E4C8CF1C3C148EF1B7DDEF937,31471,12,14,2,109.34583,18.29563,917
34775,1C22636E4C8CF1C3C148EF1B7DDEF937,30201,16,18,2,109.4909,18.26465,1462
34776,1C22636E4C8CF1C3C148EF1B7DDEF937,31521,20,23,3,109.51458,18.22542,1555
34786,56ACD6E124DDA410369E9C6960DD08BD,30211,13,17,4,109.49882,18.23931,1508
34787,56ACD6E124DDA410369E9C6960DD08BD,30421,18,19,1,109.50021,18.25861,1511
34788,56ACD6E124DDA410369E9C6960DD08BD,30361,19,23,4,109.50347,18.24,1508
34791,DE5024DB59D5BF6AE5857A85EB7680EA,31071,0,6,6,109.58257,18.28458,1815
34792,DE5024DB59D5BF6AE5857A85EB7680EA,30854,11,12,1,109.56889,18.27076,1763
34796,5ACB2494699EB2F10AA3427B417842C4,39151,12,14,2,109.49875,18.25097,1510
34800,CFF644097BADAEEAF540049CB3A91F42,39111,1,7,6,109.5191,18.22597,1555
34801,CFF644097BADAEEAF540049CB3A91F42,31031,8,10,2,109.49979,18.25382,1510
34802,CFF644097BADAEEAF540049CB3A91F42,38251,10,11,1,109.49618,18.25493,1510
34803,CFF644097BADAEEAF540049CB3A91F42,31031,11,14,3,109.49979,18.25382,1510
34804,CFF644097BADAEEAF540049CB3A91F42,60381,16,17,1,109.5241,18.22458,1605
34838,5A7A3D5F722F0EB2695C45BF16BBC483,38157,0,9,9,109.51483,18.26958,1563
34839,5A7A3D5F722F0EB2695C45BF16BBC483,31931,12,13,1,109.54771,18.29403,1667
34840,5A7A3D5F722F0EB2695C45BF16BBC483,38271,16,18,2,109.62632,18.23049,1956
34841,5A7A3D5F722F0EB2695C45BF16BBC483,38157,19,23,4,109.51483,18.26958,1563
34847,FE349C1918E7CEFC84B48BBCA0458F0F,31781,13,14,1,109.19847,18.2975,367
34848,FE349C1918E7CEFC84B48BBCA0458F0F,60551,18,20,2,109.42722,18.30111,1218
34858,233DD781A9D8F1A3DD2D1D775A2A623D,30921,16,17,1,109.53903,18.29451,1667
34859,233DD781A9D8F1A3DD2D1D775A2A623D,31931,20,22,2,109.54771,18.29403,1667
34897,F7D930F16EBD509B106614B00A4B3D8D,38706,0,17,17,109.74625,18.37097,2430
34898,F7D930F16EBD509B106614B00A4B3D8D,31206,20,22,2,109.50819,18.23549,1507
34966,B3A1AC27CB357708CE63D3E4F68BF2E7,30854,6,11,5,109.56889,18.27076,1763
34967,B3A1AC27CB357708CE63D3E4F68BF2E7,31071,11,13,2,109.58257,18.28458,1815
34968,B3A1AC27CB357708CE63D3E4F68BF2E7,30854,13,18,5,109.56889,18.27076,1763
34969,B3A1AC27CB357708CE63D3E4F68BF2E7,31071,21,23,2,109.58257,18.28458,1815
34991,149F44702DEC8C73589BE6524F0A1FFD,30854,1,13,12,109.56889,18.27076,1763
34992,149F44702DEC8C73589BE6524F0A1FFD,38085,17,23,6,109.6291,18.23625,2007
34996,6C9D7BB79A70B1E66DD550950EE935C8,30361,18,20,2,109.50347,18.24,1508
34997,6C9D7BB79A70B1E66DD550950EE935C8,31521,20,23,3,109.51458,18.22542,1555
35007,97354F7C2AB6F7E1E04DACCC44310118,38251,20,23,3,109.49618,18.25493,1510
35052,76B21384CC3EFE3F43353B93FDFE32EE,30821,0,7,7,109.43681,18.33639,1274
35053,76B21384CC3EFE3F43353B93FDFE32EE,39091,11,15,4,109.50097,18.25222,1510
35054,76B21384CC3EFE3F43353B93FDFE32EE,30821,18,23,5,109.43681,18.33639,1274
35099,4BCC49C68A0C1DD62F91467170BABC88,30854,17,19,2,109.56889,18.27076,1763
35100,4BCC49C68A0C1DD62F91467170BABC88,30731,19,22,3,109.50944,18.22306,1555
35121,7264945C05DFDC18D47872D9F94F6B4F,30441,14,18,4,109.64021,18.25424,2010
35122,7264945C05DFDC18D47872D9F94F6B4F,60321,19,23,4,109.63611,18.24306,2008
35181,5BB45F08F5C8E403A5AC561137D5477C,38094,0,12,12,109.45403,18.28778,1316
35182,5BB45F08F5C8E403A5AC561137D5477C,31701,12,14,2,109.44132,18.28833,1266
35183,5BB45F08F5C8E403A5AC561137D5477C,60231,16,17,1,109.49903,18.21972,1504
35184,5BB45F08F5C8E403A5AC561137D5477C,30361,18,20,2,109.50347,18.24,1508
35185,5BB45F08F5C8E403A5AC561137D5477C,38094,21,23,2,109.45403,18.28778,1316
35215,EFDE35289FEC1E13D6F34EFEE66A8AD2,60631,0,15,15,109.57778,18.27583,1814
35216,EFDE35289FEC1E13D6F34EFEE66A8AD2,30854,17,19,2,109.56889,18.27076,1763
35217,EFDE35289FEC1E13D6F34EFEE66A8AD2,31071,21,23,2,109.58257,18.28458,1815
35250,89E172ACE2708883A506C917200C7533,31231,0,8,8,109.42597,18.29292,1217
35252,89E172ACE2708883A506C917200C7533,31301,12,13,1,109.14493,18.31222,170
35253,89E172ACE2708883A506C917200C7533,31471,15,17,2,109.34583,18.29563,917
35254,89E172ACE2708883A506C917200C7533,60381,18,20,2,109.5241,18.22458,1605
35255,89E172ACE2708883A506C917200C7533,60552,21,22,1,109.41729,18.30014,1218
35256,8E1FB7AD92E84F40BA2A70D5520A3AD6,30731,0,7,7,109.50944,18.22306,1555
35257,8E1FB7AD92E84F40BA2A70D5520A3AD6,39091,11,13,2,109.50097,18.25222,1510
35258,8E1FB7AD92E84F40BA2A70D5520A3AD6,39321,13,22,9,109.529,18.2167,1604
35279,3977578BE56276DA0700B04B81DC1356,39181,8,9,1,109.55153,18.28035,1715
35280,3977578BE56276DA0700B04B81DC1356,30851,12,13,1,109.5616,18.27396,1713
35281,3977578BE56276DA0700B04B81DC1356,31561,15,17,2,109.56792,18.28479,1765
35305,77EBC7C5936E724AFF90D84A07AD90DB,30721,1,16,15,109.51597,18.28257,1565
35306,77EBC7C5936E724AFF90D84A07AD90DB,30201,19,20,1,109.4909,18.26465,1462
35307,77EBC7C5936E724AFF90D84A07AD90DB,39091,21,22,1,109.50097,18.25222,1510
35309,46E98DB18E03749C45352338127F9B4B,60411,15,16,1,109.32514,18.30854,869
35310,46E98DB18E03749C45352338127F9B4B,31471,18,20,2,109.34583,18.29563,917
35311,46E98DB18E03749C45352338127F9B4B,60411,21,23,2,109.32514,18.30854,869
35312,4A68C1945FCC1868E3DBF0CF909E5429,38541,0,10,10,109.73715,18.34875,2426
35338,919B6D6CA33899F0F2E7C2D48DA4283C,39321,18,23,5,109.529,18.2167,1604
35346,F3CCA2DC8A3A6438A9717D695C077F67,30731,1,8,7,109.50944,18.22306,1555
35348,F3CCA2DC8A3A6438A9717D695C077F67,60381,18,20,2,109.5241,18.22458,1605
35349,F3CCA2DC8A3A6438A9717D695C077F67,30731,21,23,2,109.50944,18.22306,1555
35387,5186E09F1AC986E196088F011D3C54E4,60121,11,12,1,109.74507,18.37472,2430
35388,5186E09F1AC986E196088F011D3C54E4,30511,13,15,2,109.51069,18.24208,1558
35389,5186E09F1AC986E196088F011D3C54E4,60261,16,23,7,109.44326,18.3075,1319
35414,AD608A919061B1C684914F8654FB2493,60161,12,13,1,109.49174,18.26181,1461
35415,AD608A919061B1C684914F8654FB2493,60084,13,15,2,109.4984,18.2334,1507
35416,AD608A919061B1C684914F8654FB2493,60161,18,19,1,109.49174,18.26181,1461
35418,4EF13302A4A6283D4450282828263850,60117,12,14,2,109.73604,18.35681,2427
35426,53D8AA1BA087F345732BEDDB7238341C,60361,0,8,8,109.51938,18.29681,1567
35427,53D8AA1BA087F345732BEDDB7238341C,60381,9,11,2,109.5241,18.22458,1605
35428,53D8AA1BA087F345732BEDDB7238341C,60361,13,15,2,109.51938,18.29681,1567
35429,53D8AA1BA087F345732BEDDB7238341C,30721,17,18,1,109.51597,18.28257,1565
35430,503D57F7BC7A1E0C94A1BA4749FB68C5,60221,1,8,7,109.52569,18.29188,1616
35431,503D57F7BC7A1E0C94A1BA4749FB68C5,31471,9,11,2,109.34583,18.29563,917
35432,503D57F7BC7A1E0C94A1BA4749FB68C5,38315,14,15,1,109.48979,18.29764,1467
35441,0133DDFFB5CECBB261CEDEF10A82D50B,30854,0,1,1,109.56889,18.27076,1763
35442,0133DDFFB5CECBB261CEDEF10A82D50B,31561,1,7,6,109.56792,18.28479,1765
35444,0133DDFFB5CECBB261CEDEF10A82D50B,30854,15,16,1,109.56889,18.27076,1763
35445,4094E4255C1DC92E37A62D94F33F035E,31781,13,14,1,109.19847,18.2975,367
35446,4094E4255C1DC92E37A62D94F33F035E,60054,15,16,1,109.3016,18.31229,770
35447,4094E4255C1DC92E37A62D94F33F035E,31531,20,23,3,109.49583,18.25972,1461
35451,24892DF473AC6ED4692FBD552CF21D37,60381,0,20,20,109.5241,18.22458,1605
35452,24892DF473AC6ED4692FBD552CF21D37,30711,21,23,2,109.50271,18.25347,1510
35453,44A75810FF8F9221047E9675BDBF60A2,31071,0,16,16,109.58257,18.28458,1815
35454,44A75810FF8F9221047E9675BDBF60A2,31561,18,23,5,109.56792,18.28479,1765
35470,B5111A17FE99EC54DAC2FDD550B4E7BA,30441,12,14,2,109.64021,18.25424,2010
35471,B5111A17FE99EC54DAC2FDD550B4E7BA,30171,17,19,2,109.48458,18.27139,1463
35472,B5111A17FE99EC54DAC2FDD550B4E7BA,60621,22,23,1,109.48354,18.27451,1464
35499,9FE9D15036A68E9BB0005F7A79F0480E,30721,13,15,2,109.51597,18.28257,1565
35500,9FE9D15036A68E9BB0005F7A79F0480E,60221,15,18,3,109.52569,18.29188,1616
35501,9FE9D15036A68E9BB0005F7A79F0480E,30721,18,19,1,109.51597,18.28257,1565
35547,65DB2325B6E1E7A0D88A5D2D920F9EA1,31431,0,7,7,109.44639,18.29042,1316
35548,65DB2325B6E1E7A0D88A5D2D920F9EA1,31304,9,12,3,109.15903,18.32854,223
35549,65DB2325B6E1E7A0D88A5D2D920F9EA1,31081,14,16,2,109.44639,18.30181,1318
35550,65DB2325B6E1E7A0D88A5D2D920F9EA1,30711,20,21,1,109.50271,18.25347,1510
35557,56C8C781972E8BFAF8A768A19AD7F590,38261,0,7,7,109.50361,18.28153,1515
35559,56C8C781972E8BFAF8A768A19AD7F590,30201,19,21,2,109.4909,18.26465,1462
35567,FBAECD693E6B86DD24561BB293296A49,60371,1,6,5,109.53063,18.30056,1618
35568,FBAECD693E6B86DD24561BB293296A49,38241,7,11,4,109.54111,18.30542,1669
35597,173CD7A2B7B334BC53A50A1D248FBCFE,31071,2,8,6,109.58257,18.28458,1815
35598,173CD7A2B7B334BC53A50A1D248FBCFE,30854,8,21,13,109.56889,18.27076,1763
35599,173CD7A2B7B334BC53A50A1D248FBCFE,31071,21,23,2,109.58257,18.28458,1815
35607,451E2BF48CD7B253EB0892324E679BCC,31461,4,5,1,109.5091,18.25389,1510
35608,451E2BF48CD7B253EB0892324E679BCC,60281,7,18,11,109.51743,18.25924,1561
35609,451E2BF48CD7B253EB0892324E679BCC,38291,19,22,3,109.51618,18.24313,1558
35610,451E2BF48CD7B253EB0892324E679BCC,38297,22,23,1,109.52576,18.24965,1609
35615,4DB778A581941E2A7955D8DA3B7ADAFE,31931,0,8,8,109.54771,18.29403,1667
35618,4DB778A581941E2A7955D8DA3B7ADAFE,31931,19,21,2,109.54771,18.29403,1667
35637,CAD1FFF41FBB07303E4F900E7ED6962A,30611,13,14,1,109.74958,18.40188,2485
35651,D64799F525F391CA7FC0CDD8417C04E0,39321,0,5,5,109.529,18.2167,1604
35652,D64799F525F391CA7FC0CDD8417C04E0,30731,9,11,2,109.50944,18.22306,1555
35653,D64799F525F391CA7FC0CDD8417C04E0,31781,13,14,1,109.19847,18.2975,367
35654,D64799F525F391CA7FC0CDD8417C04E0,60221,19,20,1,109.52569,18.29188,1616
35655,B0EA82CA44F2A5DBEC337F9E5C778FEC,39183,0,5,5,109.55542,18.28208,1715
35656,B0EA82CA44F2A5DBEC337F9E5C778FEC,39181,9,16,7,109.55153,18.28035,1715
35657,B0EA82CA44F2A5DBEC337F9E5C778FEC,39183,18,19,1,109.55542,18.28208,1715
35670,E9927B4E67F3A8CBF17FB017C70DF235,30721,0,19,19,109.51597,18.28257,1565
35671,E9927B4E67F3A8CBF17FB017C70DF235,60281,20,23,3,109.51743,18.25924,1561
35672,5EB9946C32427EC9667421AF45A45A41,38951,0,7,7,109.48097,18.28868,1416
35673,5EB9946C32427EC9667421AF45A45A41,38951,8,10,2,109.48097,18.28868,1416
35674,5EB9946C32427EC9667421AF45A45A41,38951,12,14,2,109.48097,18.28868,1416
35675,5EB9946C32427EC9667421AF45A45A41,38951,14,22,8,109.48097,18.28868,1416
35681,0AAC0DF5DA334AB291DB1D2333656F0A,38754,13,17,4,109.74667,18.37382,2430
35682,0AAC0DF5DA334AB291DB1D2333656F0A,30361,18,20,2,109.50347,18.24,1508
35694,78D44725626E719FF0C0FCBC8763A33E,60361,0,2,2,109.51938,18.29681,1567
35695,78D44725626E719FF0C0FCBC8763A33E,31951,2,4,2,109.52174,18.30299,1568
35696,78D44725626E719FF0C0FCBC8763A33E,31561,7,17,10,109.56792,18.28479,1765
35699,1BFA72EACB1A635128314056DAC7D19E,31723,0,6,6,109.68563,18.23701,2207
35700,1BFA72EACB1A635128314056DAC7D19E,30371,9,14,5,109.51,18.24771,1559
35701,1BFA72EACB1A635128314056DAC7D19E,31261,14,16,2,109.51174,18.2466,1559
35702,1BFA72EACB1A635128314056DAC7D19E,31723,18,23,5,109.68563,18.23701,2207
35714,E1079EEA1562514A818A5D1EA4D6596C,38754,15,16,1,109.74667,18.37382,2430
35715,0E5593A90D661690BE3DAAA17AD936E2,30281,1,9,8,109.50597,18.27583,1514
35716,0E5593A90D661690BE3DAAA17AD936E2,31091,10,11,1,109.41201,18.31222,1170
35717,0E5593A90D661690BE3DAAA17AD936E2,38127,12,21,9,109.50833,18.27222,1513
35732,07FD145FE6C81328C98C6C5C8452E794,30854,2,4,2,109.56889,18.27076,1763
35733,07FD145FE6C81328C98C6C5C8452E794,30232,4,17,13,109.6191,18.31701,1971
35734,07FD145FE6C81328C98C6C5C8452E794,30854,21,23,2,109.56889,18.27076,1763
35747,47844E829FCB05D6E87386BF9A1380C3,31701,12,14,2,109.44132,18.28833,1266
35748,47844E829FCB05D6E87386BF9A1380C3,31701,18,20,2,109.44132,18.28833,1266
35749,47844E829FCB05D6E87386BF9A1380C3,30271,20,21,1,109.49132,18.23153,1456
35760,2071FF1D9C1E71B294973F5BC85A9FC1,31101,12,14,2,109.65389,18.23403,2057
35761,2071FF1D9C1E71B294973F5BC85A9FC1,30361,19,23,4,109.50347,18.24,1508
35781,2C3BD53A8702A47FB82F05FB4993B683,31561,0,6,6,109.56792,18.28479,1765
35782,2C3BD53A8702A47FB82F05FB4993B683,39183,6,9,3,109.55542,18.28208,1715
35783,2C3BD53A8702A47FB82F05FB4993B683,31561,10,12,2,109.56792,18.28479,1765
35784,2C3BD53A8702A47FB82F05FB4993B683,31031,16,18,2,109.49979,18.25382,1510
35785,2C3BD53A8702A47FB82F05FB4993B683,31561,20,23,3,109.56792,18.28479,1765
35807,18794851E86EA8BA29FCF821CF1F07C3,39111,0,1,1,109.5191,18.22597,1555
35808,18794851E86EA8BA29FCF821CF1F07C3,31071,3,7,4,109.58257,18.28458,1815
35809,18794851E86EA8BA29FCF821CF1F07C3,30854,7,17,10,109.56889,18.27076,1763
35810,18794851E86EA8BA29FCF821CF1F07C3,31421,18,20,2,109.55382,18.22347,1705
35811,18794851E86EA8BA29FCF821CF1F07C3,31071,22,23,1,109.58257,18.28458,1815
35823,F5FA9E3AD48A61D07594249E558C93A1,60331,0,7,7,109.505,18.26507,1512
35824,F5FA9E3AD48A61D07594249E558C93A1,31031,9,10,1,109.49979,18.25382,1510
35825,F5FA9E3AD48A61D07594249E558C93A1,31101,12,18,6,109.65389,18.23403,2057
35826,F5FA9E3AD48A61D07594249E558C93A1,31231,22,23,1,109.42597,18.29292,1217
35837,28116E081E8AAFD89F4929BB4937EC6F,38127,15,17,2,109.50833,18.27222,1513
35838,28116E081E8AAFD89F4929BB4937EC6F,31041,18,20,2,109.50278,18.23701,1507
35839,28116E081E8AAFD89F4929BB4937EC6F,38127,21,23,2,109.50833,18.27222,1513
35869,860D8FD1FD466E2189F245D42B766A0C,30271,0,8,8,109.49132,18.23153,1456
35870,860D8FD1FD466E2189F245D42B766A0C,60211,11,16,5,109.63549,18.26049,2011
35871,860D8FD1FD466E2189F245D42B766A0C,31761,17,18,1,109.60521,18.27965,1914
35872,860D8FD1FD466E2189F245D42B766A0C,31031,18,20,2,109.49979,18.25382,1510
35882,6449449F1B7E787D614284B9622B1531,38951,0,2,2,109.48097,18.28868,1416
35883,6449449F1B7E787D614284B9622B1531,38951,3,6,3,109.48097,18.28868,1416
35884,6449449F1B7E787D614284B9622B1531,38951,7,8,1,109.48097,18.28868,1416
35885,6449449F1B7E787D614284B9622B1531,30661,13,14,1,109.37028,18.24361,1008
35886,6449449F1B7E787D614284B9622B1531,38951,17,20,3,109.48097,18.28868,1416
35887,6449449F1B7E787D614284B9622B1531,39151,21,22,1,109.49875,18.25097,1510
35888,6449449F1B7E787D614284B9622B1531,38951,22,23,1,109.48097,18.28868,1416
35893,63106A356FA62C4782D11D6E10075301,30421,11,12,1,109.50021,18.25861,1511
35896,283001ED673D8EDBEF7EEB00BDB31533,30571,0,6,6,109.50243,18.21861,1504
35897,283001ED673D8EDBEF7EEB00BDB31533,31181,7,18,11,109.50382,18.24813,1509
35898,283001ED673D8EDBEF7EEB00BDB31533,30571,21,23,2,109.50243,18.21861,1504
35916,42923D86FCA39B981325B127230BF145,60117,16,17,1,109.73604,18.35681,2427
35917,42923D86FCA39B981325B127230BF145,30101,19,22,3,109.57299,18.33333,1773
35946,D778D7F80641F53D92BA8D70258C8DBD,30771,11,12,1,109.49938,18.26042,1511
35947,D778D7F80641F53D92BA8D70258C8DBD,30941,14,18,4,109.5559,18.33938,1724
35948,0E1B3CFC64EBB658DA96D0DCA834701E,61011,0,4,4,109.60653,18.19076,1900
35950,0E1B3CFC64EBB658DA96D0DCA834701E,61011,6,12,6,109.60653,18.19076,1900
35952,0E1B3CFC64EBB658DA96D0DCA834701E,61011,18,23,5,109.60653,18.19076,1900
35958,0F192EC3C2BBBBE0C5456A1D0C57D78A,39321,0,12,12,109.529,18.2167,1604
35959,0F192EC3C2BBBBE0C5456A1D0C57D78A,31561,16,17,1,109.56792,18.28479,1765
35960,0F192EC3C2BBBBE0C5456A1D0C57D78A,60661,18,19,1,109.548,18.2377,1657
35961,0F192EC3C2BBBBE0C5456A1D0C57D78A,39321,21,23,2,109.529,18.2167,1604
36002,202870BA524F8D7E9C1B66336BF1F034,31951,0,5,5,109.52174,18.30299,1568
36003,202870BA524F8D7E9C1B66336BF1F034,60631,7,16,9,109.57778,18.27583,1814
36004,202870BA524F8D7E9C1B66336BF1F034,30854,16,18,2,109.56889,18.27076,1763
36005,202870BA524F8D7E9C1B66336BF1F034,30071,20,22,2,109.52819,18.30472,1619
36010,6B24823797A23CF47C34C631323C3D8C,31031,0,6,6,109.49979,18.25382,1510
36011,6B24823797A23CF47C34C631323C3D8C,30571,10,12,2,109.50243,18.21861,1504
36057,F5C34768E0DD06615D7F1F7BD0ADA2BD,31471,14,17,3,109.34583,18.29563,917
36058,F5C34768E0DD06615D7F1F7BD0ADA2BD,39111,19,20,1,109.5191,18.22597,1555
36069,D6B54C643B88B86782DC30A38AD291FD,31561,3,6,3,109.56792,18.28479,1765
36070,D6B54C643B88B86782DC30A38AD291FD,30854,9,10,1,109.56889,18.27076,1763
36071,D6B54C643B88B86782DC30A38AD291FD,31561,12,13,1,109.56792,18.28479,1765
36072,D6B54C643B88B86782DC30A38AD291FD,60504,15,18,3,109.47917,18.28903,1416
36073,50C497E938D256053EDA53A1DE0E2147,31931,0,10,10,109.54771,18.29403,1667
36074,50C497E938D256053EDA53A1DE0E2147,31304,13,15,2,109.15903,18.32854,223
36075,50C497E938D256053EDA53A1DE0E2147,31931,16,23,7,109.54771,18.29403,1667
36095,1FE2866848043A2C10AD87212485FE15,31205,1,2,1,109.51111,18.23736,1557
36096,1FE2866848043A2C10AD87212485FE15,31071,4,11,7,109.58257,18.28458,1815
36097,1FE2866848043A2C10AD87212485FE15,30854,11,15,4,109.56889,18.27076,1763
36098,1FE2866848043A2C10AD87212485FE15,31945,16,17,1,109.58021,18.29403,1817
36099,1FE2866848043A2C10AD87212485FE15,30854,17,20,3,109.56889,18.27076,1763
36100,1FE2866848043A2C10AD87212485FE15,31071,22,23,1,109.58257,18.28458,1815
36104,34AB502A442AA8EA4A7FB30471B204DB,60621,3,7,4,109.48354,18.27451,1464
36105,34AB502A442AA8EA4A7FB30471B204DB,31431,8,9,1,109.44639,18.29042,1316
36106,34AB502A442AA8EA4A7FB30471B204DB,38325,11,13,2,109.39792,18.2909,1116
36107,34AB502A442AA8EA4A7FB30471B204DB,30341,14,15,1,109.3625,18.29167,966
36108,34AB502A442AA8EA4A7FB30471B204DB,38251,15,17,2,109.49618,18.25493,1510
36163,1106C42D626632E595B23A5D1A538F7F,30171,0,6,6,109.48458,18.27139,1463
36164,1106C42D626632E595B23A5D1A538F7F,31145,10,12,2,109.20431,18.30479,369
36165,1106C42D626632E595B23A5D1A538F7F,30171,15,19,4,109.48458,18.27139,1463
36166,1106C42D626632E595B23A5D1A538F7F,30171,19,23,4,109.48458,18.27139,1463
36188,18BDE11B8B881AB9918111A51A22299D,60054,0,8,8,109.3016,18.31229,770
36189,18BDE11B8B881AB9918111A51A22299D,30661,8,11,3,109.37028,18.24361,1008
36190,18BDE11B8B881AB9918111A51A22299D,60054,11,15,4,109.3016,18.31229,770
36191,18BDE11B8B881AB9918111A51A22299D,30661,15,17,2,109.37028,18.24361,1008
36192,18BDE11B8B881AB9918111A51A22299D,60054,17,23,6,109.3016,18.31229,770
36222,CD576F1C1CDFB89E6A99A20E65927346,30854,0,1,1,109.56889,18.27076,1763
36223,CD576F1C1CDFB89E6A99A20E65927346,31071,4,6,2,109.58257,18.28458,1815
36224,CD576F1C1CDFB89E6A99A20E65927346,30854,7,20,13,109.56889,18.27076,1763
36228,A1BC0987A3E1C2D1FC67C0DAF118596D,31521,16,17,1,109.51458,18.22542,1555
36229,A1BC0987A3E1C2D1FC67C0DAF118596D,60381,17,19,2,109.5241,18.22458,1605
36230,A1BC0987A3E1C2D1FC67C0DAF118596D,31521,20,23,3,109.51458,18.22542,1555
36254,E9DC5E3F06A9FBF162477C6043E75224,39181,8,11,3,109.55153,18.28035,1715
36255,E9DC5E3F06A9FBF162477C6043E75224,39181,12,13,1,109.55153,18.28035,1715
36256,0695D4E7B3E726CA09D841B87798B560,31561,0,1,1,109.56792,18.28479,1765
36257,0695D4E7B3E726CA09D841B87798B560,30854,1,2,1,109.56889,18.27076,1763
36258,0695D4E7B3E726CA09D841B87798B560,31071,4,5,1,109.58257,18.28458,1815
36264,791234E587E0C86D41967E57B8EBA1DD,30791,21,23,2,109.72333,18.40889,2386
36279,DC2D9D389C76C3C3F81B17488EA05107,60114,19,20,1,109.73028,18.33847,2374
36280,DC2D9D389C76C3C3F81B17488EA05107,60071,22,23,1,109.75674,18.31583,2470
36294,2B3D1202B9CAAA0F3B6C3510362F28D1,38251,18,20,2,109.49618,18.25493,1510
36295,2B3D1202B9CAAA0F3B6C3510362F28D1,31021,22,23,1,109.49021,18.27,1463
36296,63FBAC0202144B00077561285E6A7F87,30651,2,4,2,109.42611,18.385,1232
36297,63FBAC0202144B00077561285E6A7F87,30821,4,23,19,109.43681,18.33639,1274
36298,CA886EB7268A5A35237559872C8687FC,30861,0,11,11,109.52722,18.22743,1606
36299,CA886EB7268A5A35237559872C8687FC,38325,11,13,2,109.39792,18.2909,1116
36300,CA886EB7268A5A35237559872C8687FC,30661,14,15,1,109.37028,18.24361,1008
36347,225EDE82328108AFB3E7EE610CA3F074,31931,0,9,9,109.54771,18.29403,1667
36348,225EDE82328108AFB3E7EE610CA3F074,60371,10,11,1,109.53063,18.30056,1618
36349,225EDE82328108AFB3E7EE610CA3F074,31931,13,23,10,109.54771,18.29403,1667
36376,900E2AA536A0FD530A3DA5C409DA4E53,30351,0,1,1,109.41701,18.29292,1217
36377,900E2AA536A0FD530A3DA5C409DA4E53,30821,2,6,4,109.43681,18.33639,1274
36378,900E2AA536A0FD530A3DA5C409DA4E53,30351,7,9,2,109.41701,18.29292,1217
36379,900E2AA536A0FD530A3DA5C409DA4E53,31031,13,14,1,109.49979,18.25382,1510
36385,904A4DAC7D8AB1F23EC8AAB1DFE3672F,39111,0,9,9,109.5191,18.22597,1555
36386,904A4DAC7D8AB1F23EC8AAB1DFE3672F,31521,10,23,13,109.51458,18.22542,1555
36415,5533066D8871087CCD481B88DD73EF7D,31361,0,6,6,109.47417,18.28292,1415
36416,5533066D8871087CCD481B88DD73EF7D,60441,8,9,1,109.46792,18.28604,1366
36417,5533066D8871087CCD481B88DD73EF7D,60401,9,11,2,109.47444,18.27583,1414
36418,5533066D8871087CCD481B88DD73EF7D,31361,13,17,4,109.47417,18.28292,1415
36419,5533066D8871087CCD481B88DD73EF7D,60401,18,19,1,109.47444,18.27583,1414
36420,5533066D8871087CCD481B88DD73EF7D,31361,19,23,4,109.47417,18.28292,1415
36456,33D0BAF81064BA9871C044941C4D0C71,60401,2,3,1,109.47444,18.27583,1414
36457,33D0BAF81064BA9871C044941C4D0C71,31231,5,7,2,109.42597,18.29292,1217
36458,33D0BAF81064BA9871C044941C4D0C71,31531,10,15,5,109.49583,18.25972,1461
36459,33D0BAF81064BA9871C044941C4D0C71,31031,15,17,2,109.49979,18.25382,1510
36460,33D0BAF81064BA9871C044941C4D0C71,30421,17,19,2,109.50021,18.25861,1511
36461,33D0BAF81064BA9871C044941C4D0C71,60291,20,21,1,109.50826,18.24639,1509
36483,1593E13193A160EF9BE2323C5CE79FFF,30084,18,19,1,109.50118,18.26972,1513
36484,1593E13193A160EF9BE2323C5CE79FFF,31031,21,22,1,109.49979,18.25382,1510
36512,CB25D65CBFC783CF101DCA33ED449F1A,31071,0,14,14,109.58257,18.28458,1815
36513,CB25D65CBFC783CF101DCA33ED449F1A,30201,19,21,2,109.4909,18.26465,1462
36519,B78E7295CB13532B4E2C30EF158E297F,30854,2,6,4,109.56889,18.27076,1763
36520,B78E7295CB13532B4E2C30EF158E297F,31931,7,9,2,109.54771,18.29403,1667
36521,B78E7295CB13532B4E2C30EF158E297F,39183,10,11,1,109.55542,18.28208,1715
36537,AA2A5396AD753E9245AC53C94BAEDECD,61011,0,2,2,109.60653,18.19076,1900
36546,F47C4E1E39056C43B0AD32AC994AB7C0,31931,1,16,15,109.54771,18.29403,1667
36547,F47C4E1E39056C43B0AD32AC994AB7C0,60361,16,19,3,109.51938,18.29681,1567
36548,F47C4E1E39056C43B0AD32AC994AB7C0,31931,22,23,1,109.54771,18.29403,1667
36557,276E28EA74B0ACD204AF25ED59E826DF,38251,19,21,2,109.49618,18.25493,1510
36620,AE748D8ECC22123141A5E3C651126BDA,60291,0,8,8,109.50826,18.24639,1509
36621,AE748D8ECC22123141A5E3C651126BDA,31471,12,13,1,109.34583,18.29563,917
36625,999DEB7BFC175BF03EAE5DB1D4B2EFB6,60361,0,7,7,109.51938,18.29681,1567
36627,999DEB7BFC175BF03EAE5DB1D4B2EFB6,60121,20,21,1,109.74507,18.37472,2430
36649,18073AD9E71B8DFC1E520C5E3653B1BD,38881,0,8,8,109.51618,18.26431,1562
36650,18073AD9E71B8DFC1E520C5E3653B1BD,31951,12,16,4,109.52174,18.30299,1568
36651,18073AD9E71B8DFC1E520C5E3653B1BD,30781,19,20,1,109.3275,18.37847,881
36652,18073AD9E71B8DFC1E520C5E3653B1BD,31291,21,23,2,109.30375,18.40729,786
36662,14F4ACAD1B4C4B8CE52F7EFB2E582792,60441,17,18,1,109.46792,18.28604,1366
36663,14F4ACAD1B4C4B8CE52F7EFB2E582792,31031,22,23,1,109.49979,18.25382,1510
36665,5500319C4CC4B6D41BA9A9B3B3348D32,31031,12,14,2,109.49979,18.25382,1510
36666,5500319C4CC4B6D41BA9A9B3B3348D32,30771,14,16,2,109.49938,18.26042,1511
36689,31BAA46A2F25AC63D78E0ACA44BF0FE9,39181,0,9,9,109.55153,18.28035,1715
36690,31BAA46A2F25AC63D78E0ACA44BF0FE9,31931,14,15,1,109.54771,18.29403,1667
36691,31BAA46A2F25AC63D78E0ACA44BF0FE9,39181,19,23,4,109.55153,18.28035,1715
36700,876477FD9DD46FF97674E612DA6296D8,60161,0,2,2,109.49174,18.26181,1461
36701,876477FD9DD46FF97674E612DA6296D8,31231,4,7,3,109.42597,18.29292,1217
36702,876477FD9DD46FF97674E612DA6296D8,31531,10,16,6,109.49583,18.25972,1461
36703,876477FD9DD46FF97674E612DA6296D8,30211,17,19,2,109.49882,18.23931,1508
36704,876477FD9DD46FF97674E612DA6296D8,31531,20,23,3,109.49583,18.25972,1461
36721,4335E93DC4F6D2DE747AE4BA0FAD49A5,30861,0,6,6,109.52722,18.22743,1606
36722,4335E93DC4F6D2DE747AE4BA0FAD49A5,60552,9,10,1,109.41729,18.30014,1218
36723,4335E93DC4F6D2DE747AE4BA0FAD49A5,31781,12,13,1,109.19847,18.2975,367
36724,4335E93DC4F6D2DE747AE4BA0FAD49A5,31471,15,16,1,109.34583,18.29563,917
36725,4335E93DC4F6D2DE747AE4BA0FAD49A5,30861,20,23,3,109.52722,18.22743,1606
36737,6A0E249716CDD801F644B3A9F150D4A1,38261,12,14,2,109.50361,18.28153,1515
36795,520E021BAEA9C2E9A1EEC02BE29D26C4,38754,14,16,2,109.74667,18.37382,2430
36797,807332CEC38772FA8DF98C48FBD8DD1E,39183,16,17,1,109.55542,18.28208,1715
36798,807332CEC38772FA8DF98C48FBD8DD1E,31561,20,22,2,109.56792,18.28479,1765
36805,05465E4C43A13393BD3ACA2D09C543FF,38111,17,20,3,109.52007,18.22403,1555
36806,05465E4C43A13393BD3ACA2D09C543FF,31521,21,22,1,109.51458,18.22542,1555
36861,E4B522EF4348156010E5C578EC13D60F,31071,4,6,2,109.58257,18.28458,1815
36862,E4B522EF4348156010E5C578EC13D60F,30854,9,17,8,109.56889,18.27076,1763
36863,E4B522EF4348156010E5C578EC13D60F,60211,18,20,2,109.63549,18.26049,2011
36864,E4B522EF4348156010E5C578EC13D60F,30191,21,23,2,109.50361,18.22701,1506
36865,0EB02C47C78555CF4AFEAD0B55845762,31431,2,9,7,109.44639,18.29042,1316
36866,0EB02C47C78555CF4AFEAD0B55845762,38391,10,11,1,109.44111,18.29083,1266
36872,7168F7EAD82B76A2A520C85DAB769D72,31561,1,5,4,109.56792,18.28479,1765
36873,7168F7EAD82B76A2A520C85DAB769D72,39183,9,19,10,109.55542,18.28208,1715
36874,C5B2C146A715B405C4C002F4F3423FFB,39091,8,10,2,109.50097,18.25222,1510
36875,C5B2C146A715B405C4C002F4F3423FFB,31391,10,14,4,109.50382,18.24285,1508
36876,C5B2C146A715B405C4C002F4F3423FFB,39091,15,16,1,109.50097,18.25222,1510
36880,560794A44CA17A43FA34D0FA6C339747,30854,1,7,6,109.56889,18.27076,1763
36881,560794A44CA17A43FA34D0FA6C339747,60361,12,15,3,109.51938,18.29681,1567
36882,560794A44CA17A43FA34D0FA6C339747,30854,18,23,5,109.56889,18.27076,1763
36883,A02174AC24A0C1CA04FD26E43D25EE05,60071,0,5,5,109.75674,18.31583,2470
36884,A02174AC24A0C1CA04FD26E43D25EE05,30851,7,9,2,109.5616,18.27396,1713
36885,A02174AC24A0C1CA04FD26E43D25EE05,30854,9,12,3,109.56889,18.27076,1763
36958,5E6BED6B24013599647F8A86A362B027,30671,0,6,6,109.43611,18.30139,1268
36959,5E6BED6B24013599647F8A86A362B027,30281,10,11,1,109.50597,18.27583,1514
36960,5E6BED6B24013599647F8A86A362B027,38261,13,14,1,109.50361,18.28153,1515
36985,608A55C14BAB2A5B627ACC1F39B89FB6,31945,0,7,7,109.58021,18.29403,1817
36986,608A55C14BAB2A5B627ACC1F39B89FB6,30854,7,9,2,109.56889,18.27076,1763
36987,608A55C14BAB2A5B627ACC1F39B89FB6,31071,10,12,2,109.58257,18.28458,1815
36988,608A55C14BAB2A5B627ACC1F39B89FB6,31945,12,13,1,109.58021,18.29403,1817
36989,608A55C14BAB2A5B627ACC1F39B89FB6,30854,16,18,2,109.56889,18.27076,1763
36990,608A55C14BAB2A5B627ACC1F39B89FB6,31945,21,23,2,109.58021,18.29403,1817
37019,85586D73EA48B4F4D520D899B0BE0554,30291,0,5,5,109.50403,18.27028,1513
37020,85586D73EA48B4F4D520D899B0BE0554,31071,6,14,8,109.58257,18.28458,1815
37021,85586D73EA48B4F4D520D899B0BE0554,30854,16,17,1,109.56889,18.27076,1763
37022,85586D73EA48B4F4D520D899B0BE0554,31071,18,19,1,109.58257,18.28458,1815
37023,85586D73EA48B4F4D520D899B0BE0554,30291,19,23,4,109.50403,18.27028,1513
37033,10EBF762D28520B09848288F7052CFDE,30854,2,5,3,109.56889,18.27076,1763
37034,10EBF762D28520B09848288F7052CFDE,31181,7,12,5,109.50382,18.24813,1509
37035,10EBF762D28520B09848288F7052CFDE,39101,14,18,4,109.50132,18.24931,1509
37036,10EBF762D28520B09848288F7052CFDE,31561,20,21,1,109.56792,18.28479,1765
37037,10EBF762D28520B09848288F7052CFDE,30854,21,23,2,109.56889,18.27076,1763
37065,EF189AF224755104A3EF0837AE0BC2BB,60281,0,9,9,109.51743,18.25924,1561
37067,EF189AF224755104A3EF0837AE0BC2BB,60281,20,23,3,109.51743,18.25924,1561
37103,506F62361FE26A5D1F7362001D98620C,38111,0,7,7,109.52007,18.22403,1555
37104,506F62361FE26A5D1F7362001D98620C,39321,7,8,1,109.529,18.2167,1604
37105,506F62361FE26A5D1F7362001D98620C,38111,9,10,1,109.52007,18.22403,1555
37106,506F62361FE26A5D1F7362001D98620C,38754,11,14,3,109.74667,18.37382,2430
37107,506F62361FE26A5D1F7362001D98620C,31521,17,19,2,109.51458,18.22542,1555
37108,506F62361FE26A5D1F7362001D98620C,38111,19,23,4,109.52007,18.22403,1555
37116,3C162B8B833533A8C79FA08500420144,30711,15,18,3,109.50271,18.25347,1510
37117,3C162B8B833533A8C79FA08500420144,31271,18,19,1,109.48958,18.26257,1462
37118,3C162B8B833533A8C79FA08500420144,60571,20,21,1,109.50722,18.25056,1510
37119,3C162B8B833533A8C79FA08500420144,38826,22,23,1,109.50326,18.25514,1510
37134,AAB3DCB18BAF89954DC0C8A658A6D766,31031,1,2,1,109.49979,18.25382,1510
37135,AAB3DCB18BAF89954DC0C8A658A6D766,38251,2,5,3,109.49618,18.25493,1510
37136,AAB3DCB18BAF89954DC0C8A658A6D766,60231,5,6,1,109.49903,18.21972,1504
37137,AAB3DCB18BAF89954DC0C8A658A6D766,30051,7,9,2,109.48917,18.21215,1453
37138,AAB3DCB18BAF89954DC0C8A658A6D766,60231,9,18,9,109.49903,18.21972,1504
37139,AAB3DCB18BAF89954DC0C8A658A6D766,31031,19,22,3,109.49979,18.25382,1510
37188,065F1687C35F3C827A2EA4A378A0E2C6,30851,8,10,2,109.5616,18.27396,1713
37189,065F1687C35F3C827A2EA4A378A0E2C6,60091,13,14,1,109.59729,18.30431,1869
37190,065F1687C35F3C827A2EA4A378A0E2C6,30851,17,21,4,109.5616,18.27396,1713
37205,3066D3BA0EF6F55E10FAD924A6ADDDEF,30711,0,2,2,109.50271,18.25347,1510
37206,3066D3BA0EF6F55E10FAD924A6ADDDEF,30381,2,23,21,109.52521,18.24507,1609
37226,13166628932DF36C0AD7B1DB5811240A,60591,0,6,6,109.61118,18.21715,1904
37227,13166628932DF36C0AD7B1DB5811240A,30854,6,15,9,109.56889,18.27076,1763
37228,13166628932DF36C0AD7B1DB5811240A,60591,19,23,4,109.61118,18.21715,1904
37232,1E8430723C686C1702DF9BA656941DD0,38951,0,6,6,109.48097,18.28868,1416
37233,1E8430723C686C1702DF9BA656941DD0,31345,7,9,2,109.39,18.29,1066
37234,1E8430723C686C1702DF9BA656941DD0,31231,9,11,2,109.42597,18.29292,1217
37235,1E8430723C686C1702DF9BA656941DD0,38105,12,13,1,109.40299,18.29229,1117
37236,1E8430723C686C1702DF9BA656941DD0,38094,14,16,2,109.45403,18.28778,1316
37237,1E8430723C686C1702DF9BA656941DD0,38951,18,22,4,109.48097,18.28868,1416
37277,E605B26D53F08A0D3360A4541E09F4E2,30721,0,7,7,109.51597,18.28257,1565
37278,E605B26D53F08A0D3360A4541E09F4E2,31145,11,13,2,109.20431,18.30479,369
37279,E605B26D53F08A0D3360A4541E09F4E2,38283,14,23,9,109.62229,18.22618,1956
37301,5DC8F62831D42C28A31B401E39C2405E,30171,0,8,8,109.48458,18.27139,1463
37302,5DC8F62831D42C28A31B401E39C2405E,38881,10,12,2,109.51618,18.26431,1562
37303,5DC8F62831D42C28A31B401E39C2405E,30171,13,16,3,109.48458,18.27139,1463
37304,5DC8F62831D42C28A31B401E39C2405E,39151,18,21,3,109.49875,18.25097,1510
37316,F3743A0150B752AC5079D26C89C3915F,60614,0,2,2,109.48799,18.29521,1467
37317,F3743A0150B752AC5079D26C89C3915F,38951,2,5,3,109.48097,18.28868,1416
37318,F3743A0150B752AC5079D26C89C3915F,60614,6,7,1,109.48799,18.29521,1467
37319,F3743A0150B752AC5079D26C89C3915F,38951,10,11,1,109.48097,18.28868,1416
37320,F3743A0150B752AC5079D26C89C3915F,30741,13,14,1,109.49833,18.28681,1516
37321,F3743A0150B752AC5079D26C89C3915F,30971,14,17,3,109.48708,18.29319,1467
37322,F3743A0150B752AC5079D26C89C3915F,38951,19,20,1,109.48097,18.28868,1416
37323,F3743A0150B752AC5079D26C89C3915F,60614,20,21,1,109.48799,18.29521,1467
37338,7E826D5B1F16716D0276910DC964328A,60594,1,10,9,109.62694,18.22799,1956
37339,7E826D5B1F16716D0276910DC964328A,38052,11,12,1,109.62618,18.23042,1956
37340,7E826D5B1F16716D0276910DC964328A,33481,13,14,1,109.67278,18.41278,2187
37341,7E826D5B1F16716D0276910DC964328A,33101,15,16,1,109.68438,18.44368,2242
37342,7E826D5B1F16716D0276910DC964328A,38052,19,22,3,109.62618,18.23042,1956
37412,C48911F2501F3C5309DA39E0641B7D38,31071,15,16,1,109.58257,18.28458,1815
37413,C48911F2501F3C5309DA39E0641B7D38,30854,18,22,4,109.56889,18.27076,1763
37431,96994AD87756271E307B81F41E5136D2,60501,12,13,1,109.48701,18.29021,1466
37432,96994AD87756271E307B81F41E5136D2,60441,14,15,1,109.46792,18.28604,1366
37433,96994AD87756271E307B81F41E5136D2,30854,16,19,3,109.56889,18.27076,1763
37437,0F558B6653C655C7F0BAEA9D66B33F57,31761,2,4,2,109.60521,18.27965,1914
37438,0F558B6653C655C7F0BAEA9D66B33F57,31071,4,7,3,109.58257,18.28458,1815
37439,0F558B6653C655C7F0BAEA9D66B33F57,30854,10,22,12,109.56889,18.27076,1763
37457,08EDC1BDFD8ECE46CA15A186317FA7B7,31521,0,11,11,109.51458,18.22542,1555
37458,08EDC1BDFD8ECE46CA15A186317FA7B7,60054,15,16,1,109.3016,18.31229,770
37459,08EDC1BDFD8ECE46CA15A186317FA7B7,30361,17,20,3,109.50347,18.24,1508
37460,08EDC1BDFD8ECE46CA15A186317FA7B7,31521,21,23,2,109.51458,18.22542,1555
37483,7421066246AAD1C230E7E2A7ADF06E9D,60631,0,5,5,109.57778,18.27583,1814
37484,7421066246AAD1C230E7E2A7ADF06E9D,30854,7,8,1,109.56889,18.27076,1763
37485,7421066246AAD1C230E7E2A7ADF06E9D,31071,8,11,3,109.58257,18.28458,1815
37486,7421066246AAD1C230E7E2A7ADF06E9D,60631,12,13,1,109.57778,18.27583,1814
37487,7421066246AAD1C230E7E2A7ADF06E9D,30854,13,19,6,109.56889,18.27076,1763
37488,7421066246AAD1C230E7E2A7ADF06E9D,60631,22,23,1,109.57778,18.27583,1814
37490,6BCFCC220636F506D1865F02E5E7FDE8,60084,20,21,1,109.4984,18.2334,1507
37491,6BCFCC220636F506D1865F02E5E7FDE8,31761,22,23,1,109.60521,18.27965,1914
37492,A4823EEC9A8E697E80697432C029B488,30391,11,13,2,109.4975,18.27118,1513
37493,A4823EEC9A8E697E80697432C029B488,30771,13,15,2,109.49938,18.26042,1511
37494,A4823EEC9A8E697E80697432C029B488,30391,19,20,1,109.4975,18.27118,1513
37495,A4823EEC9A8E697E80697432C029B488,31561,21,22,1,109.56792,18.28479,1765
37503,17CC4D48447B18FFE0C5E2D7115F70E9,60161,15,16,1,109.49174,18.26181,1461
37504,17CC4D48447B18FFE0C5E2D7115F70E9,38251,16,18,2,109.49618,18.25493,1510
37518,A273393D96A2B92B5EC32D0B9DC69E7D,31021,0,6,6,109.49021,18.27,1463
37519,A273393D96A2B92B5EC32D0B9DC69E7D,30771,7,9,2,109.49938,18.26042,1511
37520,A273393D96A2B92B5EC32D0B9DC69E7D,30201,9,11,2,109.4909,18.26465,1462
37521,A273393D96A2B92B5EC32D0B9DC69E7D,30711,12,14,2,109.50271,18.25347,1510
37522,A273393D96A2B92B5EC32D0B9DC69E7D,31021,18,23,5,109.49021,18.27,1463
37550,D13BDDDA768B4492C03FFA127AE05681,38871,0,6,6,109.44681,18.28625,1316
37551,D13BDDDA768B4492C03FFA127AE05681,30111,7,13,6,109.47583,18.30542,1419
37552,D13BDDDA768B4492C03FFA127AE05681,38283,14,23,9,109.62229,18.22618,1956
37559,417408FFDA93B177641D270D3A5C4B2D,31071,0,6,6,109.58257,18.28458,1815
37560,417408FFDA93B177641D270D3A5C4B2D,60631,7,10,3,109.57778,18.27583,1814
37561,417408FFDA93B177641D270D3A5C4B2D,30854,11,13,2,109.56889,18.27076,1763
37562,417408FFDA93B177641D270D3A5C4B2D,31071,13,14,1,109.58257,18.28458,1815
37563,417408FFDA93B177641D270D3A5C4B2D,60631,15,18,3,109.57778,18.27583,1814
37564,417408FFDA93B177641D270D3A5C4B2D,30891,22,23,1,109.59431,18.28389,1865
37615,6862E1409834047709EBD3185EEA79B3,38141,0,11,11,109.39479,18.2916,1116
37616,6862E1409834047709EBD3185EEA79B3,38141,14,23,9,109.39479,18.2916,1116
37617,B1BCC89C2F3E15CBE4070B0B890371C7,30854,1,2,1,109.56889,18.27076,1763
37618,B1BCC89C2F3E15CBE4070B0B890371C7,60631,4,6,2,109.57778,18.27583,1814
37619,B1BCC89C2F3E15CBE4070B0B890371C7,30854,8,14,6,109.56889,18.27076,1763
37638,0CED616A832F8659D1540B6D8ADE8C66,31781,12,13,1,109.19847,18.2975,367
37639,0CED616A832F8659D1540B6D8ADE8C66,31471,14,15,1,109.34583,18.29563,917
37640,0CED616A832F8659D1540B6D8ADE8C66,38903,19,22,3,109.39229,18.29243,1117
37651,28F7DFD4A036DBA4E68AFC71762D44D7,31561,0,5,5,109.56792,18.28479,1765
37652,28F7DFD4A036DBA4E68AFC71762D44D7,30851,7,19,12,109.5616,18.27396,1713
37660,1D9ABE27C2D558C89E365FD305F32137,30271,0,7,7,109.49132,18.23153,1456
37661,1D9ABE27C2D558C89E365FD305F32137,31521,8,9,1,109.51458,18.22542,1555
37662,1D9ABE27C2D558C89E365FD305F32137,31781,11,15,4,109.19847,18.2975,367
37663,1D9ABE27C2D558C89E365FD305F32137,31521,16,18,2,109.51458,18.22542,1555
37664,1D9ABE27C2D558C89E365FD305F32137,60381,19,20,1,109.5241,18.22458,1605
37665,1D9ABE27C2D558C89E365FD305F32137,30271,20,22,2,109.49132,18.23153,1456
37700,AA42C8D5F23E17A418E66C8770B385FE,60571,0,12,12,109.50722,18.25056,1510
37701,AA42C8D5F23E17A418E66C8770B385FE,30151,15,23,8,109.50986,18.25083,1560
37748,1ACCBC562528CC75566F6D945C1677CB,38251,0,9,9,109.49618,18.25493,1510
37775,707670CE62A106DAC866A70B1F89E816,31431,0,8,8,109.44639,18.29042,1316
37776,707670CE62A106DAC866A70B1F89E816,60071,11,12,1,109.75674,18.31583,2470
37788,6EA83A9329F5D86E7E7F9B8351352891,30421,12,14,2,109.50021,18.25861,1511
37789,6EA83A9329F5D86E7E7F9B8351352891,30921,15,17,2,109.53903,18.29451,1667
37798,8DD23AA43C0F7967C45F7488D66F9159,31945,0,7,7,109.58021,18.29403,1817
37799,8DD23AA43C0F7967C45F7488D66F9159,30854,8,12,4,109.56889,18.27076,1763
37800,8DD23AA43C0F7967C45F7488D66F9159,31945,12,13,1,109.58021,18.29403,1817
37801,8DD23AA43C0F7967C45F7488D66F9159,30854,14,19,5,109.56889,18.27076,1763
37802,8DD23AA43C0F7967C45F7488D66F9159,60311,21,23,2,109.52097,18.24319,1558
37803,D63E20D130E2F81CA5A6AF5385AEF68B,30511,2,6,4,109.51069,18.24208,1558
37804,D63E20D130E2F81CA5A6AF5385AEF68B,31521,7,10,3,109.51458,18.22542,1555
37805,D63E20D130E2F81CA5A6AF5385AEF68B,30361,10,12,2,109.50347,18.24,1508
37806,D63E20D130E2F81CA5A6AF5385AEF68B,38111,13,16,3,109.52007,18.22403,1555
37807,D63E20D130E2F81CA5A6AF5385AEF68B,30731,16,17,1,109.50944,18.22306,1555
37808,D63E20D130E2F81CA5A6AF5385AEF68B,31521,18,20,2,109.51458,18.22542,1555
37809,D63E20D130E2F81CA5A6AF5385AEF68B,60381,20,22,2,109.5241,18.22458,1605
37810,3B66C6D354CAB83AFF8CCC11FF0B09AC,38991,6,9,3,109.52681,18.30368,1618
37811,3B66C6D354CAB83AFF8CCC11FF0B09AC,60171,9,11,2,109.51292,18.30694,1569
37812,3B66C6D354CAB83AFF8CCC11FF0B09AC,31951,11,13,2,109.52174,18.30299,1568
37813,3B66C6D354CAB83AFF8CCC11FF0B09AC,31781,14,16,2,109.19847,18.2975,367
37814,3B66C6D354CAB83AFF8CCC11FF0B09AC,38251,19,23,4,109.49618,18.25493,1510
37833,CC99FA2A6C21E3A9E3287361BB3FB0AC,30851,0,6,6,109.5616,18.27396,1713
37834,CC99FA2A6C21E3A9E3287361BB3FB0AC,31561,7,9,2,109.56792,18.28479,1765
37835,CC99FA2A6C21E3A9E3287361BB3FB0AC,30851,10,11,1,109.5616,18.27396,1713
37836,CC99FA2A6C21E3A9E3287361BB3FB0AC,31561,11,13,2,109.56792,18.28479,1765
37837,CC99FA2A6C21E3A9E3287361BB3FB0AC,30851,14,15,1,109.5616,18.27396,1713
37838,CC99FA2A6C21E3A9E3287361BB3FB0AC,31561,17,18,1,109.56792,18.28479,1765
37839,CC99FA2A6C21E3A9E3287361BB3FB0AC,30851,21,23,2,109.5616,18.27396,1713
37848,1EF385EC60D556EE5F45CC248F3036E3,31301,12,13,1,109.14493,18.31222,170
37849,1EF385EC60D556EE5F45CC248F3036E3,31421,18,19,1,109.55382,18.22347,1705
37894,F7ABE1A2051D725D70F50CD6183F5B8A,30201,0,9,9,109.4909,18.26465,1462
37895,F7ABE1A2051D725D70F50CD6183F5B8A,31781,11,14,3,109.19847,18.2975,367
37896,F7ABE1A2051D725D70F50CD6183F5B8A,31471,16,17,1,109.34583,18.29563,917
37897,F7ABE1A2051D725D70F50CD6183F5B8A,30201,19,23,4,109.4909,18.26465,1462
37912,72A5AEE2B8265DA80B198D741B53A3DA,60371,19,20,1,109.53063,18.30056,1618
37913,72A5AEE2B8265DA80B198D741B53A3DA,30071,21,22,1,109.52819,18.30472,1619
37917,094C7084A845593EA3BA8B1180C420B0,60121,15,16,1,109.74507,18.37472,2430
37918,094C7084A845593EA3BA8B1180C420B0,31091,19,20,1,109.41201,18.31222,1170
37919,094C7084A845593EA3BA8B1180C420B0,30121,21,23,2,109.52861,18.27222,1613
37926,5AB036BD4852DC840A52FF542200B93C,31461,0,8,8,109.5091,18.25389,1510
37927,5AB036BD4852DC840A52FF542200B93C,31161,11,15,4,109.70229,18.31361,2270
37928,5AB036BD4852DC840A52FF542200B93C,30711,16,18,2,109.50271,18.25347,1510
37929,5AB036BD4852DC840A52FF542200B93C,31461,21,23,2,109.5091,18.25389,1510
38039,2CB2771F7B23DF9836E81244B3977177,31471,16,17,1,109.34583,18.29563,917
38040,2CB2771F7B23DF9836E81244B3977177,30201,21,23,2,109.4909,18.26465,1462
38044,108BEC70F7DB0D9C00EBA021AFD47ACE,31031,0,8,8,109.49979,18.25382,1510
38045,108BEC70F7DB0D9C00EBA021AFD47ACE,38251,13,14,1,109.49618,18.25493,1510
38046,108BEC70F7DB0D9C00EBA021AFD47ACE,38315,15,16,1,109.48979,18.29764,1467
38057,324899445F811D5785FB336DE18DAC0E,31931,0,6,6,109.54771,18.29403,1667
38064,EDD211647BCC1D3CABF473CB2801C791,30161,0,2,2,109.50042,18.24389,1508
38065,EDD211647BCC1D3CABF473CB2801C791,31041,2,10,8,109.50278,18.23701,1507
38066,EDD211647BCC1D3CABF473CB2801C791,30161,11,23,12,109.50042,18.24389,1508
38081,25D6F59FBC67CDA90FF7920DEC546472,38706,0,10,10,109.74625,18.37097,2430
38082,25D6F59FBC67CDA90FF7920DEC546472,31781,14,15,1,109.19847,18.2975,367
38083,25D6F59FBC67CDA90FF7920DEC546472,31031,18,19,1,109.49979,18.25382,1510
38084,25D6F59FBC67CDA90FF7920DEC546472,38706,20,23,3,109.74625,18.37097,2430
38119,EBF906C5498076BCFA3E97DF6001B4F3,60631,1,8,7,109.57778,18.27583,1814
38120,EBF906C5498076BCFA3E97DF6001B4F3,30854,10,11,1,109.56889,18.27076,1763
38155,2A6BA0678DDF16AF08BAC9E3FA3C9391,31561,0,6,6,109.56792,18.28479,1765
38156,2A6BA0678DDF16AF08BAC9E3FA3C9391,30854,9,20,11,109.56889,18.27076,1763
38170,928DF0385E8541CFD2F5858501C04155,30234,6,7,1,109.60681,18.29979,1918
38171,928DF0385E8541CFD2F5858501C04155,30854,7,12,5,109.56889,18.27076,1763
38214,4AC58984B2F202FD588F865249555769,31311,1,16,15,109.72299,18.27438,2364
38215,4AC58984B2F202FD588F865249555769,38271,20,22,2,109.62632,18.23049,1956
38216,B334BB19B11E6B0F5578EDD58288683C,30111,12,15,3,109.47583,18.30542,1419
38217,B334BB19B11E6B0F5578EDD58288683C,31081,19,23,4,109.44639,18.30181,1318
38218,8BB15E7C959475309A269AAF24FD7109,30911,0,1,1,109.50493,18.26181,1511
38219,8BB15E7C959475309A269AAF24FD7109,39111,3,9,6,109.5191,18.22597,1555
38220,8BB15E7C959475309A269AAF24FD7109,31391,11,12,1,109.50382,18.24285,1508
38221,8BB15E7C959475309A269AAF24FD7109,31521,13,20,7,109.51458,18.22542,1555
38222,8BB15E7C959475309A269AAF24FD7109,60381,20,22,2,109.5241,18.22458,1605
38223,75817DB682187A07461734D66E1E6492,60631,0,4,4,109.57778,18.27583,1814
38224,75817DB682187A07461734D66E1E6492,30854,4,12,8,109.56889,18.27076,1763
38225,75817DB682187A07461734D66E1E6492,30851,17,18,1,109.5616,18.27396,1713
38226,75817DB682187A07461734D66E1E6492,31061,19,21,2,109.53333,18.23257,1607
38227,75817DB682187A07461734D66E1E6492,60631,22,23,1,109.57778,18.27583,1814
38255,E16204D131FCD957D5ADB9592C1DD0ED,30854,16,19,3,109.56889,18.27076,1763
38256,E16204D131FCD957D5ADB9592C1DD0ED,30361,19,21,2,109.50347,18.24,1508
38257,E16204D131FCD957D5ADB9592C1DD0ED,31561,21,23,2,109.56792,18.28479,1765
38264,F46FDDC29A8850C2C04367141B6440B6,30854,7,8,1,109.56889,18.27076,1763
38265,F46FDDC29A8850C2C04367141B6440B6,31801,9,12,3,109.20417,18.32118,371
38289,7DABC59FEA0DB7B637BC8EAB3272FDB2,31061,0,7,7,109.53333,18.23257,1607
38290,7DABC59FEA0DB7B637BC8EAB3272FDB2,31145,10,12,2,109.20431,18.30479,369
38291,7DABC59FEA0DB7B637BC8EAB3272FDB2,30661,13,15,2,109.37028,18.24361,1008
38292,7DABC59FEA0DB7B637BC8EAB3272FDB2,38251,19,21,2,109.49618,18.25493,1510
38293,7DABC59FEA0DB7B637BC8EAB3272FDB2,31061,22,23,1,109.53333,18.23257,1607
38304,7FB0F8EA4F93FB3B277450D57CE0C694,31321,12,14,2,109.63799,18.23201,2007
38305,7FB0F8EA4F93FB3B277450D57CE0C694,31531,16,23,7,109.49583,18.25972,1461
38319,BB722B9C2BE433A2166F92FAB5C577D9,31521,0,6,6,109.51458,18.22542,1555
38320,BB722B9C2BE433A2166F92FAB5C577D9,31781,9,12,3,109.19847,18.2975,367
38321,BB722B9C2BE433A2166F92FAB5C577D9,31471,14,18,4,109.34583,18.29563,917
38331,21C679D1B9FF307EA1AC2A89744209FE,38291,0,12,12,109.51618,18.24313,1558
38332,21C679D1B9FF307EA1AC2A89744209FE,60281,12,13,1,109.51743,18.25924,1561
38333,21C679D1B9FF307EA1AC2A89744209FE,38291,14,23,9,109.51618,18.24313,1558
38336,ED3B9FA0C7EBC373FA8CE8DAF74F568C,60234,0,5,5,109.49577,18.2096,1453
38337,ED3B9FA0C7EBC373FA8CE8DAF74F568C,30571,6,8,2,109.50243,18.21861,1504
38338,ED3B9FA0C7EBC373FA8CE8DAF74F568C,38347,8,9,1,109.4934,18.21444,1454
38339,ED3B9FA0C7EBC373FA8CE8DAF74F568C,31031,9,11,2,109.49979,18.25382,1510
38340,ED3B9FA0C7EBC373FA8CE8DAF74F568C,30571,14,18,4,109.50243,18.21861,1504
38341,ED3B9FA0C7EBC373FA8CE8DAF74F568C,30361,19,20,1,109.50347,18.24,1508
38342,ED3B9FA0C7EBC373FA8CE8DAF74F568C,30571,21,23,2,109.50243,18.21861,1504
38387,50180B11A4CA88EAD2B9BCC82FC09C4C,30281,0,7,7,109.50597,18.27583,1514
38388,50180B11A4CA88EAD2B9BCC82FC09C4C,31841,9,20,11,109.73201,18.33382,2373
38389,50180B11A4CA88EAD2B9BCC82FC09C4C,30854,21,23,2,109.56889,18.27076,1763
38402,D4EDFC03E7ED63DAAF98D926C98FC74F,31181,0,7,7,109.50382,18.24813,1509
38403,D4EDFC03E7ED63DAAF98D926C98FC74F,30441,10,12,2,109.64021,18.25424,2010
38404,D4EDFC03E7ED63DAAF98D926C98FC74F,31181,17,19,2,109.50382,18.24813,1509
38405,D4EDFC03E7ED63DAAF98D926C98FC74F,31181,19,23,4,109.50382,18.24813,1509
38438,ABCD0851CC1C78BCD7AF6DBDF2F5DE49,30211,6,11,5,109.49882,18.23931,1508
38439,ABCD0851CC1C78BCD7AF6DBDF2F5DE49,60552,11,13,2,109.41729,18.30014,1218
38486,E6541B4F346982101D887BAAF0315541,31561,17,18,1,109.56792,18.28479,1765
38487,E6541B4F346982101D887BAAF0315541,30854,19,23,4,109.56889,18.27076,1763
38501,9EB99F27F9127F01C16DB7BA7D10B6E0,31561,0,8,8,109.56792,18.28479,1765
38502,9EB99F27F9127F01C16DB7BA7D10B6E0,31071,9,10,1,109.58257,18.28458,1815
38503,9EB99F27F9127F01C16DB7BA7D10B6E0,30854,10,12,2,109.56889,18.27076,1763
38504,9EB99F27F9127F01C16DB7BA7D10B6E0,31071,14,16,2,109.58257,18.28458,1815
38505,9EB99F27F9127F01C16DB7BA7D10B6E0,30854,19,21,2,109.56889,18.27076,1763
38530,B643AC77F8D8498A9694D45BA8B0F75F,30854,0,12,12,109.56889,18.27076,1763
38531,B643AC77F8D8498A9694D45BA8B0F75F,60631,13,16,3,109.57778,18.27583,1814
38532,B643AC77F8D8498A9694D45BA8B0F75F,30851,17,18,1,109.5616,18.27396,1713
38533,B643AC77F8D8498A9694D45BA8B0F75F,31561,18,23,5,109.56792,18.28479,1765
38537,8C84F1CB6E49AC2736E89C4CFE87B2BD,31391,0,7,7,109.50382,18.24285,1508
38538,8C84F1CB6E49AC2736E89C4CFE87B2BD,60381,12,15,3,109.5241,18.22458,1605
38539,8C84F1CB6E49AC2736E89C4CFE87B2BD,30711,16,17,1,109.50271,18.25347,1510
38540,8C84F1CB6E49AC2736E89C4CFE87B2BD,31391,17,23,6,109.50382,18.24285,1508
38553,37907F3D7030B6146A33BAFE73719B21,31781,11,13,2,109.19847,18.2975,367
38554,37907F3D7030B6146A33BAFE73719B21,31231,17,19,2,109.42597,18.29292,1217
38555,37907F3D7030B6146A33BAFE73719B21,31231,20,23,3,109.42597,18.29292,1217
38572,E81160546B66436F002CB563AAB7719F,31571,2,3,1,109.61563,18.23326,1957
38573,E81160546B66436F002CB563AAB7719F,30581,3,7,4,109.62257,18.24951,1959
38574,E81160546B66436F002CB563AAB7719F,31571,7,8,1,109.61563,18.23326,1957
38575,E81160546B66436F002CB563AAB7719F,60054,12,14,2,109.3016,18.31229,770
38576,E81160546B66436F002CB563AAB7719F,38315,17,18,1,109.48979,18.29764,1467
38639,EF727BDF3D7B6D877CF0038228740019,30211,13,14,1,109.49882,18.23931,1508
38640,EF727BDF3D7B6D877CF0038228740019,39151,15,20,5,109.49875,18.25097,1510
38641,EEE6C5854E7673512BDD1CCF526E946C,31471,16,17,1,109.34583,18.29563,917
38642,EEE6C5854E7673512BDD1CCF526E946C,38951,19,20,1,109.48097,18.28868,1416
38643,EEE6C5854E7673512BDD1CCF526E946C,38951,21,23,2,109.48097,18.28868,1416
38644,1B107E88505197CF8BA7F2178A168846,30661,11,13,2,109.37028,18.24361,1008
38645,1B107E88505197CF8BA7F2178A168846,38145,18,23,5,109.378,18.2912,1066
38683,2260047EB2D30172BB0014D53FF32A4B,39111,0,7,7,109.5191,18.22597,1555
38684,2260047EB2D30172BB0014D53FF32A4B,31781,11,12,1,109.19847,18.2975,367
38685,2260047EB2D30172BB0014D53FF32A4B,31471,13,14,1,109.34583,18.29563,917
38686,2260047EB2D30172BB0014D53FF32A4B,30361,17,18,1,109.50347,18.24,1508
38687,2260047EB2D30172BB0014D53FF32A4B,39111,20,23,3,109.5191,18.22597,1555
38694,6F25B46DE233F84CBE88187DB2427FA9,30201,0,9,9,109.4909,18.26465,1462
38695,6F25B46DE233F84CBE88187DB2427FA9,31021,9,12,3,109.49021,18.27,1463
38696,6F25B46DE233F84CBE88187DB2427FA9,30201,12,18,6,109.4909,18.26465,1462
38697,6F25B46DE233F84CBE88187DB2427FA9,30201,19,23,4,109.4909,18.26465,1462
38705,27BCEF3137923B84211F08830816C810,30851,2,8,6,109.5616,18.27396,1713
38707,27BCEF3137923B84211F08830816C810,61011,14,15,1,109.60653,18.19076,1900
38717,5EAEAB611440D169B1CE8706AE16111E,31521,0,4,4,109.51458,18.22542,1555
38718,5EAEAB611440D169B1CE8706AE16111E,30511,7,9,2,109.51069,18.24208,1558
38719,5EAEAB611440D169B1CE8706AE16111E,31521,12,16,4,109.51458,18.22542,1555
38720,5EAEAB611440D169B1CE8706AE16111E,30511,18,19,1,109.51069,18.24208,1558
38721,5EAEAB611440D169B1CE8706AE16111E,60131,20,21,1,109.49819,18.24778,1509
38724,9BE19A4707368CF2308CCC927EC29D43,31851,15,16,1,109.71736,18.29007,2316
38726,5426296000364EE32711CD0E73D782C8,30854,0,1,1,109.56889,18.27076,1763
38727,5426296000364EE32711CD0E73D782C8,31071,2,23,21,109.58257,18.28458,1815
38729,896E70230E917230ACB2F2222A93F438,30421,17,23,6,109.50021,18.25861,1511
38739,439C404954398764464D854D76F475D8,39071,0,10,10,109.19917,18.29472,367
38740,439C404954398764464D854D76F475D8,30761,13,15,2,109.45201,18.3,1318
38741,439C404954398764464D854D76F475D8,31091,15,17,2,109.41201,18.31222,1170
38760,82727639E71DFEFC2A16FBFC1D14AF54,31101,14,15,1,109.65389,18.23403,2057
38761,82727639E71DFEFC2A16FBFC1D14AF54,60211,19,20,1,109.63549,18.26049,2011
38762,82727639E71DFEFC2A16FBFC1D14AF54,38131,21,22,1,109.65167,18.23535,2057
38786,4995463B780282C9C030A19D9F49AEAC,30854,8,15,7,109.56889,18.27076,1763
38787,4995463B780282C9C030A19D9F49AEAC,31071,16,17,1,109.58257,18.28458,1815
38788,4995463B780282C9C030A19D9F49AEAC,30854,20,21,1,109.56889,18.27076,1763
38789,4995463B780282C9C030A19D9F49AEAC,31071,22,23,1,109.58257,18.28458,1815
38824,C6F078264A4011D72ABD6DE75DA6F035,30391,0,8,8,109.4975,18.27118,1513
38827,C6F078264A4011D72ABD6DE75DA6F035,39101,20,22,2,109.50132,18.24931,1509
38905,00FD2268DE6E83934D2916174E81532F,60472,6,8,2,109.46625,18.29542,1367
38906,00FD2268DE6E83934D2916174E81532F,30111,12,13,1,109.47583,18.30542,1419
38907,00FD2268DE6E83934D2916174E81532F,30761,14,15,1,109.45201,18.3,1318
38908,00FD2268DE6E83934D2916174E81532F,30111,16,21,5,109.47583,18.30542,1419
38964,0C16D819785C0566D50CC6C5E7058EF2,30571,0,11,11,109.50243,18.21861,1504
38965,0C16D819785C0566D50CC6C5E7058EF2,38754,12,17,5,109.74667,18.37382,2430
38966,0C16D819785C0566D50CC6C5E7058EF2,30571,19,20,1,109.50243,18.21861,1504
38978,B340EDEF4A878E8DF5CBEC25E465EACE,30854,2,8,6,109.56889,18.27076,1763
38979,B340EDEF4A878E8DF5CBEC25E465EACE,60631,9,10,1,109.57778,18.27583,1814
38980,B340EDEF4A878E8DF5CBEC25E465EACE,30854,10,12,2,109.56889,18.27076,1763
38981,B340EDEF4A878E8DF5CBEC25E465EACE,31071,12,19,7,109.58257,18.28458,1815
38982,B340EDEF4A878E8DF5CBEC25E465EACE,30854,20,22,2,109.56889,18.27076,1763
38985,3E36844870867DBEBD25143A17160259,30071,5,12,7,109.52819,18.30472,1619
38997,F198CAA1F49ACA5D003FD8F8473B3798,31071,1,20,19,109.58257,18.28458,1815
38998,F198CAA1F49ACA5D003FD8F8473B3798,30854,21,23,2,109.56889,18.27076,1763
39041,C860767955774E3494068CF38C009FB6,39151,16,17,1,109.49875,18.25097,1510
39042,C860767955774E3494068CF38C009FB6,60391,19,23,4,109.47667,18.28757,1416
39046,8A2602EE97ED1F19C3F8048B259C52D2,31521,18,20,2,109.51458,18.22542,1555
39047,8A2602EE97ED1F19C3F8048B259C52D2,60381,20,21,1,109.5241,18.22458,1605
39081,3B9CF45D57A7D2A120FFDEE58BB4974D,31431,0,9,9,109.44639,18.29042,1316
39082,3B9CF45D57A7D2A120FFDEE58BB4974D,31781,11,14,3,109.19847,18.2975,367
39083,3B9CF45D57A7D2A120FFDEE58BB4974D,31431,17,18,1,109.44639,18.29042,1316
39084,3B9CF45D57A7D2A120FFDEE58BB4974D,31701,18,20,2,109.44132,18.28833,1266
39110,8C5A16299A6D294198C90C34C25C5949,31561,14,15,1,109.56792,18.28479,1765
39111,8C5A16299A6D294198C90C34C25C5949,30854,19,20,1,109.56889,18.27076,1763
39112,8C5A16299A6D294198C90C34C25C5949,39183,20,21,1,109.55542,18.28208,1715
39113,662D882A6A10D0E6C3566690F0A40636,30854,0,8,8,109.56889,18.27076,1763
39114,662D882A6A10D0E6C3566690F0A40636,31071,10,11,1,109.58257,18.28458,1815
39115,662D882A6A10D0E6C3566690F0A40636,30854,16,17,1,109.56889,18.27076,1763
39233,ED27A36B4EC5F7DF8073D01D839A8DDC,38356,16,18,2,109.50201,18.21486,1504
39234,ED27A36B4EC5F7DF8073D01D839A8DDC,60381,19,20,1,109.5241,18.22458,1605
39235,ED27A36B4EC5F7DF8073D01D839A8DDC,38356,21,23,2,109.50201,18.21486,1504
39244,3175EB28BB7B27CAE2120D6151C4EC00,38315,0,13,13,109.48979,18.29764,1467
39254,3A5827A88DC93A9B58B304F6E1017BB8,60401,0,1,1,109.47444,18.27583,1414
39255,3A5827A88DC93A9B58B304F6E1017BB8,38251,3,5,2,109.49618,18.25493,1510
39256,3A5827A88DC93A9B58B304F6E1017BB8,31231,6,9,3,109.42597,18.29292,1217
39257,3A5827A88DC93A9B58B304F6E1017BB8,38331,13,23,10,109.62465,18.22736,1956
39283,4699AE6CF383C4C75244005144E585A1,31061,14,21,7,109.53333,18.23257,1607
39284,4699AE6CF383C4C75244005144E585A1,60211,22,23,1,109.63549,18.26049,2011
39285,7C4555390A772AFC617B693DE91FE9EE,60371,3,5,2,109.53063,18.30056,1618
39286,7C4555390A772AFC617B693DE91FE9EE,31931,6,8,2,109.54771,18.29403,1667
39287,7C4555390A772AFC617B693DE91FE9EE,39181,9,11,2,109.55153,18.28035,1715
39288,7C4555390A772AFC617B693DE91FE9EE,31931,13,14,1,109.54771,18.29403,1667
39289,7C4555390A772AFC617B693DE91FE9EE,38241,15,16,1,109.54111,18.30542,1669
39290,7C4555390A772AFC617B693DE91FE9EE,31261,20,23,3,109.51174,18.2466,1559
39291,DB0545D9EAEB3C579F968F7F5B217B6C,38127,0,15,15,109.50833,18.27222,1513
39385,EC3D175E97D1257AC20AF39754562033,39131,0,6,6,109.2066,18.29639,417
39386,EC3D175E97D1257AC20AF39754562033,31781,7,9,2,109.19847,18.2975,367
39440,533C598FBE9A80A69F24B4E517B0CF08,30741,16,20,4,109.49833,18.28681,1516
39441,533C598FBE9A80A69F24B4E517B0CF08,30421,21,22,1,109.50021,18.25861,1511
39447,DC0EB400EA24BEE9EB39D315B0E6AEF0,60041,11,15,4,109.39889,18.31944,1121
39448,DC0EB400EA24BEE9EB39D315B0E6AEF0,38871,17,23,6,109.44681,18.28625,1316
39470,9FEA4B85EAE4FAEE1CAF0EABFF2FAEA1,31561,3,5,2,109.56792,18.28479,1765
39471,9FEA4B85EAE4FAEE1CAF0EABFF2FAEA1,39183,7,9,2,109.55542,18.28208,1715
39472,9FEA4B85EAE4FAEE1CAF0EABFF2FAEA1,31561,14,23,9,109.56792,18.28479,1765
39477,AA303E27C0F1A202B07C13B2600A28E3,31471,15,17,2,109.34583,18.29563,917
39478,AA303E27C0F1A202B07C13B2600A28E3,30361,19,21,2,109.50347,18.24,1508
39499,89A3D380798A385AE8DF1304AC1B4E0B,31931,0,13,13,109.54771,18.29403,1667
39500,89A3D380798A385AE8DF1304AC1B4E0B,39181,14,15,1,109.55153,18.28035,1715
39501,89A3D380798A385AE8DF1304AC1B4E0B,31931,18,22,4,109.54771,18.29403,1667
39548,3566D93A1983F1B060C3ACA68586876F,38951,19,20,1,109.48097,18.28868,1416
39549,3566D93A1983F1B060C3ACA68586876F,38951,22,23,1,109.48097,18.28868,1416
39603,73D60F2EA359EEE2578482BDCFC4E018,39321,14,16,2,109.529,18.2167,1604
39604,73D60F2EA359EEE2578482BDCFC4E018,38541,17,21,4,109.73715,18.34875,2426
39636,9FC721E86703223349C05C95FE4BBB6F,60087,0,2,2,109.50688,18.22299,1505
39637,9FC721E86703223349C05C95FE4BBB6F,60081,2,10,8,109.51097,18.22639,1556
39638,9FC721E86703223349C05C95FE4BBB6F,60381,11,19,8,109.5241,18.22458,1605
39639,9FC721E86703223349C05C95FE4BBB6F,31521,19,20,1,109.51458,18.22542,1555
39640,9FC721E86703223349C05C95FE4BBB6F,60087,21,23,2,109.50688,18.22299,1505
39650,B616D64706FE00CB4CDA3E3D124853B8,30511,15,16,1,109.51069,18.24208,1558
39651,B616D64706FE00CB4CDA3E3D124853B8,31671,17,23,6,109.38965,18.29813,1068
39682,37165DF42A8775B3C0474BD893FEF592,39321,16,18,2,109.529,18.2167,1604
39683,37165DF42A8775B3C0474BD893FEF592,30361,19,21,2,109.50347,18.24,1508
39691,36DE5DE7D024FC0D4AA8374BBC02FD61,60401,0,8,8,109.47444,18.27583,1414
39692,36DE5DE7D024FC0D4AA8374BBC02FD61,33051,11,16,5,109.6475,18.46618,2096
39753,A8CC84F6441C04DAF82A74609E587ED2,30561,0,2,2,109.52778,18.31938,1621
39754,A8CC84F6441C04DAF82A74609E587ED2,30561,4,6,2,109.52778,18.31938,1621
39755,A8CC84F6441C04DAF82A74609E587ED2,31931,7,11,4,109.54771,18.29403,1667
39756,A8CC84F6441C04DAF82A74609E587ED2,30561,12,13,1,109.52778,18.31938,1621
39757,A8CC84F6441C04DAF82A74609E587ED2,31931,14,16,2,109.54771,18.29403,1667
39758,A8CC84F6441C04DAF82A74609E587ED2,30561,18,21,3,109.52778,18.31938,1621
39791,F195AFF17955B04C2BD69FE8CB907348,39061,0,3,3,109.38222,18.28958,1066
39792,F195AFF17955B04C2BD69FE8CB907348,38027,3,8,5,109.38833,18.2909,1066
39793,F195AFF17955B04C2BD69FE8CB907348,31781,8,10,2,109.19847,18.2975,367
39794,F195AFF17955B04C2BD69FE8CB907348,39081,11,12,1,109.19382,18.29111,366
39795,F195AFF17955B04C2BD69FE8CB907348,31471,14,15,1,109.34583,18.29563,917
39823,2576A40187A845D7B849E820F16B3DB1,30854,1,3,2,109.56889,18.27076,1763
39824,2576A40187A845D7B849E820F16B3DB1,31071,3,8,5,109.58257,18.28458,1815
39825,2576A40187A845D7B849E820F16B3DB1,30854,10,11,1,109.56889,18.27076,1763
39826,2576A40187A845D7B849E820F16B3DB1,31071,13,15,2,109.58257,18.28458,1815
39827,2576A40187A845D7B849E820F16B3DB1,30854,16,19,3,109.56889,18.27076,1763
39835,90B0A60855A43B2DB99A0964CE51D3AF,31071,1,6,5,109.58257,18.28458,1815
39836,90B0A60855A43B2DB99A0964CE51D3AF,30854,8,10,2,109.56889,18.27076,1763
39837,90B0A60855A43B2DB99A0964CE51D3AF,31071,14,21,7,109.58257,18.28458,1815
39863,51B9FE31A6261A2E6FE900B23D8E8A33,60391,0,15,15,109.47667,18.28757,1416
39864,51B9FE31A6261A2E6FE900B23D8E8A33,60381,18,19,1,109.5241,18.22458,1605
39865,51B9FE31A6261A2E6FE900B23D8E8A33,30421,20,21,1,109.50021,18.25861,1511
39866,51B9FE31A6261A2E6FE900B23D8E8A33,60391,21,23,2,109.47667,18.28757,1416
39887,4323F1BAF644B54BAE5AE7C688725B1E,31071,0,14,14,109.58257,18.28458,1815
39888,4323F1BAF644B54BAE5AE7C688725B1E,39151,16,18,2,109.49875,18.25097,1510
39921,39997DEFFD87AA0C9D18E1194544E438,30854,0,8,8,109.56889,18.27076,1763
39922,39997DEFFD87AA0C9D18E1194544E438,30891,8,10,2,109.59431,18.28389,1865
39923,39997DEFFD87AA0C9D18E1194544E438,30854,11,16,5,109.56889,18.27076,1763
39924,39997DEFFD87AA0C9D18E1194544E438,30891,16,20,4,109.59431,18.28389,1865
39930,B20C192805DC56EE880FB74EB0759F15,38754,14,15,1,109.74667,18.37382,2430
39932,DF726AC992EA795A98DE4DF26D62B584,31521,13,20,7,109.51458,18.22542,1555
39933,DF726AC992EA795A98DE4DF26D62B584,30361,20,21,1,109.50347,18.24,1508
39936,9D173245E760E51856EB0F1A3A5A796E,31145,9,11,2,109.20431,18.30479,369
39967,85113926FD58DF2481DE297BC312E23D,38094,0,9,9,109.45403,18.28778,1316
39968,85113926FD58DF2481DE297BC312E23D,31311,11,18,7,109.72299,18.27438,2364
39969,85113926FD58DF2481DE297BC312E23D,60121,18,20,2,109.74507,18.37472,2430
39992,B23FC02C429984B68CAAC5B6CFEA2906,60281,0,16,16,109.51743,18.25924,1561
39993,B23FC02C429984B68CAAC5B6CFEA2906,38316,17,19,2,109.48542,18.27424,1464
39994,B23FC02C429984B68CAAC5B6CFEA2906,38881,20,23,3,109.51618,18.26431,1562
39995,9DC6ECD11DB9342376E99047D8C3456C,30854,1,14,13,109.56889,18.27076,1763
39996,9DC6ECD11DB9342376E99047D8C3456C,38261,18,22,4,109.50361,18.28153,1515
40008,B094ED54FC7E5FCBA88708259A919ECC,31421,0,10,10,109.55382,18.22347,1705
40009,B094ED54FC7E5FCBA88708259A919ECC,38251,15,17,2,109.49618,18.25493,1510
40010,B094ED54FC7E5FCBA88708259A919ECC,31421,18,23,5,109.55382,18.22347,1705
40108,74AD1AF2EA5153BD40BCF9A3F3F2C4E3,30854,7,9,2,109.56889,18.27076,1763
40109,74AD1AF2EA5153BD40BCF9A3F3F2C4E3,31071,9,11,2,109.58257,18.28458,1815
40110,74AD1AF2EA5153BD40BCF9A3F3F2C4E3,30854,11,13,2,109.56889,18.27076,1763
40111,74AD1AF2EA5153BD40BCF9A3F3F2C4E3,31071,14,21,7,109.58257,18.28458,1815
40125,A9FCE0049DB44FE004EAFBF5B783F4A5,31351,0,1,1,109.4959,18.28417,1465
40126,A9FCE0049DB44FE004EAFBF5B783F4A5,31945,2,7,5,109.58021,18.29403,1817
40127,A9FCE0049DB44FE004EAFBF5B783F4A5,30854,8,11,3,109.56889,18.27076,1763
40128,A9FCE0049DB44FE004EAFBF5B783F4A5,31945,12,23,11,109.58021,18.29403,1817
40161,2636D092653DB639DF114DD1E5470CF3,31021,0,11,11,109.49021,18.27,1463
40162,2636D092653DB639DF114DD1E5470CF3,31071,15,21,6,109.58257,18.28458,1815
40193,4DEA461E038CB97C304B1C8C76D68215,31145,12,15,3,109.20431,18.30479,369
40194,4DEA461E038CB97C304B1C8C76D68215,31521,19,20,1,109.51458,18.22542,1555
40195,4DEA461E038CB97C304B1C8C76D68215,39321,20,23,3,109.529,18.2167,1604
40203,92E108319E8175B7B6E72625E24D17C9,30361,18,20,2,109.50347,18.24,1508
40204,92E108319E8175B7B6E72625E24D17C9,38811,22,23,1,109.50875,18.2175,1504
40214,12A0D13AED64522A8A0ABBA021E92F4C,60361,0,10,10,109.51938,18.29681,1567
40215,12A0D13AED64522A8A0ABBA021E92F4C,60501,14,15,1,109.48701,18.29021,1466
40216,12A0D13AED64522A8A0ABBA021E92F4C,60361,20,21,1,109.51938,18.29681,1567
40217,BFBF13B5E10088239CEDE316C8663521,30581,0,7,7,109.62257,18.24951,1959
40218,BFBF13B5E10088239CEDE316C8663521,31571,7,8,1,109.61563,18.23326,1957
40219,BFBF13B5E10088239CEDE316C8663521,60054,12,14,2,109.3016,18.31229,770
40220,BFBF13B5E10088239CEDE316C8663521,60614,17,18,1,109.48799,18.29521,1467
40223,84DF4A7C208235D171EF56473BCCF210,60631,0,18,18,109.57778,18.27583,1814
40224,84DF4A7C208235D171EF56473BCCF210,30851,22,23,1,109.5616,18.27396,1713
40259,C3071072DB6684DC75BE160268E6323C,30854,6,18,12,109.56889,18.27076,1763
40260,C3071072DB6684DC75BE160268E6323C,30084,20,22,2,109.50118,18.26972,1513
40261,83F8DEFB45E9970F803B6E01CF53475C,31201,0,3,3,109.51042,18.23819,1558
40262,83F8DEFB45E9970F803B6E01CF53475C,31021,3,11,8,109.49021,18.27,1463
40263,83F8DEFB45E9970F803B6E01CF53475C,31206,12,15,3,109.50819,18.23549,1507
40264,83F8DEFB45E9970F803B6E01CF53475C,31021,17,22,5,109.49021,18.27,1463
40296,A0C1D054F6EAC4F4EEE507DF1D074BC1,30854,0,17,17,109.56889,18.27076,1763
40297,A0C1D054F6EAC4F4EEE507DF1D074BC1,30421,18,19,1,109.50021,18.25861,1511
40298,A0C1D054F6EAC4F4EEE507DF1D074BC1,30854,20,23,3,109.56889,18.27076,1763
40303,A94F66C88B84FF0658441320CD9F667C,30854,0,5,5,109.56889,18.27076,1763
40304,A94F66C88B84FF0658441320CD9F667C,31071,9,11,2,109.58257,18.28458,1815
40305,A94F66C88B84FF0658441320CD9F667C,30854,12,13,1,109.56889,18.27076,1763
40318,BE586ACB441383CC10D7CF3923850B73,60371,0,4,4,109.53063,18.30056,1618
40319,BE586ACB441383CC10D7CF3923850B73,39183,8,9,1,109.55542,18.28208,1715
40320,BE586ACB441383CC10D7CF3923850B73,31931,13,19,6,109.54771,18.29403,1667
40328,C316CE65034FB3C77BE459147CBF943A,60291,0,9,9,109.50826,18.24639,1509
40329,C316CE65034FB3C77BE459147CBF943A,30161,10,12,2,109.50042,18.24389,1508
40330,C316CE65034FB3C77BE459147CBF943A,31181,13,14,1,109.50382,18.24813,1509
40331,C316CE65034FB3C77BE459147CBF943A,30161,15,17,2,109.50042,18.24389,1508
40332,C316CE65034FB3C77BE459147CBF943A,30161,17,19,2,109.50042,18.24389,1508
40333,C316CE65034FB3C77BE459147CBF943A,30371,20,23,3,109.51,18.24771,1559
40336,0563BC067E662950114EF8FD62D34D59,39091,0,9,9,109.50097,18.25222,1510
40337,0563BC067E662950114EF8FD62D34D59,31145,11,12,1,109.20431,18.30479,369
40338,0563BC067E662950114EF8FD62D34D59,39131,13,14,1,109.2066,18.29639,417
40346,79DF40D2B98887E142CED30D6ACACB42,31521,0,8,8,109.51458,18.22542,1555
40347,79DF40D2B98887E142CED30D6ACACB42,31781,10,12,2,109.19847,18.2975,367
40348,79DF40D2B98887E142CED30D6ACACB42,31471,14,15,1,109.34583,18.29563,917
40349,79DF40D2B98887E142CED30D6ACACB42,60161,19,20,1,109.49174,18.26181,1461
40366,57174D33B48D199AA8B09D59209E3E63,31781,13,14,1,109.19847,18.2975,367
40367,57174D33B48D199AA8B09D59209E3E63,31471,15,17,2,109.34583,18.29563,917
40368,57174D33B48D199AA8B09D59209E3E63,30391,21,22,1,109.4975,18.27118,1513
40373,833001CDF394BB3F6E4F040C2A70AC27,30854,0,7,7,109.56889,18.27076,1763
40374,833001CDF394BB3F6E4F040C2A70AC27,31071,8,12,4,109.58257,18.28458,1815
40375,833001CDF394BB3F6E4F040C2A70AC27,30854,12,13,1,109.56889,18.27076,1763
40376,833001CDF394BB3F6E4F040C2A70AC27,31071,14,19,5,109.58257,18.28458,1815
40381,D6A345956751BA2ACC5430EDF68A104F,39181,0,6,6,109.55153,18.28035,1715
40382,D6A345956751BA2ACC5430EDF68A104F,39181,7,10,3,109.55153,18.28035,1715
40383,D6A345956751BA2ACC5430EDF68A104F,31931,10,16,6,109.54771,18.29403,1667
40384,D6A345956751BA2ACC5430EDF68A104F,39181,18,19,1,109.55153,18.28035,1715
40385,D6A345956751BA2ACC5430EDF68A104F,31071,20,22,2,109.58257,18.28458,1815
40386,2DE9EDA76548D997396F5AD85CC3B910,38991,4,5,1,109.52681,18.30368,1618
40387,2DE9EDA76548D997396F5AD85CC3B910,60371,6,8,2,109.53063,18.30056,1618
40388,2DE9EDA76548D997396F5AD85CC3B910,31781,11,14,3,109.19847,18.2975,367
40389,2DE9EDA76548D997396F5AD85CC3B910,60221,17,21,4,109.52569,18.29188,1616
40422,62AE585F0AAA8DA5ED8FA7DC785DB597,30361,12,15,3,109.50347,18.24,1508
40441,C50EC98EBB3AD6F34D76F87C749DAC01,39181,0,9,9,109.55153,18.28035,1715
40442,C50EC98EBB3AD6F34D76F87C749DAC01,31931,10,13,3,109.54771,18.29403,1667
40443,C50EC98EBB3AD6F34D76F87C749DAC01,39181,13,15,2,109.55153,18.28035,1715
40444,C50EC98EBB3AD6F34D76F87C749DAC01,31931,15,19,4,109.54771,18.29403,1667
40445,C50EC98EBB3AD6F34D76F87C749DAC01,39181,19,23,4,109.55153,18.28035,1715
40455,667EA80049388AD19BD964958F75B929,31145,13,15,2,109.20431,18.30479,369
40456,667EA80049388AD19BD964958F75B929,60054,16,18,2,109.3016,18.31229,770
40457,667EA80049388AD19BD964958F75B929,30421,19,20,1,109.50021,18.25861,1511
40461,DB27065941C483C1992B62B188635BF8,31471,14,15,1,109.34583,18.29563,917
40462,DB27065941C483C1992B62B188635BF8,60221,19,20,1,109.52569,18.29188,1616
40463,DB27065941C483C1992B62B188635BF8,31864,21,23,2,109.49014,18.28333,1465
40469,E33D19A2E6AE9CBD99027C143E4122D1,30361,0,3,3,109.50347,18.24,1508
40470,E33D19A2E6AE9CBD99027C143E4122D1,38376,4,10,6,109.50924,18.24,1558
40471,E33D19A2E6AE9CBD99027C143E4122D1,30361,14,16,2,109.50347,18.24,1508
40472,E33D19A2E6AE9CBD99027C143E4122D1,30421,16,19,3,109.50021,18.25861,1511
40473,E33D19A2E6AE9CBD99027C143E4122D1,31391,19,21,2,109.50382,18.24285,1508
40494,CF23CF6CFE18BB23E9BD394A1039CA8D,31145,14,15,1,109.20431,18.30479,369
40495,CF23CF6CFE18BB23E9BD394A1039CA8D,60054,16,18,2,109.3016,18.31229,770
40496,F00821368F615DCDAF214035D8EC4A44,31071,12,13,1,109.58257,18.28458,1815
40497,F00821368F615DCDAF214035D8EC4A44,30854,15,17,2,109.56889,18.27076,1763
40498,F00821368F615DCDAF214035D8EC4A44,38291,18,21,3,109.51618,18.24313,1558
40524,934029FB5F97BCE114EDCE88F0393A63,30854,2,12,10,109.56889,18.27076,1763
40527,8D7B9451E0189947198D6AC9CE51CFEE,30111,0,1,1,109.47583,18.30542,1419
40528,8D7B9451E0189947198D6AC9CE51CFEE,30764,1,3,2,109.45806,18.29486,1367
40529,8D7B9451E0189947198D6AC9CE51CFEE,31091,4,14,10,109.41201,18.31222,1170
40530,8D7B9451E0189947198D6AC9CE51CFEE,31081,19,21,2,109.44639,18.30181,1318
40531,8D7B9451E0189947198D6AC9CE51CFEE,31091,21,23,2,109.41201,18.31222,1170
40549,770049901BD1590EBE86EED8F56910D2,31471,10,12,2,109.34583,18.29563,917
40550,770049901BD1590EBE86EED8F56910D2,31145,14,16,2,109.20431,18.30479,369
40551,770049901BD1590EBE86EED8F56910D2,30361,19,20,1,109.50347,18.24,1508
40552,770049901BD1590EBE86EED8F56910D2,60041,22,23,1,109.39889,18.31944,1121
40565,335A7B1DE8538918FDA774EE3E402A76,30191,0,7,7,109.50361,18.22701,1506
40566,335A7B1DE8538918FDA774EE3E402A76,60381,9,12,3,109.5241,18.22458,1605
40567,335A7B1DE8538918FDA774EE3E402A76,30191,13,23,10,109.50361,18.22701,1506
40606,FE635F2B32C65ADB512C504153E6C643,30361,15,18,3,109.50347,18.24,1508
40607,FE635F2B32C65ADB512C504153E6C643,38052,19,23,4,109.62618,18.23042,1956
40625,B81967918F04CCC09086D5144AD4448F,30201,0,8,8,109.4909,18.26465,1462
40626,B81967918F04CCC09086D5144AD4448F,31471,10,12,2,109.34583,18.29563,917
40627,B81967918F04CCC09086D5144AD4448F,31145,13,14,1,109.20431,18.30479,369
40628,B81967918F04CCC09086D5144AD4448F,31271,18,23,5,109.48958,18.26257,1462
40683,A14C813C3E3A7182759DA822342505B5,39183,0,16,16,109.55542,18.28208,1715
40684,A14C813C3E3A7182759DA822342505B5,39181,17,18,1,109.55153,18.28035,1715
40685,A14C813C3E3A7182759DA822342505B5,39183,19,21,2,109.55542,18.28208,1715
40694,AD39A6F857F8E578E6A2D9E072C4613F,30681,0,8,8,109.48493,18.26917,1463
40695,AD39A6F857F8E578E6A2D9E072C4613F,38111,12,13,1,109.52007,18.22403,1555
40696,AD39A6F857F8E578E6A2D9E072C4613F,30791,15,18,3,109.72333,18.40889,2386
40697,AD39A6F857F8E578E6A2D9E072C4613F,30421,20,21,1,109.50021,18.25861,1511
40698,409F5E8F01172D32BBE91132149C037E,38371,0,13,13,109.50972,18.23924,1558
40699,409F5E8F01172D32BBE91132149C037E,30421,15,17,2,109.50021,18.25861,1511
40700,409F5E8F01172D32BBE91132149C037E,38371,19,23,4,109.50972,18.23924,1558
40725,9147E6833419D1AC88CC9A3C7C57D8F9,30511,2,4,2,109.51069,18.24208,1558
40726,9147E6833419D1AC88CC9A3C7C57D8F9,38376,6,7,1,109.50924,18.24,1558
40727,9147E6833419D1AC88CC9A3C7C57D8F9,30361,8,10,2,109.50347,18.24,1508
40728,9147E6833419D1AC88CC9A3C7C57D8F9,38371,11,13,2,109.50972,18.23924,1558
40729,9147E6833419D1AC88CC9A3C7C57D8F9,30361,14,16,2,109.50347,18.24,1508
40730,9147E6833419D1AC88CC9A3C7C57D8F9,30421,16,19,3,109.50021,18.25861,1511
40731,9147E6833419D1AC88CC9A3C7C57D8F9,30361,19,21,2,109.50347,18.24,1508
40740,55CBF233BA3606523955A1093C92D734,31031,11,13,2,109.49979,18.25382,1510
40741,55CBF233BA3606523955A1093C92D734,30421,13,16,3,109.50021,18.25861,1511
40768,F4066052A05F84E460A213A00F90E37F,60201,0,4,4,109.5041,18.2509,1510
40769,F4066052A05F84E460A213A00F90E37F,38251,5,10,5,109.49618,18.25493,1510
40770,F4066052A05F84E460A213A00F90E37F,38071,14,15,1,109.40722,18.30938,1169
40824,9C1407835BC54BEBDB541F52E1DA1820,61011,8,16,8,109.60653,18.19076,1900
40847,EBCB949B72E5CE9FCA5E9C7D3826BEF9,60201,1,4,3,109.5041,18.2509,1510
40848,EBCB949B72E5CE9FCA5E9C7D3826BEF9,60291,5,9,4,109.50826,18.24639,1509
40849,EBCB949B72E5CE9FCA5E9C7D3826BEF9,60201,9,10,1,109.5041,18.2509,1510
40850,EBCB949B72E5CE9FCA5E9C7D3826BEF9,60161,13,15,2,109.49174,18.26181,1461
40851,EBCB949B72E5CE9FCA5E9C7D3826BEF9,60201,19,23,4,109.5041,18.2509,1510
40893,C162E20472DBB598395501A28AA53C86,31671,0,8,8,109.38965,18.29813,1068
40894,C162E20472DBB598395501A28AA53C86,38185,10,12,2,109.51333,18.27347,1563
40895,C162E20472DBB598395501A28AA53C86,60291,14,15,1,109.50826,18.24639,1509
40896,C162E20472DBB598395501A28AA53C86,31021,16,18,2,109.49021,18.27,1463
40897,C162E20472DBB598395501A28AA53C86,60261,20,22,2,109.44326,18.3075,1319
40898,6E2021B014C4D0B652A2E4FE8D2CF038,31071,0,14,14,109.58257,18.28458,1815
40899,6E2021B014C4D0B652A2E4FE8D2CF038,30854,14,16,2,109.56889,18.27076,1763
40900,6E2021B014C4D0B652A2E4FE8D2CF038,31071,20,22,2,109.58257,18.28458,1815
40951,911CEC4AC21FB385F27D5F98FF05CA40,30201,11,23,12,109.4909,18.26465,1462
40971,DBB710D279E76C79F1E4B0766F579F8A,31071,0,7,7,109.58257,18.28458,1815
40972,DBB710D279E76C79F1E4B0766F579F8A,30854,8,9,1,109.56889,18.27076,1763
40973,DBB710D279E76C79F1E4B0766F579F8A,31071,10,17,7,109.58257,18.28458,1815
40986,951158CC6AD050845D913E5934112D91,60084,0,7,7,109.4984,18.2334,1507
40987,951158CC6AD050845D913E5934112D91,30051,7,8,1,109.48917,18.21215,1453
41041,84CE8301EE7DE9359AE27DC0300F36A9,30761,1,5,4,109.45201,18.3,1318
41042,84CE8301EE7DE9359AE27DC0300F36A9,30854,8,14,6,109.56889,18.27076,1763
41072,000584B3023702F3E9DDF521B1C35B1A,31351,0,2,2,109.4959,18.28417,1465
41073,000584B3023702F3E9DDF521B1C35B1A,31071,4,7,3,109.58257,18.28458,1815
41074,000584B3023702F3E9DDF521B1C35B1A,30854,9,11,2,109.56889,18.27076,1763
41075,000584B3023702F3E9DDF521B1C35B1A,31945,13,14,1,109.58021,18.29403,1817
41076,000584B3023702F3E9DDF521B1C35B1A,30221,16,17,1,109.57833,18.20222,1802
41077,000584B3023702F3E9DDF521B1C35B1A,31071,20,22,2,109.58257,18.28458,1815
41088,84B290D0AF9CB48AF24DF60053E525A2,31271,16,18,2,109.48958,18.26257,1462
41089,84B290D0AF9CB48AF24DF60053E525A2,30681,18,20,2,109.48493,18.26917,1463
41090,84B290D0AF9CB48AF24DF60053E525A2,31271,21,23,2,109.48958,18.26257,1462
41121,37D38EF0062E64D55C94EB554B76F9EE,31945,0,3,3,109.58021,18.29403,1817
41122,37D38EF0062E64D55C94EB554B76F9EE,31071,3,7,4,109.58257,18.28458,1815
41123,37D38EF0062E64D55C94EB554B76F9EE,31945,8,9,1,109.58021,18.29403,1817
41124,37D38EF0062E64D55C94EB554B76F9EE,30854,10,17,7,109.56889,18.27076,1763
41139,E00EF22F493557E868E52C93194870CF,60381,19,21,2,109.5241,18.22458,1605
41140,E00EF22F493557E868E52C93194870CF,30854,21,23,2,109.56889,18.27076,1763
41147,7EC0E6AB7B4A98205882F5FFBEA13441,60234,2,5,3,109.49577,18.2096,1453
41148,7EC0E6AB7B4A98205882F5FFBEA13441,38017,5,13,8,109.49729,18.21424,1504
41149,7EC0E6AB7B4A98205882F5FFBEA13441,38111,13,14,1,109.52007,18.22403,1555
41150,7EC0E6AB7B4A98205882F5FFBEA13441,38754,15,17,2,109.74667,18.37382,2430
41151,7EC0E6AB7B4A98205882F5FFBEA13441,38017,21,23,2,109.49729,18.21424,1504
41155,15FA33D999B0EB11F94D5A6342781D57,31071,0,7,7,109.58257,18.28458,1815
41156,15FA33D999B0EB11F94D5A6342781D57,39081,11,12,1,109.19382,18.29111,366
41157,15FA33D999B0EB11F94D5A6342781D57,31471,14,16,2,109.34583,18.29563,917
41183,2986E42C864F9C3503A05721F57A75DB,31931,0,12,12,109.54771,18.29403,1667
41184,2986E42C864F9C3503A05721F57A75DB,60171,14,16,2,109.51292,18.30694,1569
41185,2986E42C864F9C3503A05721F57A75DB,31931,17,21,4,109.54771,18.29403,1667
41271,7FD31F65A9E7574FDAD4A110ACBA289D,60171,8,17,9,109.51292,18.30694,1569
41272,7FD31F65A9E7574FDAD4A110ACBA289D,31931,18,19,1,109.54771,18.29403,1667
41288,D21A77842B7456864CF5D4493E9BC8AC,31031,19,20,1,109.49979,18.25382,1510
41289,D21A77842B7456864CF5D4493E9BC8AC,30771,21,23,2,109.49938,18.26042,1511
41292,76F6A54588C8DF7DDADFC50CAA11D44C,31561,1,4,3,109.56792,18.28479,1765
41293,76F6A54588C8DF7DDADFC50CAA11D44C,30854,5,6,1,109.56889,18.27076,1763
41294,76F6A54588C8DF7DDADFC50CAA11D44C,31561,7,9,2,109.56792,18.28479,1765
41386,012ABD06F231728C214A4BA917E75B1C,31561,2,12,10,109.56792,18.28479,1765
41387,012ABD06F231728C214A4BA917E75B1C,30851,12,23,11,109.5616,18.27396,1713
41392,AB25B62B696E140EFF56840EA509FBEC,31021,0,12,12,109.49021,18.27,1463
41393,AB25B62B696E140EFF56840EA509FBEC,31071,16,21,5,109.58257,18.28458,1815
41411,2428138ABBB212CA047CB5D8922FEA6C,31271,16,18,2,109.48958,18.26257,1462
41412,2428138ABBB212CA047CB5D8922FEA6C,31271,20,23,3,109.48958,18.26257,1462
41444,B059BBC33E2156C18B654245B6B48400,31841,0,10,10,109.73201,18.33382,2373
41445,B059BBC33E2156C18B654245B6B48400,31471,14,15,1,109.34583,18.29563,917
41446,B059BBC33E2156C18B654245B6B48400,31471,16,17,1,109.34583,18.29563,917
41463,8468419E5C597B7D73CBDE87F8FF8BC8,38171,0,10,10,109.50799,18.28139,1515
41464,8468419E5C597B7D73CBDE87F8FF8BC8,30721,15,17,2,109.51597,18.28257,1565
41465,8468419E5C597B7D73CBDE87F8FF8BC8,38171,20,23,3,109.50799,18.28139,1515
41470,1980C8D409DE9551539224B3D393CDAA,38991,1,3,2,109.52681,18.30368,1618
41471,1980C8D409DE9551539224B3D393CDAA,30071,6,20,14,109.52819,18.30472,1619
41472,1980C8D409DE9551539224B3D393CDAA,31951,22,23,1,109.52174,18.30299,1568
41503,84E955A0550DCD4ABBE7AEDF9211B01F,31781,14,15,1,109.19847,18.2975,367
41504,84E955A0550DCD4ABBE7AEDF9211B01F,30361,16,18,2,109.50347,18.24,1508
41505,84E955A0550DCD4ABBE7AEDF9211B01F,38111,18,22,4,109.52007,18.22403,1555
41506,635914FBAF9BDB855B8CB450E2AE782A,30571,0,1,1,109.50243,18.21861,1504
41507,635914FBAF9BDB855B8CB450E2AE782A,30051,3,16,13,109.48917,18.21215,1453
41508,635914FBAF9BDB855B8CB450E2AE782A,30571,16,17,1,109.50243,18.21861,1504
41509,635914FBAF9BDB855B8CB450E2AE782A,30051,18,21,3,109.48917,18.21215,1453
41521,D9AE11CD16B231308C3F0FB3F53BC3E9,31071,1,6,5,109.58257,18.28458,1815
41522,D9AE11CD16B231308C3F0FB3F53BC3E9,30854,6,12,6,109.56889,18.27076,1763
41523,D9AE11CD16B231308C3F0FB3F53BC3E9,31071,14,18,4,109.58257,18.28458,1815
41524,D9AE11CD16B231308C3F0FB3F53BC3E9,30854,18,19,1,109.56889,18.27076,1763
41560,983D4F389BF2B6DDDB09B0049946D36C,38951,0,1,1,109.48097,18.28868,1416
41561,983D4F389BF2B6DDDB09B0049946D36C,60614,3,7,4,109.48799,18.29521,1467
41562,983D4F389BF2B6DDDB09B0049946D36C,31031,11,13,2,109.49979,18.25382,1510
41563,983D4F389BF2B6DDDB09B0049946D36C,30771,14,15,1,109.49938,18.26042,1511
41564,983D4F389BF2B6DDDB09B0049946D36C,38951,16,20,4,109.48097,18.28868,1416
41566,FDDBAB9FCE399B704F31A21C4D97D4EB,38361,12,19,7,109.43667,18.29201,1267
41567,FDDBAB9FCE399B704F31A21C4D97D4EB,30671,19,21,2,109.43611,18.30139,1268
41568,FDDBAB9FCE399B704F31A21C4D97D4EB,38361,22,23,1,109.43667,18.29201,1267
41577,EACE20B4A2182292F610DC040D74163A,33521,10,14,4,109.66313,18.45174,2143
41607,8EE2B55B9C0133D9EB3C4198C24C9CD9,31271,0,11,11,109.48958,18.26257,1462
41608,8EE2B55B9C0133D9EB3C4198C24C9CD9,31471,13,14,1,109.34583,18.29563,917
41609,8EE2B55B9C0133D9EB3C4198C24C9CD9,31471,16,17,1,109.34583,18.29563,917
41610,8EE2B55B9C0133D9EB3C4198C24C9CD9,30891,18,23,5,109.59431,18.28389,1865
41618,68CEAA977F13F8E6482609B7352C0B52,30711,15,20,5,109.50271,18.25347,1510
41619,68CEAA977F13F8E6482609B7352C0B52,38127,22,23,1,109.50833,18.27222,1513
41636,37385E5852F0E8B9BD379DD12A67AD23,48574,0,12,12,109.48931,18.28458,1465
41637,37385E5852F0E8B9BD379DD12A67AD23,31145,14,16,2,109.20431,18.30479,369
41713,FD18155FE4FC718630CE71D3DC676309,38251,16,23,7,109.49618,18.25493,1510
41722,8752BC71725B50257436D50C6598F252,31071,0,6,6,109.58257,18.28458,1815
41723,8752BC71725B50257436D50C6598F252,30854,8,21,13,109.56889,18.27076,1763
41727,653802FBFFAEB319D5E2987830A7AC5C,60281,0,19,19,109.51743,18.25924,1561
41728,653802FBFFAEB319D5E2987830A7AC5C,30461,20,23,3,109.5116,18.26313,1562
41761,B65A42EE158A1686688454429BA4F642,39321,1,9,8,109.529,18.2167,1604
41762,B65A42EE158A1686688454429BA4F642,31521,11,14,3,109.51458,18.22542,1555
41763,B65A42EE158A1686688454429BA4F642,39321,18,19,1,109.529,18.2167,1604
41764,B65A42EE158A1686688454429BA4F642,39111,20,22,2,109.5191,18.22597,1555
41765,B65A42EE158A1686688454429BA4F642,60381,22,23,1,109.5241,18.22458,1605
41799,08077B5D5F0A9938A81D328635D03C8B,30854,1,6,5,109.56889,18.27076,1763
41800,08077B5D5F0A9938A81D328635D03C8B,31071,10,11,1,109.58257,18.28458,1815
41801,08077B5D5F0A9938A81D328635D03C8B,30854,13,22,9,109.56889,18.27076,1763
41804,189633BA4D39EBA8A203BC9E364D4B1F,30381,1,8,7,109.52521,18.24507,1609
41805,189633BA4D39EBA8A203BC9E364D4B1F,30051,12,14,2,109.48917,18.21215,1453
41806,189633BA4D39EBA8A203BC9E364D4B1F,38291,14,16,2,109.51618,18.24313,1558
41816,7BBB2DDEDB0AE43F8CE7FBD1FCB52741,31071,1,7,6,109.58257,18.28458,1815
41817,7BBB2DDEDB0AE43F8CE7FBD1FCB52741,30854,7,8,1,109.56889,18.27076,1763
41818,7BBB2DDEDB0AE43F8CE7FBD1FCB52741,31071,9,20,11,109.58257,18.28458,1815
41819,C983E73D646629A775690ECA8920EB29,31631,0,1,1,109.59542,18.36826,1879
41820,C983E73D646629A775690ECA8920EB29,30101,3,20,17,109.57299,18.33333,1773
41828,DB6D9FFA46279E97CED98B6CF908C718,60411,4,10,6,109.32514,18.30854,869
41829,DB6D9FFA46279E97CED98B6CF908C718,38754,12,14,2,109.74667,18.37382,2430
41830,DB6D9FFA46279E97CED98B6CF908C718,38871,15,16,1,109.44681,18.28625,1316
41831,DB6D9FFA46279E97CED98B6CF908C718,31471,17,19,2,109.34583,18.29563,917
41844,5B1793F390E8BE5126CF433016029F77,31161,0,9,9,109.70229,18.31361,2270
41845,5B1793F390E8BE5126CF433016029F77,38751,14,17,3,109.74903,18.37639,2481
41846,5B1793F390E8BE5126CF433016029F77,31201,20,21,1,109.51042,18.23819,1558
41847,5B1793F390E8BE5126CF433016029F77,31161,22,23,1,109.70229,18.31361,2270
41935,377A324496E54511961704972731A3D5,38121,13,14,1,109.51361,18.27813,1564
41936,377A324496E54511961704972731A3D5,31521,17,18,1,109.51458,18.22542,1555
41937,377A324496E54511961704972731A3D5,31821,21,23,2,109.51181,18.24924,1559
41981,3011558B901D7A197828D36F3A7146BE,30361,0,9,9,109.50347,18.24,1508
41982,3011558B901D7A197828D36F3A7146BE,60054,11,12,1,109.3016,18.31229,770
41983,3011558B901D7A197828D36F3A7146BE,31471,13,15,2,109.34583,18.29563,917
42026,3AA78C75CDB56F7940531D4F95789DAF,31781,16,17,1,109.19847,18.2975,367
42027,3AA78C75CDB56F7940531D4F95789DAF,38251,19,20,1,109.49618,18.25493,1510
42028,3AA78C75CDB56F7940531D4F95789DAF,31271,21,23,2,109.48958,18.26257,1462
42029,104EFBF239A23046252D07031DBBF3A9,60231,1,3,2,109.49903,18.21972,1504
42030,104EFBF239A23046252D07031DBBF3A9,30571,4,8,4,109.50243,18.21861,1504
42031,104EFBF239A23046252D07031DBBF3A9,39301,9,13,4,109.48361,18.21153,1453
42032,104EFBF239A23046252D07031DBBF3A9,60401,14,15,1,109.47444,18.27583,1414
42033,104EFBF239A23046252D07031DBBF3A9,30571,17,20,3,109.50243,18.21861,1504
42034,104EFBF239A23046252D07031DBBF3A9,60231,21,23,2,109.49903,18.21972,1504
42059,117CDF2D41FFFF099F62724091D8605A,60631,7,9,2,109.57778,18.27583,1814
42060,117CDF2D41FFFF099F62724091D8605A,38911,11,13,2,109.51674,18.24965,1559
42061,117CDF2D41FFFF099F62724091D8605A,30854,14,15,1,109.56889,18.27076,1763
42074,9AA959ED87D1ECC3053DED17290EFCBD,31561,10,11,1,109.56792,18.28479,1765
42075,9AA959ED87D1ECC3053DED17290EFCBD,39183,13,14,1,109.55542,18.28208,1715
42076,9AA959ED87D1ECC3053DED17290EFCBD,31561,18,19,1,109.56792,18.28479,1765
42077,9AA959ED87D1ECC3053DED17290EFCBD,30854,22,23,1,109.56889,18.27076,1763
42081,0E4E3873A84F880D37A184F5409B3BB0,38826,0,7,7,109.50326,18.25514,1510
42082,0E4E3873A84F880D37A184F5409B3BB0,31311,11,15,4,109.72299,18.27438,2364
42083,0E4E3873A84F880D37A184F5409B3BB0,38826,17,21,4,109.50326,18.25514,1510
42084,0E4E3873A84F880D37A184F5409B3BB0,60381,21,23,2,109.5241,18.22458,1605
42109,7890099D98AA300C5BF12527E7372DB0,60631,0,7,7,109.57778,18.27583,1814
42110,7890099D98AA300C5BF12527E7372DB0,31071,9,10,1,109.58257,18.28458,1815
42111,7890099D98AA300C5BF12527E7372DB0,60631,12,14,2,109.57778,18.27583,1814
42112,7890099D98AA300C5BF12527E7372DB0,30854,16,18,2,109.56889,18.27076,1763
42113,7890099D98AA300C5BF12527E7372DB0,60631,18,23,5,109.57778,18.27583,1814
42120,B1CDB845FD43C065DBB8ADFB7BB832CF,60381,0,9,9,109.5241,18.22458,1605
42121,B1CDB845FD43C065DBB8ADFB7BB832CF,60054,12,14,2,109.3016,18.31229,770
42122,B1CDB845FD43C065DBB8ADFB7BB832CF,31521,17,18,1,109.51458,18.22542,1555
42145,C6812E7C0E8E7B7313DC722FACB50779,30854,0,13,13,109.56889,18.27076,1763
42146,C6812E7C0E8E7B7313DC722FACB50779,31071,13,14,1,109.58257,18.28458,1815
42147,C6812E7C0E8E7B7313DC722FACB50779,30854,14,17,3,109.56889,18.27076,1763
42148,C6812E7C0E8E7B7313DC722FACB50779,60631,17,18,1,109.57778,18.27583,1814
42149,C6812E7C0E8E7B7313DC722FACB50779,30854,21,23,2,109.56889,18.27076,1763
42176,F9495F66439606D360743D0ECE9C8939,31471,16,18,2,109.34583,18.29563,917
42177,F9495F66439606D360743D0ECE9C8939,30201,21,23,2,109.4909,18.26465,1462
42196,667C95EE70813FD5688175AD35041F35,31521,0,14,14,109.51458,18.22542,1555
42197,667C95EE70813FD5688175AD35041F35,31471,15,17,2,109.34583,18.29563,917
42198,667C95EE70813FD5688175AD35041F35,60411,18,19,1,109.32514,18.30854,869
42199,667C95EE70813FD5688175AD35041F35,38071,20,21,1,109.40722,18.30938,1169
42212,32D0EBFA645FCE8DAD65D018847E5043,30232,1,7,6,109.6191,18.31701,1971
42213,32D0EBFA645FCE8DAD65D018847E5043,30854,7,17,10,109.56889,18.27076,1763
42214,32D0EBFA645FCE8DAD65D018847E5043,30232,22,23,1,109.6191,18.31701,1971
42228,2261FA59C58CA1DB4ED476451BEA0AD4,48574,0,9,9,109.48931,18.28458,1465
42229,2261FA59C58CA1DB4ED476451BEA0AD4,30341,11,14,3,109.3625,18.29167,966
42230,2261FA59C58CA1DB4ED476451BEA0AD4,60221,15,17,2,109.52569,18.29188,1616
42231,2261FA59C58CA1DB4ED476451BEA0AD4,31864,19,21,2,109.49014,18.28333,1465
42248,4CC3058F56A42FB99DF66B1D4EA3395F,30081,0,8,8,109.50243,18.26632,1512
42249,4CC3058F56A42FB99DF66B1D4EA3395F,33521,13,14,1,109.66313,18.45174,2143
42250,4CC3058F56A42FB99DF66B1D4EA3395F,30771,15,18,3,109.49938,18.26042,1511
42251,4CC3058F56A42FB99DF66B1D4EA3395F,60291,20,21,1,109.50826,18.24639,1509
42252,4CC3058F56A42FB99DF66B1D4EA3395F,30421,21,23,2,109.50021,18.25861,1511
42265,494A811FCF2737ED3FFA69BD83875999,38017,10,15,5,109.49729,18.21424,1504
42266,494A811FCF2737ED3FFA69BD83875999,31261,16,17,1,109.51174,18.2466,1559
42267,494A811FCF2737ED3FFA69BD83875999,38017,20,22,2,109.49729,18.21424,1504
42270,D7691351C1D270A735CC5E329CBD1B0D,38961,0,1,1,109.50847,18.23514,1507
42271,D7691351C1D270A735CC5E329CBD1B0D,38971,2,14,12,109.50743,18.25125,1510
42272,D7691351C1D270A735CC5E329CBD1B0D,60401,19,21,2,109.47444,18.27583,1414
42273,D7691351C1D270A735CC5E329CBD1B0D,60201,21,23,2,109.5041,18.2509,1510
42298,40285EE8CCE25C38988EC087545664EC,31071,0,7,7,109.58257,18.28458,1815
42299,40285EE8CCE25C38988EC087545664EC,30854,9,22,13,109.56889,18.27076,1763
42322,41559587820EDAC647856A7555135196,30351,1,9,8,109.41701,18.29292,1217
42323,41559587820EDAC647856A7555135196,60054,12,14,2,109.3016,18.31229,770
42324,41559587820EDAC647856A7555135196,30351,14,23,9,109.41701,18.29292,1217
42378,15C75AF46ECCD283F35270238206A211,31521,0,9,9,109.51458,18.22542,1555
42379,15C75AF46ECCD283F35270238206A211,30341,9,11,2,109.3625,18.29167,966
42380,15C75AF46ECCD283F35270238206A211,30661,12,14,2,109.37028,18.24361,1008
42408,688D348A33B22EDABB9FBB91115A631A,31321,0,9,9,109.63799,18.23201,2007
42409,688D348A33B22EDABB9FBB91115A631A,60054,13,14,1,109.3016,18.31229,770
42410,688D348A33B22EDABB9FBB91115A631A,31321,16,23,7,109.63799,18.23201,2007
42440,2B60907F04C29DE058B3E64B1D3B4100,31561,0,9,9,109.56792,18.28479,1765
42441,2B60907F04C29DE058B3E64B1D3B4100,30854,10,13,3,109.56889,18.27076,1763
42442,2B60907F04C29DE058B3E64B1D3B4100,31561,13,15,2,109.56792,18.28479,1765
42443,2B60907F04C29DE058B3E64B1D3B4100,30854,16,22,6,109.56889,18.27076,1763
42444,2B60907F04C29DE058B3E64B1D3B4100,31561,22,23,1,109.56792,18.28479,1765
42455,8A19D38C67DEBBE2072401E23B2467C5,30191,18,19,1,109.50361,18.22701,1506
42456,8A19D38C67DEBBE2072401E23B2467C5,31161,21,23,2,109.70229,18.31361,2270
42461,FD5B9AB034F15F72E8BEF02193669238,60241,8,10,2,109.53319,18.28667,1616
42462,FD5B9AB034F15F72E8BEF02193669238,31931,10,11,1,109.54771,18.29403,1667
42463,FD5B9AB034F15F72E8BEF02193669238,60241,12,14,2,109.53319,18.28667,1616
42464,FD5B9AB034F15F72E8BEF02193669238,31931,14,16,2,109.54771,18.29403,1667
42465,FD5B9AB034F15F72E8BEF02193669238,60241,18,19,1,109.53319,18.28667,1616
42483,E393AE4487D1B35F053473F2BB0639D8,60614,11,12,1,109.48799,18.29521,1467
42484,E393AE4487D1B35F053473F2BB0639D8,31145,15,16,1,109.20431,18.30479,369
42485,E393AE4487D1B35F053473F2BB0639D8,31861,19,20,1,109.49042,18.27549,1464
42486,E393AE4487D1B35F053473F2BB0639D8,30391,21,22,1,109.4975,18.27118,1513
42497,770024D3A15B5B9DACFBC750336F966D,30861,16,23,7,109.52722,18.22743,1606
42504,04ABA8BFD5D63DDF1B83BA0577C9019C,31421,2,4,2,109.55382,18.22347,1705
42505,04ABA8BFD5D63DDF1B83BA0577C9019C,39183,6,7,1,109.55542,18.28208,1715
42541,AC0E940CA4876D60068799AC7DD06B30,31391,0,11,11,109.50382,18.24285,1508
42542,AC0E940CA4876D60068799AC7DD06B30,30211,13,14,1,109.49882,18.23931,1508
42543,AC0E940CA4876D60068799AC7DD06B30,38754,16,20,4,109.74667,18.37382,2430
42544,AC0E940CA4876D60068799AC7DD06B30,31391,21,22,1,109.50382,18.24285,1508
42551,5CFFF8D919E96524101209E188C669B3,31951,0,7,7,109.52174,18.30299,1568
42552,5CFFF8D919E96524101209E188C669B3,31761,8,9,1,109.60521,18.27965,1914
42565,E9E473F09C342630187345312F4A31D8,39181,0,9,9,109.55153,18.28035,1715
42566,E9E473F09C342630187345312F4A31D8,39181,10,18,8,109.55153,18.28035,1715
42567,E9E473F09C342630187345312F4A31D8,60361,19,20,1,109.51938,18.29681,1567
42568,E9E473F09C342630187345312F4A31D8,39181,21,23,2,109.55153,18.28035,1715
42569,B4D280332D4864EE44777CDB8551463D,31461,0,8,8,109.5091,18.25389,1510
42570,B4D280332D4864EE44777CDB8551463D,31781,10,11,1,109.19847,18.2975,367
42572,B4D280332D4864EE44777CDB8551463D,31461,20,23,3,109.5091,18.25389,1510
42581,9D7F04124F972FD96F04746E3F4BE9E0,31781,12,13,1,109.19847,18.2975,367
42582,9D7F04124F972FD96F04746E3F4BE9E0,31471,14,15,1,109.34583,18.29563,917
42583,9D7F04124F972FD96F04746E3F4BE9E0,31671,18,19,1,109.38965,18.29813,1068
42584,08A066736557478B1013C0CF834491DF,30921,0,7,7,109.53903,18.29451,1667
42585,08A066736557478B1013C0CF834491DF,31931,10,23,13,109.54771,18.29403,1667
42618,06540DDC6C869D24F26FD34ED45D168E,38325,1,10,9,109.39792,18.2909,1116
42619,06540DDC6C869D24F26FD34ED45D168E,31145,12,14,2,109.20431,18.30479,369
42620,06540DDC6C869D24F26FD34ED45D168E,30711,17,19,2,109.50271,18.25347,1510
42624,95130D5AB1FAFE982946B601FB0CB133,60161,16,19,3,109.49174,18.26181,1461
42625,95130D5AB1FAFE982946B601FB0CB133,60401,20,23,3,109.47444,18.27583,1414
42631,E75CF54BA14775FEDD26504F9F6B7365,31561,15,17,2,109.56792,18.28479,1765
42632,E75CF54BA14775FEDD26504F9F6B7365,30851,17,18,1,109.5616,18.27396,1713
42633,E75CF54BA14775FEDD26504F9F6B7365,31945,20,21,1,109.58021,18.29403,1817
42634,00FC332040A284DA251A8D0705989FE9,31071,1,13,12,109.58257,18.28458,1815
42635,00FC332040A284DA251A8D0705989FE9,30854,14,15,1,109.56889,18.27076,1763
42646,40EFEC8E77CE7DC1304A309568559076,38212,0,11,11,109.48889,18.26306,1462
42647,40EFEC8E77CE7DC1304A309568559076,31471,12,15,3,109.34583,18.29563,917
42648,40EFEC8E77CE7DC1304A309568559076,31471,17,18,1,109.34583,18.29563,917
42649,40EFEC8E77CE7DC1304A309568559076,38271,20,21,1,109.62632,18.23049,1956
42650,40EFEC8E77CE7DC1304A309568559076,31321,22,23,1,109.63799,18.23201,2007
42670,56DFEAF03DB999C001DE943D9823E4CB,31531,0,2,2,109.49583,18.25972,1461
42671,56DFEAF03DB999C001DE943D9823E4CB,60401,5,8,3,109.47444,18.27583,1414
42672,56DFEAF03DB999C001DE943D9823E4CB,31531,11,16,5,109.49583,18.25972,1461
42673,56DFEAF03DB999C001DE943D9823E4CB,31031,17,19,2,109.49979,18.25382,1510
42674,60C76AD19DF8888A84F620E94C92FF2B,30571,8,12,4,109.50243,18.21861,1504
42675,60C76AD19DF8888A84F620E94C92FF2B,60231,13,14,1,109.49903,18.21972,1504
42676,60C76AD19DF8888A84F620E94C92FF2B,30571,15,23,8,109.50243,18.21861,1504
42677,A9687DB826AE3C93D5CD961A912865D6,38094,0,7,7,109.45403,18.28778,1316
42678,A9687DB826AE3C93D5CD961A912865D6,30661,10,11,1,109.37028,18.24361,1008
42679,A9687DB826AE3C93D5CD961A912865D6,31471,15,16,1,109.34583,18.29563,917
42680,A9687DB826AE3C93D5CD961A912865D6,31531,18,20,2,109.49583,18.25972,1461
42681,A9687DB826AE3C93D5CD961A912865D6,38094,21,23,2,109.45403,18.28778,1316
42704,4B14D70D67BD817E96B015ABCEF5D17B,38911,0,2,2,109.51674,18.24965,1559
42705,4B14D70D67BD817E96B015ABCEF5D17B,31301,5,12,7,109.14493,18.31222,170
42706,4B14D70D67BD817E96B015ABCEF5D17B,30381,13,16,3,109.52521,18.24507,1609
42707,4B14D70D67BD817E96B015ABCEF5D17B,60281,18,23,5,109.51743,18.25924,1561
42710,5169AE4C4AE9067320D7FAAA8A39A4BE,31511,0,8,8,109.26326,18.40521,635
42712,5169AE4C4AE9067320D7FAAA8A39A4BE,31511,17,23,6,109.26326,18.40521,635
42735,7C53E1516813111F7584C70DC82C3E1E,31031,0,9,9,109.49979,18.25382,1510
42736,7C53E1516813111F7584C70DC82C3E1E,39021,10,13,3,109.40368,18.41035,1186
42737,7C53E1516813111F7584C70DC82C3E1E,31031,15,17,2,109.49979,18.25382,1510
42738,7C53E1516813111F7584C70DC82C3E1E,31201,18,19,1,109.51042,18.23819,1558
42739,7C53E1516813111F7584C70DC82C3E1E,30711,21,23,2,109.50271,18.25347,1510
42745,F6CCF646674665C449464A30D23BCEEF,30271,0,16,16,109.49132,18.23153,1456
42746,F6CCF646674665C449464A30D23BCEEF,38251,17,18,1,109.49618,18.25493,1510
42747,8DA877D3A30401F86E81FB7BC1CA2A00,30854,0,7,7,109.56889,18.27076,1763
42748,8DA877D3A30401F86E81FB7BC1CA2A00,60361,12,15,3,109.51938,18.29681,1567
42749,8DA877D3A30401F86E81FB7BC1CA2A00,31071,19,21,2,109.58257,18.28458,1815
42760,2AE38FAF341950B0B91404FFCE5A0F3E,39183,0,6,6,109.55542,18.28208,1715
42761,2AE38FAF341950B0B91404FFCE5A0F3E,30921,7,12,5,109.53903,18.29451,1667
42762,2AE38FAF341950B0B91404FFCE5A0F3E,31931,13,14,1,109.54771,18.29403,1667
42835,63DE0122FF7AF14798CDE9006100D774,38754,15,17,2,109.74667,18.37382,2430
42836,63DE0122FF7AF14798CDE9006100D774,38484,18,19,1,109.53028,18.31528,1620
42837,63DE0122FF7AF14798CDE9006100D774,38821,20,23,3,109.50354,18.25243,1510
42855,14AE6C820CE45F96077630992CABD33D,31551,1,14,13,109.55868,18.24222,1708
42856,14AE6C820CE45F96077630992CABD33D,30851,15,16,1,109.5616,18.27396,1713
42857,14AE6C820CE45F96077630992CABD33D,31551,17,18,1,109.55868,18.24222,1708
42905,B34415F599F0ED7D1A073EE314A60B9B,31671,0,10,10,109.38965,18.29813,1068
42906,B34415F599F0ED7D1A073EE314A60B9B,60041,10,12,2,109.39889,18.31944,1121
42907,B34415F599F0ED7D1A073EE314A60B9B,60541,12,13,1,109.4084,18.29208,1167
42908,B34415F599F0ED7D1A073EE314A60B9B,31671,16,18,2,109.38965,18.29813,1068
42909,B34415F599F0ED7D1A073EE314A60B9B,60041,19,22,3,109.39889,18.31944,1121
42927,3D1C26E17AD3339BBD6A6505EC18047F,31201,0,9,9,109.51042,18.23819,1558
42928,3D1C26E17AD3339BBD6A6505EC18047F,38291,10,13,3,109.51618,18.24313,1558
42929,3D1C26E17AD3339BBD6A6505EC18047F,31201,13,17,4,109.51042,18.23819,1558
42930,3D1C26E17AD3339BBD6A6505EC18047F,60311,19,21,2,109.52097,18.24319,1558
42937,545A608945D9F6A83833DD1074D20FCD,31471,14,16,2,109.34583,18.29563,917
42938,545A608945D9F6A83833DD1074D20FCD,30854,19,20,1,109.56889,18.27076,1763
42969,8CD15CF6B5FB4821940FF9AFE6D6CB84,39181,0,6,6,109.55153,18.28035,1715
42970,8CD15CF6B5FB4821940FF9AFE6D6CB84,31931,7,10,3,109.54771,18.29403,1667
42971,8CD15CF6B5FB4821940FF9AFE6D6CB84,39181,10,21,11,109.55153,18.28035,1715
42974,E0A24740E2C54F3B77DB561A91D2BED7,31821,3,4,1,109.51181,18.24924,1559
42975,E0A24740E2C54F3B77DB561A91D2BED7,30251,8,17,9,109.50611,18.26653,1512
42976,E0A24740E2C54F3B77DB561A91D2BED7,30711,18,20,2,109.50271,18.25347,1510
42977,E0A24740E2C54F3B77DB561A91D2BED7,30151,21,22,1,109.50986,18.25083,1560
42982,248CE0B148D688C343222BB27AEE2380,31071,1,5,4,109.58257,18.28458,1815
42983,248CE0B148D688C343222BB27AEE2380,30854,9,19,10,109.56889,18.27076,1763
43004,F113DDC78FC5471ED8A23532B5EF78E0,30181,0,10,10,109.51597,18.23313,1557
43005,F113DDC78FC5471ED8A23532B5EF78E0,31031,10,11,1,109.49979,18.25382,1510
43006,F113DDC78FC5471ED8A23532B5EF78E0,30181,12,19,7,109.51597,18.23313,1557
43007,F113DDC78FC5471ED8A23532B5EF78E0,31521,19,20,1,109.51458,18.22542,1555
43008,F113DDC78FC5471ED8A23532B5EF78E0,30181,22,23,1,109.51597,18.23313,1557
43039,D7F545CDB740917BC3BFA2B57C1003E1,60011,14,18,4,109.48965,18.30222,1468
43040,D7F545CDB740917BC3BFA2B57C1003E1,60031,19,20,1,109.49694,18.31632,1521
43047,44BEBA2727205520AE9AF3AB76A75967,38871,1,2,1,109.44681,18.28625,1316
43048,44BEBA2727205520AE9AF3AB76A75967,31231,2,9,7,109.42597,18.29292,1217
43049,44BEBA2727205520AE9AF3AB76A75967,30361,12,23,11,109.50347,18.24,1508
43053,A71E0E95457402DD3D59C9873DD44764,31471,17,19,2,109.34583,18.29563,917
43054,A71E0E95457402DD3D59C9873DD44764,31691,19,22,3,109.36604,18.3075,1019
43064,9C7BAF149C969E12C7E00E6FCA4D0F9D,31321,0,3,3,109.63799,18.23201,2007
43065,9C7BAF149C969E12C7E00E6FCA4D0F9D,30581,6,8,2,109.62257,18.24951,1959
43066,9C7BAF149C969E12C7E00E6FCA4D0F9D,31321,9,12,3,109.63799,18.23201,2007
43067,9C7BAF149C969E12C7E00E6FCA4D0F9D,30671,14,21,7,109.43611,18.30139,1268
43084,79552C9BA7D6D0482C348613B3829C6B,39151,1,2,1,109.49875,18.25097,1510
43085,79552C9BA7D6D0482C348613B3829C6B,31181,5,23,18,109.50382,18.24813,1509
43151,F40E3F81DC1CBEED8C7FE1B2171B6EA7,31031,11,12,1,109.49979,18.25382,1510
43210,D622AAD01DD5982861A246970AE90D47,39111,20,22,2,109.5191,18.22597,1555
43211,7094512B15E4EF60EF67A3E6DEAF677A,60594,0,6,6,109.62694,18.22799,1956
43212,7094512B15E4EF60EF67A3E6DEAF677A,38052,8,9,1,109.62618,18.23042,1956
43213,7094512B15E4EF60EF67A3E6DEAF677A,33051,12,14,2,109.6475,18.46618,2096
43214,7094512B15E4EF60EF67A3E6DEAF677A,38052,15,20,5,109.62618,18.23042,1956
43215,7094512B15E4EF60EF67A3E6DEAF677A,60594,20,23,3,109.62694,18.22799,1956
43220,622234A65D292D040A9E438A2770674C,30851,0,7,7,109.5616,18.27396,1713
43221,622234A65D292D040A9E438A2770674C,31561,10,11,1,109.56792,18.28479,1765
43222,622234A65D292D040A9E438A2770674C,30851,12,23,11,109.5616,18.27396,1713
43261,38CF8AD578A393476F29705A4599B8B1,38891,0,10,10,109.51486,18.24118,1558
43262,38CF8AD578A393476F29705A4599B8B1,31321,11,12,1,109.63799,18.23201,2007
43263,38CF8AD578A393476F29705A4599B8B1,31571,12,14,2,109.61563,18.23326,1957
43264,38CF8AD578A393476F29705A4599B8B1,60211,14,16,2,109.63549,18.26049,2011
43312,0AE94CE0906371E5C953A3B589C7696A,60524,0,9,9,109.42951,18.28993,1216
43313,0AE94CE0906371E5C953A3B589C7696A,31471,11,13,2,109.34583,18.29563,917
43314,0AE94CE0906371E5C953A3B589C7696A,60054,14,15,1,109.3016,18.31229,770
43315,0AE94CE0906371E5C953A3B589C7696A,38683,19,23,4,109.4266,18.29097,1216
43378,14F1CC63CDA098F9694EAC8584B9C7A5,31561,0,13,13,109.56792,18.28479,1765
43379,14F1CC63CDA098F9694EAC8584B9C7A5,30854,14,15,1,109.56889,18.27076,1763
43405,1BC010F6BA936B1BC6461BB11F6A6D07,31181,13,15,2,109.50382,18.24813,1509
43406,1BC010F6BA936B1BC6461BB11F6A6D07,60291,15,17,2,109.50826,18.24639,1509
43407,1BC010F6BA936B1BC6461BB11F6A6D07,31321,18,19,1,109.63799,18.23201,2007
43408,1BC010F6BA936B1BC6461BB11F6A6D07,60211,20,22,2,109.63549,18.26049,2011
43472,1D8B814EC83D52D7C5F3FED99C129EE0,60631,2,3,1,109.57778,18.27583,1814
43473,1D8B814EC83D52D7C5F3FED99C129EE0,30854,4,9,5,109.56889,18.27076,1763
43474,1D8B814EC83D52D7C5F3FED99C129EE0,38271,10,20,10,109.62632,18.23049,1956
43519,2EE87E32F61D076A80AF4573D60352AD,38951,13,17,4,109.48097,18.28868,1416
43520,2EE87E32F61D076A80AF4573D60352AD,38951,20,21,1,109.48097,18.28868,1416
43521,2EE87E32F61D076A80AF4573D60352AD,38951,21,23,2,109.48097,18.28868,1416
43566,3340DD955EDB97C88115D8B367138332,60391,0,11,11,109.47667,18.28757,1416
43567,3340DD955EDB97C88115D8B367138332,60391,13,16,3,109.47667,18.28757,1416
43568,3340DD955EDB97C88115D8B367138332,48645,20,22,2,109.48597,18.29299,1467
43629,08DA3CFA22819D4D1B43402F03528A0D,31521,0,1,1,109.51458,18.22542,1555
43630,08DA3CFA22819D4D1B43402F03528A0D,30861,2,13,11,109.52722,18.22743,1606
43631,08DA3CFA22819D4D1B43402F03528A0D,39111,14,16,2,109.5191,18.22597,1555
43682,18AAFF817ACB01445A8E56AB6C7AC8DB,38951,18,22,4,109.48097,18.28868,1416
43688,94C6B6D07606799F9DD78C376ADCB85C,60281,0,5,5,109.51743,18.25924,1561
43689,94C6B6D07606799F9DD78C376ADCB85C,30151,7,8,1,109.50986,18.25083,1560
43690,94C6B6D07606799F9DD78C376ADCB85C,60201,8,10,2,109.5041,18.2509,1510
43691,94C6B6D07606799F9DD78C376ADCB85C,38911,11,13,2,109.51674,18.24965,1559
43692,94C6B6D07606799F9DD78C376ADCB85C,60281,14,18,4,109.51743,18.25924,1561
43693,94C6B6D07606799F9DD78C376ADCB85C,38061,19,20,1,109.50597,18.23118,1506
43694,94C6B6D07606799F9DD78C376ADCB85C,30361,20,21,1,109.50347,18.24,1508
43702,2D115D52FDAB55086A12D742071FDFC9,30232,0,10,10,109.6191,18.31701,1971
43703,2D115D52FDAB55086A12D742071FDFC9,30854,12,16,4,109.56889,18.27076,1763
43704,2D115D52FDAB55086A12D742071FDFC9,30232,17,19,2,109.6191,18.31701,1971
43705,2D115D52FDAB55086A12D742071FDFC9,30854,20,22,2,109.56889,18.27076,1763
43711,FD99026B657D830B20F9D76D7C087CF9,38094,0,8,8,109.45403,18.28778,1316
43712,FD99026B657D830B20F9D76D7C087CF9,60381,11,13,2,109.5241,18.22458,1605
43713,FD99026B657D830B20F9D76D7C087CF9,38094,14,17,3,109.45403,18.28778,1316
43714,FD99026B657D830B20F9D76D7C087CF9,31031,18,21,3,109.49979,18.25382,1510
43715,FD99026B657D830B20F9D76D7C087CF9,38094,21,23,2,109.45403,18.28778,1316
43730,CD576E44D9D4928B8C41CE5BA0D78E9B,31931,12,16,4,109.54771,18.29403,1667
43731,CD576E44D9D4928B8C41CE5BA0D78E9B,39181,18,23,5,109.55153,18.28035,1715
43750,850F414E89CB3AC3E862CBFA17778006,30571,0,10,10,109.50243,18.21861,1504
43751,850F414E89CB3AC3E862CBFA17778006,31521,11,12,1,109.51458,18.22542,1555
43752,850F414E89CB3AC3E862CBFA17778006,60041,16,23,7,109.39889,18.31944,1121
43771,452F0FF6BC36839041DCBEF2292D6E55,38127,0,10,10,109.50833,18.27222,1513
43772,452F0FF6BC36839041DCBEF2292D6E55,38157,11,15,4,109.51483,18.26958,1563
43773,452F0FF6BC36839041DCBEF2292D6E55,30361,16,18,2,109.50347,18.24,1508
43774,452F0FF6BC36839041DCBEF2292D6E55,38251,18,19,1,109.49618,18.25493,1510
43775,452F0FF6BC36839041DCBEF2292D6E55,38127,22,23,1,109.50833,18.27222,1513
43788,5D8CEDE1DBBC134D191D1BBEC2BD5BCD,60524,0,7,7,109.42951,18.28993,1216
43798,23019CE071DC0B0CEC6E78ADA422CE57,38973,0,13,13,109.51097,18.25389,1560
43799,23019CE071DC0B0CEC6E78ADA422CE57,38754,14,16,2,109.74667,18.37382,2430
43800,23019CE071DC0B0CEC6E78ADA422CE57,31391,19,20,1,109.50382,18.24285,1508
43801,23019CE071DC0B0CEC6E78ADA422CE57,30151,21,23,2,109.50986,18.25083,1560
43802,C462628FF36F8FF2D0B7493E6DDA38BB,30661,2,8,6,109.37028,18.24361,1008
43803,C462628FF36F8FF2D0B7493E6DDA38BB,60411,8,9,1,109.32514,18.30854,869
43804,C462628FF36F8FF2D0B7493E6DDA38BB,30661,10,19,9,109.37028,18.24361,1008
43805,C462628FF36F8FF2D0B7493E6DDA38BB,60411,21,23,2,109.32514,18.30854,869
43809,B7ADBAC4A77BC50F432A788B21FD4A34,31431,10,15,5,109.44639,18.29042,1316
43810,B7ADBAC4A77BC50F432A788B21FD4A34,60381,16,19,3,109.5241,18.22458,1605
43825,B29F33564DDA3CFA905BF42633BA4302,31205,0,1,1,109.51111,18.23736,1557
43826,B29F33564DDA3CFA905BF42633BA4302,60614,3,13,10,109.48799,18.29521,1467
43827,B29F33564DDA3CFA905BF42633BA4302,60291,14,16,2,109.50826,18.24639,1509
43828,B29F33564DDA3CFA905BF42633BA4302,60411,18,23,5,109.32514,18.30854,869
43850,6A96BADFE00274340CC18F957A412DF2,30421,13,16,3,109.50021,18.25861,1511
43853,F8D799D9161B0143E0D71C40472A357E,30071,0,16,16,109.52819,18.30472,1619
43854,F8D799D9161B0143E0D71C40472A357E,30711,18,20,2,109.50271,18.25347,1510
43855,F8D799D9161B0143E0D71C40472A357E,30071,22,23,1,109.52819,18.30472,1619
43858,599AFAF71D30C85AA4E0085C43FF5E03,30051,2,9,7,109.48917,18.21215,1453
43859,599AFAF71D30C85AA4E0085C43FF5E03,60235,11,12,1,109.49269,18.2253,1455
43860,599AFAF71D30C85AA4E0085C43FF5E03,31421,16,17,1,109.55382,18.22347,1705
43861,4BA42026831E7F4B42D17FDF4BDEE62E,31931,1,8,7,109.54771,18.29403,1667
43862,4BA42026831E7F4B42D17FDF4BDEE62E,39181,8,10,2,109.55153,18.28035,1715
43863,4BA42026831E7F4B42D17FDF4BDEE62E,31931,13,15,2,109.54771,18.29403,1667
43864,4BA42026831E7F4B42D17FDF4BDEE62E,39181,16,18,2,109.55153,18.28035,1715
43865,4BA42026831E7F4B42D17FDF4BDEE62E,38315,19,21,2,109.48979,18.29764,1467
43870,8BDE8C6966F9C7122ABA59EA6C195945,31171,18,19,1,109.50938,18.24917,1559
43871,8BDE8C6966F9C7122ABA59EA6C195945,31081,20,23,3,109.44639,18.30181,1318
43901,4DB51FB607DF400B9FA557F761A7BFBF,31311,10,16,6,109.72299,18.27438,2364
43902,4DB51FB607DF400B9FA557F761A7BFBF,38391,20,23,3,109.44111,18.29083,1266
43906,7BF65E5054DA81A230AB5423620158E1,60631,0,7,7,109.57778,18.27583,1814
43907,7BF65E5054DA81A230AB5423620158E1,30854,9,12,3,109.56889,18.27076,1763
43908,7BF65E5054DA81A230AB5423620158E1,31071,17,18,1,109.58257,18.28458,1815
43909,7BF65E5054DA81A230AB5423620158E1,30854,20,22,2,109.56889,18.27076,1763
43915,5C9B70CEEA6B4F63E437274BF151DF2C,31471,15,17,2,109.34583,18.29563,917
43916,5C9B70CEEA6B4F63E437274BF151DF2C,39111,19,23,4,109.5191,18.22597,1555
43923,FCF69C4EB20A61D7801C0D8953A36537,31071,0,13,13,109.58257,18.28458,1815
43924,FCF69C4EB20A61D7801C0D8953A36537,30851,15,16,1,109.5616,18.27396,1713
43925,FCF69C4EB20A61D7801C0D8953A36537,31071,19,23,4,109.58257,18.28458,1815
43936,F31EF896F79B80EE579B410C7A108E36,38251,0,8,8,109.49618,18.25493,1510
43937,F31EF896F79B80EE579B410C7A108E36,31031,12,14,2,109.49979,18.25382,1510
43938,F31EF896F79B80EE579B410C7A108E36,30351,14,16,2,109.41701,18.29292,1217
43939,E9CDFE5A4E319AABCB1BB5066094528A,60084,1,3,2,109.4984,18.2334,1507
43940,E9CDFE5A4E319AABCB1BB5066094528A,30271,4,7,3,109.49132,18.23153,1456
43949,ADA7B055F17CD683C10482B3BCB22A75,60491,1,3,2,109.43354,18.30847,1269
43950,ADA7B055F17CD683C10482B3BCB22A75,31081,4,6,2,109.44639,18.30181,1318
43972,E6651E3C6D8FEA2077D9EFC6D097D06C,38251,0,14,14,109.49618,18.25493,1510
43973,E6651E3C6D8FEA2077D9EFC6D097D06C,31031,17,21,4,109.49979,18.25382,1510
43976,4CB912B6F8396332BBD4A470BCE42007,60221,0,6,6,109.52569,18.29188,1616
43977,4CB912B6F8396332BBD4A470BCE42007,30421,6,10,4,109.50021,18.25861,1511
43978,4CB912B6F8396332BBD4A470BCE42007,60221,11,20,9,109.52569,18.29188,1616
43979,4CB912B6F8396332BBD4A470BCE42007,31534,21,23,2,109.49368,18.25806,1461
43980,6A5315660D9B469BEC66B2E434056CB6,31471,16,17,1,109.34583,18.29563,917
43981,6A5315660D9B469BEC66B2E434056CB6,60381,20,22,2,109.5241,18.22458,1605
43985,24E94C322C21864A44D8B04F37BB2EEC,31271,0,10,10,109.48958,18.26257,1462
43986,24E94C322C21864A44D8B04F37BB2EEC,60054,14,15,1,109.3016,18.31229,770
43987,24E94C322C21864A44D8B04F37BB2EEC,31471,16,17,1,109.34583,18.29563,917
43988,24E94C322C21864A44D8B04F37BB2EEC,30891,21,23,2,109.59431,18.28389,1865
44030,D0397702CD04E389C6CD3782DE9B02F8,38157,0,10,10,109.51483,18.26958,1563
44031,D0397702CD04E389C6CD3782DE9B02F8,31521,12,16,4,109.51458,18.22542,1555
44032,D0397702CD04E389C6CD3782DE9B02F8,60381,16,18,2,109.5241,18.22458,1605
44033,D0397702CD04E389C6CD3782DE9B02F8,31061,19,20,1,109.53333,18.23257,1607
44034,D0397702CD04E389C6CD3782DE9B02F8,38911,22,23,1,109.51674,18.24965,1559
44040,AAC7E9546787DDB508C41969C1E453E7,39154,0,12,12,109.50201,18.25681,1511
44041,AAC7E9546787DDB508C41969C1E453E7,31561,13,15,2,109.56792,18.28479,1765
44042,AAC7E9546787DDB508C41969C1E453E7,60114,16,18,2,109.73028,18.33847,2374
44043,AAC7E9546787DDB508C41969C1E453E7,30421,20,23,3,109.50021,18.25861,1511
44049,3AA728046A24C765839BE31583DC1011,39101,11,12,1,109.50132,18.24931,1509
44050,3AA728046A24C765839BE31583DC1011,31471,14,16,2,109.34583,18.29563,917
44051,3AA728046A24C765839BE31583DC1011,39091,18,22,4,109.50097,18.25222,1510
44067,2115670ECBCEFE4CA16C55F5204DF607,31071,0,7,7,109.58257,18.28458,1815
44068,2115670ECBCEFE4CA16C55F5204DF607,30854,9,20,11,109.56889,18.27076,1763
44078,AF4FF2394625B3300738BCD880272864,30581,10,11,1,109.62257,18.24951,1959
44079,AF4FF2394625B3300738BCD880272864,33354,12,15,3,109.67465,18.44583,2192
44080,AF4FF2394625B3300738BCD880272864,33051,15,16,1,109.6475,18.46618,2096
44086,9BF33DB1F7AC1D27E06AF501C14CCF2C,39181,18,21,3,109.55153,18.28035,1715
44087,9BF33DB1F7AC1D27E06AF501C14CCF2C,31931,22,23,1,109.54771,18.29403,1667
44104,A46BA306DAEA889FAC7ACE9E5FD6A1FF,60331,0,1,1,109.505,18.26507,1512
44105,A46BA306DAEA889FAC7ACE9E5FD6A1FF,30081,3,10,7,109.50243,18.26632,1512
44106,A46BA306DAEA889FAC7ACE9E5FD6A1FF,30911,11,23,12,109.50493,18.26181,1511
44107,E649CF84A26278291AA1A5B5C5D01FCA,30854,0,3,3,109.56889,18.27076,1763
44108,E649CF84A26278291AA1A5B5C5D01FCA,31561,7,9,2,109.56792,18.28479,1765
44109,E649CF84A26278291AA1A5B5C5D01FCA,30854,9,11,2,109.56889,18.27076,1763
44110,E649CF84A26278291AA1A5B5C5D01FCA,31561,11,12,1,109.56792,18.28479,1765
44111,E649CF84A26278291AA1A5B5C5D01FCA,30161,17,18,1,109.50042,18.24389,1508
44112,E649CF84A26278291AA1A5B5C5D01FCA,30854,19,20,1,109.56889,18.27076,1763
44113,E649CF84A26278291AA1A5B5C5D01FCA,31561,22,23,1,109.56792,18.28479,1765
44114,5AE620030CD6D52CC29C82349F95610D,38111,0,9,9,109.52007,18.22403,1555
44115,5AE620030CD6D52CC29C82349F95610D,31221,13,15,2,109.61333,18.26833,1913
44116,5AE620030CD6D52CC29C82349F95610D,31521,16,19,3,109.51458,18.22542,1555
44117,6C44DD6A334FD8F5ED58CBD00D571465,31521,0,8,8,109.51458,18.22542,1555
44118,6C44DD6A334FD8F5ED58CBD00D571465,31145,12,13,1,109.20431,18.30479,369
44119,6C44DD6A334FD8F5ED58CBD00D571465,31471,16,18,2,109.34583,18.29563,917
44169,14F21534C21254001A38352AD4BB0EF6,31071,0,7,7,109.58257,18.28458,1815
44170,14F21534C21254001A38352AD4BB0EF6,30854,8,12,4,109.56889,18.27076,1763
44171,14F21534C21254001A38352AD4BB0EF6,31071,13,16,3,109.58257,18.28458,1815
44205,6C0260646767B781577B5B8CE2471E51,38484,1,2,1,109.53028,18.31528,1620
44206,6C0260646767B781577B5B8CE2471E51,60614,3,4,1,109.48799,18.29521,1467
44207,6C0260646767B781577B5B8CE2471E51,38484,5,16,11,109.53028,18.31528,1620
44208,6C0260646767B781577B5B8CE2471E51,30321,17,18,1,109.49563,18.29611,1467
44209,6C0260646767B781577B5B8CE2471E51,38484,19,21,2,109.53028,18.31528,1620
44228,3FAC9FAFB3ECDCE59F92B59DE0495304,60291,0,9,9,109.50826,18.24639,1509
44229,3FAC9FAFB3ECDCE59F92B59DE0495304,60131,13,14,1,109.49819,18.24778,1509
44230,3FAC9FAFB3ECDCE59F92B59DE0495304,39111,15,17,2,109.5191,18.22597,1555
44231,3FAC9FAFB3ECDCE59F92B59DE0495304,31521,20,21,1,109.51458,18.22542,1555
44249,52626520133C58C019E9712FB19D3224,31301,15,16,1,109.14493,18.31222,170
44250,52626520133C58C019E9712FB19D3224,30271,19,20,1,109.49132,18.23153,1456
44251,52626520133C58C019E9712FB19D3224,38171,22,23,1,109.50799,18.28139,1515
44264,8F6EA1C108FADA76A214A7ED71ECE3D1,30891,0,2,2,109.59431,18.28389,1865
44265,8F6EA1C108FADA76A214A7ED71ECE3D1,39183,5,6,1,109.55542,18.28208,1715
44266,8F6EA1C108FADA76A214A7ED71ECE3D1,30854,9,17,8,109.56889,18.27076,1763
44275,20C15B76A1E0DF79D86EDEAC7BC3D7B7,31071,1,7,6,109.58257,18.28458,1815
44276,20C15B76A1E0DF79D86EDEAC7BC3D7B7,31945,8,13,5,109.58021,18.29403,1817
44277,20C15B76A1E0DF79D86EDEAC7BC3D7B7,30854,18,21,3,109.56889,18.27076,1763
44278,20C15B76A1E0DF79D86EDEAC7BC3D7B7,30441,21,22,1,109.64021,18.25424,2010
44316,63B5E489F3503F8EC6E40A38F9D2117C,60171,9,18,9,109.51292,18.30694,1569
44317,63B5E489F3503F8EC6E40A38F9D2117C,60361,21,23,2,109.51938,18.29681,1567
44342,E25E879CAFC04F12992F409DED32F7E4,60011,19,20,1,109.48965,18.30222,1468
44343,E25E879CAFC04F12992F409DED32F7E4,38291,21,22,1,109.51618,18.24313,1558
44345,A59893CF63A9A48BE0D9E2ED611A9BB2,30721,11,12,1,109.51597,18.28257,1565
44360,F199F86E80566351E28B88A26F39C674,31351,0,7,7,109.4959,18.28417,1465
44361,F199F86E80566351E28B88A26F39C674,30281,8,9,1,109.50597,18.27583,1514
44362,F199F86E80566351E28B88A26F39C674,38261,10,11,1,109.50361,18.28153,1515
44378,CFFDD1BF3134B9FDD71614F40E1DE0FD,30854,3,5,2,109.56889,18.27076,1763
44379,CFFDD1BF3134B9FDD71614F40E1DE0FD,31071,6,14,8,109.58257,18.28458,1815
44380,CFFDD1BF3134B9FDD71614F40E1DE0FD,39091,16,18,2,109.50097,18.25222,1510
44381,FF811E88FEA9CBDF12E5CC54DEE7CCA1,30232,0,5,5,109.6191,18.31701,1971
44382,FF811E88FEA9CBDF12E5CC54DEE7CCA1,30854,10,11,1,109.56889,18.27076,1763
44383,781955161DE29ECF49F0988D5A8412EF,31471,16,17,1,109.34583,18.29563,917
44384,781955161DE29ECF49F0988D5A8412EF,38951,19,20,1,109.48097,18.28868,1416
44385,781955161DE29ECF49F0988D5A8412EF,38951,21,23,2,109.48097,18.28868,1416
44410,8AABF5FDF2B06EB445749240A3894969,31071,0,1,1,109.58257,18.28458,1815
44411,8AABF5FDF2B06EB445749240A3894969,30854,2,22,20,109.56889,18.27076,1763
44426,59972224BAF878DB2B5AD7A1D50178FC,31145,14,15,1,109.20431,18.30479,369
44427,59972224BAF878DB2B5AD7A1D50178FC,31471,16,17,1,109.34583,18.29563,917
44428,59972224BAF878DB2B5AD7A1D50178FC,30854,20,22,2,109.56889,18.27076,1763
44460,F315998EC48289C5B7879B7FA5033861,31461,0,14,14,109.5091,18.25389,1510
44461,F315998EC48289C5B7879B7FA5033861,38127,14,16,2,109.50833,18.27222,1513
44474,1EC959553638CEC3C2D1606E92235CDE,39111,0,1,1,109.5191,18.22597,1555
44475,1EC959553638CEC3C2D1606E92235CDE,30854,1,2,1,109.56889,18.27076,1763
44476,1EC959553638CEC3C2D1606E92235CDE,31945,5,6,1,109.58021,18.29403,1817
44477,1EC959553638CEC3C2D1606E92235CDE,30854,10,18,8,109.56889,18.27076,1763
44478,1EC959553638CEC3C2D1606E92235CDE,31421,19,20,1,109.55382,18.22347,1705
44485,FE95B3A32EFBC2838F293DF38F55FDD1,31931,0,1,1,109.54771,18.29403,1667
44486,FE95B3A32EFBC2838F293DF38F55FDD1,39183,6,11,5,109.55542,18.28208,1715
44487,FE95B3A32EFBC2838F293DF38F55FDD1,31931,14,16,2,109.54771,18.29403,1667
44488,FE95B3A32EFBC2838F293DF38F55FDD1,30854,21,23,2,109.56889,18.27076,1763
44494,0FD89E239CD1BF14C1ED19615717BC0E,31471,14,16,2,109.34583,18.29563,917
44495,0FD89E239CD1BF14C1ED19615717BC0E,31521,18,23,5,109.51458,18.22542,1555
44505,0C12679B52C25C8A094B9B69D277B0C8,31071,0,6,6,109.58257,18.28458,1815
44506,0C12679B52C25C8A094B9B69D277B0C8,30854,7,8,1,109.56889,18.27076,1763
44507,0C12679B52C25C8A094B9B69D277B0C8,31071,12,23,11,109.58257,18.28458,1815
44544,EC8642AA937DB73541C5437DE9D9374B,31181,0,6,6,109.50382,18.24813,1509
44545,EC8642AA937DB73541C5437DE9D9374B,38017,8,11,3,109.49729,18.21424,1504
44546,EC8642AA937DB73541C5437DE9D9374B,60401,15,19,4,109.47444,18.27583,1414
44547,EC8642AA937DB73541C5437DE9D9374B,31181,20,23,3,109.50382,18.24813,1509
44557,2B8147CA8BF08978004DA378A0F33355,30854,0,4,4,109.56889,18.27076,1763
44558,2B8147CA8BF08978004DA378A0F33355,31031,8,9,1,109.49979,18.25382,1510
44559,2B8147CA8BF08978004DA378A0F33355,31781,13,14,1,109.19847,18.2975,367
44563,CA373FFAFD7EFAD5EEFC32965095EB00,30821,16,18,2,109.43681,18.33639,1274
44564,CA373FFAFD7EFAD5EEFC32965095EB00,60201,21,22,1,109.5041,18.2509,1510
44565,CA373FFAFD7EFAD5EEFC32965095EB00,38251,22,23,1,109.49618,18.25493,1510
44570,E8BAAF476E8FE57075BAB1A8D4FF1780,30891,3,5,2,109.59431,18.28389,1865
44571,E8BAAF476E8FE57075BAB1A8D4FF1780,30854,7,8,1,109.56889,18.27076,1763
44572,E8BAAF476E8FE57075BAB1A8D4FF1780,30232,11,23,12,109.6191,18.31701,1971
44586,DA576E66EB047CDA32DD08419727A116,39183,0,5,5,109.55542,18.28208,1715
44587,DA576E66EB047CDA32DD08419727A116,30851,5,8,3,109.5616,18.27396,1713
44588,DA576E66EB047CDA32DD08419727A116,31421,9,12,3,109.55382,18.22347,1705
44610,5F14E1A15EFA1C13F8B10CBC543F107C,31701,0,14,14,109.44132,18.28833,1266
44611,5F14E1A15EFA1C13F8B10CBC543F107C,60241,18,20,2,109.53319,18.28667,1616
44645,5A612FD41D5C59DA1534F33EB272F1CE,30854,0,13,13,109.56889,18.27076,1763
44646,5A612FD41D5C59DA1534F33EB272F1CE,60591,15,17,2,109.61118,18.21715,1904
44647,5A612FD41D5C59DA1534F33EB272F1CE,30854,19,20,1,109.56889,18.27076,1763
44648,5A612FD41D5C59DA1534F33EB272F1CE,31071,21,23,2,109.58257,18.28458,1815
44671,7C16827D646BDC874DE2BD7EE32189C5,30854,9,11,2,109.56889,18.27076,1763
44672,7C16827D646BDC874DE2BD7EE32189C5,60631,12,13,1,109.57778,18.27583,1814
44673,7C16827D646BDC874DE2BD7EE32189C5,60241,16,18,2,109.53319,18.28667,1616
44678,5D4710E685AEDA29FE14D10D51B03621,33051,14,15,1,109.6475,18.46618,2096
44679,5D4710E685AEDA29FE14D10D51B03621,30051,20,23,3,109.48917,18.21215,1453
44778,CEB7EA5D037E7DFD2A157DEECC6ACC53,31541,21,22,1,109.1809,18.36722,329
44783,1933B3069C81BAD64390BF81190C399E,38127,0,11,11,109.50833,18.27222,1513
44784,1933B3069C81BAD64390BF81190C399E,31471,15,17,2,109.34583,18.29563,917
44785,1933B3069C81BAD64390BF81190C399E,60541,20,21,1,109.4084,18.29208,1167
44789,D12944CE5296653EC6E6CC8C30E0E8A0,60111,18,20,2,109.72556,18.31924,2371
44790,D12944CE5296653EC6E6CC8C30E0E8A0,38961,21,22,1,109.50847,18.23514,1507
44791,D56A67341D1DA856D04BC2181FD404FB,60541,0,1,1,109.4084,18.29208,1167
44792,D56A67341D1DA856D04BC2181FD404FB,31231,3,7,4,109.42597,18.29292,1217
44793,D56A67341D1DA856D04BC2181FD404FB,60541,9,11,2,109.4084,18.29208,1167
44794,D56A67341D1DA856D04BC2181FD404FB,30351,16,17,1,109.41701,18.29292,1217
44795,D56A67341D1DA856D04BC2181FD404FB,60552,17,19,2,109.41729,18.30014,1218
44796,D56A67341D1DA856D04BC2181FD404FB,60541,21,23,2,109.4084,18.29208,1167
44837,E4C7AB656E412C7E33554D18277C9478,60291,14,16,2,109.50826,18.24639,1509
44838,E4C7AB656E412C7E33554D18277C9478,30511,20,22,2,109.51069,18.24208,1558
44862,707F435BF102979FBACE7253981A53B6,30171,1,10,9,109.48458,18.27139,1463
44863,707F435BF102979FBACE7253981A53B6,30421,11,13,2,109.50021,18.25861,1511
44864,707F435BF102979FBACE7253981A53B6,60054,15,16,1,109.3016,18.31229,770
44865,707F435BF102979FBACE7253981A53B6,30171,19,22,3,109.48458,18.27139,1463
44905,66F0C63A2BC847E16C97B2AD6644B4E6,31021,0,11,11,109.49021,18.27,1463
44906,66F0C63A2BC847E16C97B2AD6644B4E6,30341,12,18,6,109.3625,18.29167,966
44941,83B8326C5AE775F9B6383CC3A8412C48,60071,9,10,1,109.75674,18.31583,2470
44942,83B8326C5AE775F9B6383CC3A8412C48,31301,13,15,2,109.14493,18.31222,170
44943,83B8326C5AE775F9B6383CC3A8412C48,31471,16,17,1,109.34583,18.29563,917
44944,83B8326C5AE775F9B6383CC3A8412C48,38951,18,23,5,109.48097,18.28868,1416
44950,7F632B4875B2736225CD6D350CD25670,31071,1,7,6,109.58257,18.28458,1815
44951,7F632B4875B2736225CD6D350CD25670,30854,9,11,2,109.56889,18.27076,1763
44952,7F632B4875B2736225CD6D350CD25670,31071,12,13,1,109.58257,18.28458,1815
44953,7F632B4875B2736225CD6D350CD25670,30854,14,21,7,109.56889,18.27076,1763
44954,B1040167F22A61DD40A5E55E00271607,31351,0,6,6,109.4959,18.28417,1465
44955,B1040167F22A61DD40A5E55E00271607,31301,8,19,11,109.14493,18.31222,170
44956,B1040167F22A61DD40A5E55E00271607,30084,21,23,2,109.50118,18.26972,1513
44991,1B6EBBFF3B9D8A3E18753343B6A29EAE,31071,0,7,7,109.58257,18.28458,1815
44992,1B6EBBFF3B9D8A3E18753343B6A29EAE,31561,7,9,2,109.56792,18.28479,1765
44993,1B6EBBFF3B9D8A3E18753343B6A29EAE,31071,12,23,11,109.58257,18.28458,1815
44994,599A4CAA28C4A41DBB6851A8D7648BC9,30171,0,1,1,109.48458,18.27139,1463
44995,599A4CAA28C4A41DBB6851A8D7648BC9,38871,2,6,4,109.44681,18.28625,1316
44996,599A4CAA28C4A41DBB6851A8D7648BC9,30171,7,10,3,109.48458,18.27139,1463
44997,599A4CAA28C4A41DBB6851A8D7648BC9,30571,12,15,3,109.50243,18.21861,1504
45038,39CA4FE8290F03A5AE8EA1D8371B2A6D,30121,0,7,7,109.52861,18.27222,1613
45040,39CA4FE8290F03A5AE8EA1D8371B2A6D,30121,18,23,5,109.52861,18.27222,1613
45061,3BF3A82A70A93B4B71D52AA73CE29D00,38251,0,9,9,109.49618,18.25493,1510
45062,3BF3A82A70A93B4B71D52AA73CE29D00,31471,12,13,1,109.34583,18.29563,917
45063,3BF3A82A70A93B4B71D52AA73CE29D00,30341,15,17,2,109.3625,18.29167,966
45091,4D4289AE0DFBF4B5C79A47559DC2EBDD,30854,0,10,10,109.56889,18.27076,1763
45092,4D4289AE0DFBF4B5C79A47559DC2EBDD,30861,14,21,7,109.52722,18.22743,1606
45099,68DBE0B52FD0AB95F1DD47068FD7847F,60311,0,7,7,109.52097,18.24319,1558
45100,68DBE0B52FD0AB95F1DD47068FD7847F,30181,7,19,12,109.51597,18.23313,1557
45101,68DBE0B52FD0AB95F1DD47068FD7847F,60311,19,23,4,109.52097,18.24319,1558
45132,D88AE248BE01D22E4DE2A4B556E71166,38951,0,8,8,109.48097,18.28868,1416
45133,D88AE248BE01D22E4DE2A4B556E71166,30971,9,12,3,109.48708,18.29319,1467
45134,D88AE248BE01D22E4DE2A4B556E71166,38951,12,17,5,109.48097,18.28868,1416
45165,0B67294FA9DBD53325D63EA36C1B8784,31231,0,11,11,109.42597,18.29292,1217
45166,0B67294FA9DBD53325D63EA36C1B8784,31145,13,16,3,109.20431,18.30479,369
45235,7E95AEA91A37473FF71C625BDD54FD92,60226,0,1,1,109.5175,18.28778,1566
45236,7E95AEA91A37473FF71C625BDD54FD92,60361,3,9,6,109.51938,18.29681,1567
45237,7E95AEA91A37473FF71C625BDD54FD92,38154,10,11,1,109.5266,18.28278,1615
45238,7E95AEA91A37473FF71C625BDD54FD92,60361,15,16,1,109.51938,18.29681,1567
45239,7E95AEA91A37473FF71C625BDD54FD92,60226,17,18,1,109.5175,18.28778,1566
45240,7E95AEA91A37473FF71C625BDD54FD92,60241,18,20,2,109.53319,18.28667,1616
45241,7E95AEA91A37473FF71C625BDD54FD92,60361,20,23,3,109.51938,18.29681,1567
45254,35E2175E021CD04E6CF0361F38962323,31531,11,12,1,109.49583,18.25972,1461
45255,35E2175E021CD04E6CF0361F38962323,31473,13,15,2,109.34792,18.29465,917
45282,066CC6CBB5ADF978A93AF5D0C3292806,30071,0,6,6,109.52819,18.30472,1619
45283,066CC6CBB5ADF978A93AF5D0C3292806,31931,9,10,1,109.54771,18.29403,1667
45284,066CC6CBB5ADF978A93AF5D0C3292806,60211,13,16,3,109.63549,18.26049,2011
45285,066CC6CBB5ADF978A93AF5D0C3292806,39321,19,21,2,109.529,18.2167,1604
45311,AAFE4E0B4B6AE737025ABC3F9BE70797,31781,15,17,2,109.19847,18.2975,367
45312,AAFE4E0B4B6AE737025ABC3F9BE70797,31701,18,21,3,109.44132,18.28833,1266
45313,AAFE4E0B4B6AE737025ABC3F9BE70797,60524,22,23,1,109.42951,18.28993,1216
45352,967DC30377CC6C2FF7663D7FEE1391C0,31473,16,18,2,109.34792,18.29465,917
45353,967DC30377CC6C2FF7663D7FEE1391C0,30101,20,23,3,109.57299,18.33333,1773
45371,222E0B6922623CE9FBB280F81068D40E,31061,0,7,7,109.53333,18.23257,1607
45372,222E0B6922623CE9FBB280F81068D40E,30851,9,11,2,109.5616,18.27396,1713
45373,222E0B6922623CE9FBB280F81068D40E,39321,12,17,5,109.529,18.2167,1604
45374,222E0B6922623CE9FBB280F81068D40E,31061,17,19,2,109.53333,18.23257,1607
45375,AD2FF3511C546F92347A76D5BDCE6CA1,30571,0,7,7,109.50243,18.21861,1504
45376,AD2FF3511C546F92347A76D5BDCE6CA1,38347,7,8,1,109.4934,18.21444,1454
45377,AD2FF3511C546F92347A76D5BDCE6CA1,38017,10,12,2,109.49729,18.21424,1504
45378,AD2FF3511C546F92347A76D5BDCE6CA1,30571,12,17,5,109.50243,18.21861,1504
45454,926FBA523DAEDABC03774AE3ED899479,38127,0,14,14,109.50833,18.27222,1513
45455,926FBA523DAEDABC03774AE3ED899479,30281,19,20,1,109.50597,18.27583,1514
45470,551995058BB73CF3CAA268CB90FD9FE2,38251,18,20,2,109.49618,18.25493,1510
45471,551995058BB73CF3CAA268CB90FD9FE2,30421,20,21,1,109.50021,18.25861,1511
45493,9BD095517798346F169AD6D898CA1A42,60361,0,6,6,109.51938,18.29681,1567
45494,9BD095517798346F169AD6D898CA1A42,60221,8,16,8,109.52569,18.29188,1616
45495,9BD095517798346F169AD6D898CA1A42,60361,21,23,2,109.51938,18.29681,1567
45506,E992E0166BE08FEB8B592A9E59B112AB,31471,13,15,2,109.34583,18.29563,917
45507,E992E0166BE08FEB8B592A9E59B112AB,31534,20,23,3,109.49368,18.25806,1461
45508,3720DDB8E91BF73FF05637BA50F0661B,31521,0,11,11,109.51458,18.22542,1555
45509,3720DDB8E91BF73FF05637BA50F0661B,30361,12,13,1,109.50347,18.24,1508
45510,3720DDB8E91BF73FF05637BA50F0661B,31521,14,23,9,109.51458,18.22542,1555
45530,E154399B1350F1CD6894DBAC16833152,38331,7,9,2,109.62465,18.22736,1956
45531,E154399B1350F1CD6894DBAC16833152,38754,10,11,1,109.74667,18.37382,2430
45532,E154399B1350F1CD6894DBAC16833152,38331,13,16,3,109.62465,18.22736,1956
45533,E154399B1350F1CD6894DBAC16833152,60231,18,20,2,109.49903,18.21972,1504
45553,080247CC19405F981D4BEFE1A1E9D339,31931,0,1,1,109.54771,18.29403,1667
45554,080247CC19405F981D4BEFE1A1E9D339,39181,1,10,9,109.55153,18.28035,1715
45555,080247CC19405F981D4BEFE1A1E9D339,31931,11,12,1,109.54771,18.29403,1667
45556,080247CC19405F981D4BEFE1A1E9D339,39181,15,17,2,109.55153,18.28035,1715
45600,104D50A9C0319F25E132948E6191A1E5,30211,1,2,1,109.49882,18.23931,1508
45601,104D50A9C0319F25E132948E6191A1E5,60161,6,8,2,109.49174,18.26181,1461
45602,104D50A9C0319F25E132948E6191A1E5,30271,13,14,1,109.49132,18.23153,1456
45603,104D50A9C0319F25E132948E6191A1E5,30211,14,16,2,109.49882,18.23931,1508
45604,104D50A9C0319F25E132948E6191A1E5,30271,17,18,1,109.49132,18.23153,1456
45605,104D50A9C0319F25E132948E6191A1E5,60084,18,20,2,109.4984,18.2334,1507
45611,E904D23B3C819F061EFB1AF0F13A2364,38951,0,8,8,109.48097,18.28868,1416
45612,E904D23B3C819F061EFB1AF0F13A2364,30971,9,12,3,109.48708,18.29319,1467
45613,E904D23B3C819F061EFB1AF0F13A2364,38951,12,23,11,109.48097,18.28868,1416
45614,D54FF92D90E0CD41A304344578DE281C,60541,0,6,6,109.4084,18.29208,1167
45615,D54FF92D90E0CD41A304344578DE281C,31681,7,8,1,109.40396,18.29979,1168
45616,D54FF92D90E0CD41A304344578DE281C,33051,10,12,2,109.6475,18.46618,2096
45617,D54FF92D90E0CD41A304344578DE281C,33481,13,15,2,109.67278,18.41278,2187
45618,D54FF92D90E0CD41A304344578DE281C,60381,16,18,2,109.5241,18.22458,1605
45619,D54FF92D90E0CD41A304344578DE281C,60541,20,23,3,109.4084,18.29208,1167
45660,F15BD9A44406D60DBAB181C797D514C7,31031,0,8,8,109.49979,18.25382,1510
45661,F15BD9A44406D60DBAB181C797D514C7,31781,11,13,2,109.19847,18.2975,367
45662,F15BD9A44406D60DBAB181C797D514C7,31031,15,22,7,109.49979,18.25382,1510
45688,B023927CBEC0A8053CBDF64A5B76E367,30571,0,2,2,109.50243,18.21861,1504
45689,B023927CBEC0A8053CBDF64A5B76E367,30051,3,4,1,109.48917,18.21215,1453
45690,B023927CBEC0A8053CBDF64A5B76E367,60231,5,6,1,109.49903,18.21972,1504
45691,B023927CBEC0A8053CBDF64A5B76E367,31931,10,12,2,109.54771,18.29403,1667
45703,9161F8CF9FE399F91F1ACEDE385ADA60,31781,8,10,2,109.19847,18.2975,367
45704,9161F8CF9FE399F91F1ACEDE385ADA60,31471,12,13,1,109.34583,18.29563,917
45705,9161F8CF9FE399F91F1ACEDE385ADA60,60221,16,17,1,109.52569,18.29188,1616
45720,C5F520449EBC5BB529DC1F3F22008D6A,31431,0,9,9,109.44639,18.29042,1316
45721,C5F520449EBC5BB529DC1F3F22008D6A,31781,13,15,2,109.19847,18.2975,367
45722,C5F520449EBC5BB529DC1F3F22008D6A,31431,19,23,4,109.44639,18.29042,1316
45763,C925EDC1C2C39BAEC75090090BF059D6,30741,0,8,8,109.49833,18.28681,1516
45764,C925EDC1C2C39BAEC75090090BF059D6,38754,11,13,2,109.74667,18.37382,2430
45765,C925EDC1C2C39BAEC75090090BF059D6,31841,15,16,1,109.73201,18.33382,2373
45766,C925EDC1C2C39BAEC75090090BF059D6,31551,18,19,1,109.55868,18.24222,1708
45767,C925EDC1C2C39BAEC75090090BF059D6,30741,21,23,2,109.49833,18.28681,1516
45770,13104A6A71A054F852B52BB76993ADB2,30851,4,17,13,109.5616,18.27396,1713
45771,13104A6A71A054F852B52BB76993ADB2,30854,20,22,2,109.56889,18.27076,1763
45788,027E602081DB43952E091CB45BB3419B,60524,0,7,7,109.42951,18.28993,1216
45845,BBEE860FA709C883F82529C03A4CBE80,60291,0,1,1,109.50826,18.24639,1509
45846,BBEE860FA709C883F82529C03A4CBE80,31521,2,22,20,109.51458,18.22542,1555
45852,D4EE8E1A4C04A1FF0596E4221D0B8B42,31461,12,14,2,109.5091,18.25389,1510
45853,D4EE8E1A4C04A1FF0596E4221D0B8B42,31071,17,21,4,109.58257,18.28458,1815
45858,FF8CB3D02361FAEBFE418108180099D8,60201,12,14,2,109.5041,18.2509,1510
45859,FF8CB3D02361FAEBFE418108180099D8,30711,15,22,7,109.50271,18.25347,1510
45883,32F65A20D32806FF353EB969C069139F,31031,0,7,7,109.49979,18.25382,1510
45884,32F65A20D32806FF353EB969C069139F,33051,10,14,4,109.6475,18.46618,2096
45885,32F65A20D32806FF353EB969C069139F,38251,16,17,1,109.49618,18.25493,1510
45886,32F65A20D32806FF353EB969C069139F,31031,18,23,5,109.49979,18.25382,1510
45923,875F4B80762D0E664890361D764F907D,60081,0,7,7,109.51097,18.22639,1556
45924,875F4B80762D0E664890361D764F907D,30571,7,11,4,109.50243,18.21861,1504
45925,875F4B80762D0E664890361D764F907D,60231,11,18,7,109.49903,18.21972,1504
45926,875F4B80762D0E664890361D764F907D,60081,19,22,3,109.51097,18.22639,1556
45933,694A76996BB887B2B7F2884E406FB0D5,30971,1,9,8,109.48708,18.29319,1467
45934,694A76996BB887B2B7F2884E406FB0D5,31781,12,14,2,109.19847,18.2975,367
45935,694A76996BB887B2B7F2884E406FB0D5,60221,16,20,4,109.52569,18.29188,1616
45936,694A76996BB887B2B7F2884E406FB0D5,31521,21,23,2,109.51458,18.22542,1555
45970,304683EC3F3249EB9C6842AA235349DC,30854,1,17,16,109.56889,18.27076,1763
45971,304683EC3F3249EB9C6842AA235349DC,30051,18,19,1,109.48917,18.21215,1453
45972,304683EC3F3249EB9C6842AA235349DC,30571,19,20,1,109.50243,18.21861,1504
45973,6337E3A707231D3808C1315BC45E0374,38141,0,9,9,109.39479,18.2916,1116
45974,6337E3A707231D3808C1315BC45E0374,60381,14,16,2,109.5241,18.22458,1605
45975,6337E3A707231D3808C1315BC45E0374,38141,17,23,6,109.39479,18.2916,1116
46013,0F924F37F5D3D17A952F4CCE171DD879,31561,0,3,3,109.56792,18.28479,1765
46014,0F924F37F5D3D17A952F4CCE171DD879,39183,6,7,1,109.55542,18.28208,1715
46015,0F924F37F5D3D17A952F4CCE171DD879,30854,7,10,3,109.56889,18.27076,1763
46016,0F924F37F5D3D17A952F4CCE171DD879,39183,14,22,8,109.55542,18.28208,1715
46022,28FD729A56A38491CC99ABB23711BC1C,39181,0,2,2,109.55153,18.28035,1715
46023,28FD729A56A38491CC99ABB23711BC1C,31931,7,8,1,109.54771,18.29403,1667
46024,28FD729A56A38491CC99ABB23711BC1C,39181,11,13,2,109.55153,18.28035,1715
46025,28FD729A56A38491CC99ABB23711BC1C,31931,18,20,2,109.54771,18.29403,1667
46026,28FD729A56A38491CC99ABB23711BC1C,39181,20,23,3,109.55153,18.28035,1715
46048,D7D9352263CF977FD0E7820F34F6CA72,60614,0,14,14,109.48799,18.29521,1467
46049,D7D9352263CF977FD0E7820F34F6CA72,31851,17,20,3,109.71736,18.29007,2316
46050,D7D9352263CF977FD0E7820F34F6CA72,30151,21,23,2,109.50986,18.25083,1560
46110,2CA871175E69D08EE1C85C5B81F73318,31071,0,5,5,109.58257,18.28458,1815
46111,2CA871175E69D08EE1C85C5B81F73318,30854,5,7,2,109.56889,18.27076,1763
46112,2CA871175E69D08EE1C85C5B81F73318,31071,8,14,6,109.58257,18.28458,1815
46113,2CA871175E69D08EE1C85C5B81F73318,60661,15,16,1,109.548,18.2377,1657
46114,2CA871175E69D08EE1C85C5B81F73318,31071,18,20,2,109.58257,18.28458,1815
46172,CE47E8C2A5EAD7F93DD37F876A8014ED,30441,0,8,8,109.64021,18.25424,2010
46173,CE47E8C2A5EAD7F93DD37F876A8014ED,31221,9,12,3,109.61333,18.26833,1913
46174,3D8ADE80304FD3207128013D43F1118A,60421,3,12,9,109.46333,18.31743,1371
46175,3D8ADE80304FD3207128013D43F1118A,31591,16,17,1,109.46924,18.34882,1376
46176,3D8ADE80304FD3207128013D43F1118A,30111,19,21,2,109.47583,18.30542,1419
46177,3D8ADE80304FD3207128013D43F1118A,30711,21,23,2,109.50271,18.25347,1510
46178,B80D6AB96D3D5CEE71A70ED25275F830,38951,0,9,9,109.48097,18.28868,1416
46179,B80D6AB96D3D5CEE71A70ED25275F830,38951,11,12,1,109.48097,18.28868,1416
46180,B80D6AB96D3D5CEE71A70ED25275F830,31531,14,17,3,109.49583,18.25972,1461
46181,B80D6AB96D3D5CEE71A70ED25275F830,38951,19,23,4,109.48097,18.28868,1416
46217,918CA9A7084F993FB16E3BC0238F013F,38141,0,9,9,109.39479,18.2916,1116
46218,918CA9A7084F993FB16E3BC0238F013F,38315,10,11,1,109.48979,18.29764,1467
46243,54F5D56BC8E73B852AF722D0635DD6D9,30971,15,17,2,109.48708,18.29319,1467
46244,54F5D56BC8E73B852AF722D0635DD6D9,60381,19,23,4,109.5241,18.22458,1605
46247,6256EC46A5EE081F3E479741B6BEAFA5,60501,0,8,8,109.48701,18.29021,1466
46248,6256EC46A5EE081F3E479741B6BEAFA5,31861,11,12,1,109.49042,18.27549,1464
46249,6256EC46A5EE081F3E479741B6BEAFA5,30971,13,15,2,109.48708,18.29319,1467
46250,6256EC46A5EE081F3E479741B6BEAFA5,60501,18,20,2,109.48701,18.29021,1466
46251,6256EC46A5EE081F3E479741B6BEAFA5,30731,21,22,1,109.50944,18.22306,1555
46259,33D03C41649B47EDC5176C93FF6F1D8D,60411,0,11,11,109.32514,18.30854,869
46260,33D03C41649B47EDC5176C93FF6F1D8D,30661,11,19,8,109.37028,18.24361,1008
46261,33D03C41649B47EDC5176C93FF6F1D8D,31251,22,23,1,109.18528,18.2975,317
46297,36BCA39777B9D1E703C1404CDA6A45E7,30511,0,9,9,109.51069,18.24208,1558
46299,36BCA39777B9D1E703C1404CDA6A45E7,60221,16,18,2,109.52569,18.29188,1616
46300,36BCA39777B9D1E703C1404CDA6A45E7,31031,19,20,1,109.49979,18.25382,1510
46301,36BCA39777B9D1E703C1404CDA6A45E7,60291,22,23,1,109.50826,18.24639,1509
46319,C358285726113434A30FBBA8DED710E7,60371,0,1,1,109.53063,18.30056,1618
46320,C358285726113434A30FBBA8DED710E7,30921,1,6,5,109.53903,18.29451,1667
46321,C358285726113434A30FBBA8DED710E7,60371,8,9,1,109.53063,18.30056,1618
46322,C358285726113434A30FBBA8DED710E7,30321,9,11,2,109.49563,18.29611,1467
46323,C358285726113434A30FBBA8DED710E7,60171,12,19,7,109.51292,18.30694,1569
46336,ADBF485F417000D97D859A85712FAE70,60411,12,13,1,109.32514,18.30854,869
46337,ADBF485F417000D97D859A85712FAE70,31471,14,18,4,109.34583,18.29563,917
46338,ADBF485F417000D97D859A85712FAE70,60411,20,22,2,109.32514,18.30854,869
46348,6CBFC4099211CFF22099930D5C42EF4F,31761,12,14,2,109.60521,18.27965,1914
46349,6CBFC4099211CFF22099930D5C42EF4F,31071,17,19,2,109.58257,18.28458,1815
46350,6CBFC4099211CFF22099930D5C42EF4F,30854,20,22,2,109.56889,18.27076,1763
46447,8621CFDF1B89A83351494618C53D033F,31071,2,4,2,109.58257,18.28458,1815
46448,8621CFDF1B89A83351494618C53D033F,39181,4,7,3,109.55153,18.28035,1715
46449,8621CFDF1B89A83351494618C53D033F,31071,7,16,9,109.58257,18.28458,1815
46450,8621CFDF1B89A83351494618C53D033F,39181,18,20,2,109.55153,18.28035,1715
46504,BE7763F8096EB5A037146E1CC4190538,30854,0,15,15,109.56889,18.27076,1763
46505,BE7763F8096EB5A037146E1CC4190538,31561,16,19,3,109.56792,18.28479,1765
46506,BE7763F8096EB5A037146E1CC4190538,30854,20,21,1,109.56889,18.27076,1763
46507,6A9C2BB6A710F77DBA3EB36FEB39BE39,38027,0,7,7,109.38833,18.2909,1066
46508,6A9C2BB6A710F77DBA3EB36FEB39BE39,31145,8,13,5,109.20431,18.30479,369
46509,6A9C2BB6A710F77DBA3EB36FEB39BE39,31471,16,17,1,109.34583,18.29563,917
46510,6A9C2BB6A710F77DBA3EB36FEB39BE39,38027,18,23,5,109.38833,18.2909,1066
46515,5A1C4533F331B639AE5D3D6E2930E30B,31945,0,2,2,109.58021,18.29403,1817
46516,5A1C4533F331B639AE5D3D6E2930E30B,31071,3,7,4,109.58257,18.28458,1815
46517,5A1C4533F331B639AE5D3D6E2930E30B,30854,7,9,2,109.56889,18.27076,1763
46518,5A1C4533F331B639AE5D3D6E2930E30B,31071,9,11,2,109.58257,18.28458,1815
46532,3C3846E246DA805C8FD831C3E0164BD8,31521,10,11,1,109.51458,18.22542,1555
46533,3C3846E246DA805C8FD831C3E0164BD8,38871,15,16,1,109.44681,18.28625,1316
46534,3C3846E246DA805C8FD831C3E0164BD8,31701,17,19,2,109.44132,18.28833,1266
46535,3C3846E246DA805C8FD831C3E0164BD8,31431,22,23,1,109.44639,18.29042,1316
46546,9EF4EA0E4466E0443B8D1386AD3C2593,31521,0,3,3,109.51458,18.22542,1555
46547,9EF4EA0E4466E0443B8D1386AD3C2593,39321,4,6,2,109.529,18.2167,1604
46548,9EF4EA0E4466E0443B8D1386AD3C2593,31521,6,8,2,109.51458,18.22542,1555
46549,9EF4EA0E4466E0443B8D1386AD3C2593,30361,16,18,2,109.50347,18.24,1508
46550,9EF4EA0E4466E0443B8D1386AD3C2593,31521,21,23,2,109.51458,18.22542,1555
46602,7AB82AF5C83804E1196D4CF764B27017,30321,1,19,18,109.49563,18.29611,1467
46603,7AB82AF5C83804E1196D4CF764B27017,31206,21,22,1,109.50819,18.23549,1507
46639,2191B2AD5C915B8862D4C345F0A13CFB,30851,2,12,10,109.5616,18.27396,1713
46640,2191B2AD5C915B8862D4C345F0A13CFB,60351,13,16,3,109.58403,18.28958,1816
46641,2191B2AD5C915B8862D4C345F0A13CFB,30851,17,19,2,109.5616,18.27396,1713
46642,2191B2AD5C915B8862D4C345F0A13CFB,31071,21,22,1,109.58257,18.28458,1815
46692,EDC17F917D3B692B137ACF040E1D7AE4,30421,0,7,7,109.50021,18.25861,1511
46693,EDC17F917D3B692B137ACF040E1D7AE4,31561,10,11,1,109.56792,18.28479,1765
46694,EDC17F917D3B692B137ACF040E1D7AE4,30421,12,14,2,109.50021,18.25861,1511
46729,B95895328C22197B47AD92C8267A3C6A,30921,3,4,1,109.53903,18.29451,1667
46730,B95895328C22197B47AD92C8267A3C6A,60371,5,6,1,109.53063,18.30056,1618
46731,B95895328C22197B47AD92C8267A3C6A,60171,10,18,8,109.51292,18.30694,1569
46740,13C882817D5EF3329D8612AEE7E0F34D,30961,14,15,1,109.74042,18.37903,2431
46741,13C882817D5EF3329D8612AEE7E0F34D,31491,16,17,1,109.73042,18.38771,2382
46742,13C882817D5EF3329D8612AEE7E0F34D,30201,21,23,2,109.4909,18.26465,1462
46756,74A9CCA48CD6C2DA9FC7DFDB8817D50B,31945,20,22,2,109.58021,18.29403,1817
46767,EB316856896788EC8FD871E122E95728,30931,0,6,6,109.55653,18.32722,1722
46768,EB316856896788EC8FD871E122E95728,31811,8,11,3,109.54201,18.31806,1671
46769,EB316856896788EC8FD871E122E95728,30701,11,14,3,109.59313,18.32007,1871
46770,EB316856896788EC8FD871E122E95728,31811,14,18,4,109.54201,18.31806,1671
46771,EB316856896788EC8FD871E122E95728,30701,20,23,3,109.59313,18.32007,1871
46792,41F47B8A3E7EDA8FCE88001CED656BDF,39183,2,3,1,109.55542,18.28208,1715
46793,41F47B8A3E7EDA8FCE88001CED656BDF,30854,7,15,8,109.56889,18.27076,1763
46794,41F47B8A3E7EDA8FCE88001CED656BDF,39183,18,19,1,109.55542,18.28208,1715
46795,41F47B8A3E7EDA8FCE88001CED656BDF,31071,19,21,2,109.58257,18.28458,1815
46801,560FD465CF3E1590B881631113C42929,30211,10,14,4,109.49882,18.23931,1508
46802,560FD465CF3E1590B881631113C42929,30921,18,22,4,109.53903,18.29451,1667
46812,971FAC974FC919EB70A5D4943C3307C0,60594,0,7,7,109.62694,18.22799,1956
46813,971FAC974FC919EB70A5D4943C3307C0,38052,8,9,1,109.62618,18.23042,1956
46814,971FAC974FC919EB70A5D4943C3307C0,60594,14,19,5,109.62694,18.22799,1956
46823,CD3BCBAB8571FB81953C842A434E5DB8,31071,0,6,6,109.58257,18.28458,1815
46824,CD3BCBAB8571FB81953C842A434E5DB8,30854,6,18,12,109.56889,18.27076,1763
46825,CD3BCBAB8571FB81953C842A434E5DB8,31071,21,23,2,109.58257,18.28458,1815
46923,FB16AA24AD94D8CC7E1110E44BD68910,60631,0,7,7,109.57778,18.27583,1814
46924,FB16AA24AD94D8CC7E1110E44BD68910,30854,8,19,11,109.56889,18.27076,1763
46925,FB16AA24AD94D8CC7E1110E44BD68910,31945,21,23,2,109.58021,18.29403,1817
46975,706B8E0F0F5D1C9FC2F8EBB2574EE89F,30711,0,17,17,109.50271,18.25347,1510
46976,706B8E0F0F5D1C9FC2F8EBB2574EE89F,30711,17,23,6,109.50271,18.25347,1510
46989,2DDF3A993BD69F79020EB97CF3A71819,38261,0,7,7,109.50361,18.28153,1515
46990,2DDF3A993BD69F79020EB97CF3A71819,30161,11,21,10,109.50042,18.24389,1508
46991,2DDF3A993BD69F79020EB97CF3A71819,38171,22,23,1,109.50799,18.28139,1515
47002,EB5A58B29D07DC10D6158FCB5E76E79E,30921,0,15,15,109.53903,18.29451,1667
47003,EB5A58B29D07DC10D6158FCB5E76E79E,30051,17,21,4,109.48917,18.21215,1453
47011,34A1BA5A97F90C4ABB34EDC7004774A9,30851,0,17,17,109.5616,18.27396,1713
47012,34A1BA5A97F90C4ABB34EDC7004774A9,30951,20,23,3,109.56208,18.25667,1761
47013,D00EAD9144E7A4027F84D32EB5112DB4,30921,0,1,1,109.53903,18.29451,1667
47014,D00EAD9144E7A4027F84D32EB5112DB4,31931,1,2,1,109.54771,18.29403,1667
47015,D00EAD9144E7A4027F84D32EB5112DB4,30921,3,5,2,109.53903,18.29451,1667
47016,D00EAD9144E7A4027F84D32EB5112DB4,31931,7,20,13,109.54771,18.29403,1667
47032,A492F275D85D5092E783C1723E9E2DAC,30661,13,16,3,109.37028,18.24361,1008
47033,A492F275D85D5092E783C1723E9E2DAC,38315,17,20,3,109.48979,18.29764,1467
47044,B164B8C0AEC0E295C9ED3DBE75B5D547,31461,9,10,1,109.5091,18.25389,1510
47045,B164B8C0AEC0E295C9ED3DBE75B5D547,38145,12,13,1,109.378,18.2912,1066
47046,B164B8C0AEC0E295C9ED3DBE75B5D547,30084,18,20,2,109.50118,18.26972,1513
47058,036D32EAF14CC03AE0D7817408EFE5C6,60631,0,4,4,109.57778,18.27583,1814
47059,036D32EAF14CC03AE0D7817408EFE5C6,30854,7,8,1,109.56889,18.27076,1763
47060,036D32EAF14CC03AE0D7817408EFE5C6,33481,13,15,2,109.67278,18.41278,2187
47061,036D32EAF14CC03AE0D7817408EFE5C6,30854,17,18,1,109.56889,18.27076,1763
47078,BAD2D8FDB06B9C9EA54FA7C4BC5F7D6F,60114,14,16,2,109.73028,18.33847,2374
47080,873371507B11C4BEF9A7B54B7B3E6864,31061,5,7,2,109.53333,18.23257,1607
47081,873371507B11C4BEF9A7B54B7B3E6864,60552,9,10,1,109.41729,18.30014,1218
47086,5264833F0013AE6B294396000613EF89,30381,0,1,1,109.52521,18.24507,1609
47087,5264833F0013AE6B294396000613EF89,30461,2,7,5,109.5116,18.26313,1562
47088,5264833F0013AE6B294396000613EF89,60201,7,8,1,109.5041,18.2509,1510
47089,5264833F0013AE6B294396000613EF89,60581,12,15,3,109.59785,18.29931,1868
47090,5264833F0013AE6B294396000613EF89,39154,16,17,1,109.50201,18.25681,1511
47091,5264833F0013AE6B294396000613EF89,30461,20,23,3,109.5116,18.26313,1562
47096,AE6DC7ACB81DB5F351E45AC25E5F5A3B,38297,0,13,13,109.52576,18.24965,1609
47097,AE6DC7ACB81DB5F351E45AC25E5F5A3B,31031,14,16,2,109.49979,18.25382,1510
47098,AE6DC7ACB81DB5F351E45AC25E5F5A3B,30381,20,23,3,109.52521,18.24507,1609
47106,318C2956C2993982332D961729732BA8,31781,15,16,1,109.19847,18.2975,367
47107,318C2956C2993982332D961729732BA8,30671,20,23,3,109.43611,18.30139,1268
47113,ADAB51A6D99BADC8222FC392D72ADA01,60281,0,6,6,109.51743,18.25924,1561
47114,ADAB51A6D99BADC8222FC392D72ADA01,30251,7,8,1,109.50611,18.26653,1512
47115,ADAB51A6D99BADC8222FC392D72ADA01,60281,8,23,15,109.51743,18.25924,1561
47139,0547C7536E43628EF24935F0C2BF5E2C,30921,0,5,5,109.53903,18.29451,1667
47140,0547C7536E43628EF24935F0C2BF5E2C,31931,6,16,10,109.54771,18.29403,1667
47141,0547C7536E43628EF24935F0C2BF5E2C,30921,16,17,1,109.53903,18.29451,1667
47142,0547C7536E43628EF24935F0C2BF5E2C,60241,21,22,1,109.53319,18.28667,1616
47146,2F440A235E684ECEDD042B3100A4AE95,31071,0,7,7,109.58257,18.28458,1815
47147,2F440A235E684ECEDD042B3100A4AE95,30854,7,8,1,109.56889,18.27076,1763
47148,2F440A235E684ECEDD042B3100A4AE95,30101,9,14,5,109.57299,18.33333,1773
47149,2F440A235E684ECEDD042B3100A4AE95,30854,17,18,1,109.56889,18.27076,1763
47150,2F440A235E684ECEDD042B3100A4AE95,31071,19,23,4,109.58257,18.28458,1815
47174,5EBEA276FCB4A19AC5C987F5C7CC8908,60504,1,2,1,109.47917,18.28903,1416
47175,5EBEA276FCB4A19AC5C987F5C7CC8908,60011,3,6,3,109.48965,18.30222,1468
47176,5EBEA276FCB4A19AC5C987F5C7CC8908,38361,10,14,4,109.43667,18.29201,1267
47177,5EBEA276FCB4A19AC5C987F5C7CC8908,60504,14,17,3,109.47917,18.28903,1416
47204,A4132C7C24D4F6CFBC6C091695995585,30631,0,7,7,109.34382,18.32778,922
47205,A4132C7C24D4F6CFBC6C091695995585,31691,10,11,1,109.36604,18.3075,1019
47206,A4132C7C24D4F6CFBC6C091695995585,30631,12,14,2,109.34382,18.32778,922
47207,A4132C7C24D4F6CFBC6C091695995585,31691,14,17,3,109.36604,18.3075,1019
47208,A4132C7C24D4F6CFBC6C091695995585,30631,19,23,4,109.34382,18.32778,922
47222,CB44FE843228066922623C4A2B161A4C,60504,0,10,10,109.47917,18.28903,1416
47223,CB44FE843228066922623C4A2B161A4C,30081,12,16,4,109.50243,18.26632,1512
47224,CB44FE843228066922623C4A2B161A4C,60504,21,23,2,109.47917,18.28903,1416
47227,FBC323A047041F71D8997C22FDE88F17,60241,19,20,1,109.53319,18.28667,1616
47276,9FA61329C09648F8617BA9BB3AD39F2D,60201,18,19,1,109.5041,18.2509,1510
47277,9FA61329C09648F8617BA9BB3AD39F2D,60161,19,21,2,109.49174,18.26181,1461
47278,9FA61329C09648F8617BA9BB3AD39F2D,60201,22,23,1,109.5041,18.2509,1510
47279,4BA143AD44480D9BEACA2836C34FF531,60161,14,16,2,109.49174,18.26181,1461
47280,4BA143AD44480D9BEACA2836C34FF531,60231,17,18,1,109.49903,18.21972,1504
47287,C834EF1A38F263607CE4942426932ED6,31851,9,11,2,109.71736,18.29007,2316
47288,C834EF1A38F263607CE4942426932ED6,30081,15,18,3,109.50243,18.26632,1512
47289,C834EF1A38F263607CE4942426932ED6,30711,18,19,1,109.50271,18.25347,1510
47290,C834EF1A38F263607CE4942426932ED6,30281,19,20,1,109.50597,18.27583,1514
47291,C834EF1A38F263607CE4942426932ED6,30711,21,22,1,109.50271,18.25347,1510
47292,C425D181738CCF9419F024C82994FF27,30851,12,18,6,109.5616,18.27396,1713
47293,C425D181738CCF9419F024C82994FF27,31561,20,22,2,109.56792,18.28479,1765
47300,2EADBBB6C6C164CAD4547374810838B0,30201,0,7,7,109.4909,18.26465,1462
47301,2EADBBB6C6C164CAD4547374810838B0,60552,8,10,2,109.41729,18.30014,1218
47302,2EADBBB6C6C164CAD4547374810838B0,31301,10,12,2,109.14493,18.31222,170
47303,2EADBBB6C6C164CAD4547374810838B0,31471,14,15,1,109.34583,18.29563,917
47304,2EADBBB6C6C164CAD4547374810838B0,30821,18,19,1,109.43681,18.33639,1274
47305,2EADBBB6C6C164CAD4547374810838B0,30201,20,22,2,109.4909,18.26465,1462
47331,1A1509AC6E667B603EE3773D1273B7B0,30421,18,20,2,109.50021,18.25861,1511
47332,1A1509AC6E667B603EE3773D1273B7B0,31091,21,22,1,109.41201,18.31222,1170
47388,C8135D3E403B7CC96352A41CBCD291A7,38241,0,7,7,109.54111,18.30542,1669
47389,C8135D3E403B7CC96352A41CBCD291A7,31931,11,15,4,109.54771,18.29403,1667
47390,C8135D3E403B7CC96352A41CBCD291A7,38241,16,18,2,109.54111,18.30542,1669
47391,C8135D3E403B7CC96352A41CBCD291A7,30921,20,23,3,109.53903,18.29451,1667
47423,E0223036572082E83876AFB7D72B2DD2,30921,0,1,1,109.53903,18.29451,1667
47424,E0223036572082E83876AFB7D72B2DD2,31931,4,5,1,109.54771,18.29403,1667
47425,E0223036572082E83876AFB7D72B2DD2,30921,6,7,1,109.53903,18.29451,1667
47435,BCF86295AA2D4858A2FA047D814B97DE,39183,3,7,4,109.55542,18.28208,1715
47436,BCF86295AA2D4858A2FA047D814B97DE,31071,11,17,6,109.58257,18.28458,1815
47437,BCF86295AA2D4858A2FA047D814B97DE,30854,18,23,5,109.56889,18.27076,1763
47465,972967B6F1349FDD6DE1B1DC6FF352B3,31521,18,21,3,109.51458,18.22542,1555
47466,972967B6F1349FDD6DE1B1DC6FF352B3,60381,21,23,2,109.5241,18.22458,1605
47477,44B51AB0086A395492A545161BBB3047,39111,0,3,3,109.5191,18.22597,1555
47478,44B51AB0086A395492A545161BBB3047,31521,4,9,5,109.51458,18.22542,1555
47479,44B51AB0086A395492A545161BBB3047,39321,9,12,3,109.529,18.2167,1604
47480,44B51AB0086A395492A545161BBB3047,60381,14,17,3,109.5241,18.22458,1605
47481,44B51AB0086A395492A545161BBB3047,31521,17,19,2,109.51458,18.22542,1555
47482,44B51AB0086A395492A545161BBB3047,31521,19,23,4,109.51458,18.22542,1555
47560,0C8D15C0488D521680F0DE3A28CFE111,31811,0,6,6,109.54201,18.31806,1671
47561,0C8D15C0488D521680F0DE3A28CFE111,30701,6,21,15,109.59313,18.32007,1871
47562,0C8D15C0488D521680F0DE3A28CFE111,31811,22,23,1,109.54201,18.31806,1671
47585,B91A19B1FD9FC6BA8C6D18C2634BCD94,38052,0,19,19,109.62618,18.23042,1956
47586,B91A19B1FD9FC6BA8C6D18C2634BCD94,30581,19,21,2,109.62257,18.24951,1959
47587,B91A19B1FD9FC6BA8C6D18C2634BCD94,60594,21,23,2,109.62694,18.22799,1956
47597,CA3896FB33E9BC68E91955EDFF5D709B,60631,1,7,6,109.57778,18.27583,1814
47598,CA3896FB33E9BC68E91955EDFF5D709B,31945,9,10,1,109.58021,18.29403,1817
47599,CA3896FB33E9BC68E91955EDFF5D709B,30854,10,13,3,109.56889,18.27076,1763
47612,64F4CDF664AA04E7B79DE93C57128CF6,31931,0,7,7,109.54771,18.29403,1667
47613,64F4CDF664AA04E7B79DE93C57128CF6,39181,9,17,8,109.55153,18.28035,1715
47614,64F4CDF664AA04E7B79DE93C57128CF6,31931,22,23,1,109.54771,18.29403,1667
47622,BBD9C34CBFBB91B9631A99054896F05A,31941,5,8,3,109.62451,18.31222,1970
47625,BBD9C34CBFBB91B9631A99054896F05A,39191,20,22,2,109.51493,18.23472,1557
47626,45CCFCD3EBDF941E1C92B70ED06E8B5E,30854,0,17,17,109.56889,18.27076,1763
47627,45CCFCD3EBDF941E1C92B70ED06E8B5E,31561,21,22,1,109.56792,18.28479,1765
47670,41DC1447E442C6A02FED34B3723350A6,30971,16,17,1,109.48708,18.29319,1467
47671,41DC1447E442C6A02FED34B3723350A6,60381,18,23,5,109.5241,18.22458,1605
47685,5ACB2494699EB2F10AA3427B417842C4,39091,13,16,3,109.50097,18.25222,1510
47689,CFF644097BADAEEAF540049CB3A91F42,39111,0,7,7,109.5191,18.22597,1555
47690,CFF644097BADAEEAF540049CB3A91F42,31145,10,12,2,109.20431,18.30479,369
47691,CFF644097BADAEEAF540049CB3A91F42,31521,16,17,1,109.51458,18.22542,1555
47692,CFF644097BADAEEAF540049CB3A91F42,60381,19,21,2,109.5241,18.22458,1605
47739,DB190B6B2094B1275C5FEDCD655A516B,31811,0,6,6,109.54201,18.31806,1671
47740,DB190B6B2094B1275C5FEDCD655A516B,39081,11,12,1,109.19382,18.29111,366
47741,DB190B6B2094B1275C5FEDCD655A516B,60054,15,16,1,109.3016,18.31229,770
47742,DB190B6B2094B1275C5FEDCD655A516B,31811,18,19,1,109.54201,18.31806,1671
47773,73D13478BB2B18F309F322A91E52830F,31081,0,7,7,109.44639,18.30181,1318
47774,73D13478BB2B18F309F322A91E52830F,31471,12,14,2,109.34583,18.29563,917
47775,73D13478BB2B18F309F322A91E52830F,60551,19,20,1,109.42722,18.30111,1218
47785,617D274C6203C3080475711DB0A2A53F,31521,0,7,7,109.51458,18.22542,1555
47786,617D274C6203C3080475711DB0A2A53F,31521,8,10,2,109.51458,18.22542,1555
47787,617D274C6203C3080475711DB0A2A53F,60381,11,13,2,109.5241,18.22458,1605
47788,617D274C6203C3080475711DB0A2A53F,31521,13,18,5,109.51458,18.22542,1555
47789,617D274C6203C3080475711DB0A2A53F,60381,19,21,2,109.5241,18.22458,1605
47824,E65658506C2BF9C993BA69EE6D38B3C6,31951,1,19,18,109.52174,18.30299,1568
47825,E65658506C2BF9C993BA69EE6D38B3C6,31561,21,22,1,109.56792,18.28479,1765
47853,B3A1AC27CB357708CE63D3E4F68BF2E7,30854,9,19,10,109.56889,18.27076,1763
47854,B3A1AC27CB357708CE63D3E4F68BF2E7,31071,19,21,2,109.58257,18.28458,1815
47855,B3A1AC27CB357708CE63D3E4F68BF2E7,30854,22,23,1,109.56889,18.27076,1763
47873,149F44702DEC8C73589BE6524F0A1FFD,30854,1,11,10,109.56889,18.27076,1763
47874,149F44702DEC8C73589BE6524F0A1FFD,38085,15,23,8,109.6291,18.23625,2007
47940,676BED5E3C1811E8B533688BEDCC91B7,31021,0,8,8,109.49021,18.27,1463
47941,676BED5E3C1811E8B533688BEDCC91B7,60441,11,15,4,109.46792,18.28604,1366
47942,676BED5E3C1811E8B533688BEDCC91B7,31021,16,18,2,109.49021,18.27,1463
47961,B871522C394F4429C8D66865C530B2B2,60551,0,1,1,109.42722,18.30111,1218
47962,B871522C394F4429C8D66865C530B2B2,30671,2,3,1,109.43611,18.30139,1268
47963,B871522C394F4429C8D66865C530B2B2,60491,3,4,1,109.43354,18.30847,1269
47964,B871522C394F4429C8D66865C530B2B2,60551,6,7,1,109.42722,18.30111,1218
47965,B871522C394F4429C8D66865C530B2B2,31471,11,14,3,109.34583,18.29563,917
47966,B871522C394F4429C8D66865C530B2B2,31471,15,16,1,109.34583,18.29563,917
47967,B871522C394F4429C8D66865C530B2B2,60491,17,18,1,109.43354,18.30847,1269
48049,891EFF4C7017E69E0ADF4BB9FE2616FD,60524,0,4,4,109.42951,18.28993,1216
48050,891EFF4C7017E69E0ADF4BB9FE2616FD,31271,7,8,1,109.48958,18.26257,1462
48058,367FD9ECC2463438ADE3989905FE5BA2,39321,0,6,6,109.529,18.2167,1604
48059,367FD9ECC2463438ADE3989905FE5BA2,30971,8,9,1,109.48708,18.29319,1467
48060,367FD9ECC2463438ADE3989905FE5BA2,38951,12,23,11,109.48097,18.28868,1416
48065,48C4FC0F4987EC4FBC3EC910EA4A9934,31231,0,9,9,109.42597,18.29292,1217
48066,48C4FC0F4987EC4FBC3EC910EA4A9934,33051,13,14,1,109.6475,18.46618,2096
48067,48C4FC0F4987EC4FBC3EC910EA4A9934,30854,16,17,1,109.56889,18.27076,1763
48088,6587551DA47309E484D1302521C8D417,60631,3,4,1,109.57778,18.27583,1814
48089,6587551DA47309E484D1302521C8D417,38275,7,22,15,109.62875,18.22938,2006
48093,EFDE35289FEC1E13D6F34EFEE66A8AD2,31561,19,20,1,109.56792,18.28479,1765
48094,EFDE35289FEC1E13D6F34EFEE66A8AD2,60631,21,22,1,109.57778,18.27583,1814
48109,BCF7902B3144684D44567B20BDAA780E,30321,19,23,4,109.49563,18.29611,1467
48138,3977578BE56276DA0700B04B81DC1356,30851,0,14,14,109.5616,18.27396,1713
48139,3977578BE56276DA0700B04B81DC1356,31561,15,17,2,109.56792,18.28479,1765
48157,E5DA2FC779B1E8E31A367E849D1BF38A,30951,11,13,2,109.56208,18.25667,1761
48158,E5DA2FC779B1E8E31A367E849D1BF38A,30854,13,16,3,109.56889,18.27076,1763
48159,E5DA2FC779B1E8E31A367E849D1BF38A,38127,20,23,3,109.50833,18.27222,1513
48178,919B6D6CA33899F0F2E7C2D48DA4283C,39321,0,8,8,109.529,18.2167,1604
48179,919B6D6CA33899F0F2E7C2D48DA4283C,31801,10,11,1,109.20417,18.32118,371
48180,919B6D6CA33899F0F2E7C2D48DA4283C,31471,12,13,1,109.34583,18.29563,917
48181,919B6D6CA33899F0F2E7C2D48DA4283C,39321,15,23,8,109.529,18.2167,1604
48211,6527BE1E19E202485FE6583E7CEDE6A0,31521,0,1,1,109.51458,18.22542,1555
48212,6527BE1E19E202485FE6583E7CEDE6A0,30731,3,8,5,109.50944,18.22306,1555
48213,1EC821E40F7D3254B00CC9AB764BF161,38023,0,2,2,109.37132,18.28993,1016
48214,1EC821E40F7D3254B00CC9AB764BF161,38145,3,7,4,109.378,18.2912,1066
48276,0133DDFFB5CECBB261CEDEF10A82D50B,30854,1,8,7,109.56889,18.27076,1763
48277,0133DDFFB5CECBB261CEDEF10A82D50B,31561,10,12,2,109.56792,18.28479,1765
48278,0133DDFFB5CECBB261CEDEF10A82D50B,31071,12,13,1,109.58257,18.28458,1815
48279,0133DDFFB5CECBB261CEDEF10A82D50B,31561,15,16,1,109.56792,18.28479,1765
48282,24892DF473AC6ED4692FBD552CF21D37,60381,2,10,8,109.5241,18.22458,1605
48283,24892DF473AC6ED4692FBD552CF21D37,39321,10,13,3,109.529,18.2167,1604
48284,24892DF473AC6ED4692FBD552CF21D37,60381,13,23,10,109.5241,18.22458,1605
48285,44A75810FF8F9221047E9675BDBF60A2,31561,0,7,7,109.56792,18.28479,1765
48286,44A75810FF8F9221047E9675BDBF60A2,30854,12,13,1,109.56889,18.27076,1763
48287,44A75810FF8F9221047E9675BDBF60A2,31071,13,16,3,109.58257,18.28458,1815
48288,44A75810FF8F9221047E9675BDBF60A2,30854,16,18,2,109.56889,18.27076,1763
48289,44A75810FF8F9221047E9675BDBF60A2,31071,19,21,2,109.58257,18.28458,1815
48294,EEA6FAB436EFD40A971681E1E7E827FF,60594,0,8,8,109.62694,18.22799,1956
48295,EEA6FAB436EFD40A971681E1E7E827FF,31781,12,13,1,109.19847,18.2975,367
48296,EEA6FAB436EFD40A971681E1E7E827FF,38754,15,17,2,109.74667,18.37382,2430
48297,EEA6FAB436EFD40A971681E1E7E827FF,30581,19,20,1,109.62257,18.24951,1959
48298,EEA6FAB436EFD40A971681E1E7E827FF,60594,21,23,2,109.62694,18.22799,1956
48344,E3AA3CC18802E5190B3AA5A477107D6A,31071,1,7,6,109.58257,18.28458,1815
48345,E3AA3CC18802E5190B3AA5A477107D6A,30854,7,11,4,109.56889,18.27076,1763
48346,E3AA3CC18802E5190B3AA5A477107D6A,31071,13,23,10,109.58257,18.28458,1815
48350,0BBE0A7C0F4128829E11ADBE9E2E333B,31321,0,8,8,109.63799,18.23201,2007
48351,0BBE0A7C0F4128829E11ADBE9E2E333B,31781,12,13,1,109.19847,18.2975,367
48359,0E129C09250C0D46273B4BD7E5225556,30151,0,5,5,109.50986,18.25083,1560
48360,0E129C09250C0D46273B4BD7E5225556,60201,6,8,2,109.5041,18.2509,1510
48361,0E129C09250C0D46273B4BD7E5225556,38251,10,11,1,109.49618,18.25493,1510
48403,E6312CBC8153A9C6DAB83670095D0D25,38951,16,20,4,109.48097,18.28868,1416
48404,E6312CBC8153A9C6DAB83670095D0D25,38951,21,22,1,109.48097,18.28868,1416
48408,3F80F6C7ECC59E36D89C8EF1746C8724,38121,18,19,1,109.51361,18.27813,1564
48409,3F80F6C7ECC59E36D89C8EF1746C8724,31201,19,22,3,109.51042,18.23819,1558
48428,56C8C781972E8BFAF8A768A19AD7F590,38261,0,7,7,109.50361,18.28153,1515
48431,56C8C781972E8BFAF8A768A19AD7F590,38171,18,23,5,109.50799,18.28139,1515
48467,173CD7A2B7B334BC53A50A1D248FBCFE,31071,3,4,1,109.58257,18.28458,1815
48468,173CD7A2B7B334BC53A50A1D248FBCFE,30854,7,17,10,109.56889,18.27076,1763
48469,173CD7A2B7B334BC53A50A1D248FBCFE,31071,20,21,1,109.58257,18.28458,1815
48475,451E2BF48CD7B253EB0892324E679BCC,38297,0,7,7,109.52576,18.24965,1609
48476,451E2BF48CD7B253EB0892324E679BCC,60281,7,17,10,109.51743,18.25924,1561
48477,451E2BF48CD7B253EB0892324E679BCC,31461,17,18,1,109.5091,18.25389,1510
48478,451E2BF48CD7B253EB0892324E679BCC,38291,18,21,3,109.51618,18.24313,1558
48485,4DB778A581941E2A7955D8DA3B7ADAFE,31931,1,7,6,109.54771,18.29403,1667
48486,4DB778A581941E2A7955D8DA3B7ADAFE,31841,8,18,10,109.73201,18.33382,2373
48487,4DB778A581941E2A7955D8DA3B7ADAFE,31931,19,20,1,109.54771,18.29403,1667
48488,A5068BA438682A01E08CBBBB05E225FD,30211,0,5,5,109.49882,18.23931,1508
48489,A5068BA438682A01E08CBBBB05E225FD,31251,5,6,1,109.18528,18.2975,317
48490,A5068BA438682A01E08CBBBB05E225FD,60621,6,7,1,109.48354,18.27451,1464
48491,A5068BA438682A01E08CBBBB05E225FD,31781,9,11,2,109.19847,18.2975,367
48492,A5068BA438682A01E08CBBBB05E225FD,31471,13,14,1,109.34583,18.29563,917
48544,0D87DA60FDB2AF9A9FA2C393794B287E,31291,0,9,9,109.30375,18.40729,786
48596,DDE77D3A656666992FC3458B84010D43,39183,0,6,6,109.55542,18.28208,1715
48597,DDE77D3A656666992FC3458B84010D43,31561,6,7,1,109.56792,18.28479,1765
48598,DDE77D3A656666992FC3458B84010D43,39183,11,20,9,109.55542,18.28208,1715
48645,38A8595594DC26AD8BE733FC85DB4CA6,31631,0,16,16,109.59542,18.36826,1879
48646,38A8595594DC26AD8BE733FC85DB4CA6,30101,16,18,2,109.57299,18.33333,1773
48647,38A8595594DC26AD8BE733FC85DB4CA6,31631,21,23,2,109.59542,18.36826,1879
48664,2C3BD53A8702A47FB82F05FB4993B683,31561,0,13,13,109.56792,18.28479,1765
48665,2C3BD53A8702A47FB82F05FB4993B683,30854,14,16,2,109.56889,18.27076,1763
48680,2D747BB9EF94A7A497B1722BD009FBFB,30854,4,13,9,109.56889,18.27076,1763
48681,2D747BB9EF94A7A497B1722BD009FBFB,39183,17,18,1,109.55542,18.28208,1715
48691,122DBE3548D9D99C856018D6EE8E2161,31721,0,6,6,109.67938,18.24014,2158
48692,122DBE3548D9D99C856018D6EE8E2161,30441,7,8,1,109.64021,18.25424,2010
48693,122DBE3548D9D99C856018D6EE8E2161,30121,10,23,13,109.52861,18.27222,1613
48694,F5FA9E3AD48A61D07594249E558C93A1,60401,0,1,1,109.47444,18.27583,1414
48695,F5FA9E3AD48A61D07594249E558C93A1,31231,2,5,3,109.42597,18.29292,1217
48696,F5FA9E3AD48A61D07594249E558C93A1,60084,5,7,2,109.4984,18.2334,1507
48697,F5FA9E3AD48A61D07594249E558C93A1,60401,8,10,2,109.47444,18.27583,1414
48698,F5FA9E3AD48A61D07594249E558C93A1,38315,15,17,2,109.48979,18.29764,1467
48704,866460FA5062A635337B6369BB2AADDA,30854,2,7,5,109.56889,18.27076,1763
48705,866460FA5062A635337B6369BB2AADDA,60381,10,13,3,109.5241,18.22458,1605
48706,866460FA5062A635337B6369BB2AADDA,30854,18,19,1,109.56889,18.27076,1763
48719,C2622C284BAD8F487DCD454B3FAF9432,30721,0,13,13,109.51597,18.28257,1565
48720,C2622C284BAD8F487DCD454B3FAF9432,31121,14,22,8,109.16292,18.37063,230
48733,283001ED673D8EDBEF7EEB00BDB31533,30571,0,6,6,109.50243,18.21861,1504
48734,283001ED673D8EDBEF7EEB00BDB31533,31181,6,18,12,109.50382,18.24813,1509
48735,283001ED673D8EDBEF7EEB00BDB31533,30571,19,22,3,109.50243,18.21861,1504
48742,F0B6727884A767D82C873414BBDB13C7,30581,17,18,1,109.62257,18.24951,1959
48743,F0B6727884A767D82C873414BBDB13C7,60501,20,21,1,109.48701,18.29021,1466
48744,F0B6727884A767D82C873414BBDB13C7,31864,22,23,1,109.49014,18.28333,1465
48761,42923D86FCA39B981325B127230BF145,30101,1,3,2,109.57299,18.33333,1773
48762,42923D86FCA39B981325B127230BF145,39183,5,6,1,109.55542,18.28208,1715
48763,42923D86FCA39B981325B127230BF145,60117,8,9,1,109.73604,18.35681,2427
48764,42923D86FCA39B981325B127230BF145,30232,12,13,1,109.6191,18.31701,1971
48771,EDE78B6CF45A5ED767091F2988348E3D,38315,14,16,2,109.48979,18.29764,1467
48772,EDE78B6CF45A5ED767091F2988348E3D,30861,19,21,2,109.52722,18.22743,1606
48773,EB6BFD55088EBBC13FF4108BB4CD6C9F,60411,0,10,10,109.32514,18.30854,869
48774,EB6BFD55088EBBC13FF4108BB4CD6C9F,30661,11,13,2,109.37028,18.24361,1008
48775,EB6BFD55088EBBC13FF4108BB4CD6C9F,60054,14,15,1,109.3016,18.31229,770
48794,0E1B3CFC64EBB658DA96D0DCA834701E,61011,19,21,2,109.60653,18.19076,1900
48842,6B24823797A23CF47C34C631323C3D8C,31031,0,8,8,109.49979,18.25382,1510
48843,6B24823797A23CF47C34C631323C3D8C,31531,11,13,2,109.49583,18.25972,1461
48844,6B24823797A23CF47C34C631323C3D8C,31031,15,17,2,109.49979,18.25382,1510
48845,6B24823797A23CF47C34C631323C3D8C,38754,18,19,1,109.74667,18.37382,2430
48846,6B24823797A23CF47C34C631323C3D8C,31031,21,23,2,109.49979,18.25382,1510
48868,E144D2237263FD19C57C13D01FC7E08E,60054,10,11,1,109.3016,18.31229,770
48869,E144D2237263FD19C57C13D01FC7E08E,31471,12,14,2,109.34583,18.29563,917
48870,E144D2237263FD19C57C13D01FC7E08E,39091,15,16,1,109.50097,18.25222,1510
48872,D39D64452E6BBEF7B3056CA239E1B86E,30854,0,14,14,109.56889,18.27076,1763
48873,D39D64452E6BBEF7B3056CA239E1B86E,31561,14,15,1,109.56792,18.28479,1765
48874,D39D64452E6BBEF7B3056CA239E1B86E,30854,17,23,6,109.56889,18.27076,1763
48902,A3E72DA264E597E8FEA49E7837CC250A,31521,0,9,9,109.51458,18.22542,1555
48903,A3E72DA264E597E8FEA49E7837CC250A,31521,14,19,5,109.51458,18.22542,1555
48904,A3E72DA264E597E8FEA49E7837CC250A,30361,21,22,1,109.50347,18.24,1508
48923,FCB0C1D52F8BE5F0C9BD5C8F37313BFD,60241,12,14,2,109.53319,18.28667,1616
48924,FCB0C1D52F8BE5F0C9BD5C8F37313BFD,30721,16,18,2,109.51597,18.28257,1565
48973,34AB502A442AA8EA4A7FB30471B204DB,31471,10,11,1,109.34583,18.29563,917
48974,34AB502A442AA8EA4A7FB30471B204DB,60054,11,13,2,109.3016,18.31229,770
48975,34AB502A442AA8EA4A7FB30471B204DB,38251,15,16,1,109.49618,18.25493,1510
48976,34AB502A442AA8EA4A7FB30471B204DB,30171,20,23,3,109.48458,18.27139,1463
49020,5EB757C8918F704B5295B0BDE01D6841,31351,0,3,3,109.4959,18.28417,1465
49021,5EB757C8918F704B5295B0BDE01D6841,31701,4,8,4,109.44132,18.28833,1266
49022,5EB757C8918F704B5295B0BDE01D6841,38162,9,10,1,109.43944,18.28889,1266
49031,5FF9CBAB281B4ADF0AD2A70608A00E08,30241,10,11,1,109.26174,18.3275,622
49032,5FF9CBAB281B4ADF0AD2A70608A00E08,60614,15,17,2,109.48799,18.29521,1467
49078,E962C3D0A8FC163364DD770DFBF0ADE9,60121,14,15,1,109.74507,18.37472,2430
49097,0D61EA75C03A93303AE1706E6D1B22F4,30201,0,8,8,109.4909,18.26465,1462
49098,0D61EA75C03A93303AE1706E6D1B22F4,60281,9,11,2,109.51743,18.25924,1561
49099,0D61EA75C03A93303AE1706E6D1B22F4,30201,11,13,2,109.4909,18.26465,1462
49100,0D61EA75C03A93303AE1706E6D1B22F4,60311,16,21,5,109.52097,18.24319,1558
49141,2B3D1202B9CAAA0F3B6C3510362F28D1,30201,0,7,7,109.4909,18.26465,1462
49142,2B3D1202B9CAAA0F3B6C3510362F28D1,31101,11,12,1,109.65389,18.23403,2057
49143,2B3D1202B9CAAA0F3B6C3510362F28D1,31101,13,15,2,109.65389,18.23403,2057
49144,63FBAC0202144B00077561285E6A7F87,30821,0,13,13,109.43681,18.33639,1274
49145,63FBAC0202144B00077561285E6A7F87,30651,14,15,1,109.42611,18.385,1232
49146,63FBAC0202144B00077561285E6A7F87,30821,15,23,8,109.43681,18.33639,1274
49173,070984703178D21DC5287E457C03691A,39181,0,5,5,109.55153,18.28035,1715
49174,070984703178D21DC5287E457C03691A,31931,7,9,2,109.54771,18.29403,1667
49175,070984703178D21DC5287E457C03691A,39181,9,12,3,109.55153,18.28035,1715
49192,87ADC98470D754E65D1F229228B379D5,30851,0,6,6,109.5616,18.27396,1713
49193,87ADC98470D754E65D1F229228B379D5,30201,7,9,2,109.4909,18.26465,1462
49194,87ADC98470D754E65D1F229228B379D5,30851,12,23,11,109.5616,18.27396,1713
49214,225EDE82328108AFB3E7EE610CA3F074,31931,0,18,18,109.54771,18.29403,1667
49215,225EDE82328108AFB3E7EE610CA3F074,60371,20,21,1,109.53063,18.30056,1618
49299,1593E13193A160EF9BE2323C5CE79FFF,31931,0,1,1,109.54771,18.29403,1667
49300,1593E13193A160EF9BE2323C5CE79FFF,38241,1,23,22,109.54111,18.30542,1669
49348,4275FD70CE0658198E368801C2857FA2,31521,0,9,9,109.51458,18.22542,1555
49389,B47BACC30D9A35D35F1E9FB0E5DF7D48,31071,2,6,4,109.58257,18.28458,1815
49390,B47BACC30D9A35D35F1E9FB0E5DF7D48,30854,11,12,1,109.56889,18.27076,1763
49391,B47BACC30D9A35D35F1E9FB0E5DF7D48,31071,14,19,5,109.58257,18.28458,1815
49392,B47BACC30D9A35D35F1E9FB0E5DF7D48,30854,22,23,1,109.56889,18.27076,1763
49429,64EA917EAAD3EB55DA2ABB227203C131,60631,0,6,6,109.57778,18.27583,1814
49430,64EA917EAAD3EB55DA2ABB227203C131,30851,9,10,1,109.5616,18.27396,1713
49431,64EA917EAAD3EB55DA2ABB227203C131,31071,13,17,4,109.58257,18.28458,1815
49432,48C2384D12D5B16772007E35CE360CBB,30721,0,19,19,109.51597,18.28257,1565
49433,48C2384D12D5B16772007E35CE360CBB,38185,21,22,1,109.51333,18.27347,1563
49454,60085C98EDC64770922E20845B09F807,31931,0,17,17,109.54771,18.29403,1667
49455,60085C98EDC64770922E20845B09F807,39181,17,19,2,109.55153,18.28035,1715
49456,60085C98EDC64770922E20845B09F807,31931,19,23,4,109.54771,18.29403,1667
49471,82EB7611DCDB84F91528CD6B7C229C51,39091,8,9,1,109.50097,18.25222,1510
49472,82EB7611DCDB84F91528CD6B7C229C51,31471,11,12,1,109.34583,18.29563,917
49473,82EB7611DCDB84F91528CD6B7C229C51,31471,14,15,1,109.34583,18.29563,917
49488,14F4ACAD1B4C4B8CE52F7EFB2E582792,31031,0,5,5,109.49979,18.25382,1510
49489,14F4ACAD1B4C4B8CE52F7EFB2E582792,31031,6,11,5,109.49979,18.25382,1510
49490,14F4ACAD1B4C4B8CE52F7EFB2E582792,31534,11,13,2,109.49368,18.25806,1461
49491,14F4ACAD1B4C4B8CE52F7EFB2E582792,31031,13,15,2,109.49979,18.25382,1510
49492,14F4ACAD1B4C4B8CE52F7EFB2E582792,31461,18,20,2,109.5091,18.25389,1510
49493,14F4ACAD1B4C4B8CE52F7EFB2E582792,31031,21,23,2,109.49979,18.25382,1510
49513,FBE9370FE25A2FA07998471D4C524639,31471,1,2,1,109.34583,18.29563,917
49514,FBE9370FE25A2FA07998471D4C524639,30661,2,6,4,109.37028,18.24361,1008
49515,FBE9370FE25A2FA07998471D4C524639,60411,6,7,1,109.32514,18.30854,869
49516,FBE9370FE25A2FA07998471D4C524639,31471,8,10,2,109.34583,18.29563,917
49517,FBE9370FE25A2FA07998471D4C524639,31471,11,15,4,109.34583,18.29563,917
49526,31BAA46A2F25AC63D78E0ACA44BF0FE9,39181,0,7,7,109.55153,18.28035,1715
49527,31BAA46A2F25AC63D78E0ACA44BF0FE9,31931,8,15,7,109.54771,18.29403,1667
49528,31BAA46A2F25AC63D78E0ACA44BF0FE9,39181,15,23,8,109.55153,18.28035,1715
49572,C25D5C616C048636FA7F718C694FFBDC,31521,16,19,3,109.51458,18.22542,1555
49573,C25D5C616C048636FA7F718C694FFBDC,38111,20,21,1,109.52007,18.22403,1555
49574,C25D5C616C048636FA7F718C694FFBDC,31521,21,22,1,109.51458,18.22542,1555
49633,D080330F46FFE140C3D67F6850CA9E9D,31531,0,8,8,109.49583,18.25972,1461
49634,D080330F46FFE140C3D67F6850CA9E9D,31781,11,13,2,109.19847,18.2975,367
49635,D080330F46FFE140C3D67F6850CA9E9D,31531,18,19,1,109.49583,18.25972,1461
49636,D080330F46FFE140C3D67F6850CA9E9D,38251,20,21,1,109.49618,18.25493,1510
49676,CC4662D0AB761935A19DD4261E4FE213,31561,0,6,6,109.56792,18.28479,1765
49677,CC4662D0AB761935A19DD4261E4FE213,30851,9,10,1,109.5616,18.27396,1713
49678,CC4662D0AB761935A19DD4261E4FE213,31561,15,23,8,109.56792,18.28479,1765
49689,000AECFEC5FE1C4D11E1909AB25C278D,60161,0,11,11,109.49174,18.26181,1461
49703,70A62761FE79F922D082380DA7747243,31561,0,6,6,109.56792,18.28479,1765
49704,70A62761FE79F922D082380DA7747243,30854,10,22,12,109.56889,18.27076,1763
49716,E4B522EF4348156010E5C578EC13D60F,30191,0,2,2,109.50361,18.22701,1506
49717,E4B522EF4348156010E5C578EC13D60F,30854,3,4,1,109.56889,18.27076,1763
49718,E4B522EF4348156010E5C578EC13D60F,31945,4,5,1,109.58021,18.29403,1817
49719,E4B522EF4348156010E5C578EC13D60F,30854,11,17,6,109.56889,18.27076,1763
49720,E4B522EF4348156010E5C578EC13D60F,38205,19,20,1,109.62743,18.23139,1956
49726,7168F7EAD82B76A2A520C85DAB769D72,39183,1,9,8,109.55542,18.28208,1715
49727,7168F7EAD82B76A2A520C85DAB769D72,31561,14,16,2,109.56792,18.28479,1765
49728,7168F7EAD82B76A2A520C85DAB769D72,30854,18,20,2,109.56889,18.27076,1763
49729,71E19E1917BF3FC55A3CE758E0010AE6,31391,0,15,15,109.50382,18.24285,1508
49761,9AA539837E311390E257930DE90B7B56,38391,0,1,1,109.44111,18.29083,1266
49762,9AA539837E311390E257930DE90B7B56,31701,2,8,6,109.44132,18.28833,1266
49763,9AA539837E311390E257930DE90B7B56,38315,12,14,2,109.48979,18.29764,1467
49821,2AB873DF25588EC945CFF2CC54F197C3,30581,0,8,8,109.62257,18.24951,1959
49822,2AB873DF25588EC945CFF2CC54F197C3,31471,13,15,2,109.34583,18.29563,917
49823,2AB873DF25588EC945CFF2CC54F197C3,30581,19,23,4,109.62257,18.24951,1959
49845,608A55C14BAB2A5B627ACC1F39B89FB6,31945,0,7,7,109.58021,18.29403,1817
49846,608A55C14BAB2A5B627ACC1F39B89FB6,31071,10,11,1,109.58257,18.28458,1815
49847,608A55C14BAB2A5B627ACC1F39B89FB6,31945,12,13,1,109.58021,18.29403,1817
49848,608A55C14BAB2A5B627ACC1F39B89FB6,30854,13,17,4,109.56889,18.27076,1763
49849,608A55C14BAB2A5B627ACC1F39B89FB6,31071,18,20,2,109.58257,18.28458,1815
49850,608A55C14BAB2A5B627ACC1F39B89FB6,31945,21,23,2,109.58021,18.29403,1817
49879,10EBF762D28520B09848288F7052CFDE,30854,0,5,5,109.56889,18.27076,1763
49880,10EBF762D28520B09848288F7052CFDE,39101,7,11,4,109.50132,18.24931,1509
49881,10EBF762D28520B09848288F7052CFDE,39101,14,15,1,109.50132,18.24931,1509
49882,10EBF762D28520B09848288F7052CFDE,30854,18,20,2,109.56889,18.27076,1763
49883,10EBF762D28520B09848288F7052CFDE,31071,20,23,3,109.58257,18.28458,1815
49904,82ACC50762A431B4A2E6C3A41E29B2C7,30101,0,8,8,109.57299,18.33333,1773
49905,82ACC50762A431B4A2E6C3A41E29B2C7,30071,12,17,5,109.52819,18.30472,1619
49906,82ACC50762A431B4A2E6C3A41E29B2C7,60361,20,21,1,109.51938,18.29681,1567
49907,82ACC50762A431B4A2E6C3A41E29B2C7,30101,22,23,1,109.57299,18.33333,1773
49914,6E6193514D8E876D83956A94AD4F3FB1,31931,0,8,8,109.54771,18.29403,1667
49915,6E6193514D8E876D83956A94AD4F3FB1,30921,10,11,1,109.53903,18.29451,1667
49916,6E6193514D8E876D83956A94AD4F3FB1,31931,12,14,2,109.54771,18.29403,1667
49917,6E6193514D8E876D83956A94AD4F3FB1,30071,18,20,2,109.52819,18.30472,1619
49918,6E6193514D8E876D83956A94AD4F3FB1,31931,21,22,1,109.54771,18.29403,1667
49924,EF189AF224755104A3EF0837AE0BC2BB,30711,0,1,1,109.50271,18.25347,1510
49925,EF189AF224755104A3EF0837AE0BC2BB,60281,2,14,12,109.51743,18.25924,1561
49926,EF189AF224755104A3EF0837AE0BC2BB,31461,17,18,1,109.5091,18.25389,1510
49934,B2B62201EF4A108EDC8EB73A48BE86EA,30111,0,1,1,109.47583,18.30542,1419
49935,B2B62201EF4A108EDC8EB73A48BE86EA,38871,2,9,7,109.44681,18.28625,1316
49936,B2B62201EF4A108EDC8EB73A48BE86EA,31431,10,12,2,109.44639,18.29042,1316
49937,B2B62201EF4A108EDC8EB73A48BE86EA,31431,13,17,4,109.44639,18.29042,1316
49943,9A369E1280A8BB5227D2B6A5698033ED,60121,17,19,2,109.74507,18.37472,2430
49946,2BF695F70882DCFE1A4499C31C4A9579,60594,0,3,3,109.62694,18.22799,1956
49947,2BF695F70882DCFE1A4499C31C4A9579,38331,3,6,3,109.62465,18.22736,1956
49948,2BF695F70882DCFE1A4499C31C4A9579,38052,7,13,6,109.62618,18.23042,1956
49949,2BF695F70882DCFE1A4499C31C4A9579,31321,13,15,2,109.63799,18.23201,2007
49950,2BF695F70882DCFE1A4499C31C4A9579,38052,15,18,3,109.62618,18.23042,1956
49951,2BF695F70882DCFE1A4499C31C4A9579,38331,19,21,2,109.62465,18.22736,1956
49961,C61360C6C8202A54143E165C2C08120B,30951,0,1,1,109.56208,18.25667,1761
49962,C61360C6C8202A54143E165C2C08120B,30232,1,2,1,109.6191,18.31701,1971
49963,C61360C6C8202A54143E165C2C08120B,30951,3,7,4,109.56208,18.25667,1761
49964,C61360C6C8202A54143E165C2C08120B,30851,11,12,1,109.5616,18.27396,1713
49985,AAB3DCB18BAF89954DC0C8A658A6D766,38251,0,2,2,109.49618,18.25493,1510
49986,AAB3DCB18BAF89954DC0C8A658A6D766,60231,4,5,1,109.49903,18.21972,1504
49987,AAB3DCB18BAF89954DC0C8A658A6D766,31031,5,6,1,109.49979,18.25382,1510
49988,AAB3DCB18BAF89954DC0C8A658A6D766,30051,8,10,2,109.48917,18.21215,1453
49989,AAB3DCB18BAF89954DC0C8A658A6D766,60231,12,13,1,109.49903,18.21972,1504
49998,6EE484A856A2F2B5959CBB035140462D,60641,0,6,6,109.53854,18.2359,1657
49999,6EE484A856A2F2B5959CBB035140462D,31701,10,12,2,109.44132,18.28833,1266
50016,F84CB73131A8F3F2021BE5E4FA198E87,30861,12,16,4,109.52722,18.22743,1606
50017,F84CB73131A8F3F2021BE5E4FA198E87,31031,17,19,2,109.49979,18.25382,1510
50024,F277E39F930DABB1C32B459808E7C21D,31534,0,7,7,109.49368,18.25806,1461
50025,F277E39F930DABB1C32B459808E7C21D,30071,12,13,1,109.52819,18.30472,1619
50081,7260738E9AF8A6F148DEA7642BD04088,31534,0,10,10,109.49368,18.25806,1461
50083,B61666307486DD531F980787F0F8A7B7,60631,2,3,1,109.57778,18.27583,1814
50084,B61666307486DD531F980787F0F8A7B7,30854,4,5,1,109.56889,18.27076,1763
50085,B61666307486DD531F980787F0F8A7B7,60631,5,17,12,109.57778,18.27583,1814
50086,B61666307486DD531F980787F0F8A7B7,30854,17,19,2,109.56889,18.27076,1763
50102,E605B26D53F08A0D3360A4541E09F4E2,30721,1,8,7,109.51597,18.28257,1565
50103,E605B26D53F08A0D3360A4541E09F4E2,38283,9,12,3,109.62229,18.22618,1956
50104,E605B26D53F08A0D3360A4541E09F4E2,38283,14,17,3,109.62229,18.22618,1956
50105,E605B26D53F08A0D3360A4541E09F4E2,30721,20,23,3,109.51597,18.28257,1565
50109,6DF7485545B790F22810B0EDD8F1B356,31945,0,7,7,109.58021,18.29403,1817
50110,6DF7485545B790F22810B0EDD8F1B356,30854,8,9,1,109.56889,18.27076,1763
50111,6DF7485545B790F22810B0EDD8F1B356,31945,12,13,1,109.58021,18.29403,1817
50112,6DF7485545B790F22810B0EDD8F1B356,30854,15,17,2,109.56889,18.27076,1763
50113,6DF7485545B790F22810B0EDD8F1B356,30711,18,21,3,109.50271,18.25347,1510
50143,2C5F898948A2B7909519666936FBF333,38707,0,9,9,109.73778,18.35368,2427
50144,2C5F898948A2B7909519666936FBF333,38707,11,13,2,109.73778,18.35368,2427
50145,2C5F898948A2B7909519666936FBF333,38707,15,17,2,109.73778,18.35368,2427
50146,2C5F898948A2B7909519666936FBF333,31161,19,22,3,109.70229,18.31361,2270
50157,F167FEC88E6854C4E8BE1680AD709113,30861,0,7,7,109.52722,18.22743,1606
50158,F167FEC88E6854C4E8BE1680AD709113,30971,8,9,1,109.48708,18.29319,1467
50159,F167FEC88E6854C4E8BE1680AD709113,30971,10,11,1,109.48708,18.29319,1467
50160,F167FEC88E6854C4E8BE1680AD709113,38951,12,21,9,109.48097,18.28868,1416
50202,820C7A160D6A8FFF0CCE914B15E69B50,30721,0,8,8,109.51597,18.28257,1565
50203,820C7A160D6A8FFF0CCE914B15E69B50,39154,9,12,3,109.50201,18.25681,1511
50204,820C7A160D6A8FFF0CCE914B15E69B50,30721,13,23,10,109.51597,18.28257,1565
50207,80A003466CAB94607199247E4F269A75,39091,12,15,3,109.50097,18.25222,1510
50226,07F3C4748B468EDA7E91DFDA551BC9A2,33354,0,7,7,109.67465,18.44583,2192
50227,07F3C4748B468EDA7E91DFDA551BC9A2,31781,9,11,2,109.19847,18.2975,367
50228,07F3C4748B468EDA7E91DFDA551BC9A2,31471,13,15,2,109.34583,18.29563,917
50229,07F3C4748B468EDA7E91DFDA551BC9A2,38023,16,17,1,109.37132,18.28993,1016
50230,07F3C4748B468EDA7E91DFDA551BC9A2,60221,19,21,2,109.52569,18.29188,1616
50231,07F3C4748B468EDA7E91DFDA551BC9A2,38023,21,23,2,109.37132,18.28993,1016
50247,C48911F2501F3C5309DA39E0641B7D38,31071,1,3,2,109.58257,18.28458,1815
50248,C48911F2501F3C5309DA39E0641B7D38,30854,7,9,2,109.56889,18.27076,1763
50249,C48911F2501F3C5309DA39E0641B7D38,31071,9,19,10,109.58257,18.28458,1815
50250,C48911F2501F3C5309DA39E0641B7D38,30854,19,22,3,109.56889,18.27076,1763
50264,96994AD87756271E307B81F41E5136D2,30854,0,10,10,109.56889,18.27076,1763
50265,96994AD87756271E307B81F41E5136D2,31031,15,20,5,109.49979,18.25382,1510
50266,96994AD87756271E307B81F41E5136D2,39151,22,23,1,109.49875,18.25097,1510
50274,0F558B6653C655C7F0BAEA9D66B33F57,31071,2,7,5,109.58257,18.28458,1815
50275,0F558B6653C655C7F0BAEA9D66B33F57,30854,8,18,10,109.56889,18.27076,1763
50276,0F558B6653C655C7F0BAEA9D66B33F57,30421,19,21,2,109.50021,18.25861,1511
50319,7421066246AAD1C230E7E2A7ADF06E9D,60631,5,7,2,109.57778,18.27583,1814
50320,7421066246AAD1C230E7E2A7ADF06E9D,30854,7,18,11,109.56889,18.27076,1763
50321,7421066246AAD1C230E7E2A7ADF06E9D,30421,19,21,2,109.50021,18.25861,1511
50345,A01B4012B619D942E7CC3AC9B78722B4,31561,0,1,1,109.56792,18.28479,1765
50346,A01B4012B619D942E7CC3AC9B78722B4,30851,2,7,5,109.5616,18.27396,1713
50347,A01B4012B619D942E7CC3AC9B78722B4,31561,11,22,11,109.56792,18.28479,1765
50352,77CEA39CA686523ACAD4D7ACE43C45F6,31351,13,15,2,109.4959,18.28417,1465
50353,77CEA39CA686523ACAD4D7ACE43C45F6,30351,15,21,6,109.41701,18.29292,1217
50374,417408FFDA93B177641D270D3A5C4B2D,30891,0,4,4,109.59431,18.28389,1865
50375,417408FFDA93B177641D270D3A5C4B2D,60631,8,17,9,109.57778,18.27583,1814
50376,417408FFDA93B177641D270D3A5C4B2D,31071,20,23,3,109.58257,18.28458,1815
50377,131FD19D60F318F2E92456D189868A09,60054,11,13,2,109.3016,18.31229,770
50378,131FD19D60F318F2E92456D189868A09,31781,15,16,1,109.19847,18.2975,367
50401,B66AAE657FB7958F5827047B5F8024B6,60631,2,6,4,109.57778,18.27583,1814
50402,B66AAE657FB7958F5827047B5F8024B6,31561,11,12,1,109.56792,18.28479,1765
50403,B66AAE657FB7958F5827047B5F8024B6,30851,13,14,1,109.5616,18.27396,1713
50404,B66AAE657FB7958F5827047B5F8024B6,30854,18,20,2,109.56889,18.27076,1763
50412,2A3E5205AC8230AFA039AD71C1DA60B8,38185,1,2,1,109.51333,18.27347,1563
50413,2A3E5205AC8230AFA039AD71C1DA60B8,38157,5,7,2,109.51483,18.26958,1563
50414,2A3E5205AC8230AFA039AD71C1DA60B8,30211,8,10,2,109.49882,18.23931,1508
50415,2A3E5205AC8230AFA039AD71C1DA60B8,31554,11,22,11,109.55521,18.2459,1709
50438,A119B093D14CCB6B6870AA9A88D1F972,30051,0,7,7,109.48917,18.21215,1453
50439,A119B093D14CCB6B6870AA9A88D1F972,60621,7,9,2,109.48354,18.27451,1464
50440,A119B093D14CCB6B6870AA9A88D1F972,60054,11,13,2,109.3016,18.31229,770
50441,A119B093D14CCB6B6870AA9A88D1F972,31031,15,17,2,109.49979,18.25382,1510
50442,A119B093D14CCB6B6870AA9A88D1F972,60621,19,21,2,109.48354,18.27451,1464
50443,A119B093D14CCB6B6870AA9A88D1F972,30051,21,23,2,109.48917,18.21215,1453
50468,8D0A4EF6BB9DEDE12E59D3FEDBD17479,31311,0,12,12,109.72299,18.27438,2364
50473,0A9117B90774715AACE2ED3045D6F579,60041,13,15,2,109.39889,18.31944,1121
50474,0A9117B90774715AACE2ED3045D6F579,31091,18,20,2,109.41201,18.31222,1170
50475,0A9117B90774715AACE2ED3045D6F579,31861,21,23,2,109.49042,18.27549,1464
50478,EA27C1DACC015E381783BB03940DBA88,31561,13,14,1,109.56792,18.28479,1765
50479,EA27C1DACC015E381783BB03940DBA88,39183,15,16,1,109.55542,18.28208,1715
50512,F866B6E34CEF853A6497211DD74A607E,30711,0,8,8,109.50271,18.25347,1510
50515,F866B6E34CEF853A6497211DD74A607E,30711,19,21,2,109.50271,18.25347,1510
50516,F866B6E34CEF853A6497211DD74A607E,31071,22,23,1,109.58257,18.28458,1815
50519,F3D63C0B2248B39F370D3CF39845220E,60614,16,17,1,109.48799,18.29521,1467
50520,F3D63C0B2248B39F370D3CF39845220E,38951,20,23,3,109.48097,18.28868,1416
50527,EFFEF00C078D502D6D0D1D469ACBA466,30281,19,21,2,109.50597,18.27583,1514
50528,EFFEF00C078D502D6D0D1D469ACBA466,38321,22,23,1,109.39854,18.29132,1116
50572,D2A5F87218CF25385163A2F3C4229CB8,31561,0,7,7,109.56792,18.28479,1765
50573,D2A5F87218CF25385163A2F3C4229CB8,30851,10,12,2,109.5616,18.27396,1713
50574,D2A5F87218CF25385163A2F3C4229CB8,31561,13,19,6,109.56792,18.28479,1765
50575,F1CC7A6DEAC0F0CAF8EACDD2FC371C14,38754,14,16,2,109.74667,18.37382,2430
50576,F1CC7A6DEAC0F0CAF8EACDD2FC371C14,39091,17,18,1,109.50097,18.25222,1510
50577,F1CC7A6DEAC0F0CAF8EACDD2FC371C14,31071,20,21,1,109.58257,18.28458,1815
50588,707670CE62A106DAC866A70B1F89E816,30581,0,8,8,109.62257,18.24951,1959
50589,707670CE62A106DAC866A70B1F89E816,60441,10,11,1,109.46792,18.28604,1366
50590,707670CE62A106DAC866A70B1F89E816,31471,12,15,3,109.34583,18.29563,917
50591,707670CE62A106DAC866A70B1F89E816,30581,19,23,4,109.62257,18.24951,1959
50603,C1602FB5A20BD98313F7CC13F431D061,30271,0,15,15,109.49132,18.23153,1456
50604,C1602FB5A20BD98313F7CC13F431D061,31031,15,17,2,109.49979,18.25382,1510
50605,C1602FB5A20BD98313F7CC13F431D061,30271,21,23,2,109.49132,18.23153,1456
50609,8DD23AA43C0F7967C45F7488D66F9159,31945,1,7,6,109.58021,18.29403,1817
50610,8DD23AA43C0F7967C45F7488D66F9159,30854,11,12,1,109.56889,18.27076,1763
50611,8DD23AA43C0F7967C45F7488D66F9159,31945,12,13,1,109.58021,18.29403,1817
50612,8DD23AA43C0F7967C45F7488D66F9159,30854,18,20,2,109.56889,18.27076,1763
50613,8DD23AA43C0F7967C45F7488D66F9159,31461,21,23,2,109.5091,18.25389,1510
50619,3B66C6D354CAB83AFF8CCC11FF0B09AC,60381,17,18,1,109.5241,18.22458,1605
50620,3B66C6D354CAB83AFF8CCC11FF0B09AC,60361,21,22,1,109.51938,18.29681,1567
50627,D2CF9265B60194574BF1A7726786A2D8,31145,10,15,5,109.20431,18.30479,369
50628,D2CF9265B60194574BF1A7726786A2D8,31304,17,18,1,109.15903,18.32854,223
50629,D2CF9265B60194574BF1A7726786A2D8,31541,19,21,2,109.1809,18.36722,329
50669,598A5BC9BEA86E74379689160E91B24E,30854,1,14,13,109.56889,18.27076,1763
50670,598A5BC9BEA86E74379689160E91B24E,31071,17,18,1,109.58257,18.28458,1815
50699,F4E8369A4C9B6C532D393F00D3A77C26,30854,0,7,7,109.56889,18.27076,1763
50700,F4E8369A4C9B6C532D393F00D3A77C26,39183,10,20,10,109.55542,18.28208,1715
50706,C339249D1ACA3291A5D7DAFA9F0D0DF2,38346,0,6,6,109.49688,18.21306,1503
50707,C339249D1ACA3291A5D7DAFA9F0D0DF2,38341,8,9,1,109.49965,18.21299,1503
50708,C339249D1ACA3291A5D7DAFA9F0D0DF2,31311,10,12,2,109.72299,18.27438,2364
50709,C339249D1ACA3291A5D7DAFA9F0D0DF2,60121,15,17,2,109.74507,18.37472,2430
50710,C339249D1ACA3291A5D7DAFA9F0D0DF2,31321,18,20,2,109.63799,18.23201,2007
50711,C339249D1ACA3291A5D7DAFA9F0D0DF2,60321,22,23,1,109.63611,18.24306,2008
50715,C76D7E78C5C113DAF50BFDE07720534D,30731,0,8,8,109.50944,18.22306,1555
50716,C76D7E78C5C113DAF50BFDE07720534D,31471,11,13,2,109.34583,18.29563,917
50717,C76D7E78C5C113DAF50BFDE07720534D,30361,14,16,2,109.50347,18.24,1508
50718,C76D7E78C5C113DAF50BFDE07720534D,30181,16,20,4,109.51597,18.23313,1557
50719,C76D7E78C5C113DAF50BFDE07720534D,31201,20,22,2,109.51042,18.23819,1558
50740,BFDE1CB7ED71CA9593AFA77408B12977,39183,0,1,1,109.55542,18.28208,1715
50741,BFDE1CB7ED71CA9593AFA77408B12977,30854,1,11,10,109.56889,18.27076,1763
50742,BFDE1CB7ED71CA9593AFA77408B12977,39183,14,21,7,109.55542,18.28208,1715
50743,1D8B56371E487F3812C9965576175C8D,38361,0,9,9,109.43667,18.29201,1267
50744,1D8B56371E487F3812C9965576175C8D,31811,13,14,1,109.54201,18.31806,1671
50750,9BD0746EAD915C7FE62E448DC71186FA,30854,13,15,2,109.56889,18.27076,1763
50751,9BD0746EAD915C7FE62E448DC71186FA,30711,17,18,1,109.50271,18.25347,1510
50752,9BD0746EAD915C7FE62E448DC71186FA,31071,20,21,1,109.58257,18.28458,1815
50769,1A4B51DFD66BF1F13D5FAE3E1A0A202C,30854,13,17,4,109.56889,18.27076,1763
50770,1A4B51DFD66BF1F13D5FAE3E1A0A202C,31071,21,22,1,109.58257,18.28458,1815
50799,B37777551ADDE84A1FDFE1FF465C24DC,30921,1,6,5,109.53903,18.29451,1667
50800,B37777551ADDE84A1FDFE1FF465C24DC,60301,10,11,1,109.60715,18.30993,1919
50801,B37777551ADDE84A1FDFE1FF465C24DC,31931,11,15,4,109.54771,18.29403,1667
50802,B37777551ADDE84A1FDFE1FF465C24DC,30921,19,20,1,109.53903,18.29451,1667
50863,EDD211647BCC1D3CABF473CB2801C791,31041,2,10,8,109.50278,18.23701,1507
50864,EDD211647BCC1D3CABF473CB2801C791,30161,11,23,12,109.50042,18.24389,1508
50873,7B2AEE2086698683607EDDDB4B678234,60201,13,15,2,109.5041,18.2509,1510
50874,7B2AEE2086698683607EDDDB4B678234,31461,15,18,3,109.5091,18.25389,1510
50875,7B2AEE2086698683607EDDDB4B678234,60221,19,21,2,109.52569,18.29188,1616
50910,E58F7930139B2ED51DE79005F05C056D,39183,14,15,1,109.55542,18.28208,1715
50911,E58F7930139B2ED51DE79005F05C056D,39181,18,23,5,109.55153,18.28035,1715
50912,856FED43C24F39C7284040D716161D86,31081,0,10,10,109.44639,18.30181,1318
50913,856FED43C24F39C7284040D716161D86,60381,11,13,2,109.5241,18.22458,1605
50914,856FED43C24F39C7284040D716161D86,60114,16,18,2,109.73028,18.33847,2374
50915,856FED43C24F39C7284040D716161D86,31021,19,20,1,109.49021,18.27,1463
50916,856FED43C24F39C7284040D716161D86,31081,21,23,2,109.44639,18.30181,1318
50921,EBF906C5498076BCFA3E97DF6001B4F3,30854,0,2,2,109.56889,18.27076,1763
50922,EBF906C5498076BCFA3E97DF6001B4F3,60631,3,7,4,109.57778,18.27583,1814
50923,EBF906C5498076BCFA3E97DF6001B4F3,30854,11,23,12,109.56889,18.27076,1763
50947,2A6BA0678DDF16AF08BAC9E3FA3C9391,31561,1,7,6,109.56792,18.28479,1765
50948,2A6BA0678DDF16AF08BAC9E3FA3C9391,30854,8,11,3,109.56889,18.27076,1763
50949,2A6BA0678DDF16AF08BAC9E3FA3C9391,31561,12,14,2,109.56792,18.28479,1765
50950,2A6BA0678DDF16AF08BAC9E3FA3C9391,30854,17,20,3,109.56889,18.27076,1763
51007,4AC58984B2F202FD588F865249555769,31311,0,8,8,109.72299,18.27438,2364
51008,4AC58984B2F202FD588F865249555769,30761,12,14,2,109.45201,18.3,1318
51009,4AC58984B2F202FD588F865249555769,31311,18,23,5,109.72299,18.27438,2364
51015,75817DB682187A07461734D66E1E6492,60631,0,4,4,109.57778,18.27583,1814
51016,75817DB682187A07461734D66E1E6492,30854,6,16,10,109.56889,18.27076,1763
51017,75817DB682187A07461734D66E1E6492,30851,17,20,3,109.5616,18.27396,1713
51018,75817DB682187A07461734D66E1E6492,60631,21,23,2,109.57778,18.27583,1814
51023,28AD4F4A057EAD61FC013015642C4D8F,31521,1,9,8,109.51458,18.22542,1555
51024,28AD4F4A057EAD61FC013015642C4D8F,60081,12,15,3,109.51097,18.22639,1556
51025,28AD4F4A057EAD61FC013015642C4D8F,30191,16,17,1,109.50361,18.22701,1506
51026,28AD4F4A057EAD61FC013015642C4D8F,30051,17,20,3,109.48917,18.21215,1453
51080,005F3AEFE6DBF371ED1FD57736434098,30854,11,20,9,109.56889,18.27076,1763
51081,005F3AEFE6DBF371ED1FD57736434098,31071,21,23,2,109.58257,18.28458,1815
51122,5CCD9DE75DF89B316E1B16CD295DB4E3,60361,0,7,7,109.51938,18.29681,1567
51123,5CCD9DE75DF89B316E1B16CD295DB4E3,31561,12,16,4,109.56792,18.28479,1765
51124,5CCD9DE75DF89B316E1B16CD295DB4E3,30854,16,18,2,109.56889,18.27076,1763
51125,5CCD9DE75DF89B316E1B16CD295DB4E3,60361,19,23,4,109.51938,18.29681,1567
51130,34F3D64B41C252481F72E5CF931AC833,31071,4,6,2,109.58257,18.28458,1815
51131,34F3D64B41C252481F72E5CF931AC833,30851,6,13,7,109.5616,18.27396,1713
51151,D0866918F07FFECFBBDD57492CC6C931,60411,12,13,1,109.32514,18.30854,869
51152,D0866918F07FFECFBBDD57492CC6C931,31471,15,17,2,109.34583,18.29563,917
51153,D0866918F07FFECFBBDD57492CC6C931,60411,18,21,3,109.32514,18.30854,869
51177,73C19B2A002A8D6E0EC77225EBBCD503,31491,2,4,2,109.73042,18.38771,2382
51178,73C19B2A002A8D6E0EC77225EBBCD503,30791,4,7,3,109.72333,18.40889,2386
51190,2FA8C9EB39391D82B65635AB780DCA95,60524,0,8,8,109.42951,18.28993,1216
51191,2FA8C9EB39391D82B65635AB780DCA95,30971,8,10,2,109.48708,18.29319,1467
51192,2FA8C9EB39391D82B65635AB780DCA95,38951,11,15,4,109.48097,18.28868,1416
51193,2FA8C9EB39391D82B65635AB780DCA95,30971,15,18,3,109.48708,18.29319,1467
51194,2FA8C9EB39391D82B65635AB780DCA95,38951,18,23,5,109.48097,18.28868,1416
51202,6B51370D2A6A7CB5ED483F2827F846C2,31471,13,15,2,109.34583,18.29563,917
51203,6B51370D2A6A7CB5ED483F2827F846C2,60291,19,21,2,109.50826,18.24639,1509
51204,6B51370D2A6A7CB5ED483F2827F846C2,39111,22,23,1,109.5191,18.22597,1555
51218,A952750F25C558E5C17B3EB7DD935431,30071,1,3,2,109.52819,18.30472,1619
51219,A952750F25C558E5C17B3EB7DD935431,60371,7,9,2,109.53063,18.30056,1618
51220,A952750F25C558E5C17B3EB7DD935431,31931,11,12,1,109.54771,18.29403,1667
51221,A952750F25C558E5C17B3EB7DD935431,60371,18,21,3,109.53063,18.30056,1618
51222,A952750F25C558E5C17B3EB7DD935431,31931,22,23,1,109.54771,18.29403,1667
51223,BD1C8CAB0CA377D9350002A865081450,38185,0,6,6,109.51333,18.27347,1563
51224,BD1C8CAB0CA377D9350002A865081450,31021,9,11,2,109.49021,18.27,1463
51225,BD1C8CAB0CA377D9350002A865081450,30251,11,13,2,109.50611,18.26653,1512
51226,BD1C8CAB0CA377D9350002A865081450,31021,16,19,3,109.49021,18.27,1463
51227,BD1C8CAB0CA377D9350002A865081450,30251,22,23,1,109.50611,18.26653,1512
51230,ABCD0851CC1C78BCD7AF6DBDF2F5DE49,60524,0,5,5,109.42951,18.28993,1216
51231,ABCD0851CC1C78BCD7AF6DBDF2F5DE49,60552,5,10,5,109.41729,18.30014,1218
51232,ABCD0851CC1C78BCD7AF6DBDF2F5DE49,60524,12,14,2,109.42951,18.28993,1216
51233,ABCD0851CC1C78BCD7AF6DBDF2F5DE49,30671,15,16,1,109.43611,18.30139,1268
51234,ABCD0851CC1C78BCD7AF6DBDF2F5DE49,60552,16,19,3,109.41729,18.30014,1218
51235,F5C95858D90175E8C584149B48249C9D,60524,0,7,7,109.42951,18.28993,1216
51239,5E97A4561E11AAC4FBC53FD068EAA52B,30854,0,14,14,109.56889,18.27076,1763
51240,5E97A4561E11AAC4FBC53FD068EAA52B,30531,17,18,1,109.53271,18.21472,1604
51264,C19430CE8DF26BDEF43903E57E682236,31561,0,7,7,109.56792,18.28479,1765
51265,C19430CE8DF26BDEF43903E57E682236,31071,8,9,1,109.58257,18.28458,1815
51266,C19430CE8DF26BDEF43903E57E682236,31561,11,22,11,109.56792,18.28479,1765
51310,D68CB3826910D94323D89C47E2F5E00C,30854,11,16,5,109.56889,18.27076,1763
51311,D68CB3826910D94323D89C47E2F5E00C,31561,20,21,1,109.56792,18.28479,1765
51351,E83EEC0EDEADBA548B114EA601516E47,60571,0,5,5,109.50722,18.25056,1510
51352,E83EEC0EDEADBA548B114EA601516E47,60291,7,13,6,109.50826,18.24639,1509
51355,B643AC77F8D8498A9694D45BA8B0F75F,60631,0,17,17,109.57778,18.27583,1814
51356,B643AC77F8D8498A9694D45BA8B0F75F,31561,17,20,3,109.56792,18.28479,1765
51405,B509D6A1196DD550C311B4C425D8CCC0,38951,2,8,6,109.48097,18.28868,1416
51406,B509D6A1196DD550C311B4C425D8CCC0,30971,8,12,4,109.48708,18.29319,1467
51407,B509D6A1196DD550C311B4C425D8CCC0,38951,12,16,4,109.48097,18.28868,1416
51408,B509D6A1196DD550C311B4C425D8CCC0,30971,16,18,2,109.48708,18.29319,1467
51409,B509D6A1196DD550C311B4C425D8CCC0,38951,19,23,4,109.48097,18.28868,1416
51455,CE3B82B6F005FAEB254B1A364EFB9408,60411,12,13,1,109.32514,18.30854,869
51456,CE3B82B6F005FAEB254B1A364EFB9408,60614,15,17,2,109.48799,18.29521,1467
51468,4968BDF068C505E078DCD9BE1053BBFB,30201,9,19,10,109.4909,18.26465,1462
51493,27BCEF3137923B84211F08830816C810,30851,0,1,1,109.5616,18.27396,1713
51494,27BCEF3137923B84211F08830816C810,31561,2,4,2,109.56792,18.28479,1765
51495,27BCEF3137923B84211F08830816C810,30071,8,15,7,109.52819,18.30472,1619
51496,27BCEF3137923B84211F08830816C810,30851,16,17,1,109.5616,18.27396,1713
51510,FB917EEDD019FE7A46C7EE57314AE768,38162,18,20,2,109.43944,18.28889,1266
51511,FB917EEDD019FE7A46C7EE57314AE768,31391,21,22,1,109.50382,18.24285,1508
51526,5426296000364EE32711CD0E73D782C8,31071,5,7,2,109.58257,18.28458,1815
51527,5426296000364EE32711CD0E73D782C8,30854,8,14,6,109.56889,18.27076,1763
51535,0FCA9DC43F3306C596F52131F1C7B8CA,31471,13,15,2,109.34583,18.29563,917
51536,0FCA9DC43F3306C596F52131F1C7B8CA,30581,18,23,5,109.62257,18.24951,1959
51546,96E79F39E5EC731B78E83C20610BE900,30111,0,5,5,109.47583,18.30542,1419
51547,96E79F39E5EC731B78E83C20610BE900,30321,8,9,1,109.49563,18.29611,1467
51569,5A3AB3066996487C1CB6E18FABA628E7,60381,0,8,8,109.5241,18.22458,1605
51570,5A3AB3066996487C1CB6E18FABA628E7,60054,11,12,1,109.3016,18.31229,770
51571,5A3AB3066996487C1CB6E18FABA628E7,31471,13,14,1,109.34583,18.29563,917
51580,4995463B780282C9C030A19D9F49AEAC,30854,11,16,5,109.56889,18.27076,1763
51581,4995463B780282C9C030A19D9F49AEAC,31071,16,17,1,109.58257,18.28458,1815
51582,4995463B780282C9C030A19D9F49AEAC,30421,19,22,3,109.50021,18.25861,1511
51614,56DB853C0B6BC26DC3ABDBD960F52342,31021,0,6,6,109.49021,18.27,1463
51615,56DB853C0B6BC26DC3ABDBD960F52342,30171,7,8,1,109.48458,18.27139,1463
51620,5513A4EBEB51AF5647B29C75D8B8CC2C,30211,0,9,9,109.49882,18.23931,1508
51621,5513A4EBEB51AF5647B29C75D8B8CC2C,33521,11,15,4,109.66313,18.45174,2143
51622,486A78088314F236B361634EA8E4A8C3,60084,0,6,6,109.4984,18.2334,1507
51623,486A78088314F236B361634EA8E4A8C3,38754,10,12,2,109.74667,18.37382,2430
51737,45A4BBA7E29D98A1407820384344799B,60614,1,3,2,109.48799,18.29521,1467
51738,45A4BBA7E29D98A1407820384344799B,38951,4,5,1,109.48097,18.28868,1416
51739,45A4BBA7E29D98A1407820384344799B,60614,6,8,2,109.48799,18.29521,1467
51740,45A4BBA7E29D98A1407820384344799B,38951,9,14,5,109.48097,18.28868,1416
51741,45A4BBA7E29D98A1407820384344799B,60504,15,17,2,109.47917,18.28903,1416
51742,45A4BBA7E29D98A1407820384344799B,31521,18,20,2,109.51458,18.22542,1555
51743,45A4BBA7E29D98A1407820384344799B,38951,21,23,2,109.48097,18.28868,1416
51744,680C3C6F27D372D5C5B42FAEAC7B1567,38251,2,8,6,109.49618,18.25493,1510
51745,680C3C6F27D372D5C5B42FAEAC7B1567,31471,12,14,2,109.34583,18.29563,917
51746,680C3C6F27D372D5C5B42FAEAC7B1567,30361,17,20,3,109.50347,18.24,1508
51747,680C3C6F27D372D5C5B42FAEAC7B1567,30711,20,22,2,109.50271,18.25347,1510
51754,996C0D9500BF90CC0E7F5A04C49A464B,39183,12,13,1,109.55542,18.28208,1715
51755,996C0D9500BF90CC0E7F5A04C49A464B,31931,14,15,1,109.54771,18.29403,1667
51756,996C0D9500BF90CC0E7F5A04C49A464B,39181,17,18,1,109.55153,18.28035,1715
51757,996C0D9500BF90CC0E7F5A04C49A464B,31931,19,20,1,109.54771,18.29403,1667
51767,DA7695571AF860EADFA185350D767F54,38141,0,17,17,109.39479,18.2916,1116
51768,DA7695571AF860EADFA185350D767F54,31031,18,21,3,109.49979,18.25382,1510
51769,DA7695571AF860EADFA185350D767F54,38141,22,23,1,109.39479,18.2916,1116
51770,B340EDEF4A878E8DF5CBEC25E465EACE,31071,1,3,2,109.58257,18.28458,1815
51771,B340EDEF4A878E8DF5CBEC25E465EACE,30854,3,21,18,109.56889,18.27076,1763
51785,F198CAA1F49ACA5D003FD8F8473B3798,31071,1,7,6,109.58257,18.28458,1815
51786,F198CAA1F49ACA5D003FD8F8473B3798,30854,7,9,2,109.56889,18.27076,1763
51787,F198CAA1F49ACA5D003FD8F8473B3798,31071,13,15,2,109.58257,18.28458,1815
51788,F198CAA1F49ACA5D003FD8F8473B3798,30854,17,18,1,109.56889,18.27076,1763
51818,A2FA5E7511F31EDC8642A1453F736A76,38951,0,6,6,109.48097,18.28868,1416
51819,A2FA5E7511F31EDC8642A1453F736A76,30971,8,12,4,109.48708,18.29319,1467
51820,A2FA5E7511F31EDC8642A1453F736A76,38951,13,23,10,109.48097,18.28868,1416
51830,8A2602EE97ED1F19C3F8048B259C52D2,60381,0,7,7,109.5241,18.22458,1605
51831,8A2602EE97ED1F19C3F8048B259C52D2,33051,10,14,4,109.6475,18.46618,2096
51832,8A2602EE97ED1F19C3F8048B259C52D2,31521,17,19,2,109.51458,18.22542,1555
51842,5A7583FE846F06DB3517F6D5D54AC2C3,31781,0,2,2,109.19847,18.2975,367
51843,5A7583FE846F06DB3517F6D5D54AC2C3,31143,3,9,6,109.19986,18.29875,368
51844,5A7583FE846F06DB3517F6D5D54AC2C3,60411,12,13,1,109.32514,18.30854,869
51845,5A7583FE846F06DB3517F6D5D54AC2C3,60054,14,16,2,109.3016,18.31229,770
51846,5A7583FE846F06DB3517F6D5D54AC2C3,31471,16,17,1,109.34583,18.29563,917
51847,5A7583FE846F06DB3517F6D5D54AC2C3,60211,18,22,4,109.63549,18.26049,2011
51880,8C5A16299A6D294198C90C34C25C5949,30854,1,2,1,109.56889,18.27076,1763
51881,8C5A16299A6D294198C90C34C25C5949,39183,2,4,2,109.55542,18.28208,1715
51882,8C5A16299A6D294198C90C34C25C5949,30854,4,5,1,109.56889,18.27076,1763
51883,662D882A6A10D0E6C3566690F0A40636,31071,16,17,1,109.58257,18.28458,1815
51884,662D882A6A10D0E6C3566690F0A40636,30854,21,23,2,109.56889,18.27076,1763
51893,35C6EDC8AAC6B5ABA770190223528BA2,60341,0,4,4,109.70597,18.31778,2271
51894,35C6EDC8AAC6B5ABA770190223528BA2,60552,5,8,3,109.41729,18.30014,1218
51895,35C6EDC8AAC6B5ABA770190223528BA2,31061,11,14,3,109.53333,18.23257,1607
51908,38B4623EE00239B95DF14D8187D4B411,60331,0,6,6,109.505,18.26507,1512
51909,38B4623EE00239B95DF14D8187D4B411,31781,9,11,2,109.19847,18.2975,367
51910,38B4623EE00239B95DF14D8187D4B411,60054,15,16,1,109.3016,18.31229,770
51911,38B4623EE00239B95DF14D8187D4B411,60331,19,23,4,109.505,18.26507,1512
51923,A83D8E7E1A47FE31FB41A8731F87D76F,60381,0,8,8,109.5241,18.22458,1605
51924,A83D8E7E1A47FE31FB41A8731F87D76F,31031,10,12,2,109.49979,18.25382,1510
51925,A83D8E7E1A47FE31FB41A8731F87D76F,31781,13,14,1,109.19847,18.2975,367
51926,A83D8E7E1A47FE31FB41A8731F87D76F,31471,15,17,2,109.34583,18.29563,917
51927,A83D8E7E1A47FE31FB41A8731F87D76F,31031,20,23,3,109.49979,18.25382,1510
51952,B32D2CE6FAE9B9E7FD3C32948AAABD42,30181,0,10,10,109.51597,18.23313,1557
51953,B32D2CE6FAE9B9E7FD3C32948AAABD42,30191,15,16,1,109.50361,18.22701,1506
51954,B32D2CE6FAE9B9E7FD3C32948AAABD42,30361,18,19,1,109.50347,18.24,1508
51955,B32D2CE6FAE9B9E7FD3C32948AAABD42,30181,20,21,1,109.51597,18.23313,1557
51956,B43DB539B5964E15F0064080164C40C1,60631,1,9,8,109.57778,18.27583,1814
51957,B43DB539B5964E15F0064080164C40C1,38052,10,16,6,109.62618,18.23042,1956
51958,B43DB539B5964E15F0064080164C40C1,30861,17,19,2,109.52722,18.22743,1606
51959,297362B848EFD355E0E96CC67D1F021F,30421,0,1,1,109.50021,18.25861,1511
51960,297362B848EFD355E0E96CC67D1F021F,30421,2,6,4,109.50021,18.25861,1511
51961,297362B848EFD355E0E96CC67D1F021F,30911,7,9,2,109.50493,18.26181,1511
51962,297362B848EFD355E0E96CC67D1F021F,30021,10,23,13,109.12014,18.40986,86
51998,C984DAF128575CB0A22AC03D6B0242E9,31031,11,14,3,109.49979,18.25382,1510
51999,C984DAF128575CB0A22AC03D6B0242E9,38251,16,19,3,109.49618,18.25493,1510
52044,FB69127E95B4D9EC5AF61282F8D7EEB7,31561,1,4,3,109.56792,18.28479,1765
52045,FB69127E95B4D9EC5AF61282F8D7EEB7,31071,5,7,2,109.58257,18.28458,1815
52046,FB69127E95B4D9EC5AF61282F8D7EEB7,30854,7,8,1,109.56889,18.27076,1763
52047,FB69127E95B4D9EC5AF61282F8D7EEB7,31561,12,13,1,109.56792,18.28479,1765
52048,FB69127E95B4D9EC5AF61282F8D7EEB7,30854,16,19,3,109.56889,18.27076,1763
52049,E0C692116FEED9FE20A5CF7D2F4944B1,30201,13,15,2,109.4909,18.26465,1462
52086,AB2757F3465D5BF12D6B9326486D6787,30854,7,9,2,109.56889,18.27076,1763
52087,AB2757F3465D5BF12D6B9326486D6787,39183,11,19,8,109.55542,18.28208,1715
52088,AB2757F3465D5BF12D6B9326486D6787,31071,19,20,1,109.58257,18.28458,1815
52110,C1F9914EF577AE2A8300B1A3945A50FF,31561,3,7,4,109.56792,18.28479,1765
52111,C1F9914EF577AE2A8300B1A3945A50FF,30854,9,10,1,109.56889,18.27076,1763
52112,C1F9914EF577AE2A8300B1A3945A50FF,30851,12,13,1,109.5616,18.27396,1713
52113,C1F9914EF577AE2A8300B1A3945A50FF,30084,19,20,1,109.50118,18.26972,1513
52114,C1F9914EF577AE2A8300B1A3945A50FF,30851,21,23,2,109.5616,18.27396,1713
52115,44F505B3929E26B4B29F00CC284F3084,30854,15,16,1,109.56889,18.27076,1763
52116,44F505B3929E26B4B29F00CC284F3084,31071,18,20,2,109.58257,18.28458,1815
52117,44F505B3929E26B4B29F00CC284F3084,30854,20,23,3,109.56889,18.27076,1763
52142,86C0171C8311911DC85F52F1754351D5,31461,0,2,2,109.5091,18.25389,1510
52143,86C0171C8311911DC85F52F1754351D5,39154,4,5,1,109.50201,18.25681,1511
52144,86C0171C8311911DC85F52F1754351D5,30771,7,8,1,109.49938,18.26042,1511
52145,86C0171C8311911DC85F52F1754351D5,30021,11,23,12,109.12014,18.40986,86
52150,1CFC708F68A59EF527E459C034E07554,30531,0,12,12,109.53271,18.21472,1604
52190,4B573FBC218CB9A5C892E803644339BF,30241,10,11,1,109.26174,18.3275,622
52191,4B573FBC218CB9A5C892E803644339BF,31471,13,15,2,109.34583,18.29563,917
52199,E610935782979ECFD62FB0099155ECBC,31031,18,20,2,109.49979,18.25382,1510
52200,E610935782979ECFD62FB0099155ECBC,60524,22,23,1,109.42951,18.28993,1216
52259,F605546ADA1ADB3E2AF3E74D19682812,60371,0,2,2,109.53063,18.30056,1618
52260,F605546ADA1ADB3E2AF3E74D19682812,60221,3,22,19,109.52569,18.29188,1616
52270,4587E26C00C36D3FE7633B1B02F6A233,60661,10,19,9,109.548,18.2377,1657
52280,C01D7F4C525517694A04D5EAA5AD2420,31071,4,15,11,109.58257,18.28458,1815
52281,C01D7F4C525517694A04D5EAA5AD2420,30071,17,18,1,109.52819,18.30472,1619
52282,C01D7F4C525517694A04D5EAA5AD2420,31945,20,21,1,109.58021,18.29403,1817
52283,C01D7F4C525517694A04D5EAA5AD2420,31071,21,22,1,109.58257,18.28458,1815
52303,0D4EC220235B9B6AB88032F5B2A0499A,31701,18,20,2,109.44132,18.28833,1266
52304,0D4EC220235B9B6AB88032F5B2A0499A,31431,20,21,1,109.44639,18.29042,1316
52329,BE8220A49F1231C0A022F4AA2075503E,60381,18,19,1,109.5241,18.22458,1605
52330,BE8220A49F1231C0A022F4AA2075503E,31071,21,22,1,109.58257,18.28458,1815
52410,E191BF114A3C2277CB7C3323BAA13F43,30854,6,11,5,109.56889,18.27076,1763
52411,E191BF114A3C2277CB7C3323BAA13F43,38013,12,13,1,109.49514,18.21951,1454
52427,3379F8CA3C60221B34F1581AF646427C,39111,0,10,10,109.5191,18.22597,1555
52428,3379F8CA3C60221B34F1581AF646427C,30201,12,13,1,109.4909,18.26465,1462
52429,3379F8CA3C60221B34F1581AF646427C,30971,14,17,3,109.48708,18.29319,1467
52430,3379F8CA3C60221B34F1581AF646427C,38951,17,23,6,109.48097,18.28868,1416
52445,187F8A9110396785A2F66708CAB2E68C,60221,2,11,9,109.52569,18.29188,1616
52446,187F8A9110396785A2F66708CAB2E68C,30854,14,15,1,109.56889,18.27076,1763
52447,187F8A9110396785A2F66708CAB2E68C,31521,17,23,6,109.51458,18.22542,1555
52454,A68637AA89BD62624E677D9E66C32FAD,30161,0,10,10,109.50042,18.24389,1508
52455,A68637AA89BD62624E677D9E66C32FAD,60261,12,14,2,109.44326,18.3075,1319
52456,A68637AA89BD62624E677D9E66C32FAD,30361,15,16,1,109.50347,18.24,1508
52457,A68637AA89BD62624E677D9E66C32FAD,30161,16,18,2,109.50042,18.24389,1508
52458,A68637AA89BD62624E677D9E66C32FAD,31031,19,20,1,109.49979,18.25382,1510
52459,A68637AA89BD62624E677D9E66C32FAD,31391,20,22,2,109.50382,18.24285,1508
52493,B5290624DD7244A223762FE2F75BD41F,38951,0,7,7,109.48097,18.28868,1416
52494,B5290624DD7244A223762FE2F75BD41F,30971,8,11,3,109.48708,18.29319,1467
52495,B5290624DD7244A223762FE2F75BD41F,30201,12,22,10,109.4909,18.26465,1462
52506,36DE5DE7D024FC0D4AA8374BBC02FD61,30271,0,8,8,109.49132,18.23153,1456
52507,36DE5DE7D024FC0D4AA8374BBC02FD61,30211,9,10,1,109.49882,18.23931,1508
52589,B17D654C0C5F0BF2FDFE2DB8B9C0B83F,31041,1,2,1,109.50278,18.23701,1507
52590,B17D654C0C5F0BF2FDFE2DB8B9C0B83F,30771,5,16,11,109.49938,18.26042,1511
52591,B17D654C0C5F0BF2FDFE2DB8B9C0B83F,60291,16,19,3,109.50826,18.24639,1509
52592,B17D654C0C5F0BF2FDFE2DB8B9C0B83F,30771,20,23,3,109.49938,18.26042,1511
52628,2576A40187A845D7B849E820F16B3DB1,31071,3,4,1,109.58257,18.28458,1815
52629,2576A40187A845D7B849E820F16B3DB1,30854,4,9,5,109.56889,18.27076,1763
52630,2576A40187A845D7B849E820F16B3DB1,31071,9,15,6,109.58257,18.28458,1815
52631,2576A40187A845D7B849E820F16B3DB1,31561,16,18,2,109.56792,18.28479,1765
52632,2576A40187A845D7B849E820F16B3DB1,30854,18,20,2,109.56889,18.27076,1763
52636,EE972DDDB0EBA2B6E0C8E188BA31FBAC,31231,1,7,6,109.42597,18.29292,1217
52637,EE972DDDB0EBA2B6E0C8E188BA31FBAC,30731,9,11,2,109.50944,18.22306,1555
52638,EE972DDDB0EBA2B6E0C8E188BA31FBAC,33051,14,15,1,109.6475,18.46618,2096
52641,90B0A60855A43B2DB99A0964CE51D3AF,30854,14,15,1,109.56889,18.27076,1763
52642,90B0A60855A43B2DB99A0964CE51D3AF,31071,20,21,1,109.58257,18.28458,1815
52653,2F6227BE52214F56DC5C7B0F02022EE3,39131,0,8,8,109.2066,18.29639,417
52657,5D4C3826131546B88608CD2FD019690E,31061,15,16,1,109.53333,18.23257,1607
52658,5D4C3826131546B88608CD2FD019690E,60381,18,20,2,109.5241,18.22458,1605
52678,60ACD2B6657BEEA3D1B558DE71329F84,60084,0,6,6,109.4984,18.2334,1507
52679,60ACD2B6657BEEA3D1B558DE71329F84,30051,9,10,1,109.48917,18.21215,1453
52680,60ACD2B6657BEEA3D1B558DE71329F84,38251,15,16,1,109.49618,18.25493,1510
52681,60ACD2B6657BEEA3D1B558DE71329F84,30771,17,19,2,109.49938,18.26042,1511
52747,DF726AC992EA795A98DE4DF26D62B584,31521,0,7,7,109.51458,18.22542,1555
52748,DF726AC992EA795A98DE4DF26D62B584,31781,8,12,4,109.19847,18.2975,367
52749,DF726AC992EA795A98DE4DF26D62B584,31471,13,14,1,109.34583,18.29563,917
52750,DF726AC992EA795A98DE4DF26D62B584,60381,18,19,1,109.5241,18.22458,1605
52751,DF726AC992EA795A98DE4DF26D62B584,31521,19,22,3,109.51458,18.22542,1555
52783,0D3DA8126B134D203BB35373EAFFB116,31071,0,5,5,109.58257,18.28458,1815
52784,0D3DA8126B134D203BB35373EAFFB116,30854,8,13,5,109.56889,18.27076,1763
52785,0D3DA8126B134D203BB35373EAFFB116,31071,17,19,2,109.58257,18.28458,1815
52786,0D3DA8126B134D203BB35373EAFFB116,30854,20,21,1,109.56889,18.27076,1763
52787,0D3DA8126B134D203BB35373EAFFB116,31071,21,23,2,109.58257,18.28458,1815
52813,97DFCEF20461204135ADC6D971200EB4,60341,20,21,1,109.70597,18.31778,2271
52845,6BCE0DED3EAD20A4FC692537465B6332,31071,0,1,1,109.58257,18.28458,1815
52846,6BCE0DED3EAD20A4FC692537465B6332,39183,1,6,5,109.55542,18.28208,1715
52847,6BCE0DED3EAD20A4FC692537465B6332,30854,8,13,5,109.56889,18.27076,1763
52848,6BCE0DED3EAD20A4FC692537465B6332,39183,13,22,9,109.55542,18.28208,1715
52872,4641AF7FC76419FEB068E4DB4580E39B,31521,0,3,3,109.51458,18.22542,1555
52873,4641AF7FC76419FEB068E4DB4580E39B,31521,4,18,14,109.51458,18.22542,1555
52874,4641AF7FC76419FEB068E4DB4580E39B,60381,20,21,1,109.5241,18.22458,1605
52893,E1E11838338C82F354BD58BE0CE18B02,30661,0,14,14,109.37028,18.24361,1008
52894,E1E11838338C82F354BD58BE0CE18B02,31031,16,19,3,109.49979,18.25382,1510
52895,E1E11838338C82F354BD58BE0CE18B02,31231,20,22,2,109.42597,18.29292,1217
52915,B2945CAC16CB15B397E519AE18D7E012,31951,10,18,8,109.52174,18.30299,1568
52923,A9FCE0049DB44FE004EAFBF5B783F4A5,31945,2,8,6,109.58021,18.29403,1817
52924,A9FCE0049DB44FE004EAFBF5B783F4A5,30854,10,18,8,109.56889,18.27076,1763
52965,5097B43636B9B42C01AD4143B912CF81,31841,0,1,1,109.73201,18.33382,2373
52966,5097B43636B9B42C01AD4143B912CF81,30501,3,8,5,109.72,18.34951,2326
52967,5097B43636B9B42C01AD4143B912CF81,31841,9,10,1,109.73201,18.33382,2373
53005,B663EE883B81AEB709AC84DCCEC3D38E,31945,0,7,7,109.58021,18.29403,1817
53006,B663EE883B81AEB709AC84DCCEC3D38E,31071,12,20,8,109.58257,18.28458,1815
53007,B663EE883B81AEB709AC84DCCEC3D38E,31945,21,23,2,109.58021,18.29403,1817
53033,E5A756A7B211F9CDD28913639DA08B67,38331,0,1,1,109.62465,18.22736,1956
53035,E5A756A7B211F9CDD28913639DA08B67,38052,7,10,3,109.62618,18.23042,1956
53036,E5A756A7B211F9CDD28913639DA08B67,38331,10,16,6,109.62465,18.22736,1956
53037,E5A756A7B211F9CDD28913639DA08B67,30361,17,19,2,109.50347,18.24,1508
53038,E5A756A7B211F9CDD28913639DA08B67,38052,20,23,3,109.62618,18.23042,1956
53055,DF03FBE0214EA22180A936A96E104200,60381,13,15,2,109.5241,18.22458,1605
53083,84DF4A7C208235D171EF56473BCCF210,30851,0,1,1,109.5616,18.27396,1713
53084,84DF4A7C208235D171EF56473BCCF210,31561,4,6,2,109.56792,18.28479,1765
53085,84DF4A7C208235D171EF56473BCCF210,60631,7,17,10,109.57778,18.27583,1814
53092,62710F810F76361D1B8C4EDC4D8736B2,31471,13,14,1,109.34583,18.29563,917
53093,62710F810F76361D1B8C4EDC4D8736B2,60221,18,21,3,109.52569,18.29188,1616
53094,62710F810F76361D1B8C4EDC4D8736B2,30341,21,22,1,109.3625,18.29167,966
53100,015CDEB9169BCE5537ABAE49B6A63F2B,31071,0,7,7,109.58257,18.28458,1815
53101,015CDEB9169BCE5537ABAE49B6A63F2B,38132,11,13,2,109.64632,18.23417,2057
53102,015CDEB9169BCE5537ABAE49B6A63F2B,38271,14,15,1,109.62632,18.23049,1956
53135,A94F66C88B84FF0658441320CD9F667C,30854,0,5,5,109.56889,18.27076,1763
53136,A94F66C88B84FF0658441320CD9F667C,31071,8,10,2,109.58257,18.28458,1815
53137,A94F66C88B84FF0658441320CD9F667C,30854,12,21,9,109.56889,18.27076,1763
53153,9905C3E423D151CCE1280F3A1732CE90,30854,0,6,6,109.56889,18.27076,1763
53154,9905C3E423D151CCE1280F3A1732CE90,30851,7,9,2,109.5616,18.27396,1713
53155,9905C3E423D151CCE1280F3A1732CE90,31071,14,18,4,109.58257,18.28458,1815
53156,9905C3E423D151CCE1280F3A1732CE90,30854,20,23,3,109.56889,18.27076,1763
53162,ED11B367500D0FBFDAB3E55D1F336A82,30661,13,14,1,109.37028,18.24361,1008
53163,ED11B367500D0FBFDAB3E55D1F336A82,60321,18,23,5,109.63611,18.24306,2008
53172,C316CE65034FB3C77BE459147CBF943A,60291,0,8,8,109.50826,18.24639,1509
53173,C316CE65034FB3C77BE459147CBF943A,30161,12,14,2,109.50042,18.24389,1508
53174,C316CE65034FB3C77BE459147CBF943A,30161,15,19,4,109.50042,18.24389,1508
53175,C316CE65034FB3C77BE459147CBF943A,60291,20,22,2,109.50826,18.24639,1509
53180,BE586ACB441383CC10D7CF3923850B73,31931,1,2,1,109.54771,18.29403,1667
53181,BE586ACB441383CC10D7CF3923850B73,60371,2,5,3,109.53063,18.30056,1618
53182,BE586ACB441383CC10D7CF3923850B73,31931,6,14,8,109.54771,18.29403,1667
53183,BE586ACB441383CC10D7CF3923850B73,60371,14,16,2,109.53063,18.30056,1618
53184,BE586ACB441383CC10D7CF3923850B73,31931,18,22,4,109.54771,18.29403,1667
53200,C874B49FDD8AB3F57E7187DFACBAD030,60054,15,17,2,109.3016,18.31229,770
53201,C874B49FDD8AB3F57E7187DFACBAD030,30211,21,23,2,109.49882,18.23931,1508
53233,67E12DC002DA6B0CA8CA5CAEEC84ACCD,60321,0,9,9,109.63611,18.24306,2008
53234,67E12DC002DA6B0CA8CA5CAEEC84ACCD,60614,13,16,3,109.48799,18.29521,1467
53252,77410BDA5A40A13509119785FF70899D,31321,16,17,1,109.63799,18.23201,2007
53253,77410BDA5A40A13509119785FF70899D,38094,20,23,3,109.45403,18.28778,1316
53256,11136C83CACE9221E59CD40325571723,30891,0,7,7,109.59431,18.28389,1865
53257,11136C83CACE9221E59CD40325571723,30854,7,11,4,109.56889,18.27076,1763
53258,11136C83CACE9221E59CD40325571723,31071,13,22,9,109.58257,18.28458,1815
53259,C50EC98EBB3AD6F34D76F87C749DAC01,39181,0,10,10,109.55153,18.28035,1715
53260,C50EC98EBB3AD6F34D76F87C749DAC01,31931,11,18,7,109.54771,18.29403,1667
53261,C50EC98EBB3AD6F34D76F87C749DAC01,39181,19,23,4,109.55153,18.28035,1715
53272,8B167331F8E78254A4CBA6A89A1236BC,60524,0,13,13,109.42951,18.28993,1216
53273,8B167331F8E78254A4CBA6A89A1236BC,60401,17,18,1,109.47444,18.27583,1414
53274,0D00E0CA974DDA00224ACCD00B993468,30851,0,6,6,109.5616,18.27396,1713
53275,0D00E0CA974DDA00224ACCD00B993468,30854,10,11,1,109.56889,18.27076,1763
53276,0D00E0CA974DDA00224ACCD00B993468,31561,12,13,1,109.56792,18.28479,1765
53292,813E2F35830EA7BC497F7B8897EB64FA,38871,0,8,8,109.44681,18.28625,1316
53293,813E2F35830EA7BC497F7B8897EB64FA,31701,8,12,4,109.44132,18.28833,1266
53294,813E2F35830EA7BC497F7B8897EB64FA,31181,12,13,1,109.50382,18.24813,1509
53295,813E2F35830EA7BC497F7B8897EB64FA,31701,15,18,3,109.44132,18.28833,1266
53313,CF23CF6CFE18BB23E9BD394A1039CA8D,60621,0,5,5,109.48354,18.27451,1464
53314,CF23CF6CFE18BB23E9BD394A1039CA8D,30391,5,7,2,109.4975,18.27118,1513
53315,CF23CF6CFE18BB23E9BD394A1039CA8D,60552,8,9,1,109.41729,18.30014,1218
53317,F00821368F615DCDAF214035D8EC4A44,60631,1,2,1,109.57778,18.27583,1814
53318,F00821368F615DCDAF214035D8EC4A44,31071,3,10,7,109.58257,18.28458,1815
53319,F00821368F615DCDAF214035D8EC4A44,31761,12,13,1,109.60521,18.27965,1914
53320,F00821368F615DCDAF214035D8EC4A44,30854,15,18,3,109.56889,18.27076,1763
53354,0B2CDE43D7DE290E07FF365A2D22E5DE,30854,16,22,6,109.56889,18.27076,1763
53355,0B2CDE43D7DE290E07FF365A2D22E5DE,30232,22,23,1,109.6191,18.31701,1971
53359,934029FB5F97BCE114EDCE88F0393A63,30854,12,23,11,109.56889,18.27076,1763
53360,8D7B9451E0189947198D6AC9CE51CFEE,31091,0,8,8,109.41201,18.31222,1170
53361,8D7B9451E0189947198D6AC9CE51CFEE,30761,8,10,2,109.45201,18.3,1318
53362,8D7B9451E0189947198D6AC9CE51CFEE,31091,12,19,7,109.41201,18.31222,1170
53363,8D7B9451E0189947198D6AC9CE51CFEE,30111,20,23,3,109.47583,18.30542,1419
53378,96F98526707B06BE1263CCD4F72E07A1,30854,14,16,2,109.56889,18.27076,1763
53379,96F98526707B06BE1263CCD4F72E07A1,31321,18,19,1,109.63799,18.23201,2007
53380,96F98526707B06BE1263CCD4F72E07A1,31945,21,22,1,109.58021,18.29403,1817
53410,356E75600A8901067E9EDB6E5BE4617A,38157,0,7,7,109.51483,18.26958,1563
53411,356E75600A8901067E9EDB6E5BE4617A,60661,7,10,3,109.548,18.2377,1657
53412,356E75600A8901067E9EDB6E5BE4617A,31531,12,13,1,109.49583,18.25972,1461
53413,356E75600A8901067E9EDB6E5BE4617A,38157,14,16,2,109.51483,18.26958,1563
53447,17AC4F8E6659EB7FBFD30E5467A1D200,30711,2,11,9,109.50271,18.25347,1510
53448,17AC4F8E6659EB7FBFD30E5467A1D200,30711,14,17,3,109.50271,18.25347,1510
53449,17AC4F8E6659EB7FBFD30E5467A1D200,31031,17,20,3,109.49979,18.25382,1510
53472,115C807365610875A0C78CE0F5727351,30361,0,10,10,109.50347,18.24,1508
53473,115C807365610875A0C78CE0F5727351,38315,12,15,3,109.48979,18.29764,1467
53475,B93185B4820D7E0DEE74EBEA00941D15,30371,0,14,14,109.51,18.24771,1559
53476,B93185B4820D7E0DEE74EBEA00941D15,60201,14,19,5,109.5041,18.2509,1510
53477,B93185B4820D7E0DEE74EBEA00941D15,38291,20,23,3,109.51618,18.24313,1558
53505,A14C813C3E3A7182759DA822342505B5,30851,1,2,1,109.5616,18.27396,1713
53506,A14C813C3E3A7182759DA822342505B5,39181,2,5,3,109.55153,18.28035,1715
53507,A14C813C3E3A7182759DA822342505B5,30851,7,12,5,109.5616,18.27396,1713
53515,F84D949DDCBF25D5530F771BC55E0B9D,61011,0,7,7,109.60653,18.19076,1900
53517,F84D949DDCBF25D5530F771BC55E0B9D,61011,11,14,3,109.60653,18.19076,1900
53519,F84D949DDCBF25D5530F771BC55E0B9D,61011,20,21,1,109.60653,18.19076,1900
53531,53490AD77ACCA93C3ED0F3DE79CA488B,31071,8,9,1,109.58257,18.28458,1815
53532,53490AD77ACCA93C3ED0F3DE79CA488B,30854,10,18,8,109.56889,18.27076,1763
53533,53490AD77ACCA93C3ED0F3DE79CA488B,31071,21,23,2,109.58257,18.28458,1815
53534,409F5E8F01172D32BBE91132149C037E,38371,0,11,11,109.50972,18.23924,1558
53535,409F5E8F01172D32BBE91132149C037E,31201,12,14,2,109.51042,18.23819,1558
53536,409F5E8F01172D32BBE91132149C037E,38251,14,15,1,109.49618,18.25493,1510
53537,409F5E8F01172D32BBE91132149C037E,31201,19,23,4,109.51042,18.23819,1558
53552,6EF68F35CE79552C1164E70C67C72C02,30121,0,11,11,109.52861,18.27222,1613
53553,6EF68F35CE79552C1164E70C67C72C02,31561,14,15,1,109.56792,18.28479,1765
53554,6EF68F35CE79552C1164E70C67C72C02,30854,15,16,1,109.56889,18.27076,1763
53555,6EF68F35CE79552C1164E70C67C72C02,30121,19,23,4,109.52861,18.27222,1613
53587,C75C3F9BB96630EE8B7793004C08C0A4,31181,0,8,8,109.50382,18.24813,1509
53588,C75C3F9BB96630EE8B7793004C08C0A4,39183,10,19,9,109.55542,18.28208,1715
53589,C75C3F9BB96630EE8B7793004C08C0A4,31021,21,23,2,109.49021,18.27,1463
53627,6E2021B014C4D0B652A2E4FE8D2CF038,31071,0,14,14,109.58257,18.28458,1815
53628,6E2021B014C4D0B652A2E4FE8D2CF038,30854,17,20,3,109.56889,18.27076,1763
53629,9C1407835BC54BEBDB541F52E1DA1820,61011,0,5,5,109.60653,18.19076,1900
53631,9C1407835BC54BEBDB541F52E1DA1820,61011,22,23,1,109.60653,18.19076,1900
53737,C162E20472DBB598395501A28AA53C86,31671,0,7,7,109.38965,18.29813,1068
53738,C162E20472DBB598395501A28AA53C86,60621,9,10,1,109.48354,18.27451,1464
53739,C162E20472DBB598395501A28AA53C86,38157,12,15,3,109.51483,18.26958,1563
53740,C162E20472DBB598395501A28AA53C86,38185,17,18,1,109.51333,18.27347,1563
53741,C162E20472DBB598395501A28AA53C86,60261,21,23,2,109.44326,18.3075,1319
53762,ECB0D6F4F8CE3A022BB643A50974CBE5,31721,21,23,2,109.67938,18.24014,2158
53792,725878F92DD1E911C97E4FFA084F4E39,38951,0,8,8,109.48097,18.28868,1416
53793,725878F92DD1E911C97E4FFA084F4E39,30971,8,12,4,109.48708,18.29319,1467
53794,725878F92DD1E911C97E4FFA084F4E39,38951,13,18,5,109.48097,18.28868,1416
53795,725878F92DD1E911C97E4FFA084F4E39,30971,18,21,3,109.48708,18.29319,1467
53796,725878F92DD1E911C97E4FFA084F4E39,38951,21,23,2,109.48097,18.28868,1416
53839,EC2E5F212996789448E1A244BC83F4F2,38127,20,21,1,109.50833,18.27222,1513
53863,8799356B7181F28146A203E5F86C52F0,31351,0,8,8,109.4959,18.28417,1465
53864,8799356B7181F28146A203E5F86C52F0,38834,9,17,8,109.47639,18.21146,1403
53870,680970852212DD0BF6E2D40630BA722B,31431,0,13,13,109.44639,18.29042,1316
53871,680970852212DD0BF6E2D40630BA722B,60241,14,15,1,109.53319,18.28667,1616
53872,680970852212DD0BF6E2D40630BA722B,31571,15,17,2,109.61563,18.23326,1957
53873,680970852212DD0BF6E2D40630BA722B,60041,21,23,2,109.39889,18.31944,1121
53881,45729A78C6274EF974E0AECB4805EEA8,30181,0,8,8,109.51597,18.23313,1557
53882,45729A78C6274EF974E0AECB4805EEA8,31031,9,11,2,109.49979,18.25382,1510
53883,45729A78C6274EF974E0AECB4805EEA8,30181,13,14,1,109.51597,18.23313,1557
53884,45729A78C6274EF974E0AECB4805EEA8,38754,15,17,2,109.74667,18.37382,2430
53885,45729A78C6274EF974E0AECB4805EEA8,30181,20,23,3,109.51597,18.23313,1557
53888,2091DB2ACA69B10ADE950A23CC278A98,31431,0,2,2,109.44639,18.29042,1316
53889,2091DB2ACA69B10ADE950A23CC278A98,30761,2,3,1,109.45201,18.3,1318
53890,2091DB2ACA69B10ADE950A23CC278A98,30451,4,5,1,109.1791,18.36229,278
53891,2091DB2ACA69B10ADE950A23CC278A98,31431,8,19,11,109.44639,18.29042,1316
53892,2091DB2ACA69B10ADE950A23CC278A98,31121,20,22,2,109.16292,18.37063,230
53895,986F83A7E11B8AB62EA723FFB84474AB,30771,0,6,6,109.49938,18.26042,1511
53932,99CBAA6A65A50998F0A10B72B36210E4,60231,2,4,2,109.49903,18.21972,1504
53933,99CBAA6A65A50998F0A10B72B36210E4,38251,8,18,10,109.49618,18.25493,1510
53934,99CBAA6A65A50998F0A10B72B36210E4,30571,20,23,3,109.50243,18.21861,1504
53938,2FE0F3A82C27452F04A6B927F514EFA7,31551,2,10,8,109.55868,18.24222,1708
53939,2FE0F3A82C27452F04A6B927F514EFA7,31554,11,23,12,109.55521,18.2459,1709
53959,000584B3023702F3E9DDF521B1C35B1A,31071,1,7,6,109.58257,18.28458,1815
53960,000584B3023702F3E9DDF521B1C35B1A,30854,10,11,1,109.56889,18.27076,1763
53992,A83913B9ADE36A68ACBE4A33FF9BCCC8,30771,0,8,8,109.49938,18.26042,1511
54006,55FA72F7A9567EE8C2569F2A3640F92B,31931,12,13,1,109.54771,18.29403,1667
54007,55FA72F7A9567EE8C2569F2A3640F92B,39181,14,17,3,109.55153,18.28035,1715
54008,55FA72F7A9567EE8C2569F2A3640F92B,60371,20,23,3,109.53063,18.30056,1618
54009,EAECAD6795CCC08874248CEF19AA1A37,31231,0,7,7,109.42597,18.29292,1217
54010,EAECAD6795CCC08874248CEF19AA1A37,31145,10,11,1,109.20431,18.30479,369
54011,EAECAD6795CCC08874248CEF19AA1A37,60054,16,17,1,109.3016,18.31229,770
54012,EAECAD6795CCC08874248CEF19AA1A37,31231,19,21,2,109.42597,18.29292,1217
54028,C57035AEBF062E3859D2B5CF6DDF4DF1,60391,0,10,10,109.47667,18.28757,1416
54029,C57035AEBF062E3859D2B5CF6DDF4DF1,60391,12,16,4,109.47667,18.28757,1416
54030,C57035AEBF062E3859D2B5CF6DDF4DF1,60381,19,21,2,109.5241,18.22458,1605
54050,15FA33D999B0EB11F94D5A6342781D57,38754,14,15,1,109.74667,18.37382,2430
54051,15FA33D999B0EB11F94D5A6342781D57,39091,17,18,1,109.50097,18.25222,1510
54052,15FA33D999B0EB11F94D5A6342781D57,31071,20,21,1,109.58257,18.28458,1815
54085,E34FF61340C5B86CF9FD0AD454D26266,60241,12,13,1,109.53319,18.28667,1616
54086,E34FF61340C5B86CF9FD0AD454D26266,60331,17,23,6,109.505,18.26507,1512
54094,847C24726A64F90DD9FA53C8F0C0414F,31145,10,11,1,109.20431,18.30479,369
54151,1122041491C04B199A15F6E1E401D68F,30461,0,16,16,109.5116,18.26313,1562
54152,1122041491C04B199A15F6E1E401D68F,60281,16,22,6,109.51743,18.25924,1561
54158,A32249CDCFA0D3FFE2AE1D7FEF6BE36F,30721,0,7,7,109.51597,18.28257,1565
54159,A32249CDCFA0D3FFE2AE1D7FEF6BE36F,38121,8,10,2,109.51361,18.27813,1564
54160,A32249CDCFA0D3FFE2AE1D7FEF6BE36F,30854,12,13,1,109.56889,18.27076,1763
54161,A32249CDCFA0D3FFE2AE1D7FEF6BE36F,38121,15,20,5,109.51361,18.27813,1564
54162,A32249CDCFA0D3FFE2AE1D7FEF6BE36F,30721,21,23,2,109.51597,18.28257,1565
54202,5B655911B80C25070CDB76D312753BF6,30854,9,10,1,109.56889,18.27076,1763
54203,5B655911B80C25070CDB76D312753BF6,31071,12,18,6,109.58257,18.28458,1815
54234,C9B3A6667B962D267CA332A6E590E095,31251,0,8,8,109.18528,18.2975,317
54235,C9B3A6667B962D267CA332A6E590E095,31411,11,13,2,109.5016,18.23576,1507
54236,C9B3A6667B962D267CA332A6E590E095,31206,14,16,2,109.50819,18.23549,1507
54237,C9B3A6667B962D267CA332A6E590E095,30571,17,18,1,109.50243,18.21861,1504
54238,C9B3A6667B962D267CA332A6E590E095,38251,18,20,2,109.49618,18.25493,1510
54239,C9B3A6667B962D267CA332A6E590E095,31041,21,23,2,109.50278,18.23701,1507
54255,012ABD06F231728C214A4BA917E75B1C,30851,0,2,2,109.5616,18.27396,1713
54256,012ABD06F231728C214A4BA917E75B1C,31561,2,12,10,109.56792,18.28479,1765
54257,012ABD06F231728C214A4BA917E75B1C,30851,12,17,5,109.5616,18.27396,1713
54258,012ABD06F231728C214A4BA917E75B1C,31561,18,22,4,109.56792,18.28479,1765
54259,51061B3DE820AF1C1C713EF684728003,31071,0,7,7,109.58257,18.28458,1815
54260,51061B3DE820AF1C1C713EF684728003,30854,7,9,2,109.56889,18.27076,1763
54261,51061B3DE820AF1C1C713EF684728003,30221,10,11,1,109.57833,18.20222,1802
54262,51061B3DE820AF1C1C713EF684728003,30854,15,20,5,109.56889,18.27076,1763
54318,4E8D795F40D47DACACC3FDDF22027131,30921,0,13,13,109.53903,18.29451,1667
54319,4E8D795F40D47DACACC3FDDF22027131,31931,16,17,1,109.54771,18.29403,1667
54325,F3652FF504BC297E68234A33C1877043,30234,0,5,5,109.60681,18.29979,1918
54326,F3652FF504BC297E68234A33C1877043,30854,6,19,13,109.56889,18.27076,1763
54336,1980C8D409DE9551539224B3D393CDAA,31951,0,1,1,109.52174,18.30299,1568
54337,1980C8D409DE9551539224B3D393CDAA,30071,5,13,8,109.52819,18.30472,1619
54338,1980C8D409DE9551539224B3D393CDAA,31951,13,23,10,109.52174,18.30299,1568
54373,635914FBAF9BDB855B8CB450E2AE782A,30051,1,13,12,109.48917,18.21215,1453
54374,635914FBAF9BDB855B8CB450E2AE782A,30571,13,19,6,109.50243,18.21861,1504
54382,5D56123A0C68AD72DA20EA4585A51B48,60381,0,8,8,109.5241,18.22458,1605
54383,5D56123A0C68AD72DA20EA4585A51B48,31861,12,14,2,109.49042,18.27549,1464
54384,5D56123A0C68AD72DA20EA4585A51B48,30741,18,23,5,109.49833,18.28681,1516
54404,ACC390C77025BECAF4CD259D41E8F314,30232,0,7,7,109.6191,18.31701,1971
54405,ACC390C77025BECAF4CD259D41E8F314,30854,7,10,3,109.56889,18.27076,1763
54406,ACC390C77025BECAF4CD259D41E8F314,30232,11,14,3,109.6191,18.31701,1971
54407,ACC390C77025BECAF4CD259D41E8F314,30854,15,23,8,109.56889,18.27076,1763
54453,9AC1B73A6A57A1A8B7B76A628C70874E,31071,0,8,8,109.58257,18.28458,1815
54454,9AC1B73A6A57A1A8B7B76A628C70874E,30854,8,11,3,109.56889,18.27076,1763
54455,9AC1B73A6A57A1A8B7B76A628C70874E,31071,12,23,11,109.58257,18.28458,1815
54456,43E035AE85036EBD9891453E9567CB81,60361,15,17,2,109.51938,18.29681,1567
54457,43E035AE85036EBD9891453E9567CB81,30151,19,23,4,109.50986,18.25083,1560
54526,2371AF49C13083A9B56BAFD9F258B46A,60361,0,1,1,109.51938,18.29681,1567
54527,2371AF49C13083A9B56BAFD9F258B46A,31261,3,5,2,109.51174,18.2466,1559
54528,2371AF49C13083A9B56BAFD9F258B46A,30721,7,21,14,109.51597,18.28257,1565
54529,2371AF49C13083A9B56BAFD9F258B46A,30071,21,23,2,109.52819,18.30472,1619
54533,8C2CF39A00D35EA3A7B1A771113C2AE8,31071,0,7,7,109.58257,18.28458,1815
54534,8C2CF39A00D35EA3A7B1A771113C2AE8,30854,7,9,2,109.56889,18.27076,1763
54535,8C2CF39A00D35EA3A7B1A771113C2AE8,38754,10,12,2,109.74667,18.37382,2430
54536,8C2CF39A00D35EA3A7B1A771113C2AE8,31164,13,14,1,109.69993,18.27215,2263
54537,8C2CF39A00D35EA3A7B1A771113C2AE8,60221,16,17,1,109.52569,18.29188,1616
54546,FD18155FE4FC718630CE71D3DC676309,38251,0,8,8,109.49618,18.25493,1510
54547,FD18155FE4FC718630CE71D3DC676309,30341,9,15,6,109.3625,18.29167,966
54551,8752BC71725B50257436D50C6598F252,30854,0,6,6,109.56889,18.27076,1763
54552,8752BC71725B50257436D50C6598F252,31071,7,8,1,109.58257,18.28458,1815
54553,8752BC71725B50257436D50C6598F252,30854,9,12,3,109.56889,18.27076,1763
54554,8752BC71725B50257436D50C6598F252,31071,12,13,1,109.58257,18.28458,1815
54555,8752BC71725B50257436D50C6598F252,30854,15,18,3,109.56889,18.27076,1763
54556,8752BC71725B50257436D50C6598F252,31411,19,21,2,109.5016,18.23576,1507
54582,12D8E06C2EC8C969710FB791DF137B2B,33481,14,15,1,109.67278,18.41278,2187
54583,12D8E06C2EC8C969710FB791DF137B2B,31071,19,23,4,109.58257,18.28458,1815
54620,860BE848C8101F7690BF8A8F8889D18A,39091,0,8,8,109.50097,18.25222,1510
54621,860BE848C8101F7690BF8A8F8889D18A,31031,12,16,4,109.49979,18.25382,1510
54622,860BE848C8101F7690BF8A8F8889D18A,39091,20,23,3,109.50097,18.25222,1510
54631,653802FBFFAEB319D5E2987830A7AC5C,38881,0,12,12,109.51618,18.26431,1562
54632,653802FBFFAEB319D5E2987830A7AC5C,60261,13,18,5,109.44326,18.3075,1319
54645,ED67941542B7BC0CBB81E45CC76BA427,38251,18,21,3,109.49618,18.25493,1510
54646,189633BA4D39EBA8A203BC9E364D4B1F,38291,18,20,2,109.51618,18.24313,1558
54647,189633BA4D39EBA8A203BC9E364D4B1F,30381,22,23,1,109.52521,18.24507,1609
54648,300A1885BA30CEEF17B7B730D91F8A14,30151,0,8,8,109.50986,18.25083,1560
54656,DC9973204E62AA99FA79F0696CF6C0F6,31945,0,2,2,109.58021,18.29403,1817
54657,DC9973204E62AA99FA79F0696CF6C0F6,30232,3,5,2,109.6191,18.31701,1971
54658,DC9973204E62AA99FA79F0696CF6C0F6,30854,7,14,7,109.56889,18.27076,1763
54659,DC9973204E62AA99FA79F0696CF6C0F6,31071,14,15,1,109.58257,18.28458,1815
54660,DC9973204E62AA99FA79F0696CF6C0F6,30854,18,20,2,109.56889,18.27076,1763
54661,DC9973204E62AA99FA79F0696CF6C0F6,31945,21,23,2,109.58021,18.29403,1817
54666,7BBB2DDEDB0AE43F8CE7FBD1FCB52741,31071,1,10,9,109.58257,18.28458,1815
54667,7BBB2DDEDB0AE43F8CE7FBD1FCB52741,30854,10,11,1,109.56889,18.27076,1763
54668,7BBB2DDEDB0AE43F8CE7FBD1FCB52741,31071,11,13,2,109.58257,18.28458,1815
54669,7BBB2DDEDB0AE43F8CE7FBD1FCB52741,30854,17,19,2,109.56889,18.27076,1763
54736,377A324496E54511961704972731A3D5,31821,0,7,7,109.51181,18.24924,1559
54737,377A324496E54511961704972731A3D5,38121,7,8,1,109.51361,18.27813,1564
54738,377A324496E54511961704972731A3D5,39111,12,14,2,109.5191,18.22597,1555
54739,377A324496E54511961704972731A3D5,30711,15,17,2,109.50271,18.25347,1510
54740,377A324496E54511961704972731A3D5,31261,21,23,2,109.51174,18.2466,1559
54843,35ADE76574C90D3F668DA7E7FAC83625,31621,0,9,9,109.51035,18.29826,1568
54844,35ADE76574C90D3F668DA7E7FAC83625,60281,10,11,1,109.51743,18.25924,1561
54845,35ADE76574C90D3F668DA7E7FAC83625,31621,12,23,11,109.51035,18.29826,1568
54871,0E4E3873A84F880D37A184F5409B3BB0,30711,1,12,11,109.50271,18.25347,1510
54872,0E4E3873A84F880D37A184F5409B3BB0,31031,13,15,2,109.49979,18.25382,1510
54883,DBD4841C5E4F303F65EFFFA2DCCC9037,30611,19,20,1,109.74958,18.40188,2485
54894,48C54876E17753CB38ABDB119760EED3,38361,0,7,7,109.43667,18.29201,1267
54895,48C54876E17753CB38ABDB119760EED3,31781,9,11,2,109.19847,18.2975,367
54896,48C54876E17753CB38ABDB119760EED3,30771,16,18,2,109.49938,18.26042,1511
54897,48C54876E17753CB38ABDB119760EED3,31701,19,20,1,109.44132,18.28833,1266
54898,48C54876E17753CB38ABDB119760EED3,38361,21,23,2,109.43667,18.29201,1267
54906,7890099D98AA300C5BF12527E7372DB0,60631,0,7,7,109.57778,18.27583,1814
54907,7890099D98AA300C5BF12527E7372DB0,30854,9,11,2,109.56889,18.27076,1763
54908,7890099D98AA300C5BF12527E7372DB0,60631,12,23,11,109.57778,18.27583,1814
54923,B1CDB845FD43C065DBB8ADFB7BB832CF,60381,1,5,4,109.5241,18.22458,1605
54924,B1CDB845FD43C065DBB8ADFB7BB832CF,31521,5,9,4,109.51458,18.22542,1555
54925,B1CDB845FD43C065DBB8ADFB7BB832CF,31781,13,15,2,109.19847,18.2975,367
54926,B1CDB845FD43C065DBB8ADFB7BB832CF,30361,18,19,1,109.50347,18.24,1508
54927,B1CDB845FD43C065DBB8ADFB7BB832CF,60381,20,23,3,109.5241,18.22458,1605
54938,ED6F7009636BD3F67073E899290E8706,38251,0,8,8,109.49618,18.25493,1510
54939,ED6F7009636BD3F67073E899290E8706,60344,13,14,1,109.68847,18.31931,2221
54940,ED6F7009636BD3F67073E899290E8706,38251,16,23,7,109.49618,18.25493,1510
54944,9AA959ED87D1ECC3053DED17290EFCBD,30854,0,4,4,109.56889,18.27076,1763
54945,9AA959ED87D1ECC3053DED17290EFCBD,31561,5,6,1,109.56792,18.28479,1765
54946,9AA959ED87D1ECC3053DED17290EFCBD,39183,8,10,2,109.55542,18.28208,1715
54947,9AA959ED87D1ECC3053DED17290EFCBD,31561,10,18,8,109.56792,18.28479,1765
54966,2018AFC66B55C1596C097BE2B8C40D81,39183,3,4,1,109.55542,18.28208,1715
54967,2018AFC66B55C1596C097BE2B8C40D81,30854,7,8,1,109.56889,18.27076,1763
54968,2018AFC66B55C1596C097BE2B8C40D81,31071,10,14,4,109.58257,18.28458,1815
54969,2018AFC66B55C1596C097BE2B8C40D81,30854,17,21,4,109.56889,18.27076,1763
54970,2018AFC66B55C1596C097BE2B8C40D81,31071,21,23,2,109.58257,18.28458,1815
55030,32D0EBFA645FCE8DAD65D018847E5043,30232,1,6,5,109.6191,18.31701,1971
55031,32D0EBFA645FCE8DAD65D018847E5043,30854,9,11,2,109.56889,18.27076,1763
55032,32D0EBFA645FCE8DAD65D018847E5043,30232,13,14,1,109.6191,18.31701,1971
55033,32D0EBFA645FCE8DAD65D018847E5043,30854,19,21,2,109.56889,18.27076,1763
55041,124582850E875F6ABADF3995E17B9C14,38951,0,8,8,109.48097,18.28868,1416
55042,124582850E875F6ABADF3995E17B9C14,30971,9,11,2,109.48708,18.29319,1467
55043,124582850E875F6ABADF3995E17B9C14,60614,12,13,1,109.48799,18.29521,1467
55044,124582850E875F6ABADF3995E17B9C14,60504,18,19,1,109.47917,18.28903,1416
55045,124582850E875F6ABADF3995E17B9C14,39091,20,22,2,109.50097,18.25222,1510
55052,A3F1A757214C25A449688115E5C4321B,31931,0,15,15,109.54771,18.29403,1667
55053,A3F1A757214C25A449688115E5C4321B,60371,16,18,2,109.53063,18.30056,1618
55059,97310D96003EB3F80B00200829A6C917,30421,0,8,8,109.50021,18.25861,1511
55060,97310D96003EB3F80B00200829A6C917,31781,13,14,1,109.19847,18.2975,367
55061,97310D96003EB3F80B00200829A6C917,30361,16,17,1,109.50347,18.24,1508
55062,97310D96003EB3F80B00200829A6C917,31534,19,21,2,109.49368,18.25806,1461
55080,97D0EDC4C3991BB00D2216D455B37E1E,60491,0,2,2,109.43354,18.30847,1269
55081,97D0EDC4C3991BB00D2216D455B37E1E,60421,3,4,1,109.46333,18.31743,1371
55120,40285EE8CCE25C38988EC087545664EC,30854,0,1,1,109.56889,18.27076,1763
55121,40285EE8CCE25C38988EC087545664EC,31071,2,7,5,109.58257,18.28458,1815
55122,40285EE8CCE25C38988EC087545664EC,30854,7,14,7,109.56889,18.27076,1763
55123,40285EE8CCE25C38988EC087545664EC,31071,15,17,2,109.58257,18.28458,1815
55134,E5688750AFF137F525F6B57BF016E6A9,30441,0,1,1,109.64021,18.25424,2010
55135,E5688750AFF137F525F6B57BF016E6A9,38275,3,20,17,109.62875,18.22938,2006
55136,E5688750AFF137F525F6B57BF016E6A9,31071,21,23,2,109.58257,18.28458,1815
55165,A5CD09962A7112EBCA0B8431614A22D0,33481,13,15,2,109.67278,18.41278,2187
55166,A5CD09962A7112EBCA0B8431614A22D0,30854,17,20,3,109.56889,18.27076,1763
55210,C8922FAF66F21ECAECB6B717FCD5A53B,60391,1,6,5,109.47667,18.28757,1416
55211,C8922FAF66F21ECAECB6B717FCD5A53B,60614,6,14,8,109.48799,18.29521,1467
55212,C8922FAF66F21ECAECB6B717FCD5A53B,60391,16,18,2,109.47667,18.28757,1416
55220,AD90E9B8415F78DBA16ADA8EB692280E,60321,0,7,7,109.63611,18.24306,2008
55221,AD90E9B8415F78DBA16ADA8EB692280E,60541,11,12,1,109.4084,18.29208,1167
55222,AD90E9B8415F78DBA16ADA8EB692280E,60321,16,23,7,109.63611,18.24306,2008
55279,2B60907F04C29DE058B3E64B1D3B4100,31561,0,7,7,109.56792,18.28479,1765
55280,2B60907F04C29DE058B3E64B1D3B4100,30854,7,13,6,109.56889,18.27076,1763
55281,2B60907F04C29DE058B3E64B1D3B4100,31561,13,14,1,109.56792,18.28479,1765
55282,2B60907F04C29DE058B3E64B1D3B4100,38283,16,18,2,109.62229,18.22618,1956
55283,2B60907F04C29DE058B3E64B1D3B4100,31561,22,23,1,109.56792,18.28479,1765
55284,A503639E15A0B5D04B0130D882921438,31031,0,18,18,109.49979,18.25382,1510
55285,A503639E15A0B5D04B0130D882921438,30421,19,20,1,109.50021,18.25861,1511
55286,A503639E15A0B5D04B0130D882921438,31031,20,23,3,109.49979,18.25382,1510
55292,8A19D38C67DEBBE2072401E23B2467C5,31161,0,10,10,109.70229,18.31361,2270
55293,8A19D38C67DEBBE2072401E23B2467C5,33521,13,15,2,109.66313,18.45174,2143
55294,8A19D38C67DEBBE2072401E23B2467C5,30191,20,23,3,109.50361,18.22701,1506
55295,2BCFA9C4E1ED903F9FC4B4668FFF48A3,60421,0,11,11,109.46333,18.31743,1371
55296,2BCFA9C4E1ED903F9FC4B4668FFF48A3,38315,14,17,3,109.48979,18.29764,1467
55305,42E0A9876983C86FFFD22EE12B32D1F7,31521,0,6,6,109.51458,18.22542,1555
55306,42E0A9876983C86FFFD22EE12B32D1F7,31781,8,12,4,109.19847,18.2975,367
55307,42E0A9876983C86FFFD22EE12B32D1F7,31471,14,15,1,109.34583,18.29563,917
55308,42E0A9876983C86FFFD22EE12B32D1F7,31521,19,22,3,109.51458,18.22542,1555
55313,19DF3AF20A6216C60974B8B3423BEBC6,31021,13,15,2,109.49021,18.27,1463
55314,19DF3AF20A6216C60974B8B3423BEBC6,31931,17,19,2,109.54771,18.29403,1667
55315,19DF3AF20A6216C60974B8B3423BEBC6,30921,20,21,1,109.53903,18.29451,1667
55329,8BB72B564DE6262BEA9209907400F565,38094,0,7,7,109.45403,18.28778,1316
55330,8BB72B564DE6262BEA9209907400F565,60054,12,14,2,109.3016,18.31229,770
55347,04ABA8BFD5D63DDF1B83BA0577C9019C,30854,9,17,8,109.56889,18.27076,1763
55348,04ABA8BFD5D63DDF1B83BA0577C9019C,39183,17,19,2,109.55542,18.28208,1715
55407,AC0E940CA4876D60068799AC7DD06B30,30161,0,6,6,109.50042,18.24389,1508
55408,AC0E940CA4876D60068799AC7DD06B30,30281,7,9,2,109.50597,18.27583,1514
55409,AC0E940CA4876D60068799AC7DD06B30,30051,10,11,1,109.48917,18.21215,1453
55410,AC0E940CA4876D60068799AC7DD06B30,60401,15,18,3,109.47444,18.27583,1414
55411,AC0E940CA4876D60068799AC7DD06B30,31391,20,23,3,109.50382,18.24285,1508
55426,E9E473F09C342630187345312F4A31D8,39181,0,14,14,109.55153,18.28035,1715
55427,E9E473F09C342630187345312F4A31D8,31031,18,20,2,109.49979,18.25382,1510
55428,E9E473F09C342630187345312F4A31D8,39181,21,23,2,109.55153,18.28035,1715
55442,D4F66FB71406E4E38A7A105B0CD3164D,31031,0,6,6,109.49979,18.25382,1510
55443,D4F66FB71406E4E38A7A105B0CD3164D,30711,6,22,16,109.50271,18.25347,1510
55452,08A066736557478B1013C0CF834491DF,30921,0,7,7,109.53903,18.29451,1667
55453,08A066736557478B1013C0CF834491DF,31931,9,17,8,109.54771,18.29403,1667
55463,CE0A7F48A0786EED2BD468477FDDA0D5,31031,0,6,6,109.49979,18.25382,1510
55465,CE0A7F48A0786EED2BD468477FDDA0D5,31145,13,14,1,109.20431,18.30479,369
55466,CE0A7F48A0786EED2BD468477FDDA0D5,60221,18,21,3,109.52569,18.29188,1616
55506,E75CF54BA14775FEDD26504F9F6B7365,31945,0,6,6,109.58021,18.29403,1817
55507,E75CF54BA14775FEDD26504F9F6B7365,31561,7,19,12,109.56792,18.28479,1765
55508,E75CF54BA14775FEDD26504F9F6B7365,30234,20,22,2,109.60681,18.29979,1918
55509,00FC332040A284DA251A8D0705989FE9,31071,0,9,9,109.58257,18.28458,1815
55510,00FC332040A284DA251A8D0705989FE9,30854,9,21,12,109.56889,18.27076,1763
55537,60C76AD19DF8888A84F620E94C92FF2B,60161,3,4,1,109.49174,18.26181,1461
55538,60C76AD19DF8888A84F620E94C92FF2B,39151,7,9,2,109.49875,18.25097,1510
55539,60C76AD19DF8888A84F620E94C92FF2B,60084,10,11,1,109.4984,18.2334,1507
55540,60C76AD19DF8888A84F620E94C92FF2B,60161,11,12,1,109.49174,18.26181,1461
55541,60C76AD19DF8888A84F620E94C92FF2B,30571,12,20,8,109.50243,18.21861,1504
55542,60C76AD19DF8888A84F620E94C92FF2B,60231,20,21,1,109.49903,18.21972,1504
55583,2981C8B3C1AD0C63670497656AA260BB,30771,19,22,3,109.49938,18.26042,1511
55584,2981C8B3C1AD0C63670497656AA260BB,30721,22,23,1,109.51597,18.28257,1565
55626,F6CCF646674665C449464A30D23BCEEF,30271,11,14,3,109.49132,18.23153,1456
55627,F6CCF646674665C449464A30D23BCEEF,30571,18,19,1,109.50243,18.21861,1504
55628,39F25FE146A03325C93C111F2A943B6C,30854,15,17,2,109.56889,18.27076,1763
55629,39F25FE146A03325C93C111F2A943B6C,31071,19,21,2,109.58257,18.28458,1815
55634,4E7B7A24B335C2D3B9254A6E7207B078,30651,14,17,3,109.42611,18.385,1232
55635,4E7B7A24B335C2D3B9254A6E7207B078,60551,18,23,5,109.42722,18.30111,1218
55690,8DAAE9387127D24D516B493EB48ABB27,39091,0,10,10,109.50097,18.25222,1510
55730,1E36640BE395A4EE8CCB2697222419A5,60631,2,3,1,109.57778,18.27583,1814
55731,1E36640BE395A4EE8CCB2697222419A5,31071,4,6,2,109.58257,18.28458,1815
55732,1E36640BE395A4EE8CCB2697222419A5,30854,8,18,10,109.56889,18.27076,1763
55733,1E36640BE395A4EE8CCB2697222419A5,38891,19,20,1,109.51486,18.24118,1558
55734,1E36640BE395A4EE8CCB2697222419A5,30191,21,23,2,109.50361,18.22701,1506
55735,14AE6C820CE45F96077630992CABD33D,30951,1,7,6,109.56208,18.25667,1761
55736,14AE6C820CE45F96077630992CABD33D,31551,8,18,10,109.55868,18.24222,1708
55737,14AE6C820CE45F96077630992CABD33D,30951,20,22,2,109.56208,18.25667,1761
55754,DFFF17B7FE30E79B8AABBB5CE171272F,39183,12,14,2,109.55542,18.28208,1715
55755,DFFF17B7FE30E79B8AABBB5CE171272F,31561,14,19,5,109.56792,18.28479,1765
55765,AC435D39B518EE36E9A2F7FB71463491,30721,0,6,6,109.51597,18.28257,1565
55766,AC435D39B518EE36E9A2F7FB71463491,31561,8,12,4,109.56792,18.28479,1765
55767,AC435D39B518EE36E9A2F7FB71463491,30721,13,23,10,109.51597,18.28257,1565
55771,97E500FACC6D356A86120D646AE5646D,38871,1,4,3,109.44681,18.28625,1316
55772,97E500FACC6D356A86120D646AE5646D,30171,7,8,1,109.48458,18.27139,1463
55839,EC4B90EDBF35256FDB4D4F8B87DB8A04,31071,3,6,3,109.58257,18.28458,1815
55840,EC4B90EDBF35256FDB4D4F8B87DB8A04,30854,8,10,2,109.56889,18.27076,1763
55841,EC4B90EDBF35256FDB4D4F8B87DB8A04,31071,10,11,1,109.58257,18.28458,1815
55842,EC4B90EDBF35256FDB4D4F8B87DB8A04,30854,13,23,10,109.56889,18.27076,1763
55843,765EFA3B9C0C38522A77B4DC379A88A8,30181,0,12,12,109.51597,18.23313,1557
55844,765EFA3B9C0C38522A77B4DC379A88A8,60221,17,18,1,109.52569,18.29188,1616
55863,F113DDC78FC5471ED8A23532B5EF78E0,30181,0,2,2,109.51597,18.23313,1557
55864,F113DDC78FC5471ED8A23532B5EF78E0,30181,3,6,3,109.51597,18.23313,1557
55865,F113DDC78FC5471ED8A23532B5EF78E0,30181,7,13,6,109.51597,18.23313,1557
55879,5A1FDC762E3A00EF6FB4C515806ADF6A,30151,0,2,2,109.50986,18.25083,1560
55880,5A1FDC762E3A00EF6FB4C515806ADF6A,31261,2,10,8,109.51174,18.2466,1559
55881,5A1FDC762E3A00EF6FB4C515806ADF6A,38291,10,12,2,109.51618,18.24313,1558
55882,5A1FDC762E3A00EF6FB4C515806ADF6A,31261,12,17,5,109.51174,18.2466,1559
55883,5A1FDC762E3A00EF6FB4C515806ADF6A,38291,19,23,4,109.51618,18.24313,1558
55903,0D69669D4DBC1CEB06269A084D86E853,60631,2,11,9,109.57778,18.27583,1814
55904,0D69669D4DBC1CEB06269A084D86E853,31571,15,16,1,109.61563,18.23326,1957
55905,0D69669D4DBC1CEB06269A084D86E853,30581,19,20,1,109.62257,18.24951,1959
55924,03DA52CB04D303C32B3FDE6BAFCAF395,31521,10,14,4,109.51458,18.22542,1555
55925,03DA52CB04D303C32B3FDE6BAFCAF395,60631,15,16,1,109.57778,18.27583,1814
55926,03DA52CB04D303C32B3FDE6BAFCAF395,30854,16,17,1,109.56889,18.27076,1763
55927,03DA52CB04D303C32B3FDE6BAFCAF395,31521,19,23,4,109.51458,18.22542,1555
55930,82DD14B5C026D53A308B7973E7FE94EA,31061,0,7,7,109.53333,18.23257,1607
55931,82DD14B5C026D53A308B7973E7FE94EA,31701,10,12,2,109.44132,18.28833,1266
55935,7AD44260775546C7B79200C2095B5215,31471,15,17,2,109.34583,18.29563,917
55936,7AD44260775546C7B79200C2095B5215,30661,19,22,3,109.37028,18.24361,1008
55995,59CD1D4AEF7EA7DE0994909193B0D818,30681,0,8,8,109.48493,18.26917,1463
55996,59CD1D4AEF7EA7DE0994909193B0D818,31801,10,12,2,109.20417,18.32118,371
55997,59CD1D4AEF7EA7DE0994909193B0D818,31471,15,17,2,109.34583,18.29563,917
55998,59CD1D4AEF7EA7DE0994909193B0D818,31531,18,20,2,109.49583,18.25972,1461
55999,59CD1D4AEF7EA7DE0994909193B0D818,30171,21,23,2,109.48458,18.27139,1463
56007,C9DE6AF5861DC39A611FCC9B2DCFD783,38951,0,8,8,109.48097,18.28868,1416
56008,C9DE6AF5861DC39A611FCC9B2DCFD783,30971,8,10,2,109.48708,18.29319,1467
56009,C9DE6AF5861DC39A611FCC9B2DCFD783,30971,11,13,2,109.48708,18.29319,1467
56019,9390F3530298874939B7DDA5575429FD,30361,20,22,2,109.50347,18.24,1508
56047,2B37ECAF93E1D338CBB5FDF40ACD1C13,30854,6,11,5,109.56889,18.27076,1763
56048,2B37ECAF93E1D338CBB5FDF40ACD1C13,31071,11,12,1,109.58257,18.28458,1815
56049,2B37ECAF93E1D338CBB5FDF40ACD1C13,30854,13,15,2,109.56889,18.27076,1763
56050,2B37ECAF93E1D338CBB5FDF40ACD1C13,31071,17,19,2,109.58257,18.28458,1815
56051,2B37ECAF93E1D338CBB5FDF40ACD1C13,30854,22,23,1,109.56889,18.27076,1763
56056,7094512B15E4EF60EF67A3E6DEAF677A,60594,0,8,8,109.62694,18.22799,1956
56057,7094512B15E4EF60EF67A3E6DEAF677A,38052,8,9,1,109.62618,18.23042,1956
56058,7094512B15E4EF60EF67A3E6DEAF677A,60594,9,11,2,109.62694,18.22799,1956
56059,7094512B15E4EF60EF67A3E6DEAF677A,31571,16,17,1,109.61563,18.23326,1957
56060,7094512B15E4EF60EF67A3E6DEAF677A,31321,19,20,1,109.63799,18.23201,2007
56061,7094512B15E4EF60EF67A3E6DEAF677A,38052,22,23,1,109.62618,18.23042,1956
56092,5C5C16E98C1163D699B17F68D2A1C502,60571,0,8,8,109.50722,18.25056,1510
56106,19AF0D8561DDB234E66714D4BD522678,31521,13,15,2,109.51458,18.22542,1555
56107,19AF0D8561DDB234E66714D4BD522678,31521,15,21,6,109.51458,18.22542,1555
56137,2C75E170FFFB8DA3468A04F9EEF0226E,30854,14,16,2,109.56889,18.27076,1763
56138,2C75E170FFFB8DA3468A04F9EEF0226E,60084,19,20,1,109.4984,18.2334,1507
56186,A4D22152627C5C24F4D207D0FDD787D4,60371,0,1,1,109.53063,18.30056,1618
56187,A4D22152627C5C24F4D207D0FDD787D4,60241,3,8,5,109.53319,18.28667,1616
56188,A4D22152627C5C24F4D207D0FDD787D4,60221,9,18,9,109.52569,18.29188,1616
56197,27229B6D41BD7CDDDAA38911093865DB,38085,5,15,10,109.6291,18.23625,2007
56198,27229B6D41BD7CDDDAA38911093865DB,31071,18,19,1,109.58257,18.28458,1815
56199,27229B6D41BD7CDDDAA38911093865DB,30854,19,22,3,109.56889,18.27076,1763
56215,14F1CC63CDA098F9694EAC8584B9C7A5,31561,0,8,8,109.56792,18.28479,1765
56216,14F1CC63CDA098F9694EAC8584B9C7A5,30854,10,12,2,109.56889,18.27076,1763
56226,E3921F0CF54D3F02F585C6050AAAD093,60084,0,7,7,109.4984,18.2334,1507
56227,E3921F0CF54D3F02F585C6050AAAD093,30854,10,11,1,109.56889,18.27076,1763
56280,DC60807FE78F0A4024F6DE8DC83F5D09,60131,0,2,2,109.49819,18.24778,1509
56281,DC60807FE78F0A4024F6DE8DC83F5D09,39091,3,7,4,109.50097,18.25222,1510
56282,DC60807FE78F0A4024F6DE8DC83F5D09,60381,9,10,1,109.5241,18.22458,1605
56283,DC60807FE78F0A4024F6DE8DC83F5D09,60131,11,12,1,109.49819,18.24778,1509
56284,DC60807FE78F0A4024F6DE8DC83F5D09,39151,13,16,3,109.49875,18.25097,1510
56285,DC60807FE78F0A4024F6DE8DC83F5D09,60131,16,17,1,109.49819,18.24778,1509
56286,DC60807FE78F0A4024F6DE8DC83F5D09,60381,18,21,3,109.5241,18.22458,1605
56287,DC60807FE78F0A4024F6DE8DC83F5D09,31031,21,23,2,109.49979,18.25382,1510
56290,C8501DFE42E6954852B7593EDA5D3099,30211,13,14,1,109.49882,18.23931,1508
56291,C8501DFE42E6954852B7593EDA5D3099,60361,14,16,2,109.51938,18.29681,1567
56292,C8501DFE42E6954852B7593EDA5D3099,39151,18,20,2,109.49875,18.25097,1510
56293,C8501DFE42E6954852B7593EDA5D3099,30731,21,23,2,109.50944,18.22306,1555
56379,2225A928A5F41EC3C7691341B4D74A48,38297,0,5,5,109.52576,18.24965,1609
56380,2225A928A5F41EC3C7691341B4D74A48,60311,6,7,1,109.52097,18.24319,1558
56381,2225A928A5F41EC3C7691341B4D74A48,38297,8,20,12,109.52576,18.24965,1609
56471,08DA3CFA22819D4D1B43402F03528A0D,31521,3,5,2,109.51458,18.22542,1555
56472,08DA3CFA22819D4D1B43402F03528A0D,31521,5,6,1,109.51458,18.22542,1555
56473,08DA3CFA22819D4D1B43402F03528A0D,30861,7,17,10,109.52722,18.22743,1606
56474,08DA3CFA22819D4D1B43402F03528A0D,60381,18,23,5,109.5241,18.22458,1605
56483,7C4B45B599684104AFE3AA992CD3924A,31761,0,7,7,109.60521,18.27965,1914
56484,7C4B45B599684104AFE3AA992CD3924A,30811,8,9,1,109.65188,18.26257,2062
56485,7C4B45B599684104AFE3AA992CD3924A,39021,11,14,3,109.40368,18.41035,1186
56486,7C4B45B599684104AFE3AA992CD3924A,60381,15,17,2,109.5241,18.22458,1605
56487,7C4B45B599684104AFE3AA992CD3924A,38111,21,23,2,109.52007,18.22403,1555
56504,EF19CB13707D6DFCAE162877A347BCE9,31206,0,7,7,109.50819,18.23549,1507
56505,EF19CB13707D6DFCAE162877A347BCE9,30361,8,10,2,109.50347,18.24,1508
56506,EF19CB13707D6DFCAE162877A347BCE9,60401,14,15,1,109.47444,18.27583,1414
56507,EF19CB13707D6DFCAE162877A347BCE9,60441,15,17,2,109.46792,18.28604,1366
56508,EF19CB13707D6DFCAE162877A347BCE9,31206,21,23,2,109.50819,18.23549,1507
56531,C34234ACF873DBD501F7188735591693,31345,0,9,9,109.39,18.29,1066
56532,C34234ACF873DBD501F7188735591693,30171,11,12,1,109.48458,18.27139,1463
56533,C34234ACF873DBD501F7188735591693,31345,12,14,2,109.39,18.29,1066
56534,C34234ACF873DBD501F7188735591693,30361,17,19,2,109.50347,18.24,1508
56535,C34234ACF873DBD501F7188735591693,31345,20,23,3,109.39,18.29,1066
56536,18AAFF817ACB01445A8E56AB6C7AC8DB,30821,15,17,2,109.43681,18.33639,1274
56537,18AAFF817ACB01445A8E56AB6C7AC8DB,38951,18,23,5,109.48097,18.28868,1416
56565,0C3DD1EABA2D708A2506DA8150CEC148,31561,0,6,6,109.56792,18.28479,1765
56566,0C3DD1EABA2D708A2506DA8150CEC148,30854,7,9,2,109.56889,18.27076,1763
56567,0C3DD1EABA2D708A2506DA8150CEC148,31561,10,13,3,109.56792,18.28479,1765
56568,0C3DD1EABA2D708A2506DA8150CEC148,30854,13,17,4,109.56889,18.27076,1763
56569,0C3DD1EABA2D708A2506DA8150CEC148,31561,18,23,5,109.56792,18.28479,1765
56580,CF339E74AE2AB11E21E4B60CD856FF52,60641,9,10,1,109.53854,18.2359,1657
56581,CF339E74AE2AB11E21E4B60CD856FF52,60321,11,15,4,109.63611,18.24306,2008
56593,3887FF64832E3EF638532F1D2F2E4297,60231,4,12,8,109.49903,18.21972,1504
56594,3887FF64832E3EF638532F1D2F2E4297,60201,15,16,1,109.5041,18.2509,1510
56615,20076B8669E5BE36124693E9782985A5,60221,16,18,2,109.52569,18.29188,1616
56616,20076B8669E5BE36124693E9782985A5,31491,19,22,3,109.73042,18.38771,2382
56646,588410E89DFC58F669994FE4D6BC8BEB,31951,10,16,6,109.52174,18.30299,1568
56647,588410E89DFC58F669994FE4D6BC8BEB,38071,19,22,3,109.40722,18.30938,1169
56656,AB43182259122294244C13D6FC66D4A1,30891,0,4,4,109.59431,18.28389,1865
56657,AB43182259122294244C13D6FC66D4A1,30851,7,8,1,109.5616,18.27396,1713
56658,AB43182259122294244C13D6FC66D4A1,31561,8,18,10,109.56792,18.28479,1765
56659,AB43182259122294244C13D6FC66D4A1,60631,20,22,2,109.57778,18.27583,1814
56664,C462628FF36F8FF2D0B7493E6DDA38BB,60411,0,1,1,109.32514,18.30854,869
56665,C462628FF36F8FF2D0B7493E6DDA38BB,30661,1,10,9,109.37028,18.24361,1008
56666,C462628FF36F8FF2D0B7493E6DDA38BB,60411,11,15,4,109.32514,18.30854,869
56667,C462628FF36F8FF2D0B7493E6DDA38BB,30661,18,20,2,109.37028,18.24361,1008
56668,C462628FF36F8FF2D0B7493E6DDA38BB,60411,22,23,1,109.32514,18.30854,869
56669,19A0329D0AB44903B1CD08967E695964,30381,0,9,9,109.52521,18.24507,1609
56670,19A0329D0AB44903B1CD08967E695964,30381,11,14,3,109.52521,18.24507,1609
56702,08DE09BBA0A90299BFCC2039B5540121,38361,17,22,5,109.43667,18.29201,1267
56703,B29F33564DDA3CFA905BF42633BA4302,60614,1,14,13,109.48799,18.29521,1467
56704,B29F33564DDA3CFA905BF42633BA4302,38291,15,19,4,109.51618,18.24313,1558
56705,B29F33564DDA3CFA905BF42633BA4302,31391,20,21,1,109.50382,18.24285,1508
56720,4D1BB128029C55ECC42D47D6B6CF70E9,30581,0,8,8,109.62257,18.24951,1959
56721,4D1BB128029C55ECC42D47D6B6CF70E9,31471,13,14,1,109.34583,18.29563,917
56722,4D1BB128029C55ECC42D47D6B6CF70E9,30581,19,20,1,109.62257,18.24951,1959
56723,4D1BB128029C55ECC42D47D6B6CF70E9,31571,20,23,3,109.61563,18.23326,1957
56724,72839B8F6256E6FF641405D4832BF569,30854,15,17,2,109.56889,18.27076,1763
56725,72839B8F6256E6FF641405D4832BF569,31071,19,22,3,109.58257,18.28458,1815
56736,5EE25A6E7DD554FFDA0C9C1A504114B7,60291,0,6,6,109.50826,18.24639,1509
56737,5EE25A6E7DD554FFDA0C9C1A504114B7,30221,7,16,9,109.57833,18.20222,1802
56738,5EE25A6E7DD554FFDA0C9C1A504114B7,38127,18,20,2,109.50833,18.27222,1513
56739,5EE25A6E7DD554FFDA0C9C1A504114B7,30221,21,23,2,109.57833,18.20222,1802
56740,4BA42026831E7F4B42D17FDF4BDEE62E,31931,0,5,5,109.54771,18.29403,1667
56741,4BA42026831E7F4B42D17FDF4BDEE62E,39181,7,10,3,109.55153,18.28035,1715
56742,F8D799D9161B0143E0D71C40472A357E,30071,0,8,8,109.52819,18.30472,1619
56743,F8D799D9161B0143E0D71C40472A357E,30071,10,12,2,109.52819,18.30472,1619
56744,F8D799D9161B0143E0D71C40472A357E,30071,13,16,3,109.52819,18.30472,1619
56745,F8D799D9161B0143E0D71C40472A357E,30071,16,23,7,109.52819,18.30472,1619
56746,FCFB14BA36BDB7CD6A39612B9AE933B2,38127,0,7,7,109.50833,18.27222,1513
56747,FCFB14BA36BDB7CD6A39612B9AE933B2,39181,11,14,3,109.55153,18.28035,1715
56748,FCFB14BA36BDB7CD6A39612B9AE933B2,39183,14,16,2,109.55542,18.28208,1715
56749,FCFB14BA36BDB7CD6A39612B9AE933B2,38127,18,23,5,109.50833,18.27222,1513
56757,C0CA4E58B15F58D7F48B8BEF10CEB35A,30854,2,6,4,109.56889,18.27076,1763
56758,C0CA4E58B15F58D7F48B8BEF10CEB35A,60631,6,8,2,109.57778,18.27583,1814
56759,C0CA4E58B15F58D7F48B8BEF10CEB35A,30854,9,10,1,109.56889,18.27076,1763
56777,7BF65E5054DA81A230AB5423620158E1,60631,0,7,7,109.57778,18.27583,1814
56778,7BF65E5054DA81A230AB5423620158E1,30854,8,19,11,109.56889,18.27076,1763
56779,7BF65E5054DA81A230AB5423620158E1,60631,20,23,3,109.57778,18.27583,1814
56783,E92442C28CB44C67B1AFA3BE5AC81485,31861,0,8,8,109.49042,18.27549,1464
56784,E92442C28CB44C67B1AFA3BE5AC81485,31471,9,11,2,109.34583,18.29563,917
56785,E92442C28CB44C67B1AFA3BE5AC81485,31145,12,14,2,109.20431,18.30479,369
56812,D1A5E6081E70F748BFD3C6895B141C01,30661,2,6,4,109.37028,18.24361,1008
56813,D1A5E6081E70F748BFD3C6895B141C01,60411,6,7,1,109.32514,18.30854,869
56814,D1A5E6081E70F748BFD3C6895B141C01,30661,8,10,2,109.37028,18.24361,1008
56815,D1A5E6081E70F748BFD3C6895B141C01,60411,12,16,4,109.32514,18.30854,869
56816,D1A5E6081E70F748BFD3C6895B141C01,30661,17,19,2,109.37028,18.24361,1008
56817,D1A5E6081E70F748BFD3C6895B141C01,30241,19,20,1,109.26174,18.3275,622
56818,D1A5E6081E70F748BFD3C6895B141C01,30661,21,22,1,109.37028,18.24361,1008
56835,53B443662130EB5C95A209BD2C82316A,31351,0,10,10,109.4959,18.28417,1465
56836,53B443662130EB5C95A209BD2C82316A,31201,11,13,2,109.51042,18.23819,1558
56837,53B443662130EB5C95A209BD2C82316A,30741,16,17,1,109.49833,18.28681,1516
56838,53B443662130EB5C95A209BD2C82316A,31701,19,20,1,109.44132,18.28833,1266
56839,A99D0259FFF60076BAC532F5435B4CD8,31521,0,20,20,109.51458,18.22542,1555
56840,A99D0259FFF60076BAC532F5435B4CD8,60381,20,23,3,109.5241,18.22458,1605
56854,CFA93479DB4AE060A01F399350848C9C,31471,13,14,1,109.34583,18.29563,917
56855,CFA93479DB4AE060A01F399350848C9C,31081,18,19,1,109.44639,18.30181,1318
56856,CFA93479DB4AE060A01F399350848C9C,30671,20,23,3,109.43611,18.30139,1268
56857,A412B863FD18FF008395045517EEAEF4,30681,0,4,4,109.48493,18.26917,1463
56858,A412B863FD18FF008395045517EEAEF4,30201,4,9,5,109.4909,18.26465,1462
56859,A412B863FD18FF008395045517EEAEF4,30171,12,15,3,109.48458,18.27139,1463
56884,29D55E311FBB827A581F4801593055E3,31145,12,14,2,109.20431,18.30479,369
56885,29D55E311FBB827A581F4801593055E3,60381,15,16,1,109.5241,18.22458,1605
56886,29D55E311FBB827A581F4801593055E3,31521,17,19,2,109.51458,18.22542,1555
56887,29D55E311FBB827A581F4801593055E3,60381,21,23,2,109.5241,18.22458,1605
56896,E9CDFE5A4E319AABCB1BB5066094528A,38325,0,4,4,109.39792,18.2909,1116
56897,E9CDFE5A4E319AABCB1BB5066094528A,38251,8,9,1,109.49618,18.25493,1510
56920,4620253064DC63F203FE01AA69A2C318,31071,2,7,5,109.58257,18.28458,1815
56921,4620253064DC63F203FE01AA69A2C318,30854,8,10,2,109.56889,18.27076,1763
56922,4620253064DC63F203FE01AA69A2C318,31071,14,15,1,109.58257,18.28458,1815
56923,4620253064DC63F203FE01AA69A2C318,30854,19,20,1,109.56889,18.27076,1763
56924,4620253064DC63F203FE01AA69A2C318,31071,21,23,2,109.58257,18.28458,1815
56941,6C20D2414CF9A0F17DA8E3BEC5FF1F39,38951,0,8,8,109.48097,18.28868,1416
56942,6C20D2414CF9A0F17DA8E3BEC5FF1F39,30971,8,13,5,109.48708,18.29319,1467
56943,6C20D2414CF9A0F17DA8E3BEC5FF1F39,38951,13,18,5,109.48097,18.28868,1416
56964,2E5CD5354D68AAA8E89573B276E5DD63,38154,0,16,16,109.5266,18.28278,1615
56965,2E5CD5354D68AAA8E89573B276E5DD63,60281,17,18,1,109.51743,18.25924,1561
56966,2E5CD5354D68AAA8E89573B276E5DD63,38154,21,23,2,109.5266,18.28278,1615
56986,D26DFF9CD872B22A8694735583552102,30201,0,6,6,109.4909,18.26465,1462
56987,D26DFF9CD872B22A8694735583552102,30421,6,9,3,109.50021,18.25861,1511
56988,D26DFF9CD872B22A8694735583552102,30191,9,10,1,109.50361,18.22701,1506
56989,D26DFF9CD872B22A8694735583552102,31473,13,16,3,109.34792,18.29465,917
56990,D26DFF9CD872B22A8694735583552102,30201,18,23,5,109.4909,18.26465,1462
57005,2115670ECBCEFE4CA16C55F5204DF607,30854,1,2,1,109.56889,18.27076,1763
57006,2115670ECBCEFE4CA16C55F5204DF607,31071,4,6,2,109.58257,18.28458,1815
57007,2115670ECBCEFE4CA16C55F5204DF607,60631,6,7,1,109.57778,18.27583,1814
57033,13BAA3236560B028172DAA5EDFE7A1EF,38141,0,9,9,109.39479,18.2916,1116
57034,13BAA3236560B028172DAA5EDFE7A1EF,38315,10,11,1,109.48979,18.29764,1467
57043,A46BA306DAEA889FAC7ACE9E5FD6A1FF,30911,0,2,2,109.50493,18.26181,1511
57044,A46BA306DAEA889FAC7ACE9E5FD6A1FF,39154,3,6,3,109.50201,18.25681,1511
57045,A46BA306DAEA889FAC7ACE9E5FD6A1FF,30081,6,12,6,109.50243,18.26632,1512
57046,A46BA306DAEA889FAC7ACE9E5FD6A1FF,31391,16,18,2,109.50382,18.24285,1508
57047,A46BA306DAEA889FAC7ACE9E5FD6A1FF,60331,19,23,4,109.505,18.26507,1512
57059,E649CF84A26278291AA1A5B5C5D01FCA,38013,12,13,1,109.49514,18.21951,1454
57060,E649CF84A26278291AA1A5B5C5D01FCA,30161,16,18,2,109.50042,18.24389,1508
57061,E649CF84A26278291AA1A5B5C5D01FCA,30161,20,21,1,109.50042,18.24389,1508
57066,6C44DD6A334FD8F5ED58CBD00D571465,39111,0,7,7,109.5191,18.22597,1555
57067,6C44DD6A334FD8F5ED58CBD00D571465,31521,8,10,2,109.51458,18.22542,1555
57068,6C44DD6A334FD8F5ED58CBD00D571465,30241,12,14,2,109.26174,18.3275,622
57084,C6C3BC01E542B810EF853FEEB6C81198,60361,0,15,15,109.51938,18.29681,1567
57085,C6C3BC01E542B810EF853FEEB6C81198,31561,20,22,2,109.56792,18.28479,1765
57109,B84B247FA61A8C12DFCCCF3C2D72006D,31071,15,16,1,109.58257,18.28458,1815
57110,B84B247FA61A8C12DFCCCF3C2D72006D,30854,17,19,2,109.56889,18.27076,1763
57111,B84B247FA61A8C12DFCCCF3C2D72006D,31071,19,21,2,109.58257,18.28458,1815
57136,6C0260646767B781577B5B8CE2471E51,38484,0,2,2,109.53028,18.31528,1620
57137,6C0260646767B781577B5B8CE2471E51,38241,3,5,2,109.54111,18.30542,1669
57138,6C0260646767B781577B5B8CE2471E51,38484,7,8,1,109.53028,18.31528,1620
57139,6C0260646767B781577B5B8CE2471E51,30561,10,19,9,109.52778,18.31938,1621
57140,6C0260646767B781577B5B8CE2471E51,60551,19,20,1,109.42722,18.30111,1218
57141,6C0260646767B781577B5B8CE2471E51,38484,21,22,1,109.53028,18.31528,1620
57181,CCDAE1D93142B496C062FB4F9D78FBDF,31931,14,16,2,109.54771,18.29403,1667
57182,CCDAE1D93142B496C062FB4F9D78FBDF,31031,18,19,1,109.49979,18.25382,1510
57183,CCDAE1D93142B496C062FB4F9D78FBDF,31345,19,21,2,109.39,18.29,1066
57184,CCDAE1D93142B496C062FB4F9D78FBDF,30661,22,23,1,109.37028,18.24361,1008
57228,7D7F0272C9EBC060D193BEFCF3336FD2,60551,0,8,8,109.42722,18.30111,1218
57229,7D7F0272C9EBC060D193BEFCF3336FD2,38325,10,13,3,109.39792,18.2909,1116
57235,63B5E489F3503F8EC6E40A38F9D2117C,60171,9,15,6,109.51292,18.30694,1569
57236,63B5E489F3503F8EC6E40A38F9D2117C,31031,19,20,1,109.49979,18.25382,1510
57262,E5B8920F3E3691BAA92FB7B056CFD690,31345,0,11,11,109.39,18.29,1066
57291,E8E23C329BD7B13F35CAF563AB694008,38145,0,6,6,109.378,18.2912,1066
57292,E8E23C329BD7B13F35CAF563AB694008,31781,9,10,1,109.19847,18.2975,367
57293,E8E23C329BD7B13F35CAF563AB694008,60054,12,14,2,109.3016,18.31229,770
57294,E8E23C329BD7B13F35CAF563AB694008,60551,19,20,1,109.42722,18.30111,1218
57300,CFFDD1BF3134B9FDD71614F40E1DE0FD,30854,5,6,1,109.56889,18.27076,1763
57301,CFFDD1BF3134B9FDD71614F40E1DE0FD,31071,7,23,16,109.58257,18.28458,1815
57302,14CF7292716F53E42F641F6D8A9AE1BB,31071,0,7,7,109.58257,18.28458,1815
57303,14CF7292716F53E42F641F6D8A9AE1BB,30854,8,11,3,109.56889,18.27076,1763
57304,14CF7292716F53E42F641F6D8A9AE1BB,31071,12,14,2,109.58257,18.28458,1815
57305,14CF7292716F53E42F641F6D8A9AE1BB,30854,18,19,1,109.56889,18.27076,1763
57306,14CF7292716F53E42F641F6D8A9AE1BB,31071,19,23,4,109.58257,18.28458,1815
57324,8AABF5FDF2B06EB445749240A3894969,31071,1,5,4,109.58257,18.28458,1815
57325,8AABF5FDF2B06EB445749240A3894969,30854,6,12,6,109.56889,18.27076,1763
57331,6CBD210FE212796CEDBD8FF4BC0A58A4,39183,0,5,5,109.55542,18.28208,1715
57332,6CBD210FE212796CEDBD8FF4BC0A58A4,31931,8,11,3,109.54771,18.29403,1667
57333,6CBD210FE212796CEDBD8FF4BC0A58A4,39183,13,14,1,109.55542,18.28208,1715
57334,6CBD210FE212796CEDBD8FF4BC0A58A4,31931,14,18,4,109.54771,18.29403,1667
57335,6CBD210FE212796CEDBD8FF4BC0A58A4,39183,19,23,4,109.55542,18.28208,1715
57379,1EC959553638CEC3C2D1606E92235CDE,30854,5,18,13,109.56889,18.27076,1763
57380,1EC959553638CEC3C2D1606E92235CDE,60551,18,19,1,109.42722,18.30111,1218
57381,1EC959553638CEC3C2D1606E92235CDE,30854,20,21,1,109.56889,18.27076,1763
57382,FE95B3A32EFBC2838F293DF38F55FDD1,39183,0,4,4,109.55542,18.28208,1715
57383,FE95B3A32EFBC2838F293DF38F55FDD1,31931,7,8,1,109.54771,18.29403,1667
57384,FE95B3A32EFBC2838F293DF38F55FDD1,31561,9,10,1,109.56792,18.28479,1765
57385,FE95B3A32EFBC2838F293DF38F55FDD1,39183,10,11,1,109.55542,18.28208,1715
57386,FE95B3A32EFBC2838F293DF38F55FDD1,31931,12,13,1,109.54771,18.29403,1667
57387,FE95B3A32EFBC2838F293DF38F55FDD1,31561,15,16,1,109.56792,18.28479,1765
57388,FE95B3A32EFBC2838F293DF38F55FDD1,39183,20,22,2,109.55542,18.28208,1715
57393,A515C2BA2B0AE21CADC42FF4E7FC0007,39181,0,6,6,109.55153,18.28035,1715
57394,A515C2BA2B0AE21CADC42FF4E7FC0007,31931,7,8,1,109.54771,18.29403,1667
57395,A515C2BA2B0AE21CADC42FF4E7FC0007,39181,11,13,2,109.55153,18.28035,1715
57396,A515C2BA2B0AE21CADC42FF4E7FC0007,31931,13,14,1,109.54771,18.29403,1667
57397,A515C2BA2B0AE21CADC42FF4E7FC0007,39181,18,23,5,109.55153,18.28035,1715
57403,0C12679B52C25C8A094B9B69D277B0C8,31071,0,6,6,109.58257,18.28458,1815
57404,0C12679B52C25C8A094B9B69D277B0C8,31561,8,9,1,109.56792,18.28479,1765
57405,0C12679B52C25C8A094B9B69D277B0C8,31071,12,23,11,109.58257,18.28458,1815
57423,01320058954DC2695E406EF39999A80E,30711,14,18,4,109.50271,18.25347,1510
57424,01320058954DC2695E406EF39999A80E,31031,20,21,1,109.49979,18.25382,1510
57462,CA373FFAFD7EFAD5EEFC32965095EB00,60201,0,10,10,109.5041,18.2509,1510
57463,CA373FFAFD7EFAD5EEFC32965095EB00,39151,11,13,2,109.49875,18.25097,1510
57464,CA373FFAFD7EFAD5EEFC32965095EB00,30531,14,17,3,109.53271,18.21472,1604
57465,CA373FFAFD7EFAD5EEFC32965095EB00,60381,18,19,1,109.5241,18.22458,1605
57466,CA373FFAFD7EFAD5EEFC32965095EB00,30531,20,22,2,109.53271,18.21472,1604
57478,51ED683608E55A4EDEADC423E7C7B6C3,60631,0,15,15,109.57778,18.27583,1814
57479,51ED683608E55A4EDEADC423E7C7B6C3,30854,15,16,1,109.56889,18.27076,1763
57485,EBB8C4DC19F3856E93F775E3331F31B3,31201,9,13,4,109.51042,18.23819,1558
57486,EBB8C4DC19F3856E93F775E3331F31B3,60331,13,17,4,109.505,18.26507,1512
57487,EBB8C4DC19F3856E93F775E3331F31B3,38291,20,21,1,109.51618,18.24313,1558
57488,EBB8C4DC19F3856E93F775E3331F31B3,30181,21,23,2,109.51597,18.23313,1557
57510,30CE72A519D49881F23B8123486E3A02,60411,13,15,2,109.32514,18.30854,869
57511,30CE72A519D49881F23B8123486E3A02,31471,18,19,1,109.34583,18.29563,917
57512,30CE72A519D49881F23B8123486E3A02,60411,20,22,2,109.32514,18.30854,869
57529,2E380E8B6DE6DF345E034CB99A0DCDD4,38951,1,8,7,109.48097,18.28868,1416
57530,2E380E8B6DE6DF345E034CB99A0DCDD4,30971,9,10,1,109.48708,18.29319,1467
57531,2E380E8B6DE6DF345E034CB99A0DCDD4,38951,11,13,2,109.48097,18.28868,1416
57532,2E380E8B6DE6DF345E034CB99A0DCDD4,31031,14,15,1,109.49979,18.25382,1510
57533,2E380E8B6DE6DF345E034CB99A0DCDD4,30971,16,17,1,109.48708,18.29319,1467
57534,2E380E8B6DE6DF345E034CB99A0DCDD4,38951,18,23,5,109.48097,18.28868,1416
57543,5F14E1A15EFA1C13F8B10CBC543F107C,31701,0,10,10,109.44132,18.28833,1266
57577,9A1D1AA5EE2CD156CC396C667ED8C5B9,31071,2,8,6,109.58257,18.28458,1815
57578,9A1D1AA5EE2CD156CC396C667ED8C5B9,31145,12,13,1,109.20431,18.30479,369
57579,9A1D1AA5EE2CD156CC396C667ED8C5B9,30854,16,17,1,109.56889,18.27076,1763
57580,9A1D1AA5EE2CD156CC396C667ED8C5B9,38754,19,20,1,109.74667,18.37382,2430
57581,9A1D1AA5EE2CD156CC396C667ED8C5B9,31071,21,23,2,109.58257,18.28458,1815
57601,CCCCDA317D5974DB71F84A09BF6FE491,30171,1,9,8,109.48458,18.27139,1463
57602,CCCCDA317D5974DB71F84A09BF6FE491,60231,13,14,1,109.49903,18.21972,1504
57603,CCCCDA317D5974DB71F84A09BF6FE491,60311,17,19,2,109.52097,18.24319,1558
57604,CCCCDA317D5974DB71F84A09BF6FE491,30171,22,23,1,109.48458,18.27139,1463
57644,408C4FED868686E7B96333835F4C4205,31071,0,20,20,109.58257,18.28458,1815
57645,408C4FED868686E7B96333835F4C4205,31031,21,22,1,109.49979,18.25382,1510
57677,6FEF3B8DB206443C925B112D4BEDB705,31471,12,13,1,109.34583,18.29563,917
57680,01661942FCE90AF8E243ED68E3EDED24,60221,19,20,1,109.52569,18.29188,1616
57681,01661942FCE90AF8E243ED68E3EDED24,60381,22,23,1,109.5241,18.22458,1605
57686,3F15A4F5D7468DD83DEF8F2C7F2C36E7,31171,0,11,11,109.50938,18.24917,1559
57687,3F15A4F5D7468DD83DEF8F2C7F2C36E7,60054,13,14,1,109.3016,18.31229,770
57688,3F15A4F5D7468DD83DEF8F2C7F2C36E7,30711,17,19,2,109.50271,18.25347,1510
57689,3F15A4F5D7468DD83DEF8F2C7F2C36E7,31821,20,23,3,109.51181,18.24924,1559
57726,B03EB6B394C6FA523E27D03BBB015313,30211,0,1,1,109.49882,18.23931,1508
57727,B03EB6B394C6FA523E27D03BBB015313,39154,1,8,7,109.50201,18.25681,1511
57728,B03EB6B394C6FA523E27D03BBB015313,31041,8,11,3,109.50278,18.23701,1507
57729,B03EB6B394C6FA523E27D03BBB015313,39154,11,13,2,109.50201,18.25681,1511
57775,D56A67341D1DA856D04BC2181FD404FB,30351,1,7,6,109.41701,18.29292,1217
57776,D56A67341D1DA856D04BC2181FD404FB,60541,8,9,1,109.4084,18.29208,1167
57777,D56A67341D1DA856D04BC2181FD404FB,60552,11,12,1,109.41729,18.30014,1218
57778,D56A67341D1DA856D04BC2181FD404FB,60541,12,15,3,109.4084,18.29208,1167
57779,D56A67341D1DA856D04BC2181FD404FB,60552,17,19,2,109.41729,18.30014,1218
57780,D56A67341D1DA856D04BC2181FD404FB,60541,20,22,2,109.4084,18.29208,1167
57799,8EE232244A6B7B45E2A0712998285336,60291,0,5,5,109.50826,18.24639,1509
57800,8EE232244A6B7B45E2A0712998285336,31521,5,6,1,109.51458,18.22542,1555
57801,8EE232244A6B7B45E2A0712998285336,31781,9,12,3,109.19847,18.2975,367
57802,8EE232244A6B7B45E2A0712998285336,31471,14,15,1,109.34583,18.29563,917
57803,8EE232244A6B7B45E2A0712998285336,31521,19,22,3,109.51458,18.22542,1555
57806,AEA7DA64082D7A925B68DE7CFFD60270,30891,3,6,3,109.59431,18.28389,1865
57807,AEA7DA64082D7A925B68DE7CFFD60270,30854,10,21,11,109.56889,18.27076,1763
57811,85A7453C1FEF050DA02F4B93676DDB91,31061,15,17,2,109.53333,18.23257,1607
57814,92AA74C025DCC8E1B6F69E40B85D2713,60111,0,12,12,109.72556,18.31924,2371
57851,1BCCA6A55B141322D673AB5FC569497E,30201,0,1,1,109.4909,18.26465,1462
57852,1BCCA6A55B141322D673AB5FC569497E,38017,2,3,1,109.49729,18.21424,1504
57853,1BCCA6A55B141322D673AB5FC569497E,30421,4,14,10,109.50021,18.25861,1511
57854,1BCCA6A55B141322D673AB5FC569497E,30911,15,17,2,109.50493,18.26181,1511
57855,1BCCA6A55B141322D673AB5FC569497E,31861,20,23,3,109.49042,18.27549,1464
57858,E4C7AB656E412C7E33554D18277C9478,30151,12,13,1,109.50986,18.25083,1560
57859,E4C7AB656E412C7E33554D18277C9478,60201,17,18,1,109.5041,18.2509,1510
57860,E4C7AB656E412C7E33554D18277C9478,30854,18,21,3,109.56889,18.27076,1763
57918,1C1DA7B8AAE0554EF7DCF4492C7D5937,39321,0,8,8,109.529,18.2167,1604
57919,1C1DA7B8AAE0554EF7DCF4492C7D5937,38111,12,13,1,109.52007,18.22403,1555
57920,1C1DA7B8AAE0554EF7DCF4492C7D5937,39321,16,17,1,109.529,18.2167,1604
57921,1C1DA7B8AAE0554EF7DCF4492C7D5937,60381,19,20,1,109.5241,18.22458,1605
57922,1C1DA7B8AAE0554EF7DCF4492C7D5937,39321,20,22,2,109.529,18.2167,1604
57941,F82B3BBB77C5FF41C0BBD473F847E370,30891,2,4,2,109.59431,18.28389,1865
57942,F82B3BBB77C5FF41C0BBD473F847E370,30854,6,10,4,109.56889,18.27076,1763
57943,F82B3BBB77C5FF41C0BBD473F847E370,39183,13,21,8,109.55542,18.28208,1715
57961,4C809D576F7E163EA2BDA6D9D176F0A1,39151,16,18,2,109.49875,18.25097,1510
57983,7F632B4875B2736225CD6D350CD25670,30854,7,12,5,109.56889,18.27076,1763
57984,7F632B4875B2736225CD6D350CD25670,31071,12,13,1,109.58257,18.28458,1815
57985,7F632B4875B2736225CD6D350CD25670,30854,13,21,8,109.56889,18.27076,1763
58008,1B6EBBFF3B9D8A3E18753343B6A29EAE,31071,0,13,13,109.58257,18.28458,1815
58009,1B6EBBFF3B9D8A3E18753343B6A29EAE,30851,16,17,1,109.5616,18.27396,1713
58010,1B6EBBFF3B9D8A3E18753343B6A29EAE,31071,20,23,3,109.58257,18.28458,1815
58031,3BF3A82A70A93B4B71D52AA73CE29D00,39151,18,20,2,109.49875,18.25097,1510
58032,3BF3A82A70A93B4B71D52AA73CE29D00,60401,21,23,2,109.47444,18.27583,1414
58047,59F29435D748531F416A4F1636997ECF,31071,1,8,7,109.58257,18.28458,1815
58048,59F29435D748531F416A4F1636997ECF,30854,12,23,11,109.56889,18.27076,1763
58049,68DBE0B52FD0AB95F1DD47068FD7847F,60311,0,1,1,109.52097,18.24319,1558
58050,68DBE0B52FD0AB95F1DD47068FD7847F,38911,2,7,5,109.51674,18.24965,1559
58051,68DBE0B52FD0AB95F1DD47068FD7847F,60311,7,8,1,109.52097,18.24319,1558
58052,68DBE0B52FD0AB95F1DD47068FD7847F,30181,8,12,4,109.51597,18.23313,1557
58053,68DBE0B52FD0AB95F1DD47068FD7847F,38291,12,15,3,109.51618,18.24313,1558
58054,68DBE0B52FD0AB95F1DD47068FD7847F,30181,16,17,1,109.51597,18.23313,1557
58055,68DBE0B52FD0AB95F1DD47068FD7847F,30161,18,21,3,109.50042,18.24389,1508
58058,D88AE248BE01D22E4DE2A4B556E71166,38951,1,10,9,109.48097,18.28868,1416
58059,D88AE248BE01D22E4DE2A4B556E71166,30971,11,12,1,109.48708,18.29319,1467
58060,D88AE248BE01D22E4DE2A4B556E71166,38951,15,19,4,109.48097,18.28868,1416
58061,D88AE248BE01D22E4DE2A4B556E71166,60524,19,20,1,109.42951,18.28993,1216
58145,DECB7B3FC95BFA8620EFD8D9DE328252,30854,13,14,1,109.56889,18.27076,1763
58146,DECB7B3FC95BFA8620EFD8D9DE328252,31945,15,16,1,109.58021,18.29403,1817
58147,DECB7B3FC95BFA8620EFD8D9DE328252,30854,19,23,4,109.56889,18.27076,1763
58174,172CB232BBE684655CFBDFD055BB1CB5,30241,16,18,2,109.26174,18.3275,622
58175,172CB232BBE684655CFBDFD055BB1CB5,30771,21,23,2,109.49938,18.26042,1511
58191,CF1922E57BC1E2D5DC4336E820C48B77,60411,3,7,4,109.32514,18.30854,869
58192,CF1922E57BC1E2D5DC4336E820C48B77,30661,8,12,4,109.37028,18.24361,1008
58193,CF1922E57BC1E2D5DC4336E820C48B77,60411,12,23,11,109.32514,18.30854,869
58239,5D5B29A994BBA3635D38463A75BE58F6,30201,0,14,14,109.4909,18.26465,1462
58240,5D5B29A994BBA3635D38463A75BE58F6,30421,18,20,2,109.50021,18.25861,1511
58306,8CA8213586CAC00347DCD29330308F27,31931,12,13,1,109.54771,18.29403,1667
58307,8CA8213586CAC00347DCD29330308F27,30921,15,16,1,109.53903,18.29451,1667
58325,90D91A493F9482486DCC3B27CF3F61EE,30854,6,7,1,109.56889,18.27076,1763
58326,90D91A493F9482486DCC3B27CF3F61EE,31071,8,16,8,109.58257,18.28458,1815
58327,90D91A493F9482486DCC3B27CF3F61EE,30854,18,19,1,109.56889,18.27076,1763
58354,9BD095517798346F169AD6D898CA1A42,60361,0,6,6,109.51938,18.29681,1567
58355,9BD095517798346F169AD6D898CA1A42,60221,9,10,1,109.52569,18.29188,1616
58356,9BD095517798346F169AD6D898CA1A42,60361,12,14,2,109.51938,18.29681,1567
58357,9BD095517798346F169AD6D898CA1A42,30321,15,16,1,109.49563,18.29611,1467
58358,9BD095517798346F169AD6D898CA1A42,60361,19,23,4,109.51938,18.29681,1567
58389,7171A8398911756415ECFCDCF96F249B,30121,0,6,6,109.52861,18.27222,1613
58390,7171A8398911756415ECFCDCF96F249B,30951,9,10,1,109.56208,18.25667,1761
58391,7171A8398911756415ECFCDCF96F249B,30851,11,23,12,109.5616,18.27396,1713
58392,3720DDB8E91BF73FF05637BA50F0661B,31521,0,7,7,109.51458,18.22542,1555
58393,3720DDB8E91BF73FF05637BA50F0661B,60054,11,13,2,109.3016,18.31229,770
58394,3720DDB8E91BF73FF05637BA50F0661B,30361,15,17,2,109.50347,18.24,1508
58395,3720DDB8E91BF73FF05637BA50F0661B,30511,17,18,1,109.51069,18.24208,1558
58396,3720DDB8E91BF73FF05637BA50F0661B,31521,18,20,2,109.51458,18.22542,1555
58397,3720DDB8E91BF73FF05637BA50F0661B,30511,20,23,3,109.51069,18.24208,1558
58408,BD5D5103B08534F20AF53FB58E9A43CA,31931,0,6,6,109.54771,18.29403,1667
58409,BD5D5103B08534F20AF53FB58E9A43CA,38241,6,8,2,109.54111,18.30542,1669
58410,BD5D5103B08534F20AF53FB58E9A43CA,31931,8,15,7,109.54771,18.29403,1667
58414,5482E24643B1F6F0530F56448111EE30,31701,0,8,8,109.44132,18.28833,1266
58415,5482E24643B1F6F0530F56448111EE30,60054,12,14,2,109.3016,18.31229,770
58416,5482E24643B1F6F0530F56448111EE30,31701,18,23,5,109.44132,18.28833,1266
58432,080247CC19405F981D4BEFE1A1E9D339,39181,16,18,2,109.55153,18.28035,1715
58433,080247CC19405F981D4BEFE1A1E9D339,31931,19,23,4,109.54771,18.29403,1667
58489,104D50A9C0319F25E132948E6191A1E5,30271,0,1,1,109.49132,18.23153,1456
58490,104D50A9C0319F25E132948E6191A1E5,30211,1,5,4,109.49882,18.23931,1508
58491,104D50A9C0319F25E132948E6191A1E5,60084,7,10,3,109.4984,18.2334,1507
58492,104D50A9C0319F25E132948E6191A1E5,30271,16,18,2,109.49132,18.23153,1456
58493,104D50A9C0319F25E132948E6191A1E5,60161,19,23,4,109.49174,18.26181,1461
58544,B023927CBEC0A8053CBDF64A5B76E367,30571,0,4,4,109.50243,18.21861,1504
58545,B023927CBEC0A8053CBDF64A5B76E367,38017,4,6,2,109.49729,18.21424,1504
58546,B023927CBEC0A8053CBDF64A5B76E367,31931,8,15,7,109.54771,18.29403,1667
58560,9161F8CF9FE399F91F1ACEDE385ADA60,60381,16,18,2,109.5241,18.22458,1605
58561,9161F8CF9FE399F91F1ACEDE385ADA60,60551,21,22,1,109.42722,18.30111,1218
58587,EAD22166B32AC453F1024BFF97D86E27,39111,17,19,2,109.5191,18.22597,1555
58588,EAD22166B32AC453F1024BFF97D86E27,31521,21,23,2,109.51458,18.22542,1555
58628,45FA8AF959A216E06C82392E21728E7F,31071,0,7,7,109.58257,18.28458,1815
58629,45FA8AF959A216E06C82392E21728E7F,31561,8,12,4,109.56792,18.28479,1765
58630,45FA8AF959A216E06C82392E21728E7F,31071,12,13,1,109.58257,18.28458,1815
58633,13104A6A71A054F852B52BB76993ADB2,30851,0,3,3,109.5616,18.27396,1713
58634,13104A6A71A054F852B52BB76993ADB2,30891,6,8,2,109.59431,18.28389,1865
58635,13104A6A71A054F852B52BB76993ADB2,30851,8,19,11,109.5616,18.27396,1713
58636,13104A6A71A054F852B52BB76993ADB2,30854,20,22,2,109.56889,18.27076,1763
58637,4DE71CE1D98B4BE73B9507B19A1BFD20,39081,0,8,8,109.19382,18.29111,366
58660,D4EE8E1A4C04A1FF0596E4221D0B8B42,31071,0,7,7,109.58257,18.28458,1815
58661,D4EE8E1A4C04A1FF0596E4221D0B8B42,30854,8,16,8,109.56889,18.27076,1763
58662,D4EE8E1A4C04A1FF0596E4221D0B8B42,31071,19,20,1,109.58257,18.28458,1815
58663,D4EE8E1A4C04A1FF0596E4221D0B8B42,30854,21,22,1,109.56889,18.27076,1763
58672,7803AECF4FFC2BF233E3B7ACD0D2E9F8,39181,0,6,6,109.55153,18.28035,1715
58673,7803AECF4FFC2BF233E3B7ACD0D2E9F8,31931,7,9,2,109.54771,18.29403,1667
58674,7803AECF4FFC2BF233E3B7ACD0D2E9F8,39181,11,12,1,109.55153,18.28035,1715
58675,7803AECF4FFC2BF233E3B7ACD0D2E9F8,31931,14,15,1,109.54771,18.29403,1667
58676,7803AECF4FFC2BF233E3B7ACD0D2E9F8,39181,16,23,7,109.55153,18.28035,1715
58709,5A888DC7A3AA300CC584D9862C5384A1,60221,0,7,7,109.52569,18.29188,1616
58710,5A888DC7A3AA300CC584D9862C5384A1,39181,9,10,1,109.55153,18.28035,1715
58711,5A888DC7A3AA300CC584D9862C5384A1,39183,12,17,5,109.55542,18.28208,1715
58712,5A888DC7A3AA300CC584D9862C5384A1,60371,18,20,2,109.53063,18.30056,1618
58713,5A888DC7A3AA300CC584D9862C5384A1,60221,20,22,2,109.52569,18.29188,1616
58719,3607565CF2EC562DCF715F1B17219F8A,38911,0,4,4,109.51674,18.24965,1559
58720,3607565CF2EC562DCF715F1B17219F8A,38291,5,16,11,109.51618,18.24313,1558
58721,3607565CF2EC562DCF715F1B17219F8A,60381,19,22,3,109.5241,18.22458,1605
58732,875F4B80762D0E664890361D764F907D,60081,0,7,7,109.51097,18.22639,1556
58733,875F4B80762D0E664890361D764F907D,30571,7,18,11,109.50243,18.21861,1504
58734,875F4B80762D0E664890361D764F907D,60081,19,21,2,109.51097,18.22639,1556
58735,875F4B80762D0E664890361D764F907D,30421,21,23,2,109.50021,18.25861,1511
58780,8CF08DEE8EF83AC7333B837D79034776,30721,0,8,8,109.51597,18.28257,1565
58782,8CF08DEE8EF83AC7333B837D79034776,38121,17,23,6,109.51361,18.27813,1564
58831,283021500C5E323BF3C7B7DFEEB52477,30191,2,4,2,109.50361,18.22701,1506
58832,283021500C5E323BF3C7B7DFEEB52477,60087,5,7,2,109.50688,18.22299,1505
58833,283021500C5E323BF3C7B7DFEEB52477,30191,8,17,9,109.50361,18.22701,1506
58834,283021500C5E323BF3C7B7DFEEB52477,30711,19,20,1,109.50271,18.25347,1510
58835,283021500C5E323BF3C7B7DFEEB52477,30711,20,23,3,109.50271,18.25347,1510
58840,866D2FF3F0433164D173837FCFC2B596,60381,20,22,2,109.5241,18.22458,1605
58841,866D2FF3F0433164D173837FCFC2B596,31521,22,23,1,109.51458,18.22542,1555
58907,80779C982E47128931C5479B9B9DAF80,30421,12,15,3,109.50021,18.25861,1511
58908,80779C982E47128931C5479B9B9DAF80,30421,19,23,4,109.50021,18.25861,1511
58943,D91289410D46E2838A7CD67AF8E32DCF,30191,9,14,5,109.50361,18.22701,1506
58972,98EB4BE9AFE850A2CD3C4284738A450F,30211,2,8,6,109.49882,18.23931,1508
58973,98EB4BE9AFE850A2CD3C4284738A450F,31781,11,13,2,109.19847,18.2975,367
58974,98EB4BE9AFE850A2CD3C4284738A450F,31471,14,15,1,109.34583,18.29563,917
58975,98EB4BE9AFE850A2CD3C4284738A450F,60221,19,20,1,109.52569,18.29188,1616
59042,C358285726113434A30FBBA8DED710E7,60371,0,10,10,109.53063,18.30056,1618
59043,C358285726113434A30FBBA8DED710E7,31621,10,11,1,109.51035,18.29826,1568
59044,C358285726113434A30FBBA8DED710E7,30181,11,13,2,109.51597,18.23313,1557
59045,C358285726113434A30FBBA8DED710E7,30741,14,15,1,109.49833,18.28681,1516
59095,8621CFDF1B89A83351494618C53D033F,39181,10,12,2,109.55153,18.28035,1715
59096,8621CFDF1B89A83351494618C53D033F,39181,13,14,1,109.55153,18.28035,1715
59097,8621CFDF1B89A83351494618C53D033F,31071,14,16,2,109.58257,18.28458,1815
59098,8621CFDF1B89A83351494618C53D033F,39181,16,18,2,109.55153,18.28035,1715
59099,8621CFDF1B89A83351494618C53D033F,31071,18,20,2,109.58257,18.28458,1815
59100,8621CFDF1B89A83351494618C53D033F,39181,20,21,1,109.55153,18.28035,1715
59101,8621CFDF1B89A83351494618C53D033F,31071,21,23,2,109.58257,18.28458,1815
59160,4E0233AEC2496361DA9DC06776993140,31761,0,6,6,109.60521,18.27965,1914
59166,A7B9481C677E747C5C2240237CB64DE4,60361,0,10,10,109.51938,18.29681,1567
59167,A7B9481C677E747C5C2240237CB64DE4,31931,13,15,2,109.54771,18.29403,1667
59168,A7B9481C677E747C5C2240237CB64DE4,60361,17,19,2,109.51938,18.29681,1567
59177,BE7763F8096EB5A037146E1CC4190538,30854,0,11,11,109.56889,18.27076,1763
59178,BE7763F8096EB5A037146E1CC4190538,31561,13,14,1,109.56792,18.28479,1765
59179,BE7763F8096EB5A037146E1CC4190538,30854,14,22,8,109.56889,18.27076,1763
59190,5A1C4533F331B639AE5D3D6E2930E30B,31945,0,7,7,109.58021,18.29403,1817
59191,5A1C4533F331B639AE5D3D6E2930E30B,30854,8,10,2,109.56889,18.27076,1763
59192,5A1C4533F331B639AE5D3D6E2930E30B,60631,13,14,1,109.57778,18.27583,1814
59200,65DCC597AECA35C4AE4D4EA8A3F39D90,31561,0,13,13,109.56792,18.28479,1765
59201,65DCC597AECA35C4AE4D4EA8A3F39D90,39183,15,16,1,109.55542,18.28208,1715
59244,7BADC73A7F08A10826F163710F0B362C,60401,0,10,10,109.47444,18.27583,1414
59245,7BADC73A7F08A10826F163710F0B362C,31031,11,14,3,109.49979,18.25382,1510
59246,7BADC73A7F08A10826F163710F0B362C,30271,18,19,1,109.49132,18.23153,1456
59247,7BADC73A7F08A10826F163710F0B362C,30161,19,20,1,109.50042,18.24389,1508
59248,7BADC73A7F08A10826F163710F0B362C,60401,21,23,2,109.47444,18.27583,1414
59251,6F89FC58525A7C2DD968C6BC975151FB,30731,0,7,7,109.50944,18.22306,1555
59252,6F89FC58525A7C2DD968C6BC975151FB,38315,8,10,2,109.48979,18.29764,1467
59285,E9F64FD67E39C3E2C15C20715338A941,31931,10,15,5,109.54771,18.29403,1667
59286,E9F64FD67E39C3E2C15C20715338A941,39154,17,23,6,109.50201,18.25681,1511
59320,0F7E5E1521F0A13C4E28C5BB6AF12F0A,31421,3,4,1,109.55382,18.22347,1705
59321,0F7E5E1521F0A13C4E28C5BB6AF12F0A,30951,5,6,1,109.56208,18.25667,1761
59322,0F7E5E1521F0A13C4E28C5BB6AF12F0A,31421,7,11,4,109.55382,18.22347,1705
59323,0F7E5E1521F0A13C4E28C5BB6AF12F0A,30951,14,15,1,109.56208,18.25667,1761
59324,0F7E5E1521F0A13C4E28C5BB6AF12F0A,31421,16,17,1,109.55382,18.22347,1705
59325,0F7E5E1521F0A13C4E28C5BB6AF12F0A,30951,18,20,2,109.56208,18.25667,1761
59326,0F7E5E1521F0A13C4E28C5BB6AF12F0A,31421,21,22,1,109.55382,18.22347,1705
59365,EB316856896788EC8FD871E122E95728,30701,2,3,1,109.59313,18.32007,1871
59366,EB316856896788EC8FD871E122E95728,30931,5,6,1,109.55653,18.32722,1722
59367,EB316856896788EC8FD871E122E95728,31811,7,11,4,109.54201,18.31806,1671
59368,EB316856896788EC8FD871E122E95728,30701,12,14,2,109.59313,18.32007,1871
59369,EB316856896788EC8FD871E122E95728,31811,14,17,3,109.54201,18.31806,1671
59370,EB316856896788EC8FD871E122E95728,30701,21,23,2,109.59313,18.32007,1871
59415,971FAC974FC919EB70A5D4943C3307C0,60594,0,7,7,109.62694,18.22799,1956
59416,971FAC974FC919EB70A5D4943C3307C0,38052,8,10,2,109.62618,18.23042,1956
59417,971FAC974FC919EB70A5D4943C3307C0,60594,11,12,1,109.62694,18.22799,1956
59418,971FAC974FC919EB70A5D4943C3307C0,38052,16,19,3,109.62618,18.23042,1956
59440,CD3BCBAB8571FB81953C842A434E5DB8,31071,0,5,5,109.58257,18.28458,1815
59441,CD3BCBAB8571FB81953C842A434E5DB8,30854,6,12,6,109.56889,18.27076,1763
59517,FB16AA24AD94D8CC7E1110E44BD68910,60631,0,14,14,109.57778,18.27583,1814
59518,FB16AA24AD94D8CC7E1110E44BD68910,30854,16,19,3,109.56889,18.27076,1763
59519,FB16AA24AD94D8CC7E1110E44BD68910,31945,19,21,2,109.58021,18.29403,1817
59541,D5ED0B56415F07DD214B0DC3E9293672,38171,19,20,1,109.50799,18.28139,1515
59542,D5ED0B56415F07DD214B0DC3E9293672,30854,21,23,2,109.56889,18.27076,1763
59547,2DDF3A993BD69F79020EB97CF3A71819,38171,0,6,6,109.50799,18.28139,1515
59548,2DDF3A993BD69F79020EB97CF3A71819,30161,7,8,1,109.50042,18.24389,1508
59549,2DDF3A993BD69F79020EB97CF3A71819,30161,10,20,10,109.50042,18.24389,1508
59550,2DDF3A993BD69F79020EB97CF3A71819,30161,21,23,2,109.50042,18.24389,1508
59573,706B8E0F0F5D1C9FC2F8EBB2574EE89F,30711,0,17,17,109.50271,18.25347,1510
59574,706B8E0F0F5D1C9FC2F8EBB2574EE89F,30711,19,22,3,109.50271,18.25347,1510
59578,D8898064D7FB8C9B8CE800B6EE2F87B6,30232,0,6,6,109.6191,18.31701,1971
59579,D8898064D7FB8C9B8CE800B6EE2F87B6,30854,8,18,10,109.56889,18.27076,1763
59580,D8898064D7FB8C9B8CE800B6EE2F87B6,30232,21,23,2,109.6191,18.31701,1971
59591,EBD16061EA20EE33D9344D33735E5205,38291,0,9,9,109.51618,18.24313,1558
59592,EBD16061EA20EE33D9344D33735E5205,38291,10,11,1,109.51618,18.24313,1558
59593,EBD16061EA20EE33D9344D33735E5205,31201,12,13,1,109.51042,18.23819,1558
59594,EBD16061EA20EE33D9344D33735E5205,31261,14,16,2,109.51174,18.2466,1559
59595,7CEC70539F74ECB5A75A4999FD1AE35E,31864,1,7,6,109.49014,18.28333,1465
59596,7CEC70539F74ECB5A75A4999FD1AE35E,30341,12,13,1,109.3625,18.29167,966
59597,7CEC70539F74ECB5A75A4999FD1AE35E,60054,14,15,1,109.3016,18.31229,770
59598,7CEC70539F74ECB5A75A4999FD1AE35E,60381,18,19,1,109.5241,18.22458,1605
59599,7CEC70539F74ECB5A75A4999FD1AE35E,31864,20,23,3,109.49014,18.28333,1465
59605,34A1BA5A97F90C4ABB34EDC7004774A9,30951,0,8,8,109.56208,18.25667,1761
59606,34A1BA5A97F90C4ABB34EDC7004774A9,30851,9,18,9,109.5616,18.27396,1713
59607,3C6B416FA80A7A03E14FC0317D60CB00,30854,7,9,2,109.56889,18.27076,1763
59608,3C6B416FA80A7A03E14FC0317D60CB00,60631,10,11,1,109.57778,18.27583,1814
59609,3C6B416FA80A7A03E14FC0317D60CB00,30854,11,23,12,109.56889,18.27076,1763
59628,B164B8C0AEC0E295C9ED3DBE75B5D547,30084,0,7,7,109.50118,18.26972,1513
59629,B164B8C0AEC0E295C9ED3DBE75B5D547,31851,9,10,1,109.71736,18.29007,2316
59630,B164B8C0AEC0E295C9ED3DBE75B5D547,38871,13,16,3,109.44681,18.28625,1316
59701,2F440A235E684ECEDD042B3100A4AE95,30031,12,13,1,109.53681,18.33313,1673
59702,2F440A235E684ECEDD042B3100A4AE95,30854,17,18,1,109.56889,18.27076,1763
59703,2F440A235E684ECEDD042B3100A4AE95,31071,18,20,2,109.58257,18.28458,1815
59704,2F440A235E684ECEDD042B3100A4AE95,30251,21,23,2,109.50611,18.26653,1512
59712,0547C7536E43628EF24935F0C2BF5E2C,30921,0,6,6,109.53903,18.29451,1667
59713,0547C7536E43628EF24935F0C2BF5E2C,31931,8,11,3,109.54771,18.29403,1667
59714,0547C7536E43628EF24935F0C2BF5E2C,30921,15,18,3,109.53903,18.29451,1667
59715,0547C7536E43628EF24935F0C2BF5E2C,60241,20,21,1,109.53319,18.28667,1616
59748,F3EA7BB85A440E2BE2D597787EA5279B,60235,0,2,2,109.49269,18.2253,1455
59749,F3EA7BB85A440E2BE2D597787EA5279B,38834,5,7,2,109.47639,18.21146,1403
59750,F3EA7BB85A440E2BE2D597787EA5279B,30051,7,23,16,109.48917,18.21215,1453
59751,5EBEA276FCB4A19AC5C987F5C7CC8908,60504,3,6,3,109.47917,18.28903,1416
59752,5EBEA276FCB4A19AC5C987F5C7CC8908,60472,6,8,2,109.46625,18.29542,1367
59753,5EBEA276FCB4A19AC5C987F5C7CC8908,38361,9,11,2,109.43667,18.29201,1267
59754,5EBEA276FCB4A19AC5C987F5C7CC8908,60504,13,16,3,109.47917,18.28903,1416
59755,5EBEA276FCB4A19AC5C987F5C7CC8908,38361,18,20,2,109.43667,18.29201,1267
59756,5EBEA276FCB4A19AC5C987F5C7CC8908,60552,20,23,3,109.41729,18.30014,1218
59757,54036114D002A873652B2123255670F7,60041,0,1,1,109.39889,18.31944,1121
59758,54036114D002A873652B2123255670F7,31321,3,18,15,109.63799,18.23201,2007
59759,54036114D002A873652B2123255670F7,30511,22,23,1,109.51069,18.24208,1558
59779,7B1A07C39637E996C01DF0A3D287D3C6,30854,0,6,6,109.56889,18.27076,1763
59780,7B1A07C39637E996C01DF0A3D287D3C6,31561,7,8,1,109.56792,18.28479,1765
59781,7B1A07C39637E996C01DF0A3D287D3C6,30854,9,15,6,109.56889,18.27076,1763
59782,45086BC0869D90A8E8F669EDA6561CFA,31071,0,14,14,109.58257,18.28458,1815
59783,45086BC0869D90A8E8F669EDA6561CFA,30581,15,16,1,109.62257,18.24951,1959
59784,45086BC0869D90A8E8F669EDA6561CFA,30281,18,21,3,109.50597,18.27583,1514
59785,45086BC0869D90A8E8F669EDA6561CFA,31071,22,23,1,109.58257,18.28458,1815
59786,DB4DF566D4757FF3BB488F82DE126248,31561,0,13,13,109.56792,18.28479,1765
59787,DB4DF566D4757FF3BB488F82DE126248,39183,16,17,1,109.55542,18.28208,1715
59788,A4132C7C24D4F6CFBC6C091695995585,30631,0,8,8,109.34382,18.32778,922
59789,A4132C7C24D4F6CFBC6C091695995585,31691,9,10,1,109.36604,18.3075,1019
59790,A4132C7C24D4F6CFBC6C091695995585,30631,12,15,3,109.34382,18.32778,922
59791,A4132C7C24D4F6CFBC6C091695995585,31691,16,17,1,109.36604,18.3075,1019
59792,A4132C7C24D4F6CFBC6C091695995585,30631,19,23,4,109.34382,18.32778,922
59820,1FC5887E4053936D3ED4D738338DC172,30121,0,7,7,109.52861,18.27222,1613
59821,1FC5887E4053936D3ED4D738338DC172,30951,10,16,6,109.56208,18.25667,1761
59822,1FC5887E4053936D3ED4D738338DC172,30121,18,23,5,109.52861,18.27222,1613
59852,4BA143AD44480D9BEACA2836C34FF531,60231,6,8,2,109.49903,18.21972,1504
59853,4BA143AD44480D9BEACA2836C34FF531,60161,11,12,1,109.49174,18.26181,1461
59854,4BA143AD44480D9BEACA2836C34FF531,30221,15,17,2,109.57833,18.20222,1802
59855,9FA61329C09648F8617BA9BB3AD39F2D,39151,0,1,1,109.49875,18.25097,1510
59856,9FA61329C09648F8617BA9BB3AD39F2D,60161,2,4,2,109.49174,18.26181,1461
59857,9FA61329C09648F8617BA9BB3AD39F2D,39151,4,6,2,109.49875,18.25097,1510
59858,9FA61329C09648F8617BA9BB3AD39F2D,60161,8,9,1,109.49174,18.26181,1461
59859,9FA61329C09648F8617BA9BB3AD39F2D,31321,13,22,9,109.63799,18.23201,2007
59896,1A1509AC6E667B603EE3773D1273B7B0,60504,14,15,1,109.47917,18.28903,1416
59897,1A1509AC6E667B603EE3773D1273B7B0,30671,15,22,7,109.43611,18.30139,1268
59933,C8135D3E403B7CC96352A41CBCD291A7,38241,0,6,6,109.54111,18.30542,1669
59934,C8135D3E403B7CC96352A41CBCD291A7,31931,9,14,5,109.54771,18.29403,1667
59935,C8135D3E403B7CC96352A41CBCD291A7,38241,17,19,2,109.54111,18.30542,1669
59936,C8135D3E403B7CC96352A41CBCD291A7,31931,20,22,2,109.54771,18.29403,1667
59983,BCF86295AA2D4858A2FA047D814B97DE,31071,0,7,7,109.58257,18.28458,1815
59984,BCF86295AA2D4858A2FA047D814B97DE,30854,9,11,2,109.56889,18.27076,1763
60004,44B51AB0086A395492A545161BBB3047,31521,16,20,4,109.51458,18.22542,1555
60005,44B51AB0086A395492A545161BBB3047,60381,20,22,2,109.5241,18.22458,1605
60026,B7A2800FDF738E1064EAD2A5E58F7A3C,61011,3,12,9,109.60653,18.19076,1900
60028,B7A2800FDF738E1064EAD2A5E58F7A3C,61011,16,23,7,109.60653,18.19076,1900
60066,4F877A4B395C9E22C3B85958392F2EAB,30051,0,9,9,109.48917,18.21215,1453
60067,4F877A4B395C9E22C3B85958392F2EAB,31181,10,14,4,109.50382,18.24813,1509
60068,4F877A4B395C9E22C3B85958392F2EAB,60131,14,16,2,109.49819,18.24778,1509
60069,4F877A4B395C9E22C3B85958392F2EAB,30854,17,23,6,109.56889,18.27076,1763
60082,0C8D15C0488D521680F0DE3A28CFE111,31811,0,6,6,109.54201,18.31806,1671
60083,0C8D15C0488D521680F0DE3A28CFE111,30701,7,16,9,109.59313,18.32007,1871
60084,0C8D15C0488D521680F0DE3A28CFE111,31811,17,18,1,109.54201,18.31806,1671
60098,CA3896FB33E9BC68E91955EDFF5D709B,60631,1,6,5,109.57778,18.27583,1814
60099,CA3896FB33E9BC68E91955EDFF5D709B,30854,7,22,15,109.56889,18.27076,1763
60115,45CCFCD3EBDF941E1C92B70ED06E8B5E,30854,0,4,4,109.56889,18.27076,1763
60116,45CCFCD3EBDF941E1C92B70ED06E8B5E,31945,8,9,1,109.58021,18.29403,1817
60117,45CCFCD3EBDF941E1C92B70ED06E8B5E,30854,12,18,6,109.56889,18.27076,1763
60118,45CCFCD3EBDF941E1C92B70ED06E8B5E,31561,19,21,2,109.56792,18.28479,1765
60139,DE5024DB59D5BF6AE5857A85EB7680EA,30854,13,19,6,109.56889,18.27076,1763
60140,DE5024DB59D5BF6AE5857A85EB7680EA,30191,21,23,2,109.50361,18.22701,1506
60145,F621296F333E8058687ACD884B135C6E,31901,1,3,2,109.68236,18.35368,2227
60146,F621296F333E8058687ACD884B135C6E,30504,4,23,19,109.705,18.35368,2277
60151,D97A48FFEC6EDAD02D62F5D217EED3AD,60161,1,2,1,109.49174,18.26181,1461
60152,D97A48FFEC6EDAD02D62F5D217EED3AD,60401,6,10,4,109.47444,18.27583,1414
60153,D97A48FFEC6EDAD02D62F5D217EED3AD,30711,12,15,3,109.50271,18.25347,1510
60154,D97A48FFEC6EDAD02D62F5D217EED3AD,60161,17,19,2,109.49174,18.26181,1461
60155,D97A48FFEC6EDAD02D62F5D217EED3AD,30361,19,21,2,109.50347,18.24,1508
60156,D97A48FFEC6EDAD02D62F5D217EED3AD,30711,21,22,1,109.50271,18.25347,1510
60166,5A7A3D5F722F0EB2695C45BF16BBC483,38157,0,6,6,109.51483,18.26958,1563
60167,5A7A3D5F722F0EB2695C45BF16BBC483,60621,7,8,1,109.48354,18.27451,1464
60168,5A7A3D5F722F0EB2695C45BF16BBC483,30191,10,11,1,109.50361,18.22701,1506
60169,5A7A3D5F722F0EB2695C45BF16BBC483,60661,14,15,1,109.548,18.2377,1657
60170,5A7A3D5F722F0EB2695C45BF16BBC483,60621,16,18,2,109.48354,18.27451,1464
60171,5A7A3D5F722F0EB2695C45BF16BBC483,38157,21,23,2,109.51483,18.26958,1563
60177,01282A80CFB4D1A01E953241ACFECD26,30232,0,9,9,109.6191,18.31701,1971
60178,01282A80CFB4D1A01E953241ACFECD26,30854,12,23,11,109.56889,18.27076,1763
60214,617D274C6203C3080475711DB0A2A53F,39321,0,4,4,109.529,18.2167,1604
60215,617D274C6203C3080475711DB0A2A53F,31521,5,6,1,109.51458,18.22542,1555
60218,617D274C6203C3080475711DB0A2A53F,31521,18,21,3,109.51458,18.22542,1555
60282,B3A1AC27CB357708CE63D3E4F68BF2E7,31071,2,4,2,109.58257,18.28458,1815
60283,B3A1AC27CB357708CE63D3E4F68BF2E7,30854,7,9,2,109.56889,18.27076,1763
60284,B3A1AC27CB357708CE63D3E4F68BF2E7,30731,9,11,2,109.50944,18.22306,1555
60285,B3A1AC27CB357708CE63D3E4F68BF2E7,30854,14,16,2,109.56889,18.27076,1763
60286,B3A1AC27CB357708CE63D3E4F68BF2E7,31071,17,21,4,109.58257,18.28458,1815
60287,B3A1AC27CB357708CE63D3E4F68BF2E7,30854,22,23,1,109.56889,18.27076,1763
60299,9FC1643F8DE11E5B5C74AA0D49F27E08,30711,11,15,4,109.50271,18.25347,1510
60300,9FC1643F8DE11E5B5C74AA0D49F27E08,30681,15,18,3,109.48493,18.26917,1463
60301,9FC1643F8DE11E5B5C74AA0D49F27E08,30711,18,23,5,109.50271,18.25347,1510
60321,6C9D7BB79A70B1E66DD550950EE935C8,31521,0,6,6,109.51458,18.22542,1555
60322,6C9D7BB79A70B1E66DD550950EE935C8,38145,7,8,1,109.378,18.2912,1066
60323,6C9D7BB79A70B1E66DD550950EE935C8,60054,12,14,2,109.3016,18.31229,770
60324,6C9D7BB79A70B1E66DD550950EE935C8,31521,16,23,7,109.51458,18.22542,1555
60405,21801B44E160B959843F53878D5BED5F,30084,0,5,5,109.50118,18.26972,1513
60406,21801B44E160B959843F53878D5BED5F,30771,5,7,2,109.49938,18.26042,1511
60407,21801B44E160B959843F53878D5BED5F,31781,9,11,2,109.19847,18.2975,367
60433,7264945C05DFDC18D47872D9F94F6B4F,60321,0,9,9,109.63611,18.24306,2008
60445,2B8C748A18FA7D08D4335AD7C9DEF01B,30951,11,14,3,109.56208,18.25667,1761
60446,2B8C748A18FA7D08D4335AD7C9DEF01B,31761,18,19,1,109.60521,18.27965,1914
60471,367FD9ECC2463438ADE3989905FE5BA2,38951,0,7,7,109.48097,18.28868,1416
60472,367FD9ECC2463438ADE3989905FE5BA2,30661,10,13,3,109.37028,18.24361,1008
60473,367FD9ECC2463438ADE3989905FE5BA2,38951,15,23,8,109.48097,18.28868,1416
60474,ED9F022E359658609122089860CD2887,38094,18,20,2,109.45403,18.28778,1316
60475,ED9F022E359658609122089860CD2887,30711,21,22,1,109.50271,18.25347,1510
60496,6587551DA47309E484D1302521C8D417,38275,7,12,5,109.62875,18.22938,2006
60497,6587551DA47309E484D1302521C8D417,60631,13,14,1,109.57778,18.27583,1814
60498,6587551DA47309E484D1302521C8D417,38275,17,22,5,109.62875,18.22938,2006
60538,3977578BE56276DA0700B04B81DC1356,30851,0,6,6,109.5616,18.27396,1713
60539,3977578BE56276DA0700B04B81DC1356,31561,6,20,14,109.56792,18.28479,1765
60551,A77A9A9ECE9C6EA9F5E37047DE8E4E0E,39321,0,6,6,109.529,18.2167,1604
60552,A77A9A9ECE9C6EA9F5E37047DE8E4E0E,38111,7,8,1,109.52007,18.22403,1555
60553,A77A9A9ECE9C6EA9F5E37047DE8E4E0E,31471,10,11,1,109.34583,18.29563,917
60554,A77A9A9ECE9C6EA9F5E37047DE8E4E0E,39321,14,15,1,109.529,18.2167,1604
60555,A77A9A9ECE9C6EA9F5E37047DE8E4E0E,31206,17,19,2,109.50819,18.23549,1507
60556,A77A9A9ECE9C6EA9F5E37047DE8E4E0E,31521,21,23,2,109.51458,18.22542,1555
60596,CC26F9F071245CA0A7A9071D1AE3256E,31351,0,1,1,109.4959,18.28417,1465
60597,CC26F9F071245CA0A7A9071D1AE3256E,31864,4,5,1,109.49014,18.28333,1465
60598,CC26F9F071245CA0A7A9071D1AE3256E,31351,5,6,1,109.4959,18.28417,1465
60620,AD608A919061B1C684914F8654FB2493,60231,16,20,4,109.49903,18.21972,1504
60621,AD608A919061B1C684914F8654FB2493,60084,21,23,2,109.4984,18.2334,1507
60631,0133DDFFB5CECBB261CEDEF10A82D50B,31561,0,18,18,109.56792,18.28479,1765
60632,0133DDFFB5CECBB261CEDEF10A82D50B,30854,20,23,3,109.56889,18.27076,1763
60633,44A75810FF8F9221047E9675BDBF60A2,31071,4,9,5,109.58257,18.28458,1815
60634,44A75810FF8F9221047E9675BDBF60A2,30854,11,13,2,109.56889,18.27076,1763
60635,44A75810FF8F9221047E9675BDBF60A2,31071,14,16,2,109.58257,18.28458,1815
60636,44A75810FF8F9221047E9675BDBF60A2,30854,18,19,1,109.56889,18.27076,1763
60658,C0DEC1A1A71755BE992575C088C9CC1E,60131,0,15,15,109.49819,18.24778,1509
60659,C0DEC1A1A71755BE992575C088C9CC1E,31031,15,19,4,109.49979,18.25382,1510
60660,C0DEC1A1A71755BE992575C088C9CC1E,60131,20,21,1,109.49819,18.24778,1509
60661,C0DEC1A1A71755BE992575C088C9CC1E,31181,22,23,1,109.50382,18.24813,1509
60669,E3AA3CC18802E5190B3AA5A477107D6A,30731,15,16,1,109.50944,18.22306,1555
60670,E3AA3CC18802E5190B3AA5A477107D6A,30571,17,18,1,109.50243,18.21861,1504
60683,0E129C09250C0D46273B4BD7E5225556,30151,0,6,6,109.50986,18.25083,1560
60684,0E129C09250C0D46273B4BD7E5225556,38251,6,11,5,109.49618,18.25493,1510
60685,0E129C09250C0D46273B4BD7E5225556,30661,14,17,3,109.37028,18.24361,1008
60686,0E129C09250C0D46273B4BD7E5225556,38291,20,22,2,109.51618,18.24313,1558
60687,0E129C09250C0D46273B4BD7E5225556,60201,22,23,1,109.5041,18.2509,1510
60707,26A45EFEBFDCEB4A3AD081943B64403C,30631,0,4,4,109.34382,18.32778,922
60708,26A45EFEBFDCEB4A3AD081943B64403C,31121,7,13,6,109.16292,18.37063,230
60709,26A45EFEBFDCEB4A3AD081943B64403C,31691,18,22,4,109.36604,18.3075,1019
60710,26A45EFEBFDCEB4A3AD081943B64403C,30631,22,23,1,109.34382,18.32778,922
60722,E6312CBC8153A9C6DAB83670095D0D25,38951,0,2,2,109.48097,18.28868,1416
60723,E6312CBC8153A9C6DAB83670095D0D25,60501,2,7,5,109.48701,18.29021,1466
60724,E6312CBC8153A9C6DAB83670095D0D25,38951,11,14,3,109.48097,18.28868,1416
60751,3874C4E4871E18E9A94F1B63176AFE6D,31681,0,8,8,109.40396,18.29979,1168
60753,C709D01469E0800AF998DFAF42105CDC,30854,0,5,5,109.56889,18.27076,1763
60754,C709D01469E0800AF998DFAF42105CDC,60631,7,8,1,109.57778,18.27583,1814
60755,C709D01469E0800AF998DFAF42105CDC,30854,9,16,7,109.56889,18.27076,1763
60778,173CD7A2B7B334BC53A50A1D248FBCFE,31071,0,6,6,109.58257,18.28458,1815
60779,173CD7A2B7B334BC53A50A1D248FBCFE,30854,10,12,2,109.56889,18.27076,1763
60780,173CD7A2B7B334BC53A50A1D248FBCFE,31071,14,21,7,109.58257,18.28458,1815
60781,451E2BF48CD7B253EB0892324E679BCC,38297,0,6,6,109.52576,18.24965,1609
60782,451E2BF48CD7B253EB0892324E679BCC,60281,6,15,9,109.51743,18.25924,1561
60783,451E2BF48CD7B253EB0892324E679BCC,38291,16,22,6,109.51618,18.24313,1558
60791,8A0382A2385C362EFE2664E8795F133E,31561,0,5,5,109.56792,18.28479,1765
60792,8A0382A2385C362EFE2664E8795F133E,39183,7,18,11,109.55542,18.28208,1715
60793,8A0382A2385C362EFE2664E8795F133E,31561,21,23,2,109.56792,18.28479,1765
60808,B679F5300CCD6252F372C516FDDBA1B2,31181,16,17,1,109.50382,18.24813,1509
60809,B679F5300CCD6252F372C516FDDBA1B2,31181,18,21,3,109.50382,18.24813,1509
60810,B679F5300CCD6252F372C516FDDBA1B2,31181,21,23,2,109.50382,18.24813,1509
60820,78D44725626E719FF0C0FCBC8763A33E,31561,8,12,4,109.56792,18.28479,1765
60821,78D44725626E719FF0C0FCBC8763A33E,30851,16,18,2,109.5616,18.27396,1713
60822,78D44725626E719FF0C0FCBC8763A33E,60221,18,19,1,109.52569,18.29188,1616
60831,0E5593A90D661690BE3DAAA17AD936E2,38127,0,4,4,109.50833,18.27222,1513
60832,0E5593A90D661690BE3DAAA17AD936E2,38073,8,22,14,109.40813,18.30958,1169
60863,4CE90E7F21A3960AF8727F22C7C2F7EA,31201,0,7,7,109.51042,18.23819,1558
60864,4CE90E7F21A3960AF8727F22C7C2F7EA,60281,8,11,3,109.51743,18.25924,1561
60865,4CE90E7F21A3960AF8727F22C7C2F7EA,31201,12,23,11,109.51042,18.23819,1558
60876,38A8595594DC26AD8BE733FC85DB4CA6,31631,0,15,15,109.59542,18.36826,1879
60877,38A8595594DC26AD8BE733FC85DB4CA6,30101,15,17,2,109.57299,18.33333,1773
60878,38A8595594DC26AD8BE733FC85DB4CA6,31631,17,22,5,109.59542,18.36826,1879
60905,8FAAC7EA21AE7BB6F52A4D0F285944CD,38721,0,8,8,109.50368,18.27542,1514
60906,8FAAC7EA21AE7BB6F52A4D0F285944CD,30281,8,10,2,109.50597,18.27583,1514
60907,8FAAC7EA21AE7BB6F52A4D0F285944CD,60201,10,12,2,109.5041,18.2509,1510
60945,AD596F5EEC3151EE996EA9BC3D4042FE,30421,14,15,1,109.50021,18.25861,1511
60946,AD596F5EEC3151EE996EA9BC3D4042FE,30421,16,18,2,109.50021,18.25861,1511
60947,AD596F5EEC3151EE996EA9BC3D4042FE,38251,19,21,2,109.49618,18.25493,1510
60948,AD596F5EEC3151EE996EA9BC3D4042FE,30421,21,23,2,109.50021,18.25861,1511
60949,521A7ED98375837397B112E54A372514,38017,17,18,1,109.49729,18.21424,1504
60950,521A7ED98375837397B112E54A372514,30191,18,20,2,109.50361,18.22701,1506
60951,521A7ED98375837397B112E54A372514,31431,20,22,2,109.44639,18.29042,1316
60962,EDE78B6CF45A5ED767091F2988348E3D,60381,17,19,2,109.5241,18.22458,1605
60963,EDE78B6CF45A5ED767091F2988348E3D,31351,20,23,3,109.4959,18.28417,1465
60968,283001ED673D8EDBEF7EEB00BDB31533,30571,1,5,4,109.50243,18.21861,1504
60969,283001ED673D8EDBEF7EEB00BDB31533,60331,7,9,2,109.505,18.26507,1512
60970,283001ED673D8EDBEF7EEB00BDB31533,60201,9,18,9,109.5041,18.2509,1510
60971,283001ED673D8EDBEF7EEB00BDB31533,30571,18,20,2,109.50243,18.21861,1504
61013,0E1B3CFC64EBB658DA96D0DCA834701E,61011,6,20,14,109.60653,18.19076,1900
61021,CB1C8502149DACE0B32B2F7416279EF2,30854,11,15,4,109.56889,18.27076,1763
61022,CB1C8502149DACE0B32B2F7416279EF2,31071,16,17,1,109.58257,18.28458,1815
61023,CB1C8502149DACE0B32B2F7416279EF2,31945,20,22,2,109.58021,18.29403,1817
61065,D39D64452E6BBEF7B3056CA239E1B86E,30854,0,6,6,109.56889,18.27076,1763
61066,D39D64452E6BBEF7B3056CA239E1B86E,31561,6,7,1,109.56792,18.28479,1765
61067,D39D64452E6BBEF7B3056CA239E1B86E,30854,11,13,2,109.56889,18.27076,1763
61068,D39D64452E6BBEF7B3056CA239E1B86E,31561,14,15,1,109.56792,18.28479,1765
61069,D39D64452E6BBEF7B3056CA239E1B86E,30854,16,23,7,109.56889,18.27076,1763
61130,1FE2866848043A2C10AD87212485FE15,31181,1,2,1,109.50382,18.24813,1509
61131,1FE2866848043A2C10AD87212485FE15,31071,3,13,10,109.58257,18.28458,1815
61132,1FE2866848043A2C10AD87212485FE15,30854,13,17,4,109.56889,18.27076,1763
61133,1FE2866848043A2C10AD87212485FE15,31071,21,23,2,109.58257,18.28458,1815
61197,CD576F1C1CDFB89E6A99A20E65927346,31561,14,18,4,109.56792,18.28479,1765
61198,CD576F1C1CDFB89E6A99A20E65927346,30854,20,22,2,109.56889,18.27076,1763
61234,B712327B6033C61F37801CFD6DAC08AD,30071,13,17,4,109.52819,18.30472,1619
61235,B712327B6033C61F37801CFD6DAC08AD,38484,22,23,1,109.53028,18.31528,1620
61267,A7B3BDD8DC79485BA41EC7F220A41345,60631,1,17,16,109.57778,18.27583,1814
61268,A7B3BDD8DC79485BA41EC7F220A41345,30854,20,22,2,109.56889,18.27076,1763
61269,63FBAC0202144B00077561285E6A7F87,30651,1,2,1,109.42611,18.385,1232
61270,63FBAC0202144B00077561285E6A7F87,30821,3,13,10,109.43681,18.33639,1274
61271,63FBAC0202144B00077561285E6A7F87,30651,14,16,2,109.42611,18.385,1232
61272,63FBAC0202144B00077561285E6A7F87,30821,17,21,4,109.43681,18.33639,1274
61280,070984703178D21DC5287E457C03691A,39181,16,18,2,109.55153,18.28035,1715
61281,070984703178D21DC5287E457C03691A,39181,19,23,4,109.55153,18.28035,1715
61331,225EDE82328108AFB3E7EE610CA3F074,31931,7,14,7,109.54771,18.29403,1667
61332,225EDE82328108AFB3E7EE610CA3F074,60371,16,18,2,109.53063,18.30056,1618
61333,225EDE82328108AFB3E7EE610CA3F074,31931,19,23,4,109.54771,18.29403,1667
61344,9E2CAA912E7C38B3460AB2C8B985CA0D,30854,0,15,15,109.56889,18.27076,1763
61345,9E2CAA912E7C38B3460AB2C8B985CA0D,30221,18,22,4,109.57833,18.20222,1802
61358,044BFA16D267A2D3E1462E21B9443F95,38085,0,8,8,109.6291,18.23625,2007
61359,044BFA16D267A2D3E1462E21B9443F95,31781,10,12,2,109.19847,18.2975,367
61360,044BFA16D267A2D3E1462E21B9443F95,60441,15,17,2,109.46792,18.28604,1366
61361,044BFA16D267A2D3E1462E21B9443F95,38085,21,23,2,109.6291,18.23625,2007
61369,89362A3CA3AE6F5B75871F2110924F99,30851,0,6,6,109.5616,18.27396,1713
61370,89362A3CA3AE6F5B75871F2110924F99,30951,8,11,3,109.56208,18.25667,1761
61371,89362A3CA3AE6F5B75871F2110924F99,31551,11,13,2,109.55868,18.24222,1708
61372,89362A3CA3AE6F5B75871F2110924F99,30951,13,18,5,109.56208,18.25667,1761
61373,89362A3CA3AE6F5B75871F2110924F99,30851,19,23,4,109.5616,18.27396,1713
61392,4E42F3C8BFACF58FB6187931BEBBDF23,38484,0,2,2,109.53028,18.31528,1620
61393,4E42F3C8BFACF58FB6187931BEBBDF23,30561,2,7,5,109.52778,18.31938,1621
61450,B78E7295CB13532B4E2C30EF158E297F,30854,1,4,3,109.56889,18.27076,1763
61451,B78E7295CB13532B4E2C30EF158E297F,31931,4,6,2,109.54771,18.29403,1667
61452,B78E7295CB13532B4E2C30EF158E297F,30854,6,7,1,109.56889,18.27076,1763
61453,B78E7295CB13532B4E2C30EF158E297F,31561,16,17,1,109.56792,18.28479,1765
61454,B78E7295CB13532B4E2C30EF158E297F,39183,18,19,1,109.55542,18.28208,1715
61455,B78E7295CB13532B4E2C30EF158E297F,30851,22,23,1,109.5616,18.27396,1713
61482,8D20E29FA3AA7FC35B155C473A656344,38111,0,6,6,109.52007,18.22403,1555
61483,8D20E29FA3AA7FC35B155C473A656344,31521,8,10,2,109.51458,18.22542,1555
61484,8D20E29FA3AA7FC35B155C473A656344,30361,11,13,2,109.50347,18.24,1508
61485,8D20E29FA3AA7FC35B155C473A656344,38111,14,16,2,109.52007,18.22403,1555
61486,8D20E29FA3AA7FC35B155C473A656344,38111,17,19,2,109.52007,18.22403,1555
61487,8D20E29FA3AA7FC35B155C473A656344,31521,19,20,1,109.51458,18.22542,1555
61488,8D20E29FA3AA7FC35B155C473A656344,38111,22,23,1,109.52007,18.22403,1555
61493,F47C4E1E39056C43B0AD32AC994AB7C0,31931,0,15,15,109.54771,18.29403,1667
61494,F47C4E1E39056C43B0AD32AC994AB7C0,30921,17,19,2,109.53903,18.29451,1667
61495,F47C4E1E39056C43B0AD32AC994AB7C0,31931,21,22,1,109.54771,18.29403,1667
61560,02789FFFF0828D5AC1FE96B1CA16BB9C,38951,0,9,9,109.48097,18.28868,1416
61561,02789FFFF0828D5AC1FE96B1CA16BB9C,31781,12,15,3,109.19847,18.2975,367
61562,02789FFFF0828D5AC1FE96B1CA16BB9C,31471,16,18,2,109.34583,18.29563,917
61563,02789FFFF0828D5AC1FE96B1CA16BB9C,38951,21,23,2,109.48097,18.28868,1416
61618,A928E9F6C796FE1A60807BA003DE87BB,39183,14,16,2,109.55542,18.28208,1715
61619,A928E9F6C796FE1A60807BA003DE87BB,38127,18,20,2,109.50833,18.27222,1513
61620,A928E9F6C796FE1A60807BA003DE87BB,31071,21,23,2,109.58257,18.28458,1815
61693,D8681498A4BDCBE5A54E7CD864E651F0,60371,0,1,1,109.53063,18.30056,1618
61694,D8681498A4BDCBE5A54E7CD864E651F0,30071,2,5,3,109.52819,18.30472,1619
61695,D8681498A4BDCBE5A54E7CD864E651F0,38315,5,6,1,109.48979,18.29764,1467
61703,70A62761FE79F922D082380DA7747243,31561,1,3,2,109.56792,18.28479,1765
61704,70A62761FE79F922D082380DA7747243,30854,4,23,19,109.56889,18.27076,1763
61749,9AF351B3CC27394DFED45513F0E32162,60351,0,6,6,109.58403,18.28958,1816
61750,9AF351B3CC27394DFED45513F0E32162,31061,9,10,1,109.53333,18.23257,1607
61751,9AF351B3CC27394DFED45513F0E32162,30951,11,14,3,109.56208,18.25667,1761
61752,3D5A468E02E58892BB875A2C29BFAFBA,60281,0,2,2,109.51743,18.25924,1561
61753,3D5A468E02E58892BB875A2C29BFAFBA,38911,3,4,1,109.51674,18.24965,1559
61754,3D5A468E02E58892BB875A2C29BFAFBA,31821,7,10,3,109.51181,18.24924,1559
61755,3D5A468E02E58892BB875A2C29BFAFBA,31781,12,13,1,109.19847,18.2975,367
61756,3D5A468E02E58892BB875A2C29BFAFBA,38291,18,20,2,109.51618,18.24313,1558
61757,3D5A468E02E58892BB875A2C29BFAFBA,60573,21,22,1,109.50757,18.25299,1510
61768,608A55C14BAB2A5B627ACC1F39B89FB6,31945,0,7,7,109.58021,18.29403,1817
61769,608A55C14BAB2A5B627ACC1F39B89FB6,30854,7,16,9,109.56889,18.27076,1763
61770,608A55C14BAB2A5B627ACC1F39B89FB6,31521,19,20,1,109.51458,18.22542,1555
61843,10EBF762D28520B09848288F7052CFDE,31071,0,5,5,109.58257,18.28458,1815
61844,10EBF762D28520B09848288F7052CFDE,30711,7,12,5,109.50271,18.25347,1510
61845,10EBF762D28520B09848288F7052CFDE,30511,12,13,1,109.51069,18.24208,1558
61846,10EBF762D28520B09848288F7052CFDE,39101,14,18,4,109.50132,18.24931,1509
61847,10EBF762D28520B09848288F7052CFDE,30854,19,21,2,109.56889,18.27076,1763
61848,10EBF762D28520B09848288F7052CFDE,31071,22,23,1,109.58257,18.28458,1815
61903,AAB3DCB18BAF89954DC0C8A658A6D766,60231,3,6,3,109.49903,18.21972,1504
61904,AAB3DCB18BAF89954DC0C8A658A6D766,30421,10,21,11,109.50021,18.25861,1511
61905,AAB3DCB18BAF89954DC0C8A658A6D766,31951,21,23,2,109.52174,18.30299,1568
61967,86EE5D68F9CFA1D4E3B7514A323B43C4,60361,0,8,8,109.51938,18.29681,1567
61968,86EE5D68F9CFA1D4E3B7514A323B43C4,38484,8,10,2,109.53028,18.31528,1620
61969,86EE5D68F9CFA1D4E3B7514A323B43C4,30071,11,21,10,109.52819,18.30472,1619
61970,F3743A0150B752AC5079D26C89C3915F,30741,17,18,1,109.49833,18.28681,1516
61971,F3743A0150B752AC5079D26C89C3915F,60614,22,23,1,109.48799,18.29521,1467
61972,13166628932DF36C0AD7B1DB5811240A,60631,11,12,1,109.57778,18.27583,1814
61973,13166628932DF36C0AD7B1DB5811240A,30854,15,19,4,109.56889,18.27076,1763
61974,13166628932DF36C0AD7B1DB5811240A,60591,20,22,2,109.61118,18.21715,1904
61991,B621E9075674E792CCB217233825F9D1,30851,1,10,9,109.5616,18.27396,1713
61992,B621E9075674E792CCB217233825F9D1,60631,13,15,2,109.57778,18.27583,1814
61993,B621E9075674E792CCB217233825F9D1,31571,20,23,3,109.61563,18.23326,1957
62002,6DF7485545B790F22810B0EDD8F1B356,31945,0,7,7,109.58021,18.29403,1817
62003,6DF7485545B790F22810B0EDD8F1B356,30854,7,9,2,109.56889,18.27076,1763
62004,6DF7485545B790F22810B0EDD8F1B356,31945,12,13,1,109.58021,18.29403,1817
62005,6DF7485545B790F22810B0EDD8F1B356,31071,16,17,1,109.58257,18.28458,1815
62006,6DF7485545B790F22810B0EDD8F1B356,31945,19,23,4,109.58021,18.29403,1817
62022,F167FEC88E6854C4E8BE1680AD709113,60054,12,13,1,109.3016,18.31229,770
62023,F167FEC88E6854C4E8BE1680AD709113,38951,15,17,2,109.48097,18.28868,1416
62024,F167FEC88E6854C4E8BE1680AD709113,60614,17,18,1,109.48799,18.29521,1467
62025,F167FEC88E6854C4E8BE1680AD709113,38951,18,22,4,109.48097,18.28868,1416
62061,07F3C4748B468EDA7E91DFDA551BC9A2,38023,0,7,7,109.37132,18.28993,1016
62062,07F3C4748B468EDA7E91DFDA551BC9A2,31081,8,9,1,109.44639,18.30181,1318
62063,07F3C4748B468EDA7E91DFDA551BC9A2,31571,13,14,1,109.61563,18.23326,1957
62064,07F3C4748B468EDA7E91DFDA551BC9A2,31701,16,18,2,109.44132,18.28833,1266
62065,07F3C4748B468EDA7E91DFDA551BC9A2,38023,21,23,2,109.37132,18.28993,1016
62092,0F558B6653C655C7F0BAEA9D66B33F57,30721,0,2,2,109.51597,18.28257,1565
62093,0F558B6653C655C7F0BAEA9D66B33F57,31071,4,7,3,109.58257,18.28458,1815
62094,0F558B6653C655C7F0BAEA9D66B33F57,30854,9,10,1,109.56889,18.27076,1763
62095,0F558B6653C655C7F0BAEA9D66B33F57,31071,10,12,2,109.58257,18.28458,1815
62096,0F558B6653C655C7F0BAEA9D66B33F57,30854,12,16,4,109.56889,18.27076,1763
62097,0F558B6653C655C7F0BAEA9D66B33F57,31521,19,21,2,109.51458,18.22542,1555
62098,0F558B6653C655C7F0BAEA9D66B33F57,30854,22,23,1,109.56889,18.27076,1763
62099,3628EDF55F9AE10864AAD56A403A43FA,30891,1,5,4,109.59431,18.28389,1865
62100,3628EDF55F9AE10864AAD56A403A43FA,30854,5,6,1,109.56889,18.27076,1763
62101,3628EDF55F9AE10864AAD56A403A43FA,30891,6,15,9,109.59431,18.28389,1865
62102,3628EDF55F9AE10864AAD56A403A43FA,30854,19,22,3,109.56889,18.27076,1763
62112,1026894DC5FF9A7FAF3A2EE28B95E239,30891,12,15,3,109.59431,18.28389,1865
62113,1026894DC5FF9A7FAF3A2EE28B95E239,30854,17,23,6,109.56889,18.27076,1763
62120,43F5AB52A0AF3FEB5880C6DCD16BBA02,60011,0,7,7,109.48965,18.30222,1468
62121,43F5AB52A0AF3FEB5880C6DCD16BBA02,31041,9,15,6,109.50278,18.23701,1507
62122,43F5AB52A0AF3FEB5880C6DCD16BBA02,60011,19,23,4,109.48965,18.30222,1468
62150,85AA0B3F846A2C147D928E6A13F763A6,60071,0,8,8,109.75674,18.31583,2470
62152,7421066246AAD1C230E7E2A7ADF06E9D,60631,0,6,6,109.57778,18.27583,1814
62153,7421066246AAD1C230E7E2A7ADF06E9D,30854,7,11,4,109.56889,18.27076,1763
62154,7421066246AAD1C230E7E2A7ADF06E9D,31071,14,15,1,109.58257,18.28458,1815
62155,7421066246AAD1C230E7E2A7ADF06E9D,30854,17,18,1,109.56889,18.27076,1763
62156,7421066246AAD1C230E7E2A7ADF06E9D,60631,21,23,2,109.57778,18.27583,1814
62157,10026EC528DC65E6B062D4E8B47727C1,38157,1,6,5,109.51483,18.26958,1563
62158,10026EC528DC65E6B062D4E8B47727C1,30171,8,11,3,109.48458,18.27139,1463
62159,10026EC528DC65E6B062D4E8B47727C1,38127,12,23,11,109.50833,18.27222,1513
62167,A01B4012B619D942E7CC3AC9B78722B4,39183,0,1,1,109.55542,18.28208,1715
62168,A01B4012B619D942E7CC3AC9B78722B4,31561,3,23,20,109.56792,18.28479,1765
62177,E2A4A2ABBE2AAFDE32C6FA06BCCC268D,30854,11,16,5,109.56889,18.27076,1763
62178,E2A4A2ABBE2AAFDE32C6FA06BCCC268D,31071,20,23,3,109.58257,18.28458,1815
62297,F3D63C0B2248B39F370D3CF39845220E,38951,0,7,7,109.48097,18.28868,1416
62298,F3D63C0B2248B39F370D3CF39845220E,30971,8,9,1,109.48708,18.29319,1467
62299,F3D63C0B2248B39F370D3CF39845220E,30711,10,12,2,109.50271,18.25347,1510
62300,F3D63C0B2248B39F370D3CF39845220E,38951,15,17,2,109.48097,18.28868,1416
62301,F3D63C0B2248B39F370D3CF39845220E,30971,17,19,2,109.48708,18.29319,1467
62302,F3D63C0B2248B39F370D3CF39845220E,38951,19,23,4,109.48097,18.28868,1416
62305,EFFEF00C078D502D6D0D1D469ACBA466,39041,0,8,8,109.40021,18.29278,1117
62306,EFFEF00C078D502D6D0D1D469ACBA466,31471,9,11,2,109.34583,18.29563,917
62307,EFFEF00C078D502D6D0D1D469ACBA466,38321,12,15,3,109.39854,18.29132,1116
62308,EFFEF00C078D502D6D0D1D469ACBA466,30281,19,20,1,109.50597,18.27583,1514
62309,EFFEF00C078D502D6D0D1D469ACBA466,30421,21,23,2,109.50021,18.25861,1511
62350,DF49F834C08C7E8FA6D78272EE1FB651,60361,0,7,7,109.51938,18.29681,1567
62351,DF49F834C08C7E8FA6D78272EE1FB651,30951,12,17,5,109.56208,18.25667,1761
62352,DF49F834C08C7E8FA6D78272EE1FB651,60361,18,23,5,109.51938,18.29681,1567
62360,C1602FB5A20BD98313F7CC13F431D061,30271,0,7,7,109.49132,18.23153,1456
62361,C1602FB5A20BD98313F7CC13F431D061,30771,9,15,6,109.49938,18.26042,1511
62362,C1602FB5A20BD98313F7CC13F431D061,30771,16,18,2,109.49938,18.26042,1511
62363,C1602FB5A20BD98313F7CC13F431D061,39151,19,21,2,109.49875,18.25097,1510
62376,8DD23AA43C0F7967C45F7488D66F9159,30854,2,9,7,109.56889,18.27076,1763
62377,8DD23AA43C0F7967C45F7488D66F9159,31945,13,14,1,109.58021,18.29403,1817
62378,8DD23AA43C0F7967C45F7488D66F9159,30854,18,20,2,109.56889,18.27076,1763
62381,BD4652414D5C17466BA36FD4BD943A94,39183,15,16,1,109.55542,18.28208,1715
62382,BD4652414D5C17466BA36FD4BD943A94,30421,18,19,1,109.50021,18.25861,1511
62383,BD4652414D5C17466BA36FD4BD943A94,38157,20,21,1,109.51483,18.26958,1563
62398,59F2738320001FD950F433CB128A2616,30361,3,13,10,109.50347,18.24,1508
62399,59F2738320001FD950F433CB128A2616,38157,15,23,8,109.51483,18.26958,1563
62450,D517610C2076C41FED0ED80CB6FFB44C,30851,0,14,14,109.5616,18.27396,1713
62451,D517610C2076C41FED0ED80CB6FFB44C,31561,14,15,1,109.56792,18.28479,1765
62452,D517610C2076C41FED0ED80CB6FFB44C,30851,17,22,5,109.5616,18.27396,1713
62470,F4E8369A4C9B6C532D393F00D3A77C26,31561,2,3,1,109.56792,18.28479,1765
62471,F4E8369A4C9B6C532D393F00D3A77C26,30854,4,6,2,109.56889,18.27076,1763
62472,F4E8369A4C9B6C532D393F00D3A77C26,31561,7,8,1,109.56792,18.28479,1765
62473,F4E8369A4C9B6C532D393F00D3A77C26,39183,8,19,11,109.55542,18.28208,1715
62474,F4E8369A4C9B6C532D393F00D3A77C26,30854,20,22,2,109.56889,18.27076,1763
62495,BFDE1CB7ED71CA9593AFA77408B12977,39183,5,7,2,109.55542,18.28208,1715
62496,BFDE1CB7ED71CA9593AFA77408B12977,30854,8,9,1,109.56889,18.27076,1763
62497,BFDE1CB7ED71CA9593AFA77408B12977,39183,11,13,2,109.55542,18.28208,1715
62498,BFDE1CB7ED71CA9593AFA77408B12977,30731,15,16,1,109.50944,18.22306,1555
62499,9BD0746EAD915C7FE62E448DC71186FA,30854,0,2,2,109.56889,18.27076,1763
62500,9BD0746EAD915C7FE62E448DC71186FA,31071,2,10,8,109.58257,18.28458,1815
62501,9BD0746EAD915C7FE62E448DC71186FA,30854,13,16,3,109.56889,18.27076,1763
62508,C85D0B931BEF54F05B9ABBBB03212DB7,30854,0,6,6,109.56889,18.27076,1763
62509,C85D0B931BEF54F05B9ABBBB03212DB7,31561,8,18,10,109.56792,18.28479,1765
62510,C85D0B931BEF54F05B9ABBBB03212DB7,30854,19,20,1,109.56889,18.27076,1763
62511,1A4B51DFD66BF1F13D5FAE3E1A0A202C,31071,0,7,7,109.58257,18.28458,1815
62512,1A4B51DFD66BF1F13D5FAE3E1A0A202C,30854,7,11,4,109.56889,18.27076,1763
62548,B37777551ADDE84A1FDFE1FF465C24DC,31421,13,17,4,109.55382,18.22347,1705
62549,B37777551ADDE84A1FDFE1FF465C24DC,60381,19,20,1,109.5241,18.22458,1605
62568,DB5DBB26A2C3C99D2F6E5594795E2B47,30151,0,7,7,109.50986,18.25083,1560
62569,DB5DBB26A2C3C99D2F6E5594795E2B47,60401,9,12,3,109.47444,18.27583,1414
62570,DB5DBB26A2C3C99D2F6E5594795E2B47,30171,14,15,1,109.48458,18.27139,1463
62575,D0F0D586BD20DB339C6320E410D3897E,31931,6,11,5,109.54771,18.29403,1667
62628,EBF906C5498076BCFA3E97DF6001B4F3,60631,3,7,4,109.57778,18.27583,1814
62629,EBF906C5498076BCFA3E97DF6001B4F3,30854,12,23,11,109.56889,18.27076,1763
62640,2575DC0A6ACDD25FC20DB5874F9656C2,38127,0,13,13,109.50833,18.27222,1513
62647,2A6BA0678DDF16AF08BAC9E3FA3C9391,31561,0,2,2,109.56792,18.28479,1765
62648,2A6BA0678DDF16AF08BAC9E3FA3C9391,30854,3,6,3,109.56889,18.27076,1763
62649,2A6BA0678DDF16AF08BAC9E3FA3C9391,31561,6,8,2,109.56792,18.28479,1765
62650,2A6BA0678DDF16AF08BAC9E3FA3C9391,30854,9,11,2,109.56889,18.27076,1763
62651,2A6BA0678DDF16AF08BAC9E3FA3C9391,31561,13,15,2,109.56792,18.28479,1765
62652,2A6BA0678DDF16AF08BAC9E3FA3C9391,30854,17,19,2,109.56889,18.27076,1763
62653,2A6BA0678DDF16AF08BAC9E3FA3C9391,31561,21,22,1,109.56792,18.28479,1765
62662,BBA16F6706035825AE1DA4ED4DD948D9,30181,7,12,5,109.51597,18.23313,1557
62663,BBA16F6706035825AE1DA4ED4DD948D9,31521,13,14,1,109.51458,18.22542,1555
62664,BBA16F6706035825AE1DA4ED4DD948D9,30181,14,17,3,109.51597,18.23313,1557
62665,BBA16F6706035825AE1DA4ED4DD948D9,30361,18,20,2,109.50347,18.24,1508
62666,BBA16F6706035825AE1DA4ED4DD948D9,30181,20,23,3,109.51597,18.23313,1557
62667,928DF0385E8541CFD2F5858501C04155,31071,0,2,2,109.58257,18.28458,1815
62668,928DF0385E8541CFD2F5858501C04155,30234,5,6,1,109.60681,18.29979,1918
62669,928DF0385E8541CFD2F5858501C04155,30854,11,20,9,109.56889,18.27076,1763
62676,5330201098C22642D689CB029F620A39,30051,0,6,6,109.48917,18.21215,1453
62677,5330201098C22642D689CB029F620A39,38361,8,9,1,109.43667,18.29201,1267
62678,5330201098C22642D689CB029F620A39,31101,13,16,3,109.65389,18.23403,2057
62685,8E3A30A4D1E8F550E98C2EF7500D367D,30084,0,10,10,109.50118,18.26972,1513
62686,8E3A30A4D1E8F550E98C2EF7500D367D,30081,14,15,1,109.50243,18.26632,1512
62687,8E3A30A4D1E8F550E98C2EF7500D367D,30711,15,17,2,109.50271,18.25347,1510
62688,8E3A30A4D1E8F550E98C2EF7500D367D,30081,19,23,4,109.50243,18.26632,1512
62708,75817DB682187A07461734D66E1E6492,60631,0,4,4,109.57778,18.27583,1814
62709,75817DB682187A07461734D66E1E6492,30854,5,18,13,109.56889,18.27076,1763
62710,75817DB682187A07461734D66E1E6492,60631,21,23,2,109.57778,18.27583,1814
62742,E16204D131FCD957D5ADB9592C1DD0ED,31071,1,12,11,109.58257,18.28458,1815
62743,E16204D131FCD957D5ADB9592C1DD0ED,60311,14,16,2,109.52097,18.24319,1558
62744,E16204D131FCD957D5ADB9592C1DD0ED,31071,18,20,2,109.58257,18.28458,1815
62756,53FAD38445EA2327DCFAAAADCAABAB84,30361,0,8,8,109.50347,18.24,1508
62757,53FAD38445EA2327DCFAAAADCAABAB84,38315,9,10,1,109.48979,18.29764,1467
62808,34F3D64B41C252481F72E5CF931AC833,30851,1,11,10,109.5616,18.27396,1713
62809,34F3D64B41C252481F72E5CF931AC833,30854,12,13,1,109.56889,18.27076,1763
62810,34F3D64B41C252481F72E5CF931AC833,31071,13,15,2,109.58257,18.28458,1815
62817,EACE0C43F4CFE6E058FB80EE357B16CF,30321,0,18,18,109.49563,18.29611,1467
62818,EACE0C43F4CFE6E058FB80EE357B16CF,31561,18,19,1,109.56792,18.28479,1765
62832,D4EDFC03E7ED63DAAF98D926C98FC74F,31181,6,7,1,109.50382,18.24813,1509
62833,D4EDFC03E7ED63DAAF98D926C98FC74F,30511,10,23,13,109.51069,18.24208,1558
62837,FC12400ACC5D52C4DD5609D1A21E8705,31931,0,6,6,109.54771,18.29403,1667
62838,FC12400ACC5D52C4DD5609D1A21E8705,39181,8,9,1,109.55153,18.28035,1715
62839,FC12400ACC5D52C4DD5609D1A21E8705,31931,9,11,2,109.54771,18.29403,1667
62840,FC12400ACC5D52C4DD5609D1A21E8705,39181,13,18,5,109.55153,18.28035,1715
62841,FC12400ACC5D52C4DD5609D1A21E8705,31931,19,23,4,109.54771,18.29403,1667
62843,8D8AA41210FC9E2D5DD4D81CF4DB18D7,60361,13,16,3,109.51938,18.29681,1567
62844,8D8AA41210FC9E2D5DD4D81CF4DB18D7,30084,19,20,1,109.50118,18.26972,1513
62858,A952750F25C558E5C17B3EB7DD935431,60371,5,9,4,109.53063,18.30056,1618
62859,A952750F25C558E5C17B3EB7DD935431,31931,12,21,9,109.54771,18.29403,1667
62863,ABCD0851CC1C78BCD7AF6DBDF2F5DE49,30671,6,7,1,109.43611,18.30139,1268
62864,ABCD0851CC1C78BCD7AF6DBDF2F5DE49,60552,8,21,13,109.41729,18.30014,1218
62877,FF6409757A02529917194A790554851A,31145,14,15,1,109.20431,18.30479,369
62926,E6541B4F346982101D887BAAF0315541,30854,1,7,6,109.56889,18.27076,1763
62927,E6541B4F346982101D887BAAF0315541,31561,8,9,1,109.56792,18.28479,1765
62928,E6541B4F346982101D887BAAF0315541,30854,13,14,1,109.56889,18.27076,1763
62936,9EB99F27F9127F01C16DB7BA7D10B6E0,30854,17,20,3,109.56889,18.27076,1763
62937,9EB99F27F9127F01C16DB7BA7D10B6E0,31561,21,22,1,109.56792,18.28479,1765
62968,B643AC77F8D8498A9694D45BA8B0F75F,30854,19,20,1,109.56889,18.27076,1763
62969,B643AC77F8D8498A9694D45BA8B0F75F,31561,21,23,2,109.56792,18.28479,1765
63007,DFD04086D24122EB0B303CE9A87DF681,39191,0,6,6,109.51493,18.23472,1557
63008,DFD04086D24122EB0B303CE9A87DF681,31201,7,9,2,109.51042,18.23819,1558
63009,DFD04086D24122EB0B303CE9A87DF681,31471,11,13,2,109.34583,18.29563,917
63010,DFD04086D24122EB0B303CE9A87DF681,31201,15,17,2,109.51042,18.23819,1558
63011,DFD04086D24122EB0B303CE9A87DF681,31201,20,22,2,109.51042,18.23819,1558
63032,CE70D3AAC3EF6B01DB8A5F34BD94E77D,30651,0,3,3,109.42611,18.385,1232
63033,CE70D3AAC3EF6B01DB8A5F34BD94E77D,30821,3,16,13,109.43681,18.33639,1274
63092,4968BDF068C505E078DCD9BE1053BBFB,31473,15,17,2,109.34792,18.29465,917
63093,4968BDF068C505E078DCD9BE1053BBFB,30771,20,21,1,109.49938,18.26042,1511
63094,4968BDF068C505E078DCD9BE1053BBFB,60331,22,23,1,109.505,18.26507,1512
63107,27BCEF3137923B84211F08830816C810,61011,10,13,3,109.60653,18.19076,1900
63109,27BCEF3137923B84211F08830816C810,61011,15,16,1,109.60653,18.19076,1900
63138,439C404954398764464D854D76F475D8,31041,0,8,8,109.50278,18.23701,1507
63139,439C404954398764464D854D76F475D8,39091,11,13,2,109.50097,18.25222,1510
63140,439C404954398764464D854D76F475D8,38251,14,15,1,109.49618,18.25493,1510
63141,439C404954398764464D854D76F475D8,30581,16,23,7,109.62257,18.24951,1959
63185,91EC74D2B208A10BECBB101C6735C578,31864,0,7,7,109.49014,18.28333,1465
63186,91EC74D2B208A10BECBB101C6735C578,38261,9,10,1,109.50361,18.28153,1515
63187,91EC74D2B208A10BECBB101C6735C578,30421,10,11,1,109.50021,18.25861,1511
63197,4995463B780282C9C030A19D9F49AEAC,30721,0,2,2,109.51597,18.28257,1565
63198,4995463B780282C9C030A19D9F49AEAC,31071,4,8,4,109.58257,18.28458,1815
63199,4995463B780282C9C030A19D9F49AEAC,30854,8,15,7,109.56889,18.27076,1763
63200,4995463B780282C9C030A19D9F49AEAC,31071,16,17,1,109.58257,18.28458,1815
63201,4995463B780282C9C030A19D9F49AEAC,31521,19,21,2,109.51458,18.22542,1555
63202,4995463B780282C9C030A19D9F49AEAC,30854,21,22,1,109.56889,18.27076,1763
63206,5426296000364EE32711CD0E73D782C8,30854,0,1,1,109.56889,18.27076,1763
63207,5426296000364EE32711CD0E73D782C8,31071,5,7,2,109.58257,18.28458,1815
63208,5426296000364EE32711CD0E73D782C8,31561,9,15,6,109.56792,18.28479,1765
63211,2361E8D6BAB0231B2E8E3C0F34517282,30291,0,5,5,109.50403,18.27028,1513
63212,2361E8D6BAB0231B2E8E3C0F34517282,30721,9,11,2,109.51597,18.28257,1565
63213,2361E8D6BAB0231B2E8E3C0F34517282,30081,12,14,2,109.50243,18.26632,1512
63214,2361E8D6BAB0231B2E8E3C0F34517282,60331,15,17,2,109.505,18.26507,1512
63215,2361E8D6BAB0231B2E8E3C0F34517282,30081,20,22,2,109.50243,18.26632,1512
63248,937F0B31443CC6355891AA9D2DB0C670,31561,0,16,16,109.56792,18.28479,1765
63249,937F0B31443CC6355891AA9D2DB0C670,31091,19,20,1,109.41201,18.31222,1170
63313,6F0540B756080DEA0630ADD22B34EFCA,31261,0,7,7,109.51174,18.2466,1559
63314,6F0540B756080DEA0630ADD22B34EFCA,38801,7,18,11,109.51472,18.2584,1561
63315,6F0540B756080DEA0630ADD22B34EFCA,31171,18,23,5,109.50938,18.24917,1559
63327,996C0D9500BF90CC0E7F5A04C49A464B,30921,1,2,1,109.53903,18.29451,1667
63328,996C0D9500BF90CC0E7F5A04C49A464B,39181,5,6,1,109.55153,18.28035,1715
63329,996C0D9500BF90CC0E7F5A04C49A464B,31931,6,19,13,109.54771,18.29403,1667
63336,8C8DB7A18864109B823771C405E00B29,30951,9,17,8,109.56208,18.25667,1761
63337,8C8DB7A18864109B823771C405E00B29,31071,19,22,3,109.58257,18.28458,1815
63338,DA7695571AF860EADFA185350D767F54,38141,0,15,15,109.39479,18.2916,1116
63339,DA7695571AF860EADFA185350D767F54,31671,15,17,2,109.38965,18.29813,1068
63340,DA7695571AF860EADFA185350D767F54,38071,18,21,3,109.40722,18.30938,1169
63385,8A2602EE97ED1F19C3F8048B259C52D2,31521,0,7,7,109.51458,18.22542,1555
63386,8A2602EE97ED1F19C3F8048B259C52D2,60381,8,10,2,109.5241,18.22458,1605
63387,8A2602EE97ED1F19C3F8048B259C52D2,38754,13,14,1,109.74667,18.37382,2430
63388,8A2602EE97ED1F19C3F8048B259C52D2,31521,18,21,3,109.51458,18.22542,1555
63393,30732B1BCE6CCF48F1EA3BFF12855D39,31071,0,2,2,109.58257,18.28458,1815
63394,30732B1BCE6CCF48F1EA3BFF12855D39,30854,4,9,5,109.56889,18.27076,1763
63395,30732B1BCE6CCF48F1EA3BFF12855D39,31071,10,11,1,109.58257,18.28458,1815
63396,30732B1BCE6CCF48F1EA3BFF12855D39,30854,12,13,1,109.56889,18.27076,1763
63397,30732B1BCE6CCF48F1EA3BFF12855D39,30221,14,15,1,109.57833,18.20222,1802
63408,874B1DEE34891BC74B0E782C57027407,30461,1,7,6,109.5116,18.26313,1562
63409,874B1DEE34891BC74B0E782C57027407,30911,10,11,1,109.50493,18.26181,1511
63410,874B1DEE34891BC74B0E782C57027407,38881,12,14,2,109.51618,18.26431,1562
63411,874B1DEE34891BC74B0E782C57027407,60361,19,21,2,109.51938,18.29681,1567
63412,874B1DEE34891BC74B0E782C57027407,30461,21,23,2,109.5116,18.26313,1562
63447,662D882A6A10D0E6C3566690F0A40636,30854,1,14,13,109.56889,18.27076,1763
63448,662D882A6A10D0E6C3566690F0A40636,31221,14,16,2,109.61333,18.26833,1913
63480,88E514C9B989D3BAAAAAC4584CA74239,30821,18,19,1,109.43681,18.33639,1274
63481,88E514C9B989D3BAAAAAC4584CA74239,38951,20,23,3,109.48097,18.28868,1416
63490,A6DE0B8C40477DEE9D4849FDF2121A4D,60504,0,5,5,109.47917,18.28903,1416
63491,A6DE0B8C40477DEE9D4849FDF2121A4D,38951,6,7,1,109.48097,18.28868,1416
63492,A6DE0B8C40477DEE9D4849FDF2121A4D,30971,8,11,3,109.48708,18.29319,1467
63493,A6DE0B8C40477DEE9D4849FDF2121A4D,38951,12,23,11,109.48097,18.28868,1416
63496,6C1B85A5DA00EF7C1AE90EE47B67586A,60311,0,7,7,109.52097,18.24319,1558
63497,6C1B85A5DA00EF7C1AE90EE47B67586A,31031,7,8,1,109.49979,18.25382,1510
63498,6C1B85A5DA00EF7C1AE90EE47B67586A,30951,10,12,2,109.56208,18.25667,1761
63499,6C1B85A5DA00EF7C1AE90EE47B67586A,31421,12,14,2,109.55382,18.22347,1705
63500,6C1B85A5DA00EF7C1AE90EE47B67586A,30951,15,16,1,109.56208,18.25667,1761
63501,6C1B85A5DA00EF7C1AE90EE47B67586A,60311,18,22,4,109.52097,18.24319,1558
63502,B43DB539B5964E15F0064080164C40C1,60631,0,7,7,109.57778,18.27583,1814
63503,B43DB539B5964E15F0064080164C40C1,38052,11,14,3,109.62618,18.23042,1956
63504,B43DB539B5964E15F0064080164C40C1,60631,19,20,1,109.57778,18.27583,1814
63553,B2376BB99A8F8A7FC5A41C7F0EEFB359,31945,0,12,12,109.58021,18.29403,1817
63554,B2376BB99A8F8A7FC5A41C7F0EEFB359,30851,15,17,2,109.5616,18.27396,1713
63555,B2376BB99A8F8A7FC5A41C7F0EEFB359,31945,19,23,4,109.58021,18.29403,1817
63582,0E0D6E55BB1995EBF85F6B7AA8765E55,60631,0,2,2,109.57778,18.27583,1814
63583,0E0D6E55BB1995EBF85F6B7AA8765E55,30854,3,4,1,109.56889,18.27076,1763
63584,0E0D6E55BB1995EBF85F6B7AA8765E55,60631,4,7,3,109.57778,18.27583,1814
63594,AB2757F3465D5BF12D6B9326486D6787,31561,0,7,7,109.56792,18.28479,1765
63595,AB2757F3465D5BF12D6B9326486D6787,39183,10,12,2,109.55542,18.28208,1715
63596,AB2757F3465D5BF12D6B9326486D6787,30571,15,17,2,109.50243,18.21861,1504
63597,D9DC36234BE55D2C1082932A9BD7AF66,31471,14,16,2,109.34583,18.29563,917
63598,D9DC36234BE55D2C1082932A9BD7AF66,38951,19,22,3,109.48097,18.28868,1416
63603,44F505B3929E26B4B29F00CC284F3084,31071,3,7,4,109.58257,18.28458,1815
63604,44F505B3929E26B4B29F00CC284F3084,30854,8,23,15,109.56889,18.27076,1763
63610,C1F9914EF577AE2A8300B1A3945A50FF,31561,1,4,3,109.56792,18.28479,1765
63611,C1F9914EF577AE2A8300B1A3945A50FF,30851,4,7,3,109.5616,18.27396,1713
63612,C1F9914EF577AE2A8300B1A3945A50FF,31561,7,16,9,109.56792,18.28479,1765
63624,15CFA914984D65F8478F81F9B1D1EDF1,30581,0,4,4,109.62257,18.24951,1959
63625,15CFA914984D65F8478F81F9B1D1EDF1,60321,5,6,1,109.63611,18.24306,2008
63626,15CFA914984D65F8478F81F9B1D1EDF1,31841,9,11,2,109.73201,18.33382,2373
63627,1B3A598566348B7D6FD7035DB108D269,30181,0,9,9,109.51597,18.23313,1557
63628,1B3A598566348B7D6FD7035DB108D269,30661,12,14,2,109.37028,18.24361,1008
63629,1B3A598566348B7D6FD7035DB108D269,30181,16,23,7,109.51597,18.23313,1557
63635,B49997E558EBA6E6EDC3CFE777E3F80C,39181,0,7,7,109.55153,18.28035,1715
63636,B49997E558EBA6E6EDC3CFE777E3F80C,39181,11,16,5,109.55153,18.28035,1715
63637,B49997E558EBA6E6EDC3CFE777E3F80C,39181,19,23,4,109.55153,18.28035,1715
63648,4E462508978A46CC849EDD9B946711A1,60381,16,17,1,109.5241,18.22458,1605
63649,4E462508978A46CC849EDD9B946711A1,60361,20,21,1,109.51938,18.29681,1567
63780,BE8220A49F1231C0A022F4AA2075503E,31071,0,4,4,109.58257,18.28458,1815
63781,BE8220A49F1231C0A022F4AA2075503E,30854,8,11,3,109.56889,18.27076,1763
63782,BE8220A49F1231C0A022F4AA2075503E,31945,12,15,3,109.58021,18.29403,1817
63825,3E13064FD790A32F797A7600CB4728A2,31561,0,8,8,109.56792,18.28479,1765
63830,C9524866A6E9E0E3158261DBB1EE420F,38951,0,8,8,109.48097,18.28868,1416
63831,C9524866A6E9E0E3158261DBB1EE420F,30971,8,10,2,109.48708,18.29319,1467
63832,C9524866A6E9E0E3158261DBB1EE420F,38951,13,23,10,109.48097,18.28868,1416
63833,E191BF114A3C2277CB7C3323BAA13F43,31561,1,5,4,109.56792,18.28479,1765
63834,E191BF114A3C2277CB7C3323BAA13F43,30854,6,14,8,109.56889,18.27076,1763
63847,9FC721E86703223349C05C95FE4BBB6F,60087,0,1,1,109.50688,18.22299,1505
63848,9FC721E86703223349C05C95FE4BBB6F,60081,2,10,8,109.51097,18.22639,1556
63849,9FC721E86703223349C05C95FE4BBB6F,60381,11,19,8,109.5241,18.22458,1605
63850,9FC721E86703223349C05C95FE4BBB6F,60087,20,23,3,109.50688,18.22299,1505
63851,5EB30B0DA8B001416D7FFE7A6F67F2E7,31411,0,6,6,109.5016,18.23576,1507
63852,5EB30B0DA8B001416D7FFE7A6F67F2E7,30581,10,11,1,109.62257,18.24951,1959
63854,5EB30B0DA8B001416D7FFE7A6F67F2E7,31041,19,23,4,109.50278,18.23701,1507
63855,3379F8CA3C60221B34F1581AF646427C,38951,0,11,11,109.48097,18.28868,1416
63856,3379F8CA3C60221B34F1581AF646427C,30201,13,14,1,109.4909,18.26465,1462
63857,3379F8CA3C60221B34F1581AF646427C,31351,14,15,1,109.4959,18.28417,1465
63858,3379F8CA3C60221B34F1581AF646427C,30971,19,22,3,109.48708,18.29319,1467
63868,4E5C7D4BC6B840901509F09ECE716731,30681,18,20,2,109.48493,18.26917,1463
63869,4E5C7D4BC6B840901509F09ECE716731,60524,22,23,1,109.42951,18.28993,1216
63881,86823533E32EFBE3843EA59936CEBA25,30291,15,16,1,109.50403,18.27028,1513
63882,86823533E32EFBE3843EA59936CEBA25,38251,19,21,2,109.49618,18.25493,1510
63895,2A39E7A469E1A8EB79BEC03B6E43A857,39183,10,13,3,109.55542,18.28208,1715
63896,2A39E7A469E1A8EB79BEC03B6E43A857,31561,16,21,5,109.56792,18.28479,1765
63906,3C7B93BB0A27C1CE56C61B7C28661B4D,31521,0,12,12,109.51458,18.22542,1555
63907,3C7B93BB0A27C1CE56C61B7C28661B4D,30111,14,18,4,109.47583,18.30542,1419
63908,3C7B93BB0A27C1CE56C61B7C28661B4D,30321,20,23,3,109.49563,18.29611,1467
63935,A8CC84F6441C04DAF82A74609E587ED2,30561,4,5,1,109.52778,18.31938,1621
63936,A8CC84F6441C04DAF82A74609E587ED2,31931,8,9,1,109.54771,18.29403,1667
63937,A8CC84F6441C04DAF82A74609E587ED2,30561,12,13,1,109.52778,18.31938,1621
63938,A8CC84F6441C04DAF82A74609E587ED2,31931,14,15,1,109.54771,18.29403,1667
63971,8554F0A178316702A9146AC053A2336A,39154,0,6,6,109.50201,18.25681,1511
63972,8554F0A178316702A9146AC053A2336A,60381,11,12,1,109.5241,18.22458,1605
63973,8554F0A178316702A9146AC053A2336A,30421,13,14,1,109.50021,18.25861,1511
63974,8554F0A178316702A9146AC053A2336A,30711,14,18,4,109.50271,18.25347,1510
64058,39997DEFFD87AA0C9D18E1194544E438,30891,2,4,2,109.59431,18.28389,1865
64059,39997DEFFD87AA0C9D18E1194544E438,30854,5,15,10,109.56889,18.27076,1763
64060,39997DEFFD87AA0C9D18E1194544E438,30891,18,22,4,109.59431,18.28389,1865
64071,EAC1FFA16DAEE7E9BFF5141167C4613D,31071,0,10,10,109.58257,18.28458,1815
64072,EAC1FFA16DAEE7E9BFF5141167C4613D,30854,13,14,1,109.56889,18.27076,1763
64073,FC6A614D4965712344FE973AE5D670AE,38826,0,3,3,109.50326,18.25514,1510
64074,FC6A614D4965712344FE973AE5D670AE,30421,4,8,4,109.50021,18.25861,1511
64075,FC6A614D4965712344FE973AE5D670AE,31781,9,10,1,109.19847,18.2975,367
64105,10526BE112ADB237730F205D73F11651,31681,0,1,1,109.40396,18.29979,1168
64106,10526BE112ADB237730F205D73F11651,38903,2,6,4,109.39229,18.29243,1117
64107,10526BE112ADB237730F205D73F11651,60552,6,7,1,109.41729,18.30014,1218
64167,E1E11838338C82F354BD58BE0CE18B02,31231,0,10,10,109.42597,18.29292,1217
64168,E1E11838338C82F354BD58BE0CE18B02,38071,13,15,2,109.40722,18.30938,1169
64172,240C7AE62CCCE19BA710707BB926A029,60371,0,3,3,109.53063,18.30056,1618
64173,240C7AE62CCCE19BA710707BB926A029,30071,5,7,2,109.52819,18.30472,1619
64174,240C7AE62CCCE19BA710707BB926A029,31621,8,9,1,109.51035,18.29826,1568
64177,7A43B41ADDC428BDB8DEA80FF49A22D7,30051,14,16,2,109.48917,18.21215,1453
64178,7A43B41ADDC428BDB8DEA80FF49A22D7,30381,17,19,2,109.52521,18.24507,1609
64179,7A43B41ADDC428BDB8DEA80FF49A22D7,31236,20,22,2,109.42965,18.29111,1216
64185,74AD1AF2EA5153BD40BCF9A3F3F2C4E3,30854,12,14,2,109.56889,18.27076,1763
64186,74AD1AF2EA5153BD40BCF9A3F3F2C4E3,31071,16,17,1,109.58257,18.28458,1815
64187,74AD1AF2EA5153BD40BCF9A3F3F2C4E3,30854,20,21,1,109.56889,18.27076,1763
64188,74AD1AF2EA5153BD40BCF9A3F3F2C4E3,31071,21,22,1,109.58257,18.28458,1815
64259,79B6F08E0B8C6978AC15D212F9B7DA57,38951,0,13,13,109.48097,18.28868,1416
64260,79B6F08E0B8C6978AC15D212F9B7DA57,38951,14,16,2,109.48097,18.28868,1416
64290,141EF093A17F7D2104B5D19E539CCBDA,30321,12,23,11,109.49563,18.29611,1467
64291,84DF4A7C208235D171EF56473BCCF210,30851,0,1,1,109.5616,18.27396,1713
64292,84DF4A7C208235D171EF56473BCCF210,31561,3,6,3,109.56792,18.28479,1765
64293,84DF4A7C208235D171EF56473BCCF210,60631,7,8,1,109.57778,18.27583,1814
64294,84DF4A7C208235D171EF56473BCCF210,31864,13,17,4,109.49014,18.28333,1465
64295,84DF4A7C208235D171EF56473BCCF210,30851,20,23,3,109.5616,18.27396,1713
64309,015CDEB9169BCE5537ABAE49B6A63F2B,31071,0,5,5,109.58257,18.28458,1815
64310,015CDEB9169BCE5537ABAE49B6A63F2B,30854,8,17,9,109.56889,18.27076,1763
64311,015CDEB9169BCE5537ABAE49B6A63F2B,60661,18,19,1,109.548,18.2377,1657
64316,BCE29A3A46F5A479B3F0FA50B11216DE,60631,2,8,6,109.57778,18.27583,1814
64317,BCE29A3A46F5A479B3F0FA50B11216DE,30854,9,10,1,109.56889,18.27076,1763
64318,BCE29A3A46F5A479B3F0FA50B11216DE,31071,11,13,2,109.58257,18.28458,1815
64319,1FA4B82215610E27D44D7E787BF2CCFC,38951,0,7,7,109.48097,18.28868,1416
64320,1FA4B82215610E27D44D7E787BF2CCFC,30971,11,12,1,109.48708,18.29319,1467
64321,1FA4B82215610E27D44D7E787BF2CCFC,38951,13,15,2,109.48097,18.28868,1416
64322,1FA4B82215610E27D44D7E787BF2CCFC,38951,19,20,1,109.48097,18.28868,1416
64331,C3071072DB6684DC75BE160268E6323C,30854,1,7,6,109.56889,18.27076,1763
64332,C3071072DB6684DC75BE160268E6323C,60631,11,12,1,109.57778,18.27583,1814
64333,C3071072DB6684DC75BE160268E6323C,30854,12,14,2,109.56889,18.27076,1763
64334,C3071072DB6684DC75BE160268E6323C,31071,16,17,1,109.58257,18.28458,1815
64335,C3071072DB6684DC75BE160268E6323C,30084,21,23,2,109.50118,18.26972,1513
64355,7024F3A14F6F554DC6E80063E30315F0,31561,0,9,9,109.56792,18.28479,1765
64356,7024F3A14F6F554DC6E80063E30315F0,39183,9,18,9,109.55542,18.28208,1715
64373,C336D6DCC64E1B6DB7364EB12E8E8722,31864,18,19,1,109.49014,18.28333,1465
64374,C336D6DCC64E1B6DB7364EB12E8E8722,38094,20,23,3,109.45403,18.28778,1316
64380,BE586ACB441383CC10D7CF3923850B73,60371,16,18,2,109.53063,18.30056,1618
64381,BE586ACB441383CC10D7CF3923850B73,31931,19,21,2,109.54771,18.29403,1667
64382,BE586ACB441383CC10D7CF3923850B73,60371,21,22,1,109.53063,18.30056,1618
64446,F6B0C4B9BFBC5C0F5D704098C64B8B01,31864,8,11,3,109.49014,18.28333,1465
64451,11136C83CACE9221E59CD40325571723,30854,11,13,2,109.56889,18.27076,1763
64452,11136C83CACE9221E59CD40325571723,30571,15,16,1,109.50243,18.21861,1504
64467,0D00E0CA974DDA00224ACCD00B993468,30854,0,16,16,109.56889,18.27076,1763
64468,0D00E0CA974DDA00224ACCD00B993468,31071,20,22,2,109.58257,18.28458,1815
64469,0D00E0CA974DDA00224ACCD00B993468,30851,22,23,1,109.5616,18.27396,1713
64474,87FB240A931190D7195CA3A485DD9E27,60351,0,7,7,109.58403,18.28958,1816
64475,87FB240A931190D7195CA3A485DD9E27,31421,10,11,1,109.55382,18.22347,1705
64476,87FB240A931190D7195CA3A485DD9E27,30951,13,17,4,109.56208,18.25667,1761
64477,87FB240A931190D7195CA3A485DD9E27,60351,19,23,4,109.58403,18.28958,1816
64480,567BF1868FBA42FA9B3B29F2CA13F65D,30221,0,1,1,109.57833,18.20222,1802
64481,567BF1868FBA42FA9B3B29F2CA13F65D,31931,2,11,9,109.54771,18.29403,1667
64482,567BF1868FBA42FA9B3B29F2CA13F65D,30921,16,19,3,109.53903,18.29451,1667
64483,567BF1868FBA42FA9B3B29F2CA13F65D,31931,19,20,1,109.54771,18.29403,1667
64484,567BF1868FBA42FA9B3B29F2CA13F65D,30221,20,22,2,109.57833,18.20222,1802
64485,BD16D1AE4BEC916A65CAE508C1E18FE2,38315,14,16,2,109.48979,18.29764,1467
64486,BD16D1AE4BEC916A65CAE508C1E18FE2,31861,18,19,1,109.49042,18.27549,1464
64487,BD16D1AE4BEC916A65CAE508C1E18FE2,30771,20,22,2,109.49938,18.26042,1511
64498,4D30F99963F81430D842605075346DD5,30361,18,20,2,109.50347,18.24,1508
64499,4D30F99963F81430D842605075346DD5,31431,21,23,2,109.44639,18.29042,1316
64500,F00821368F615DCDAF214035D8EC4A44,31071,2,5,3,109.58257,18.28458,1815
64501,F00821368F615DCDAF214035D8EC4A44,30854,8,17,9,109.56889,18.27076,1763
64502,0B2CDE43D7DE290E07FF365A2D22E5DE,30854,11,12,1,109.56889,18.27076,1763
64524,934029FB5F97BCE114EDCE88F0393A63,30854,0,6,6,109.56889,18.27076,1763
64525,934029FB5F97BCE114EDCE88F0393A63,30234,10,11,1,109.60681,18.29979,1918
64526,934029FB5F97BCE114EDCE88F0393A63,30854,13,23,10,109.56889,18.27076,1763
64527,8D7B9451E0189947198D6AC9CE51CFEE,60391,0,1,1,109.47667,18.28757,1416
64528,8D7B9451E0189947198D6AC9CE51CFEE,30764,2,4,2,109.45806,18.29486,1367
64529,8D7B9451E0189947198D6AC9CE51CFEE,31091,4,18,14,109.41201,18.31222,1170
64530,8D7B9451E0189947198D6AC9CE51CFEE,60391,19,20,1,109.47667,18.28757,1416
64554,96F98526707B06BE1263CCD4F72E07A1,31071,1,8,7,109.58257,18.28458,1815
64555,96F98526707B06BE1263CCD4F72E07A1,31945,10,11,1,109.58021,18.29403,1817
64556,96F98526707B06BE1263CCD4F72E07A1,31071,16,18,2,109.58257,18.28458,1815
64557,96F98526707B06BE1263CCD4F72E07A1,30854,19,20,1,109.56889,18.27076,1763
64603,17AC4F8E6659EB7FBFD30E5467A1D200,38971,0,6,6,109.50743,18.25125,1510
64604,17AC4F8E6659EB7FBFD30E5467A1D200,60571,7,9,2,109.50722,18.25056,1510
64605,17AC4F8E6659EB7FBFD30E5467A1D200,30711,10,11,1,109.50271,18.25347,1510
64606,17AC4F8E6659EB7FBFD30E5467A1D200,31864,12,14,2,109.49014,18.28333,1465
64607,17AC4F8E6659EB7FBFD30E5467A1D200,30711,14,18,4,109.50271,18.25347,1510
64608,17AC4F8E6659EB7FBFD30E5467A1D200,31864,19,20,1,109.49014,18.28333,1465
64609,17AC4F8E6659EB7FBFD30E5467A1D200,30711,21,23,2,109.50271,18.25347,1510
64613,D73D0E1690714CD7F442C709F67E4771,30851,10,13,3,109.5616,18.27396,1713
64614,D73D0E1690714CD7F442C709F67E4771,60361,18,23,5,109.51938,18.29681,1567
64650,F0E7859D5BD715E48CC584AE72D7999E,30121,4,10,6,109.52861,18.27222,1613
64651,F0E7859D5BD715E48CC584AE72D7999E,30854,13,17,4,109.56889,18.27076,1763
64652,F84D949DDCBF25D5530F771BC55E0B9D,61011,0,5,5,109.60653,18.19076,1900
64654,F84D949DDCBF25D5530F771BC55E0B9D,61011,13,21,8,109.60653,18.19076,1900
64655,AD39A6F857F8E578E6A2D9E072C4613F,30201,18,20,2,109.4909,18.26465,1462
64656,AD39A6F857F8E578E6A2D9E072C4613F,30351,20,22,2,109.41701,18.29292,1217
64659,53490AD77ACCA93C3ED0F3DE79CA488B,31071,0,4,4,109.58257,18.28458,1815
64660,53490AD77ACCA93C3ED0F3DE79CA488B,30854,7,8,1,109.56889,18.27076,1763
64661,53490AD77ACCA93C3ED0F3DE79CA488B,31071,10,12,2,109.58257,18.28458,1815
64662,53490AD77ACCA93C3ED0F3DE79CA488B,30854,14,17,3,109.56889,18.27076,1763
64669,6E2021B014C4D0B652A2E4FE8D2CF038,31071,0,7,7,109.58257,18.28458,1815
64670,6E2021B014C4D0B652A2E4FE8D2CF038,30854,10,15,5,109.56889,18.27076,1763
64671,75BB5F056A285E641293B913E6CE7C17,31351,19,20,1,109.4959,18.28417,1465
64672,75BB5F056A285E641293B913E6CE7C17,30201,21,23,2,109.4909,18.26465,1462
64683,C75C3F9BB96630EE8B7793004C08C0A4,31021,0,11,11,109.49021,18.27,1463
64684,C75C3F9BB96630EE8B7793004C08C0A4,39183,13,17,4,109.55542,18.28208,1715
64700,72412073C8C31099732BE7BF67B866F5,31531,1,11,10,109.49583,18.25972,1461
64701,72412073C8C31099732BE7BF67B866F5,38484,13,16,3,109.53028,18.31528,1620
64702,72412073C8C31099732BE7BF67B866F5,38251,20,21,1,109.49618,18.25493,1510
64719,5E58B9A5D572F3495DB1095E03ED0539,31551,0,4,4,109.55868,18.24222,1708
64720,5E58B9A5D572F3495DB1095E03ED0539,60594,7,23,16,109.62694,18.22799,1956
64721,9C1407835BC54BEBDB541F52E1DA1820,61011,2,5,3,109.60653,18.19076,1900
64723,9C1407835BC54BEBDB541F52E1DA1820,61011,8,18,10,109.60653,18.19076,1900
64738,DF7A11C5ED41023DC32CA06344F5707F,38871,0,2,2,109.44681,18.28625,1316
64739,DF7A11C5ED41023DC32CA06344F5707F,31861,4,5,1,109.49042,18.27549,1464
64740,DF7A11C5ED41023DC32CA06344F5707F,31021,6,7,1,109.49021,18.27,1463
64741,DF7A11C5ED41023DC32CA06344F5707F,60401,7,9,2,109.47444,18.27583,1414
64742,DF7A11C5ED41023DC32CA06344F5707F,38334,14,23,9,109.65035,18.23785,2057
64749,9051969BBCBF8B78870D88A07EF566D6,60381,20,22,2,109.5241,18.22458,1605
64837,DBB710D279E76C79F1E4B0766F579F8A,31071,1,14,13,109.58257,18.28458,1815
64838,DBB710D279E76C79F1E4B0766F579F8A,30854,14,17,3,109.56889,18.27076,1763
64839,DBB710D279E76C79F1E4B0766F579F8A,31071,21,22,1,109.58257,18.28458,1815
64864,8799356B7181F28146A203E5F86C52F0,31351,0,7,7,109.4959,18.28417,1465
64865,8799356B7181F28146A203E5F86C52F0,38834,8,21,13,109.47639,18.21146,1403
64866,8799356B7181F28146A203E5F86C52F0,31351,22,23,1,109.4959,18.28417,1465
64867,41F3C3B484933318A782EA0B7EF5AC36,31071,14,16,2,109.58257,18.28458,1815
64868,41F3C3B484933318A782EA0B7EF5AC36,30854,17,23,6,109.56889,18.27076,1763
64872,DC29C676832347947F366933ECB88090,31561,12,13,1,109.56792,18.28479,1765
64873,DC29C676832347947F366933ECB88090,39183,14,17,3,109.55542,18.28208,1715
64874,DC29C676832347947F366933ECB88090,31561,18,23,5,109.56792,18.28479,1765
64895,99CBAA6A65A50998F0A10B72B36210E4,60231,0,6,6,109.49903,18.21972,1504
64896,99CBAA6A65A50998F0A10B72B36210E4,31361,8,9,1,109.47417,18.28292,1415
64897,99CBAA6A65A50998F0A10B72B36210E4,60161,11,12,1,109.49174,18.26181,1461
64923,15D59418DD5A1D712EB453306C200F13,38251,0,7,7,109.49618,18.25493,1510
64924,15D59418DD5A1D712EB453306C200F13,30731,8,10,2,109.50944,18.22306,1555
64925,15D59418DD5A1D712EB453306C200F13,31145,13,15,2,109.20431,18.30479,369
64931,671490F49BCE8273E41F25414F74FB54,60221,0,11,11,109.52569,18.29188,1616
64932,671490F49BCE8273E41F25414F74FB54,31851,15,17,2,109.71736,18.29007,2316
64933,671490F49BCE8273E41F25414F74FB54,60371,18,23,5,109.53063,18.30056,1618
64952,37D38EF0062E64D55C94EB554B76F9EE,30854,12,14,2,109.56889,18.27076,1763
64953,37D38EF0062E64D55C94EB554B76F9EE,31071,19,20,1,109.58257,18.28458,1815
64954,37D38EF0062E64D55C94EB554B76F9EE,30854,21,22,1,109.56889,18.27076,1763
64961,E00EF22F493557E868E52C93194870CF,30854,8,9,1,109.56889,18.27076,1763
64962,E00EF22F493557E868E52C93194870CF,31071,9,11,2,109.58257,18.28458,1815
64963,E00EF22F493557E868E52C93194870CF,30854,12,14,2,109.56889,18.27076,1763
64964,E00EF22F493557E868E52C93194870CF,31071,15,19,4,109.58257,18.28458,1815
65011,7784022BDEFABB0258B32ABBB5E13027,31891,14,16,2,109.71326,18.37569,2330
65012,7784022BDEFABB0258B32ABBB5E13027,38171,21,23,2,109.50799,18.28139,1515
65045,020753EF78F0A0C39658113A3377EA1E,31561,2,6,4,109.56792,18.28479,1765
65046,020753EF78F0A0C39658113A3377EA1E,38153,8,10,2,109.51819,18.25736,1561
65047,020753EF78F0A0C39658113A3377EA1E,31561,12,18,6,109.56792,18.28479,1765
65052,05A57DE8DC0D94268B97E02566D1A0C9,60631,0,8,8,109.57778,18.27583,1814
65053,05A57DE8DC0D94268B97E02566D1A0C9,60351,8,18,10,109.58403,18.28958,1816
65054,05A57DE8DC0D94268B97E02566D1A0C9,60631,21,23,2,109.57778,18.27583,1814
65082,F9B937F9F26C2F09039C158F4674A0AD,30711,0,11,11,109.50271,18.25347,1510
65083,F9B937F9F26C2F09039C158F4674A0AD,60571,11,12,1,109.50722,18.25056,1510
65084,F9B937F9F26C2F09039C158F4674A0AD,30711,12,14,2,109.50271,18.25347,1510
65085,F9B937F9F26C2F09039C158F4674A0AD,60571,14,15,1,109.50722,18.25056,1510
65086,F9B937F9F26C2F09039C158F4674A0AD,30711,15,19,4,109.50271,18.25347,1510
65087,F9B937F9F26C2F09039C158F4674A0AD,30711,19,23,4,109.50271,18.25347,1510
65183,56F818D0924E7BDB02CCC04065747626,38205,0,10,10,109.62743,18.23139,1956
65184,56F818D0924E7BDB02CCC04065747626,38171,14,15,1,109.50799,18.28139,1515
65185,56F818D0924E7BDB02CCC04065747626,38205,18,23,5,109.62743,18.23139,1956
65190,51061B3DE820AF1C1C713EF684728003,31071,0,7,7,109.58257,18.28458,1815
65191,51061B3DE820AF1C1C713EF684728003,30854,7,11,4,109.56889,18.27076,1763
65192,51061B3DE820AF1C1C713EF684728003,31071,12,16,4,109.58257,18.28458,1815
65193,51061B3DE820AF1C1C713EF684728003,30854,20,23,3,109.56889,18.27076,1763
65194,012ABD06F231728C214A4BA917E75B1C,31561,0,4,4,109.56792,18.28479,1765
65195,012ABD06F231728C214A4BA917E75B1C,30851,5,10,5,109.5616,18.27396,1713
65196,012ABD06F231728C214A4BA917E75B1C,31561,11,17,6,109.56792,18.28479,1765
65197,7235447B1B76CF7498ADD1835D8DDC17,38111,1,6,5,109.52007,18.22403,1555
65198,7235447B1B76CF7498ADD1835D8DDC17,38111,7,22,15,109.52007,18.22403,1555
65199,A8E9C7BB918ADAD29A3EA7ACDDCD32D7,38951,0,15,15,109.48097,18.28868,1416
65200,A8E9C7BB918ADAD29A3EA7ACDDCD32D7,38951,16,20,4,109.48097,18.28868,1416
65201,A8E9C7BB918ADAD29A3EA7ACDDCD32D7,38951,20,23,3,109.48097,18.28868,1416
65206,AB25B62B696E140EFF56840EA509FBEC,30854,0,3,3,109.56889,18.27076,1763
65207,AB25B62B696E140EFF56840EA509FBEC,31071,5,7,2,109.58257,18.28458,1815
65208,AB25B62B696E140EFF56840EA509FBEC,30854,7,8,1,109.56889,18.27076,1763
65223,7FC41386BF666F159E200B23AD07CE36,30084,0,7,7,109.50118,18.26972,1513
65224,7FC41386BF666F159E200B23AD07CE36,60117,10,11,1,109.73604,18.35681,2427
65225,7FC41386BF666F159E200B23AD07CE36,38754,11,14,3,109.74667,18.37382,2430
65226,7FC41386BF666F159E200B23AD07CE36,30281,19,20,1,109.50597,18.27583,1514
65227,7FC41386BF666F159E200B23AD07CE36,30084,20,22,2,109.50118,18.26972,1513
65240,7BFBDB733951E97CDC6510F1C40B7948,30661,13,15,2,109.37028,18.24361,1008
65241,7BFBDB733951E97CDC6510F1C40B7948,60411,17,23,6,109.32514,18.30854,869
65246,1980C8D409DE9551539224B3D393CDAA,30071,0,10,10,109.52819,18.30472,1619
65247,1980C8D409DE9551539224B3D393CDAA,30071,10,11,1,109.52819,18.30472,1619
65248,1980C8D409DE9551539224B3D393CDAA,60371,11,13,2,109.53063,18.30056,1618
65249,1980C8D409DE9551539224B3D393CDAA,30071,17,23,6,109.52819,18.30472,1619
65266,65ED412303B1E82EB00C534CD3433EAC,38251,17,18,1,109.49618,18.25493,1510
65267,65ED412303B1E82EB00C534CD3433EAC,30161,18,19,1,109.50042,18.24389,1508
65268,65ED412303B1E82EB00C534CD3433EAC,38111,20,23,3,109.52007,18.22403,1555
65274,635914FBAF9BDB855B8CB450E2AE782A,30051,0,1,1,109.48917,18.21215,1453
65275,635914FBAF9BDB855B8CB450E2AE782A,38834,1,2,1,109.47639,18.21146,1403
65276,635914FBAF9BDB855B8CB450E2AE782A,30051,4,22,18,109.48917,18.21215,1453
65283,D9AE11CD16B231308C3F0FB3F53BC3E9,38241,0,7,7,109.54111,18.30542,1669
65284,D9AE11CD16B231308C3F0FB3F53BC3E9,30854,8,13,5,109.56889,18.27076,1763
65285,D9AE11CD16B231308C3F0FB3F53BC3E9,31071,13,15,2,109.58257,18.28458,1815
65304,ACC390C77025BECAF4CD259D41E8F314,30232,2,14,12,109.6191,18.31701,1971
65305,ACC390C77025BECAF4CD259D41E8F314,30854,16,20,4,109.56889,18.27076,1763
65324,372B6FDE38B899AE3F54A72097165114,39183,0,14,14,109.55542,18.28208,1715
65325,372B6FDE38B899AE3F54A72097165114,31561,14,16,2,109.56792,18.28479,1765
65326,372B6FDE38B899AE3F54A72097165114,39183,17,23,6,109.55542,18.28208,1715
65335,FA0EB766C44C307B69FC2247C53C674E,39151,0,7,7,109.49875,18.25097,1510
65336,FA0EB766C44C307B69FC2247C53C674E,31031,9,12,3,109.49979,18.25382,1510
65337,FA0EB766C44C307B69FC2247C53C674E,39091,12,15,3,109.50097,18.25222,1510
65338,FA0EB766C44C307B69FC2247C53C674E,39151,18,19,1,109.49875,18.25097,1510
65339,FA0EB766C44C307B69FC2247C53C674E,60131,21,23,2,109.49819,18.24778,1509
65363,43E035AE85036EBD9891453E9567CB81,30151,0,7,7,109.50986,18.25083,1560
65364,43E035AE85036EBD9891453E9567CB81,60361,12,15,3,109.51938,18.29681,1567
65365,43E035AE85036EBD9891453E9567CB81,31041,18,20,2,109.50278,18.23701,1507
65366,43E035AE85036EBD9891453E9567CB81,30151,21,23,2,109.50986,18.25083,1560
65412,2371AF49C13083A9B56BAFD9F258B46A,30071,0,1,1,109.52819,18.30472,1619
65413,2371AF49C13083A9B56BAFD9F258B46A,60381,2,4,2,109.5241,18.22458,1605
65414,2371AF49C13083A9B56BAFD9F258B46A,30721,7,14,7,109.51597,18.28257,1565
65436,653802FBFFAEB319D5E2987830A7AC5C,38881,0,7,7,109.51618,18.26431,1562
65437,653802FBFFAEB319D5E2987830A7AC5C,60281,8,10,2,109.51743,18.25924,1561
65438,653802FBFFAEB319D5E2987830A7AC5C,38754,11,13,2,109.74667,18.37382,2430
65439,653802FBFFAEB319D5E2987830A7AC5C,31071,13,14,1,109.58257,18.28458,1815
65440,653802FBFFAEB319D5E2987830A7AC5C,31061,15,16,1,109.53333,18.23257,1607
65441,653802FBFFAEB319D5E2987830A7AC5C,30571,17,19,2,109.50243,18.21861,1504
65442,92E14A6094471B9C1A50CE8585136EC6,30211,0,1,1,109.49882,18.23931,1508
65443,92E14A6094471B9C1A50CE8585136EC6,30161,2,3,1,109.50042,18.24389,1508
65444,92E14A6094471B9C1A50CE8585136EC6,60087,4,11,7,109.50688,18.22299,1505
65445,92E14A6094471B9C1A50CE8585136EC6,30421,13,16,3,109.50021,18.25861,1511
65446,92E14A6094471B9C1A50CE8585136EC6,30861,19,23,4,109.52722,18.22743,1606
65466,12D8E06C2EC8C969710FB791DF137B2B,31071,0,14,14,109.58257,18.28458,1815
65467,12D8E06C2EC8C969710FB791DF137B2B,30854,17,18,1,109.56889,18.27076,1763
65513,7BBB2DDEDB0AE43F8CE7FBD1FCB52741,31071,1,3,2,109.58257,18.28458,1815
65514,7BBB2DDEDB0AE43F8CE7FBD1FCB52741,30854,7,12,5,109.56889,18.27076,1763
65515,7BBB2DDEDB0AE43F8CE7FBD1FCB52741,30571,16,18,2,109.50243,18.21861,1504
65556,51161D5D6D1A3B73044835EE003078F8,31531,0,1,1,109.49583,18.25972,1461
65557,51161D5D6D1A3B73044835EE003078F8,30201,2,9,7,109.4909,18.26465,1462
65558,51161D5D6D1A3B73044835EE003078F8,31561,9,10,1,109.56792,18.28479,1765
65559,51161D5D6D1A3B73044835EE003078F8,30201,14,20,6,109.4909,18.26465,1462
65564,2A5282CF2D793BD3891BB31CAD86ADB8,31471,14,16,2,109.34583,18.29563,917
65565,2A5282CF2D793BD3891BB31CAD86ADB8,31031,17,19,2,109.49979,18.25382,1510
65566,2A5282CF2D793BD3891BB31CAD86ADB8,30271,20,21,1,109.49132,18.23153,1456
65576,D4AA3869830031578B573FD0033C24A8,31931,0,8,8,109.54771,18.29403,1667
65577,D4AA3869830031578B573FD0033C24A8,30921,9,10,1,109.53903,18.29451,1667
65578,D4AA3869830031578B573FD0033C24A8,31931,10,23,13,109.54771,18.29403,1667
65593,377A324496E54511961704972731A3D5,38297,14,16,2,109.52576,18.24965,1609
65594,377A324496E54511961704972731A3D5,31261,20,23,3,109.51174,18.2466,1559
65645,89048436012E137B6C20E2880EE91E56,31471,14,16,2,109.34583,18.29563,917
65646,89048436012E137B6C20E2880EE91E56,60161,21,23,2,109.49174,18.26181,1461
65667,664AAF94F095BCD14233E5648F0324F0,30671,18,20,2,109.43611,18.30139,1268
65712,267866E3C16D42B6BB8A9DF9FAF7C41F,30051,15,16,1,109.48917,18.21215,1453
65713,267866E3C16D42B6BB8A9DF9FAF7C41F,60401,18,19,1,109.47444,18.27583,1414
65714,267866E3C16D42B6BB8A9DF9FAF7C41F,30711,19,23,4,109.50271,18.25347,1510
65727,ED6F7009636BD3F67073E899290E8706,38251,0,8,8,109.49618,18.25493,1510
65728,ED6F7009636BD3F67073E899290E8706,38754,10,11,1,109.74667,18.37382,2430
65729,ED6F7009636BD3F67073E899290E8706,38251,12,23,11,109.49618,18.25493,1510
65779,97310D96003EB3F80B00200829A6C917,31531,0,9,9,109.49583,18.25972,1461
65780,97310D96003EB3F80B00200829A6C917,33051,11,12,1,109.6475,18.46618,2096
65781,97310D96003EB3F80B00200829A6C917,31031,14,15,1,109.49979,18.25382,1510
65782,97310D96003EB3F80B00200829A6C917,31531,15,18,3,109.49583,18.25972,1461
65783,97310D96003EB3F80B00200829A6C917,31534,21,22,1,109.49368,18.25806,1461
65788,A3F1A757214C25A449688115E5C4321B,60371,0,12,12,109.53063,18.30056,1618
65789,A3F1A757214C25A449688115E5C4321B,30071,16,18,2,109.52819,18.30472,1619
65790,A3F1A757214C25A449688115E5C4321B,31931,22,23,1,109.54771,18.29403,1667
65797,32D0EBFA645FCE8DAD65D018847E5043,30232,0,6,6,109.6191,18.31701,1971
65798,32D0EBFA645FCE8DAD65D018847E5043,30854,9,17,8,109.56889,18.27076,1763
65799,32D0EBFA645FCE8DAD65D018847E5043,38171,19,20,1,109.50799,18.28139,1515
65800,32D0EBFA645FCE8DAD65D018847E5043,30854,21,22,1,109.56889,18.27076,1763
65882,528DF0E8B4B73FA0C9FB75037E21B5BA,31931,0,13,13,109.54771,18.29403,1667
65883,528DF0E8B4B73FA0C9FB75037E21B5BA,60241,17,18,1,109.53319,18.28667,1616
65884,528DF0E8B4B73FA0C9FB75037E21B5BA,31931,22,23,1,109.54771,18.29403,1667
65932,9E8746086915F9D4A063A74CF0B5B7AB,39183,16,18,2,109.55542,18.28208,1715
65933,9E8746086915F9D4A063A74CF0B5B7AB,31561,20,22,2,109.56792,18.28479,1765
65964,83F5F6CBF2A63352524671B510BBFB08,30191,0,18,18,109.50361,18.22701,1506
65965,83F5F6CBF2A63352524671B510BBFB08,30854,19,20,1,109.56889,18.27076,1763
65966,83F5F6CBF2A63352524671B510BBFB08,30191,21,23,2,109.50361,18.22701,1506
65979,30D8A678A1441E4FFDF2E3F44AE24060,31071,0,6,6,109.58257,18.28458,1815
65980,30D8A678A1441E4FFDF2E3F44AE24060,30681,9,10,1,109.48493,18.26917,1463
65985,A503639E15A0B5D04B0130D882921438,31031,0,17,17,109.49979,18.25382,1510
65986,A503639E15A0B5D04B0130D882921438,30421,17,20,3,109.50021,18.25861,1511
65987,A503639E15A0B5D04B0130D882921438,31031,20,23,3,109.49979,18.25382,1510
66050,6D9BDE6CAD0A1D083E1A3525B2ECC955,31471,12,14,2,109.34583,18.29563,917
66051,6D9BDE6CAD0A1D083E1A3525B2ECC955,38361,19,21,2,109.43667,18.29201,1267
66054,B7C4E049ABEA8BC374DE2818E1AEEA50,30711,10,14,4,109.50271,18.25347,1510
66055,B7C4E049ABEA8BC374DE2818E1AEEA50,30232,15,16,1,109.6191,18.31701,1971
66056,B7C4E049ABEA8BC374DE2818E1AEEA50,31941,17,18,1,109.62451,18.31222,1970
66062,AC0E940CA4876D60068799AC7DD06B30,31391,0,11,11,109.50382,18.24285,1508
66063,AC0E940CA4876D60068799AC7DD06B30,30281,13,14,1,109.50597,18.27583,1514
66064,AC0E940CA4876D60068799AC7DD06B30,39111,18,20,2,109.5191,18.22597,1555
66085,11111C6844101386CE50DF2BBF6A2434,30181,18,19,1,109.51597,18.23313,1557
66086,11111C6844101386CE50DF2BBF6A2434,31461,21,23,2,109.5091,18.25389,1510
66098,08A066736557478B1013C0CF834491DF,31931,14,15,1,109.54771,18.29403,1667
66099,08A066736557478B1013C0CF834491DF,30921,16,23,7,109.53903,18.29451,1667
66131,00FC332040A284DA251A8D0705989FE9,31071,2,7,5,109.58257,18.28458,1815
66132,00FC332040A284DA251A8D0705989FE9,30854,7,21,14,109.56889,18.27076,1763
66133,00FC332040A284DA251A8D0705989FE9,31071,21,23,2,109.58257,18.28458,1815
66134,96C474E5BFF92BC21432A4ADDD7A543D,30854,1,8,7,109.56889,18.27076,1763
66135,96C474E5BFF92BC21432A4ADDD7A543D,31071,9,11,2,109.58257,18.28458,1815
66136,96C474E5BFF92BC21432A4ADDD7A543D,30854,11,21,10,109.56889,18.27076,1763
66137,96C474E5BFF92BC21432A4ADDD7A543D,31761,22,23,1,109.60521,18.27965,1914
66231,2AE38FAF341950B0B91404FFCE5A0F3E,30921,6,18,12,109.53903,18.29451,1667
66232,2AE38FAF341950B0B91404FFCE5A0F3E,31931,19,22,3,109.54771,18.29403,1667
66236,39F25FE146A03325C93C111F2A943B6C,31945,0,7,7,109.58021,18.29403,1817
66237,39F25FE146A03325C93C111F2A943B6C,31221,9,10,1,109.61333,18.26833,1913
66238,39F25FE146A03325C93C111F2A943B6C,31945,12,13,1,109.58021,18.29403,1817
66239,39F25FE146A03325C93C111F2A943B6C,30854,15,16,1,109.56889,18.27076,1763
66240,39F25FE146A03325C93C111F2A943B6C,31071,16,17,1,109.58257,18.28458,1815
66241,39F25FE146A03325C93C111F2A943B6C,31945,19,20,1,109.58021,18.29403,1817
66245,8DA877D3A30401F86E81FB7BC1CA2A00,30854,0,2,2,109.56889,18.27076,1763
66246,8DA877D3A30401F86E81FB7BC1CA2A00,31071,2,3,1,109.58257,18.28458,1815
66247,8DA877D3A30401F86E81FB7BC1CA2A00,30854,4,6,2,109.56889,18.27076,1763
66248,8DA877D3A30401F86E81FB7BC1CA2A00,31561,9,10,1,109.56792,18.28479,1765
66249,8DA877D3A30401F86E81FB7BC1CA2A00,31071,11,12,1,109.58257,18.28458,1815
66250,8DA877D3A30401F86E81FB7BC1CA2A00,30854,12,19,7,109.56889,18.27076,1763
66326,1E36640BE395A4EE8CCB2697222419A5,30191,0,1,1,109.50361,18.22701,1506
66327,1E36640BE395A4EE8CCB2697222419A5,31071,2,7,5,109.58257,18.28458,1815
66328,1E36640BE395A4EE8CCB2697222419A5,30854,8,11,3,109.56889,18.27076,1763
66329,14AE6C820CE45F96077630992CABD33D,30951,0,18,18,109.56208,18.25667,1761
66330,14AE6C820CE45F96077630992CABD33D,31421,19,23,4,109.55382,18.22347,1705
66350,4952E844CCE6B5C80C460AFAA592A5D2,60491,0,9,9,109.43354,18.30847,1269
66351,4952E844CCE6B5C80C460AFAA592A5D2,60371,11,19,8,109.53063,18.30056,1618
66352,4952E844CCE6B5C80C460AFAA592A5D2,30071,20,21,1,109.52819,18.30472,1619
66356,B34415F599F0ED7D1A073EE314A60B9B,31671,0,10,10,109.38965,18.29813,1068
66357,B34415F599F0ED7D1A073EE314A60B9B,60041,11,12,1,109.39889,18.31944,1121
66358,B34415F599F0ED7D1A073EE314A60B9B,31671,14,23,9,109.38965,18.29813,1068
66359,97F47D5DCCBDDBBC4776678A182515C7,30421,12,14,2,109.50021,18.25861,1511
66360,97F47D5DCCBDDBBC4776678A182515C7,31531,18,23,5,109.49583,18.25972,1461
66393,0CD3A9451B945A7EABB5A7155C5317AC,30711,1,9,8,109.50271,18.25347,1510
66394,0CD3A9451B945A7EABB5A7155C5317AC,30711,12,13,1,109.50271,18.25347,1510
66395,0CD3A9451B945A7EABB5A7155C5317AC,30711,14,18,4,109.50271,18.25347,1510
66396,0CD3A9451B945A7EABB5A7155C5317AC,30421,18,20,2,109.50021,18.25861,1511
66423,EC4B90EDBF35256FDB4D4F8B87DB8A04,31071,0,7,7,109.58257,18.28458,1815
66424,EC4B90EDBF35256FDB4D4F8B87DB8A04,30854,10,22,12,109.56889,18.27076,1763
66442,DFEFB1CD7965FB8E2BDF1B532ED92233,31931,0,8,8,109.54771,18.29403,1667
66443,DFEFB1CD7965FB8E2BDF1B532ED92233,30921,9,12,3,109.53903,18.29451,1667
66444,DFEFB1CD7965FB8E2BDF1B532ED92233,60631,14,17,3,109.57778,18.27583,1814
66445,DFEFB1CD7965FB8E2BDF1B532ED92233,30921,21,23,2,109.53903,18.29451,1667
66466,5A1FDC762E3A00EF6FB4C515806ADF6A,38911,1,2,1,109.51674,18.24965,1559
66467,5A1FDC762E3A00EF6FB4C515806ADF6A,31261,2,7,5,109.51174,18.2466,1559
66468,5A1FDC762E3A00EF6FB4C515806ADF6A,38291,11,12,1,109.51618,18.24313,1558
66469,5A1FDC762E3A00EF6FB4C515806ADF6A,31261,12,14,2,109.51174,18.2466,1559
66470,5A1FDC762E3A00EF6FB4C515806ADF6A,38911,15,17,2,109.51674,18.24965,1559
66471,5A1FDC762E3A00EF6FB4C515806ADF6A,38291,18,19,1,109.51618,18.24313,1558
66472,5A1FDC762E3A00EF6FB4C515806ADF6A,38911,22,23,1,109.51674,18.24965,1559
66493,0D69669D4DBC1CEB06269A084D86E853,30661,11,12,1,109.37028,18.24361,1008
66494,0D69669D4DBC1CEB06269A084D86E853,31471,13,14,1,109.34583,18.29563,917
66495,0D69669D4DBC1CEB06269A084D86E853,31571,16,17,1,109.61563,18.23326,1957
66496,0D69669D4DBC1CEB06269A084D86E853,60214,19,20,1,109.63104,18.24493,2009
66497,0D69669D4DBC1CEB06269A084D86E853,31571,21,23,2,109.61563,18.23326,1957
66498,1FF4421A750C813FA8447B1B3F4E4C2B,31471,14,16,2,109.34583,18.29563,917
66499,1FF4421A750C813FA8447B1B3F4E4C2B,30361,19,21,2,109.50347,18.24,1508
66500,1FF4421A750C813FA8447B1B3F4E4C2B,60614,21,23,2,109.48799,18.29521,1467
66551,59CD1D4AEF7EA7DE0994909193B0D818,30681,0,6,6,109.48493,18.26917,1463
66559,9390F3530298874939B7DDA5575429FD,60401,0,1,1,109.47444,18.27583,1414
66560,9390F3530298874939B7DDA5575429FD,60201,2,8,6,109.5041,18.2509,1510
66561,9390F3530298874939B7DDA5575429FD,39151,9,10,1,109.49875,18.25097,1510
66562,9390F3530298874939B7DDA5575429FD,38251,11,13,2,109.49618,18.25493,1510
66563,9390F3530298874939B7DDA5575429FD,31521,15,17,2,109.51458,18.22542,1555
66564,9390F3530298874939B7DDA5575429FD,60201,17,19,2,109.5041,18.2509,1510
66565,9390F3530298874939B7DDA5575429FD,30421,19,21,2,109.50021,18.25861,1511
66604,7094512B15E4EF60EF67A3E6DEAF677A,60594,0,8,8,109.62694,18.22799,1956
66605,7094512B15E4EF60EF67A3E6DEAF677A,38052,8,12,4,109.62618,18.23042,1956
66606,7094512B15E4EF60EF67A3E6DEAF677A,38052,12,16,4,109.62618,18.23042,1956
66607,7094512B15E4EF60EF67A3E6DEAF677A,38052,17,19,2,109.62618,18.23042,1956
66645,EA446444DFE25212830F95291C13D19D,31931,0,16,16,109.54771,18.29403,1667
66646,EA446444DFE25212830F95291C13D19D,39181,17,18,1,109.55153,18.28035,1715
66647,EA446444DFE25212830F95291C13D19D,31931,19,21,2,109.54771,18.29403,1667
66654,38CF8AD578A393476F29705A4599B8B1,39191,0,1,1,109.51493,18.23472,1557
66655,38CF8AD578A393476F29705A4599B8B1,38891,1,8,7,109.51486,18.24118,1558
66656,38CF8AD578A393476F29705A4599B8B1,60291,12,14,2,109.50826,18.24639,1509
66657,38CF8AD578A393476F29705A4599B8B1,38291,17,18,1,109.51618,18.24313,1558
66658,38CF8AD578A393476F29705A4599B8B1,38271,19,21,2,109.62632,18.23049,1956
66702,AF125EFCC483E24833CBDDBC7248BDF1,31861,18,19,1,109.49042,18.27549,1464
66703,AF125EFCC483E24833CBDDBC7248BDF1,39111,21,23,2,109.5191,18.22597,1555
66708,1B274DBCA220CD483DF90BC3189A9C97,31303,0,7,7,109.15826,18.29549,217
66709,1B274DBCA220CD483DF90BC3189A9C97,60552,9,10,1,109.41729,18.30014,1218
66710,1B274DBCA220CD483DF90BC3189A9C97,30731,14,16,2,109.50944,18.22306,1555
66741,E218C587552A5DADC05C4E69685FE374,30854,19,20,1,109.56889,18.27076,1763
66742,E218C587552A5DADC05C4E69685FE374,39183,21,23,2,109.55542,18.28208,1715
66794,1D8B814EC83D52D7C5F3FED99C129EE0,60631,2,7,5,109.57778,18.27583,1814
66795,1D8B814EC83D52D7C5F3FED99C129EE0,38271,10,19,9,109.62632,18.23049,1956
66811,BE3CBAB86B8807A2A34FBDD31F67422E,31701,17,18,1,109.44132,18.28833,1266
66812,BE3CBAB86B8807A2A34FBDD31F67422E,30201,20,23,3,109.4909,18.26465,1462
66845,2EE87E32F61D076A80AF4573D60352AD,60614,1,8,7,109.48799,18.29521,1467
66846,2EE87E32F61D076A80AF4573D60352AD,38951,9,10,1,109.48097,18.28868,1416
66847,2EE87E32F61D076A80AF4573D60352AD,38951,13,19,6,109.48097,18.28868,1416
66984,2D115D52FDAB55086A12D742071FDFC9,30854,1,7,6,109.56889,18.27076,1763
66985,2D115D52FDAB55086A12D742071FDFC9,30232,9,10,1,109.6191,18.31701,1971
66986,2D115D52FDAB55086A12D742071FDFC9,30854,11,14,3,109.56889,18.27076,1763
66987,2D115D52FDAB55086A12D742071FDFC9,30232,14,17,3,109.6191,18.31701,1971
66988,2D115D52FDAB55086A12D742071FDFC9,30854,18,20,2,109.56889,18.27076,1763
66989,2D115D52FDAB55086A12D742071FDFC9,30232,21,23,2,109.6191,18.31701,1971
67052,0D1E951D9B5BE78A6173DA9864BDF954,30151,3,4,1,109.50986,18.25083,1560
67053,0D1E951D9B5BE78A6173DA9864BDF954,60311,4,14,10,109.52097,18.24319,1558
67054,0D1E951D9B5BE78A6173DA9864BDF954,31261,16,17,1,109.51174,18.2466,1559
67055,0D1E951D9B5BE78A6173DA9864BDF954,30511,17,18,1,109.51069,18.24208,1558
67056,0D1E951D9B5BE78A6173DA9864BDF954,39191,19,21,2,109.51493,18.23472,1557
67097,B29F33564DDA3CFA905BF42633BA4302,60311,14,16,2,109.52097,18.24319,1558
67098,B29F33564DDA3CFA905BF42633BA4302,30151,19,20,1,109.50986,18.25083,1560
67099,B29F33564DDA3CFA905BF42633BA4302,30151,21,22,1,109.50986,18.25083,1560
67105,FCFB14BA36BDB7CD6A39612B9AE933B2,38127,0,4,4,109.50833,18.27222,1513
67106,FCFB14BA36BDB7CD6A39612B9AE933B2,31931,9,10,1,109.54771,18.29403,1667
67107,FCFB14BA36BDB7CD6A39612B9AE933B2,39181,12,13,1,109.55153,18.28035,1715
67108,F8D799D9161B0143E0D71C40472A357E,30071,0,4,4,109.52819,18.30472,1619
67109,F8D799D9161B0143E0D71C40472A357E,31951,5,6,1,109.52174,18.30299,1568
67110,F8D799D9161B0143E0D71C40472A357E,30071,6,11,5,109.52819,18.30472,1619
67111,F8D799D9161B0143E0D71C40472A357E,30071,11,12,1,109.52819,18.30472,1619
67112,F8D799D9161B0143E0D71C40472A357E,31951,12,14,2,109.52174,18.30299,1568
67113,F8D799D9161B0143E0D71C40472A357E,30071,14,16,2,109.52819,18.30472,1619
67120,4DB51FB607DF400B9FA557F761A7BFBF,31701,0,5,5,109.44132,18.28833,1266
67121,4DB51FB607DF400B9FA557F761A7BFBF,38391,6,14,8,109.44111,18.29083,1266
67122,4DB51FB607DF400B9FA557F761A7BFBF,31071,16,17,1,109.58257,18.28458,1815
67147,7BF65E5054DA81A230AB5423620158E1,60631,0,5,5,109.57778,18.27583,1814
67148,7BF65E5054DA81A230AB5423620158E1,30854,7,19,12,109.56889,18.27076,1763
67172,D8757A808F606352AF3AC0BD9CD2C12A,30671,0,6,6,109.43611,18.30139,1268
67173,D8757A808F606352AF3AC0BD9CD2C12A,60491,7,11,4,109.43354,18.30847,1269
67174,D8757A808F606352AF3AC0BD9CD2C12A,30671,11,13,2,109.43611,18.30139,1268
67182,53B443662130EB5C95A209BD2C82316A,30741,0,9,9,109.49833,18.28681,1516
67183,53B443662130EB5C95A209BD2C82316A,60261,10,11,1,109.44326,18.3075,1319
67184,53B443662130EB5C95A209BD2C82316A,30741,11,14,3,109.49833,18.28681,1516
67218,CBA3C8B9B43EEE6240912BCCD5614505,31534,17,19,2,109.49368,18.25806,1461
67219,CBA3C8B9B43EEE6240912BCCD5614505,30391,21,22,1,109.4975,18.27118,1513
67231,079A114D194FE2EFB0C89059CA4EBC03,31251,0,1,1,109.18528,18.2975,317
67233,079A114D194FE2EFB0C89059CA4EBC03,31251,11,13,2,109.18528,18.2975,317
67235,079A114D194FE2EFB0C89059CA4EBC03,31251,17,18,1,109.18528,18.2975,317
67237,079A114D194FE2EFB0C89059CA4EBC03,31251,22,23,1,109.18528,18.2975,317
67275,AAC7E9546787DDB508C41969C1E453E7,30421,0,10,10,109.50021,18.25861,1511
67276,AAC7E9546787DDB508C41969C1E453E7,30711,11,15,4,109.50271,18.25347,1510
67293,2115670ECBCEFE4CA16C55F5204DF607,38127,19,20,1,109.50833,18.27222,1513
67294,2115670ECBCEFE4CA16C55F5204DF607,30721,22,23,1,109.51597,18.28257,1565
67321,A46BA306DAEA889FAC7ACE9E5FD6A1FF,30911,0,2,2,109.50493,18.26181,1511
67322,A46BA306DAEA889FAC7ACE9E5FD6A1FF,39154,3,4,1,109.50201,18.25681,1511
67323,A46BA306DAEA889FAC7ACE9E5FD6A1FF,30911,8,10,2,109.50493,18.26181,1511
67324,A46BA306DAEA889FAC7ACE9E5FD6A1FF,30371,11,12,1,109.51,18.24771,1559
67325,A46BA306DAEA889FAC7ACE9E5FD6A1FF,30911,12,14,2,109.50493,18.26181,1511
67326,A46BA306DAEA889FAC7ACE9E5FD6A1FF,30361,17,18,1,109.50347,18.24,1508
67327,E649CF84A26278291AA1A5B5C5D01FCA,31561,1,7,6,109.56792,18.28479,1765
67328,E649CF84A26278291AA1A5B5C5D01FCA,30854,9,23,14,109.56889,18.27076,1763
67331,6C44DD6A334FD8F5ED58CBD00D571465,39111,0,6,6,109.5191,18.22597,1555
67332,6C44DD6A334FD8F5ED58CBD00D571465,31521,7,9,2,109.51458,18.22542,1555
67333,6C44DD6A334FD8F5ED58CBD00D571465,31311,10,12,2,109.72299,18.27438,2364
67356,C6C3BC01E542B810EF853FEEB6C81198,60361,0,6,6,109.51938,18.29681,1567
67357,C6C3BC01E542B810EF853FEEB6C81198,60221,9,10,1,109.52569,18.29188,1616
67358,C6C3BC01E542B810EF853FEEB6C81198,60361,11,18,7,109.51938,18.29681,1567
67367,14F21534C21254001A38352AD4BB0EF6,31071,0,14,14,109.58257,18.28458,1815
67368,14F21534C21254001A38352AD4BB0EF6,31561,15,20,5,109.56792,18.28479,1765
67402,6C0260646767B781577B5B8CE2471E51,38484,0,1,1,109.53028,18.31528,1620
67403,6C0260646767B781577B5B8CE2471E51,60614,2,3,1,109.48799,18.29521,1467
67404,6C0260646767B781577B5B8CE2471E51,38241,7,9,2,109.54111,18.30542,1669
67405,6C0260646767B781577B5B8CE2471E51,38484,11,22,11,109.53028,18.31528,1620
67446,8F6EA1C108FADA76A214A7ED71ECE3D1,39183,1,4,3,109.55542,18.28208,1715
67447,8F6EA1C108FADA76A214A7ED71ECE3D1,30854,7,18,11,109.56889,18.27076,1763
67448,8F6EA1C108FADA76A214A7ED71ECE3D1,30891,22,23,1,109.59431,18.28389,1865
67462,E5223925311928E13AD79849D459FACD,31864,0,8,8,109.49014,18.28333,1465
67463,E5223925311928E13AD79849D459FACD,31471,9,11,2,109.34583,18.29563,917
67464,E5223925311928E13AD79849D459FACD,30661,14,16,2,109.37028,18.24361,1008
67503,8DEBA8F3DD446F0F0680296AB7E73431,60441,4,5,1,109.46792,18.28604,1366
67504,8DEBA8F3DD446F0F0680296AB7E73431,60472,7,22,15,109.46625,18.29542,1367
67522,6CBD210FE212796CEDBD8FF4BC0A58A4,39183,0,5,5,109.55542,18.28208,1715
67523,6CBD210FE212796CEDBD8FF4BC0A58A4,31931,9,16,7,109.54771,18.29403,1667
67524,6CBD210FE212796CEDBD8FF4BC0A58A4,39183,18,20,2,109.55542,18.28208,1715
67525,6CBD210FE212796CEDBD8FF4BC0A58A4,31931,20,22,2,109.54771,18.29403,1667
67526,6CBD210FE212796CEDBD8FF4BC0A58A4,39183,22,23,1,109.55542,18.28208,1715
67530,FF811E88FEA9CBDF12E5CC54DEE7CCA1,30951,18,20,2,109.56208,18.25667,1761
67531,FF811E88FEA9CBDF12E5CC54DEE7CCA1,30232,21,23,2,109.6191,18.31701,1971
67532,CFFDD1BF3134B9FDD71614F40E1DE0FD,31561,3,4,1,109.56792,18.28479,1765
67533,CFFDD1BF3134B9FDD71614F40E1DE0FD,30854,6,7,1,109.56889,18.27076,1763
67534,CFFDD1BF3134B9FDD71614F40E1DE0FD,31071,8,20,12,109.58257,18.28458,1815
67610,55795AC975E109597451A352D4BE3C61,38911,0,18,18,109.51674,18.24965,1559
67611,55795AC975E109597451A352D4BE3C61,38291,21,22,1,109.51618,18.24313,1558
67617,A515C2BA2B0AE21CADC42FF4E7FC0007,38484,14,15,1,109.53028,18.31528,1620
67618,A515C2BA2B0AE21CADC42FF4E7FC0007,39181,19,22,3,109.55153,18.28035,1715
67619,FE95B3A32EFBC2838F293DF38F55FDD1,31931,0,5,5,109.54771,18.29403,1667
67620,FE95B3A32EFBC2838F293DF38F55FDD1,39183,8,9,1,109.55542,18.28208,1715
67621,FE95B3A32EFBC2838F293DF38F55FDD1,31931,9,10,1,109.54771,18.29403,1667
67622,FE95B3A32EFBC2838F293DF38F55FDD1,39183,13,18,5,109.55542,18.28208,1715
67623,98298A3B656BE6FF1B8BB54146834A14,39101,0,8,8,109.50132,18.24931,1509
67624,98298A3B656BE6FF1B8BB54146834A14,60671,10,11,1,109.52979,18.31757,1621
67625,98298A3B656BE6FF1B8BB54146834A14,60291,13,14,1,109.50826,18.24639,1509
67626,98298A3B656BE6FF1B8BB54146834A14,39101,18,23,5,109.50132,18.24931,1509
67665,FC8552628F8A5A5219C1C30314657039,60661,0,4,4,109.548,18.2377,1657
67666,FC8552628F8A5A5219C1C30314657039,30271,8,9,1,109.49132,18.23153,1456
67690,FDA4F1BDCC2C826EAA49A048FC9F710C,38951,1,6,5,109.48097,18.28868,1416
67691,FDA4F1BDCC2C826EAA49A048FC9F710C,30971,8,11,3,109.48708,18.29319,1467
67692,FDA4F1BDCC2C826EAA49A048FC9F710C,38951,12,19,7,109.48097,18.28868,1416
67696,E8BAAF476E8FE57075BAB1A8D4FF1780,30232,0,5,5,109.6191,18.31701,1971
67697,E8BAAF476E8FE57075BAB1A8D4FF1780,30854,9,21,12,109.56889,18.27076,1763
67698,E8BAAF476E8FE57075BAB1A8D4FF1780,30232,21,23,2,109.6191,18.31701,1971
67728,EBB8C4DC19F3856E93F775E3331F31B3,31521,0,1,1,109.51458,18.22542,1555
67729,EBB8C4DC19F3856E93F775E3331F31B3,30081,1,9,8,109.50243,18.26632,1512
67730,EBB8C4DC19F3856E93F775E3331F31B3,60311,12,14,2,109.52097,18.24319,1558
67731,EBB8C4DC19F3856E93F775E3331F31B3,30181,14,16,2,109.51597,18.23313,1557
67732,EBB8C4DC19F3856E93F775E3331F31B3,30081,18,20,2,109.50243,18.26632,1512
67742,E2A254B664D603859C9454241D0A5D2B,30351,0,6,6,109.41701,18.29292,1217
67743,E2A254B664D603859C9454241D0A5D2B,60381,10,11,1,109.5241,18.22458,1605
67744,E2A254B664D603859C9454241D0A5D2B,39321,12,14,2,109.529,18.2167,1604
67745,E2A254B664D603859C9454241D0A5D2B,31521,15,21,6,109.51458,18.22542,1555
67796,7C16827D646BDC874DE2BD7EE32189C5,60631,1,7,6,109.57778,18.27583,1814
67797,7C16827D646BDC874DE2BD7EE32189C5,30854,11,12,1,109.56889,18.27076,1763
67798,7C16827D646BDC874DE2BD7EE32189C5,30891,12,13,1,109.59431,18.28389,1865
67799,7C16827D646BDC874DE2BD7EE32189C5,30854,18,19,1,109.56889,18.27076,1763
67820,01661942FCE90AF8E243ED68E3EDED24,30861,0,7,7,109.52722,18.22743,1606
67821,01661942FCE90AF8E243ED68E3EDED24,31091,9,10,1,109.41201,18.31222,1170
67822,01661942FCE90AF8E243ED68E3EDED24,31701,11,12,1,109.44132,18.28833,1266
67849,36D79DC35161ADC015B71969A834709A,31841,0,10,10,109.73201,18.33382,2373
67850,36D79DC35161ADC015B71969A834709A,31521,13,14,1,109.51458,18.22542,1555
67853,B03EB6B394C6FA523E27D03BBB015313,30771,14,15,1,109.49938,18.26042,1511
67854,B03EB6B394C6FA523E27D03BBB015313,39154,17,23,6,109.50201,18.25681,1511
67888,CEB7EA5D037E7DFD2A157DEECC6ACC53,31121,3,13,10,109.16292,18.37063,230
67889,CEB7EA5D037E7DFD2A157DEECC6ACC53,30961,15,23,8,109.74042,18.37903,2431
67935,9B979E9430BCD0DDB6C78BBE525EBD2D,60631,2,6,4,109.57778,18.27583,1814
67936,9B979E9430BCD0DDB6C78BBE525EBD2D,30854,8,22,14,109.56889,18.27076,1763
67952,E4C7AB656E412C7E33554D18277C9478,60201,0,1,1,109.5041,18.2509,1510
67953,E4C7AB656E412C7E33554D18277C9478,60291,1,6,5,109.50826,18.24639,1509
67954,E4C7AB656E412C7E33554D18277C9478,30911,8,10,2,109.50493,18.26181,1511
67955,E4C7AB656E412C7E33554D18277C9478,60291,12,14,2,109.50826,18.24639,1509
67956,E4C7AB656E412C7E33554D18277C9478,30511,18,19,1,109.51069,18.24208,1558
67957,E4C7AB656E412C7E33554D18277C9478,31461,20,22,2,109.5091,18.25389,1510
68001,1370C2C3031B43C481D89C3608A5C347,38094,18,23,5,109.45403,18.28778,1316
68015,F82B3BBB77C5FF41C0BBD473F847E370,30891,2,6,4,109.59431,18.28389,1865
68016,F82B3BBB77C5FF41C0BBD473F847E370,39183,10,11,1,109.55542,18.28208,1715
68069,8CD2F16F090DFFBF34897CAC847CB1B1,38991,19,23,4,109.52681,18.30368,1618
68079,1B6EBBFF3B9D8A3E18753343B6A29EAE,31071,0,6,6,109.58257,18.28458,1815
68080,1B6EBBFF3B9D8A3E18753343B6A29EAE,30851,7,11,4,109.5616,18.27396,1713
68081,1B6EBBFF3B9D8A3E18753343B6A29EAE,31071,12,14,2,109.58257,18.28458,1815
68082,1B6EBBFF3B9D8A3E18753343B6A29EAE,30851,15,17,2,109.5616,18.27396,1713
68083,1B6EBBFF3B9D8A3E18753343B6A29EAE,31071,18,23,5,109.58257,18.28458,1815
68084,EC89B2FFE00F967E6D0A3B697A6D636D,30191,0,1,1,109.50361,18.22701,1506
68085,EC89B2FFE00F967E6D0A3B697A6D636D,31201,2,8,6,109.51042,18.23819,1558
68086,EC89B2FFE00F967E6D0A3B697A6D636D,30854,11,16,5,109.56889,18.27076,1763
68087,EC89B2FFE00F967E6D0A3B697A6D636D,31071,16,23,7,109.58257,18.28458,1815
68099,45D6FEED987FF96C23D5532C0D645AC3,38127,0,7,7,109.50833,18.27222,1513
68100,45D6FEED987FF96C23D5532C0D645AC3,30681,7,11,4,109.48493,18.26917,1463
68101,45D6FEED987FF96C23D5532C0D645AC3,38127,12,23,11,109.50833,18.27222,1513
68127,4D4289AE0DFBF4B5C79A47559DC2EBDD,30854,3,16,13,109.56889,18.27076,1763
68128,4D4289AE0DFBF4B5C79A47559DC2EBDD,30741,17,21,4,109.49833,18.28681,1516
68136,68DBE0B52FD0AB95F1DD47068FD7847F,60311,0,8,8,109.52097,18.24319,1558
68137,68DBE0B52FD0AB95F1DD47068FD7847F,30181,8,11,3,109.51597,18.23313,1557
68138,68DBE0B52FD0AB95F1DD47068FD7847F,60311,12,14,2,109.52097,18.24319,1558
68164,D88AE248BE01D22E4DE2A4B556E71166,60054,13,14,1,109.3016,18.31229,770
68165,D88AE248BE01D22E4DE2A4B556E71166,31531,18,23,5,109.49583,18.25972,1461
68172,74206C862E4BA6236E7F7978D63D1D7D,38153,8,11,3,109.51819,18.25736,1561
68173,74206C862E4BA6236E7F7978D63D1D7D,39091,12,13,1,109.50097,18.25222,1510
68174,74206C862E4BA6236E7F7978D63D1D7D,30854,15,18,3,109.56889,18.27076,1763
68191,AF7F14400E2F4B8DDF9B93D022E57629,30561,14,17,3,109.52778,18.31938,1621
68192,AF7F14400E2F4B8DDF9B93D022E57629,30561,20,22,2,109.52778,18.31938,1621
68231,E8DB631088E68D5FF25F35789654CC79,30581,0,14,14,109.62257,18.24951,1959
68232,E8DB631088E68D5FF25F35789654CC79,30391,16,19,3,109.4975,18.27118,1513
68310,BE846F126888513CE6D470563DFBDB18,31554,0,17,17,109.55521,18.2459,1709
68311,BE846F126888513CE6D470563DFBDB18,31031,18,21,3,109.49979,18.25382,1510
68312,BE846F126888513CE6D470563DFBDB18,31554,21,23,2,109.55521,18.2459,1709
68316,066CC6CBB5ADF978A93AF5D0C3292806,30241,2,3,1,109.26174,18.3275,622
68317,066CC6CBB5ADF978A93AF5D0C3292806,31931,4,9,5,109.54771,18.29403,1667
68318,066CC6CBB5ADF978A93AF5D0C3292806,31561,13,16,3,109.56792,18.28479,1765
68319,066CC6CBB5ADF978A93AF5D0C3292806,31931,19,21,2,109.54771,18.29403,1667
68320,066CC6CBB5ADF978A93AF5D0C3292806,30071,22,23,1,109.52819,18.30472,1619
68381,467C8511E86D253BF99620140D63CB78,31143,0,8,8,109.19986,18.29875,368
68382,467C8511E86D253BF99620140D63CB78,31145,8,10,2,109.20431,18.30479,369
68383,467C8511E86D253BF99620140D63CB78,31781,10,11,1,109.19847,18.2975,367
68386,222E0B6922623CE9FBB280F81068D40E,30731,6,7,1,109.50944,18.22306,1555
68387,222E0B6922623CE9FBB280F81068D40E,30571,11,15,4,109.50243,18.21861,1504
68406,46D10B971C10D2856504DC61068F66E7,30281,19,20,1,109.50597,18.27583,1514
68407,46D10B971C10D2856504DC61068F66E7,38991,22,23,1,109.52681,18.30368,1618
68421,8CA8213586CAC00347DCD29330308F27,30921,3,4,1,109.53903,18.29451,1667
68422,8CA8213586CAC00347DCD29330308F27,31931,5,7,2,109.54771,18.29403,1667
68423,8CA8213586CAC00347DCD29330308F27,30921,8,11,3,109.53903,18.29451,1667
68424,8CA8213586CAC00347DCD29330308F27,31931,11,21,10,109.54771,18.29403,1667
68425,0550FDCD60CACF2E05F552DF9A576106,31861,12,16,4,109.49042,18.27549,1464
68426,0550FDCD60CACF2E05F552DF9A576106,30171,16,23,7,109.48458,18.27139,1463
68438,90D91A493F9482486DCC3B27CF3F61EE,30854,0,7,7,109.56889,18.27076,1763
68439,90D91A493F9482486DCC3B27CF3F61EE,31071,11,13,2,109.58257,18.28458,1815
68440,90D91A493F9482486DCC3B27CF3F61EE,30854,15,16,1,109.56889,18.27076,1763
68441,EA4EEEA6F324C3F08DBAE63BA2B33BB6,31261,11,12,1,109.51174,18.2466,1559
68442,EA4EEEA6F324C3F08DBAE63BA2B33BB6,30084,14,23,9,109.50118,18.26972,1513
68456,9BD095517798346F169AD6D898CA1A42,60361,0,18,18,109.51938,18.29681,1567
68457,9BD095517798346F169AD6D898CA1A42,60221,19,21,2,109.52569,18.29188,1616
68458,9BD095517798346F169AD6D898CA1A42,60361,21,23,2,109.51938,18.29681,1567
68472,1C9664F68A8624049BECAF58706F2981,31271,0,10,10,109.48958,18.26257,1462
68473,1C9664F68A8624049BECAF58706F2981,30761,11,13,2,109.45201,18.3,1318
68474,1C9664F68A8624049BECAF58706F2981,60381,14,15,1,109.5241,18.22458,1605
68475,1C9664F68A8624049BECAF58706F2981,38754,16,17,1,109.74667,18.37382,2430
68476,1C9664F68A8624049BECAF58706F2981,60161,20,21,1,109.49174,18.26181,1461
68477,1C9664F68A8624049BECAF58706F2981,60431,21,23,2,109.46139,18.32861,1373
68530,3720DDB8E91BF73FF05637BA50F0661B,31521,0,7,7,109.51458,18.22542,1555
68531,3720DDB8E91BF73FF05637BA50F0661B,30511,9,10,1,109.51069,18.24208,1558
68532,3720DDB8E91BF73FF05637BA50F0661B,31521,11,12,1,109.51458,18.22542,1555
68533,3720DDB8E91BF73FF05637BA50F0661B,30511,12,14,2,109.51069,18.24208,1558
68534,3720DDB8E91BF73FF05637BA50F0661B,31521,14,23,9,109.51458,18.22542,1555
68558,BD5D5103B08534F20AF53FB58E9A43CA,31931,1,3,2,109.54771,18.29403,1667
68559,BD5D5103B08534F20AF53FB58E9A43CA,38241,3,4,1,109.54111,18.30542,1669
68560,BD5D5103B08534F20AF53FB58E9A43CA,31931,5,10,5,109.54771,18.29403,1667
68561,BD5D5103B08534F20AF53FB58E9A43CA,31031,19,20,1,109.49979,18.25382,1510
68562,BD5D5103B08534F20AF53FB58E9A43CA,31931,22,23,1,109.54771,18.29403,1667
68576,DD8DCE806AFFEAC5D779812E5F8F2B3D,31561,0,17,17,109.56792,18.28479,1765
68577,DD8DCE806AFFEAC5D779812E5F8F2B3D,30854,18,20,2,109.56889,18.27076,1763
68578,DD8DCE806AFFEAC5D779812E5F8F2B3D,31561,20,21,1,109.56792,18.28479,1765
68602,104D50A9C0319F25E132948E6191A1E5,30271,0,8,8,109.49132,18.23153,1456
68603,104D50A9C0319F25E132948E6191A1E5,60161,9,11,2,109.49174,18.26181,1461
68604,104D50A9C0319F25E132948E6191A1E5,30271,12,13,1,109.49132,18.23153,1456
68605,104D50A9C0319F25E132948E6191A1E5,30051,15,16,1,109.48917,18.21215,1453
68609,D54FF92D90E0CD41A304344578DE281C,60541,0,6,6,109.4084,18.29208,1167
68610,D54FF92D90E0CD41A304344578DE281C,31091,9,10,1,109.41201,18.31222,1170
68611,D54FF92D90E0CD41A304344578DE281C,30581,15,16,1,109.62257,18.24951,1959
68612,D54FF92D90E0CD41A304344578DE281C,60541,21,23,2,109.4084,18.29208,1167
68644,B023927CBEC0A8053CBDF64A5B76E367,30571,0,3,3,109.50243,18.21861,1504
68645,B023927CBEC0A8053CBDF64A5B76E367,30571,4,7,3,109.50243,18.21861,1504
68646,B023927CBEC0A8053CBDF64A5B76E367,30921,9,11,2,109.53903,18.29451,1667
68647,B023927CBEC0A8053CBDF64A5B76E367,31931,14,17,3,109.54771,18.29403,1667
68668,6815588633DF1E7C6974D1816808CD27,31521,0,10,10,109.51458,18.22542,1555
68669,6815588633DF1E7C6974D1816808CD27,30421,12,13,1,109.50021,18.25861,1511
68670,6815588633DF1E7C6974D1816808CD27,30851,14,15,1,109.5616,18.27396,1713
68713,13104A6A71A054F852B52BB76993ADB2,30854,0,6,6,109.56889,18.27076,1763
68714,13104A6A71A054F852B52BB76993ADB2,30851,6,16,10,109.5616,18.27396,1713
68715,13104A6A71A054F852B52BB76993ADB2,30854,19,23,4,109.56889,18.27076,1763
68758,D4EE8E1A4C04A1FF0596E4221D0B8B42,30854,0,5,5,109.56889,18.27076,1763
68759,D4EE8E1A4C04A1FF0596E4221D0B8B42,31071,6,7,1,109.58257,18.28458,1815
68760,D4EE8E1A4C04A1FF0596E4221D0B8B42,30854,7,17,10,109.56889,18.27076,1763
68761,D4EE8E1A4C04A1FF0596E4221D0B8B42,31071,18,21,3,109.58257,18.28458,1815
68762,D4EE8E1A4C04A1FF0596E4221D0B8B42,30854,21,22,1,109.56889,18.27076,1763
68779,98029F333AC5519D4BA1B7A7F8079304,30861,18,20,2,109.52722,18.22743,1606
68780,98029F333AC5519D4BA1B7A7F8079304,30861,20,23,3,109.52722,18.22743,1606
68832,875F4B80762D0E664890361D764F907D,60081,0,7,7,109.51097,18.22639,1556
68833,875F4B80762D0E664890361D764F907D,30571,7,18,11,109.50243,18.21861,1504
68834,875F4B80762D0E664890361D764F907D,60081,19,23,4,109.51097,18.22639,1556
68902,EA88ED728918442D87692D43C7401C41,31521,15,18,3,109.51458,18.22542,1555
68903,EA88ED728918442D87692D43C7401C41,30191,19,20,1,109.50361,18.22701,1506
69031,C17F2EF1DEA79C8C951E3013EE071B2C,31071,0,8,8,109.58257,18.28458,1815
69032,C17F2EF1DEA79C8C951E3013EE071B2C,30854,12,18,6,109.56889,18.27076,1763
69033,C17F2EF1DEA79C8C951E3013EE071B2C,31071,19,23,4,109.58257,18.28458,1815
69072,737EEDA02FEB0FD167FBB0A5DFAF2866,60361,6,9,3,109.51938,18.29681,1567
69073,737EEDA02FEB0FD167FBB0A5DFAF2866,60581,11,12,1,109.59785,18.29931,1868
69074,737EEDA02FEB0FD167FBB0A5DFAF2866,60241,14,23,9,109.53319,18.28667,1616
69151,F8290DFC7AD7A3BC6FCA7482642F724C,31701,0,1,1,109.44132,18.28833,1266
69152,F8290DFC7AD7A3BC6FCA7482642F724C,38871,1,7,6,109.44681,18.28625,1316
69153,F8290DFC7AD7A3BC6FCA7482642F724C,31781,11,12,1,109.19847,18.2975,367
69154,DE841C2C767041F00D7DAF75FFC633F6,30771,2,5,3,109.49938,18.26042,1511
69155,DE841C2C767041F00D7DAF75FFC633F6,30421,6,21,15,109.50021,18.25861,1511
69156,DE841C2C767041F00D7DAF75FFC633F6,31561,22,23,1,109.56792,18.28479,1765
69188,24E98C0EC4A6054CC486A2611C493128,30854,17,19,2,109.56889,18.27076,1763
69189,24E98C0EC4A6054CC486A2611C493128,38961,22,23,1,109.50847,18.23514,1507
69255,8621CFDF1B89A83351494618C53D033F,39181,2,4,2,109.55153,18.28035,1715
69256,8621CFDF1B89A83351494618C53D033F,39181,5,6,1,109.55153,18.28035,1715
69257,8621CFDF1B89A83351494618C53D033F,39183,11,12,1,109.55542,18.28208,1715
69258,8621CFDF1B89A83351494618C53D033F,31071,12,23,11,109.58257,18.28458,1815
69265,0714D7583345BD7D9A70C3B1EBB51F43,38484,6,7,1,109.53028,18.31528,1620
69277,22B987DE38F8C4435934FE5E6190C4A2,60631,2,5,3,109.57778,18.27583,1814
69278,22B987DE38F8C4435934FE5E6190C4A2,31571,8,21,13,109.61563,18.23326,1957
69281,BE7763F8096EB5A037146E1CC4190538,30854,1,2,1,109.56889,18.27076,1763
69282,BE7763F8096EB5A037146E1CC4190538,30851,4,5,1,109.5616,18.27396,1713
69283,BE7763F8096EB5A037146E1CC4190538,30854,6,8,2,109.56889,18.27076,1763
69284,BE7763F8096EB5A037146E1CC4190538,31561,8,22,14,109.56792,18.28479,1765
69288,5A1C4533F331B639AE5D3D6E2930E30B,31945,0,2,2,109.58021,18.29403,1817
69289,5A1C4533F331B639AE5D3D6E2930E30B,60631,5,6,1,109.57778,18.27583,1814
69290,5A1C4533F331B639AE5D3D6E2930E30B,30854,7,11,4,109.56889,18.27076,1763
69291,5A1C4533F331B639AE5D3D6E2930E30B,31945,11,23,12,109.58021,18.29403,1817
69350,7BADC73A7F08A10826F163710F0B362C,60401,0,8,8,109.47444,18.27583,1414
69351,7BADC73A7F08A10826F163710F0B362C,30341,8,9,1,109.3625,18.29167,966
69352,7BADC73A7F08A10826F163710F0B362C,30661,10,15,5,109.37028,18.24361,1008
69353,7BADC73A7F08A10826F163710F0B362C,60401,20,22,2,109.47444,18.27583,1414
69354,7BADC73A7F08A10826F163710F0B362C,60161,22,23,1,109.49174,18.26181,1461
69367,8B3125BACE32612AE7F9DC5599DC75E6,60081,0,7,7,109.51097,18.22639,1556
69368,8B3125BACE32612AE7F9DC5599DC75E6,60331,12,15,3,109.505,18.26507,1512
69369,8B3125BACE32612AE7F9DC5599DC75E6,30661,16,17,1,109.37028,18.24361,1008
69370,8B3125BACE32612AE7F9DC5599DC75E6,60081,20,23,3,109.51097,18.22639,1556
69393,BA0C44295D246224E442075F9885D682,39151,0,6,6,109.49875,18.25097,1510
69394,BA0C44295D246224E442075F9885D682,60201,8,9,1,109.5041,18.2509,1510
69395,BA0C44295D246224E442075F9885D682,31471,11,13,2,109.34583,18.29563,917
69396,BA0C44295D246224E442075F9885D682,60201,15,23,8,109.5041,18.2509,1510
69428,2E29BE7E21F829BB8E4505964B146371,31561,9,10,1,109.56792,18.28479,1765
69429,2E29BE7E21F829BB8E4505964B146371,30854,10,12,2,109.56889,18.27076,1763
69430,2E29BE7E21F829BB8E4505964B146371,31561,15,16,1,109.56792,18.28479,1765
69431,2E29BE7E21F829BB8E4505964B146371,30854,20,22,2,109.56889,18.27076,1763
69456,2AC2732C54885D0DFCC0189356186E57,60101,20,22,2,109.75465,18.40139,2485
69469,EB316856896788EC8FD871E122E95728,30701,3,7,4,109.59313,18.32007,1871
69470,EB316856896788EC8FD871E122E95728,31811,7,10,3,109.54201,18.31806,1671
69471,EB316856896788EC8FD871E122E95728,30701,12,14,2,109.59313,18.32007,1871
69472,EB316856896788EC8FD871E122E95728,31811,16,19,3,109.54201,18.31806,1671
69473,EB316856896788EC8FD871E122E95728,30701,20,22,2,109.59313,18.32007,1871
69526,971FAC974FC919EB70A5D4943C3307C0,38275,0,5,5,109.62875,18.22938,2006
69527,971FAC974FC919EB70A5D4943C3307C0,38052,6,7,1,109.62618,18.23042,1956
69528,971FAC974FC919EB70A5D4943C3307C0,38052,9,11,2,109.62618,18.23042,1956
69618,FB16AA24AD94D8CC7E1110E44BD68910,60631,19,21,2,109.57778,18.27583,1814
69619,FB16AA24AD94D8CC7E1110E44BD68910,31945,21,23,2,109.58021,18.29403,1817
69643,2DDF3A993BD69F79020EB97CF3A71819,38171,1,6,5,109.50799,18.28139,1515
69644,2DDF3A993BD69F79020EB97CF3A71819,30161,7,16,9,109.50042,18.24389,1508
69645,2DDF3A993BD69F79020EB97CF3A71819,30161,17,19,2,109.50042,18.24389,1508
69646,2DDF3A993BD69F79020EB97CF3A71819,30161,22,23,1,109.50042,18.24389,1508
69670,706B8E0F0F5D1C9FC2F8EBB2574EE89F,30711,0,11,11,109.50271,18.25347,1510
69671,706B8E0F0F5D1C9FC2F8EBB2574EE89F,31461,11,13,2,109.5091,18.25389,1510
69672,706B8E0F0F5D1C9FC2F8EBB2574EE89F,30711,14,19,5,109.50271,18.25347,1510
69673,706B8E0F0F5D1C9FC2F8EBB2574EE89F,31461,19,23,4,109.5091,18.25389,1510
69674,D8898064D7FB8C9B8CE800B6EE2F87B6,30232,0,1,1,109.6191,18.31701,1971
69675,D8898064D7FB8C9B8CE800B6EE2F87B6,30854,2,5,3,109.56889,18.27076,1763
69676,D8898064D7FB8C9B8CE800B6EE2F87B6,39183,6,10,4,109.55542,18.28208,1715
69677,D8898064D7FB8C9B8CE800B6EE2F87B6,30232,14,22,8,109.6191,18.31701,1971
69706,34A1BA5A97F90C4ABB34EDC7004774A9,30851,3,4,1,109.5616,18.27396,1713
69707,34A1BA5A97F90C4ABB34EDC7004774A9,31071,7,16,9,109.58257,18.28458,1815
69708,34A1BA5A97F90C4ABB34EDC7004774A9,30851,18,19,1,109.5616,18.27396,1713
69727,1E3543DF0B1169B9C568FFE53CC2BD25,39321,11,12,1,109.529,18.2167,1604
69728,1E3543DF0B1169B9C568FFE53CC2BD25,39111,13,14,1,109.5191,18.22597,1555
69729,1E3543DF0B1169B9C568FFE53CC2BD25,60054,16,17,1,109.3016,18.31229,770
69737,580E03A111E839B85E7FD8688310DCFE,31071,0,5,5,109.58257,18.28458,1815
69738,580E03A111E839B85E7FD8688310DCFE,30854,7,8,1,109.56889,18.27076,1763
69739,580E03A111E839B85E7FD8688310DCFE,30851,8,9,1,109.5616,18.27396,1713
69740,580E03A111E839B85E7FD8688310DCFE,30854,11,13,2,109.56889,18.27076,1763
69760,66C57C174C13228C3B069E7F4C411F81,31021,4,9,5,109.49021,18.27,1463
69761,66C57C174C13228C3B069E7F4C411F81,60381,13,15,2,109.5241,18.22458,1605
69762,66C57C174C13228C3B069E7F4C411F81,60594,16,17,1,109.62694,18.22799,1956
69768,ADAB51A6D99BADC8222FC392D72ADA01,60281,0,16,16,109.51743,18.25924,1561
69769,ADAB51A6D99BADC8222FC392D72ADA01,38291,16,17,1,109.51618,18.24313,1558
69770,ADAB51A6D99BADC8222FC392D72ADA01,60281,18,23,5,109.51743,18.25924,1561
69776,BCA20A8B84D9B121C8D359C3C95F0C11,39183,15,17,2,109.55542,18.28208,1715
69777,BCA20A8B84D9B121C8D359C3C95F0C11,30854,18,19,1,109.56889,18.27076,1763
69778,BCA20A8B84D9B121C8D359C3C95F0C11,39183,20,23,3,109.55542,18.28208,1715
69792,0547C7536E43628EF24935F0C2BF5E2C,30921,0,6,6,109.53903,18.29451,1667
69793,0547C7536E43628EF24935F0C2BF5E2C,31931,8,18,10,109.54771,18.29403,1667
69794,0547C7536E43628EF24935F0C2BF5E2C,30921,19,23,4,109.53903,18.29451,1667
69823,42C8D372D859B07C8E4F0E073BF1E7C9,31071,6,12,6,109.58257,18.28458,1815
69824,42C8D372D859B07C8E4F0E073BF1E7C9,60631,13,23,10,109.57778,18.27583,1814
69827,5EBEA276FCB4A19AC5C987F5C7CC8908,60552,0,1,1,109.41729,18.30014,1218
69828,5EBEA276FCB4A19AC5C987F5C7CC8908,38361,3,10,7,109.43667,18.29201,1267
69829,5EBEA276FCB4A19AC5C987F5C7CC8908,60552,14,16,2,109.41729,18.30014,1218
69830,5EBEA276FCB4A19AC5C987F5C7CC8908,60401,19,21,2,109.47444,18.27583,1414
69833,F3EA7BB85A440E2BE2D597787EA5279B,30051,0,2,2,109.48917,18.21215,1453
69834,F3EA7BB85A440E2BE2D597787EA5279B,60235,2,3,1,109.49269,18.2253,1455
69835,F3EA7BB85A440E2BE2D597787EA5279B,30051,4,22,18,109.48917,18.21215,1453
69836,F3EA7BB85A440E2BE2D597787EA5279B,38834,22,23,1,109.47639,18.21146,1403
69837,A1E318C80BE4457762B208DEDA1DAC8C,60201,0,3,3,109.5041,18.2509,1510
69838,A1E318C80BE4457762B208DEDA1DAC8C,60281,3,16,13,109.51743,18.25924,1561
69839,93EAC7B29C41BCCE26391CB550587732,31071,0,13,13,109.58257,18.28458,1815
69840,93EAC7B29C41BCCE26391CB550587732,30854,15,16,1,109.56889,18.27076,1763
69841,93EAC7B29C41BCCE26391CB550587732,31071,16,23,7,109.58257,18.28458,1815
69860,5CD05C4F3FA986DCFEC1824F9E061C0E,60281,19,22,3,109.51743,18.25924,1561
69861,5CD05C4F3FA986DCFEC1824F9E061C0E,38291,22,23,1,109.51618,18.24313,1558
69868,7B1A07C39637E996C01DF0A3D287D3C6,30854,2,13,11,109.56889,18.27076,1763
69869,7B1A07C39637E996C01DF0A3D287D3C6,31071,16,17,1,109.58257,18.28458,1815
69877,DB4DF566D4757FF3BB488F82DE126248,30851,7,13,6,109.5616,18.27396,1713
69878,DB4DF566D4757FF3BB488F82DE126248,31561,13,17,4,109.56792,18.28479,1765
69879,DB4DF566D4757FF3BB488F82DE126248,38121,19,21,2,109.51361,18.27813,1564
69880,DB4DF566D4757FF3BB488F82DE126248,31561,21,23,2,109.56792,18.28479,1765
69881,A4132C7C24D4F6CFBC6C091695995585,30631,0,8,8,109.34382,18.32778,922
69882,A4132C7C24D4F6CFBC6C091695995585,31691,8,10,2,109.36604,18.3075,1019
69883,A4132C7C24D4F6CFBC6C091695995585,30631,11,23,12,109.34382,18.32778,922
69907,FBC323A047041F71D8997C22FDE88F17,31521,12,13,1,109.51458,18.22542,1555
69908,FBC323A047041F71D8997C22FDE88F17,30171,15,17,2,109.48458,18.27139,1463
69909,FBC323A047041F71D8997C22FDE88F17,60381,20,21,1,109.5241,18.22458,1605
69919,0312B43ACF9ED1D8304E325E851AEE29,30851,0,9,9,109.5616,18.27396,1713
69920,0312B43ACF9ED1D8304E325E851AEE29,31561,9,10,1,109.56792,18.28479,1765
69921,0312B43ACF9ED1D8304E325E851AEE29,30851,11,23,12,109.5616,18.27396,1713
69928,1FC5887E4053936D3ED4D738338DC172,30121,0,7,7,109.52861,18.27222,1613
69929,1FC5887E4053936D3ED4D738338DC172,30951,8,20,12,109.56208,18.25667,1761
69930,1FC5887E4053936D3ED4D738338DC172,30851,20,21,1,109.5616,18.27396,1713
69979,6AA41B84CB33A922FFCBD7C059C1E8E3,30711,18,20,2,109.50271,18.25347,1510
70040,546CDF54295FA26EB9BE77C234A54BAC,38241,0,8,8,109.54111,18.30542,1669
70041,546CDF54295FA26EB9BE77C234A54BAC,30854,8,18,10,109.56889,18.27076,1763
70122,94C3DFE92C5BC50C77E9644C9B093F96,30511,0,3,3,109.51069,18.24208,1558
70123,94C3DFE92C5BC50C77E9644C9B093F96,60087,3,6,3,109.50688,18.22299,1505
70171,B7A2800FDF738E1064EAD2A5E58F7A3C,61011,0,14,14,109.60653,18.19076,1900
70187,0C8D15C0488D521680F0DE3A28CFE111,31811,0,5,5,109.54201,18.31806,1671
70188,0C8D15C0488D521680F0DE3A28CFE111,30701,7,8,1,109.59313,18.32007,1871
70189,0C8D15C0488D521680F0DE3A28CFE111,31811,9,10,1,109.54201,18.31806,1671
70190,0C8D15C0488D521680F0DE3A28CFE111,30701,13,23,10,109.59313,18.32007,1871
70197,B91A19B1FD9FC6BA8C6D18C2634BCD94,60594,0,11,11,109.62694,18.22799,1956
70198,B91A19B1FD9FC6BA8C6D18C2634BCD94,38052,13,15,2,109.62618,18.23042,1956
70207,9EDFD2B8D3582651294FE5EAE6936C28,31071,0,1,1,109.58257,18.28458,1815
70208,9EDFD2B8D3582651294FE5EAE6936C28,30891,2,5,3,109.59431,18.28389,1865
70209,9EDFD2B8D3582651294FE5EAE6936C28,30854,9,12,3,109.56889,18.27076,1763
70210,CA3896FB33E9BC68E91955EDFF5D709B,31945,9,10,1,109.58021,18.29403,1817
70211,CA3896FB33E9BC68E91955EDFF5D709B,60631,11,13,2,109.57778,18.27583,1814
70224,64F4CDF664AA04E7B79DE93C57128CF6,31931,0,6,6,109.54771,18.29403,1667
70225,64F4CDF664AA04E7B79DE93C57128CF6,39183,7,10,3,109.55542,18.28208,1715
70226,64F4CDF664AA04E7B79DE93C57128CF6,31931,12,13,1,109.54771,18.29403,1667
70227,64F4CDF664AA04E7B79DE93C57128CF6,30071,16,17,1,109.52819,18.30472,1619
70228,64F4CDF664AA04E7B79DE93C57128CF6,60361,19,20,1,109.51938,18.29681,1567
70248,6B806948BC9187A91D033B4096721B00,31561,1,5,4,109.56792,18.28479,1765
70249,6B806948BC9187A91D033B4096721B00,30851,9,10,1,109.5616,18.27396,1713
70250,6B806948BC9187A91D033B4096721B00,31071,11,19,8,109.58257,18.28458,1815
70251,6B806948BC9187A91D033B4096721B00,31561,21,22,1,109.56792,18.28479,1765
70260,DE5024DB59D5BF6AE5857A85EB7680EA,31071,2,7,5,109.58257,18.28458,1815
70261,DE5024DB59D5BF6AE5857A85EB7680EA,30854,9,19,10,109.56889,18.27076,1763
70279,D97A48FFEC6EDAD02D62F5D217EED3AD,60161,0,1,1,109.49174,18.26181,1461
70280,D97A48FFEC6EDAD02D62F5D217EED3AD,60401,2,8,6,109.47444,18.27583,1414
70281,D97A48FFEC6EDAD02D62F5D217EED3AD,60161,8,11,3,109.49174,18.26181,1461
70282,D97A48FFEC6EDAD02D62F5D217EED3AD,30711,13,17,4,109.50271,18.25347,1510
70283,D97A48FFEC6EDAD02D62F5D217EED3AD,31031,19,21,2,109.49979,18.25382,1510
70284,D97A48FFEC6EDAD02D62F5D217EED3AD,60401,22,23,1,109.47444,18.27583,1414
70350,617D274C6203C3080475711DB0A2A53F,60381,16,18,2,109.5241,18.22458,1605
70351,617D274C6203C3080475711DB0A2A53F,31521,19,20,1,109.51458,18.22542,1555
70352,617D274C6203C3080475711DB0A2A53F,31521,22,23,1,109.51458,18.22542,1555
70383,E65658506C2BF9C993BA69EE6D38B3C6,30771,10,14,4,109.49938,18.26042,1511
70384,E65658506C2BF9C993BA69EE6D38B3C6,31561,19,20,1,109.56792,18.28479,1765
70408,B3A1AC27CB357708CE63D3E4F68BF2E7,31071,7,9,2,109.58257,18.28458,1815
70409,B3A1AC27CB357708CE63D3E4F68BF2E7,30854,10,11,1,109.56889,18.27076,1763
70410,B3A1AC27CB357708CE63D3E4F68BF2E7,31071,13,22,9,109.58257,18.28458,1815
70413,E292D83051830D054E89D209EEABA4B9,39183,0,2,2,109.55542,18.28208,1715
70414,E292D83051830D054E89D209EEABA4B9,31561,4,23,19,109.56792,18.28479,1765
70493,14DC9638CB494ECD60B58F300BAA61B6,39181,0,8,8,109.55153,18.28035,1715
70494,14DC9638CB494ECD60B58F300BAA61B6,39183,12,13,1,109.55542,18.28208,1715
70495,14DC9638CB494ECD60B58F300BAA61B6,39181,15,23,8,109.55153,18.28035,1715
70570,2B8C748A18FA7D08D4335AD7C9DEF01B,31761,0,5,5,109.60521,18.27965,1914
70571,2B8C748A18FA7D08D4335AD7C9DEF01B,31421,7,8,1,109.55382,18.22347,1705
70572,2B8C748A18FA7D08D4335AD7C9DEF01B,30851,11,13,2,109.5616,18.27396,1713
70573,2B8C748A18FA7D08D4335AD7C9DEF01B,30951,13,15,2,109.56208,18.25667,1761
70574,2B8C748A18FA7D08D4335AD7C9DEF01B,31761,18,23,5,109.60521,18.27965,1914
70644,95D10836D378F422E54903464C65FC37,60221,18,21,3,109.52569,18.29188,1616
70645,95D10836D378F422E54903464C65FC37,60524,22,23,1,109.42951,18.28993,1216
70655,3977578BE56276DA0700B04B81DC1356,30851,13,14,1,109.5616,18.27396,1713
70656,3977578BE56276DA0700B04B81DC1356,31561,14,23,9,109.56792,18.28479,1765
70709,AD608A919061B1C684914F8654FB2493,60231,10,11,1,109.49903,18.21972,1504
70710,AD608A919061B1C684914F8654FB2493,30271,12,14,2,109.49132,18.23153,1456
70726,0133DDFFB5CECBB261CEDEF10A82D50B,31561,0,6,6,109.56792,18.28479,1765
70727,0133DDFFB5CECBB261CEDEF10A82D50B,30854,10,11,1,109.56889,18.27076,1763
70728,0133DDFFB5CECBB261CEDEF10A82D50B,31071,12,14,2,109.58257,18.28458,1815
70729,0133DDFFB5CECBB261CEDEF10A82D50B,31561,15,22,7,109.56792,18.28479,1765
70730,44A75810FF8F9221047E9675BDBF60A2,31071,0,17,17,109.58257,18.28458,1815
70731,44A75810FF8F9221047E9675BDBF60A2,30854,19,21,2,109.56889,18.27076,1763
70746,B5111A17FE99EC54DAC2FDD550B4E7BA,38017,0,5,5,109.49729,18.21424,1504
70747,B5111A17FE99EC54DAC2FDD550B4E7BA,31781,8,13,5,109.19847,18.2975,367
70748,B5111A17FE99EC54DAC2FDD550B4E7BA,38017,15,17,2,109.49729,18.21424,1504
70749,B5111A17FE99EC54DAC2FDD550B4E7BA,30711,19,20,1,109.50271,18.25347,1510
70750,B5111A17FE99EC54DAC2FDD550B4E7BA,38013,21,22,1,109.49514,18.21951,1454
70760,CD3792A09620ACF9CFFC016A0AC519A8,31864,11,13,2,109.49014,18.28333,1465
70761,CD3792A09620ACF9CFFC016A0AC519A8,38951,13,18,5,109.48097,18.28868,1416
70777,0E129C09250C0D46273B4BD7E5225556,30151,0,6,6,109.50986,18.25083,1560
70778,0E129C09250C0D46273B4BD7E5225556,60201,6,9,3,109.5041,18.2509,1510
70779,0E129C09250C0D46273B4BD7E5225556,60441,13,15,2,109.46792,18.28604,1366
70780,0E129C09250C0D46273B4BD7E5225556,60281,18,20,2,109.51743,18.25924,1561
70781,0E129C09250C0D46273B4BD7E5225556,30421,21,23,2,109.50021,18.25861,1511
70800,34CF23DE302849FAEFC3E94752360498,60171,0,8,8,109.51292,18.30694,1569
70801,34CF23DE302849FAEFC3E94752360498,38754,12,14,2,109.74667,18.37382,2430
70802,34CF23DE302849FAEFC3E94752360498,60171,15,23,8,109.51292,18.30694,1569
70818,E6312CBC8153A9C6DAB83670095D0D25,33051,13,14,1,109.6475,18.46618,2096
70819,E6312CBC8153A9C6DAB83670095D0D25,38951,15,23,8,109.48097,18.28868,1416
70824,60EEF6C7C67C0F42D81D84D28D87EF6D,60054,13,14,1,109.3016,18.31229,770
70825,60EEF6C7C67C0F42D81D84D28D87EF6D,60541,16,21,5,109.4084,18.29208,1167
70829,3F80F6C7ECC59E36D89C8EF1746C8724,60081,0,3,3,109.51097,18.22639,1556
70830,3F80F6C7ECC59E36D89C8EF1746C8724,38121,4,13,9,109.51361,18.27813,1564
70831,3F80F6C7ECC59E36D89C8EF1746C8724,31021,16,17,1,109.49021,18.27,1463
70832,3F80F6C7ECC59E36D89C8EF1746C8724,31205,19,20,1,109.51111,18.23736,1557
70833,3F80F6C7ECC59E36D89C8EF1746C8724,38061,21,23,2,109.50597,18.23118,1506
70866,C709D01469E0800AF998DFAF42105CDC,30854,0,14,14,109.56889,18.27076,1763
70867,C709D01469E0800AF998DFAF42105CDC,60631,14,15,1,109.57778,18.27583,1814
70868,C709D01469E0800AF998DFAF42105CDC,30854,15,23,8,109.56889,18.27076,1763
70884,3E8D95DB166242F89F212C4CA8890528,60241,0,6,6,109.53319,18.28667,1616
70885,3E8D95DB166242F89F212C4CA8890528,38171,7,8,1,109.50799,18.28139,1515
70886,3E8D95DB166242F89F212C4CA8890528,30281,9,12,3,109.50597,18.27583,1514
70894,173CD7A2B7B334BC53A50A1D248FBCFE,30854,5,9,4,109.56889,18.27076,1763
70895,173CD7A2B7B334BC53A50A1D248FBCFE,31071,9,10,1,109.58257,18.28458,1815
70896,173CD7A2B7B334BC53A50A1D248FBCFE,30854,14,21,7,109.56889,18.27076,1763
70897,451E2BF48CD7B253EB0892324E679BCC,31461,0,2,2,109.5091,18.25389,1510
70898,451E2BF48CD7B253EB0892324E679BCC,38291,7,23,16,109.51618,18.24313,1558
70907,4DB778A581941E2A7955D8DA3B7ADAFE,31931,2,7,5,109.54771,18.29403,1667
70908,4DB778A581941E2A7955D8DA3B7ADAFE,60114,9,17,8,109.73028,18.33847,2374
70936,387C2BFABED9CD0C7C45EBAD5F5242F9,31431,19,23,4,109.44639,18.29042,1316
70983,DDE77D3A656666992FC3458B84010D43,39183,13,14,1,109.55542,18.28208,1715
70984,DDE77D3A656666992FC3458B84010D43,31561,18,19,1,109.56792,18.28479,1765
71019,23637043AC9FEDF453218B0EC2A97702,38801,0,14,14,109.51472,18.2584,1561
71020,23637043AC9FEDF453218B0EC2A97702,31061,14,16,2,109.53333,18.23257,1607
71021,38A8595594DC26AD8BE733FC85DB4CA6,31631,0,9,9,109.59542,18.36826,1879
71022,38A8595594DC26AD8BE733FC85DB4CA6,30101,9,11,2,109.57299,18.33333,1773
71023,38A8595594DC26AD8BE733FC85DB4CA6,31631,11,16,5,109.59542,18.36826,1879
71024,38A8595594DC26AD8BE733FC85DB4CA6,30101,17,18,1,109.57299,18.33333,1773
71025,38A8595594DC26AD8BE733FC85DB4CA6,31631,19,23,4,109.59542,18.36826,1879
71042,2C3BD53A8702A47FB82F05FB4993B683,31561,0,14,14,109.56792,18.28479,1765
71043,2C3BD53A8702A47FB82F05FB4993B683,30854,14,18,4,109.56889,18.27076,1763
71044,2C3BD53A8702A47FB82F05FB4993B683,31561,20,23,3,109.56792,18.28479,1765
71065,521A7ED98375837397B112E54A372514,31431,0,4,4,109.44639,18.29042,1316
71066,521A7ED98375837397B112E54A372514,60234,7,11,4,109.49577,18.2096,1453
71067,521A7ED98375837397B112E54A372514,38017,12,14,2,109.49729,18.21424,1504
71068,521A7ED98375837397B112E54A372514,38017,16,18,2,109.49729,18.21424,1504
71069,521A7ED98375837397B112E54A372514,38017,19,20,1,109.49729,18.21424,1504
71070,521A7ED98375837397B112E54A372514,38291,21,22,1,109.51618,18.24313,1558
71074,DB0EF690DC781F73956987AB22EA398D,38361,1,8,7,109.43667,18.29201,1267
71075,DB0EF690DC781F73956987AB22EA398D,60131,12,13,1,109.49819,18.24778,1509
71076,DB0EF690DC781F73956987AB22EA398D,38251,14,16,2,109.49618,18.25493,1510
71077,DB0EF690DC781F73956987AB22EA398D,60081,17,19,2,109.51097,18.22639,1556
71078,DB0EF690DC781F73956987AB22EA398D,39151,20,21,1,109.49875,18.25097,1510
71079,DB0EF690DC781F73956987AB22EA398D,38361,22,23,1,109.43667,18.29201,1267
71099,283001ED673D8EDBEF7EEB00BDB31533,31181,6,18,12,109.50382,18.24813,1509
71100,283001ED673D8EDBEF7EEB00BDB31533,30571,19,22,3,109.50243,18.21861,1504
71107,FA44C74EF9DE654EAA8C2322E5CCBD29,31071,0,1,1,109.58257,18.28458,1815
71108,FA44C74EF9DE654EAA8C2322E5CCBD29,31761,3,4,1,109.60521,18.27965,1914
71109,FA44C74EF9DE654EAA8C2322E5CCBD29,31071,5,23,18,109.58257,18.28458,1815
71121,42923D86FCA39B981325B127230BF145,30232,0,2,2,109.6191,18.31701,1971
71122,42923D86FCA39B981325B127230BF145,39183,3,6,3,109.55542,18.28208,1715
71123,42923D86FCA39B981325B127230BF145,60084,8,9,1,109.4984,18.2334,1507
71124,42923D86FCA39B981325B127230BF145,30232,13,15,2,109.6191,18.31701,1971
71125,42923D86FCA39B981325B127230BF145,30854,16,22,6,109.56889,18.27076,1763
71172,0E1B3CFC64EBB658DA96D0DCA834701E,61011,14,18,4,109.60653,18.19076,1900
71174,0E1B3CFC64EBB658DA96D0DCA834701E,61011,21,23,2,109.60653,18.19076,1900
71212,202870BA524F8D7E9C1B66336BF1F034,38991,0,1,1,109.52681,18.30368,1618
71213,202870BA524F8D7E9C1B66336BF1F034,31951,2,5,3,109.52174,18.30299,1568
71214,202870BA524F8D7E9C1B66336BF1F034,30854,6,8,2,109.56889,18.27076,1763
71215,202870BA524F8D7E9C1B66336BF1F034,60631,8,10,2,109.57778,18.27583,1814
71216,202870BA524F8D7E9C1B66336BF1F034,30854,11,12,1,109.56889,18.27076,1763
71217,202870BA524F8D7E9C1B66336BF1F034,60631,14,18,4,109.57778,18.27583,1814
71238,D39D64452E6BBEF7B3056CA239E1B86E,30854,0,8,8,109.56889,18.27076,1763
71239,D39D64452E6BBEF7B3056CA239E1B86E,31561,10,12,2,109.56792,18.28479,1765
71240,D39D64452E6BBEF7B3056CA239E1B86E,30854,12,14,2,109.56889,18.27076,1763
71241,D39D64452E6BBEF7B3056CA239E1B86E,31561,16,17,1,109.56792,18.28479,1765
71242,D39D64452E6BBEF7B3056CA239E1B86E,30854,18,23,5,109.56889,18.27076,1763
71275,FC294DFCE86FDA84EAB1A8B689598D0A,31061,0,7,7,109.53333,18.23257,1607
71276,FC294DFCE86FDA84EAB1A8B689598D0A,31421,8,9,1,109.55382,18.22347,1705
71277,FC294DFCE86FDA84EAB1A8B689598D0A,31471,12,14,2,109.34583,18.29563,917
71278,FC294DFCE86FDA84EAB1A8B689598D0A,31061,18,22,4,109.53333,18.23257,1607
71333,1FE2866848043A2C10AD87212485FE15,31071,1,6,5,109.58257,18.28458,1815
71334,1FE2866848043A2C10AD87212485FE15,30854,7,23,16,109.56889,18.27076,1763
71335,E83EC074941D17DADC663DD9B609F59B,60594,0,11,11,109.62694,18.22799,1956
71336,E83EC074941D17DADC663DD9B609F59B,31221,12,14,2,109.61333,18.26833,1913
71337,E83EC074941D17DADC663DD9B609F59B,38052,14,15,1,109.62618,18.23042,1956
71338,E83EC074941D17DADC663DD9B609F59B,38315,16,17,1,109.48979,18.29764,1467
71349,EE2D2ED68925B4E9F21AFD9C2C986E95,39091,17,19,2,109.50097,18.25222,1510
71365,EE9ED89488CC5A6EB73A10F5D2E75FDB,60131,0,9,9,109.49819,18.24778,1509
71366,EE9ED89488CC5A6EB73A10F5D2E75FDB,33051,13,16,3,109.6475,18.46618,2096
71367,EE9ED89488CC5A6EB73A10F5D2E75FDB,38017,19,23,4,109.49729,18.21424,1504
71410,CD576F1C1CDFB89E6A99A20E65927346,30854,1,2,1,109.56889,18.27076,1763
71411,CD576F1C1CDFB89E6A99A20E65927346,31071,3,4,1,109.58257,18.28458,1815
71412,CD576F1C1CDFB89E6A99A20E65927346,31561,7,11,4,109.56792,18.28479,1765
71413,CD576F1C1CDFB89E6A99A20E65927346,30854,12,13,1,109.56889,18.27076,1763
71414,CD576F1C1CDFB89E6A99A20E65927346,31561,13,18,5,109.56792,18.28479,1765
71443,B712327B6033C61F37801CFD6DAC08AD,38484,1,3,2,109.53028,18.31528,1620
71444,B712327B6033C61F37801CFD6DAC08AD,31951,4,5,1,109.52174,18.30299,1568
71445,B712327B6033C61F37801CFD6DAC08AD,38484,6,14,8,109.53028,18.31528,1620
71459,DBF0ED639264742A7D5519236AB61C61,60071,0,11,11,109.75674,18.31583,2470
71460,DBF0ED639264742A7D5519236AB61C61,30211,14,16,2,109.49882,18.23931,1508
71461,DBF0ED639264742A7D5519236AB61C61,39151,18,21,3,109.49875,18.25097,1510
71467,DC2D9D389C76C3C3F81B17488EA05107,60201,15,19,4,109.5041,18.2509,1510
71468,DC2D9D389C76C3C3F81B17488EA05107,30201,20,21,1,109.4909,18.26465,1462
71469,DC2D9D389C76C3C3F81B17488EA05107,60201,21,23,2,109.5041,18.2509,1510
71485,63FBAC0202144B00077561285E6A7F87,30651,0,3,3,109.42611,18.385,1232
71486,63FBAC0202144B00077561285E6A7F87,30821,3,6,3,109.43681,18.33639,1274
71487,63FBAC0202144B00077561285E6A7F87,30651,8,9,1,109.42611,18.385,1232
71488,63FBAC0202144B00077561285E6A7F87,30821,9,15,6,109.43681,18.33639,1274
71489,63FBAC0202144B00077561285E6A7F87,30651,15,17,2,109.42611,18.385,1232
71490,63FBAC0202144B00077561285E6A7F87,30821,19,23,4,109.43681,18.33639,1274
71508,070984703178D21DC5287E457C03691A,39183,14,15,1,109.55542,18.28208,1715
71509,070984703178D21DC5287E457C03691A,39181,19,23,4,109.55153,18.28035,1715
71572,9E2CAA912E7C38B3460AB2C8B985CA0D,31761,18,20,2,109.60521,18.27965,1914
71573,9E2CAA912E7C38B3460AB2C8B985CA0D,31071,21,23,2,109.58257,18.28458,1815
71577,A1DF9124AA1AFE28F8679C4665FBFAB7,30771,0,1,1,109.49938,18.26042,1511
71578,A1DF9124AA1AFE28F8679C4665FBFAB7,31534,1,6,5,109.49368,18.25806,1461
71579,A1DF9124AA1AFE28F8679C4665FBFAB7,30421,6,8,2,109.50021,18.25861,1511
71580,A1DF9124AA1AFE28F8679C4665FBFAB7,60201,8,9,1,109.5041,18.2509,1510
71581,A1DF9124AA1AFE28F8679C4665FBFAB7,60441,13,15,2,109.46792,18.28604,1366
71582,A1DF9124AA1AFE28F8679C4665FBFAB7,60401,16,17,1,109.47444,18.27583,1414
71583,A1DF9124AA1AFE28F8679C4665FBFAB7,30771,21,22,1,109.49938,18.26042,1511
71592,89362A3CA3AE6F5B75871F2110924F99,30851,0,7,7,109.5616,18.27396,1713
71593,89362A3CA3AE6F5B75871F2110924F99,30951,8,17,9,109.56208,18.25667,1761
71594,89362A3CA3AE6F5B75871F2110924F99,30851,19,23,4,109.5616,18.27396,1713
71662,FF389E4ACCCAE9E25F55121145744220,31421,0,19,19,109.55382,18.22347,1705
71663,FF389E4ACCCAE9E25F55121145744220,38484,20,21,1,109.53028,18.31528,1620
71664,FF389E4ACCCAE9E25F55121145744220,31421,22,23,1,109.55382,18.22347,1705
71679,B78E7295CB13532B4E2C30EF158E297F,30854,0,7,7,109.56889,18.27076,1763
71680,B78E7295CB13532B4E2C30EF158E297F,39183,10,11,1,109.55542,18.28208,1715
71681,B78E7295CB13532B4E2C30EF158E297F,30854,13,23,10,109.56889,18.27076,1763
71684,0ACD42FBA28A767F44D73783967C8C23,30084,12,14,2,109.50118,18.26972,1513
71685,0ACD42FBA28A767F44D73783967C8C23,31864,18,22,4,109.49014,18.28333,1465
71695,3842150E551101E5C7EA3E39AF0BFFE0,31061,18,19,1,109.53333,18.23257,1607
71717,B47BACC30D9A35D35F1E9FB0E5DF7D48,30854,15,17,2,109.56889,18.27076,1763
71718,B47BACC30D9A35D35F1E9FB0E5DF7D48,31071,17,22,5,109.58257,18.28458,1815
71726,48C2384D12D5B16772007E35CE360CBB,30721,0,7,7,109.51597,18.28257,1565
71727,48C2384D12D5B16772007E35CE360CBB,38105,10,11,1,109.40299,18.29229,1117
71728,48C2384D12D5B16772007E35CE360CBB,38754,12,14,2,109.74667,18.37382,2430
71729,48C2384D12D5B16772007E35CE360CBB,31864,17,18,1,109.49014,18.28333,1465
71730,48C2384D12D5B16772007E35CE360CBB,30721,20,21,1,109.51597,18.28257,1565
71738,66CF9E87749B47E4EA7738B8F9FD88BA,31521,0,11,11,109.51458,18.22542,1555
71739,66CF9E87749B47E4EA7738B8F9FD88BA,31471,13,14,1,109.34583,18.29563,917
71740,66CF9E87749B47E4EA7738B8F9FD88BA,38071,19,22,3,109.40722,18.30938,1169
71759,C84F6E3CAF0EAE725088ED441618D6C7,30181,0,6,6,109.51597,18.23313,1557
71760,C84F6E3CAF0EAE725088ED441618D6C7,30851,8,9,1,109.5616,18.27396,1713
71761,C84F6E3CAF0EAE725088ED441618D6C7,30951,9,16,7,109.56208,18.25667,1761
71762,C84F6E3CAF0EAE725088ED441618D6C7,30851,18,19,1,109.5616,18.27396,1713
71763,C84F6E3CAF0EAE725088ED441618D6C7,30181,20,23,3,109.51597,18.23313,1557
71782,02789FFFF0828D5AC1FE96B1CA16BB9C,38951,8,9,1,109.48097,18.28868,1416
71783,02789FFFF0828D5AC1FE96B1CA16BB9C,30661,13,14,1,109.37028,18.24361,1008
71784,02789FFFF0828D5AC1FE96B1CA16BB9C,38291,16,17,1,109.51618,18.24313,1558
71785,02789FFFF0828D5AC1FE96B1CA16BB9C,60221,18,21,3,109.52569,18.29188,1616
71786,02789FFFF0828D5AC1FE96B1CA16BB9C,38951,21,23,2,109.48097,18.28868,1416
71831,A928E9F6C796FE1A60807BA003DE87BB,31071,0,6,6,109.58257,18.28458,1815
71832,A928E9F6C796FE1A60807BA003DE87BB,39183,8,9,1,109.55542,18.28208,1715
71909,8586C09CC5E6256A8D795F3F0A4D8307,60472,6,7,1,109.46625,18.29542,1367
71910,8586C09CC5E6256A8D795F3F0A4D8307,30111,8,10,2,109.47583,18.30542,1419
71911,8586C09CC5E6256A8D795F3F0A4D8307,31931,11,16,5,109.54771,18.29403,1667
71912,8586C09CC5E6256A8D795F3F0A4D8307,60371,18,19,1,109.53063,18.30056,1618
71936,9770385BF52AD3BEBCA7962FCA51DE84,60231,0,6,6,109.49903,18.21972,1504
71937,9770385BF52AD3BEBCA7962FCA51DE84,39301,7,17,10,109.48361,18.21153,1453
71938,9770385BF52AD3BEBCA7962FCA51DE84,31271,22,23,1,109.48958,18.26257,1462
71939,70A62761FE79F922D082380DA7747243,30854,0,4,4,109.56889,18.27076,1763
71940,70A62761FE79F922D082380DA7747243,31071,4,7,3,109.58257,18.28458,1815
71941,70A62761FE79F922D082380DA7747243,30854,8,21,13,109.56889,18.27076,1763
71950,3BD44570DFFDF065C9FEF492B2F29442,31521,0,8,8,109.51458,18.22542,1555
71952,3BD44570DFFDF065C9FEF492B2F29442,31521,16,18,2,109.51458,18.22542,1555
71953,3BD44570DFFDF065C9FEF492B2F29442,31031,18,22,4,109.49979,18.25382,1510
71982,E4B522EF4348156010E5C578EC13D60F,30854,12,16,4,109.56889,18.27076,1763
71983,E4B522EF4348156010E5C578EC13D60F,31521,19,20,1,109.51458,18.22542,1555
71984,E4B522EF4348156010E5C578EC13D60F,30191,21,23,2,109.50361,18.22701,1506
71985,231D1D293780C68FF3AD9DEADFFFB64D,31761,15,17,2,109.60521,18.27965,1914
71986,231D1D293780C68FF3AD9DEADFFFB64D,30771,21,22,1,109.49938,18.26042,1511
71998,9AF351B3CC27394DFED45513F0E32162,31071,0,7,7,109.58257,18.28458,1815
71999,9AF351B3CC27394DFED45513F0E32162,30851,8,9,1,109.5616,18.27396,1713
72000,9AF351B3CC27394DFED45513F0E32162,30951,13,16,3,109.56208,18.25667,1761
72001,9AF351B3CC27394DFED45513F0E32162,31071,19,23,4,109.58257,18.28458,1815
72004,3D5A468E02E58892BB875A2C29BFAFBA,60281,0,8,8,109.51743,18.25924,1561
72005,3D5A468E02E58892BB875A2C29BFAFBA,31821,8,9,1,109.51181,18.24924,1559
72006,3D5A468E02E58892BB875A2C29BFAFBA,33354,12,13,1,109.67465,18.44583,2192
72009,DCD137352B900F9F43521E37884B7F13,60054,0,6,6,109.3016,18.31229,770
72010,DCD137352B900F9F43521E37884B7F13,30661,6,13,7,109.37028,18.24361,1008
72011,DCD137352B900F9F43521E37884B7F13,60054,13,23,10,109.3016,18.31229,770
72033,11644F1AC47F305D43A6A2C9763997F5,31231,0,8,8,109.42597,18.29292,1217
72034,11644F1AC47F305D43A6A2C9763997F5,30711,9,12,3,109.50271,18.25347,1510
72035,11644F1AC47F305D43A6A2C9763997F5,30351,13,18,5,109.41701,18.29292,1217
72036,11644F1AC47F305D43A6A2C9763997F5,30711,18,21,3,109.50271,18.25347,1510
72037,11644F1AC47F305D43A6A2C9763997F5,30351,21,22,1,109.41701,18.29292,1217
72043,608A55C14BAB2A5B627ACC1F39B89FB6,31945,0,7,7,109.58021,18.29403,1817
72044,608A55C14BAB2A5B627ACC1F39B89FB6,30854,7,9,2,109.56889,18.27076,1763
72045,608A55C14BAB2A5B627ACC1F39B89FB6,31945,12,13,1,109.58021,18.29403,1817
72046,608A55C14BAB2A5B627ACC1F39B89FB6,30854,13,16,3,109.56889,18.27076,1763
72066,9EC5739B5E32B42E49B9FB860139AB72,38052,16,19,3,109.62618,18.23042,1956
72067,9EC5739B5E32B42E49B9FB860139AB72,60594,20,23,3,109.62694,18.22799,1956
72078,85586D73EA48B4F4D520D899B0BE0554,31071,10,12,2,109.58257,18.28458,1815
72079,85586D73EA48B4F4D520D899B0BE0554,39181,15,18,3,109.55153,18.28035,1715
72080,85586D73EA48B4F4D520D899B0BE0554,30291,19,23,4,109.50403,18.27028,1513
72102,10EBF762D28520B09848288F7052CFDE,31071,0,6,6,109.58257,18.28458,1815
72103,10EBF762D28520B09848288F7052CFDE,30854,6,7,1,109.56889,18.27076,1763
72104,10EBF762D28520B09848288F7052CFDE,39101,7,11,4,109.50132,18.24931,1509
72105,10EBF762D28520B09848288F7052CFDE,39101,13,17,4,109.50132,18.24931,1509
72106,10EBF762D28520B09848288F7052CFDE,31071,21,23,2,109.58257,18.28458,1815
72135,C61360C6C8202A54143E165C2C08120B,30232,20,22,2,109.6191,18.31701,1971
72136,C61360C6C8202A54143E165C2C08120B,30951,22,23,1,109.56208,18.25667,1761
72183,065F1687C35F3C827A2EA4A378A0E2C6,30851,8,12,4,109.5616,18.27396,1713
72184,065F1687C35F3C827A2EA4A378A0E2C6,31071,16,17,1,109.58257,18.28458,1815
72185,065F1687C35F3C827A2EA4A378A0E2C6,30851,17,22,5,109.5616,18.27396,1713
72213,B61666307486DD531F980787F0F8A7B7,60631,3,7,4,109.57778,18.27583,1814
72214,B61666307486DD531F980787F0F8A7B7,31571,9,17,8,109.61563,18.23326,1957
72215,B61666307486DD531F980787F0F8A7B7,30854,17,19,2,109.56889,18.27076,1763
72220,6DF7485545B790F22810B0EDD8F1B356,31945,0,13,13,109.58021,18.29403,1817
72221,6DF7485545B790F22810B0EDD8F1B356,30854,15,16,1,109.56889,18.27076,1763
72222,6DF7485545B790F22810B0EDD8F1B356,31945,17,22,5,109.58021,18.29403,1817
72300,77F5A37783010C53E376197FE3F1043D,38991,6,9,3,109.52681,18.30368,1618
72301,77F5A37783010C53E376197FE3F1043D,60371,10,12,2,109.53063,18.30056,1618
72356,7421066246AAD1C230E7E2A7ADF06E9D,60631,0,6,6,109.57778,18.27583,1814
72357,7421066246AAD1C230E7E2A7ADF06E9D,30854,7,21,14,109.56889,18.27076,1763
72362,A4823EEC9A8E697E80697432C029B488,60331,6,9,3,109.505,18.26507,1512
72363,A4823EEC9A8E697E80697432C029B488,30391,10,11,1,109.4975,18.27118,1513
72364,A4823EEC9A8E697E80697432C029B488,31021,14,16,2,109.49021,18.27,1463
72365,A4823EEC9A8E697E80697432C029B488,30391,16,19,3,109.4975,18.27118,1513
72366,A4823EEC9A8E697E80697432C029B488,31561,20,21,1,109.56792,18.28479,1765
72391,A01B4012B619D942E7CC3AC9B78722B4,39183,13,15,2,109.55542,18.28208,1715
72392,A01B4012B619D942E7CC3AC9B78722B4,31931,15,17,2,109.54771,18.29403,1667
72393,A01B4012B619D942E7CC3AC9B78722B4,31561,18,23,5,109.56792,18.28479,1765
72411,A01E2FD84FFE4D782E40311D1ABC1ECB,30281,13,14,1,109.50597,18.27583,1514
72412,A01E2FD84FFE4D782E40311D1ABC1ECB,30721,17,20,3,109.51597,18.28257,1565
72413,7D13454F622056C17C98DB56E3E88A4B,31521,0,1,1,109.51458,18.22542,1555
72414,7D13454F622056C17C98DB56E3E88A4B,31261,2,3,1,109.51174,18.2466,1559
72415,7D13454F622056C17C98DB56E3E88A4B,31521,3,13,10,109.51458,18.22542,1555
72416,7D13454F622056C17C98DB56E3E88A4B,30201,17,19,2,109.4909,18.26465,1462
72417,7D13454F622056C17C98DB56E3E88A4B,31271,20,23,3,109.48958,18.26257,1462
72418,DF46DA0955594B99E73FB26D3951FE40,60631,11,15,4,109.57778,18.27583,1814
72419,DF46DA0955594B99E73FB26D3951FE40,30854,19,23,4,109.56889,18.27076,1763
72429,AC3C2B82ADBE2E4EBD30C091CA841570,39091,17,18,1,109.50097,18.25222,1510
72430,AC3C2B82ADBE2E4EBD30C091CA841570,30371,20,23,3,109.51,18.24771,1559
72499,8C1117E4F5AA76BB724506FFA6757C9B,30861,0,4,4,109.52722,18.22743,1606
72500,8C1117E4F5AA76BB724506FFA6757C9B,60641,5,6,1,109.53854,18.2359,1657
72501,8C1117E4F5AA76BB724506FFA6757C9B,31471,10,12,2,109.34583,18.29563,917
72505,AAD294F97E8F953422B544ED61B36D13,30951,13,15,2,109.56208,18.25667,1761
72506,AAD294F97E8F953422B544ED61B36D13,31071,18,20,2,109.58257,18.28458,1815
72515,A0546DF6E12B7EBA6A12345D0ECBA027,31351,0,7,7,109.4959,18.28417,1465
72516,A0546DF6E12B7EBA6A12345D0ECBA027,38706,9,11,2,109.74625,18.37097,2430
72517,A0546DF6E12B7EBA6A12345D0ECBA027,31351,12,14,2,109.4959,18.28417,1465
72518,A0546DF6E12B7EBA6A12345D0ECBA027,31271,14,16,2,109.48958,18.26257,1462
72519,A0546DF6E12B7EBA6A12345D0ECBA027,30201,16,18,2,109.4909,18.26465,1462
72520,A0546DF6E12B7EBA6A12345D0ECBA027,31351,18,23,5,109.4959,18.28417,1465
72533,F866B6E34CEF853A6497211DD74A607E,31071,0,7,7,109.58257,18.28458,1815
72534,F866B6E34CEF853A6497211DD74A607E,31851,8,9,1,109.71736,18.29007,2316
72535,F866B6E34CEF853A6497211DD74A607E,31071,10,17,7,109.58257,18.28458,1815
72536,F866B6E34CEF853A6497211DD74A607E,60131,19,20,1,109.49819,18.24778,1509
72554,EFFEF00C078D502D6D0D1D469ACBA466,30421,0,7,7,109.50021,18.25861,1511
72555,EFFEF00C078D502D6D0D1D469ACBA466,31471,9,11,2,109.34583,18.29563,917
72556,EFFEF00C078D502D6D0D1D469ACBA466,39041,12,14,2,109.40021,18.29278,1117
72557,EFFEF00C078D502D6D0D1D469ACBA466,31471,15,17,2,109.34583,18.29563,917
72558,EFFEF00C078D502D6D0D1D469ACBA466,38325,18,20,2,109.39792,18.2909,1116
72559,EFFEF00C078D502D6D0D1D469ACBA466,60551,20,22,2,109.42722,18.30111,1218
72566,60B11D9FE0CF3079F76776CA9C4D76C8,31071,2,19,17,109.58257,18.28458,1815
72567,60B11D9FE0CF3079F76776CA9C4D76C8,30854,19,21,2,109.56889,18.27076,1763
72568,60B11D9FE0CF3079F76776CA9C4D76C8,31071,21,23,2,109.58257,18.28458,1815
72596,C1602FB5A20BD98313F7CC13F431D061,60084,1,7,6,109.4984,18.2334,1507
72597,C1602FB5A20BD98313F7CC13F431D061,30771,9,16,7,109.49938,18.26042,1511
72598,C1602FB5A20BD98313F7CC13F431D061,30771,17,19,2,109.49938,18.26042,1511
72599,C1602FB5A20BD98313F7CC13F431D061,30271,21,23,2,109.49132,18.23153,1456
72603,8DD23AA43C0F7967C45F7488D66F9159,31945,2,7,5,109.58021,18.29403,1817
72604,8DD23AA43C0F7967C45F7488D66F9159,30854,8,16,8,109.56889,18.27076,1763
72605,8DD23AA43C0F7967C45F7488D66F9159,60381,20,22,2,109.5241,18.22458,1605
72612,BD4652414D5C17466BA36FD4BD943A94,39183,12,14,2,109.55542,18.28208,1715
72613,BD4652414D5C17466BA36FD4BD943A94,30281,19,20,1,109.50597,18.27583,1514
72691,D3A66AED8A4C1CC9A2E3EF71AAE97E84,60411,18,20,2,109.32514,18.30854,869
72692,D3A66AED8A4C1CC9A2E3EF71AAE97E84,30661,20,23,3,109.37028,18.24361,1008
72737,1D8B56371E487F3812C9965576175C8D,38361,0,9,9,109.43667,18.29201,1267
72738,1D8B56371E487F3812C9965576175C8D,30171,12,13,1,109.48458,18.27139,1463
72739,1D8B56371E487F3812C9965576175C8D,31521,15,16,1,109.51458,18.22542,1555
72740,1D8B56371E487F3812C9965576175C8D,38361,18,20,2,109.43667,18.29201,1267
72741,1D8B56371E487F3812C9965576175C8D,31231,20,21,1,109.42597,18.29292,1217
72742,1D8B56371E487F3812C9965576175C8D,38361,22,23,1,109.43667,18.29201,1267
72759,C85D0B931BEF54F05B9ABBBB03212DB7,30854,2,3,1,109.56889,18.27076,1763
72760,C85D0B931BEF54F05B9ABBBB03212DB7,31561,4,9,5,109.56792,18.28479,1765
72761,C85D0B931BEF54F05B9ABBBB03212DB7,30854,11,13,2,109.56889,18.27076,1763
72762,C85D0B931BEF54F05B9ABBBB03212DB7,31561,14,18,4,109.56792,18.28479,1765
72763,C85D0B931BEF54F05B9ABBBB03212DB7,30854,18,21,3,109.56889,18.27076,1763
72786,B37777551ADDE84A1FDFE1FF465C24DC,30921,2,5,3,109.53903,18.29451,1667
72787,B37777551ADDE84A1FDFE1FF465C24DC,31931,9,19,10,109.54771,18.29403,1667
72788,B37777551ADDE84A1FDFE1FF465C24DC,30921,19,21,2,109.53903,18.29451,1667
72789,B37777551ADDE84A1FDFE1FF465C24DC,31931,22,23,1,109.54771,18.29403,1667
72790,CBC603DF99C1D6981715077F3EA24CB6,30232,0,6,6,109.6191,18.31701,1971
72791,CBC603DF99C1D6981715077F3EA24CB6,30854,9,11,2,109.56889,18.27076,1763
72792,CBC603DF99C1D6981715077F3EA24CB6,60054,14,16,2,109.3016,18.31229,770
72793,CBC603DF99C1D6981715077F3EA24CB6,31031,18,21,3,109.49979,18.25382,1510
72794,CBC603DF99C1D6981715077F3EA24CB6,30854,22,23,1,109.56889,18.27076,1763
72800,E5498B89122F0B814DF15FAF2B624D23,30234,0,10,10,109.60681,18.29979,1918
72801,E5498B89122F0B814DF15FAF2B624D23,60091,12,14,2,109.59729,18.30431,1869
72802,E5498B89122F0B814DF15FAF2B624D23,30234,17,21,4,109.60681,18.29979,1918
72803,E5498B89122F0B814DF15FAF2B624D23,30854,21,23,2,109.56889,18.27076,1763
72853,EBF906C5498076BCFA3E97DF6001B4F3,30854,15,16,1,109.56889,18.27076,1763
72854,EBF906C5498076BCFA3E97DF6001B4F3,60631,19,20,1,109.57778,18.27583,1814
72882,2A6BA0678DDF16AF08BAC9E3FA3C9391,31561,1,6,5,109.56792,18.28479,1765
72883,2A6BA0678DDF16AF08BAC9E3FA3C9391,30854,9,19,10,109.56889,18.27076,1763
72884,2A6BA0678DDF16AF08BAC9E3FA3C9391,31561,19,21,2,109.56792,18.28479,1765
72912,25AEFF32B0667D26540E580A39012DE0,38141,0,6,6,109.39479,18.2916,1116
72913,25AEFF32B0667D26540E580A39012DE0,31471,9,11,2,109.34583,18.29563,917
72914,25AEFF32B0667D26540E580A39012DE0,38141,14,18,4,109.39479,18.2916,1116
72915,25AEFF32B0667D26540E580A39012DE0,38141,22,23,1,109.39479,18.2916,1116
72927,75817DB682187A07461734D66E1E6492,60631,0,4,4,109.57778,18.27583,1814
72928,75817DB682187A07461734D66E1E6492,30854,5,7,2,109.56889,18.27076,1763
72929,75817DB682187A07461734D66E1E6492,31071,7,9,2,109.58257,18.28458,1815
72930,75817DB682187A07461734D66E1E6492,30854,9,12,3,109.56889,18.27076,1763
72931,75817DB682187A07461734D66E1E6492,30851,17,19,2,109.5616,18.27396,1713
72932,75817DB682187A07461734D66E1E6492,60631,21,23,2,109.57778,18.27583,1814
72935,980F93ED36601960C6F1553EF4F4BC27,30161,18,19,1,109.50042,18.24389,1508
72948,E16204D131FCD957D5ADB9592C1DD0ED,31761,0,8,8,109.60521,18.27965,1914
72949,E16204D131FCD957D5ADB9592C1DD0ED,31561,13,14,1,109.56792,18.28479,1765
72950,E16204D131FCD957D5ADB9592C1DD0ED,31761,14,15,1,109.60521,18.27965,1914
72951,E16204D131FCD957D5ADB9592C1DD0ED,31071,17,20,3,109.58257,18.28458,1815
72952,E16204D131FCD957D5ADB9592C1DD0ED,31521,21,22,1,109.51458,18.22542,1555
73010,3B0DECA794F20C5FB710516C02569281,60131,20,21,1,109.49819,18.24778,1509
73012,BB31C40AF9668A41ED1DCCB876852450,31061,18,20,2,109.53333,18.23257,1607
73059,8D8AA41210FC9E2D5DD4D81CF4DB18D7,60361,0,8,8,109.51938,18.29681,1567
73060,8D8AA41210FC9E2D5DD4D81CF4DB18D7,60084,11,12,1,109.4984,18.2334,1507
73061,8D8AA41210FC9E2D5DD4D81CF4DB18D7,60381,15,18,3,109.5241,18.22458,1605
73062,8D8AA41210FC9E2D5DD4D81CF4DB18D7,60361,21,23,2,109.51938,18.29681,1567
73074,4DA47CA7E0DF1887A4FCFA8DEF75F8FC,31761,0,7,7,109.60521,18.27965,1914
73075,4DA47CA7E0DF1887A4FCFA8DEF75F8FC,31551,10,11,1,109.55868,18.24222,1708
73076,4DA47CA7E0DF1887A4FCFA8DEF75F8FC,30951,12,17,5,109.56208,18.25667,1761
73077,4DA47CA7E0DF1887A4FCFA8DEF75F8FC,31761,19,23,4,109.60521,18.27965,1914
73090,A952750F25C558E5C17B3EB7DD935431,31931,9,14,5,109.54771,18.29403,1667
73091,A952750F25C558E5C17B3EB7DD935431,60371,16,22,6,109.53063,18.30056,1618
73097,ABCD0851CC1C78BCD7AF6DBDF2F5DE49,60524,0,12,12,109.42951,18.28993,1216
73098,ABCD0851CC1C78BCD7AF6DBDF2F5DE49,30671,14,15,1,109.43611,18.30139,1268
73099,ABCD0851CC1C78BCD7AF6DBDF2F5DE49,60552,15,20,5,109.41729,18.30014,1218
73103,85E9F50B5ABCB1024F25DC89F0D41C6E,60281,2,4,2,109.51743,18.25924,1561
73104,85E9F50B5ABCB1024F25DC89F0D41C6E,31041,7,12,5,109.50278,18.23701,1507
73105,85E9F50B5ABCB1024F25DC89F0D41C6E,60281,12,13,1,109.51743,18.25924,1561
73106,85E9F50B5ABCB1024F25DC89F0D41C6E,30361,16,18,2,109.50347,18.24,1508
73107,85E9F50B5ABCB1024F25DC89F0D41C6E,60281,19,22,3,109.51743,18.25924,1561
73150,9EB99F27F9127F01C16DB7BA7D10B6E0,31561,0,8,8,109.56792,18.28479,1765
73151,9EB99F27F9127F01C16DB7BA7D10B6E0,30854,8,20,12,109.56889,18.27076,1763
73170,B643AC77F8D8498A9694D45BA8B0F75F,60631,0,17,17,109.57778,18.27583,1814
73171,B643AC77F8D8498A9694D45BA8B0F75F,31561,17,20,3,109.56792,18.28479,1765
73175,8C84F1CB6E49AC2736E89C4CFE87B2BD,31391,0,7,7,109.50382,18.24285,1508
73176,8C84F1CB6E49AC2736E89C4CFE87B2BD,30711,8,9,1,109.50271,18.25347,1510
73177,8C84F1CB6E49AC2736E89C4CFE87B2BD,31521,11,13,2,109.51458,18.22542,1555
73178,8C84F1CB6E49AC2736E89C4CFE87B2BD,38094,15,16,1,109.45403,18.28778,1316
73179,8C84F1CB6E49AC2736E89C4CFE87B2BD,31391,18,23,5,109.50382,18.24285,1508
73195,95ED95A5BB76719BE5F5E1272F8C7771,60361,1,5,4,109.51938,18.29681,1567
73196,95ED95A5BB76719BE5F5E1272F8C7771,30071,6,7,1,109.52819,18.30472,1619
73197,95ED95A5BB76719BE5F5E1272F8C7771,60671,8,9,1,109.52979,18.31757,1621
73198,95ED95A5BB76719BE5F5E1272F8C7771,30071,9,20,11,109.52819,18.30472,1619
73202,7252A0F90E29EC78621699C082578EF7,30831,20,21,1,109.69813,18.32076,2271
73203,7252A0F90E29EC78621699C082578EF7,31361,22,23,1,109.47417,18.28292,1415
73240,EF727BDF3D7B6D877CF0038228740019,60401,4,6,2,109.47444,18.27583,1414
73241,EF727BDF3D7B6D877CF0038228740019,30711,9,11,2,109.50271,18.25347,1510
73242,EF727BDF3D7B6D877CF0038228740019,30711,14,23,9,109.50271,18.25347,1510
73302,785F09140A3E8EDC8952D5DB7DB13B12,38911,6,9,3,109.51674,18.24965,1559
73303,785F09140A3E8EDC8952D5DB7DB13B12,31261,9,11,2,109.51174,18.2466,1559
73304,785F09140A3E8EDC8952D5DB7DB13B12,38291,11,17,6,109.51618,18.24313,1558
73305,785F09140A3E8EDC8952D5DB7DB13B12,38911,19,22,3,109.51674,18.24965,1559
73312,439C404954398764464D854D76F475D8,38961,1,9,8,109.50847,18.23514,1507
73313,439C404954398764464D854D76F475D8,30761,12,23,11,109.45201,18.3,1318
73320,2361E8D6BAB0231B2E8E3C0F34517282,30081,0,15,15,109.50243,18.26632,1512
73321,2361E8D6BAB0231B2E8E3C0F34517282,30291,15,16,1,109.50403,18.27028,1513
73322,2361E8D6BAB0231B2E8E3C0F34517282,30081,19,23,4,109.50243,18.26632,1512
73348,91EC74D2B208A10BECBB101C6735C578,31864,1,8,7,109.49014,18.28333,1465
73349,91EC74D2B208A10BECBB101C6735C578,60281,12,14,2,109.51743,18.25924,1561
73350,91EC74D2B208A10BECBB101C6735C578,31031,14,17,3,109.49979,18.25382,1510
73351,91EC74D2B208A10BECBB101C6735C578,38094,19,20,1,109.45403,18.28778,1316
73352,91EC74D2B208A10BECBB101C6735C578,31864,22,23,1,109.49014,18.28333,1465
73363,4995463B780282C9C030A19D9F49AEAC,31071,1,7,6,109.58257,18.28458,1815
73364,4995463B780282C9C030A19D9F49AEAC,30854,7,9,2,109.56889,18.27076,1763
73365,4995463B780282C9C030A19D9F49AEAC,31071,11,15,4,109.58257,18.28458,1815
73366,CF2A30FDEEDE024C38B6F95A666F3725,60491,16,18,2,109.43354,18.30847,1269
73367,CF2A30FDEEDE024C38B6F95A666F3725,38141,19,21,2,109.39479,18.2916,1116
73377,4E94ADAE7ABEB20EEFAF67519DFCC1BE,31081,0,9,9,109.44639,18.30181,1318
73378,4E94ADAE7ABEB20EEFAF67519DFCC1BE,31031,10,17,7,109.49979,18.25382,1510
73379,4E94ADAE7ABEB20EEFAF67519DFCC1BE,31031,17,21,4,109.49979,18.25382,1510
73408,B6F891F287DE899812D485CDAA950BB5,31303,0,7,7,109.15826,18.29549,217
73409,B6F891F287DE899812D485CDAA950BB5,31091,8,9,1,109.41201,18.31222,1170
73410,B6F891F287DE899812D485CDAA950BB5,31321,11,12,1,109.63799,18.23201,2007
73411,B6F891F287DE899812D485CDAA950BB5,30821,17,19,2,109.43681,18.33639,1274
73412,B6F891F287DE899812D485CDAA950BB5,30761,20,23,3,109.45201,18.3,1318
73463,996C0D9500BF90CC0E7F5A04C49A464B,39183,0,5,5,109.55542,18.28208,1715
73464,996C0D9500BF90CC0E7F5A04C49A464B,31931,6,23,17,109.54771,18.29403,1667
73468,14A60C3EE7AB19A3980CCA0FE9C293B4,30101,0,8,8,109.57299,18.33333,1773
73469,14A60C3EE7AB19A3980CCA0FE9C293B4,31631,12,14,2,109.59542,18.36826,1879
73470,14A60C3EE7AB19A3980CCA0FE9C293B4,31251,19,23,4,109.18528,18.2975,317
73480,B340EDEF4A878E8DF5CBEC25E465EACE,30854,0,12,12,109.56889,18.27076,1763
73481,B340EDEF4A878E8DF5CBEC25E465EACE,60631,15,17,2,109.57778,18.27583,1814
73482,B340EDEF4A878E8DF5CBEC25E465EACE,30084,21,22,1,109.50118,18.26972,1513
73500,F198CAA1F49ACA5D003FD8F8473B3798,60661,19,20,1,109.548,18.2377,1657
73501,F198CAA1F49ACA5D003FD8F8473B3798,30191,21,23,2,109.50361,18.22701,1506
73537,C860767955774E3494068CF38C009FB6,60391,0,7,7,109.47667,18.28757,1416
73538,C860767955774E3494068CF38C009FB6,31061,9,11,2,109.53333,18.23257,1607
73539,C860767955774E3494068CF38C009FB6,60391,12,14,2,109.47667,18.28757,1416
73549,99986625C7CCD4CB0440D77966EC82F7,31521,0,16,16,109.51458,18.22542,1555
73550,99986625C7CCD4CB0440D77966EC82F7,30361,17,18,1,109.50347,18.24,1508
73577,94A0A464F14C2924A0C00CE569871CAB,33051,13,15,2,109.6475,18.46618,2096
73578,94A0A464F14C2924A0C00CE569871CAB,38017,18,21,3,109.49729,18.21424,1504
73579,8C5A16299A6D294198C90C34C25C5949,31561,18,21,3,109.56792,18.28479,1765
73580,8C5A16299A6D294198C90C34C25C5949,30854,22,23,1,109.56889,18.27076,1763
73581,662D882A6A10D0E6C3566690F0A40636,30854,0,6,6,109.56889,18.27076,1763
73582,662D882A6A10D0E6C3566690F0A40636,31071,8,10,2,109.58257,18.28458,1815
73583,662D882A6A10D0E6C3566690F0A40636,30854,15,23,8,109.56889,18.27076,1763
73589,35C6EDC8AAC6B5ABA770190223528BA2,60381,0,8,8,109.5241,18.22458,1605
73590,35C6EDC8AAC6B5ABA770190223528BA2,60211,10,11,1,109.63549,18.26049,2011
73617,E2CFBC4AD8BA700D32898ABFA9A0C849,60631,1,4,3,109.57778,18.27583,1814
73618,E2CFBC4AD8BA700D32898ABFA9A0C849,38153,8,10,2,109.51819,18.25736,1561
73619,E2CFBC4AD8BA700D32898ABFA9A0C849,30854,14,16,2,109.56889,18.27076,1763
73629,B43DB539B5964E15F0064080164C40C1,60631,0,7,7,109.57778,18.27583,1814
73630,B43DB539B5964E15F0064080164C40C1,38085,8,9,1,109.6291,18.23625,2007
73631,B43DB539B5964E15F0064080164C40C1,38052,11,16,5,109.62618,18.23042,1956
73632,B43DB539B5964E15F0064080164C40C1,30854,18,19,1,109.56889,18.27076,1763
73633,B43DB539B5964E15F0064080164C40C1,60631,22,23,1,109.57778,18.27583,1814
73666,D1EBD1A5A8A922DEF994C933F10DD8DB,31031,0,10,10,109.49979,18.25382,1510
73667,D1EBD1A5A8A922DEF994C933F10DD8DB,60381,11,12,1,109.5241,18.22458,1605
73668,D1EBD1A5A8A922DEF994C933F10DD8DB,60641,17,21,4,109.53854,18.2359,1657
73687,EB92ED6162DE5D09C3C6A535524882F3,31091,21,22,1,109.41201,18.31222,1170
73704,FB69127E95B4D9EC5AF61282F8D7EEB7,31071,0,6,6,109.58257,18.28458,1815
73705,FB69127E95B4D9EC5AF61282F8D7EEB7,30854,7,22,15,109.56889,18.27076,1763
73706,0E0D6E55BB1995EBF85F6B7AA8765E55,60631,1,3,2,109.57778,18.27583,1814
73707,0E0D6E55BB1995EBF85F6B7AA8765E55,30854,3,6,3,109.56889,18.27076,1763
73708,0E0D6E55BB1995EBF85F6B7AA8765E55,60631,6,8,2,109.57778,18.27583,1814
73709,0E0D6E55BB1995EBF85F6B7AA8765E55,30854,10,22,12,109.56889,18.27076,1763
73719,4BE8FEB7C7A1255367E8FF1F934ACEB2,38754,12,14,2,109.74667,18.37382,2430
73721,362594BCB737E6CB215B010FAC348A61,60361,0,7,7,109.51938,18.29681,1567
73722,362594BCB737E6CB215B010FAC348A61,60054,12,14,2,109.3016,18.31229,770
73723,362594BCB737E6CB215B010FAC348A61,60361,17,23,6,109.51938,18.29681,1567
73735,2D39AE6120F2674000C6DBB8A6E572A0,31945,0,6,6,109.58021,18.29403,1817
73736,2D39AE6120F2674000C6DBB8A6E572A0,30854,10,12,2,109.56889,18.27076,1763
73737,2D39AE6120F2674000C6DBB8A6E572A0,31945,12,13,1,109.58021,18.29403,1817
73738,2D39AE6120F2674000C6DBB8A6E572A0,30854,14,17,3,109.56889,18.27076,1763
73769,68011FE052BBE12B354F2950875992AA,31231,0,8,8,109.42597,18.29292,1217
73770,68011FE052BBE12B354F2950875992AA,31231,12,17,5,109.42597,18.29292,1217
73771,68011FE052BBE12B354F2950875992AA,31431,17,18,1,109.44639,18.29042,1316
73772,68011FE052BBE12B354F2950875992AA,31231,21,23,2,109.42597,18.29292,1217
73773,289C96166B72325FF931BEE9E63A948B,60121,18,19,1,109.74507,18.37472,2430
73774,289C96166B72325FF931BEE9E63A948B,39191,21,23,2,109.51493,18.23472,1557
73779,C1F9914EF577AE2A8300B1A3945A50FF,31561,18,20,2,109.56792,18.28479,1765
73780,C1F9914EF577AE2A8300B1A3945A50FF,30851,21,23,2,109.5616,18.27396,1713
73781,44F505B3929E26B4B29F00CC284F3084,31071,1,5,4,109.58257,18.28458,1815
73782,44F505B3929E26B4B29F00CC284F3084,30854,8,23,15,109.56889,18.27076,1763
73850,DC0EB400EA24BEE9EB39D315B0E6AEF0,38871,0,8,8,109.44681,18.28625,1316
73851,DC0EB400EA24BEE9EB39D315B0E6AEF0,31351,13,15,2,109.4959,18.28417,1465
73852,DC0EB400EA24BEE9EB39D315B0E6AEF0,38871,17,22,5,109.44681,18.28625,1316
73865,957C9474071297AA10C21C33173742BB,60621,0,10,10,109.48354,18.27451,1464
73866,957C9474071297AA10C21C33173742BB,31551,12,17,5,109.55868,18.24222,1708
73867,957C9474071297AA10C21C33173742BB,60621,21,23,2,109.48354,18.27451,1464
73939,1E7B140C13C6B69278A768C40899DDB0,31091,0,4,4,109.41201,18.31222,1170
73940,1E7B140C13C6B69278A768C40899DDB0,60551,6,8,2,109.42722,18.30111,1218
73941,1E7B140C13C6B69278A768C40899DDB0,60054,11,12,1,109.3016,18.31229,770
73949,BE8220A49F1231C0A022F4AA2075503E,38094,0,1,1,109.45403,18.28778,1316
73950,BE8220A49F1231C0A022F4AA2075503E,31945,4,13,9,109.58021,18.29403,1817
73951,BE8220A49F1231C0A022F4AA2075503E,31071,14,16,2,109.58257,18.28458,1815
73952,5B0D8910FEAC5D70C091A0F76A27F5FB,31551,0,8,8,109.55868,18.24222,1708
73953,5B0D8910FEAC5D70C091A0F76A27F5FB,30711,9,17,8,109.50271,18.25347,1510
74056,A68637AA89BD62624E677D9E66C32FAD,30161,0,9,9,109.50042,18.24389,1508
74057,A68637AA89BD62624E677D9E66C32FAD,30161,9,23,14,109.50042,18.24389,1508
74058,E4199729A84482014747EE1ECF3FF7D9,31811,0,5,5,109.54201,18.31806,1671
74059,E4199729A84482014747EE1ECF3FF7D9,30931,7,12,5,109.55653,18.32722,1722
74060,E4199729A84482014747EE1ECF3FF7D9,30101,17,18,1,109.57299,18.33333,1773
74135,1781C3B3F78A7405692A91AC60B38BEF,60041,0,5,5,109.39889,18.31944,1121
74136,1781C3B3F78A7405692A91AC60B38BEF,30631,7,8,1,109.34382,18.32778,922
74137,1781C3B3F78A7405692A91AC60B38BEF,31691,11,13,2,109.36604,18.3075,1019
74145,2E31826F518B91677E3401BE3F9A1AF2,60371,16,17,1,109.53063,18.30056,1618
74146,2E31826F518B91677E3401BE3F9A1AF2,60281,18,20,2,109.51743,18.25924,1561
74147,2E31826F518B91677E3401BE3F9A1AF2,60371,21,23,2,109.53063,18.30056,1618
74148,8554F0A178316702A9146AC053A2336A,30711,0,10,10,109.50271,18.25347,1510
74149,8554F0A178316702A9146AC053A2336A,30421,14,16,2,109.50021,18.25861,1511
74150,8554F0A178316702A9146AC053A2336A,31031,16,18,2,109.49979,18.25382,1510
74165,2297ECCBAEAEEAB6F486010C8882DE44,60614,16,17,1,109.48799,18.29521,1467
74166,2297ECCBAEAEEAB6F486010C8882DE44,60581,21,23,2,109.59785,18.29931,1868
74199,2576A40187A845D7B849E820F16B3DB1,30854,3,12,9,109.56889,18.27076,1763
74200,2576A40187A845D7B849E820F16B3DB1,31181,14,15,1,109.50382,18.24813,1509
74201,2576A40187A845D7B849E820F16B3DB1,30854,15,19,4,109.56889,18.27076,1763
74208,EE972DDDB0EBA2B6E0C8E188BA31FBAC,31231,20,23,3,109.42597,18.29292,1217
74222,05F9648883BF713D4E846B58647DFC7D,60524,14,15,1,109.42951,18.28993,1216
74223,05F9648883BF713D4E846B58647DFC7D,60552,15,18,3,109.41729,18.30014,1218
74224,05F9648883BF713D4E846B58647DFC7D,30361,20,21,1,109.50347,18.24,1508
74291,FC6A614D4965712344FE973AE5D670AE,60084,4,5,1,109.4984,18.2334,1507
74292,FC6A614D4965712344FE973AE5D670AE,60291,7,8,1,109.50826,18.24639,1509
74293,FC6A614D4965712344FE973AE5D670AE,33481,9,10,1,109.67278,18.41278,2187
74320,0D3DA8126B134D203BB35373EAFFB116,31071,0,16,16,109.58257,18.28458,1815
74321,0D3DA8126B134D203BB35373EAFFB116,30361,18,22,4,109.50347,18.24,1508
74340,10526BE112ADB237730F205D73F11651,38903,0,1,1,109.39229,18.29243,1117
74341,10526BE112ADB237730F205D73F11651,38141,1,5,4,109.39479,18.2916,1116
74342,10526BE112ADB237730F205D73F11651,38903,5,7,2,109.39229,18.29243,1117
74343,10526BE112ADB237730F205D73F11651,60552,10,12,2,109.41729,18.30014,1218
74374,BA12B1DD26AEACA59B8A6ED0F5A5E23C,30071,16,17,1,109.52819,18.30472,1619
74375,BA12B1DD26AEACA59B8A6ED0F5A5E23C,30071,20,23,3,109.52819,18.30472,1619
74384,1E8223F636C151EB082F0819A60E04D9,30771,13,15,2,109.49938,18.26042,1511
74385,1E8223F636C151EB082F0819A60E04D9,39154,17,23,6,109.50201,18.25681,1511
74397,2154632B956236CC440F4F0AD5DD5113,60561,0,8,8,109.38229,18.29785,1067
74398,2154632B956236CC440F4F0AD5DD5113,31251,9,10,1,109.18528,18.2975,317
74399,2154632B956236CC440F4F0AD5DD5113,30661,11,17,6,109.37028,18.24361,1008
74400,2154632B956236CC440F4F0AD5DD5113,60561,19,23,4,109.38229,18.29785,1067
74423,F6F55191BE81ACEA146530C2DC4B16FD,31101,1,8,7,109.65389,18.23403,2057
74425,994D400389C3C3395B80FB21D74A0E76,38961,0,7,7,109.50847,18.23514,1507
74426,994D400389C3C3395B80FB21D74A0E76,60381,11,13,2,109.5241,18.22458,1605
74427,994D400389C3C3395B80FB21D74A0E76,38961,13,14,1,109.50847,18.23514,1507
74428,994D400389C3C3395B80FB21D74A0E76,31205,19,21,2,109.51111,18.23736,1557
74441,235EF2BFA7E42A5306921E51D3359C28,31421,3,8,5,109.55382,18.22347,1705
74442,235EF2BFA7E42A5306921E51D3359C28,31781,11,12,1,109.19847,18.2975,367
74443,235EF2BFA7E42A5306921E51D3359C28,31471,14,15,1,109.34583,18.29563,917
74468,74AD1AF2EA5153BD40BCF9A3F3F2C4E3,30854,8,13,5,109.56889,18.27076,1763
74469,74AD1AF2EA5153BD40BCF9A3F3F2C4E3,31071,13,20,7,109.58257,18.28458,1815
74482,A9FCE0049DB44FE004EAFBF5B783F4A5,31945,0,7,7,109.58021,18.29403,1817
74483,A9FCE0049DB44FE004EAFBF5B783F4A5,30854,11,15,4,109.56889,18.27076,1763
74484,A9FCE0049DB44FE004EAFBF5B783F4A5,31071,17,18,1,109.58257,18.28458,1815
74488,B663EE883B81AEB709AC84DCCEC3D38E,31945,1,7,6,109.58021,18.29403,1817
74489,B663EE883B81AEB709AC84DCCEC3D38E,30854,10,12,2,109.56889,18.27076,1763
74490,B663EE883B81AEB709AC84DCCEC3D38E,31945,13,14,1,109.58021,18.29403,1817
74491,B663EE883B81AEB709AC84DCCEC3D38E,30854,14,17,3,109.56889,18.27076,1763
74492,B663EE883B81AEB709AC84DCCEC3D38E,31421,18,19,1,109.55382,18.22347,1705
74493,B663EE883B81AEB709AC84DCCEC3D38E,30191,21,23,2,109.50361,18.22701,1506
74502,D9FE6A07B455464CAD7EA907A485A370,30211,0,7,7,109.49882,18.23931,1508
74503,D9FE6A07B455464CAD7EA907A485A370,31145,9,11,2,109.20431,18.30479,369
74504,D9FE6A07B455464CAD7EA907A485A370,31781,11,12,1,109.19847,18.2975,367
74505,D9FE6A07B455464CAD7EA907A485A370,31471,13,15,2,109.34583,18.29563,917
74526,CB9E93D60C42CE31FD30C2DAB592949A,31671,0,2,2,109.38965,18.29813,1068
74527,CB9E93D60C42CE31FD30C2DAB592949A,60561,3,5,2,109.38229,18.29785,1067
74528,CB9E93D60C42CE31FD30C2DAB592949A,31671,6,8,2,109.38965,18.29813,1068
74540,EFFD4571117B023D4BFFAE2F1C9E1510,31201,0,11,11,109.51042,18.23819,1558
74541,EFFD4571117B023D4BFFAE2F1C9E1510,30181,11,13,2,109.51597,18.23313,1557
74542,EFFD4571117B023D4BFFAE2F1C9E1510,60081,13,14,1,109.51097,18.22639,1556
74543,EFFD4571117B023D4BFFAE2F1C9E1510,38961,15,20,5,109.50847,18.23514,1507
74575,8E06EAC16B0EF776FA1BAAC5B9747325,60201,0,6,6,109.5041,18.2509,1510
74576,8E06EAC16B0EF776FA1BAAC5B9747325,60571,10,21,11,109.50722,18.25056,1510
74580,84DF4A7C208235D171EF56473BCCF210,30851,0,4,4,109.5616,18.27396,1713
74581,84DF4A7C208235D171EF56473BCCF210,31561,4,7,3,109.56792,18.28479,1765
74582,84DF4A7C208235D171EF56473BCCF210,60631,7,18,11,109.57778,18.27583,1814
74606,015CDEB9169BCE5537ABAE49B6A63F2B,31071,0,12,12,109.58257,18.28458,1815
74607,015CDEB9169BCE5537ABAE49B6A63F2B,30854,15,17,2,109.56889,18.27076,1763
74608,015CDEB9169BCE5537ABAE49B6A63F2B,30861,22,23,1,109.52722,18.22743,1606
74621,1FA4B82215610E27D44D7E787BF2CCFC,60614,0,6,6,109.48799,18.29521,1467
74622,1FA4B82215610E27D44D7E787BF2CCFC,38951,9,11,2,109.48097,18.28868,1416
74623,1FA4B82215610E27D44D7E787BF2CCFC,30971,11,12,1,109.48708,18.29319,1467
74624,1FA4B82215610E27D44D7E787BF2CCFC,38951,13,18,5,109.48097,18.28868,1416
74625,1FA4B82215610E27D44D7E787BF2CCFC,30971,19,21,2,109.48708,18.29319,1467
74626,1FA4B82215610E27D44D7E787BF2CCFC,38951,21,23,2,109.48097,18.28868,1416
74627,C1B96048BA2CA99CE8708F27699E42B6,38094,16,17,1,109.45403,18.28778,1316
74628,C1B96048BA2CA99CE8708F27699E42B6,31231,17,18,1,109.42597,18.29292,1217
74629,C1B96048BA2CA99CE8708F27699E42B6,38754,19,21,2,109.74667,18.37382,2430
74657,56193BC7F4FC1B40D2007E4D562DF4BA,30581,12,19,7,109.62257,18.24951,1959
74658,56193BC7F4FC1B40D2007E4D562DF4BA,31571,20,22,2,109.61563,18.23326,1957
74661,8DBF34B975C421A689FCCF3E317AEF1B,30361,19,21,2,109.50347,18.24,1508
74662,8DBF34B975C421A689FCCF3E317AEF1B,30161,21,23,2,109.50042,18.24389,1508
74687,7024F3A14F6F554DC6E80063E30315F0,30854,2,4,2,109.56889,18.27076,1763
74688,7024F3A14F6F554DC6E80063E30315F0,39183,7,11,4,109.55542,18.28208,1715
74689,7024F3A14F6F554DC6E80063E30315F0,31561,12,14,2,109.56792,18.28479,1765
74690,7024F3A14F6F554DC6E80063E30315F0,39183,14,17,3,109.55542,18.28208,1715
74691,7024F3A14F6F554DC6E80063E30315F0,31561,21,23,2,109.56792,18.28479,1765
74692,BE586ACB441383CC10D7CF3923850B73,60371,0,5,5,109.53063,18.30056,1618
74693,BE586ACB441383CC10D7CF3923850B73,31931,6,7,1,109.54771,18.29403,1667
74694,BE586ACB441383CC10D7CF3923850B73,30851,9,15,6,109.5616,18.27396,1713
74706,5F5F21B79C1AD0925177661E61E6C3C9,30351,17,19,2,109.41701,18.29292,1217
74707,5F5F21B79C1AD0925177661E61E6C3C9,60401,20,21,1,109.47444,18.27583,1414
74731,247A25792C12411554236EBA19A3EA86,60161,10,11,1,109.49174,18.26181,1461
74732,247A25792C12411554236EBA19A3EA86,38251,12,14,2,109.49618,18.25493,1510
74733,247A25792C12411554236EBA19A3EA86,30271,16,17,1,109.49132,18.23153,1456
74744,08C064FB6DA5328247D353622FFCC8EE,31521,2,3,1,109.51458,18.22542,1555
74745,08C064FB6DA5328247D353622FFCC8EE,31521,4,9,5,109.51458,18.22542,1555
74746,08C064FB6DA5328247D353622FFCC8EE,31781,11,13,2,109.19847,18.2975,367
74747,08C064FB6DA5328247D353622FFCC8EE,31145,13,15,2,109.20431,18.30479,369
74748,D6A345956751BA2ACC5430EDF68A104F,39181,0,6,6,109.55153,18.28035,1715
74749,D6A345956751BA2ACC5430EDF68A104F,31931,7,13,6,109.54771,18.29403,1667
74750,D6A345956751BA2ACC5430EDF68A104F,39181,13,19,6,109.55153,18.28035,1715
74751,D6A345956751BA2ACC5430EDF68A104F,39181,20,23,3,109.55153,18.28035,1715
74774,0D00E0CA974DDA00224ACCD00B993468,30851,0,5,5,109.5616,18.27396,1713
74775,0D00E0CA974DDA00224ACCD00B993468,30854,9,11,2,109.56889,18.27076,1763
74776,0D00E0CA974DDA00224ACCD00B993468,31561,12,14,2,109.56792,18.28479,1765
74777,0D00E0CA974DDA00224ACCD00B993468,30854,15,16,1,109.56889,18.27076,1763
74778,0D00E0CA974DDA00224ACCD00B993468,31071,19,22,3,109.58257,18.28458,1815
74792,87FB240A931190D7195CA3A485DD9E27,60351,0,7,7,109.58403,18.28958,1816
74793,87FB240A931190D7195CA3A485DD9E27,30951,9,12,3,109.56208,18.25667,1761
74794,87FB240A931190D7195CA3A485DD9E27,30851,14,19,5,109.5616,18.27396,1713
74795,87FB240A931190D7195CA3A485DD9E27,60351,20,23,3,109.58403,18.28958,1816
74814,F00821368F615DCDAF214035D8EC4A44,30854,7,15,8,109.56889,18.27076,1763
74815,F00821368F615DCDAF214035D8EC4A44,31071,19,21,2,109.58257,18.28458,1815
74816,F00821368F615DCDAF214035D8EC4A44,31761,21,23,2,109.60521,18.27965,1914
74841,6FE9D30AF9D5BAD1F717916B377146E9,31201,3,10,7,109.51042,18.23819,1558
74842,6FE9D30AF9D5BAD1F717916B377146E9,31201,12,18,6,109.51042,18.23819,1558
74843,6FE9D30AF9D5BAD1F717916B377146E9,38961,18,23,5,109.50847,18.23514,1507
74853,8D7B9451E0189947198D6AC9CE51CFEE,30764,0,1,1,109.45806,18.29486,1367
74854,8D7B9451E0189947198D6AC9CE51CFEE,60391,1,4,3,109.47667,18.28757,1416
74855,8D7B9451E0189947198D6AC9CE51CFEE,31091,5,17,12,109.41201,18.31222,1170
74856,8D7B9451E0189947198D6AC9CE51CFEE,30111,18,20,2,109.47583,18.30542,1419
74857,8D7B9451E0189947198D6AC9CE51CFEE,60441,22,23,1,109.46792,18.28604,1366
74877,513924E5F8EAB458027327A1E2BAE9DB,31071,17,19,2,109.58257,18.28458,1815
74878,513924E5F8EAB458027327A1E2BAE9DB,31761,20,21,1,109.60521,18.27965,1914
74881,D947D8D9432E18EA6A214259B6E2987E,60411,0,6,6,109.32514,18.30854,869
74882,D947D8D9432E18EA6A214259B6E2987E,30661,7,11,4,109.37028,18.24361,1008
74883,D947D8D9432E18EA6A214259B6E2987E,60411,11,16,5,109.32514,18.30854,869
74884,D947D8D9432E18EA6A214259B6E2987E,30661,16,18,2,109.37028,18.24361,1008
74885,D947D8D9432E18EA6A214259B6E2987E,60411,20,23,3,109.32514,18.30854,869
74901,CB2B883155D37146FD4D4AA009B8CC00,30771,0,16,16,109.49938,18.26042,1511
74920,D73D0E1690714CD7F442C709F67E4771,60361,0,6,6,109.51938,18.29681,1567
74921,D73D0E1690714CD7F442C709F67E4771,30851,7,9,2,109.5616,18.27396,1713
74922,D73D0E1690714CD7F442C709F67E4771,31421,9,11,2,109.55382,18.22347,1705
74923,D73D0E1690714CD7F442C709F67E4771,30951,11,14,3,109.56208,18.25667,1761
74924,D73D0E1690714CD7F442C709F67E4771,30851,14,17,3,109.5616,18.27396,1713
74925,D73D0E1690714CD7F442C709F67E4771,60361,19,23,4,109.51938,18.29681,1567
74965,A14C813C3E3A7182759DA822342505B5,30851,11,15,4,109.5616,18.27396,1713
74966,A14C813C3E3A7182759DA822342505B5,39181,17,23,6,109.55153,18.28035,1715
74974,F84D949DDCBF25D5530F771BC55E0B9D,61011,2,5,3,109.60653,18.19076,1900
74976,F84D949DDCBF25D5530F771BC55E0B9D,31321,14,16,2,109.63799,18.23201,2007
74977,F84D949DDCBF25D5530F771BC55E0B9D,61011,18,23,5,109.60653,18.19076,1900
74978,00E4BC24F22404A2FC4D45749054257A,31071,2,7,5,109.58257,18.28458,1815
74979,00E4BC24F22404A2FC4D45749054257A,60631,11,13,2,109.57778,18.27583,1814
74980,00E4BC24F22404A2FC4D45749054257A,31071,15,18,3,109.58257,18.28458,1815
74981,00E4BC24F22404A2FC4D45749054257A,30854,20,22,2,109.56889,18.27076,1763
74982,00E4BC24F22404A2FC4D45749054257A,31071,22,23,1,109.58257,18.28458,1815
74984,AD39A6F857F8E578E6A2D9E072C4613F,60381,17,19,2,109.5241,18.22458,1605
74985,AD39A6F857F8E578E6A2D9E072C4613F,30361,19,20,1,109.50347,18.24,1508
74989,53490AD77ACCA93C3ED0F3DE79CA488B,31071,6,11,5,109.58257,18.28458,1815
74990,53490AD77ACCA93C3ED0F3DE79CA488B,30854,12,13,1,109.56889,18.27076,1763
74991,53490AD77ACCA93C3ED0F3DE79CA488B,31071,17,18,1,109.58257,18.28458,1815
74993,07169E7114E4F14C073261BAAC0D4491,61011,6,13,7,109.60653,18.19076,1900
74998,6E2021B014C4D0B652A2E4FE8D2CF038,31071,16,18,2,109.58257,18.28458,1815
74999,6E2021B014C4D0B652A2E4FE8D2CF038,30151,18,20,2,109.50986,18.25083,1560
75072,121138E269BBF0B506FA8CE6CEB3BF52,31931,0,13,13,109.54771,18.29403,1667
75073,121138E269BBF0B506FA8CE6CEB3BF52,39181,16,17,1,109.55153,18.28035,1715
75074,121138E269BBF0B506FA8CE6CEB3BF52,31931,18,23,5,109.54771,18.29403,1667
75083,F8DC3D69A4622DB1668B3873D901107A,31561,12,14,2,109.56792,18.28479,1765
75084,F8DC3D69A4622DB1668B3873D901107A,30321,15,23,8,109.49563,18.29611,1467
75085,9C1407835BC54BEBDB541F52E1DA1820,61011,0,2,2,109.60653,18.19076,1900
75087,9C1407835BC54BEBDB541F52E1DA1820,61011,4,7,3,109.60653,18.19076,1900
75089,9C1407835BC54BEBDB541F52E1DA1820,61011,15,16,1,109.60653,18.19076,1900
75091,9C1407835BC54BEBDB541F52E1DA1820,61011,21,23,2,109.60653,18.19076,1900
75255,8799356B7181F28146A203E5F86C52F0,31351,0,7,7,109.4959,18.28417,1465
75256,8799356B7181F28146A203E5F86C52F0,38834,8,21,13,109.47639,18.21146,1403
75257,8799356B7181F28146A203E5F86C52F0,31351,22,23,1,109.4959,18.28417,1465
75318,99CBAA6A65A50998F0A10B72B36210E4,60161,13,17,4,109.49174,18.26181,1461
75319,99CBAA6A65A50998F0A10B72B36210E4,38903,19,21,2,109.39229,18.29243,1117
75350,55FA72F7A9567EE8C2569F2A3640F92B,60371,0,4,4,109.53063,18.30056,1618
75351,55FA72F7A9567EE8C2569F2A3640F92B,31931,5,7,2,109.54771,18.29403,1667
75352,55FA72F7A9567EE8C2569F2A3640F92B,60371,11,18,7,109.53063,18.30056,1618
75364,37D38EF0062E64D55C94EB554B76F9EE,30854,0,1,1,109.56889,18.27076,1763
75365,37D38EF0062E64D55C94EB554B76F9EE,31945,2,3,1,109.58021,18.29403,1817
75366,37D38EF0062E64D55C94EB554B76F9EE,30234,5,7,2,109.60681,18.29979,1918
75367,37D38EF0062E64D55C94EB554B76F9EE,30854,7,9,2,109.56889,18.27076,1763
75368,37D38EF0062E64D55C94EB554B76F9EE,31521,18,20,2,109.51458,18.22542,1555
75369,37D38EF0062E64D55C94EB554B76F9EE,30191,21,23,2,109.50361,18.22701,1506
75392,6D9D9FEF6E1E2A39B00A5482D8A29C71,39091,8,14,6,109.50097,18.25222,1510
75414,F44476C9516E6E288D806E3D0B273E0A,31471,14,16,2,109.34583,18.29563,917
75415,F44476C9516E6E288D806E3D0B273E0A,31345,19,20,1,109.39,18.29,1066
75416,F44476C9516E6E288D806E3D0B273E0A,60561,21,22,1,109.38229,18.29785,1067
75467,CE2F298C1C14AD427DCFEBFF75DC6584,30421,18,20,2,109.50021,18.25861,1511
75468,CE2F298C1C14AD427DCFEBFF75DC6584,38157,21,22,1,109.51483,18.26958,1563
75478,1122041491C04B199A15F6E1E401D68F,60281,0,6,6,109.51743,18.25924,1561
75479,1122041491C04B199A15F6E1E401D68F,30851,8,9,1,109.5616,18.27396,1713
75480,1122041491C04B199A15F6E1E401D68F,30854,12,13,1,109.56889,18.27076,1763
75481,1122041491C04B199A15F6E1E401D68F,30851,13,15,2,109.5616,18.27396,1713
75482,919C0AB7D96F3D131A084E8BF1825A69,60131,20,21,1,109.49819,18.24778,1509
75483,919C0AB7D96F3D131A084E8BF1825A69,31521,22,23,1,109.51458,18.22542,1555
75502,4DA30323E7F41DDF0DBBA18594C0CD8F,31061,18,20,2,109.53333,18.23257,1607
75503,4DA30323E7F41DDF0DBBA18594C0CD8F,60381,20,22,2,109.5241,18.22458,1605
75513,BACB6801ACA2D5F4ABE5F40B34865F7A,30854,2,7,5,109.56889,18.27076,1763
75514,BACB6801ACA2D5F4ABE5F40B34865F7A,30851,8,13,5,109.5616,18.27396,1713
75577,01442FD72D1925EC8735B9DA554C8CD5,60131,20,21,1,109.49819,18.24778,1509
75578,01442FD72D1925EC8735B9DA554C8CD5,31521,22,23,1,109.51458,18.22542,1555
75586,012ABD06F231728C214A4BA917E75B1C,30851,0,10,10,109.5616,18.27396,1713
75587,012ABD06F231728C214A4BA917E75B1C,31561,13,15,2,109.56792,18.28479,1765
75588,012ABD06F231728C214A4BA917E75B1C,30851,16,17,1,109.5616,18.27396,1713
75589,012ABD06F231728C214A4BA917E75B1C,31561,19,23,4,109.56792,18.28479,1765
75594,65E833AB8D38C5DD26B8A2EAC456C351,30921,0,8,8,109.53903,18.29451,1667
75595,65E833AB8D38C5DD26B8A2EAC456C351,31931,11,20,9,109.54771,18.29403,1667
75596,F6351E53B2F29216163605AA9329821D,38111,0,8,8,109.52007,18.22403,1555
75597,F6351E53B2F29216163605AA9329821D,31781,10,12,2,109.19847,18.2975,367
75598,F6351E53B2F29216163605AA9329821D,38111,17,23,6,109.52007,18.22403,1555
75599,51061B3DE820AF1C1C713EF684728003,31071,1,6,5,109.58257,18.28458,1815
75600,51061B3DE820AF1C1C713EF684728003,30854,10,20,10,109.56889,18.27076,1763
75601,51061B3DE820AF1C1C713EF684728003,31071,21,23,2,109.58257,18.28458,1815
75602,A8E9C7BB918ADAD29A3EA7ACDDCD32D7,38951,0,8,8,109.48097,18.28868,1416
75603,A8E9C7BB918ADAD29A3EA7ACDDCD32D7,60041,9,16,7,109.39889,18.31944,1121
75604,A8E9C7BB918ADAD29A3EA7ACDDCD32D7,38951,17,18,1,109.48097,18.28868,1416
75605,A8E9C7BB918ADAD29A3EA7ACDDCD32D7,30771,19,20,1,109.49938,18.26042,1511
75606,A8E9C7BB918ADAD29A3EA7ACDDCD32D7,38951,21,23,2,109.48097,18.28868,1416
75641,B21CF160B0E7B775D7A1529C97D6304D,31521,0,8,8,109.51458,18.22542,1555
75642,B21CF160B0E7B775D7A1529C97D6304D,31031,11,13,2,109.49979,18.25382,1510
75643,B21CF160B0E7B775D7A1529C97D6304D,31521,13,18,5,109.51458,18.22542,1555
75644,B21CF160B0E7B775D7A1529C97D6304D,30421,19,20,1,109.50021,18.25861,1511
75645,B21CF160B0E7B775D7A1529C97D6304D,31521,21,23,2,109.51458,18.22542,1555
75646,1980C8D409DE9551539224B3D393CDAA,30071,1,16,15,109.52819,18.30472,1619
75647,1980C8D409DE9551539224B3D393CDAA,30071,17,20,3,109.52819,18.30472,1619
75648,8D2C5669816EE4B35A62B874D2922CB5,30151,0,9,9,109.50986,18.25083,1560
75649,8D2C5669816EE4B35A62B874D2922CB5,31471,11,13,2,109.34583,18.29563,917
75650,8D2C5669816EE4B35A62B874D2922CB5,60371,14,15,1,109.53063,18.30056,1618
75678,0C37E18D596D090857038629F350C2E6,30434,12,13,1,109.17083,18.35861,278
75679,0C37E18D596D090857038629F350C2E6,38484,14,17,3,109.53028,18.31528,1620
75697,84E955A0550DCD4ABBE7AEDF9211B01F,38334,0,7,7,109.65035,18.23785,2057
75699,84E955A0550DCD4ABBE7AEDF9211B01F,30854,12,16,4,109.56889,18.27076,1763
75700,84E955A0550DCD4ABBE7AEDF9211B01F,31101,18,19,1,109.65389,18.23403,2057
75701,84E955A0550DCD4ABBE7AEDF9211B01F,38334,21,23,2,109.65035,18.23785,2057
75709,D9AE11CD16B231308C3F0FB3F53BC3E9,31071,0,13,13,109.58257,18.28458,1815
75710,D9AE11CD16B231308C3F0FB3F53BC3E9,30854,14,16,2,109.56889,18.27076,1763
75746,372B6FDE38B899AE3F54A72097165114,39183,0,6,6,109.55542,18.28208,1715
75747,372B6FDE38B899AE3F54A72097165114,31561,6,10,4,109.56792,18.28479,1765
75748,372B6FDE38B899AE3F54A72097165114,39183,13,14,1,109.55542,18.28208,1715
75749,372B6FDE38B899AE3F54A72097165114,31561,15,16,1,109.56792,18.28479,1765
75750,372B6FDE38B899AE3F54A72097165114,39183,17,23,6,109.55542,18.28208,1715
75764,AAB9A05CF7766CAFD5189A62C8D82C8E,30854,11,12,1,109.56889,18.27076,1763
75765,AAB9A05CF7766CAFD5189A62C8D82C8E,30121,13,16,3,109.52861,18.27222,1613
75766,AAB9A05CF7766CAFD5189A62C8D82C8E,30854,19,23,4,109.56889,18.27076,1763
75802,7D4E42032F4B262311ED923AB8EE3966,31781,11,12,1,109.19847,18.2975,367
75803,7D4E42032F4B262311ED923AB8EE3966,30051,14,15,1,109.48917,18.21215,1453
75804,7D4E42032F4B262311ED923AB8EE3966,30711,19,20,1,109.50271,18.25347,1510
75805,7D4E42032F4B262311ED923AB8EE3966,60231,21,22,1,109.49903,18.21972,1504
75822,9915B6FF17BD3BF50FFC7042D095278F,31851,15,17,2,109.71736,18.29007,2316
75823,9915B6FF17BD3BF50FFC7042D095278F,30854,19,21,2,109.56889,18.27076,1763
75861,8752BC71725B50257436D50C6598F252,30854,11,18,7,109.56889,18.27076,1763
75862,8752BC71725B50257436D50C6598F252,31071,20,22,2,109.58257,18.28458,1815
75863,653802FBFFAEB319D5E2987830A7AC5C,60281,0,11,11,109.51743,18.25924,1561
75864,653802FBFFAEB319D5E2987830A7AC5C,60491,15,22,7,109.43354,18.30847,1269
75884,12D8E06C2EC8C969710FB791DF137B2B,31071,0,18,18,109.58257,18.28458,1815
75885,12D8E06C2EC8C969710FB791DF137B2B,30854,20,22,2,109.56889,18.27076,1763
76012,51161D5D6D1A3B73044835EE003078F8,31531,0,1,1,109.49583,18.25972,1461
76013,51161D5D6D1A3B73044835EE003078F8,30201,1,8,7,109.4909,18.26465,1462
76014,51161D5D6D1A3B73044835EE003078F8,30361,10,11,1,109.50347,18.24,1508
76015,51161D5D6D1A3B73044835EE003078F8,31821,12,14,2,109.51181,18.24924,1559
76016,51161D5D6D1A3B73044835EE003078F8,30201,18,23,5,109.4909,18.26465,1462
76030,8FE97C1052D63DE830211C405D8F5442,60631,1,7,6,109.57778,18.27583,1814
76031,8FE97C1052D63DE830211C405D8F5442,30854,8,19,11,109.56889,18.27076,1763
76064,6422CB87ACC55DDEF6EBE8946593C808,38171,0,7,7,109.50799,18.28139,1515
76065,6422CB87ACC55DDEF6EBE8946593C808,38834,11,12,1,109.47639,18.21146,1403
76066,6422CB87ACC55DDEF6EBE8946593C808,60231,16,17,1,109.49903,18.21972,1504
76067,6422CB87ACC55DDEF6EBE8946593C808,38834,18,19,1,109.47639,18.21146,1403
76068,6422CB87ACC55DDEF6EBE8946593C808,31351,21,23,2,109.4959,18.28417,1465
76123,9AA959ED87D1ECC3053DED17290EFCBD,39183,0,3,3,109.55542,18.28208,1715
76124,9AA959ED87D1ECC3053DED17290EFCBD,31561,4,23,19,109.56792,18.28479,1765
76140,7890099D98AA300C5BF12527E7372DB0,60631,0,14,14,109.57778,18.27583,1814
76141,7890099D98AA300C5BF12527E7372DB0,30854,16,18,2,109.56889,18.27076,1763
76142,7890099D98AA300C5BF12527E7372DB0,60631,20,21,1,109.57778,18.27583,1814
76149,C1F80FD61770F46AF18F3BEF2B67E7ED,31551,0,8,8,109.55868,18.24222,1708
76150,C1F80FD61770F46AF18F3BEF2B67E7ED,31781,11,13,2,109.19847,18.2975,367
76151,C1F80FD61770F46AF18F3BEF2B67E7ED,31551,15,23,8,109.55868,18.24222,1708
76222,32D0EBFA645FCE8DAD65D018847E5043,30232,0,6,6,109.6191,18.31701,1971
76223,32D0EBFA645FCE8DAD65D018847E5043,30854,6,19,13,109.56889,18.27076,1763
76224,32D0EBFA645FCE8DAD65D018847E5043,30232,20,21,1,109.6191,18.31701,1971
76225,5AE7D6F49D49A5EB75903602796D6641,60524,3,5,2,109.42951,18.28993,1216
76226,5AE7D6F49D49A5EB75903602796D6641,60401,6,8,2,109.47444,18.27583,1414
76227,5AE7D6F49D49A5EB75903602796D6641,31701,10,11,1,109.44132,18.28833,1266
76228,5AE7D6F49D49A5EB75903602796D6641,31101,13,14,1,109.65389,18.23403,2057
76229,5AE7D6F49D49A5EB75903602796D6641,31061,18,19,1,109.53333,18.23257,1607
76237,A3F1A757214C25A449688115E5C4321B,60371,0,4,4,109.53063,18.30056,1618
76238,A3F1A757214C25A449688115E5C4321B,31931,4,6,2,109.54771,18.29403,1667
76239,7A0882E1E0002B59317F5484D01238B3,31521,0,9,9,109.51458,18.22542,1555
76240,7A0882E1E0002B59317F5484D01238B3,60381,9,11,2,109.5241,18.22458,1605
76241,7A0882E1E0002B59317F5484D01238B3,31521,12,17,5,109.51458,18.22542,1555
76242,7A0882E1E0002B59317F5484D01238B3,30161,18,20,2,109.50042,18.24389,1508
76243,7A0882E1E0002B59317F5484D01238B3,31031,20,21,1,109.49979,18.25382,1510
76247,D12813139FDE232B707FEA7A6291700B,30321,0,17,17,109.49563,18.29611,1467
76248,D12813139FDE232B707FEA7A6291700B,31091,19,20,1,109.41201,18.31222,1170
76249,D12813139FDE232B707FEA7A6291700B,30361,22,23,1,109.50347,18.24,1508
76261,C1DFDFC110B50DFE0D66E47848759FB2,39183,9,12,3,109.55542,18.28208,1715
76263,C1DFDFC110B50DFE0D66E47848759FB2,38961,19,20,1,109.50847,18.23514,1507
76282,B8EC831ABF4906CAA75AE857A37BEB34,31571,0,12,12,109.61563,18.23326,1957
76283,B8EC831ABF4906CAA75AE857A37BEB34,60211,13,16,3,109.63549,18.26049,2011
76284,B8EC831ABF4906CAA75AE857A37BEB34,38071,18,19,1,109.40722,18.30938,1169
76290,40285EE8CCE25C38988EC087545664EC,31071,2,7,5,109.58257,18.28458,1815
76291,40285EE8CCE25C38988EC087545664EC,30854,7,11,4,109.56889,18.27076,1763
76292,40285EE8CCE25C38988EC087545664EC,31071,11,12,1,109.58257,18.28458,1815
76355,C8922FAF66F21ECAECB6B717FCD5A53B,60614,15,17,2,109.48799,18.29521,1467
76356,C8922FAF66F21ECAECB6B717FCD5A53B,60391,17,19,2,109.47667,18.28757,1416
76357,C8922FAF66F21ECAECB6B717FCD5A53B,60614,20,23,3,109.48799,18.29521,1467
76379,9E8746086915F9D4A063A74CF0B5B7AB,31561,0,1,1,109.56792,18.28479,1765
76380,9E8746086915F9D4A063A74CF0B5B7AB,30851,1,2,1,109.5616,18.27396,1713
76381,9E8746086915F9D4A063A74CF0B5B7AB,31561,3,5,2,109.56792,18.28479,1765
76382,9E8746086915F9D4A063A74CF0B5B7AB,39183,8,17,9,109.55542,18.28208,1715
76383,9E8746086915F9D4A063A74CF0B5B7AB,31561,18,23,5,109.56792,18.28479,1765
76410,85E3E19546A8845252074D0B609723D5,30951,12,13,1,109.56208,18.25667,1761
76411,85E3E19546A8845252074D0B609723D5,30854,17,18,1,109.56889,18.27076,1763
76412,85E3E19546A8845252074D0B609723D5,30951,21,23,2,109.56208,18.25667,1761
76416,30D8A678A1441E4FFDF2E3F44AE24060,31071,0,9,9,109.58257,18.28458,1815
76417,30D8A678A1441E4FFDF2E3F44AE24060,30854,9,11,2,109.56889,18.27076,1763
76418,30D8A678A1441E4FFDF2E3F44AE24060,31071,14,16,2,109.58257,18.28458,1815
76486,8B67CA01C44A0A9FF0492771727FF584,30854,0,16,16,109.56889,18.27076,1763
76487,8B67CA01C44A0A9FF0492771727FF584,38241,16,19,3,109.54111,18.30542,1669
76509,103ECFAC0852C7C647F1E538F02D4D90,60211,12,14,2,109.63549,18.26049,2011
76510,103ECFAC0852C7C647F1E538F02D4D90,30501,15,19,4,109.72,18.34951,2326
76511,103ECFAC0852C7C647F1E538F02D4D90,31841,22,23,1,109.73201,18.33382,2373
76534,5CFFF8D919E96524101209E188C669B3,31951,19,23,4,109.52174,18.30299,1568
76547,11111C6844101386CE50DF2BBF6A2434,60101,17,19,2,109.75465,18.40139,2485
76548,11111C6844101386CE50DF2BBF6A2434,31461,20,22,2,109.5091,18.25389,1510
76603,06540DDC6C869D24F26FD34ED45D168E,31345,14,18,4,109.39,18.29,1066
76604,06540DDC6C869D24F26FD34ED45D168E,30661,22,23,1,109.37028,18.24361,1008
76611,E75CF54BA14775FEDD26504F9F6B7365,31945,0,6,6,109.58021,18.29403,1817
76612,E75CF54BA14775FEDD26504F9F6B7365,31561,6,14,8,109.56792,18.28479,1765
76613,E75CF54BA14775FEDD26504F9F6B7365,30854,16,17,1,109.56889,18.27076,1763
76614,E75CF54BA14775FEDD26504F9F6B7365,31561,17,18,1,109.56792,18.28479,1765
76615,E75CF54BA14775FEDD26504F9F6B7365,31945,21,23,2,109.58021,18.29403,1817
76647,D04CD9DD8CE80FB000DDFF2A9F0DD83D,60131,0,7,7,109.49819,18.24778,1509
76648,D04CD9DD8CE80FB000DDFF2A9F0DD83D,60117,9,15,6,109.73604,18.35681,2427
76649,D04CD9DD8CE80FB000DDFF2A9F0DD83D,30771,16,18,2,109.49938,18.26042,1511
76650,D04CD9DD8CE80FB000DDFF2A9F0DD83D,60131,18,19,1,109.49819,18.24778,1509
76651,D04CD9DD8CE80FB000DDFF2A9F0DD83D,30421,20,21,1,109.50021,18.25861,1511
76652,D04CD9DD8CE80FB000DDFF2A9F0DD83D,60131,22,23,1,109.49819,18.24778,1509
76699,C24CAAFE002C4A637E7D01C4B7549E3D,30271,0,6,6,109.49132,18.23153,1456
76701,C24CAAFE002C4A637E7D01C4B7549E3D,30271,14,23,9,109.49132,18.23153,1456
76716,8DA877D3A30401F86E81FB7BC1CA2A00,30854,0,1,1,109.56889,18.27076,1763
76717,8DA877D3A30401F86E81FB7BC1CA2A00,31071,2,5,3,109.58257,18.28458,1815
76718,8DA877D3A30401F86E81FB7BC1CA2A00,30854,5,13,8,109.56889,18.27076,1763
76719,2AE38FAF341950B0B91404FFCE5A0F3E,30921,6,18,12,109.53903,18.29451,1667
76720,2AE38FAF341950B0B91404FFCE5A0F3E,31931,19,23,4,109.54771,18.29403,1667
76724,39F25FE146A03325C93C111F2A943B6C,30854,13,14,1,109.56889,18.27076,1763
76725,39F25FE146A03325C93C111F2A943B6C,31071,15,19,4,109.58257,18.28458,1815
76726,58418A9EA4A7DC03127CB79C039A5185,30854,0,16,16,109.56889,18.27076,1763
76727,58418A9EA4A7DC03127CB79C039A5185,31031,17,18,1,109.49979,18.25382,1510
76728,58418A9EA4A7DC03127CB79C039A5185,60131,20,21,1,109.49819,18.24778,1509
76775,7FD6B252EEC1A25653323974CFE380D9,30181,0,6,6,109.51597,18.23313,1557
76776,7FD6B252EEC1A25653323974CFE380D9,30191,6,8,2,109.50361,18.22701,1506
76777,7FD6B252EEC1A25653323974CFE380D9,60231,9,12,3,109.49903,18.21972,1504
76778,7FD6B252EEC1A25653323974CFE380D9,30181,13,14,1,109.51597,18.23313,1557
76779,7FD6B252EEC1A25653323974CFE380D9,38132,15,23,8,109.64632,18.23417,2057
76833,4E5E7B62F697D24D87C90994BD547EC8,38271,14,16,2,109.62632,18.23049,1956
76836,DFFF17B7FE30E79B8AABBB5CE171272F,31561,4,5,1,109.56792,18.28479,1765
76837,DFFF17B7FE30E79B8AABBB5CE171272F,39183,6,11,5,109.55542,18.28208,1715
76863,0F91AB88D936BFA1E1D2836B4DAF2D14,30854,0,6,6,109.56889,18.27076,1763
76864,0F91AB88D936BFA1E1D2836B4DAF2D14,30531,8,18,10,109.53271,18.21472,1604
76875,0CD3A9451B945A7EABB5A7155C5317AC,38826,0,10,10,109.50326,18.25514,1510
76876,0CD3A9451B945A7EABB5A7155C5317AC,38251,12,13,1,109.49618,18.25493,1510
76877,0CD3A9451B945A7EABB5A7155C5317AC,31031,14,17,3,109.49979,18.25382,1510
76917,E0A24740E2C54F3B77DB561A91D2BED7,31821,0,6,6,109.51181,18.24924,1559
76918,E0A24740E2C54F3B77DB561A91D2BED7,60281,7,8,1,109.51743,18.25924,1561
76919,E0A24740E2C54F3B77DB561A91D2BED7,30251,8,16,8,109.50611,18.26653,1512
76920,E0A24740E2C54F3B77DB561A91D2BED7,30151,18,23,5,109.50986,18.25083,1560
76974,0D69669D4DBC1CEB06269A084D86E853,60631,1,2,1,109.57778,18.27583,1814
76975,0D69669D4DBC1CEB06269A084D86E853,30232,3,9,6,109.6191,18.31701,1971
76976,0D69669D4DBC1CEB06269A084D86E853,60631,11,16,5,109.57778,18.27583,1814
77024,319629CFCE811660E456414DCC11FF06,31421,18,19,1,109.55382,18.22347,1705
77025,319629CFCE811660E456414DCC11FF06,31861,20,23,3,109.49042,18.27549,1464
77036,C7CE46A68B16C88AA10A9267A7FDF653,60524,0,10,10,109.42951,18.28993,1216
77037,C7CE46A68B16C88AA10A9267A7FDF653,31101,13,14,1,109.65389,18.23403,2057
77038,C7CE46A68B16C88AA10A9267A7FDF653,31061,15,23,8,109.53333,18.23257,1607
77079,9390F3530298874939B7DDA5575429FD,60401,3,5,2,109.47444,18.27583,1414
77080,9390F3530298874939B7DDA5575429FD,60201,7,9,2,109.5041,18.2509,1510
77081,9390F3530298874939B7DDA5575429FD,38754,12,14,2,109.74667,18.37382,2430
77082,9390F3530298874939B7DDA5575429FD,31701,16,17,1,109.44132,18.28833,1266
77213,967E548F53382C36FB0D7FF12F6A99E7,30771,0,8,8,109.49938,18.26042,1511
77214,967E548F53382C36FB0D7FF12F6A99E7,31531,8,14,6,109.49583,18.25972,1461
77215,967E548F53382C36FB0D7FF12F6A99E7,30201,17,23,6,109.4909,18.26465,1462
77227,77A5CD8493B54A67E96B189E9753DE10,31231,0,7,7,109.42597,18.29292,1217
77228,77A5CD8493B54A67E96B189E9753DE10,38025,7,9,2,109.36903,18.29167,1016
77229,77A5CD8493B54A67E96B189E9753DE10,60561,9,11,2,109.38229,18.29785,1067
77230,77A5CD8493B54A67E96B189E9753DE10,31231,12,14,2,109.42597,18.29292,1217
77231,77A5CD8493B54A67E96B189E9753DE10,60552,14,16,2,109.41729,18.30014,1218
77232,77A5CD8493B54A67E96B189E9753DE10,31231,18,20,2,109.42597,18.29292,1217
77233,2F3BB5BE10811E7F8F8565DAA2126DE6,39181,0,5,5,109.55153,18.28035,1715
77234,2F3BB5BE10811E7F8F8565DAA2126DE6,31931,5,14,9,109.54771,18.29403,1667
77235,2F3BB5BE10811E7F8F8565DAA2126DE6,39181,18,23,5,109.55153,18.28035,1715
77258,2E37B6A823BB12DF110868FD413961C7,30931,17,19,2,109.55653,18.32722,1722
77259,2E37B6A823BB12DF110868FD413961C7,60361,20,23,3,109.51938,18.29681,1567
77270,14F1CC63CDA098F9694EAC8584B9C7A5,30051,0,1,1,109.48917,18.21215,1453
77271,14F1CC63CDA098F9694EAC8584B9C7A5,31561,2,21,19,109.56792,18.28479,1765
77274,B16977B88DE920FADD302624AE75E34D,31761,0,4,4,109.60521,18.27965,1914
77275,B16977B88DE920FADD302624AE75E34D,31071,4,6,2,109.58257,18.28458,1815
77276,B16977B88DE920FADD302624AE75E34D,31561,6,7,1,109.56792,18.28479,1765
77277,B16977B88DE920FADD302624AE75E34D,30851,8,17,9,109.5616,18.27396,1713
77278,B16977B88DE920FADD302624AE75E34D,31945,20,23,3,109.58021,18.29403,1817
77301,E218C587552A5DADC05C4E69685FE374,30854,18,19,1,109.56889,18.27076,1763
77302,E218C587552A5DADC05C4E69685FE374,39183,21,22,1,109.55542,18.28208,1715
77316,12D34EABAB055EE48AA4835BB7A9952C,30421,0,8,8,109.50021,18.25861,1511
77317,12D34EABAB055EE48AA4835BB7A9952C,31541,10,11,1,109.1809,18.36722,329
77318,12D34EABAB055EE48AA4835BB7A9952C,30451,12,13,1,109.1791,18.36229,278
77319,12D34EABAB055EE48AA4835BB7A9952C,30421,17,23,6,109.50021,18.25861,1511
77367,2225A928A5F41EC3C7691341B4D74A48,38297,1,7,6,109.52576,18.24965,1609
77368,2225A928A5F41EC3C7691341B4D74A48,60281,9,10,1,109.51743,18.25924,1561
77369,2225A928A5F41EC3C7691341B4D74A48,30084,12,14,2,109.50118,18.26972,1513
77405,4370C9D6E8995C0B49B7BF1384E2954D,38951,0,10,10,109.48097,18.28868,1416
77406,4370C9D6E8995C0B49B7BF1384E2954D,30971,12,13,1,109.48708,18.29319,1467
77407,4370C9D6E8995C0B49B7BF1384E2954D,38951,15,18,3,109.48097,18.28868,1416
77408,4370C9D6E8995C0B49B7BF1384E2954D,38951,21,23,2,109.48097,18.28868,1416
77481,4C15740C85B7C75F2E990BCFA0AEA625,38251,1,2,1,109.49618,18.25493,1510
77482,4C15740C85B7C75F2E990BCFA0AEA625,60401,6,9,3,109.47444,18.27583,1414
77483,4C15740C85B7C75F2E990BCFA0AEA625,31031,9,11,2,109.49979,18.25382,1510
77484,4C15740C85B7C75F2E990BCFA0AEA625,31031,20,21,1,109.49979,18.25382,1510
77485,4C15740C85B7C75F2E990BCFA0AEA625,60401,21,23,2,109.47444,18.27583,1414
77488,0C3DD1EABA2D708A2506DA8150CEC148,31561,0,6,6,109.56792,18.28479,1765
77489,0C3DD1EABA2D708A2506DA8150CEC148,30854,8,10,2,109.56889,18.27076,1763
77490,0C3DD1EABA2D708A2506DA8150CEC148,31561,10,13,3,109.56792,18.28479,1765
77491,0C3DD1EABA2D708A2506DA8150CEC148,30854,15,16,1,109.56889,18.27076,1763
77492,0C3DD1EABA2D708A2506DA8150CEC148,31561,17,22,5,109.56792,18.28479,1765
77540,2F64FEF19C86AA0A8AA3E3FA37CC4F2D,30854,0,1,1,109.56889,18.27076,1763
77541,2F64FEF19C86AA0A8AA3E3FA37CC4F2D,30851,1,7,6,109.5616,18.27396,1713
77542,2F64FEF19C86AA0A8AA3E3FA37CC4F2D,60631,9,10,1,109.57778,18.27583,1814
77543,2F64FEF19C86AA0A8AA3E3FA37CC4F2D,30854,10,19,9,109.56889,18.27076,1763
77562,5B058EBBD270D4814B560F0B36F48A4A,31561,12,14,2,109.56792,18.28479,1765
77563,5B058EBBD270D4814B560F0B36F48A4A,30321,15,22,7,109.49563,18.29611,1467
77590,FCFB14BA36BDB7CD6A39612B9AE933B2,38127,0,7,7,109.50833,18.27222,1513
77591,FCFB14BA36BDB7CD6A39612B9AE933B2,31931,9,11,2,109.54771,18.29403,1667
77592,FCFB14BA36BDB7CD6A39612B9AE933B2,39183,12,13,1,109.55542,18.28208,1715
77593,FCFB14BA36BDB7CD6A39612B9AE933B2,31931,14,16,2,109.54771,18.29403,1667
77594,FCFB14BA36BDB7CD6A39612B9AE933B2,30081,20,22,2,109.50243,18.26632,1512
77595,72839B8F6256E6FF641405D4832BF569,31071,0,7,7,109.58257,18.28458,1815
77596,72839B8F6256E6FF641405D4832BF569,30854,11,12,1,109.56889,18.27076,1763
77609,599AFAF71D30C85AA4E0085C43FF5E03,60221,0,1,1,109.52569,18.29188,1616
77610,599AFAF71D30C85AA4E0085C43FF5E03,31206,1,2,1,109.50819,18.23549,1507
77611,599AFAF71D30C85AA4E0085C43FF5E03,31206,3,6,3,109.50819,18.23549,1507
77612,599AFAF71D30C85AA4E0085C43FF5E03,38291,13,15,2,109.51618,18.24313,1558
77613,599AFAF71D30C85AA4E0085C43FF5E03,31421,15,21,6,109.55382,18.22347,1705
77625,9F0C410FCC258D7DDDE61AECD9DDED82,30854,0,7,7,109.56889,18.27076,1763
77627,9F0C410FCC258D7DDDE61AECD9DDED82,30854,11,23,12,109.56889,18.27076,1763
77630,7BF65E5054DA81A230AB5423620158E1,60631,0,6,6,109.57778,18.27583,1814
77631,7BF65E5054DA81A230AB5423620158E1,30854,7,9,2,109.56889,18.27076,1763
77632,7BF65E5054DA81A230AB5423620158E1,60631,11,13,2,109.57778,18.27583,1814
77633,7BF65E5054DA81A230AB5423620158E1,30854,13,17,4,109.56889,18.27076,1763
77656,FCF69C4EB20A61D7801C0D8953A36537,31071,0,7,7,109.58257,18.28458,1815
77657,FCF69C4EB20A61D7801C0D8953A36537,31561,7,8,1,109.56792,18.28479,1765
77658,FCF69C4EB20A61D7801C0D8953A36537,31071,12,23,11,109.58257,18.28458,1815
77661,D8757A808F606352AF3AC0BD9CD2C12A,31101,17,19,2,109.65389,18.23403,2057
77662,D8757A808F606352AF3AC0BD9CD2C12A,30854,20,21,1,109.56889,18.27076,1763
77691,B432C0186449A28ED200760F76E06147,60524,0,9,9,109.42951,18.28993,1216
77692,B432C0186449A28ED200760F76E06147,39151,13,15,2,109.49875,18.25097,1510
77693,B432C0186449A28ED200760F76E06147,38251,16,17,1,109.49618,18.25493,1510
77694,B432C0186449A28ED200760F76E06147,60401,18,20,2,109.47444,18.27583,1414
77695,B432C0186449A28ED200760F76E06147,60524,21,23,2,109.42951,18.28993,1216
77699,E6651E3C6D8FEA2077D9EFC6D097D06C,38251,0,13,13,109.49618,18.25493,1510
77700,E6651E3C6D8FEA2077D9EFC6D097D06C,30711,17,23,6,109.50271,18.25347,1510
77724,079A114D194FE2EFB0C89059CA4EBC03,31251,0,2,2,109.18528,18.2975,317
77726,079A114D194FE2EFB0C89059CA4EBC03,31251,9,12,3,109.18528,18.2975,317
77798,52A7280BA3A0FD171DDC8618F647763C,31521,0,10,10,109.51458,18.22542,1555
77799,52A7280BA3A0FD171DDC8618F647763C,30271,14,16,2,109.49132,18.23153,1456
77800,52A7280BA3A0FD171DDC8618F647763C,38251,19,21,2,109.49618,18.25493,1510
77824,DEB0ECEC5EC593548F1436EFB82D45FB,60361,0,6,6,109.51938,18.29681,1567
77825,DEB0ECEC5EC593548F1436EFB82D45FB,60331,9,10,1,109.505,18.26507,1512
77826,DEB0ECEC5EC593548F1436EFB82D45FB,31421,11,13,2,109.55382,18.22347,1705
77827,DEB0ECEC5EC593548F1436EFB82D45FB,31551,14,16,2,109.55868,18.24222,1708
77828,DEB0ECEC5EC593548F1436EFB82D45FB,60361,19,23,4,109.51938,18.29681,1567
77829,A46BA306DAEA889FAC7ACE9E5FD6A1FF,60331,0,2,2,109.505,18.26507,1512
77830,A46BA306DAEA889FAC7ACE9E5FD6A1FF,39154,5,6,1,109.50201,18.25681,1511
77831,A46BA306DAEA889FAC7ACE9E5FD6A1FF,60331,6,8,2,109.505,18.26507,1512
77833,C9A6646B972DBA0085DABB092A32801A,38127,19,21,2,109.50833,18.27222,1513
77834,C9A6646B972DBA0085DABB092A32801A,30081,22,23,1,109.50243,18.26632,1512
77835,E649CF84A26278291AA1A5B5C5D01FCA,30854,0,16,16,109.56889,18.27076,1763
77836,E649CF84A26278291AA1A5B5C5D01FCA,31561,16,23,7,109.56792,18.28479,1765
77849,B84B247FA61A8C12DFCCCF3C2D72006D,31945,1,4,3,109.58021,18.29403,1817
77850,B84B247FA61A8C12DFCCCF3C2D72006D,31071,6,10,4,109.58257,18.28458,1815
77851,B84B247FA61A8C12DFCCCF3C2D72006D,30854,10,11,1,109.56889,18.27076,1763
77852,B84B247FA61A8C12DFCCCF3C2D72006D,31071,15,16,1,109.58257,18.28458,1815
77892,A316D0DC5964BFEDB6CDF37499B8E5FF,60631,0,7,7,109.57778,18.27583,1814
77893,A316D0DC5964BFEDB6CDF37499B8E5FF,30851,8,17,9,109.5616,18.27396,1713
77897,6C0260646767B781577B5B8CE2471E51,38484,6,17,11,109.53028,18.31528,1620
77898,6C0260646767B781577B5B8CE2471E51,30071,20,22,2,109.52819,18.30472,1619
77899,6C0260646767B781577B5B8CE2471E51,38484,22,23,1,109.53028,18.31528,1620
77920,8F6EA1C108FADA76A214A7ED71ECE3D1,30891,0,5,5,109.59431,18.28389,1865
77921,8F6EA1C108FADA76A214A7ED71ECE3D1,30854,6,13,7,109.56889,18.27076,1763
77922,8F6EA1C108FADA76A214A7ED71ECE3D1,30851,15,16,1,109.5616,18.27396,1713
77962,7D7F0272C9EBC060D193BEFCF3336FD2,60551,1,6,5,109.42722,18.30111,1218
77963,7D7F0272C9EBC060D193BEFCF3336FD2,60552,7,8,1,109.41729,18.30014,1218
77971,B4D2B6FFD1C494680FE0C505C6C9A74D,60361,0,10,10,109.51938,18.29681,1567
77972,B4D2B6FFD1C494680FE0C505C6C9A74D,31931,12,19,7,109.54771,18.29403,1667
77988,4BDDDFE5CA0514443B2B3ACDA26168C5,31421,7,10,3,109.55382,18.22347,1705
77989,4BDDDFE5CA0514443B2B3ACDA26168C5,30951,10,14,4,109.56208,18.25667,1761
77990,4BDDDFE5CA0514443B2B3ACDA26168C5,31421,14,19,5,109.55382,18.22347,1705
77991,4BDDDFE5CA0514443B2B3ACDA26168C5,30951,20,22,2,109.56208,18.25667,1761
77992,4BDDDFE5CA0514443B2B3ACDA26168C5,30851,22,23,1,109.5616,18.27396,1713
78025,6CBD210FE212796CEDBD8FF4BC0A58A4,39183,4,9,5,109.55542,18.28208,1715
78026,6CBD210FE212796CEDBD8FF4BC0A58A4,31561,10,11,1,109.56792,18.28479,1765
78027,6CBD210FE212796CEDBD8FF4BC0A58A4,39183,12,16,4,109.55542,18.28208,1715
78041,CFFDD1BF3134B9FDD71614F40E1DE0FD,31071,6,13,7,109.58257,18.28458,1815
78042,CFFDD1BF3134B9FDD71614F40E1DE0FD,60241,16,19,3,109.53319,18.28667,1616
78062,A88B35A7108477CCC954BD53412ECC82,60171,0,7,7,109.51292,18.30694,1569
78063,A88B35A7108477CCC954BD53412ECC82,31951,12,14,2,109.52174,18.30299,1568
78064,A88B35A7108477CCC954BD53412ECC82,38991,15,17,2,109.52681,18.30368,1618
78068,8AABF5FDF2B06EB445749240A3894969,31851,16,18,2,109.71736,18.29007,2316
78069,8AABF5FDF2B06EB445749240A3894969,31071,18,20,2,109.58257,18.28458,1815
78108,F2E4A1707C14AD7AF444AE9628A7C8BD,30081,2,4,2,109.50243,18.26632,1512
78109,F2E4A1707C14AD7AF444AE9628A7C8BD,30081,5,6,1,109.50243,18.26632,1512
78110,F2E4A1707C14AD7AF444AE9628A7C8BD,30081,7,19,12,109.50243,18.26632,1512
78111,F2E4A1707C14AD7AF444AE9628A7C8BD,30421,19,21,2,109.50021,18.25861,1511
78130,FE95B3A32EFBC2838F293DF38F55FDD1,30854,0,4,4,109.56889,18.27076,1763
78131,FE95B3A32EFBC2838F293DF38F55FDD1,31931,7,9,2,109.54771,18.29403,1667
78132,FE95B3A32EFBC2838F293DF38F55FDD1,39183,9,16,7,109.55542,18.28208,1715
78133,13926428EBE13B4BB9E89F09B3402551,31531,0,7,7,109.49583,18.25972,1461
78134,13926428EBE13B4BB9E89F09B3402551,31301,9,12,3,109.14493,18.31222,170
78135,13926428EBE13B4BB9E89F09B3402551,31471,12,14,2,109.34583,18.29563,917
78136,13926428EBE13B4BB9E89F09B3402551,30771,18,20,2,109.49938,18.26042,1511
78137,13926428EBE13B4BB9E89F09B3402551,38251,21,22,1,109.49618,18.25493,1510
78148,FD9120CA3F85D3F015CEFB66B9BF2F3D,30721,0,6,6,109.51597,18.28257,1565
78149,FD9120CA3F85D3F015CEFB66B9BF2F3D,60301,8,11,3,109.60715,18.30993,1919
78150,FD9120CA3F85D3F015CEFB66B9BF2F3D,38891,12,18,6,109.51486,18.24118,1558
78156,FC8552628F8A5A5219C1C30314657039,60661,0,4,4,109.548,18.2377,1657
78157,FC8552628F8A5A5219C1C30314657039,30854,8,10,2,109.56889,18.27076,1763
78158,FC8552628F8A5A5219C1C30314657039,30271,12,18,6,109.49132,18.23153,1456
78159,FC8552628F8A5A5219C1C30314657039,31031,19,20,1,109.49979,18.25382,1510
78160,FC8552628F8A5A5219C1C30314657039,60661,21,22,1,109.548,18.2377,1657
78179,86360CBE83A45C2F8F04805EB9121831,38157,0,7,7,109.51483,18.26958,1563
78180,86360CBE83A45C2F8F04805EB9121831,60331,8,11,3,109.505,18.26507,1512
78181,86360CBE83A45C2F8F04805EB9121831,38157,13,14,1,109.51483,18.26958,1563
78182,86360CBE83A45C2F8F04805EB9121831,60381,18,20,2,109.5241,18.22458,1605
78183,86360CBE83A45C2F8F04805EB9121831,30251,21,22,1,109.50611,18.26653,1512
78190,51ED683608E55A4EDEADC423E7C7B6C3,60631,0,10,10,109.57778,18.27583,1814
78191,51ED683608E55A4EDEADC423E7C7B6C3,30854,13,14,1,109.56889,18.27076,1763
78192,51ED683608E55A4EDEADC423E7C7B6C3,60631,15,19,4,109.57778,18.27583,1814
78193,51ED683608E55A4EDEADC423E7C7B6C3,30854,22,23,1,109.56889,18.27076,1763
78221,30CE72A519D49881F23B8123486E3A02,60411,0,2,2,109.32514,18.30854,869
78222,30CE72A519D49881F23B8123486E3A02,30661,2,4,2,109.37028,18.24361,1008
78223,30CE72A519D49881F23B8123486E3A02,60054,5,6,1,109.3016,18.31229,770
78224,30CE72A519D49881F23B8123486E3A02,60411,7,10,3,109.32514,18.30854,869
78225,30CE72A519D49881F23B8123486E3A02,31471,16,18,2,109.34583,18.29563,917
78226,30CE72A519D49881F23B8123486E3A02,60411,18,19,1,109.32514,18.30854,869
78239,E2A254B664D603859C9454241D0A5D2B,30181,16,17,1,109.51597,18.23313,1557
78240,E2A254B664D603859C9454241D0A5D2B,31521,18,23,5,109.51458,18.22542,1555
78268,7D9D1B6AF5E36EC156BCC81EE5745CAE,31031,11,12,1,109.49979,18.25382,1510
78269,7D9D1B6AF5E36EC156BCC81EE5745CAE,38251,15,16,1,109.49618,18.25493,1510
78270,7D9D1B6AF5E36EC156BCC81EE5745CAE,30271,17,18,1,109.49132,18.23153,1456
78286,408C4FED868686E7B96333835F4C4205,31071,0,6,6,109.58257,18.28458,1815
78287,408C4FED868686E7B96333835F4C4205,60631,7,8,1,109.57778,18.27583,1814
78288,408C4FED868686E7B96333835F4C4205,31071,8,11,3,109.58257,18.28458,1815
78289,408C4FED868686E7B96333835F4C4205,30854,12,14,2,109.56889,18.27076,1763
78343,02B6B5412B758335455F3642E59B11F1,38127,0,1,1,109.50833,18.27222,1513
78344,02B6B5412B758335455F3642E59B11F1,38951,1,7,6,109.48097,18.28868,1416
78345,02B6B5412B758335455F3642E59B11F1,60552,8,10,2,109.41729,18.30014,1218
78346,36D79DC35161ADC015B71969A834709A,31391,0,7,7,109.50382,18.24285,1508
78347,36D79DC35161ADC015B71969A834709A,60291,9,12,3,109.50826,18.24639,1509
78348,36D79DC35161ADC015B71969A834709A,31521,12,20,8,109.51458,18.22542,1555
78403,0C70A52F592FCFAC1CDC42762C9A17A0,60614,0,17,17,109.48799,18.29521,1467
78404,0C70A52F592FCFAC1CDC42762C9A17A0,31206,19,20,1,109.50819,18.23549,1507
78421,89C2F48F3C187B81197D45E0E1289EA8,30851,2,7,5,109.5616,18.27396,1713
78422,89C2F48F3C187B81197D45E0E1289EA8,30854,7,11,4,109.56889,18.27076,1763
78423,79C0E9CB0924537F3660125B77C46B0B,30321,0,7,7,109.49563,18.29611,1467
78424,79C0E9CB0924537F3660125B77C46B0B,60171,8,12,4,109.51292,18.30694,1569
78425,79C0E9CB0924537F3660125B77C46B0B,30321,12,13,1,109.49563,18.29611,1467
78508,530ABDCB6E5C0FF39924B84145065468,30361,0,13,13,109.50347,18.24,1508
78509,530ABDCB6E5C0FF39924B84145065468,38061,17,18,1,109.50597,18.23118,1506
78522,0E2E791F47920A60A5F7E41FFDC79CF5,31071,12,13,1,109.58257,18.28458,1815
78523,0E2E791F47920A60A5F7E41FFDC79CF5,39101,13,17,4,109.50132,18.24931,1509
78546,145444E87E9AD1AA916406CE6DA79363,31471,13,15,2,109.34583,18.29563,917
78547,145444E87E9AD1AA916406CE6DA79363,60221,18,21,3,109.52569,18.29188,1616
78548,145444E87E9AD1AA916406CE6DA79363,31864,21,23,2,109.49014,18.28333,1465
78566,1B6EBBFF3B9D8A3E18753343B6A29EAE,31561,13,14,1,109.56792,18.28479,1765
78567,1B6EBBFF3B9D8A3E18753343B6A29EAE,30854,15,16,1,109.56889,18.27076,1763
78568,1B6EBBFF3B9D8A3E18753343B6A29EAE,31071,19,23,4,109.58257,18.28458,1815
78575,EC89B2FFE00F967E6D0A3B697A6D636D,31071,3,6,3,109.58257,18.28458,1815
78576,EC89B2FFE00F967E6D0A3B697A6D636D,30854,7,17,10,109.56889,18.27076,1763
78577,EC89B2FFE00F967E6D0A3B697A6D636D,60281,19,21,2,109.51743,18.25924,1561
78578,EC89B2FFE00F967E6D0A3B697A6D636D,30211,22,23,1,109.49882,18.23931,1508
78594,64232E916CD3E53F0C7902BD5EE111F8,31781,13,15,2,109.19847,18.2975,367
78600,31D93E56E65CB3BFF8E1D9727D47FCD1,38991,0,7,7,109.52681,18.30368,1618
78601,31D93E56E65CB3BFF8E1D9727D47FCD1,60361,9,12,3,109.51938,18.29681,1567
78602,31D93E56E65CB3BFF8E1D9727D47FCD1,30071,14,15,1,109.52819,18.30472,1619
78603,31D93E56E65CB3BFF8E1D9727D47FCD1,38991,16,17,1,109.52681,18.30368,1618
78604,31D93E56E65CB3BFF8E1D9727D47FCD1,30561,18,19,1,109.52778,18.31938,1621
78617,4D4289AE0DFBF4B5C79A47559DC2EBDD,30854,1,19,18,109.56889,18.27076,1763
78618,4D4289AE0DFBF4B5C79A47559DC2EBDD,60381,20,22,2,109.5241,18.22458,1605
78619,68DBE0B52FD0AB95F1DD47068FD7847F,60311,0,9,9,109.52097,18.24319,1558
78620,68DBE0B52FD0AB95F1DD47068FD7847F,30181,10,13,3,109.51597,18.23313,1557
78621,68DBE0B52FD0AB95F1DD47068FD7847F,60311,14,23,9,109.52097,18.24319,1558
78622,D1437BB9EF0763F2FA311CE7BE9B7FBD,31091,3,4,1,109.41201,18.31222,1170
78623,D1437BB9EF0763F2FA311CE7BE9B7FBD,30351,4,7,3,109.41701,18.29292,1217
78624,D1437BB9EF0763F2FA311CE7BE9B7FBD,31091,7,9,2,109.41201,18.31222,1170
78660,74206C862E4BA6236E7F7978D63D1D7D,30854,15,16,1,109.56889,18.27076,1763
78661,74206C862E4BA6236E7F7978D63D1D7D,31021,19,20,1,109.49021,18.27,1463
78662,74206C862E4BA6236E7F7978D63D1D7D,30191,21,23,2,109.50361,18.22701,1506
78674,A3770B0865AC4E52928450D9302DBAEF,60221,2,7,5,109.52569,18.29188,1616
78675,A3770B0865AC4E52928450D9302DBAEF,31145,12,13,1,109.20431,18.30479,369
78676,22CF7007721E0F1D863F25E4633BE1AD,60311,0,8,8,109.52097,18.24319,1558
78677,22CF7007721E0F1D863F25E4633BE1AD,38291,12,15,3,109.51618,18.24313,1558
78678,22CF7007721E0F1D863F25E4633BE1AD,30084,16,18,2,109.50118,18.26972,1513
78679,22CF7007721E0F1D863F25E4633BE1AD,60311,20,23,3,109.52097,18.24319,1558
78693,4E9700B026D20ABF45FFBA72DED9D886,38951,0,13,13,109.48097,18.28868,1416
78694,4E9700B026D20ABF45FFBA72DED9D886,38951,14,20,6,109.48097,18.28868,1416
78695,4E9700B026D20ABF45FFBA72DED9D886,31271,20,21,1,109.48958,18.26257,1462
78696,4E9700B026D20ABF45FFBA72DED9D886,38951,22,23,1,109.48097,18.28868,1416
78712,D97D787B9F35A785017D7FF8B4ABF0D7,60381,0,7,7,109.5241,18.22458,1605
78713,D97D787B9F35A785017D7FF8B4ABF0D7,31061,7,8,1,109.53333,18.23257,1607
78714,D97D787B9F35A785017D7FF8B4ABF0D7,60381,12,14,2,109.5241,18.22458,1605
78717,BD38467346E00D9FC913492A38FA335E,31071,1,5,4,109.58257,18.28458,1815
78718,BD38467346E00D9FC913492A38FA335E,31761,6,7,1,109.60521,18.27965,1914
78719,BD38467346E00D9FC913492A38FA335E,31561,8,10,2,109.56792,18.28479,1765
78720,BD38467346E00D9FC913492A38FA335E,31071,15,16,1,109.58257,18.28458,1815
78721,BD38467346E00D9FC913492A38FA335E,31945,19,20,1,109.58021,18.29403,1817
78725,55CDDB1A84A2F40D42C80C17393C28FB,60472,3,15,12,109.46625,18.29542,1367
78726,55CDDB1A84A2F40D42C80C17393C28FB,38951,17,22,5,109.48097,18.28868,1416
78727,55CDDB1A84A2F40D42C80C17393C28FB,38951,22,23,1,109.48097,18.28868,1416
78743,2193DBFF071303BC78357ADF9D951389,30854,3,9,6,109.56889,18.27076,1763
78744,2193DBFF071303BC78357ADF9D951389,60591,11,12,1,109.61118,18.21715,1904
78745,2193DBFF071303BC78357ADF9D951389,60631,14,15,1,109.57778,18.27583,1814
78746,2193DBFF071303BC78357ADF9D951389,30851,18,21,3,109.5616,18.27396,1713
78747,2193DBFF071303BC78357ADF9D951389,60631,22,23,1,109.57778,18.27583,1814
78748,172CB232BBE684655CFBDFD055BB1CB5,30771,0,7,7,109.49938,18.26042,1511
78749,172CB232BBE684655CFBDFD055BB1CB5,31231,8,9,1,109.42597,18.29292,1217
78750,172CB232BBE684655CFBDFD055BB1CB5,30241,11,21,10,109.26174,18.3275,622
78763,24C0932BD5754CA1476755EEBD27CEBD,30084,19,20,1,109.50118,18.26972,1513
78764,24C0932BD5754CA1476755EEBD27CEBD,31811,21,23,2,109.54201,18.31806,1671
78836,222E0B6922623CE9FBB280F81068D40E,30571,2,11,9,109.50243,18.21861,1504
78837,222E0B6922623CE9FBB280F81068D40E,39321,12,15,3,109.529,18.2167,1604
78838,222E0B6922623CE9FBB280F81068D40E,30731,18,23,5,109.50944,18.22306,1555
78869,CC02FF405B205BC11ABABAB0E9CD605B,31473,16,17,1,109.34792,18.29465,917
78870,CC02FF405B205BC11ABABAB0E9CD605B,30731,18,23,5,109.50944,18.22306,1555
78929,B02D7A3F297B377D646E0F85B7C19006,61011,6,17,11,109.60653,18.19076,1900
78930,B02D7A3F297B377D646E0F85B7C19006,30151,18,20,2,109.50986,18.25083,1560
78938,3720DDB8E91BF73FF05637BA50F0661B,31521,17,18,1,109.51458,18.22542,1555
78939,3720DDB8E91BF73FF05637BA50F0661B,30511,21,22,1,109.51069,18.24208,1558
78942,246EF4D95FA494895EFB2D649512DAE7,60081,0,3,3,109.51097,18.22639,1556
78943,246EF4D95FA494895EFB2D649512DAE7,60381,3,4,1,109.5241,18.22458,1605
78944,246EF4D95FA494895EFB2D649512DAE7,61011,8,10,2,109.60653,18.19076,1900
78968,080247CC19405F981D4BEFE1A1E9D339,31931,1,5,4,109.54771,18.29403,1667
78969,080247CC19405F981D4BEFE1A1E9D339,39181,5,16,11,109.55153,18.28035,1715
79006,19F803FB996471824A8A9928BBFAB433,39181,0,5,5,109.55153,18.28035,1715
79007,19F803FB996471824A8A9928BBFAB433,31931,6,9,3,109.54771,18.29403,1667
79008,19F803FB996471824A8A9928BBFAB433,39181,11,17,6,109.55153,18.28035,1715
79014,104D50A9C0319F25E132948E6191A1E5,30271,0,6,6,109.49132,18.23153,1456
79015,104D50A9C0319F25E132948E6191A1E5,60161,7,10,3,109.49174,18.26181,1461
79016,104D50A9C0319F25E132948E6191A1E5,60084,10,12,2,109.4984,18.2334,1507
79017,104D50A9C0319F25E132948E6191A1E5,30211,12,15,3,109.49882,18.23931,1508
79018,F95E8C48F26FEDEBE2F61D5B3778D40A,60641,11,16,5,109.53854,18.2359,1657
79019,F95E8C48F26FEDEBE2F61D5B3778D40A,31421,19,20,1,109.55382,18.22347,1705
79020,F95E8C48F26FEDEBE2F61D5B3778D40A,38541,21,23,2,109.73715,18.34875,2426
79166,45FA8AF959A216E06C82392E21728E7F,31561,0,9,9,109.56792,18.28479,1765
79167,45FA8AF959A216E06C82392E21728E7F,30851,10,11,1,109.5616,18.27396,1713
79168,45FA8AF959A216E06C82392E21728E7F,31071,13,14,1,109.58257,18.28458,1815
79169,45FA8AF959A216E06C82392E21728E7F,30851,15,18,3,109.5616,18.27396,1713
79170,45FA8AF959A216E06C82392E21728E7F,31561,20,23,3,109.56792,18.28479,1765
79171,F5241F30A5380EF6C0AA7917E77D8230,60371,0,6,6,109.53063,18.30056,1618
79211,FF8CB3D02361FAEBFE418108180099D8,60201,0,12,12,109.5041,18.2509,1510
79212,FF8CB3D02361FAEBFE418108180099D8,30711,14,21,7,109.50271,18.25347,1510
79222,D4EE8E1A4C04A1FF0596E4221D0B8B42,31071,0,6,6,109.58257,18.28458,1815
79223,D4EE8E1A4C04A1FF0596E4221D0B8B42,30854,7,9,2,109.56889,18.27076,1763
79224,D4EE8E1A4C04A1FF0596E4221D0B8B42,31071,11,12,1,109.58257,18.28458,1815
79225,D4EE8E1A4C04A1FF0596E4221D0B8B42,30854,13,17,4,109.56889,18.27076,1763
79242,E2875F3D6B45C4D271B5DDC71A8A371B,38754,14,18,4,109.74667,18.37382,2430
79243,E2875F3D6B45C4D271B5DDC71A8A371B,60291,21,22,1,109.50826,18.24639,1509
79244,5A888DC7A3AA300CC584D9862C5384A1,30721,1,6,5,109.51597,18.28257,1565
79245,5A888DC7A3AA300CC584D9862C5384A1,30911,9,10,1,109.50493,18.26181,1511
79246,5A888DC7A3AA300CC584D9862C5384A1,39183,14,16,2,109.55542,18.28208,1715
79247,5A888DC7A3AA300CC584D9862C5384A1,38171,18,19,1,109.50799,18.28139,1515
79277,875F4B80762D0E664890361D764F907D,60081,0,7,7,109.51097,18.22639,1556
79278,875F4B80762D0E664890361D764F907D,30571,7,18,11,109.50243,18.21861,1504
79279,875F4B80762D0E664890361D764F907D,60081,19,22,3,109.51097,18.22639,1556
79351,28FD729A56A38491CC99ABB23711BC1C,39181,0,11,11,109.55153,18.28035,1715
79352,28FD729A56A38491CC99ABB23711BC1C,31931,12,14,2,109.54771,18.29403,1667
79353,28FD729A56A38491CC99ABB23711BC1C,39181,16,23,7,109.55153,18.28035,1715
79360,EA88ED728918442D87692D43C7401C41,30191,0,9,9,109.50361,18.22701,1506
79361,EA88ED728918442D87692D43C7401C41,30361,10,12,2,109.50347,18.24,1508
79362,EA88ED728918442D87692D43C7401C41,30731,13,14,1,109.50944,18.22306,1555
79363,EA88ED728918442D87692D43C7401C41,31521,15,20,5,109.51458,18.22542,1555
79402,546BD11519F9A54B0591AC07E93BC6C8,30571,0,8,8,109.50243,18.21861,1504
79403,546BD11519F9A54B0591AC07E93BC6C8,31471,12,14,2,109.34583,18.29563,917
79404,546BD11519F9A54B0591AC07E93BC6C8,38023,17,18,1,109.37132,18.28993,1016
79405,546BD11519F9A54B0591AC07E93BC6C8,30571,21,23,2,109.50243,18.21861,1504
79406,9B389AE8E9B004176803CCEAFF69104A,31071,3,4,1,109.58257,18.28458,1815
79407,9B389AE8E9B004176803CCEAFF69104A,60631,5,19,14,109.57778,18.27583,1814
79455,8877F0646282478FC034CF7A2CC8A7FE,31521,0,19,19,109.51458,18.22542,1555
79456,8877F0646282478FC034CF7A2CC8A7FE,30361,19,21,2,109.50347,18.24,1508
79464,1A9D6D9AE0D6F5B000E0E24A10F5D2D5,60371,0,8,8,109.53063,18.30056,1618
79465,1A9D6D9AE0D6F5B000E0E24A10F5D2D5,31931,13,15,2,109.54771,18.29403,1667
79466,1A9D6D9AE0D6F5B000E0E24A10F5D2D5,60371,15,16,1,109.53063,18.30056,1618
79470,8A64E05F17255A0E415C79E9E83BB775,30671,0,3,3,109.43611,18.30139,1268
79471,8A64E05F17255A0E415C79E9E83BB775,31431,4,6,2,109.44639,18.29042,1316
79472,8A64E05F17255A0E415C79E9E83BB775,30671,7,8,1,109.43611,18.30139,1268
79490,80779C982E47128931C5479B9B9DAF80,30421,0,9,9,109.50021,18.25861,1511
79491,80779C982E47128931C5479B9B9DAF80,30711,9,10,1,109.50271,18.25347,1510
79492,80779C982E47128931C5479B9B9DAF80,30151,12,14,2,109.50986,18.25083,1560
79493,80779C982E47128931C5479B9B9DAF80,38157,15,20,5,109.51483,18.26958,1563
79494,80779C982E47128931C5479B9B9DAF80,30421,21,23,2,109.50021,18.25861,1511
79516,8E244E94833DBF281BCBFE2F4A36E102,60641,0,7,7,109.53854,18.2359,1657
79517,8E244E94833DBF281BCBFE2F4A36E102,31421,7,8,1,109.55382,18.22347,1705
79518,8E244E94833DBF281BCBFE2F4A36E102,60641,11,23,12,109.53854,18.2359,1657
79519,AC138466D01C962CA6314931C59248B4,30861,0,3,3,109.52722,18.22743,1606
79520,AC138466D01C962CA6314931C59248B4,30861,4,8,4,109.52722,18.22743,1606
79521,AC138466D01C962CA6314931C59248B4,31781,11,14,3,109.19847,18.2975,367
79536,17D13F6A66037B54FAB5668CDC734401,30721,0,8,8,109.51597,18.28257,1565
79537,17D13F6A66037B54FAB5668CDC734401,39181,9,11,2,109.55153,18.28035,1715
79538,17D13F6A66037B54FAB5668CDC734401,31931,11,13,2,109.54771,18.29403,1667
79587,7112BF910BB8852FB892FD72D6683B89,30161,19,20,1,109.50042,18.24389,1508
79588,7112BF910BB8852FB892FD72D6683B89,38291,21,23,2,109.51618,18.24313,1558
79640,C358285726113434A30FBBA8DED710E7,60371,0,9,9,109.53063,18.30056,1618
79641,C358285726113434A30FBBA8DED710E7,60552,12,13,1,109.41729,18.30014,1218
79658,F8290DFC7AD7A3BC6FCA7482642F724C,38871,5,6,1,109.44681,18.28625,1316
79659,F8290DFC7AD7A3BC6FCA7482642F724C,31701,6,8,2,109.44132,18.28833,1266
79668,DE841C2C767041F00D7DAF75FFC633F6,30771,1,5,4,109.49938,18.26042,1511
79669,DE841C2C767041F00D7DAF75FFC633F6,30421,6,21,15,109.50021,18.25861,1511
79707,24E98C0EC4A6054CC486A2611C493128,30854,1,2,1,109.56889,18.27076,1763
79708,24E98C0EC4A6054CC486A2611C493128,31071,3,18,15,109.58257,18.28458,1815
79709,24E98C0EC4A6054CC486A2611C493128,30361,21,23,2,109.50347,18.24,1508
79728,8621CFDF1B89A83351494618C53D033F,31071,0,2,2,109.58257,18.28458,1815
79729,8621CFDF1B89A83351494618C53D033F,39181,3,6,3,109.55153,18.28035,1715
79730,8621CFDF1B89A83351494618C53D033F,31071,7,9,2,109.58257,18.28458,1815
79731,8621CFDF1B89A83351494618C53D033F,39181,9,23,14,109.55153,18.28035,1715
79790,22B987DE38F8C4435934FE5E6190C4A2,60631,0,5,5,109.57778,18.27583,1814
79791,22B987DE38F8C4435934FE5E6190C4A2,31101,8,9,1,109.65389,18.23403,2057
79792,22B987DE38F8C4435934FE5E6190C4A2,38271,11,13,2,109.62632,18.23049,1956
79793,22B987DE38F8C4435934FE5E6190C4A2,60591,15,17,2,109.61118,18.21715,1904
79797,BE7763F8096EB5A037146E1CC4190538,30854,6,7,1,109.56889,18.27076,1763
79798,BE7763F8096EB5A037146E1CC4190538,31561,10,19,9,109.56792,18.28479,1765
79799,BE7763F8096EB5A037146E1CC4190538,30854,22,23,1,109.56889,18.27076,1763
79822,37A40745578E15431BB880E6F6297E14,30081,2,8,6,109.50243,18.26632,1512
79823,37A40745578E15431BB880E6F6297E14,30854,8,15,7,109.56889,18.27076,1763
79824,37A40745578E15431BB880E6F6297E14,30081,16,23,7,109.50243,18.26632,1512
79874,8B3125BACE32612AE7F9DC5599DC75E6,60081,0,3,3,109.51097,18.22639,1556
79875,8B3125BACE32612AE7F9DC5599DC75E6,30661,5,10,5,109.37028,18.24361,1008
79876,8B3125BACE32612AE7F9DC5599DC75E6,60081,12,17,5,109.51097,18.22639,1556
79877,8B3125BACE32612AE7F9DC5599DC75E6,60381,18,23,5,109.5241,18.22458,1605
79919,BA0C44295D246224E442075F9885D682,30581,18,19,1,109.62257,18.24951,1959
79920,BA0C44295D246224E442075F9885D682,38283,20,22,2,109.62229,18.22618,1956
79931,2E29BE7E21F829BB8E4505964B146371,30854,1,2,1,109.56889,18.27076,1763
79932,2E29BE7E21F829BB8E4505964B146371,31561,2,13,11,109.56792,18.28479,1765
79954,0EEF00D524FC221E0814F0ECEF97AD09,31521,0,9,9,109.51458,18.22542,1555
79958,74A9CCA48CD6C2DA9FC7DFDB8817D50B,31945,0,6,6,109.58021,18.29403,1817
79959,74A9CCA48CD6C2DA9FC7DFDB8817D50B,30854,11,12,1,109.56889,18.27076,1763
79960,74A9CCA48CD6C2DA9FC7DFDB8817D50B,30851,12,14,2,109.5616,18.27396,1713
80014,CD3BCBAB8571FB81953C842A434E5DB8,30854,7,12,5,109.56889,18.27076,1763
80015,CD3BCBAB8571FB81953C842A434E5DB8,31071,13,21,8,109.58257,18.28458,1815
80074,FB16AA24AD94D8CC7E1110E44BD68910,30861,12,15,3,109.52722,18.22743,1606
80075,FB16AA24AD94D8CC7E1110E44BD68910,31945,18,20,2,109.58021,18.29403,1817
80092,C08AC91C10840D760EE6198DD08AFEC8,39101,1,8,7,109.50132,18.24931,1509
80093,C08AC91C10840D760EE6198DD08AFEC8,31145,12,14,2,109.20431,18.30479,369
80094,C08AC91C10840D760EE6198DD08AFEC8,31391,19,21,2,109.50382,18.24285,1508
80095,C08AC91C10840D760EE6198DD08AFEC8,39101,21,23,2,109.50132,18.24931,1509
80112,C164C30B5AB18A9045271D53A346B477,60381,19,21,2,109.5241,18.22458,1605
80113,C164C30B5AB18A9045271D53A346B477,60411,22,23,1,109.32514,18.30854,869
80118,8EA475D017A01807E97E34F719EA95E4,31421,4,16,12,109.55382,18.22347,1705
80119,8EA475D017A01807E97E34F719EA95E4,30851,18,21,3,109.5616,18.27396,1713
80120,E79FCCBA9F6300DF5C81A804945B477E,31071,1,4,3,109.58257,18.28458,1815
80121,E79FCCBA9F6300DF5C81A804945B477E,30854,5,7,2,109.56889,18.27076,1763
80122,E79FCCBA9F6300DF5C81A804945B477E,31071,10,13,3,109.58257,18.28458,1815
80123,E79FCCBA9F6300DF5C81A804945B477E,31945,14,15,1,109.58021,18.29403,1817
80124,E79FCCBA9F6300DF5C81A804945B477E,31071,15,17,2,109.58257,18.28458,1815
80125,D8898064D7FB8C9B8CE800B6EE2F87B6,30232,0,6,6,109.6191,18.31701,1971
80126,D8898064D7FB8C9B8CE800B6EE2F87B6,30854,7,12,5,109.56889,18.27076,1763
80127,D8898064D7FB8C9B8CE800B6EE2F87B6,39183,14,16,2,109.55542,18.28208,1715
80128,D8898064D7FB8C9B8CE800B6EE2F87B6,30854,19,20,1,109.56889,18.27076,1763
80135,C3D97A298AB6EB8497D0CC432E6DD8A2,61011,12,15,3,109.60653,18.19076,1900
80136,C3D97A298AB6EB8497D0CC432E6DD8A2,30151,18,20,2,109.50986,18.25083,1560
80137,C3D97A298AB6EB8497D0CC432E6DD8A2,60114,22,23,1,109.73028,18.33847,2374
80156,34A1BA5A97F90C4ABB34EDC7004774A9,31071,12,14,2,109.58257,18.28458,1815
80157,34A1BA5A97F90C4ABB34EDC7004774A9,30851,17,23,6,109.5616,18.27396,1713
80167,9B43F93397D8AD2193F77AAD4D6186E5,30721,18,23,5,109.51597,18.28257,1565
80172,F6517175486155917A178CA148E820EF,31701,0,9,9,109.44132,18.28833,1266
80173,F6517175486155917A178CA148E820EF,31471,12,14,2,109.34583,18.29563,917
80174,F6517175486155917A178CA148E820EF,60054,15,16,1,109.3016,18.31229,770
80175,F6517175486155917A178CA148E820EF,31701,18,23,5,109.44132,18.28833,1266
80182,C0F04DA5BBC3EA089436357A9062298C,31521,2,9,7,109.51458,18.22542,1555
80183,C0F04DA5BBC3EA089436357A9062298C,39081,12,13,1,109.19382,18.29111,366
80184,C0F04DA5BBC3EA089436357A9062298C,31781,13,15,2,109.19847,18.2975,367
80185,C0F04DA5BBC3EA089436357A9062298C,31521,19,23,4,109.51458,18.22542,1555
80203,ADAB51A6D99BADC8222FC392D72ADA01,60281,0,8,8,109.51743,18.25924,1561
80204,ADAB51A6D99BADC8222FC392D72ADA01,60311,9,10,1,109.52097,18.24319,1558
80205,ADAB51A6D99BADC8222FC392D72ADA01,60281,10,20,10,109.51743,18.25924,1561
80217,0547C7536E43628EF24935F0C2BF5E2C,60241,1,6,5,109.53319,18.28667,1616
80218,0547C7536E43628EF24935F0C2BF5E2C,31931,7,10,3,109.54771,18.29403,1667
80224,ACDEAAF45B65DE48CF80A48DBD3C775E,30854,0,6,6,109.56889,18.27076,1763
80225,ACDEAAF45B65DE48CF80A48DBD3C775E,31071,7,20,13,109.58257,18.28458,1815
80226,ACDEAAF45B65DE48CF80A48DBD3C775E,30854,20,22,2,109.56889,18.27076,1763
80227,FD67FE4B7E9CF4CE22EB70AA68B16AE3,60331,1,5,4,109.505,18.26507,1512
80228,FD67FE4B7E9CF4CE22EB70AA68B16AE3,31461,5,9,4,109.5091,18.25389,1510
80229,FD67FE4B7E9CF4CE22EB70AA68B16AE3,31471,12,15,3,109.34583,18.29563,917
80230,FD67FE4B7E9CF4CE22EB70AA68B16AE3,30421,18,19,1,109.50021,18.25861,1511
80231,FD67FE4B7E9CF4CE22EB70AA68B16AE3,60331,20,23,3,109.505,18.26507,1512
80242,5EBEA276FCB4A19AC5C987F5C7CC8908,60504,1,8,7,109.47917,18.28903,1416
80243,5EBEA276FCB4A19AC5C987F5C7CC8908,38361,9,11,2,109.43667,18.29201,1267
80244,5EBEA276FCB4A19AC5C987F5C7CC8908,60401,11,13,2,109.47444,18.27583,1414
80245,5EBEA276FCB4A19AC5C987F5C7CC8908,60552,13,15,2,109.41729,18.30014,1218
80246,5EBEA276FCB4A19AC5C987F5C7CC8908,60504,16,17,1,109.47917,18.28903,1416
80247,5EBEA276FCB4A19AC5C987F5C7CC8908,60552,19,20,1,109.41729,18.30014,1218
80254,A1E318C80BE4457762B208DEDA1DAC8C,60201,0,1,1,109.5041,18.2509,1510
80255,A1E318C80BE4457762B208DEDA1DAC8C,60281,2,7,5,109.51743,18.25924,1561
80256,A1E318C80BE4457762B208DEDA1DAC8C,31461,8,9,1,109.5091,18.25389,1510
80259,028777DBF8176CB8A735B293EDB3D71F,31931,0,17,17,109.54771,18.29403,1667
80260,028777DBF8176CB8A735B293EDB3D71F,39181,19,20,1,109.55153,18.28035,1715
80271,7B1A07C39637E996C01DF0A3D287D3C6,31071,0,4,4,109.58257,18.28458,1815
80272,7B1A07C39637E996C01DF0A3D287D3C6,30854,4,23,19,109.56889,18.27076,1763
80276,F0815D578D26B350DB87D25249BACE31,30351,17,18,1,109.41701,18.29292,1217
80277,F0815D578D26B350DB87D25249BACE31,60221,19,21,2,109.52569,18.29188,1616
80278,DB4DF566D4757FF3BB488F82DE126248,31561,18,19,1,109.56792,18.28479,1765
80279,DB4DF566D4757FF3BB488F82DE126248,60351,20,23,3,109.58403,18.28958,1816
80288,FBC323A047041F71D8997C22FDE88F17,38017,0,2,2,109.49729,18.21424,1504
80289,FBC323A047041F71D8997C22FDE88F17,30181,2,10,8,109.51597,18.23313,1557
80290,FBC323A047041F71D8997C22FDE88F17,31041,12,13,1,109.50278,18.23701,1507
80291,FBC323A047041F71D8997C22FDE88F17,38336,15,17,2,109.61111,18.21806,1904
80292,FBC323A047041F71D8997C22FDE88F17,30281,19,21,2,109.50597,18.27583,1514
80295,0312B43ACF9ED1D8304E325E851AEE29,30851,4,12,8,109.5616,18.27396,1713
80296,0312B43ACF9ED1D8304E325E851AEE29,31561,13,21,8,109.56792,18.28479,1765
80305,76E12A118C330D9C1C9FA24D20FBD536,31864,18,20,2,109.49014,18.28333,1465
80306,76E12A118C330D9C1C9FA24D20FBD536,31181,21,23,2,109.50382,18.24813,1509
80309,1FC5887E4053936D3ED4D738338DC172,30851,0,1,1,109.5616,18.27396,1713
80310,1FC5887E4053936D3ED4D738338DC172,30951,5,15,10,109.56208,18.25667,1761
80311,1FC5887E4053936D3ED4D738338DC172,30851,15,16,1,109.5616,18.27396,1713
80312,1FC5887E4053936D3ED4D738338DC172,30121,18,23,5,109.52861,18.27222,1613
80317,B55959B64746A18ECF5077B5F7359221,31561,0,9,9,109.56792,18.28479,1765
80318,B55959B64746A18ECF5077B5F7359221,30854,11,12,1,109.56889,18.27076,1763
80319,B55959B64746A18ECF5077B5F7359221,31561,12,17,5,109.56792,18.28479,1765
80320,B55959B64746A18ECF5077B5F7359221,39183,20,22,2,109.55542,18.28208,1715
80328,CE6CEE81590042CA6F5DB32658274CD4,60161,19,20,1,109.49174,18.26181,1461
80329,CE6CEE81590042CA6F5DB32658274CD4,30711,20,22,2,109.50271,18.25347,1510
80348,59E923A20262174FA0932772270B33BC,60201,2,6,4,109.5041,18.2509,1510
80349,59E923A20262174FA0932772270B33BC,31031,7,12,5,109.49979,18.25382,1510
80350,59E923A20262174FA0932772270B33BC,31471,15,18,3,109.34583,18.29563,917
80351,59E923A20262174FA0932772270B33BC,60201,19,22,3,109.5041,18.2509,1510
80388,54010DBEF2CEA9E14DD9AB244385D257,60054,12,13,1,109.3016,18.31229,770
80389,54010DBEF2CEA9E14DD9AB244385D257,30341,14,15,1,109.3625,18.29167,966
80390,54010DBEF2CEA9E14DD9AB244385D257,31521,19,20,1,109.51458,18.22542,1555
80419,C8135D3E403B7CC96352A41CBCD291A7,31571,15,16,1,109.61563,18.23326,1957
80420,C8135D3E403B7CC96352A41CBCD291A7,31931,20,21,1,109.54771,18.29403,1667
80421,5D3FF793EF0DA0E8CE0DBE9C3E8AB37A,60631,1,18,17,109.57778,18.27583,1814
80422,5D3FF793EF0DA0E8CE0DBE9C3E8AB37A,31071,21,23,2,109.58257,18.28458,1815
80434,09390A13C8E5C15C1E5674E3DB9139EC,60201,6,8,2,109.5041,18.2509,1510
80435,09390A13C8E5C15C1E5674E3DB9139EC,60161,11,16,5,109.49174,18.26181,1461
80436,09390A13C8E5C15C1E5674E3DB9139EC,60084,17,19,2,109.4984,18.2334,1507
80464,8A13D51E493E320785CD9E0AA80310AA,38052,1,9,8,109.62618,18.23042,1956
80465,8A13D51E493E320785CD9E0AA80310AA,33101,10,12,2,109.68438,18.44368,2242
80466,8A13D51E493E320785CD9E0AA80310AA,60381,17,19,2,109.5241,18.22458,1605
80506,44B51AB0086A395492A545161BBB3047,39111,0,5,5,109.5191,18.22597,1555
80507,44B51AB0086A395492A545161BBB3047,39321,6,7,1,109.529,18.2167,1604
80508,44B51AB0086A395492A545161BBB3047,31521,7,14,7,109.51458,18.22542,1555
80509,44B51AB0086A395492A545161BBB3047,60381,14,15,1,109.5241,18.22458,1605
80510,44B51AB0086A395492A545161BBB3047,31521,16,20,4,109.51458,18.22542,1555
80511,44B51AB0086A395492A545161BBB3047,60381,20,22,2,109.5241,18.22458,1605
80544,B7A2800FDF738E1064EAD2A5E58F7A3C,61011,0,9,9,109.60653,18.19076,1900
80546,B7A2800FDF738E1064EAD2A5E58F7A3C,30151,19,20,1,109.50986,18.25083,1560
80568,09934B270C1497807C20E80EA18E32E2,31071,0,8,8,109.58257,18.28458,1815
80569,09934B270C1497807C20E80EA18E32E2,30771,8,10,2,109.49938,18.26042,1511
80570,09934B270C1497807C20E80EA18E32E2,31071,11,18,7,109.58257,18.28458,1815
80571,09934B270C1497807C20E80EA18E32E2,38241,18,21,3,109.54111,18.30542,1669
80580,07B1B28EECDA8CD620E38389A07DCD5A,38484,11,12,1,109.53028,18.31528,1620
80581,07B1B28EECDA8CD620E38389A07DCD5A,38484,15,18,3,109.53028,18.31528,1620
80586,CA3896FB33E9BC68E91955EDFF5D709B,30854,15,17,2,109.56889,18.27076,1763
80587,CA3896FB33E9BC68E91955EDFF5D709B,31821,19,20,1,109.51181,18.24924,1559
80603,45CCFCD3EBDF941E1C92B70ED06E8B5E,31561,3,4,1,109.56792,18.28479,1765
80604,45CCFCD3EBDF941E1C92B70ED06E8B5E,30854,7,9,2,109.56889,18.27076,1763
80605,45CCFCD3EBDF941E1C92B70ED06E8B5E,31945,9,10,1,109.58021,18.29403,1817
80606,45CCFCD3EBDF941E1C92B70ED06E8B5E,30854,11,12,1,109.56889,18.27076,1763
80607,45CCFCD3EBDF941E1C92B70ED06E8B5E,31071,12,14,2,109.58257,18.28458,1815
80608,45CCFCD3EBDF941E1C92B70ED06E8B5E,31945,14,17,3,109.58021,18.29403,1817
80609,45CCFCD3EBDF941E1C92B70ED06E8B5E,30854,21,22,1,109.56889,18.27076,1763
80613,F355EF146BFAB3F3C8540E3056B68987,30861,0,8,8,109.52722,18.22743,1606
80614,F355EF146BFAB3F3C8540E3056B68987,31471,11,12,1,109.34583,18.29563,917
80615,F355EF146BFAB3F3C8540E3056B68987,38754,16,17,1,109.74667,18.37382,2430
80616,F355EF146BFAB3F3C8540E3056B68987,30361,21,22,1,109.50347,18.24,1508
80637,6B806948BC9187A91D033B4096721B00,30854,2,3,1,109.56889,18.27076,1763
80638,6B806948BC9187A91D033B4096721B00,31561,6,7,1,109.56792,18.28479,1765
80639,6B806948BC9187A91D033B4096721B00,31071,9,18,9,109.58257,18.28458,1815
80640,6B806948BC9187A91D033B4096721B00,31561,20,22,2,109.56792,18.28479,1765
80647,DE5024DB59D5BF6AE5857A85EB7680EA,31071,0,6,6,109.58257,18.28458,1815
80648,DE5024DB59D5BF6AE5857A85EB7680EA,30854,7,20,13,109.56889,18.27076,1763
80793,B3A1AC27CB357708CE63D3E4F68BF2E7,30854,0,7,7,109.56889,18.27076,1763
80794,B3A1AC27CB357708CE63D3E4F68BF2E7,31071,7,19,12,109.58257,18.28458,1815
80841,5101E60E066B711D5B58F6B6B67BA4EB,30851,0,9,9,109.5616,18.27396,1713
80842,5101E60E066B711D5B58F6B6B67BA4EB,30854,13,17,4,109.56889,18.27076,1763
80843,5101E60E066B711D5B58F6B6B67BA4EB,30851,20,22,2,109.5616,18.27396,1713
80930,2B8C748A18FA7D08D4335AD7C9DEF01B,31761,0,6,6,109.60521,18.27965,1914
80931,2B8C748A18FA7D08D4335AD7C9DEF01B,30951,8,10,2,109.56208,18.25667,1761
80932,2B8C748A18FA7D08D4335AD7C9DEF01B,31551,11,12,1,109.55868,18.24222,1708
80933,2B8C748A18FA7D08D4335AD7C9DEF01B,31421,13,14,1,109.55382,18.22347,1705
80934,2B8C748A18FA7D08D4335AD7C9DEF01B,30951,16,17,1,109.56208,18.25667,1761
80935,2B8C748A18FA7D08D4335AD7C9DEF01B,31761,18,23,5,109.60521,18.27965,1914
81023,3977578BE56276DA0700B04B81DC1356,31561,0,1,1,109.56792,18.28479,1765
81024,3977578BE56276DA0700B04B81DC1356,30851,2,10,8,109.5616,18.27396,1713
81025,3977578BE56276DA0700B04B81DC1356,31561,10,23,13,109.56792,18.28479,1765
81164,3F80F6C7ECC59E36D89C8EF1746C8724,38121,1,6,5,109.51361,18.27813,1564
81165,3F80F6C7ECC59E36D89C8EF1746C8724,38157,8,9,1,109.51483,18.26958,1563
81166,3F80F6C7ECC59E36D89C8EF1746C8724,38121,10,12,2,109.51361,18.27813,1564
81189,1612722AB217C3A27FE84944E5D72456,30771,18,23,5,109.49938,18.26042,1511
81202,173CD7A2B7B334BC53A50A1D248FBCFE,30854,9,11,2,109.56889,18.27076,1763
81203,173CD7A2B7B334BC53A50A1D248FBCFE,31071,12,13,1,109.58257,18.28458,1815
81204,173CD7A2B7B334BC53A50A1D248FBCFE,30854,15,19,4,109.56889,18.27076,1763
81205,173CD7A2B7B334BC53A50A1D248FBCFE,31071,19,22,3,109.58257,18.28458,1815
81206,451E2BF48CD7B253EB0892324E679BCC,38297,2,3,1,109.52576,18.24965,1609
81207,451E2BF48CD7B253EB0892324E679BCC,60281,7,17,10,109.51743,18.25924,1561
81208,451E2BF48CD7B253EB0892324E679BCC,38291,18,19,1,109.51618,18.24313,1558
81209,451E2BF48CD7B253EB0892324E679BCC,38297,22,23,1,109.52576,18.24965,1609
81249,8883DF5E66B5FC284A8EF97DE8EAAAB3,31071,0,2,2,109.58257,18.28458,1815
81250,8883DF5E66B5FC284A8EF97DE8EAAAB3,39183,4,5,1,109.55542,18.28208,1715
81251,8883DF5E66B5FC284A8EF97DE8EAAAB3,30854,5,16,11,109.56889,18.27076,1763
81252,8883DF5E66B5FC284A8EF97DE8EAAAB3,39183,16,19,3,109.55542,18.28208,1715
81274,0E00D7E0174B24239144B08D52B998E8,31124,12,13,1,109.17069,18.35,276
81275,0E00D7E0174B24239144B08D52B998E8,30451,14,16,2,109.1791,18.36229,278
81276,0E00D7E0174B24239144B08D52B998E8,31124,17,18,1,109.17069,18.35,276
81277,0E00D7E0174B24239144B08D52B998E8,30421,20,21,1,109.50021,18.25861,1511
81283,DDE77D3A656666992FC3458B84010D43,31561,12,16,4,109.56792,18.28479,1765
81284,DDE77D3A656666992FC3458B84010D43,39183,18,23,5,109.55542,18.28208,1715
81323,753A7CFE9D5A49374C0CE033D581B67F,38361,0,9,9,109.43667,18.29201,1267
81324,753A7CFE9D5A49374C0CE033D581B67F,31701,9,10,1,109.44132,18.28833,1266
81325,2C3BD53A8702A47FB82F05FB4993B683,31561,0,6,6,109.56792,18.28479,1765
81326,2C3BD53A8702A47FB82F05FB4993B683,31931,6,8,2,109.54771,18.29403,1667
81327,2C3BD53A8702A47FB82F05FB4993B683,31561,12,20,8,109.56792,18.28479,1765
81341,807F73DE76DFE56E472FA61396F0887C,38171,15,17,2,109.50799,18.28139,1515
81342,807F73DE76DFE56E472FA61396F0887C,30861,19,22,3,109.52722,18.22743,1606
81362,521A7ED98375837397B112E54A372514,60281,0,1,1,109.51743,18.25924,1561
81363,521A7ED98375837397B112E54A372514,60234,2,10,8,109.49577,18.2096,1453
81364,521A7ED98375837397B112E54A372514,38017,11,13,2,109.49729,18.21424,1504
81380,DB0EF690DC781F73956987AB22EA398D,38361,0,8,8,109.43667,18.29201,1267
81381,DB0EF690DC781F73956987AB22EA398D,31321,12,13,1,109.63799,18.23201,2007
81382,DB0EF690DC781F73956987AB22EA398D,60291,15,17,2,109.50826,18.24639,1509
81383,DB0EF690DC781F73956987AB22EA398D,60381,19,21,2,109.5241,18.22458,1605
81396,283001ED673D8EDBEF7EEB00BDB31533,30571,5,6,1,109.50243,18.21861,1504
81397,283001ED673D8EDBEF7EEB00BDB31533,60201,7,10,3,109.5041,18.2509,1510
81398,283001ED673D8EDBEF7EEB00BDB31533,31181,12,18,6,109.50382,18.24813,1509
81399,283001ED673D8EDBEF7EEB00BDB31533,30571,20,21,1,109.50243,18.21861,1504
81411,AD12F364CB1EB1AF88909B637B7422CD,31471,17,18,1,109.34583,18.29563,917
81412,AD12F364CB1EB1AF88909B637B7422CD,30201,21,23,2,109.4909,18.26465,1462
81413,0187C68AAA5B8B5AFE4438278EB6AFB0,31561,12,14,2,109.56792,18.28479,1765
81414,0187C68AAA5B8B5AFE4438278EB6AFB0,30851,15,18,3,109.5616,18.27396,1713
81455,CB1C8502149DACE0B32B2F7416279EF2,31071,9,19,10,109.58257,18.28458,1815
81456,CB1C8502149DACE0B32B2F7416279EF2,30854,19,20,1,109.56889,18.27076,1763
81562,1FE2866848043A2C10AD87212485FE15,31181,0,2,2,109.50382,18.24813,1509
81563,1FE2866848043A2C10AD87212485FE15,31071,4,7,3,109.58257,18.28458,1815
81564,1FE2866848043A2C10AD87212485FE15,30854,8,10,2,109.56889,18.27076,1763
81583,1A1B5C664F8D6460240C73AB76187420,30854,0,11,11,109.56889,18.27076,1763
81584,1A1B5C664F8D6460240C73AB76187420,31071,11,13,2,109.58257,18.28458,1815
81585,1A1B5C664F8D6460240C73AB76187420,30854,14,16,2,109.56889,18.27076,1763
81586,1A1B5C664F8D6460240C73AB76187420,31071,20,21,1,109.58257,18.28458,1815
81591,B5686BCA7E4C74E299FC4E3D24CAC39C,31031,13,17,4,109.49979,18.25382,1510
81592,B5686BCA7E4C74E299FC4E3D24CAC39C,39151,19,23,4,109.49875,18.25097,1510
81645,CD576F1C1CDFB89E6A99A20E65927346,30854,4,5,1,109.56889,18.27076,1763
81646,CD576F1C1CDFB89E6A99A20E65927346,31561,6,9,3,109.56792,18.28479,1765
81647,CD576F1C1CDFB89E6A99A20E65927346,30854,11,12,1,109.56889,18.27076,1763
81648,CD576F1C1CDFB89E6A99A20E65927346,31561,14,16,2,109.56792,18.28479,1765
81649,CD576F1C1CDFB89E6A99A20E65927346,30854,19,21,2,109.56889,18.27076,1763
81691,B712327B6033C61F37801CFD6DAC08AD,38484,0,1,1,109.53028,18.31528,1620
81692,B712327B6033C61F37801CFD6DAC08AD,31951,1,5,4,109.52174,18.30299,1568
81693,B712327B6033C61F37801CFD6DAC08AD,30561,8,9,1,109.52778,18.31938,1621
81694,B712327B6033C61F37801CFD6DAC08AD,38484,17,20,3,109.53028,18.31528,1620
81695,B712327B6033C61F37801CFD6DAC08AD,30561,20,23,3,109.52778,18.31938,1621
81701,DBF0ED639264742A7D5519236AB61C61,39151,0,4,4,109.49875,18.25097,1510
81702,DBF0ED639264742A7D5519236AB61C61,31031,8,9,1,109.49979,18.25382,1510
81727,A7B3BDD8DC79485BA41EC7F220A41345,30854,13,20,7,109.56889,18.27076,1763
81728,A7B3BDD8DC79485BA41EC7F220A41345,60631,21,22,1,109.57778,18.27583,1814
81732,B6378A75CA0A699A2E978F82FF1B5F9B,30321,0,2,2,109.49563,18.29611,1467
81733,B6378A75CA0A699A2E978F82FF1B5F9B,31621,3,22,19,109.51035,18.29826,1568
81752,DE752C5E8A13F8A5D5BD49C4D2C8009D,38881,0,7,7,109.51618,18.26431,1562
81753,DE752C5E8A13F8A5D5BD49C4D2C8009D,30681,8,10,2,109.48493,18.26917,1463
81754,DE752C5E8A13F8A5D5BD49C4D2C8009D,38881,13,17,4,109.51618,18.26431,1562
81755,DE752C5E8A13F8A5D5BD49C4D2C8009D,31031,20,21,1,109.49979,18.25382,1510
81756,79AB721DDB2EAA1CD0308535004E6A67,31071,0,8,8,109.58257,18.28458,1815
81757,79AB721DDB2EAA1CD0308535004E6A67,31561,9,11,2,109.56792,18.28479,1765
81758,79AB721DDB2EAA1CD0308535004E6A67,30854,13,16,3,109.56889,18.27076,1763
81759,79AB721DDB2EAA1CD0308535004E6A67,60291,18,21,3,109.50826,18.24639,1509
81760,79AB721DDB2EAA1CD0308535004E6A67,31181,21,23,2,109.50382,18.24813,1509
81805,9E2CAA912E7C38B3460AB2C8B985CA0D,31071,17,19,2,109.58257,18.28458,1815
81806,9E2CAA912E7C38B3460AB2C8B985CA0D,31761,20,22,2,109.60521,18.27965,1914
81822,89362A3CA3AE6F5B75871F2110924F99,30851,0,7,7,109.5616,18.27396,1713
81823,89362A3CA3AE6F5B75871F2110924F99,31551,10,11,1,109.55868,18.24222,1708
81824,89362A3CA3AE6F5B75871F2110924F99,30951,11,16,5,109.56208,18.25667,1761
81825,89362A3CA3AE6F5B75871F2110924F99,30851,18,22,4,109.5616,18.27396,1713
81842,AEA3E45BA06B234C15322E381D44AC89,31201,0,2,2,109.51042,18.23819,1558
81843,AEA3E45BA06B234C15322E381D44AC89,30031,5,18,13,109.53681,18.33313,1673
81852,7D632B68A96EBB9D6582527232D6634C,39154,0,7,7,109.50201,18.25681,1511
81853,7D632B68A96EBB9D6582527232D6634C,31461,8,9,1,109.5091,18.25389,1510
81854,7D632B68A96EBB9D6582527232D6634C,31291,14,18,4,109.30375,18.40729,786
81855,7D632B68A96EBB9D6582527232D6634C,39191,22,23,1,109.51493,18.23472,1557
81882,76E309834F99A617111BD6E6BAC7FFEC,60371,0,8,8,109.53063,18.30056,1618
81883,76E309834F99A617111BD6E6BAC7FFEC,31931,12,16,4,109.54771,18.29403,1667
81884,76E309834F99A617111BD6E6BAC7FFEC,60371,16,17,1,109.53063,18.30056,1618
81926,06CCC403601D7C9C1AA6BF102B163D95,39151,3,6,3,109.49875,18.25097,1510
81927,06CCC403601D7C9C1AA6BF102B163D95,60161,8,13,5,109.49174,18.26181,1461
81928,B78E7295CB13532B4E2C30EF158E297F,31931,0,1,1,109.54771,18.29403,1667
81929,B78E7295CB13532B4E2C30EF158E297F,30851,1,3,2,109.5616,18.27396,1713
81930,B78E7295CB13532B4E2C30EF158E297F,31931,3,7,4,109.54771,18.29403,1667
81931,B78E7295CB13532B4E2C30EF158E297F,30854,13,14,1,109.56889,18.27076,1763
81932,B78E7295CB13532B4E2C30EF158E297F,39183,16,19,3,109.55542,18.28208,1715
81933,0ACD42FBA28A767F44D73783967C8C23,31864,0,8,8,109.49014,18.28333,1465
81934,0ACD42FBA28A767F44D73783967C8C23,31941,11,13,2,109.62451,18.31222,1970
81935,0ACD42FBA28A767F44D73783967C8C23,30851,14,15,1,109.5616,18.27396,1713
81941,066E3B290AAC556F650E56DD0F693AB2,30581,14,15,1,109.62257,18.24951,1959
81942,066E3B290AAC556F650E56DD0F693AB2,38251,17,22,5,109.49618,18.25493,1510
81953,F47C4E1E39056C43B0AD32AC994AB7C0,60361,0,1,1,109.51938,18.29681,1567
81954,F47C4E1E39056C43B0AD32AC994AB7C0,31931,1,22,21,109.54771,18.29403,1667
81984,0AA81D37A252701034C59AB1A32AA9FA,31145,12,13,1,109.20431,18.30479,369
81985,0AA81D37A252701034C59AB1A32AA9FA,60054,15,17,2,109.3016,18.31229,770
81986,0AA81D37A252701034C59AB1A32AA9FA,30711,20,22,2,109.50271,18.25347,1510
82028,624AAF23364B08A587E603D133DAA33C,31471,14,16,2,109.34583,18.29563,917
82029,624AAF23364B08A587E603D133DAA33C,38094,17,18,1,109.45403,18.28778,1316
82049,999DEB7BFC175BF03EAE5DB1D4B2EFB6,60361,0,15,15,109.51938,18.29681,1567
82050,999DEB7BFC175BF03EAE5DB1D4B2EFB6,31861,16,17,1,109.49042,18.27549,1464
82051,999DEB7BFC175BF03EAE5DB1D4B2EFB6,31951,21,23,2,109.52174,18.30299,1568
82069,414763BCFC53367965A980F3BA7D5EA5,31091,16,19,3,109.41201,18.31222,1170
82138,80B72DFF870E58099F17893CA96A269C,31071,1,5,4,109.58257,18.28458,1815
82139,80B72DFF870E58099F17893CA96A269C,30854,5,8,3,109.56889,18.27076,1763
82140,80B72DFF870E58099F17893CA96A269C,31071,11,13,2,109.58257,18.28458,1815
82163,DD056101D68CBFC24096E8F587CC747C,30071,0,5,5,109.52819,18.30472,1619
82164,DD056101D68CBFC24096E8F587CC747C,31931,5,6,1,109.54771,18.29403,1667
82165,DD056101D68CBFC24096E8F587CC747C,30071,10,11,1,109.52819,18.30472,1619
82166,DD056101D68CBFC24096E8F587CC747C,31931,12,16,4,109.54771,18.29403,1667
82229,E1108DE9382EA6DD2052A0875C7E83C6,31161,19,23,4,109.70229,18.31361,2270
82251,E4B522EF4348156010E5C578EC13D60F,31945,2,9,7,109.58021,18.29403,1817
82252,E4B522EF4348156010E5C578EC13D60F,30854,10,17,7,109.56889,18.27076,1763
82264,3D5A468E02E58892BB875A2C29BFAFBA,38911,1,7,6,109.51674,18.24965,1559
82265,3D5A468E02E58892BB875A2C29BFAFBA,31821,7,11,4,109.51181,18.24924,1559
82266,3D5A468E02E58892BB875A2C29BFAFBA,31261,13,15,2,109.51174,18.2466,1559
82267,3D5A468E02E58892BB875A2C29BFAFBA,30151,19,22,3,109.50986,18.25083,1560
82268,560794A44CA17A43FA34D0FA6C339747,30854,0,6,6,109.56889,18.27076,1763
82269,560794A44CA17A43FA34D0FA6C339747,31071,11,12,1,109.58257,18.28458,1815
82270,560794A44CA17A43FA34D0FA6C339747,30854,16,22,6,109.56889,18.27076,1763
82288,608A55C14BAB2A5B627ACC1F39B89FB6,31945,0,7,7,109.58021,18.29403,1817
82289,608A55C14BAB2A5B627ACC1F39B89FB6,30854,8,17,9,109.56889,18.27076,1763
82290,608A55C14BAB2A5B627ACC1F39B89FB6,31945,19,23,4,109.58021,18.29403,1817
82294,6A910172B0D8A7BBC31B1CD07364D7F6,30361,20,21,1,109.50347,18.24,1508
82295,6A910172B0D8A7BBC31B1CD07364D7F6,31206,22,23,1,109.50819,18.23549,1507
82321,1EBF477B1EE6E13F6E111854406233C6,38251,0,8,8,109.49618,18.25493,1510
82322,1EBF477B1EE6E13F6E111854406233C6,33051,11,14,3,109.6475,18.46618,2096
82323,1EBF477B1EE6E13F6E111854406233C6,38251,16,23,7,109.49618,18.25493,1510
82338,DF7FEE90C3CFDF2E89602A7FE1135E8F,30221,0,7,7,109.57833,18.20222,1802
82339,DF7FEE90C3CFDF2E89602A7FE1135E8F,31561,7,8,1,109.56792,18.28479,1765
82340,DF7FEE90C3CFDF2E89602A7FE1135E8F,31041,11,13,2,109.50278,18.23701,1507
82357,85586D73EA48B4F4D520D899B0BE0554,30291,0,5,5,109.50403,18.27028,1513
82358,85586D73EA48B4F4D520D899B0BE0554,39181,7,10,3,109.55153,18.28035,1715
82359,85586D73EA48B4F4D520D899B0BE0554,39181,13,17,4,109.55153,18.28035,1715
82387,658407C6560C95E096BFBAE8616B0914,60291,0,10,10,109.50826,18.24639,1509
82388,658407C6560C95E096BFBAE8616B0914,31471,13,15,2,109.34583,18.29563,917
82389,71A18A4A1ADC968891F09220AD0BF67D,31071,10,11,1,109.58257,18.28458,1815
82390,71A18A4A1ADC968891F09220AD0BF67D,30854,14,17,3,109.56889,18.27076,1763
82391,71A18A4A1ADC968891F09220AD0BF67D,31071,18,20,2,109.58257,18.28458,1815
82392,71A18A4A1ADC968891F09220AD0BF67D,38754,20,21,1,109.74667,18.37382,2430
82405,5E6F81A7DA23F57413C15AC7514275E5,30851,1,3,2,109.5616,18.27396,1713
82406,5E6F81A7DA23F57413C15AC7514275E5,31945,5,17,12,109.58021,18.29403,1817
82409,AAB3DCB18BAF89954DC0C8A658A6D766,31951,0,14,14,109.52174,18.30299,1568
82410,AAB3DCB18BAF89954DC0C8A658A6D766,38881,14,17,3,109.51618,18.26431,1562
82411,AAB3DCB18BAF89954DC0C8A658A6D766,30071,18,20,2,109.52819,18.30472,1619
82412,AAB3DCB18BAF89954DC0C8A658A6D766,31951,22,23,1,109.52174,18.30299,1568
82429,065F1687C35F3C827A2EA4A378A0E2C6,30851,11,14,3,109.5616,18.27396,1713
82430,065F1687C35F3C827A2EA4A378A0E2C6,31561,16,18,2,109.56792,18.28479,1765
82431,065F1687C35F3C827A2EA4A378A0E2C6,30851,18,21,3,109.5616,18.27396,1713
82457,817705C0BB74FA2761454F22705597E3,31781,13,14,1,109.19847,18.2975,367
82458,817705C0BB74FA2761454F22705597E3,31471,16,17,1,109.34583,18.29563,917
82459,13166628932DF36C0AD7B1DB5811240A,60591,0,6,6,109.61118,18.21715,1904
82460,13166628932DF36C0AD7B1DB5811240A,30854,10,16,6,109.56889,18.27076,1763
82461,13166628932DF36C0AD7B1DB5811240A,60591,19,23,4,109.61118,18.21715,1904
82494,6DF7485545B790F22810B0EDD8F1B356,31945,0,7,7,109.58021,18.29403,1817
82495,6DF7485545B790F22810B0EDD8F1B356,30854,8,10,2,109.56889,18.27076,1763
82496,6DF7485545B790F22810B0EDD8F1B356,31945,12,13,1,109.58021,18.29403,1817
82497,6DF7485545B790F22810B0EDD8F1B356,30854,16,17,1,109.56889,18.27076,1763
82498,6DF7485545B790F22810B0EDD8F1B356,31761,19,22,3,109.60521,18.27965,1914
82531,157D967BA2CB68D4813192367156AA3F,31534,0,9,9,109.49368,18.25806,1461
82532,157D967BA2CB68D4813192367156AA3F,38315,10,12,2,109.48979,18.29764,1467
82588,0F558B6653C655C7F0BAEA9D66B33F57,31071,1,6,5,109.58257,18.28458,1815
82589,0F558B6653C655C7F0BAEA9D66B33F57,30854,7,16,9,109.56889,18.27076,1763
82590,0F558B6653C655C7F0BAEA9D66B33F57,31071,16,17,1,109.58257,18.28458,1815
82591,0F558B6653C655C7F0BAEA9D66B33F57,30854,19,20,1,109.56889,18.27076,1763
82592,1026894DC5FF9A7FAF3A2EE28B95E239,30854,0,10,10,109.56889,18.27076,1763
82593,1026894DC5FF9A7FAF3A2EE28B95E239,30891,12,14,2,109.59431,18.28389,1865
82594,1026894DC5FF9A7FAF3A2EE28B95E239,30854,14,20,6,109.56889,18.27076,1763
82611,7421066246AAD1C230E7E2A7ADF06E9D,31071,1,2,1,109.58257,18.28458,1815
82612,7421066246AAD1C230E7E2A7ADF06E9D,60631,3,6,3,109.57778,18.27583,1814
82613,7421066246AAD1C230E7E2A7ADF06E9D,30854,7,10,3,109.56889,18.27076,1763
82614,7421066246AAD1C230E7E2A7ADF06E9D,60631,12,13,1,109.57778,18.27583,1814
82615,7421066246AAD1C230E7E2A7ADF06E9D,30854,13,21,8,109.56889,18.27076,1763
82616,7421066246AAD1C230E7E2A7ADF06E9D,60631,21,23,2,109.57778,18.27583,1814
82635,A01B4012B619D942E7CC3AC9B78722B4,31561,0,7,7,109.56792,18.28479,1765
82636,A01B4012B619D942E7CC3AC9B78722B4,39183,9,11,2,109.55542,18.28208,1715
82637,A01B4012B619D942E7CC3AC9B78722B4,31561,11,23,12,109.56792,18.28479,1765
82645,C153552CEA2677B0FF473AE565EA979E,30821,0,12,12,109.43681,18.33639,1274
82646,C153552CEA2677B0FF473AE565EA979E,30651,12,13,1,109.42611,18.385,1232
82647,C153552CEA2677B0FF473AE565EA979E,30821,13,14,1,109.43681,18.33639,1274
82648,C153552CEA2677B0FF473AE565EA979E,30651,18,19,1,109.42611,18.385,1232
82649,C153552CEA2677B0FF473AE565EA979E,30821,21,23,2,109.43681,18.33639,1274
82650,417408FFDA93B177641D270D3A5C4B2D,31071,0,14,14,109.58257,18.28458,1815
82651,417408FFDA93B177641D270D3A5C4B2D,30854,15,17,2,109.56889,18.27076,1763
82652,417408FFDA93B177641D270D3A5C4B2D,31071,17,19,2,109.58257,18.28458,1815
82653,417408FFDA93B177641D270D3A5C4B2D,31945,21,22,1,109.58021,18.29403,1817
82664,DF46DA0955594B99E73FB26D3951FE40,30854,2,6,4,109.56889,18.27076,1763
82665,DF46DA0955594B99E73FB26D3951FE40,30232,6,12,6,109.6191,18.31701,1971
82666,DF46DA0955594B99E73FB26D3951FE40,30854,13,23,10,109.56889,18.27076,1763
82752,1BDE433888973A22F2D9A5CC8B5A34FF,30221,0,14,14,109.57833,18.20222,1802
82753,1BDE433888973A22F2D9A5CC8B5A34FF,38127,18,19,1,109.50833,18.27222,1513
82754,1BDE433888973A22F2D9A5CC8B5A34FF,30221,21,23,2,109.57833,18.20222,1802
82764,EFFEF00C078D502D6D0D1D469ACBA466,30421,0,7,7,109.50021,18.25861,1511
82765,EFFEF00C078D502D6D0D1D469ACBA466,31471,9,10,1,109.34583,18.29563,917
82766,EFFEF00C078D502D6D0D1D469ACBA466,39041,12,14,2,109.40021,18.29278,1117
82767,EFFEF00C078D502D6D0D1D469ACBA466,31471,15,17,2,109.34583,18.29563,917
82784,7D4FF7DC44030D76F91C2D27A16541A1,60463,0,2,2,109.52507,18.22438,1605
82788,3541891770D5E46642FA2F10632E5CD4,39111,1,5,4,109.5191,18.22597,1555
82789,3541891770D5E46642FA2F10632E5CD4,30221,7,11,4,109.57833,18.20222,1802
82790,3541891770D5E46642FA2F10632E5CD4,31521,11,12,1,109.51458,18.22542,1555
82791,3541891770D5E46642FA2F10632E5CD4,31781,13,14,1,109.19847,18.2975,367
82792,3541891770D5E46642FA2F10632E5CD4,31521,17,19,2,109.51458,18.22542,1555
82793,3541891770D5E46642FA2F10632E5CD4,30221,22,23,1,109.57833,18.20222,1802
82842,C1602FB5A20BD98313F7CC13F431D061,30421,13,18,5,109.50021,18.25861,1511
82843,C1602FB5A20BD98313F7CC13F431D061,30911,20,21,1,109.50493,18.26181,1511
82847,8DD23AA43C0F7967C45F7488D66F9159,30854,0,1,1,109.56889,18.27076,1763
82848,8DD23AA43C0F7967C45F7488D66F9159,31945,1,6,5,109.58021,18.29403,1817
82849,8DD23AA43C0F7967C45F7488D66F9159,30854,8,17,9,109.56889,18.27076,1763
82860,BD4652414D5C17466BA36FD4BD943A94,31931,13,15,2,109.54771,18.29403,1667
82861,BD4652414D5C17466BA36FD4BD943A94,39183,17,18,1,109.55542,18.28208,1715
82883,B421B0364BC07B443944D07A1DCB065A,60201,0,9,9,109.5041,18.2509,1510
82884,B421B0364BC07B443944D07A1DCB065A,60291,13,15,2,109.50826,18.24639,1509
82919,F7ABE1A2051D725D70F50CD6183F5B8A,38054,0,12,12,109.63479,18.23097,2006
82920,F7ABE1A2051D725D70F50CD6183F5B8A,30361,13,23,10,109.50347,18.24,1508
82926,CA629265321FCE7203917445EFF19E66,30771,0,6,6,109.49938,18.26042,1511
82927,CA629265321FCE7203917445EFF19E66,31781,10,11,1,109.19847,18.2975,367
82928,CA629265321FCE7203917445EFF19E66,31471,15,17,2,109.34583,18.29563,917
82929,CA629265321FCE7203917445EFF19E66,30421,18,23,5,109.50021,18.25861,1511
82953,3940DDDB655239C16F43D83626AAB86A,38241,0,5,5,109.54111,18.30542,1669
82954,3940DDDB655239C16F43D83626AAB86A,31931,5,16,11,109.54771,18.29403,1667
82955,3940DDDB655239C16F43D83626AAB86A,38241,19,23,4,109.54111,18.30542,1669
82973,C85D0B931BEF54F05B9ABBBB03212DB7,30854,0,6,6,109.56889,18.27076,1763
82974,C85D0B931BEF54F05B9ABBBB03212DB7,31561,6,18,12,109.56792,18.28479,1765
82975,C85D0B931BEF54F05B9ABBBB03212DB7,30854,19,22,3,109.56889,18.27076,1763
82994,0E1DB444F47235AEDAD0A0404A7B75B4,31561,2,3,1,109.56792,18.28479,1765
82995,0E1DB444F47235AEDAD0A0404A7B75B4,39183,7,13,6,109.55542,18.28208,1715
82996,0E1DB444F47235AEDAD0A0404A7B75B4,31561,16,17,1,109.56792,18.28479,1765
82997,0E1DB444F47235AEDAD0A0404A7B75B4,30891,19,20,1,109.59431,18.28389,1865
82998,B37777551ADDE84A1FDFE1FF465C24DC,31931,0,8,8,109.54771,18.29403,1667
82999,B37777551ADDE84A1FDFE1FF465C24DC,38821,11,14,3,109.50354,18.25243,1510
83000,CBC603DF99C1D6981715077F3EA24CB6,30854,0,1,1,109.56889,18.27076,1763
83001,CBC603DF99C1D6981715077F3EA24CB6,30232,2,7,5,109.6191,18.31701,1971
83002,CBC603DF99C1D6981715077F3EA24CB6,39183,10,11,1,109.55542,18.28208,1715
83003,CBC603DF99C1D6981715077F3EA24CB6,31521,15,16,1,109.51458,18.22542,1555
83004,CBC603DF99C1D6981715077F3EA24CB6,39183,19,23,4,109.55542,18.28208,1715
83006,EE0804F129D0F96C287A44865905653C,30711,8,9,1,109.50271,18.25347,1510
83058,324899445F811D5785FB336DE18DAC0E,31531,0,5,5,109.49583,18.25972,1461
83061,EDD211647BCC1D3CABF473CB2801C791,30361,0,10,10,109.50347,18.24,1508
83062,EDD211647BCC1D3CABF473CB2801C791,30161,11,17,6,109.50042,18.24389,1508
83063,EDD211647BCC1D3CABF473CB2801C791,31391,17,23,6,109.50382,18.24285,1508
83070,7B2AEE2086698683607EDDDB4B678234,60371,0,6,6,109.53063,18.30056,1618
83071,7B2AEE2086698683607EDDDB4B678234,60241,7,8,1,109.53319,18.28667,1616
83072,7B2AEE2086698683607EDDDB4B678234,60221,8,9,1,109.52569,18.29188,1616
83073,7B2AEE2086698683607EDDDB4B678234,60201,9,13,4,109.5041,18.2509,1510
83090,D758DCB0CB2E5EA2CADCED24F521A533,30854,0,13,13,109.56889,18.27076,1763
83091,D758DCB0CB2E5EA2CADCED24F521A533,31071,14,15,1,109.58257,18.28458,1815
83092,D758DCB0CB2E5EA2CADCED24F521A533,30854,18,23,5,109.56889,18.27076,1763
83120,2A6BA0678DDF16AF08BAC9E3FA3C9391,31561,0,6,6,109.56792,18.28479,1765
83121,2A6BA0678DDF16AF08BAC9E3FA3C9391,30854,9,19,10,109.56889,18.27076,1763
83152,8E3A30A4D1E8F550E98C2EF7500D367D,30084,2,8,6,109.50118,18.26972,1513
83153,8E3A30A4D1E8F550E98C2EF7500D367D,31145,11,14,3,109.20431,18.30479,369
83154,8E3A30A4D1E8F550E98C2EF7500D367D,30084,16,18,2,109.50118,18.26972,1513
83155,8E3A30A4D1E8F550E98C2EF7500D367D,30081,19,23,4,109.50243,18.26632,1512
83156,25AEFF32B0667D26540E580A39012DE0,38141,0,4,4,109.39479,18.2916,1116
83157,25AEFF32B0667D26540E580A39012DE0,38141,5,10,5,109.39479,18.2916,1116
83158,25AEFF32B0667D26540E580A39012DE0,31671,11,13,2,109.38965,18.29813,1068
83159,25AEFF32B0667D26540E580A39012DE0,38071,18,19,1,109.40722,18.30938,1169
83170,75817DB682187A07461734D66E1E6492,60631,0,4,4,109.57778,18.27583,1814
83171,75817DB682187A07461734D66E1E6492,30854,4,18,14,109.56889,18.27076,1763
83172,75817DB682187A07461734D66E1E6492,60631,22,23,1,109.57778,18.27583,1814
83190,E16204D131FCD957D5ADB9592C1DD0ED,60311,13,14,1,109.52097,18.24319,1558
83191,E16204D131FCD957D5ADB9592C1DD0ED,31071,17,19,2,109.58257,18.28458,1815
83248,B3D869AADCF0B90715B79410877850C1,30351,0,2,2,109.41701,18.29292,1217
83249,B3D869AADCF0B90715B79410877850C1,31231,2,4,2,109.42597,18.29292,1217
83250,B3D869AADCF0B90715B79410877850C1,30351,6,8,2,109.41701,18.29292,1217
83251,B3D869AADCF0B90715B79410877850C1,31781,10,14,4,109.19847,18.2975,367
83252,B3D869AADCF0B90715B79410877850C1,30351,17,20,3,109.41701,18.29292,1217
83276,53875E69050EC42E511A64D3211FA7B3,31561,13,15,2,109.56792,18.28479,1765
83277,53875E69050EC42E511A64D3211FA7B3,30851,19,21,2,109.5616,18.27396,1713
83322,A952750F25C558E5C17B3EB7DD935431,30071,0,4,4,109.52819,18.30472,1619
83323,A952750F25C558E5C17B3EB7DD935431,31931,7,16,9,109.54771,18.29403,1667
83324,A952750F25C558E5C17B3EB7DD935431,60371,17,23,6,109.53063,18.30056,1618
83327,ABCD0851CC1C78BCD7AF6DBDF2F5DE49,60552,0,15,15,109.41729,18.30014,1218
83328,ABCD0851CC1C78BCD7AF6DBDF2F5DE49,31091,19,20,1,109.41201,18.31222,1170
83329,ABCD0851CC1C78BCD7AF6DBDF2F5DE49,60552,21,23,2,109.41729,18.30014,1218
83332,5E97A4561E11AAC4FBC53FD068EAA52B,30854,0,6,6,109.56889,18.27076,1763
83333,5E97A4561E11AAC4FBC53FD068EAA52B,30531,8,18,10,109.53271,18.21472,1604
83334,5E97A4561E11AAC4FBC53FD068EAA52B,30854,21,22,1,109.56889,18.27076,1763
83340,C19430CE8DF26BDEF43903E57E682236,31561,0,8,8,109.56792,18.28479,1765
83341,C19430CE8DF26BDEF43903E57E682236,30854,8,10,2,109.56889,18.27076,1763
83342,C19430CE8DF26BDEF43903E57E682236,31561,12,13,1,109.56792,18.28479,1765
83343,C19430CE8DF26BDEF43903E57E682236,30854,16,18,2,109.56889,18.27076,1763
83374,B643AC77F8D8498A9694D45BA8B0F75F,60631,0,16,16,109.57778,18.27583,1814
83375,B643AC77F8D8498A9694D45BA8B0F75F,31561,17,21,4,109.56792,18.28479,1765
83488,5426296000364EE32711CD0E73D782C8,31561,12,16,4,109.56792,18.28479,1765
83489,5426296000364EE32711CD0E73D782C8,30854,19,21,2,109.56889,18.27076,1763
83501,0C6C0D19798B06A61B30F115931FC215,31801,14,15,1,109.20417,18.32118,371
83504,2361E8D6BAB0231B2E8E3C0F34517282,30291,6,8,2,109.50403,18.27028,1513
83505,2361E8D6BAB0231B2E8E3C0F34517282,38171,9,13,4,109.50799,18.28139,1515
83506,2361E8D6BAB0231B2E8E3C0F34517282,30291,17,20,3,109.50403,18.27028,1513
83570,09C311D86737E534420F351D48938D74,60201,16,17,1,109.5041,18.2509,1510
83571,09C311D86737E534420F351D48938D74,30281,20,23,3,109.50597,18.27583,1514
83590,EE10AC6477FFD3D50107E111E624E05D,60211,15,17,2,109.63549,18.26049,2011
83591,EE10AC6477FFD3D50107E111E624E05D,31351,19,22,3,109.4959,18.28417,1465
83615,996C0D9500BF90CC0E7F5A04C49A464B,31931,0,8,8,109.54771,18.29403,1667
83616,996C0D9500BF90CC0E7F5A04C49A464B,30921,8,21,13,109.53903,18.29451,1667
83626,B340EDEF4A878E8DF5CBEC25E465EACE,30854,2,10,8,109.56889,18.27076,1763
83627,B340EDEF4A878E8DF5CBEC25E465EACE,60631,10,11,1,109.57778,18.27583,1814
83628,B340EDEF4A878E8DF5CBEC25E465EACE,30854,11,15,4,109.56889,18.27076,1763
83629,B340EDEF4A878E8DF5CBEC25E465EACE,30084,18,19,1,109.50118,18.26972,1513
83630,B340EDEF4A878E8DF5CBEC25E465EACE,31201,20,23,3,109.51042,18.23819,1558
83638,F198CAA1F49ACA5D003FD8F8473B3798,30731,14,16,2,109.50944,18.22306,1555
83639,F198CAA1F49ACA5D003FD8F8473B3798,30854,17,18,1,109.56889,18.27076,1763
83668,C860767955774E3494068CF38C009FB6,60463,0,2,2,109.52507,18.22438,1605
83669,C860767955774E3494068CF38C009FB6,60391,2,15,13,109.47667,18.28757,1416
83670,C860767955774E3494068CF38C009FB6,38251,17,19,2,109.49618,18.25493,1510
83671,C860767955774E3494068CF38C009FB6,60391,19,23,4,109.47667,18.28757,1416
83728,662D882A6A10D0E6C3566690F0A40636,30854,0,13,13,109.56889,18.27076,1763
83729,662D882A6A10D0E6C3566690F0A40636,31071,17,19,2,109.58257,18.28458,1815
83775,8BB035B44D009B4E567D4EFF10F50E4D,30854,0,7,7,109.56889,18.27076,1763
83776,8BB035B44D009B4E567D4EFF10F50E4D,31311,10,11,1,109.72299,18.27438,2364
83777,8BB035B44D009B4E567D4EFF10F50E4D,31071,14,15,1,109.58257,18.28458,1815
83778,8BB035B44D009B4E567D4EFF10F50E4D,30854,17,21,4,109.56889,18.27076,1763
83782,E2CFBC4AD8BA700D32898ABFA9A0C849,31071,0,3,3,109.58257,18.28458,1815
83783,E2CFBC4AD8BA700D32898ABFA9A0C849,30851,3,4,1,109.5616,18.27396,1713
83784,E2CFBC4AD8BA700D32898ABFA9A0C849,30854,5,14,9,109.56889,18.27076,1763
83785,E2CFBC4AD8BA700D32898ABFA9A0C849,30081,19,20,1,109.50243,18.26632,1512
83786,E2CFBC4AD8BA700D32898ABFA9A0C849,30191,22,23,1,109.50361,18.22701,1506
83844,405CDAA480A91B52CBB74C6B8C550FA6,31181,1,3,2,109.50382,18.24813,1509
83845,405CDAA480A91B52CBB74C6B8C550FA6,60291,3,5,2,109.50826,18.24639,1509
83846,405CDAA480A91B52CBB74C6B8C550FA6,60131,6,9,3,109.49819,18.24778,1509
83847,405CDAA480A91B52CBB74C6B8C550FA6,31181,11,14,3,109.50382,18.24813,1509
83848,405CDAA480A91B52CBB74C6B8C550FA6,60291,16,18,2,109.50826,18.24639,1509
83870,BF77B653864ED8DD6CB6952D60F33BB5,30171,0,9,9,109.48458,18.27139,1463
83871,BF77B653864ED8DD6CB6952D60F33BB5,60621,11,14,3,109.48354,18.27451,1464
83872,BF77B653864ED8DD6CB6952D60F33BB5,30171,18,23,5,109.48458,18.27139,1463
83910,44F505B3929E26B4B29F00CC284F3084,60361,10,12,2,109.51938,18.29681,1567
83911,44F505B3929E26B4B29F00CC284F3084,30854,13,15,2,109.56889,18.27076,1763
83912,44F505B3929E26B4B29F00CC284F3084,31071,19,22,3,109.58257,18.28458,1815
83915,289C96166B72325FF931BEE9E63A948B,39191,0,6,6,109.51493,18.23472,1557
83918,289C96166B72325FF931BEE9E63A948B,39191,19,23,4,109.51493,18.23472,1557
83926,A53D76C44A71267FF477911E38598EC8,31561,17,20,3,109.56792,18.28479,1765
83927,A53D76C44A71267FF477911E38598EC8,30854,20,23,3,109.56889,18.27076,1763
83978,F5FE23BF42FC224C310CD42E08B0B950,31431,0,6,6,109.44639,18.29042,1316
83979,F5FE23BF42FC224C310CD42E08B0B950,38094,6,10,4,109.45403,18.28778,1316
83980,F5FE23BF42FC224C310CD42E08B0B950,31431,10,13,3,109.44639,18.29042,1316
83981,F5FE23BF42FC224C310CD42E08B0B950,38094,15,21,6,109.45403,18.28778,1316
84014,FA6ABA68C8C4B512A2E858E0E08423D7,30291,0,8,8,109.50403,18.27028,1513
84015,FA6ABA68C8C4B512A2E858E0E08423D7,31864,9,10,1,109.49014,18.28333,1465
84016,FA6ABA68C8C4B512A2E858E0E08423D7,30291,11,14,3,109.50403,18.27028,1513
84017,FA6ABA68C8C4B512A2E858E0E08423D7,30854,16,21,5,109.56889,18.27076,1763
84021,DC0EB400EA24BEE9EB39D315B0E6AEF0,31431,16,20,4,109.44639,18.29042,1316
84022,DC0EB400EA24BEE9EB39D315B0E6AEF0,31701,21,22,1,109.44132,18.28833,1266
84031,9FEA4B85EAE4FAEE1CAF0EABFF2FAEA1,31561,1,15,14,109.56792,18.28479,1765
84032,9FEA4B85EAE4FAEE1CAF0EABFF2FAEA1,39183,15,16,1,109.55542,18.28208,1715
84033,9FEA4B85EAE4FAEE1CAF0EABFF2FAEA1,30854,20,21,1,109.56889,18.27076,1763
84048,F605546ADA1ADB3E2AF3E74D19682812,31931,14,15,1,109.54771,18.29403,1667
84049,F605546ADA1ADB3E2AF3E74D19682812,60221,20,22,2,109.52569,18.29188,1616
84050,EF43F60CF9BD4AC27FA4A9E23A6B17C7,31821,20,21,1,109.51181,18.24924,1559
84051,EF43F60CF9BD4AC27FA4A9E23A6B17C7,31521,21,23,2,109.51458,18.22542,1555
84065,F640E2D98187FE602EA0B6D8FEAF6E35,31031,13,14,1,109.49979,18.25382,1510
84098,BE8220A49F1231C0A022F4AA2075503E,30854,14,17,3,109.56889,18.27076,1763
84099,BE8220A49F1231C0A022F4AA2075503E,31945,21,23,2,109.58021,18.29403,1817
84104,94C4D5691F7DFC1AB38806AFFAC1389E,31931,3,7,4,109.54771,18.29403,1667
84105,94C4D5691F7DFC1AB38806AFFAC1389E,30921,8,10,2,109.53903,18.29451,1667
84106,94C4D5691F7DFC1AB38806AFFAC1389E,31931,13,14,1,109.54771,18.29403,1667
84107,94C4D5691F7DFC1AB38806AFFAC1389E,39091,18,19,1,109.50097,18.25222,1510
84108,C9524866A6E9E0E3158261DBB1EE420F,30581,14,15,1,109.62257,18.24951,1959
84109,C9524866A6E9E0E3158261DBB1EE420F,38951,17,23,6,109.48097,18.28868,1416
84162,E191BF114A3C2277CB7C3323BAA13F43,30854,2,13,11,109.56889,18.27076,1763
84163,E191BF114A3C2277CB7C3323BAA13F43,39101,17,20,3,109.50132,18.24931,1509
84164,E191BF114A3C2277CB7C3323BAA13F43,30854,20,22,2,109.56889,18.27076,1763
84176,9FC721E86703223349C05C95FE4BBB6F,60081,0,10,10,109.51097,18.22639,1556
84177,9FC721E86703223349C05C95FE4BBB6F,60381,11,19,8,109.5241,18.22458,1605
84178,9FC721E86703223349C05C95FE4BBB6F,60087,21,23,2,109.50688,18.22299,1505
84187,A68637AA89BD62624E677D9E66C32FAD,30161,0,18,18,109.50042,18.24389,1508
84188,A68637AA89BD62624E677D9E66C32FAD,30161,20,23,3,109.50042,18.24389,1508
84219,65ACBAAF6AD7CF9530991E30B1E393C6,31181,17,19,2,109.50382,18.24813,1509
84220,65ACBAAF6AD7CF9530991E30B1E393C6,38291,19,21,2,109.51618,18.24313,1558
84259,8554F0A178316702A9146AC053A2336A,60161,3,6,3,109.49174,18.26181,1461
84260,8554F0A178316702A9146AC053A2336A,31031,6,8,2,109.49979,18.25382,1510
84261,2297ECCBAEAEEAB6F486010C8882DE44,60581,0,8,8,109.59785,18.29931,1868
84262,2297ECCBAEAEEAB6F486010C8882DE44,38185,12,16,4,109.51333,18.27347,1563
84318,90B0A60855A43B2DB99A0964CE51D3AF,31861,18,19,1,109.49042,18.27549,1464
84319,90B0A60855A43B2DB99A0964CE51D3AF,30201,20,21,1,109.4909,18.26465,1462
84330,05F9648883BF713D4E846B58647DFC7D,60552,0,4,4,109.41729,18.30014,1218
84331,05F9648883BF713D4E846B58647DFC7D,60524,5,6,1,109.42951,18.28993,1216
84332,05F9648883BF713D4E846B58647DFC7D,60552,7,9,2,109.41729,18.30014,1218
84333,05F9648883BF713D4E846B58647DFC7D,31091,9,10,1,109.41201,18.31222,1170
84334,05F9648883BF713D4E846B58647DFC7D,30671,11,13,2,109.43611,18.30139,1268
84335,05F9648883BF713D4E846B58647DFC7D,60552,16,17,1,109.41729,18.30014,1218
84425,0D3DA8126B134D203BB35373EAFFB116,30361,0,1,1,109.50347,18.24,1508
84426,0D3DA8126B134D203BB35373EAFFB116,31071,2,21,19,109.58257,18.28458,1815
84473,47A18820FDA9856131F74091D44B6BCB,31071,0,6,6,109.58257,18.28458,1815
84474,47A18820FDA9856131F74091D44B6BCB,31561,7,14,7,109.56792,18.28479,1765
84475,47A18820FDA9856131F74091D44B6BCB,30851,15,17,2,109.5616,18.27396,1713
84476,47A18820FDA9856131F74091D44B6BCB,31561,21,22,1,109.56792,18.28479,1765
84477,5274FB91D917823AD6AE120EE7F21099,31931,5,7,2,109.54771,18.29403,1667
84478,5274FB91D917823AD6AE120EE7F21099,30324,8,11,3,109.50326,18.29257,1517
84479,5274FB91D917823AD6AE120EE7F21099,60361,14,16,2,109.51938,18.29681,1567
84480,5274FB91D917823AD6AE120EE7F21099,31931,21,22,1,109.54771,18.29403,1667
84528,A9FCE0049DB44FE004EAFBF5B783F4A5,31945,0,13,13,109.58021,18.29403,1817
84529,A9FCE0049DB44FE004EAFBF5B783F4A5,31071,14,15,1,109.58257,18.28458,1815
84530,A9FCE0049DB44FE004EAFBF5B783F4A5,30854,15,19,4,109.56889,18.27076,1763
84531,B663EE883B81AEB709AC84DCCEC3D38E,31945,4,14,10,109.58021,18.29403,1817
84532,B663EE883B81AEB709AC84DCCEC3D38E,30854,16,17,1,109.56889,18.27076,1763
84533,B663EE883B81AEB709AC84DCCEC3D38E,31071,19,20,1,109.58257,18.28458,1815
84534,B663EE883B81AEB709AC84DCCEC3D38E,30191,21,23,2,109.50361,18.22701,1506
84592,524D453DEC27C2232F819E60169E1FC2,30741,0,8,8,109.49833,18.28681,1516
84593,524D453DEC27C2232F819E60169E1FC2,30941,8,10,2,109.5559,18.33938,1724
84594,524D453DEC27C2232F819E60169E1FC2,39183,14,16,2,109.55542,18.28208,1715
84595,524D453DEC27C2232F819E60169E1FC2,30101,18,19,1,109.57299,18.33333,1773
84596,524D453DEC27C2232F819E60169E1FC2,31461,19,20,1,109.5091,18.25389,1510
84597,524D453DEC27C2232F819E60169E1FC2,30741,21,23,2,109.49833,18.28681,1516
84618,84DF4A7C208235D171EF56473BCCF210,30851,1,2,1,109.5616,18.27396,1713
84619,84DF4A7C208235D171EF56473BCCF210,31561,4,7,3,109.56792,18.28479,1765
84620,84DF4A7C208235D171EF56473BCCF210,60631,8,18,10,109.57778,18.27583,1814
84621,84DF4A7C208235D171EF56473BCCF210,30854,19,20,1,109.56889,18.27076,1763
84685,7024F3A14F6F554DC6E80063E30315F0,31561,3,5,2,109.56792,18.28479,1765
84686,7024F3A14F6F554DC6E80063E30315F0,39183,8,10,2,109.55542,18.28208,1715
84687,7024F3A14F6F554DC6E80063E30315F0,31561,12,13,1,109.56792,18.28479,1765
84753,D6A345956751BA2ACC5430EDF68A104F,39181,0,6,6,109.55153,18.28035,1715
84754,D6A345956751BA2ACC5430EDF68A104F,31931,7,11,4,109.54771,18.29403,1667
84755,D6A345956751BA2ACC5430EDF68A104F,39181,12,23,11,109.55153,18.28035,1715
84761,867CD177C4F4B0DA2800BA7613DC965C,31061,0,12,12,109.53333,18.23257,1607
84763,867CD177C4F4B0DA2800BA7613DC965C,30211,18,23,5,109.49882,18.23931,1508
84788,13ABA70DC1B5E636027143D57A5DAAA1,31421,1,6,5,109.55382,18.22347,1705
84789,13ABA70DC1B5E636027143D57A5DAAA1,31061,7,8,1,109.53333,18.23257,1607
84790,0D00E0CA974DDA00224ACCD00B993468,30851,0,13,13,109.5616,18.27396,1713
84791,0D00E0CA974DDA00224ACCD00B993468,30854,15,18,3,109.56889,18.27076,1763
84792,0D00E0CA974DDA00224ACCD00B993468,31071,20,21,1,109.58257,18.28458,1815
84805,F00821368F615DCDAF214035D8EC4A44,31071,2,7,5,109.58257,18.28458,1815
84806,F00821368F615DCDAF214035D8EC4A44,30854,8,15,7,109.56889,18.27076,1763
84807,F00821368F615DCDAF214035D8EC4A44,31071,15,17,2,109.58257,18.28458,1815
84808,F00821368F615DCDAF214035D8EC4A44,60463,19,21,2,109.52507,18.22438,1605
84810,0B2CDE43D7DE290E07FF365A2D22E5DE,30854,13,21,8,109.56889,18.27076,1763
84821,6FE9D30AF9D5BAD1F717916B377146E9,38961,0,8,8,109.50847,18.23514,1507
84822,6FE9D30AF9D5BAD1F717916B377146E9,31781,11,13,2,109.19847,18.2975,367
84823,6FE9D30AF9D5BAD1F717916B377146E9,31471,14,16,2,109.34583,18.29563,917
84824,6FE9D30AF9D5BAD1F717916B377146E9,31201,18,22,4,109.51042,18.23819,1558
84828,8D7B9451E0189947198D6AC9CE51CFEE,60391,0,1,1,109.47667,18.28757,1416
84829,8D7B9451E0189947198D6AC9CE51CFEE,31091,2,11,9,109.41201,18.31222,1170
84830,8D7B9451E0189947198D6AC9CE51CFEE,31081,12,14,2,109.44639,18.30181,1318
84831,8D7B9451E0189947198D6AC9CE51CFEE,31091,16,20,4,109.41201,18.31222,1170
84832,8D7B9451E0189947198D6AC9CE51CFEE,30761,22,23,1,109.45201,18.3,1318
84854,934029FB5F97BCE114EDCE88F0393A63,31071,12,14,2,109.58257,18.28458,1815
84855,934029FB5F97BCE114EDCE88F0393A63,30854,17,18,1,109.56889,18.27076,1763
84856,96F98526707B06BE1263CCD4F72E07A1,31071,0,6,6,109.58257,18.28458,1815
84857,96F98526707B06BE1263CCD4F72E07A1,30854,11,22,11,109.56889,18.27076,1763
84862,513924E5F8EAB458027327A1E2BAE9DB,31071,0,7,7,109.58257,18.28458,1815
84863,513924E5F8EAB458027327A1E2BAE9DB,30854,7,9,2,109.56889,18.27076,1763
84864,513924E5F8EAB458027327A1E2BAE9DB,31031,11,13,2,109.49979,18.25382,1510
84865,513924E5F8EAB458027327A1E2BAE9DB,30854,16,17,1,109.56889,18.27076,1763
84866,513924E5F8EAB458027327A1E2BAE9DB,31071,18,20,2,109.58257,18.28458,1815
84867,513924E5F8EAB458027327A1E2BAE9DB,30854,21,23,2,109.56889,18.27076,1763
84887,24B9CD23EC5587BA3102D06F602ACE38,31951,0,2,2,109.52174,18.30299,1568
84888,24B9CD23EC5587BA3102D06F602ACE38,60171,2,22,20,109.51292,18.30694,1569
84923,90247A6FCE5F317B4B054CEB03D32D7B,31671,21,22,1,109.38965,18.29813,1068
84958,F84D949DDCBF25D5530F771BC55E0B9D,61011,0,19,19,109.60653,18.19076,1900
84979,53490AD77ACCA93C3ED0F3DE79CA488B,30854,7,10,3,109.56889,18.27076,1763
84980,53490AD77ACCA93C3ED0F3DE79CA488B,31071,14,16,2,109.58257,18.28458,1815
84981,53490AD77ACCA93C3ED0F3DE79CA488B,30854,19,20,1,109.56889,18.27076,1763
84990,6E2021B014C4D0B652A2E4FE8D2CF038,31861,18,19,1,109.49042,18.27549,1464
84991,6E2021B014C4D0B652A2E4FE8D2CF038,30201,20,21,1,109.4909,18.26465,1462
85015,07169E7114E4F14C073261BAAC0D4491,61011,0,4,4,109.60653,18.19076,1900
85017,07169E7114E4F14C073261BAAC0D4491,61011,12,23,11,109.60653,18.19076,1900
85055,9C1407835BC54BEBDB541F52E1DA1820,61011,0,4,4,109.60653,18.19076,1900
85057,9C1407835BC54BEBDB541F52E1DA1820,61011,17,20,3,109.60653,18.19076,1900
85075,D2BE39F7C6BE2553FAEEB8E39136B40A,60361,17,23,6,109.51938,18.29681,1567
85079,4E29CE086935B3CD8038A4A6640FE864,30321,0,8,8,109.49563,18.29611,1467
85080,4E29CE086935B3CD8038A4A6640FE864,60041,9,11,2,109.39889,18.31944,1121
85081,4E29CE086935B3CD8038A4A6640FE864,31321,13,18,5,109.63799,18.23201,2007
85082,4E29CE086935B3CD8038A4A6640FE864,31181,19,21,2,109.50382,18.24813,1509
85087,3520FED22A4D572CBFE1B08BD2743E22,31041,0,1,1,109.50278,18.23701,1507
85088,3520FED22A4D572CBFE1B08BD2743E22,30361,2,7,5,109.50347,18.24,1508
85089,3520FED22A4D572CBFE1B08BD2743E22,31181,7,12,5,109.50382,18.24813,1509
85090,3520FED22A4D572CBFE1B08BD2743E22,60381,13,14,1,109.5241,18.22458,1605
85134,45535CEC214473A10AF775FE26E0DA0C,31471,17,19,2,109.34583,18.29563,917
85135,45535CEC214473A10AF775FE26E0DA0C,31021,20,21,1,109.49021,18.27,1463
85136,45535CEC214473A10AF775FE26E0DA0C,31531,22,23,1,109.49583,18.25972,1461
85146,8C3D244B6DAAE8C73F174808255E03C6,60011,1,7,6,109.48965,18.30222,1468
85147,8C3D244B6DAAE8C73F174808255E03C6,30764,8,10,2,109.45806,18.29486,1367
85148,8C3D244B6DAAE8C73F174808255E03C6,30761,10,12,2,109.45201,18.3,1318
85149,8C3D244B6DAAE8C73F174808255E03C6,60614,14,19,5,109.48799,18.29521,1467
85169,0A987E09994A8BF75281CD6678876931,30571,0,6,6,109.50243,18.21861,1504
85170,0A987E09994A8BF75281CD6678876931,30531,6,7,1,109.53271,18.21472,1604
85171,0A987E09994A8BF75281CD6678876931,30571,10,12,2,109.50243,18.21861,1504
85172,C054F0F1F6DF018C36D80DAC513476F7,30151,2,9,7,109.50986,18.25083,1560
85173,C054F0F1F6DF018C36D80DAC513476F7,30151,10,13,3,109.50986,18.25083,1560
85174,C054F0F1F6DF018C36D80DAC513476F7,30151,16,17,1,109.50986,18.25083,1560
85175,C054F0F1F6DF018C36D80DAC513476F7,30151,21,22,1,109.50986,18.25083,1560
85196,EF3F5D47F696D0CEE9F7620E432B3BA9,60381,16,18,2,109.5241,18.22458,1605
85197,EF3F5D47F696D0CEE9F7620E432B3BA9,38105,19,21,2,109.40299,18.29229,1117
85215,C82725A09C032EE9BFF2088FCCC60D1D,30854,13,14,1,109.56889,18.27076,1763
85216,C82725A09C032EE9BFF2088FCCC60D1D,31071,17,23,6,109.58257,18.28458,1815
85227,DBB710D279E76C79F1E4B0766F579F8A,31071,0,1,1,109.58257,18.28458,1815
85228,DBB710D279E76C79F1E4B0766F579F8A,60211,3,5,2,109.63549,18.26049,2011
85229,DBB710D279E76C79F1E4B0766F579F8A,30854,8,9,1,109.56889,18.27076,1763
85230,DBB710D279E76C79F1E4B0766F579F8A,31071,12,14,2,109.58257,18.28458,1815
85231,DBB710D279E76C79F1E4B0766F579F8A,30854,14,15,1,109.56889,18.27076,1763
85234,B80D4B4CDBD08237A9C4254F8883AEF4,39151,0,5,5,109.49875,18.25097,1510
85235,B80D4B4CDBD08237A9C4254F8883AEF4,60201,8,11,3,109.5041,18.2509,1510
85236,B80D4B4CDBD08237A9C4254F8883AEF4,39151,12,14,2,109.49875,18.25097,1510
85237,B80D4B4CDBD08237A9C4254F8883AEF4,31181,14,18,4,109.50382,18.24813,1509
85238,B80D4B4CDBD08237A9C4254F8883AEF4,39091,18,22,4,109.50097,18.25222,1510
85251,CCCD2290FB632A48009771412BE68ADD,31561,0,5,5,109.56792,18.28479,1765
85252,CCCD2290FB632A48009771412BE68ADD,39183,6,7,1,109.55542,18.28208,1715
85253,CCCD2290FB632A48009771412BE68ADD,31561,8,19,11,109.56792,18.28479,1765
85254,8799356B7181F28146A203E5F86C52F0,31351,0,7,7,109.4959,18.28417,1465
85255,8799356B7181F28146A203E5F86C52F0,38834,8,14,6,109.47639,18.21146,1403
85256,8799356B7181F28146A203E5F86C52F0,31351,18,20,2,109.4959,18.28417,1465
85257,DC29C676832347947F366933ECB88090,31561,0,6,6,109.56792,18.28479,1765
85258,DC29C676832347947F366933ECB88090,39183,9,11,2,109.55542,18.28208,1715
85259,DC29C676832347947F366933ECB88090,31561,13,15,2,109.56792,18.28479,1765
85317,7EBC20D0E5F0FBA046CA1D08E7FF47C1,60631,1,8,7,109.57778,18.27583,1814
85318,7EBC20D0E5F0FBA046CA1D08E7FF47C1,30854,8,22,14,109.56889,18.27076,1763
85336,55FA72F7A9567EE8C2569F2A3640F92B,31931,5,7,2,109.54771,18.29403,1667
85337,55FA72F7A9567EE8C2569F2A3640F92B,39181,8,17,9,109.55153,18.28035,1715
85348,7084CDA7D62E3DD208E80D2A88147652,30281,0,7,7,109.50597,18.27583,1514
85349,7084CDA7D62E3DD208E80D2A88147652,31161,8,9,1,109.70229,18.31361,2270
85350,7084CDA7D62E3DD208E80D2A88147652,30281,13,15,2,109.50597,18.27583,1514
85351,7084CDA7D62E3DD208E80D2A88147652,60391,18,21,3,109.47667,18.28757,1416
85352,7084CDA7D62E3DD208E80D2A88147652,38127,21,22,1,109.50833,18.27222,1513
85361,37D38EF0062E64D55C94EB554B76F9EE,30854,16,17,1,109.56889,18.27076,1763
85362,37D38EF0062E64D55C94EB554B76F9EE,31945,21,23,2,109.58021,18.29403,1817
85380,3CCEADBA2BEBED7AF2D4B52641EA740D,39063,0,3,3,109.386,18.2919,1066
85381,3CCEADBA2BEBED7AF2D4B52641EA740D,38145,3,6,3,109.378,18.2912,1066
85482,BACB6801ACA2D5F4ABE5F40B34865F7A,30854,1,12,11,109.56889,18.27076,1763
85483,BACB6801ACA2D5F4ABE5F40B34865F7A,60631,14,18,4,109.57778,18.27583,1814
85552,012ABD06F231728C214A4BA917E75B1C,31561,0,3,3,109.56792,18.28479,1765
85553,012ABD06F231728C214A4BA917E75B1C,30851,5,6,1,109.5616,18.27396,1713
85554,012ABD06F231728C214A4BA917E75B1C,31561,6,8,2,109.56792,18.28479,1765
85555,012ABD06F231728C214A4BA917E75B1C,30851,9,10,1,109.5616,18.27396,1713
85556,012ABD06F231728C214A4BA917E75B1C,31561,12,13,1,109.56792,18.28479,1765
85557,012ABD06F231728C214A4BA917E75B1C,30851,15,16,1,109.5616,18.27396,1713
85558,012ABD06F231728C214A4BA917E75B1C,31561,17,19,2,109.56792,18.28479,1765
85559,51061B3DE820AF1C1C713EF684728003,31071,0,6,6,109.58257,18.28458,1815
85560,51061B3DE820AF1C1C713EF684728003,30854,8,10,2,109.56889,18.27076,1763
85561,51061B3DE820AF1C1C713EF684728003,31071,12,14,2,109.58257,18.28458,1815
85562,51061B3DE820AF1C1C713EF684728003,30854,16,23,7,109.56889,18.27076,1763
85565,A8E9C7BB918ADAD29A3EA7ACDDCD32D7,38951,1,6,5,109.48097,18.28868,1416
85566,A8E9C7BB918ADAD29A3EA7ACDDCD32D7,60041,8,15,7,109.39889,18.31944,1121
85567,A8E9C7BB918ADAD29A3EA7ACDDCD32D7,38951,17,23,6,109.48097,18.28868,1416
85581,7215C0D18BC61D4D8430855FAFDC2BFE,30421,17,19,2,109.50021,18.25861,1511
85582,7215C0D18BC61D4D8430855FAFDC2BFE,30391,21,22,1,109.4975,18.27118,1513
85611,1980C8D409DE9551539224B3D393CDAA,30071,0,5,5,109.52819,18.30472,1619
85612,1980C8D409DE9551539224B3D393CDAA,30071,5,8,3,109.52819,18.30472,1619
85613,1980C8D409DE9551539224B3D393CDAA,31951,8,9,1,109.52174,18.30299,1568
85614,1980C8D409DE9551539224B3D393CDAA,30071,11,13,2,109.52819,18.30472,1619
85615,1980C8D409DE9551539224B3D393CDAA,31951,13,15,2,109.52174,18.30299,1568
85616,1980C8D409DE9551539224B3D393CDAA,30071,15,17,2,109.52819,18.30472,1619
85617,1980C8D409DE9551539224B3D393CDAA,31951,18,19,1,109.52174,18.30299,1568
85618,1980C8D409DE9551539224B3D393CDAA,30071,20,21,1,109.52819,18.30472,1619
85619,1980C8D409DE9551539224B3D393CDAA,31951,22,23,1,109.52174,18.30299,1568
85707,782BCA908252809750EF6B8020D2A86A,30181,2,4,2,109.51597,18.23313,1557
85708,782BCA908252809750EF6B8020D2A86A,31201,5,8,3,109.51042,18.23819,1558
85709,782BCA908252809750EF6B8020D2A86A,31781,10,13,3,109.19847,18.2975,367
85710,782BCA908252809750EF6B8020D2A86A,31471,15,16,1,109.34583,18.29563,917
85711,782BCA908252809750EF6B8020D2A86A,30361,19,21,2,109.50347,18.24,1508
85712,782BCA908252809750EF6B8020D2A86A,31201,21,23,2,109.51042,18.23819,1558
85772,8752BC71725B50257436D50C6598F252,31071,0,7,7,109.58257,18.28458,1815
85773,8752BC71725B50257436D50C6598F252,30854,8,9,1,109.56889,18.27076,1763
85774,8752BC71725B50257436D50C6598F252,31071,12,13,1,109.58257,18.28458,1815
85775,8752BC71725B50257436D50C6598F252,30854,15,21,6,109.56889,18.27076,1763
85783,92E14A6094471B9C1A50CE8585136EC6,30191,0,2,2,109.50361,18.22701,1506
85784,92E14A6094471B9C1A50CE8585136EC6,30151,3,4,1,109.50986,18.25083,1560
85785,92E14A6094471B9C1A50CE8585136EC6,60087,4,16,12,109.50688,18.22299,1505
85786,92E14A6094471B9C1A50CE8585136EC6,30731,19,22,3,109.50944,18.22306,1555
85849,5B1793F390E8BE5126CF433016029F77,60131,0,1,1,109.49819,18.24778,1509
85850,5B1793F390E8BE5126CF433016029F77,31161,2,9,7,109.70229,18.31361,2270
85851,5B1793F390E8BE5126CF433016029F77,60111,10,11,1,109.72556,18.31924,2371
85852,5B1793F390E8BE5126CF433016029F77,60291,13,14,1,109.50826,18.24639,1509
85891,8FE97C1052D63DE830211C405D8F5442,60631,0,6,6,109.57778,18.27583,1814
85892,8FE97C1052D63DE830211C405D8F5442,30851,7,9,2,109.5616,18.27396,1713
85893,8FE97C1052D63DE830211C405D8F5442,30854,9,10,1,109.56889,18.27076,1763
85921,549FEB02FDCB1D950404939A4A6496A0,30921,1,6,5,109.53903,18.29451,1667
85939,6277C6831CAADB3DB04E9A9E196CCA2C,31945,0,2,2,109.58021,18.29403,1817
85940,6277C6831CAADB3DB04E9A9E196CCA2C,31071,2,12,10,109.58257,18.28458,1815
85962,6422CB87ACC55DDEF6EBE8946593C808,31351,0,7,7,109.4959,18.28417,1465
85963,6422CB87ACC55DDEF6EBE8946593C808,30161,12,13,1,109.50042,18.24389,1508
85964,6422CB87ACC55DDEF6EBE8946593C808,38834,13,21,8,109.47639,18.21146,1403
85965,6422CB87ACC55DDEF6EBE8946593C808,31351,22,23,1,109.4959,18.28417,1465
86006,53453D8B736810206EC5A6632D159BE6,31931,0,15,15,109.54771,18.29403,1667
86007,53453D8B736810206EC5A6632D159BE6,30921,18,19,1,109.53903,18.29451,1667
86008,53453D8B736810206EC5A6632D159BE6,31931,20,21,1,109.54771,18.29403,1667
86009,5B52C71F88DF5C7017D89C4E504F495B,31236,0,1,1,109.42965,18.29111,1216
86010,5B52C71F88DF5C7017D89C4E504F495B,60552,1,2,1,109.41729,18.30014,1218
86011,5B52C71F88DF5C7017D89C4E504F495B,60551,3,7,4,109.42722,18.30111,1218
86012,5B52C71F88DF5C7017D89C4E504F495B,31781,11,13,2,109.19847,18.2975,367
86013,5B52C71F88DF5C7017D89C4E504F495B,60054,15,16,1,109.3016,18.31229,770
86014,5B52C71F88DF5C7017D89C4E504F495B,60551,18,20,2,109.42722,18.30111,1218
86015,5B52C71F88DF5C7017D89C4E504F495B,30351,21,23,2,109.41701,18.29292,1217
86054,C1F80FD61770F46AF18F3BEF2B67E7ED,31551,0,7,7,109.55868,18.24222,1708
86055,C1F80FD61770F46AF18F3BEF2B67E7ED,31554,7,8,1,109.55521,18.2459,1709
86056,C1F80FD61770F46AF18F3BEF2B67E7ED,30511,9,13,4,109.51069,18.24208,1558
86057,C1F80FD61770F46AF18F3BEF2B67E7ED,31551,15,22,7,109.55868,18.24222,1708
86144,32D0EBFA645FCE8DAD65D018847E5043,30232,0,6,6,109.6191,18.31701,1971
86145,32D0EBFA645FCE8DAD65D018847E5043,30854,8,10,2,109.56889,18.27076,1763
86146,32D0EBFA645FCE8DAD65D018847E5043,30232,13,14,1,109.6191,18.31701,1971
86156,A3F1A757214C25A449688115E5C4321B,60371,1,2,1,109.53063,18.30056,1618
86157,A3F1A757214C25A449688115E5C4321B,60221,5,6,1,109.52569,18.29188,1616
86158,A3F1A757214C25A449688115E5C4321B,31931,6,17,11,109.54771,18.29403,1667
86166,D12813139FDE232B707FEA7A6291700B,39281,14,15,1,109.21333,18.30271,418
86167,D12813139FDE232B707FEA7A6291700B,30421,16,18,2,109.50021,18.25861,1511
86168,D12813139FDE232B707FEA7A6291700B,31621,19,23,4,109.51035,18.29826,1568
86177,C1DFDFC110B50DFE0D66E47848759FB2,30741,13,15,2,109.49833,18.28681,1516
86178,C1DFDFC110B50DFE0D66E47848759FB2,60381,16,17,1,109.5241,18.22458,1605
86179,C1DFDFC110B50DFE0D66E47848759FB2,39191,18,21,3,109.51493,18.23472,1557
86200,40285EE8CCE25C38988EC087545664EC,31071,0,7,7,109.58257,18.28458,1815
86201,40285EE8CCE25C38988EC087545664EC,30854,7,20,13,109.56889,18.27076,1763
86216,BBE4D8242EE46AE73AD69A56A00F4408,31271,0,6,6,109.48958,18.26257,1462
86217,BBE4D8242EE46AE73AD69A56A00F4408,30201,9,12,3,109.4909,18.26465,1462
86218,BBE4D8242EE46AE73AD69A56A00F4408,31271,16,18,2,109.48958,18.26257,1462
86219,BBE4D8242EE46AE73AD69A56A00F4408,30201,19,20,1,109.4909,18.26465,1462
86220,BBE4D8242EE46AE73AD69A56A00F4408,30201,20,22,2,109.4909,18.26465,1462
86260,567998B0F4E9D4CBDA657DF09C8BFBAD,30084,15,17,2,109.50118,18.26972,1513
86283,C8922FAF66F21ECAECB6B717FCD5A53B,60614,0,16,16,109.48799,18.29521,1467
86284,C8922FAF66F21ECAECB6B717FCD5A53B,60391,16,19,3,109.47667,18.28757,1416
86285,C8922FAF66F21ECAECB6B717FCD5A53B,60614,20,21,1,109.48799,18.29521,1467
86312,8A4DC99751E6013D4EE08DF4252C43C8,38141,5,9,4,109.39479,18.2916,1116
86313,8A4DC99751E6013D4EE08DF4252C43C8,31781,10,13,3,109.19847,18.2975,367
86314,8A4DC99751E6013D4EE08DF4252C43C8,31471,14,15,1,109.34583,18.29563,917
86333,30D8A678A1441E4FFDF2E3F44AE24060,31071,0,6,6,109.58257,18.28458,1815
86334,30D8A678A1441E4FFDF2E3F44AE24060,30854,9,10,1,109.56889,18.27076,1763
86335,30D8A678A1441E4FFDF2E3F44AE24060,31071,14,17,3,109.58257,18.28458,1815
86336,30D8A678A1441E4FFDF2E3F44AE24060,30854,20,22,2,109.56889,18.27076,1763
86355,F09B4ACB705B8CF3054D70A74071C53C,30611,0,9,9,109.74958,18.40188,2485
86356,F09B4ACB705B8CF3054D70A74071C53C,30721,10,11,1,109.51597,18.28257,1565
86357,F09B4ACB705B8CF3054D70A74071C53C,60201,14,16,2,109.5041,18.2509,1510
86358,F09B4ACB705B8CF3054D70A74071C53C,38154,20,23,3,109.5266,18.28278,1615
86405,20912724FD370D4E1BCB1C3E870358AC,30051,0,16,16,109.48917,18.21215,1453
86406,20912724FD370D4E1BCB1C3E870358AC,39191,17,20,3,109.51493,18.23472,1557
86407,20912724FD370D4E1BCB1C3E870358AC,30051,22,23,1,109.48917,18.21215,1453
86430,95471D684DB585D0049B7AB0C8B83123,30771,0,6,6,109.49938,18.26042,1511
86459,BA444E3EED1E8BBD92378A028029977A,60621,15,17,2,109.48354,18.27451,1464
86461,E9E473F09C342630187345312F4A31D8,39181,0,19,19,109.55153,18.28035,1715
86462,E9E473F09C342630187345312F4A31D8,39181,20,23,3,109.55153,18.28035,1715
86464,104AF40065ED94F83A7A7970F3C770A2,31101,8,9,1,109.65389,18.23403,2057
86465,104AF40065ED94F83A7A7970F3C770A2,30581,10,12,2,109.62257,18.24951,1959
86466,104AF40065ED94F83A7A7970F3C770A2,31521,13,16,3,109.51458,18.22542,1555
86467,104AF40065ED94F83A7A7970F3C770A2,30731,17,20,3,109.50944,18.22306,1555
86524,E75CF54BA14775FEDD26504F9F6B7365,31945,0,6,6,109.58021,18.29403,1817
86525,E75CF54BA14775FEDD26504F9F6B7365,31561,6,18,12,109.56792,18.28479,1765
86526,E75CF54BA14775FEDD26504F9F6B7365,30234,20,21,1,109.60681,18.29979,1918
86527,00FC332040A284DA251A8D0705989FE9,31071,0,8,8,109.58257,18.28458,1815
86528,00FC332040A284DA251A8D0705989FE9,30854,8,16,8,109.56889,18.27076,1763
86586,2AE38FAF341950B0B91404FFCE5A0F3E,31931,0,6,6,109.54771,18.29403,1667
86587,2AE38FAF341950B0B91404FFCE5A0F3E,30921,7,17,10,109.53903,18.29451,1667
86600,39F25FE146A03325C93C111F2A943B6C,31945,1,13,12,109.58021,18.29403,1817
86601,39F25FE146A03325C93C111F2A943B6C,31071,18,19,1,109.58257,18.28458,1815
86602,39F25FE146A03325C93C111F2A943B6C,31945,21,23,2,109.58021,18.29403,1817
86700,2C9F9127F2AECFBA8069624790D23C60,30771,19,20,1,109.49938,18.26042,1511
86708,0F91AB88D936BFA1E1D2836B4DAF2D14,30854,0,1,1,109.56889,18.27076,1763
86709,0F91AB88D936BFA1E1D2836B4DAF2D14,30891,1,6,5,109.59431,18.28389,1865
86710,0F91AB88D936BFA1E1D2836B4DAF2D14,30531,8,17,9,109.53271,18.21472,1604
86711,0F91AB88D936BFA1E1D2836B4DAF2D14,30854,19,21,2,109.56889,18.27076,1763
86718,0CD3A9451B945A7EABB5A7155C5317AC,30271,17,19,2,109.49132,18.23153,1456
86719,0CD3A9451B945A7EABB5A7155C5317AC,31231,22,23,1,109.42597,18.29292,1217
86739,EC4B90EDBF35256FDB4D4F8B87DB8A04,30854,18,19,1,109.56889,18.27076,1763
86743,8CD15CF6B5FB4821940FF9AFE6D6CB84,39181,0,1,1,109.55153,18.28035,1715
86744,8CD15CF6B5FB4821940FF9AFE6D6CB84,31931,1,4,3,109.54771,18.29403,1667
86745,8CD15CF6B5FB4821940FF9AFE6D6CB84,39181,6,21,15,109.55153,18.28035,1715
86798,0D69669D4DBC1CEB06269A084D86E853,30854,8,9,1,109.56889,18.27076,1763
86799,0D69669D4DBC1CEB06269A084D86E853,31101,13,20,7,109.65389,18.23403,2057
86814,64A6FE91570DC5F61A373BFD19D6603B,60491,16,17,1,109.43354,18.30847,1269
86815,64A6FE91570DC5F61A373BFD19D6603B,30671,18,22,4,109.43611,18.30139,1268
86887,F613CC88D209D7DC1A4E289F7CE1FEAE,38951,7,17,10,109.48097,18.28868,1416
86888,F613CC88D209D7DC1A4E289F7CE1FEAE,30281,17,19,2,109.50597,18.27583,1514
86889,F613CC88D209D7DC1A4E289F7CE1FEAE,38951,20,23,3,109.48097,18.28868,1416
86908,622234A65D292D040A9E438A2770674C,30851,0,7,7,109.5616,18.27396,1713
86909,622234A65D292D040A9E438A2770674C,31561,7,11,4,109.56792,18.28479,1765
86910,622234A65D292D040A9E438A2770674C,30851,11,14,3,109.5616,18.27396,1713
86911,622234A65D292D040A9E438A2770674C,31561,16,17,1,109.56792,18.28479,1765
86912,622234A65D292D040A9E438A2770674C,30851,18,23,5,109.5616,18.27396,1713
86961,967E548F53382C36FB0D7FF12F6A99E7,31531,0,6,6,109.49583,18.25972,1461
86962,967E548F53382C36FB0D7FF12F6A99E7,30371,8,9,1,109.51,18.24771,1559
86963,967E548F53382C36FB0D7FF12F6A99E7,30771,11,13,2,109.49938,18.26042,1511
86964,967E548F53382C36FB0D7FF12F6A99E7,30771,14,23,9,109.49938,18.26042,1511
86989,27229B6D41BD7CDDDAA38911093865DB,31071,0,4,4,109.58257,18.28458,1815
86990,27229B6D41BD7CDDDAA38911093865DB,38085,5,13,8,109.6291,18.23625,2007
86991,27229B6D41BD7CDDDAA38911093865DB,30854,15,16,1,109.56889,18.27076,1763
86992,27229B6D41BD7CDDDAA38911093865DB,31071,16,17,1,109.58257,18.28458,1815
86993,27229B6D41BD7CDDDAA38911093865DB,30854,19,20,1,109.56889,18.27076,1763
87011,14F1CC63CDA098F9694EAC8584B9C7A5,31561,5,6,1,109.56792,18.28479,1765
87012,14F1CC63CDA098F9694EAC8584B9C7A5,30854,10,16,6,109.56889,18.27076,1763
87020,B16977B88DE920FADD302624AE75E34D,31945,0,5,5,109.58021,18.29403,1817
87021,B16977B88DE920FADD302624AE75E34D,30851,7,11,4,109.5616,18.27396,1713
87022,B16977B88DE920FADD302624AE75E34D,31561,12,14,2,109.56792,18.28479,1765
87023,B16977B88DE920FADD302624AE75E34D,30854,14,15,1,109.56889,18.27076,1763
87024,B16977B88DE920FADD302624AE75E34D,31561,15,17,2,109.56792,18.28479,1765
87025,B16977B88DE920FADD302624AE75E34D,30854,17,18,1,109.56889,18.27076,1763
87026,B16977B88DE920FADD302624AE75E34D,31945,20,23,3,109.58021,18.29403,1817
87109,1D8B814EC83D52D7C5F3FED99C129EE0,30854,2,7,5,109.56889,18.27076,1763
87110,1D8B814EC83D52D7C5F3FED99C129EE0,38271,8,11,3,109.62632,18.23049,1956
87111,1D8B814EC83D52D7C5F3FED99C129EE0,39151,15,16,1,109.49875,18.25097,1510
87112,1D8B814EC83D52D7C5F3FED99C129EE0,38271,20,21,1,109.62632,18.23049,1956
87206,40A0E1FD3CD6EB88C3D6A6AB137FEE15,31431,0,8,8,109.44639,18.29042,1316
87207,40A0E1FD3CD6EB88C3D6A6AB137FEE15,33051,11,12,1,109.6475,18.46618,2096
87208,40A0E1FD3CD6EB88C3D6A6AB137FEE15,31101,14,15,1,109.65389,18.23403,2057
87209,40A0E1FD3CD6EB88C3D6A6AB137FEE15,31431,19,22,3,109.44639,18.29042,1316
87230,3C987E7C80A67E39D0CEFBFF3DF2E11E,60551,0,3,3,109.42722,18.30111,1218
87231,3C987E7C80A67E39D0CEFBFF3DF2E11E,30354,4,7,3,109.42813,18.29076,1216
87232,3C987E7C80A67E39D0CEFBFF3DF2E11E,30351,7,8,1,109.41701,18.29292,1217
87233,3C987E7C80A67E39D0CEFBFF3DF2E11E,31781,11,13,2,109.19847,18.2975,367
87234,3C987E7C80A67E39D0CEFBFF3DF2E11E,31471,14,16,2,109.34583,18.29563,917
87235,3C987E7C80A67E39D0CEFBFF3DF2E11E,60551,18,22,4,109.42722,18.30111,1218
87270,2D115D52FDAB55086A12D742071FDFC9,30232,0,1,1,109.6191,18.31701,1971
87271,2D115D52FDAB55086A12D742071FDFC9,30854,3,22,19,109.56889,18.27076,1763
87275,4C15740C85B7C75F2E990BCFA0AEA625,60524,2,5,3,109.42951,18.28993,1216
87276,4C15740C85B7C75F2E990BCFA0AEA625,60401,7,8,1,109.47444,18.27583,1414
87277,4C15740C85B7C75F2E990BCFA0AEA625,31031,8,14,6,109.49979,18.25382,1510
87278,4C15740C85B7C75F2E990BCFA0AEA625,60401,14,17,3,109.47444,18.27583,1414
87279,4C15740C85B7C75F2E990BCFA0AEA625,38251,18,19,1,109.49618,18.25493,1510
87280,4C15740C85B7C75F2E990BCFA0AEA625,60131,19,20,1,109.49819,18.24778,1509
87281,4C15740C85B7C75F2E990BCFA0AEA625,31031,20,23,3,109.49979,18.25382,1510
87338,2F64FEF19C86AA0A8AA3E3FA37CC4F2D,30854,1,5,4,109.56889,18.27076,1763
87339,2F64FEF19C86AA0A8AA3E3FA37CC4F2D,60631,8,10,2,109.57778,18.27583,1814
87340,2F64FEF19C86AA0A8AA3E3FA37CC4F2D,30854,10,23,13,109.56889,18.27076,1763
87349,AB43182259122294244C13D6FC66D4A1,30891,0,6,6,109.59431,18.28389,1865
87350,AB43182259122294244C13D6FC66D4A1,31561,10,16,6,109.56792,18.28479,1765
87351,AB43182259122294244C13D6FC66D4A1,60631,21,23,2,109.57778,18.27583,1814
87363,23019CE071DC0B0CEC6E78ADA422CE57,31461,0,10,10,109.5091,18.25389,1510
87365,23019CE071DC0B0CEC6E78ADA422CE57,38973,21,23,2,109.51097,18.25389,1560
87370,036DFEF8CA623F9034F928149FE2468D,30821,2,3,1,109.43681,18.33639,1274
87371,036DFEF8CA623F9034F928149FE2468D,30651,6,9,3,109.42611,18.385,1232
87372,036DFEF8CA623F9034F928149FE2468D,30821,12,16,4,109.43681,18.33639,1274
87373,036DFEF8CA623F9034F928149FE2468D,60011,18,19,1,109.48965,18.30222,1468
87374,036DFEF8CA623F9034F928149FE2468D,30821,22,23,1,109.43681,18.33639,1274
87412,F8D799D9161B0143E0D71C40472A357E,30071,0,15,15,109.52819,18.30472,1619
87413,F8D799D9161B0143E0D71C40472A357E,60371,15,16,1,109.53063,18.30056,1618
87414,F8D799D9161B0143E0D71C40472A357E,30071,17,23,6,109.52819,18.30472,1619
87427,5EE25A6E7DD554FFDA0C9C1A504114B7,38127,18,19,1,109.50833,18.27222,1513
87428,5EE25A6E7DD554FFDA0C9C1A504114B7,30221,20,22,2,109.57833,18.20222,1802
87433,C0CA4E58B15F58D7F48B8BEF10CEB35A,30891,0,5,5,109.59431,18.28389,1865
87434,C0CA4E58B15F58D7F48B8BEF10CEB35A,60591,10,17,7,109.61118,18.21715,1904
87435,E7DB0F55EDE33BB4C08C98B80B7173BF,30071,15,16,1,109.52819,18.30472,1619
87436,E7DB0F55EDE33BB4C08C98B80B7173BF,60371,18,22,4,109.53063,18.30056,1618
87437,7BF65E5054DA81A230AB5423620158E1,60631,1,6,5,109.57778,18.27583,1814
87438,7BF65E5054DA81A230AB5423620158E1,30854,10,15,5,109.56889,18.27076,1763
87439,7BF65E5054DA81A230AB5423620158E1,31071,19,20,1,109.58257,18.28458,1815
87440,7BF65E5054DA81A230AB5423620158E1,30191,21,23,2,109.50361,18.22701,1506
87449,D8757A808F606352AF3AC0BD9CD2C12A,31071,0,5,5,109.58257,18.28458,1815
87450,D8757A808F606352AF3AC0BD9CD2C12A,30854,8,9,1,109.56889,18.27076,1763
87451,D8757A808F606352AF3AC0BD9CD2C12A,30671,13,14,1,109.43611,18.30139,1268
87452,D8757A808F606352AF3AC0BD9CD2C12A,60491,15,16,1,109.43354,18.30847,1269
87453,D8757A808F606352AF3AC0BD9CD2C12A,30671,17,19,2,109.43611,18.30139,1268
87454,D8757A808F606352AF3AC0BD9CD2C12A,60491,21,22,1,109.43354,18.30847,1269
87467,C58D0182BFC61ED113EE3B09763C30B2,38185,0,7,7,109.51333,18.27347,1563
87468,C58D0182BFC61ED113EE3B09763C30B2,38127,8,9,1,109.50833,18.27222,1513
87469,C58D0182BFC61ED113EE3B09763C30B2,31931,10,11,1,109.54771,18.29403,1667
87470,C58D0182BFC61ED113EE3B09763C30B2,38127,13,18,5,109.50833,18.27222,1513
87471,C58D0182BFC61ED113EE3B09763C30B2,38185,20,22,2,109.51333,18.27347,1563
87489,B432C0186449A28ED200760F76E06147,31471,14,17,3,109.34583,18.29563,917
87490,B432C0186449A28ED200760F76E06147,60524,18,23,5,109.42951,18.28993,1216
87516,079A114D194FE2EFB0C89059CA4EBC03,31251,1,7,6,109.18528,18.2975,317
87518,079A114D194FE2EFB0C89059CA4EBC03,31251,21,23,2,109.18528,18.2975,317
87587,52A7280BA3A0FD171DDC8618F647763C,60084,0,1,1,109.4984,18.2334,1507
87588,52A7280BA3A0FD171DDC8618F647763C,30271,1,2,1,109.49132,18.23153,1456
87589,52A7280BA3A0FD171DDC8618F647763C,60084,3,5,2,109.4984,18.2334,1507
87590,52A7280BA3A0FD171DDC8618F647763C,31781,9,12,3,109.19847,18.2975,367
87591,52A7280BA3A0FD171DDC8618F647763C,60084,13,15,2,109.4984,18.2334,1507
87592,52A7280BA3A0FD171DDC8618F647763C,30271,17,18,1,109.49132,18.23153,1456
87597,2D70A5EC3C783EDF55DB2CDF82B883C4,38052,1,9,8,109.62618,18.23042,1956
87598,2D70A5EC3C783EDF55DB2CDF82B883C4,38052,11,15,4,109.62618,18.23042,1956
87599,2D70A5EC3C783EDF55DB2CDF82B883C4,38275,20,23,3,109.62875,18.22938,2006
87610,E649CF84A26278291AA1A5B5C5D01FCA,31561,3,4,1,109.56792,18.28479,1765
87611,E649CF84A26278291AA1A5B5C5D01FCA,30854,8,9,1,109.56889,18.27076,1763
87612,E649CF84A26278291AA1A5B5C5D01FCA,31071,9,11,2,109.58257,18.28458,1815
87613,E649CF84A26278291AA1A5B5C5D01FCA,30854,13,14,1,109.56889,18.27076,1763
87614,E649CF84A26278291AA1A5B5C5D01FCA,30161,17,20,3,109.50042,18.24389,1508
87636,C6C3BC01E542B810EF853FEEB6C81198,60361,4,13,9,109.51938,18.29681,1567
87637,C6C3BC01E542B810EF853FEEB6C81198,60221,13,14,1,109.52569,18.29188,1616
87638,C6C3BC01E542B810EF853FEEB6C81198,60361,15,16,1,109.51938,18.29681,1567
87639,C6C3BC01E542B810EF853FEEB6C81198,31561,19,22,3,109.56792,18.28479,1765
87666,6C0260646767B781577B5B8CE2471E51,38484,0,8,8,109.53028,18.31528,1620
87667,6C0260646767B781577B5B8CE2471E51,38484,9,11,2,109.53028,18.31528,1620
87668,6C0260646767B781577B5B8CE2471E51,38484,13,16,3,109.53028,18.31528,1620
87669,6C0260646767B781577B5B8CE2471E51,30071,19,21,2,109.52819,18.30472,1619
87670,6C0260646767B781577B5B8CE2471E51,31951,21,22,1,109.52174,18.30299,1568
87674,67C2E924C3DAE66F90EC1C8F2F79B902,31531,0,9,9,109.49583,18.25972,1461
87675,67C2E924C3DAE66F90EC1C8F2F79B902,60054,11,12,1,109.3016,18.31229,770
87676,67C2E924C3DAE66F90EC1C8F2F79B902,31471,12,13,1,109.34583,18.29563,917
87677,67C2E924C3DAE66F90EC1C8F2F79B902,60161,17,19,2,109.49174,18.26181,1461
87678,67C2E924C3DAE66F90EC1C8F2F79B902,31531,21,23,2,109.49583,18.25972,1461
87696,8F6EA1C108FADA76A214A7ED71ECE3D1,30851,0,4,4,109.5616,18.27396,1713
87697,8F6EA1C108FADA76A214A7ED71ECE3D1,30854,6,17,11,109.56889,18.27076,1763
87698,8F6EA1C108FADA76A214A7ED71ECE3D1,30232,20,22,2,109.6191,18.31701,1971
87699,BE24D518A0B386C325D30CFE9CBEF7B9,30891,4,7,3,109.59431,18.28389,1865
87700,BE24D518A0B386C325D30CFE9CBEF7B9,61011,9,12,3,109.60653,18.19076,1900
87702,BE24D518A0B386C325D30CFE9CBEF7B9,30232,19,23,4,109.6191,18.31701,1971
87711,A1C95B17C868D553635D99A0D1B2A324,39041,13,21,8,109.40021,18.29278,1117
87731,7409CD873716B8BE8EEC7DA694433A5F,60641,0,1,1,109.53854,18.2359,1657
87732,7409CD873716B8BE8EEC7DA694433A5F,30861,2,6,4,109.52722,18.22743,1606
87760,8DEBA8F3DD446F0F0680296AB7E73431,30764,1,2,1,109.45806,18.29486,1367
87761,8DEBA8F3DD446F0F0680296AB7E73431,60472,6,8,2,109.46625,18.29542,1367
87762,8DEBA8F3DD446F0F0680296AB7E73431,30111,9,11,2,109.47583,18.30542,1419
87763,8DEBA8F3DD446F0F0680296AB7E73431,60472,15,17,2,109.46625,18.29542,1367
87764,8039EB5AFB4AD782481BED6ABCE4707B,31201,0,8,8,109.51042,18.23819,1558
87765,8039EB5AFB4AD782481BED6ABCE4707B,31781,10,13,3,109.19847,18.2975,367
87766,8039EB5AFB4AD782481BED6ABCE4707B,60054,15,16,1,109.3016,18.31229,770
87767,8039EB5AFB4AD782481BED6ABCE4707B,30361,20,21,1,109.50347,18.24,1508
87768,8039EB5AFB4AD782481BED6ABCE4707B,31206,22,23,1,109.50819,18.23549,1507
87804,CFFDD1BF3134B9FDD71614F40E1DE0FD,31071,4,9,5,109.58257,18.28458,1815
87805,CFFDD1BF3134B9FDD71614F40E1DE0FD,60631,12,14,2,109.57778,18.27583,1814
87806,CFFDD1BF3134B9FDD71614F40E1DE0FD,31071,14,20,6,109.58257,18.28458,1815
87822,1A267E022EDC4D8D9AD3710AD25160F4,60391,4,5,1,109.47667,18.28757,1416
87823,1A267E022EDC4D8D9AD3710AD25160F4,60391,6,8,2,109.47667,18.28757,1416
87824,1A267E022EDC4D8D9AD3710AD25160F4,31471,10,11,1,109.34583,18.29563,917
87825,8AABF5FDF2B06EB445749240A3894969,31071,0,8,8,109.58257,18.28458,1815
87826,8AABF5FDF2B06EB445749240A3894969,30854,8,16,8,109.56889,18.27076,1763
87827,8AABF5FDF2B06EB445749240A3894969,31851,16,17,1,109.71736,18.29007,2316
87828,8AABF5FDF2B06EB445749240A3894969,31071,18,20,2,109.58257,18.28458,1815
87882,FE95B3A32EFBC2838F293DF38F55FDD1,39183,3,4,1,109.55542,18.28208,1715
87883,FE95B3A32EFBC2838F293DF38F55FDD1,31561,5,7,2,109.56792,18.28479,1765
87922,E8BAAF476E8FE57075BAB1A8D4FF1780,30232,1,6,5,109.6191,18.31701,1971
87923,E8BAAF476E8FE57075BAB1A8D4FF1780,30854,8,17,9,109.56889,18.27076,1763
87924,E8BAAF476E8FE57075BAB1A8D4FF1780,60381,19,20,1,109.5241,18.22458,1605
87925,E8BAAF476E8FE57075BAB1A8D4FF1780,30232,21,22,1,109.6191,18.31701,1971
87978,7C16827D646BDC874DE2BD7EE32189C5,30854,1,11,10,109.56889,18.27076,1763
87979,7C16827D646BDC874DE2BD7EE32189C5,60631,12,21,9,109.57778,18.27583,1814
88028,02B6B5412B758335455F3642E59B11F1,38951,0,8,8,109.48097,18.28868,1416
88029,02B6B5412B758335455F3642E59B11F1,38754,12,13,1,109.74667,18.37382,2430
88030,02B6B5412B758335455F3642E59B11F1,38951,15,19,4,109.48097,18.28868,1416
88031,02B6B5412B758335455F3642E59B11F1,38071,21,22,1,109.40722,18.30938,1169
88041,BDA2B6FCF35F47A82B74AE9C94731204,38054,0,9,9,109.63479,18.23097,2006
88042,BDA2B6FCF35F47A82B74AE9C94731204,31471,11,12,1,109.34583,18.29563,917
88043,BDA2B6FCF35F47A82B74AE9C94731204,60411,14,15,1,109.32514,18.30854,869
88044,BDA2B6FCF35F47A82B74AE9C94731204,31781,16,17,1,109.19847,18.2975,367
88045,BDA2B6FCF35F47A82B74AE9C94731204,38054,21,23,2,109.63479,18.23097,2006
88079,9EA825CA50A62195A51752F975FDCF57,31071,3,7,4,109.58257,18.28458,1815
88080,9EA825CA50A62195A51752F975FDCF57,30854,8,23,15,109.56889,18.27076,1763
88093,89C2F48F3C187B81197D45E0E1289EA8,31571,10,11,1,109.61563,18.23326,1957
88094,89C2F48F3C187B81197D45E0E1289EA8,30581,11,12,1,109.62257,18.24951,1959
88095,89C2F48F3C187B81197D45E0E1289EA8,31571,13,14,1,109.61563,18.23326,1957
88097,3559FC617E0C604C72AAF44A4C6A495C,31321,12,18,6,109.63799,18.23201,2007
88098,3559FC617E0C604C72AAF44A4C6A495C,31041,20,21,1,109.50278,18.23701,1507
88117,9B979E9430BCD0DDB6C78BBE525EBD2D,60631,3,6,3,109.57778,18.27583,1814
88118,9B979E9430BCD0DDB6C78BBE525EBD2D,30854,8,22,14,109.56889,18.27076,1763
88121,E4C7AB656E412C7E33554D18277C9478,60291,0,15,15,109.50826,18.24639,1509
88122,E4C7AB656E412C7E33554D18277C9478,30151,17,20,3,109.50986,18.25083,1560
88123,E4C7AB656E412C7E33554D18277C9478,31461,21,22,1,109.5091,18.25389,1510
88138,C1793DCC823463513E28F999E76F9ADC,60054,0,6,6,109.3016,18.31229,770
88139,C1793DCC823463513E28F999E76F9ADC,31471,7,9,2,109.34583,18.29563,917
88140,C1793DCC823463513E28F999E76F9ADC,60054,10,13,3,109.3016,18.31229,770
88141,C1793DCC823463513E28F999E76F9ADC,60661,16,19,3,109.548,18.2377,1657
88142,C1793DCC823463513E28F999E76F9ADC,60054,21,23,2,109.3016,18.31229,770
88164,9D84057972B69A5E23018ED19BFE5178,31231,13,16,3,109.42597,18.29292,1217
88165,9D84057972B69A5E23018ED19BFE5178,31231,17,23,6,109.42597,18.29292,1217
88240,1B6EBBFF3B9D8A3E18753343B6A29EAE,31071,0,6,6,109.58257,18.28458,1815
88241,1B6EBBFF3B9D8A3E18753343B6A29EAE,30851,8,11,3,109.5616,18.27396,1713
88242,1B6EBBFF3B9D8A3E18753343B6A29EAE,31071,12,14,2,109.58257,18.28458,1815
88243,1B6EBBFF3B9D8A3E18753343B6A29EAE,31561,14,15,1,109.56792,18.28479,1765
88244,1B6EBBFF3B9D8A3E18753343B6A29EAE,30851,15,17,2,109.5616,18.27396,1713
88245,1B6EBBFF3B9D8A3E18753343B6A29EAE,31071,19,23,4,109.58257,18.28458,1815
88269,02C53C5746E38501957FE72E2C83CCA4,60231,0,1,1,109.49903,18.21972,1504
88270,02C53C5746E38501957FE72E2C83CCA4,38251,3,4,1,109.49618,18.25493,1510
88271,02C53C5746E38501957FE72E2C83CCA4,60231,9,21,12,109.49903,18.21972,1504
88326,4D4289AE0DFBF4B5C79A47559DC2EBDD,30854,1,8,7,109.56889,18.27076,1763
88327,4D4289AE0DFBF4B5C79A47559DC2EBDD,31071,8,9,1,109.58257,18.28458,1815
88328,4D4289AE0DFBF4B5C79A47559DC2EBDD,30854,10,19,9,109.56889,18.27076,1763
88340,59F29435D748531F416A4F1636997ECF,31945,0,2,2,109.58021,18.29403,1817
88341,59F29435D748531F416A4F1636997ECF,31071,2,7,5,109.58257,18.28458,1815
88342,59F29435D748531F416A4F1636997ECF,30854,7,8,1,109.56889,18.27076,1763
88346,68DBE0B52FD0AB95F1DD47068FD7847F,60311,0,7,7,109.52097,18.24319,1558
88347,68DBE0B52FD0AB95F1DD47068FD7847F,30181,10,11,1,109.51597,18.23313,1557
88348,68DBE0B52FD0AB95F1DD47068FD7847F,31031,16,19,3,109.49979,18.25382,1510
88349,68DBE0B52FD0AB95F1DD47068FD7847F,30181,19,23,4,109.51597,18.23313,1557
88357,9955D8331F1866B4F8C7C7981EBD1A88,31206,1,14,13,109.50819,18.23549,1507
88358,9955D8331F1866B4F8C7C7981EBD1A88,60381,15,16,1,109.5241,18.22458,1605
88359,9955D8331F1866B4F8C7C7981EBD1A88,31206,17,22,5,109.50819,18.23549,1507
88371,74206C862E4BA6236E7F7978D63D1D7D,30191,0,1,1,109.50361,18.22701,1506
88372,74206C862E4BA6236E7F7978D63D1D7D,60631,3,7,4,109.57778,18.27583,1814
88373,74206C862E4BA6236E7F7978D63D1D7D,30854,9,12,3,109.56889,18.27076,1763
88374,74206C862E4BA6236E7F7978D63D1D7D,60631,14,15,1,109.57778,18.27583,1814
88404,2D8DAA5F24A7C71335ED6C7E0756CEA1,60241,16,18,2,109.53319,18.28667,1616
88405,2D8DAA5F24A7C71335ED6C7E0756CEA1,60131,20,22,2,109.49819,18.24778,1509
88408,E8DB631088E68D5FF25F35789654CC79,30581,0,10,10,109.62257,18.24951,1959
88409,E8DB631088E68D5FF25F35789654CC79,38336,11,16,5,109.61111,18.21806,1904
88450,55CDDB1A84A2F40D42C80C17393C28FB,38951,0,2,2,109.48097,18.28868,1416
88451,55CDDB1A84A2F40D42C80C17393C28FB,60472,4,14,10,109.46625,18.29542,1367
88452,55CDDB1A84A2F40D42C80C17393C28FB,38951,18,23,5,109.48097,18.28868,1416
88479,2193DBFF071303BC78357ADF9D951389,30854,4,8,4,109.56889,18.27076,1763
88480,2193DBFF071303BC78357ADF9D951389,33051,12,14,2,109.6475,18.46618,2096
88481,2193DBFF071303BC78357ADF9D951389,31031,18,21,3,109.49979,18.25382,1510
88482,2193DBFF071303BC78357ADF9D951389,60631,22,23,1,109.57778,18.27583,1814
88509,CF1922E57BC1E2D5DC4336E820C48B77,31471,2,8,6,109.34583,18.29563,917
88510,CF1922E57BC1E2D5DC4336E820C48B77,60411,11,22,11,109.32514,18.30854,869
88511,CF1922E57BC1E2D5DC4336E820C48B77,30661,22,23,1,109.37028,18.24361,1008
88516,066CC6CBB5ADF978A93AF5D0C3292806,30321,13,14,1,109.49563,18.29611,1467
88517,066CC6CBB5ADF978A93AF5D0C3292806,31931,18,23,5,109.54771,18.29403,1667
88522,26F72B0B992AAD04E729F6A1E4F85ECE,60381,19,21,2,109.5241,18.22458,1605
88523,26F72B0B992AAD04E729F6A1E4F85ECE,38241,22,23,1,109.54111,18.30542,1669
88560,10B66D855AEA437CF12F1E3706E70AE7,60291,0,9,9,109.50826,18.24639,1509
88561,10B66D855AEA437CF12F1E3706E70AE7,31471,12,14,2,109.34583,18.29563,917
88562,10B66D855AEA437CF12F1E3706E70AE7,31521,17,19,2,109.51458,18.22542,1555
88648,90D91A493F9482486DCC3B27CF3F61EE,31071,15,17,2,109.58257,18.28458,1815
88649,90D91A493F9482486DCC3B27CF3F61EE,30854,18,20,2,109.56889,18.27076,1763
88650,90D91A493F9482486DCC3B27CF3F61EE,31071,20,22,2,109.58257,18.28458,1815
88666,7C68E1F4B8B2F3CBBD5427BF66BF9C2E,39191,14,16,2,109.51493,18.23472,1557
88667,7C68E1F4B8B2F3CBBD5427BF66BF9C2E,31571,20,22,2,109.61563,18.23326,1957
88700,B02D7A3F297B377D646E0F85B7C19006,61011,0,3,3,109.60653,18.19076,1900
88702,B02D7A3F297B377D646E0F85B7C19006,61011,12,23,11,109.60653,18.19076,1900
88712,246EF4D95FA494895EFB2D649512DAE7,60081,0,6,6,109.51097,18.22639,1556
88714,246EF4D95FA494895EFB2D649512DAE7,60081,21,23,2,109.51097,18.22639,1556
88734,ADF0A7CED2B8DFD757D8FCA8B507C37E,30854,15,16,1,109.56889,18.27076,1763
88735,ADF0A7CED2B8DFD757D8FCA8B507C37E,38283,19,20,1,109.62229,18.22618,1956
88736,F941446F9B0207C03AB7C20D9AC6A7F4,31931,6,15,9,109.54771,18.29403,1667
88737,F941446F9B0207C03AB7C20D9AC6A7F4,60361,19,20,1,109.51938,18.29681,1567
88738,F941446F9B0207C03AB7C20D9AC6A7F4,31931,21,23,2,109.54771,18.29403,1667
88739,DD8DCE806AFFEAC5D779812E5F8F2B3D,31561,7,10,3,109.56792,18.28479,1765
88740,DD8DCE806AFFEAC5D779812E5F8F2B3D,31071,11,12,1,109.58257,18.28458,1815
88741,DD8DCE806AFFEAC5D779812E5F8F2B3D,31561,12,15,3,109.56792,18.28479,1765
88784,19F803FB996471824A8A9928BBFAB433,31931,14,17,3,109.54771,18.29403,1667
88785,19F803FB996471824A8A9928BBFAB433,39181,20,22,2,109.55153,18.28035,1715
88788,E6546ADDD2155B08063BE71A9EAB8C5E,31031,11,13,2,109.49979,18.25382,1510
88789,E6546ADDD2155B08063BE71A9EAB8C5E,38071,14,16,2,109.40722,18.30938,1169
88790,E6546ADDD2155B08063BE71A9EAB8C5E,38251,17,19,2,109.49618,18.25493,1510
88791,E6546ADDD2155B08063BE71A9EAB8C5E,60401,20,23,3,109.47444,18.27583,1414
88828,77414D14BE59EC89504916C6ECC18D2C,38251,13,16,3,109.49618,18.25493,1510
88829,77414D14BE59EC89504916C6ECC18D2C,60331,18,20,2,109.505,18.26507,1512
88870,B5232BF64D4E4122D35EC2DC26B51D2A,38052,17,18,1,109.62618,18.23042,1956
88871,B5232BF64D4E4122D35EC2DC26B51D2A,30441,19,21,2,109.64021,18.25424,2010
88872,B5232BF64D4E4122D35EC2DC26B51D2A,60594,21,23,2,109.62694,18.22799,1956
88884,B023927CBEC0A8053CBDF64A5B76E367,30051,0,6,6,109.48917,18.21215,1453
88885,B023927CBEC0A8053CBDF64A5B76E367,31931,9,10,1,109.54771,18.29403,1667
88886,B023927CBEC0A8053CBDF64A5B76E367,30921,11,12,1,109.53903,18.29451,1667
88887,B023927CBEC0A8053CBDF64A5B76E367,31931,14,15,1,109.54771,18.29403,1667
88926,F95E8C48F26FEDEBE2F61D5B3778D40A,38541,0,10,10,109.73715,18.34875,2426
88927,F95E8C48F26FEDEBE2F61D5B3778D40A,30421,13,15,2,109.50021,18.25861,1511
88928,F95E8C48F26FEDEBE2F61D5B3778D40A,30711,19,22,3,109.50271,18.25347,1510
88960,45FA8AF959A216E06C82392E21728E7F,31561,2,16,14,109.56792,18.28479,1765
88961,45FA8AF959A216E06C82392E21728E7F,39183,20,21,1,109.55542,18.28208,1715
88968,13104A6A71A054F852B52BB76993ADB2,30854,0,6,6,109.56889,18.27076,1763
88969,13104A6A71A054F852B52BB76993ADB2,30851,6,9,3,109.5616,18.27396,1713
88970,13104A6A71A054F852B52BB76993ADB2,30854,9,13,4,109.56889,18.27076,1763
88971,13104A6A71A054F852B52BB76993ADB2,30851,13,17,4,109.5616,18.27396,1713
88983,B172E1B17A92EA23226EC822FB6F7B82,39191,0,8,8,109.51493,18.23472,1557
88984,B172E1B17A92EA23226EC822FB6F7B82,31561,9,11,2,109.56792,18.28479,1765
88985,B172E1B17A92EA23226EC822FB6F7B82,30181,12,15,3,109.51597,18.23313,1557
88986,B172E1B17A92EA23226EC822FB6F7B82,60131,18,19,1,109.49819,18.24778,1509
88987,B172E1B17A92EA23226EC822FB6F7B82,39191,21,23,2,109.51493,18.23472,1557
89001,FF8CB3D02361FAEBFE418108180099D8,30421,1,5,4,109.50021,18.25861,1511
89002,FF8CB3D02361FAEBFE418108180099D8,60201,6,7,1,109.5041,18.2509,1510
89003,FF8CB3D02361FAEBFE418108180099D8,31261,9,12,3,109.51174,18.2466,1559
89004,FF8CB3D02361FAEBFE418108180099D8,60201,13,14,1,109.5041,18.2509,1510
89005,FF8CB3D02361FAEBFE418108180099D8,30711,15,22,7,109.50271,18.25347,1510
89016,D4EE8E1A4C04A1FF0596E4221D0B8B42,30854,13,15,2,109.56889,18.27076,1763
89017,D4EE8E1A4C04A1FF0596E4221D0B8B42,31071,15,17,2,109.58257,18.28458,1815
89018,D4EE8E1A4C04A1FF0596E4221D0B8B42,30854,20,22,2,109.56889,18.27076,1763
89056,5A888DC7A3AA300CC584D9862C5384A1,60221,0,3,3,109.52569,18.29188,1616
89057,5A888DC7A3AA300CC584D9862C5384A1,30721,3,5,2,109.51597,18.28257,1565
89058,5A888DC7A3AA300CC584D9862C5384A1,31931,8,10,2,109.54771,18.29403,1667
89059,5A888DC7A3AA300CC584D9862C5384A1,39183,12,13,1,109.55542,18.28208,1715
89083,875F4B80762D0E664890361D764F907D,60081,0,7,7,109.51097,18.22639,1556
89084,875F4B80762D0E664890361D764F907D,30571,7,18,11,109.50243,18.21861,1504
89085,875F4B80762D0E664890361D764F907D,60081,19,23,4,109.51097,18.22639,1556
89145,28FD729A56A38491CC99ABB23711BC1C,39181,0,4,4,109.55153,18.28035,1715
89146,28FD729A56A38491CC99ABB23711BC1C,31931,7,8,1,109.54771,18.29403,1667
89147,28FD729A56A38491CC99ABB23711BC1C,39181,10,13,3,109.55153,18.28035,1715
89244,FD741240540EA611084A00540F097CB4,30854,0,8,8,109.56889,18.27076,1763
89245,FD741240540EA611084A00540F097CB4,31431,10,11,1,109.44639,18.29042,1316
89246,FD741240540EA611084A00540F097CB4,30854,13,22,9,109.56889,18.27076,1763
89262,47DB633DCEAA585A5A9E2D686518C9D0,38171,0,7,7,109.50799,18.28139,1515
89263,47DB633DCEAA585A5A9E2D686518C9D0,30851,9,12,3,109.5616,18.27396,1713
89264,47DB633DCEAA585A5A9E2D686518C9D0,30854,14,23,9,109.56889,18.27076,1763
89276,6D1A5174B0679D14F4183CE4A66812B9,31071,0,8,8,109.58257,18.28458,1815
89277,6D1A5174B0679D14F4183CE4A66812B9,30854,11,12,1,109.56889,18.27076,1763
89278,6D1A5174B0679D14F4183CE4A66812B9,31071,12,15,3,109.58257,18.28458,1815
89292,C17F2EF1DEA79C8C951E3013EE071B2C,31071,16,17,1,109.58257,18.28458,1815
89293,C17F2EF1DEA79C8C951E3013EE071B2C,30854,20,22,2,109.56889,18.27076,1763
89313,8E244E94833DBF281BCBFE2F4A36E102,60641,0,9,9,109.53854,18.2359,1657
89314,8E244E94833DBF281BCBFE2F4A36E102,30861,12,13,1,109.52722,18.22743,1606
89315,8E244E94833DBF281BCBFE2F4A36E102,60641,14,23,9,109.53854,18.2359,1657
89318,80F0DD5FB175B0969C97D8701F196498,38251,0,12,12,109.49618,18.25493,1510
89319,80F0DD5FB175B0969C97D8701F196498,30854,14,15,1,109.56889,18.27076,1763
89320,80F0DD5FB175B0969C97D8701F196498,31071,18,19,1,109.58257,18.28458,1815
89321,9324CC6DBC2BEA36F562F7A9DE6CA338,31521,0,5,5,109.51458,18.22542,1555
89322,9324CC6DBC2BEA36F562F7A9DE6CA338,30221,5,6,1,109.57833,18.20222,1802
89323,9324CC6DBC2BEA36F562F7A9DE6CA338,31521,7,9,2,109.51458,18.22542,1555
89324,9324CC6DBC2BEA36F562F7A9DE6CA338,31561,10,12,2,109.56792,18.28479,1765
89325,9324CC6DBC2BEA36F562F7A9DE6CA338,31521,13,17,4,109.51458,18.22542,1555
89326,9324CC6DBC2BEA36F562F7A9DE6CA338,60221,17,21,4,109.52569,18.29188,1616
89327,9324CC6DBC2BEA36F562F7A9DE6CA338,31521,21,23,2,109.51458,18.22542,1555
89328,B16A2ACE703D283A7DD000484B3D1777,30421,0,12,12,109.50021,18.25861,1511
89329,B16A2ACE703D283A7DD000484B3D1777,31031,15,17,2,109.49979,18.25382,1510
89333,17D13F6A66037B54FAB5668CDC734401,30721,0,8,8,109.51597,18.28257,1565
89334,17D13F6A66037B54FAB5668CDC734401,31931,9,10,1,109.54771,18.29403,1667
89335,17D13F6A66037B54FAB5668CDC734401,30071,14,16,2,109.52819,18.30472,1619
89336,17D13F6A66037B54FAB5668CDC734401,31931,16,18,2,109.54771,18.29403,1667
89337,17D13F6A66037B54FAB5668CDC734401,30721,19,23,4,109.51597,18.28257,1565
89432,C358285726113434A30FBBA8DED710E7,31621,17,18,1,109.51035,18.29826,1568
89433,C358285726113434A30FBBA8DED710E7,30281,19,20,1,109.50597,18.27583,1514
89503,24E98C0EC4A6054CC486A2611C493128,33051,13,15,2,109.6475,18.46618,2096
89504,24E98C0EC4A6054CC486A2611C493128,31071,16,18,2,109.58257,18.28458,1815
89505,24E98C0EC4A6054CC486A2611C493128,30891,19,20,1,109.59431,18.28389,1865
89510,1A55CEB18A726CCE74CF0F2DC867FF78,60501,18,20,2,109.48701,18.29021,1466
89511,1A55CEB18A726CCE74CF0F2DC867FF78,31864,21,23,2,109.49014,18.28333,1465
89512,8621CFDF1B89A83351494618C53D033F,31071,0,5,5,109.58257,18.28458,1815
89513,8621CFDF1B89A83351494618C53D033F,39181,10,22,12,109.55153,18.28035,1715
89581,22B987DE38F8C4435934FE5E6190C4A2,30581,19,20,1,109.62257,18.24951,1959
89582,22B987DE38F8C4435934FE5E6190C4A2,31571,20,22,2,109.61563,18.23326,1957
89583,BE7763F8096EB5A037146E1CC4190538,30854,1,6,5,109.56889,18.27076,1763
89584,BE7763F8096EB5A037146E1CC4190538,39181,7,8,1,109.55153,18.28035,1715
89585,BE7763F8096EB5A037146E1CC4190538,39183,9,10,1,109.55542,18.28208,1715
89586,BE7763F8096EB5A037146E1CC4190538,31561,11,12,1,109.56792,18.28479,1765
89587,BE7763F8096EB5A037146E1CC4190538,39181,15,17,2,109.55153,18.28035,1715
89588,BE7763F8096EB5A037146E1CC4190538,31071,19,20,1,109.58257,18.28458,1815
89607,B76381FBDC68F2B2041DDEC63195F0A7,31931,0,4,4,109.54771,18.29403,1667
89608,B76381FBDC68F2B2041DDEC63195F0A7,39181,8,23,15,109.55153,18.28035,1715
89611,D44F04C671F28AD094462A9D39B67104,60614,0,8,8,109.48799,18.29521,1467
89612,D44F04C671F28AD094462A9D39B67104,30971,9,10,1,109.48708,18.29319,1467
89662,77EAFDBAF8DB65CFFFD8A9494D2F080D,30761,0,15,15,109.45201,18.3,1318
89663,77EAFDBAF8DB65CFFFD8A9494D2F080D,31081,18,20,2,109.44639,18.30181,1318
89664,77EAFDBAF8DB65CFFFD8A9494D2F080D,30761,21,23,2,109.45201,18.3,1318
89699,F3E280D806C0279BCC08880D6A71DAC7,30861,17,18,1,109.52722,18.22743,1606
89700,F3E280D806C0279BCC08880D6A71DAC7,31031,20,21,1,109.49979,18.25382,1510
89701,F3E280D806C0279BCC08880D6A71DAC7,31261,21,23,2,109.51174,18.2466,1559
89720,EB316856896788EC8FD871E122E95728,60361,0,5,5,109.51938,18.29681,1567
89721,EB316856896788EC8FD871E122E95728,30931,5,6,1,109.55653,18.32722,1722
89722,EB316856896788EC8FD871E122E95728,31811,8,11,3,109.54201,18.31806,1671
89723,EB316856896788EC8FD871E122E95728,30701,12,14,2,109.59313,18.32007,1871
89724,EB316856896788EC8FD871E122E95728,31811,14,18,4,109.54201,18.31806,1671
89725,EB316856896788EC8FD871E122E95728,30701,19,22,3,109.59313,18.32007,1871
89728,8F3DE08315D720DC64DC898C5903196E,31164,8,9,1,109.69993,18.27215,2263
89729,8F3DE08315D720DC64DC898C5903196E,30854,11,12,1,109.56889,18.27076,1763
89730,8F3DE08315D720DC64DC898C5903196E,60131,15,16,1,109.49819,18.24778,1509
89731,8F3DE08315D720DC64DC898C5903196E,60631,18,19,1,109.57778,18.27583,1814
89732,8F3DE08315D720DC64DC898C5903196E,30854,19,22,3,109.56889,18.27076,1763
89733,74A9CCA48CD6C2DA9FC7DFDB8817D50B,30854,9,21,12,109.56889,18.27076,1763
89734,74A9CCA48CD6C2DA9FC7DFDB8817D50B,30851,22,23,1,109.5616,18.27396,1713
89831,9DE8C13901CC7D63E2F1A6CC92603604,31071,0,15,15,109.58257,18.28458,1815
89832,9DE8C13901CC7D63E2F1A6CC92603604,30731,16,18,2,109.50944,18.22306,1555
89851,D5ED0B56415F07DD214B0DC3E9293672,30854,0,7,7,109.56889,18.27076,1763
89852,D5ED0B56415F07DD214B0DC3E9293672,30232,11,14,3,109.6191,18.31701,1971
89853,D5ED0B56415F07DD214B0DC3E9293672,30854,16,19,3,109.56889,18.27076,1763
89854,D5ED0B56415F07DD214B0DC3E9293672,30232,20,21,1,109.6191,18.31701,1971
89860,2DDF3A993BD69F79020EB97CF3A71819,38171,0,6,6,109.50799,18.28139,1515
89861,2DDF3A993BD69F79020EB97CF3A71819,30161,7,10,3,109.50042,18.24389,1508
89862,2DDF3A993BD69F79020EB97CF3A71819,30161,12,16,4,109.50042,18.24389,1508
89863,2DDF3A993BD69F79020EB97CF3A71819,38251,18,19,1,109.49618,18.25493,1510
89864,2DDF3A993BD69F79020EB97CF3A71819,38171,22,23,1,109.50799,18.28139,1515
89882,8EA475D017A01807E97E34F719EA95E4,31421,1,3,2,109.55382,18.22347,1705
89883,8EA475D017A01807E97E34F719EA95E4,30851,3,10,7,109.5616,18.27396,1713
89884,8EA475D017A01807E97E34F719EA95E4,31421,12,14,2,109.55382,18.22347,1705
89885,8EA475D017A01807E97E34F719EA95E4,30851,15,17,2,109.5616,18.27396,1713
89886,8EA475D017A01807E97E34F719EA95E4,39183,17,19,2,109.55542,18.28208,1715
89887,8EA475D017A01807E97E34F719EA95E4,31421,19,21,2,109.55382,18.22347,1705
89888,8EA475D017A01807E97E34F719EA95E4,30851,21,23,2,109.5616,18.27396,1713
89889,E79FCCBA9F6300DF5C81A804945B477E,31945,1,2,1,109.58021,18.29403,1817
89890,E79FCCBA9F6300DF5C81A804945B477E,31071,3,5,2,109.58257,18.28458,1815
89891,E79FCCBA9F6300DF5C81A804945B477E,30854,6,23,17,109.56889,18.27076,1763
89915,EBD16061EA20EE33D9344D33735E5205,38891,0,6,6,109.51486,18.24118,1558
89916,EBD16061EA20EE33D9344D33735E5205,31261,7,11,4,109.51174,18.2466,1559
89917,EBD16061EA20EE33D9344D33735E5205,38291,13,16,3,109.51618,18.24313,1558
89918,EBD16061EA20EE33D9344D33735E5205,31201,18,21,3,109.51042,18.23819,1558
89919,EBD16061EA20EE33D9344D33735E5205,38891,21,23,2,109.51486,18.24118,1558
89920,34A1BA5A97F90C4ABB34EDC7004774A9,30851,0,6,6,109.5616,18.27396,1713
89921,34A1BA5A97F90C4ABB34EDC7004774A9,39183,10,11,1,109.55542,18.28208,1715
89922,34A1BA5A97F90C4ABB34EDC7004774A9,31071,15,16,1,109.58257,18.28458,1815
89964,534C5FC5CDFDB7797BE5619911FA1868,31781,11,13,2,109.19847,18.2975,367
89965,534C5FC5CDFDB7797BE5619911FA1868,31471,14,16,2,109.34583,18.29563,917
89966,534C5FC5CDFDB7797BE5619911FA1868,30721,20,23,3,109.51597,18.28257,1565
89988,ECA37B99D2E4FEE602303DB4AB25AB77,30721,0,7,7,109.51597,18.28257,1565
89989,ECA37B99D2E4FEE602303DB4AB25AB77,60614,8,10,2,109.48799,18.29521,1467
89990,ECA37B99D2E4FEE602303DB4AB25AB77,38157,12,14,2,109.51483,18.26958,1563
89994,7070286B0061F5DABCD5BBE90834E157,30121,0,8,8,109.52861,18.27222,1613
89995,7070286B0061F5DABCD5BBE90834E157,38241,13,15,2,109.54111,18.30542,1669
89996,7070286B0061F5DABCD5BBE90834E157,30791,18,19,1,109.72333,18.40889,2386
89997,5264833F0013AE6B294396000613EF89,60201,0,8,8,109.5041,18.2509,1510
89998,5264833F0013AE6B294396000613EF89,60581,11,13,2,109.59785,18.29931,1868
89999,5264833F0013AE6B294396000613EF89,60201,14,15,1,109.5041,18.2509,1510
90000,5264833F0013AE6B294396000613EF89,60131,18,19,1,109.49819,18.24778,1509
90001,5264833F0013AE6B294396000613EF89,60201,21,23,2,109.5041,18.2509,1510
90004,AE6DC7ACB81DB5F351E45AC25E5F5A3B,30721,0,2,2,109.51597,18.28257,1565
90005,AE6DC7ACB81DB5F351E45AC25E5F5A3B,38297,4,6,2,109.52576,18.24965,1609
90006,AE6DC7ACB81DB5F351E45AC25E5F5A3B,31031,8,15,7,109.49979,18.25382,1510
90018,92F9F53206FAF7EB9CC354C3DBB7190F,60221,16,17,1,109.52569,18.29188,1616
90019,92F9F53206FAF7EB9CC354C3DBB7190F,31271,18,22,4,109.48958,18.26257,1462
90027,ADAB51A6D99BADC8222FC392D72ADA01,60281,0,6,6,109.51743,18.25924,1561
90028,ADAB51A6D99BADC8222FC392D72ADA01,60311,7,8,1,109.52097,18.24319,1558
90029,ADAB51A6D99BADC8222FC392D72ADA01,60281,8,23,15,109.51743,18.25924,1561
90041,2F440A235E684ECEDD042B3100A4AE95,31071,1,7,6,109.58257,18.28458,1815
90042,2F440A235E684ECEDD042B3100A4AE95,30854,7,8,1,109.56889,18.27076,1763
90043,2F440A235E684ECEDD042B3100A4AE95,30101,10,14,4,109.57299,18.33333,1773
90044,2F440A235E684ECEDD042B3100A4AE95,30854,16,18,2,109.56889,18.27076,1763
90045,2F440A235E684ECEDD042B3100A4AE95,31071,19,23,4,109.58257,18.28458,1815
90061,ACDEAAF45B65DE48CF80A48DBD3C775E,31071,1,2,1,109.58257,18.28458,1815
90062,ACDEAAF45B65DE48CF80A48DBD3C775E,30854,2,5,3,109.56889,18.27076,1763
90063,ACDEAAF45B65DE48CF80A48DBD3C775E,31071,5,6,1,109.58257,18.28458,1815
90064,ACDEAAF45B65DE48CF80A48DBD3C775E,30854,7,9,2,109.56889,18.27076,1763
90093,5EBEA276FCB4A19AC5C987F5C7CC8908,38361,1,7,6,109.43667,18.29201,1267
90094,5EBEA276FCB4A19AC5C987F5C7CC8908,60504,8,10,2,109.47917,18.28903,1416
90095,5EBEA276FCB4A19AC5C987F5C7CC8908,38361,10,15,5,109.43667,18.29201,1267
90096,5EBEA276FCB4A19AC5C987F5C7CC8908,60552,18,20,2,109.41729,18.30014,1218
90097,5EBEA276FCB4A19AC5C987F5C7CC8908,60401,22,23,1,109.47444,18.27583,1414
90100,93EAC7B29C41BCCE26391CB550587732,30891,0,3,3,109.59431,18.28389,1865
90101,93EAC7B29C41BCCE26391CB550587732,30854,3,5,2,109.56889,18.27076,1763
90102,93EAC7B29C41BCCE26391CB550587732,31071,7,8,1,109.58257,18.28458,1815
90103,93EAC7B29C41BCCE26391CB550587732,30854,14,18,4,109.56889,18.27076,1763
90104,93EAC7B29C41BCCE26391CB550587732,31071,18,20,2,109.58257,18.28458,1815
90127,7B1A07C39637E996C01DF0A3D287D3C6,30854,0,15,15,109.56889,18.27076,1763
90128,7B1A07C39637E996C01DF0A3D287D3C6,31071,17,20,3,109.58257,18.28458,1815
90129,7B1A07C39637E996C01DF0A3D287D3C6,30854,20,23,3,109.56889,18.27076,1763
90138,DB4DF566D4757FF3BB488F82DE126248,31561,12,17,5,109.56792,18.28479,1765
90139,DB4DF566D4757FF3BB488F82DE126248,30851,17,19,2,109.5616,18.27396,1713
90140,DB4DF566D4757FF3BB488F82DE126248,31561,22,23,1,109.56792,18.28479,1765
90144,FBC323A047041F71D8997C22FDE88F17,39191,1,2,1,109.51493,18.23472,1557
90145,FBC323A047041F71D8997C22FDE88F17,30181,5,11,6,109.51597,18.23313,1557
90146,FBC323A047041F71D8997C22FDE88F17,38341,13,15,2,109.49965,18.21299,1503
90147,FBC323A047041F71D8997C22FDE88F17,38341,16,19,3,109.49965,18.21299,1503
90148,FBC323A047041F71D8997C22FDE88F17,48574,20,22,2,109.48931,18.28458,1465
90151,0312B43ACF9ED1D8304E325E851AEE29,31561,8,10,2,109.56792,18.28479,1765
90152,0312B43ACF9ED1D8304E325E851AEE29,30851,10,13,3,109.5616,18.27396,1713
90153,0312B43ACF9ED1D8304E325E851AEE29,31561,13,17,4,109.56792,18.28479,1765
90154,0312B43ACF9ED1D8304E325E851AEE29,30851,20,21,1,109.5616,18.27396,1713
90177,B55959B64746A18ECF5077B5F7359221,31561,3,11,8,109.56792,18.28479,1765
90178,B55959B64746A18ECF5077B5F7359221,39183,14,15,1,109.55542,18.28208,1715
90179,B55959B64746A18ECF5077B5F7359221,31561,20,23,3,109.56792,18.28479,1765
90202,06DB20C95BA695C08831082FE672B8D5,60641,0,13,13,109.53854,18.2359,1657
90203,06DB20C95BA695C08831082FE672B8D5,31471,16,17,1,109.34583,18.29563,917
90204,06DB20C95BA695C08831082FE672B8D5,60641,21,23,2,109.53854,18.2359,1657
90269,09390A13C8E5C15C1E5674E3DB9139EC,60201,9,10,1,109.5041,18.2509,1510
90270,09390A13C8E5C15C1E5674E3DB9139EC,60501,11,12,1,109.48701,18.29021,1466
90271,09390A13C8E5C15C1E5674E3DB9139EC,60084,14,15,1,109.4984,18.2334,1507
90272,09390A13C8E5C15C1E5674E3DB9139EC,60231,15,16,1,109.49903,18.21972,1504
90273,09390A13C8E5C15C1E5674E3DB9139EC,60161,17,18,1,109.49174,18.26181,1461
90327,B45CD38CC32587777540C23B64B330A4,31701,0,10,10,109.44132,18.28833,1266
90328,B45CD38CC32587777540C23B64B330A4,31781,13,15,2,109.19847,18.2975,367
90329,B45CD38CC32587777540C23B64B330A4,31701,19,23,4,109.44132,18.28833,1266
90377,B7A2800FDF738E1064EAD2A5E58F7A3C,61011,5,14,9,109.60653,18.19076,1900
90409,7D506D14278B6F252BAE69DB8A578C01,38334,17,20,3,109.65035,18.23785,2057
90410,7D506D14278B6F252BAE69DB8A578C01,31071,21,22,1,109.58257,18.28458,1815
90423,0C8D15C0488D521680F0DE3A28CFE111,31811,0,3,3,109.54201,18.31806,1671
90424,0C8D15C0488D521680F0DE3A28CFE111,30701,5,15,10,109.59313,18.32007,1871
90425,0C8D15C0488D521680F0DE3A28CFE111,31811,19,20,1,109.54201,18.31806,1671
90426,0C8D15C0488D521680F0DE3A28CFE111,30701,20,22,2,109.59313,18.32007,1871
90435,CA3896FB33E9BC68E91955EDFF5D709B,31945,18,19,1,109.58021,18.29403,1817
90436,CA3896FB33E9BC68E91955EDFF5D709B,30854,20,21,1,109.56889,18.27076,1763
90447,64F4CDF664AA04E7B79DE93C57128CF6,31931,0,6,6,109.54771,18.29403,1667
90448,64F4CDF664AA04E7B79DE93C57128CF6,39181,7,18,11,109.55153,18.28035,1715
90449,64F4CDF664AA04E7B79DE93C57128CF6,31931,18,19,1,109.54771,18.29403,1667
90453,0878243E331032B9659EF30304C4F81B,30241,12,13,1,109.26174,18.3275,622
90454,0878243E331032B9659EF30304C4F81B,30661,13,15,2,109.37028,18.24361,1008
90455,0878243E331032B9659EF30304C4F81B,30151,18,23,5,109.50986,18.25083,1560
90456,45CCFCD3EBDF941E1C92B70ED06E8B5E,31561,0,4,4,109.56792,18.28479,1765
90457,45CCFCD3EBDF941E1C92B70ED06E8B5E,30854,5,8,3,109.56889,18.27076,1763
90458,45CCFCD3EBDF941E1C92B70ED06E8B5E,31945,8,9,1,109.58021,18.29403,1817
90459,45CCFCD3EBDF941E1C92B70ED06E8B5E,30854,13,17,4,109.56889,18.27076,1763
90460,45CCFCD3EBDF941E1C92B70ED06E8B5E,31561,21,22,1,109.56792,18.28479,1765
90492,6B806948BC9187A91D033B4096721B00,31561,2,6,4,109.56792,18.28479,1765
90493,6B806948BC9187A91D033B4096721B00,31071,9,20,11,109.58257,18.28458,1815
90494,DE5024DB59D5BF6AE5857A85EB7680EA,31071,0,6,6,109.58257,18.28458,1815
90495,DE5024DB59D5BF6AE5857A85EB7680EA,30854,7,16,9,109.56889,18.27076,1763
90496,DE5024DB59D5BF6AE5857A85EB7680EA,60631,20,21,1,109.57778,18.27583,1814
90499,A2F498F18C66416187F7445E3041DB7D,60281,15,17,2,109.51743,18.25924,1561
90500,A2F498F18C66416187F7445E3041DB7D,38154,18,23,5,109.5266,18.28278,1615
90513,D97A48FFEC6EDAD02D62F5D217EED3AD,31271,0,7,7,109.48958,18.26257,1462
90514,D97A48FFEC6EDAD02D62F5D217EED3AD,31471,9,12,3,109.34583,18.29563,917
90515,D97A48FFEC6EDAD02D62F5D217EED3AD,30661,13,15,2,109.37028,18.24361,1008
90516,D97A48FFEC6EDAD02D62F5D217EED3AD,30361,19,20,1,109.50347,18.24,1508
90525,933C30058B1CA246EC59609197D7CAAB,31071,0,9,9,109.58257,18.28458,1815
90526,933C30058B1CA246EC59609197D7CAAB,31931,13,14,1,109.54771,18.29403,1667
90527,933C30058B1CA246EC59609197D7CAAB,31071,15,17,2,109.58257,18.28458,1815
90528,933C30058B1CA246EC59609197D7CAAB,30281,19,20,1,109.50597,18.27583,1514
90529,933C30058B1CA246EC59609197D7CAAB,31931,21,22,1,109.54771,18.29403,1667
90612,E65658506C2BF9C993BA69EE6D38B3C6,60221,1,2,1,109.52569,18.29188,1616
90613,E65658506C2BF9C993BA69EE6D38B3C6,31951,2,18,16,109.52174,18.30299,1568
90614,E65658506C2BF9C993BA69EE6D38B3C6,31561,22,23,1,109.56792,18.28479,1765
90617,8045363099E728AC2850786DE02A569F,30854,14,16,2,109.56889,18.27076,1763
90618,8045363099E728AC2850786DE02A569F,31071,20,23,3,109.58257,18.28458,1815
90629,996308BA516E2A4FD895EB11278D247D,30201,3,16,13,109.4909,18.26465,1462
90630,996308BA516E2A4FD895EB11278D247D,31031,17,20,3,109.49979,18.25382,1510
90631,996308BA516E2A4FD895EB11278D247D,30201,21,23,2,109.4909,18.26465,1462
90647,E292D83051830D054E89D209EEABA4B9,31561,6,8,2,109.56792,18.28479,1765
90648,E292D83051830D054E89D209EEABA4B9,39183,12,14,2,109.55542,18.28208,1715
90649,E292D83051830D054E89D209EEABA4B9,31561,14,16,2,109.56792,18.28479,1765
90650,E292D83051830D054E89D209EEABA4B9,39183,18,20,2,109.55542,18.28208,1715
90652,B3B41C629129E9D549CC4811391929CA,31861,11,12,1,109.49042,18.27549,1464
90678,6AF6E3AFD18EC04099B3351F858D9C1A,30711,13,18,5,109.50271,18.25347,1510
90679,6AF6E3AFD18EC04099B3351F858D9C1A,31031,18,22,4,109.49979,18.25382,1510
90737,C93386A9D86FE22A1FD4E5116045DD8D,31561,0,6,6,109.56792,18.28479,1765
90738,C93386A9D86FE22A1FD4E5116045DD8D,39183,7,10,3,109.55542,18.28208,1715
90739,C93386A9D86FE22A1FD4E5116045DD8D,31561,10,13,3,109.56792,18.28479,1765
90740,C93386A9D86FE22A1FD4E5116045DD8D,39183,14,16,2,109.55542,18.28208,1715
90779,BD3F86FBF6DE2F542A29594C2469D37F,30071,0,6,6,109.52819,18.30472,1619
90780,BD3F86FBF6DE2F542A29594C2469D37F,60551,9,10,1,109.42722,18.30111,1218
90781,BD3F86FBF6DE2F542A29594C2469D37F,60491,13,14,1,109.43354,18.30847,1269
90782,BD3F86FBF6DE2F542A29594C2469D37F,31931,19,21,2,109.54771,18.29403,1667
90783,BD3F86FBF6DE2F542A29594C2469D37F,60371,21,23,2,109.53063,18.30056,1618
90793,2B8C748A18FA7D08D4335AD7C9DEF01B,31551,12,13,1,109.55868,18.24222,1708
90794,2B8C748A18FA7D08D4335AD7C9DEF01B,30951,14,15,1,109.56208,18.25667,1761
90795,2B8C748A18FA7D08D4335AD7C9DEF01B,31071,19,21,2,109.58257,18.28458,1815
90796,2B8C748A18FA7D08D4335AD7C9DEF01B,31761,22,23,1,109.60521,18.27965,1914
90800,CA9DF84C64B1C31A61B42BDFD659A4B0,31945,0,5,5,109.58021,18.29403,1817
90801,CA9DF84C64B1C31A61B42BDFD659A4B0,30581,7,14,7,109.62257,18.24951,1959
90802,CA9DF84C64B1C31A61B42BDFD659A4B0,30854,18,20,2,109.56889,18.27076,1763
90803,CA9DF84C64B1C31A61B42BDFD659A4B0,31945,21,23,2,109.58021,18.29403,1817
90844,6587551DA47309E484D1302521C8D417,30851,16,17,1,109.5616,18.27396,1713
90866,4EAD72A154BE5264D13EEE1D06581476,60371,0,6,6,109.53063,18.30056,1618
90867,4EAD72A154BE5264D13EEE1D06581476,31931,7,10,3,109.54771,18.29403,1667
90868,4EAD72A154BE5264D13EEE1D06581476,60371,11,21,10,109.53063,18.30056,1618
90878,3977578BE56276DA0700B04B81DC1356,30851,1,6,5,109.5616,18.27396,1713
90879,3977578BE56276DA0700B04B81DC1356,31561,8,23,15,109.56792,18.28479,1765
90947,66290D92C6D91C5C0C9CFEAA9F85388C,38185,9,11,2,109.51333,18.27347,1563
90948,66290D92C6D91C5C0C9CFEAA9F85388C,30854,14,23,9,109.56889,18.27076,1763
90952,7107EBA4D088604148F017F0D0BAED38,39111,0,5,5,109.5191,18.22597,1555
90953,7107EBA4D088604148F017F0D0BAED38,31521,6,9,3,109.51458,18.22542,1555
90954,7107EBA4D088604148F017F0D0BAED38,60381,9,11,2,109.5241,18.22458,1605
90955,7107EBA4D088604148F017F0D0BAED38,38754,12,15,3,109.74667,18.37382,2430
90956,7107EBA4D088604148F017F0D0BAED38,31521,18,21,3,109.51458,18.22542,1555
90957,7107EBA4D088604148F017F0D0BAED38,60291,21,23,2,109.50826,18.24639,1509
90981,AD608A919061B1C684914F8654FB2493,60231,9,10,1,109.49903,18.21972,1504
90982,AD608A919061B1C684914F8654FB2493,60161,14,19,5,109.49174,18.26181,1461
90983,AD608A919061B1C684914F8654FB2493,60084,19,21,2,109.4984,18.2334,1507
91004,F2DDFA8B80CE24F358EB38920C9A6AA9,31304,1,2,1,109.15903,18.32854,223
91005,F2DDFA8B80CE24F358EB38920C9A6AA9,31121,6,8,2,109.16292,18.37063,230
91006,F2DDFA8B80CE24F358EB38920C9A6AA9,31304,9,11,2,109.15903,18.32854,223
91007,F2DDFA8B80CE24F358EB38920C9A6AA9,31145,13,15,2,109.20431,18.30479,369
91008,F2DDFA8B80CE24F358EB38920C9A6AA9,31345,17,18,1,109.39,18.29,1066
91009,F2DDFA8B80CE24F358EB38920C9A6AA9,30201,19,20,1,109.4909,18.26465,1462
91045,A554960249CDEC56FA40CC752E4537D2,30861,19,21,2,109.52722,18.22743,1606
91055,0E129C09250C0D46273B4BD7E5225556,30421,0,10,10,109.50021,18.25861,1511
91056,0E129C09250C0D46273B4BD7E5225556,60401,12,14,2,109.47444,18.27583,1414
91057,0E129C09250C0D46273B4BD7E5225556,60441,14,15,1,109.46792,18.28604,1366
91058,0E129C09250C0D46273B4BD7E5225556,60281,18,20,2,109.51743,18.25924,1561
91059,0E129C09250C0D46273B4BD7E5225556,30421,21,23,2,109.50021,18.25861,1511
91095,537CA9C3FED012868AB5E4DF92AD232C,30861,0,8,8,109.52722,18.22743,1606
91096,537CA9C3FED012868AB5E4DF92AD232C,30861,12,14,2,109.52722,18.22743,1606
91097,537CA9C3FED012868AB5E4DF92AD232C,30861,17,20,3,109.52722,18.22743,1606
91098,537CA9C3FED012868AB5E4DF92AD232C,30711,20,22,2,109.50271,18.25347,1510
91109,3F80F6C7ECC59E36D89C8EF1746C8724,60281,0,1,1,109.51743,18.25924,1561
91110,3F80F6C7ECC59E36D89C8EF1746C8724,30151,1,2,1,109.50986,18.25083,1560
91111,3F80F6C7ECC59E36D89C8EF1746C8724,38121,3,11,8,109.51361,18.27813,1564
91112,3F80F6C7ECC59E36D89C8EF1746C8724,60171,13,15,2,109.51292,18.30694,1569
91150,44CB5F545D2E3587ACF209AB2414C1A1,31071,1,17,16,109.58257,18.28458,1815
91151,44CB5F545D2E3587ACF209AB2414C1A1,38127,19,20,1,109.50833,18.27222,1513
91161,5AA4ADF792DAED16A91C4BAE80AADC51,31571,0,7,7,109.61563,18.23326,1957
91162,5AA4ADF792DAED16A91C4BAE80AADC51,38054,10,12,2,109.63479,18.23097,2006
91163,5AA4ADF792DAED16A91C4BAE80AADC51,38165,17,19,2,109.44847,18.28896,1316
91164,5AA4ADF792DAED16A91C4BAE80AADC51,30361,20,22,2,109.50347,18.24,1508
91177,451E2BF48CD7B253EB0892324E679BCC,31461,0,5,5,109.5091,18.25389,1510
91178,451E2BF48CD7B253EB0892324E679BCC,60281,7,12,5,109.51743,18.25924,1561
91179,451E2BF48CD7B253EB0892324E679BCC,38291,12,21,9,109.51618,18.24313,1558
91180,451E2BF48CD7B253EB0892324E679BCC,38297,22,23,1,109.52576,18.24965,1609
91225,8883DF5E66B5FC284A8EF97DE8EAAAB3,31321,11,15,4,109.63799,18.23201,2007
91226,8883DF5E66B5FC284A8EF97DE8EAAAB3,60214,20,21,1,109.63104,18.24493,2009
91227,8883DF5E66B5FC284A8EF97DE8EAAAB3,31571,21,22,1,109.61563,18.23326,1957
91235,4F3A073B0E00F2C591EAC7CA3550DBAE,31071,20,21,1,109.58257,18.28458,1815
91236,4F3A073B0E00F2C591EAC7CA3550DBAE,30851,21,22,1,109.5616,18.27396,1713
91260,0E5593A90D661690BE3DAAA17AD936E2,38127,0,10,10,109.50833,18.27222,1513
91261,0E5593A90D661690BE3DAAA17AD936E2,38073,12,13,1,109.40813,18.30958,1169
91262,0E5593A90D661690BE3DAAA17AD936E2,38127,15,16,1,109.50833,18.27222,1513
91263,0E5593A90D661690BE3DAAA17AD936E2,30281,18,20,2,109.50597,18.27583,1514
91266,DDE77D3A656666992FC3458B84010D43,39183,1,5,4,109.55542,18.28208,1715
91267,DDE77D3A656666992FC3458B84010D43,31561,8,9,1,109.56792,18.28479,1765
91268,DDE77D3A656666992FC3458B84010D43,39183,12,21,9,109.55542,18.28208,1715
91276,07FD145FE6C81328C98C6C5C8452E794,30854,2,3,1,109.56889,18.27076,1763
91277,07FD145FE6C81328C98C6C5C8452E794,30232,5,10,5,109.6191,18.31701,1971
91278,07FD145FE6C81328C98C6C5C8452E794,30854,11,12,1,109.56889,18.27076,1763
91279,07FD145FE6C81328C98C6C5C8452E794,30232,13,23,10,109.6191,18.31701,1971
91290,2E10AE81CA4EDA6CD33CFF9EBE881FD8,60084,0,7,7,109.4984,18.2334,1507
91291,2E10AE81CA4EDA6CD33CFF9EBE881FD8,30854,10,11,1,109.56889,18.27076,1763
91293,2E10AE81CA4EDA6CD33CFF9EBE881FD8,39151,18,19,1,109.49875,18.25097,1510
91294,2E10AE81CA4EDA6CD33CFF9EBE881FD8,30711,20,22,2,109.50271,18.25347,1510
91358,807F73DE76DFE56E472FA61396F0887C,60291,0,15,15,109.50826,18.24639,1509
91359,807F73DE76DFE56E472FA61396F0887C,60201,15,17,2,109.5041,18.2509,1510
91366,E12BF6F292017B631FE5B39504EB53C3,30121,18,23,5,109.52861,18.27222,1613
91392,DB0EF690DC781F73956987AB22EA398D,38361,0,8,8,109.43667,18.29201,1267
91393,DB0EF690DC781F73956987AB22EA398D,38754,11,13,2,109.74667,18.37382,2430
91394,DB0EF690DC781F73956987AB22EA398D,30161,15,17,2,109.50042,18.24389,1508
91395,DB0EF690DC781F73956987AB22EA398D,30731,20,22,2,109.50944,18.22306,1555
91399,913AFF9774BDE45ED2E6C1B86D772D8F,31061,17,23,6,109.53333,18.23257,1607
91412,283001ED673D8EDBEF7EEB00BDB31533,30571,4,6,2,109.50243,18.21861,1504
91413,283001ED673D8EDBEF7EEB00BDB31533,60201,6,8,2,109.5041,18.2509,1510
91414,283001ED673D8EDBEF7EEB00BDB31533,31181,8,18,10,109.50382,18.24813,1509
91415,283001ED673D8EDBEF7EEB00BDB31533,30571,18,20,2,109.50243,18.21861,1504
91416,0187C68AAA5B8B5AFE4438278EB6AFB0,31931,6,9,3,109.54771,18.29403,1667
91417,0187C68AAA5B8B5AFE4438278EB6AFB0,30851,9,10,1,109.5616,18.27396,1713
91418,0187C68AAA5B8B5AFE4438278EB6AFB0,31561,10,11,1,109.56792,18.28479,1765
91419,0187C68AAA5B8B5AFE4438278EB6AFB0,30851,11,21,10,109.5616,18.27396,1713
91443,B5D5F035B558647FF9F44A76F16A1183,31206,0,14,14,109.50819,18.23549,1507
91444,B5D5F035B558647FF9F44A76F16A1183,38371,19,20,1,109.50972,18.23924,1558
91445,B5D5F035B558647FF9F44A76F16A1183,31411,21,22,1,109.5016,18.23576,1507
91489,202870BA524F8D7E9C1B66336BF1F034,31951,0,5,5,109.52174,18.30299,1568
91490,202870BA524F8D7E9C1B66336BF1F034,60631,7,9,2,109.57778,18.27583,1814
91491,202870BA524F8D7E9C1B66336BF1F034,30854,12,18,6,109.56889,18.27076,1763
91492,202870BA524F8D7E9C1B66336BF1F034,38991,19,20,1,109.52681,18.30368,1618
91515,D39D64452E6BBEF7B3056CA239E1B86E,30854,0,8,8,109.56889,18.27076,1763
91516,D39D64452E6BBEF7B3056CA239E1B86E,31561,8,10,2,109.56792,18.28479,1765
91517,D39D64452E6BBEF7B3056CA239E1B86E,30854,10,11,1,109.56889,18.27076,1763
91518,D39D64452E6BBEF7B3056CA239E1B86E,31561,14,15,1,109.56792,18.28479,1765
91519,D39D64452E6BBEF7B3056CA239E1B86E,30854,15,23,8,109.56889,18.27076,1763
91564,FC294DFCE86FDA84EAB1A8B689598D0A,38111,16,17,1,109.52007,18.22403,1555
91565,FC294DFCE86FDA84EAB1A8B689598D0A,31061,19,21,2,109.53333,18.23257,1607
91577,D1B09D14086A317457A98E1E3E3BED6B,39181,0,5,5,109.55153,18.28035,1715
91578,D1B09D14086A317457A98E1E3E3BED6B,31931,6,7,1,109.54771,18.29403,1667
91579,D1B09D14086A317457A98E1E3E3BED6B,39181,7,23,16,109.55153,18.28035,1715
91586,D6B54C643B88B86782DC30A38AD291FD,31561,2,7,5,109.56792,18.28479,1765
91587,D6B54C643B88B86782DC30A38AD291FD,30854,7,9,2,109.56889,18.27076,1763
91588,D6B54C643B88B86782DC30A38AD291FD,31561,13,17,4,109.56792,18.28479,1765
91618,1FE2866848043A2C10AD87212485FE15,31071,0,7,7,109.58257,18.28458,1815
91619,1FE2866848043A2C10AD87212485FE15,30854,7,13,6,109.56889,18.27076,1763
91620,1FE2866848043A2C10AD87212485FE15,31071,14,17,3,109.58257,18.28458,1815
91621,1FE2866848043A2C10AD87212485FE15,30854,17,21,4,109.56889,18.27076,1763
91646,EE9ED89488CC5A6EB73A10F5D2E75FDB,38085,0,1,1,109.6291,18.23625,2007
91647,EE9ED89488CC5A6EB73A10F5D2E75FDB,31571,2,4,2,109.61563,18.23326,1957
91648,EE9ED89488CC5A6EB73A10F5D2E75FDB,38085,6,8,2,109.6291,18.23625,2007
91679,CD576F1C1CDFB89E6A99A20E65927346,31071,5,6,1,109.58257,18.28458,1815
91680,CD576F1C1CDFB89E6A99A20E65927346,30854,6,7,1,109.56889,18.27076,1763
91681,CD576F1C1CDFB89E6A99A20E65927346,31561,8,9,1,109.56792,18.28479,1765
91682,CD576F1C1CDFB89E6A99A20E65927346,30854,11,12,1,109.56889,18.27076,1763
91683,CD576F1C1CDFB89E6A99A20E65927346,31561,14,15,1,109.56792,18.28479,1765
91684,CD576F1C1CDFB89E6A99A20E65927346,30854,18,21,3,109.56889,18.27076,1763
91713,0AD99509D112B17EDC0942E5CD8E86E4,30921,11,13,2,109.53903,18.29451,1667
91714,0AD99509D112B17EDC0942E5CD8E86E4,31931,14,17,3,109.54771,18.29403,1667
91715,0AD99509D112B17EDC0942E5CD8E86E4,30071,19,23,4,109.52819,18.30472,1619
91730,B712327B6033C61F37801CFD6DAC08AD,31951,1,3,2,109.52174,18.30299,1568
91731,B712327B6033C61F37801CFD6DAC08AD,38484,6,9,3,109.53028,18.31528,1620
91732,B712327B6033C61F37801CFD6DAC08AD,38484,12,13,1,109.53028,18.31528,1620
91733,B712327B6033C61F37801CFD6DAC08AD,30071,13,14,1,109.52819,18.30472,1619
91734,B712327B6033C61F37801CFD6DAC08AD,38484,15,17,2,109.53028,18.31528,1620
91735,B712327B6033C61F37801CFD6DAC08AD,38484,18,21,3,109.53028,18.31528,1620
91749,A7B3BDD8DC79485BA41EC7F220A41345,60631,0,9,9,109.57778,18.27583,1814
91750,A7B3BDD8DC79485BA41EC7F220A41345,30854,9,12,3,109.56889,18.27076,1763
91751,A7B3BDD8DC79485BA41EC7F220A41345,60631,14,20,6,109.57778,18.27583,1814
91752,A7B3BDD8DC79485BA41EC7F220A41345,30854,21,22,1,109.56889,18.27076,1763
91753,63FBAC0202144B00077561285E6A7F87,30651,2,3,1,109.42611,18.385,1232
91754,63FBAC0202144B00077561285E6A7F87,30821,4,23,19,109.43681,18.33639,1274
91763,070984703178D21DC5287E457C03691A,39181,0,6,6,109.55153,18.28035,1715
91764,070984703178D21DC5287E457C03691A,39181,9,12,3,109.55153,18.28035,1715
91765,070984703178D21DC5287E457C03691A,39181,16,23,7,109.55153,18.28035,1715
91835,89362A3CA3AE6F5B75871F2110924F99,30951,14,17,3,109.56208,18.25667,1761
91836,89362A3CA3AE6F5B75871F2110924F99,30851,19,21,2,109.5616,18.27396,1713
91864,7D632B68A96EBB9D6582527232D6634C,31461,1,8,7,109.5091,18.25389,1510
91865,7D632B68A96EBB9D6582527232D6634C,31291,9,12,3,109.30375,18.40729,786
91866,7D632B68A96EBB9D6582527232D6634C,31231,14,19,5,109.42597,18.29292,1217
91909,09605A95AE7BE30FC92DC699DB3FCBD0,31181,0,8,8,109.50382,18.24813,1509
91910,09605A95AE7BE30FC92DC699DB3FCBD0,31461,9,12,3,109.5091,18.25389,1510
91911,09605A95AE7BE30FC92DC699DB3FCBD0,31461,13,14,1,109.5091,18.25389,1510
91912,09605A95AE7BE30FC92DC699DB3FCBD0,31201,18,20,2,109.51042,18.23819,1558
91941,7FF3C6569A3990C03CAF6C52D3C8BC6C,60241,0,5,5,109.53319,18.28667,1616
91942,7FF3C6569A3990C03CAF6C52D3C8BC6C,31931,7,8,1,109.54771,18.29403,1667
91943,7FF3C6569A3990C03CAF6C52D3C8BC6C,60241,11,12,1,109.53319,18.28667,1616
91965,E46795A590C643FCDE6B993B35621D2F,31931,1,6,5,109.54771,18.29403,1667
91966,E46795A590C643FCDE6B993B35621D2F,30351,11,13,2,109.41701,18.29292,1217
91967,E46795A590C643FCDE6B993B35621D2F,30921,18,19,1,109.53903,18.29451,1667
91968,066E3B290AAC556F650E56DD0F693AB2,38251,0,7,7,109.49618,18.25493,1510
91969,066E3B290AAC556F650E56DD0F693AB2,33481,9,13,4,109.67278,18.41278,2187
91970,066E3B290AAC556F650E56DD0F693AB2,38251,16,19,3,109.49618,18.25493,1510
91971,066E3B290AAC556F650E56DD0F693AB2,31181,19,23,4,109.50382,18.24813,1509
91995,B47BACC30D9A35D35F1E9FB0E5DF7D48,30854,4,7,3,109.56889,18.27076,1763
91996,B47BACC30D9A35D35F1E9FB0E5DF7D48,31071,7,8,1,109.58257,18.28458,1815
91997,B47BACC30D9A35D35F1E9FB0E5DF7D48,30854,9,14,5,109.56889,18.27076,1763
91998,B47BACC30D9A35D35F1E9FB0E5DF7D48,31071,16,19,3,109.58257,18.28458,1815
91999,B47BACC30D9A35D35F1E9FB0E5DF7D48,30854,20,23,3,109.56889,18.27076,1763
92084,30F5D42A1A8F1CF26F5C9617FCB06C4F,31561,0,6,6,109.56792,18.28479,1765
92085,30F5D42A1A8F1CF26F5C9617FCB06C4F,39183,8,9,1,109.55542,18.28208,1715
92086,30F5D42A1A8F1CF26F5C9617FCB06C4F,31561,10,11,1,109.56792,18.28479,1765
92087,30F5D42A1A8F1CF26F5C9617FCB06C4F,39183,14,15,1,109.55542,18.28208,1715
92157,A928E9F6C796FE1A60807BA003DE87BB,30854,0,12,12,109.56889,18.27076,1763
92158,A928E9F6C796FE1A60807BA003DE87BB,30361,14,16,2,109.50347,18.24,1508
92159,A928E9F6C796FE1A60807BA003DE87BB,30854,20,23,3,109.56889,18.27076,1763
92200,568827877C6CA7A0BC5DC0EF910BF7F5,31236,0,8,8,109.42965,18.29111,1216
92201,568827877C6CA7A0BC5DC0EF910BF7F5,31031,13,14,1,109.49979,18.25382,1510
92202,568827877C6CA7A0BC5DC0EF910BF7F5,31231,18,19,1,109.42597,18.29292,1217
92203,568827877C6CA7A0BC5DC0EF910BF7F5,30671,20,21,1,109.43611,18.30139,1268
92204,568827877C6CA7A0BC5DC0EF910BF7F5,31231,21,23,2,109.42597,18.29292,1217
92205,0046001E45A9DDB75555AADDDC352392,31071,0,14,14,109.58257,18.28458,1815
92206,0046001E45A9DDB75555AADDDC352392,30854,16,17,1,109.56889,18.27076,1763
92207,0046001E45A9DDB75555AADDDC352392,31071,18,23,5,109.58257,18.28458,1815
92209,3F320FCC97654DBDACE66BB1BF09E301,38754,9,10,1,109.74667,18.37382,2430
92210,3F320FCC97654DBDACE66BB1BF09E301,38484,12,13,1,109.53028,18.31528,1620
92241,A549C024E6F63EDBD3DC866F10DB11CE,31071,12,14,2,109.58257,18.28458,1815
92242,A549C024E6F63EDBD3DC866F10DB11CE,30854,17,19,2,109.56889,18.27076,1763
92254,70A62761FE79F922D082380DA7747243,30854,0,17,17,109.56889,18.27076,1763
92255,70A62761FE79F922D082380DA7747243,31561,17,19,2,109.56792,18.28479,1765
92256,70A62761FE79F922D082380DA7747243,30854,20,22,2,109.56889,18.27076,1763
92257,9770385BF52AD3BEBCA7962FCA51DE84,60221,17,19,2,109.52569,18.29188,1616
92258,9770385BF52AD3BEBCA7962FCA51DE84,60381,20,21,1,109.5241,18.22458,1605
92301,A749E400BFD3B5908671E939EC104DEE,30854,0,6,6,109.56889,18.27076,1763
92302,A749E400BFD3B5908671E939EC104DEE,31071,6,8,2,109.58257,18.28458,1815
92303,A749E400BFD3B5908671E939EC104DEE,30854,8,21,13,109.56889,18.27076,1763
92304,E4B522EF4348156010E5C578EC13D60F,30854,3,13,10,109.56889,18.27076,1763
92305,E4B522EF4348156010E5C578EC13D60F,31071,15,16,1,109.58257,18.28458,1815
92306,8ED1BCC2D2A319298B3669D3F81BDCBA,31181,19,21,2,109.50382,18.24813,1509
92307,8ED1BCC2D2A319298B3669D3F81BDCBA,30391,22,23,1,109.4975,18.27118,1513
92308,990E16E6526CF60DC36C2ECCED74BC82,31031,1,9,8,109.49979,18.25382,1510
92310,990E16E6526CF60DC36C2ECCED74BC82,31561,19,20,1,109.56792,18.28479,1765
92320,9AF351B3CC27394DFED45513F0E32162,60351,0,6,6,109.58403,18.28958,1816
92321,9AF351B3CC27394DFED45513F0E32162,30851,7,9,2,109.5616,18.27396,1713
92322,9AF351B3CC27394DFED45513F0E32162,30951,13,17,4,109.56208,18.25667,1761
92323,9AF351B3CC27394DFED45513F0E32162,31071,18,20,2,109.58257,18.28458,1815
92324,9AF351B3CC27394DFED45513F0E32162,60351,21,22,1,109.58403,18.28958,1816
92333,608A55C14BAB2A5B627ACC1F39B89FB6,31945,0,13,13,109.58021,18.29403,1817
92334,608A55C14BAB2A5B627ACC1F39B89FB6,31071,15,16,1,109.58257,18.28458,1815
92335,608A55C14BAB2A5B627ACC1F39B89FB6,31945,21,22,1,109.58021,18.29403,1817
92373,1EBF477B1EE6E13F6E111854406233C6,31101,15,16,1,109.65389,18.23403,2057
92374,1EBF477B1EE6E13F6E111854406233C6,60131,17,19,2,109.49819,18.24778,1509
92375,1EBF477B1EE6E13F6E111854406233C6,38251,20,22,2,109.49618,18.25493,1510
92427,10EBF762D28520B09848288F7052CFDE,30854,0,6,6,109.56889,18.27076,1763
92428,10EBF762D28520B09848288F7052CFDE,39101,8,17,9,109.50132,18.24931,1509
92429,10EBF762D28520B09848288F7052CFDE,30854,20,23,3,109.56889,18.27076,1763
92434,3E01B14B28C0FDBF8BB343D61C8AA7D8,60331,13,16,3,109.505,18.26507,1512
92435,3E01B14B28C0FDBF8BB343D61C8AA7D8,60361,17,18,1,109.51938,18.29681,1567
92436,3E01B14B28C0FDBF8BB343D61C8AA7D8,60241,19,20,1,109.53319,18.28667,1616
92459,CB18F4578E52530026F2A384EBEE805A,30854,13,16,3,109.56889,18.27076,1763
92460,CB18F4578E52530026F2A384EBEE805A,31161,20,23,3,109.70229,18.31361,2270
92464,9A369E1280A8BB5227D2B6A5698033ED,31521,0,11,11,109.51458,18.22542,1555
92476,963B5F4C98446446023B8ED177B869B3,60361,0,6,6,109.51938,18.29681,1567
92477,963B5F4C98446446023B8ED177B869B3,39183,11,17,6,109.55542,18.28208,1715
92478,963B5F4C98446446023B8ED177B869B3,60361,18,23,5,109.51938,18.29681,1567
92481,BC698E1FFA446375C97B9B7301DE31FA,60221,16,19,3,109.52569,18.29188,1616
92482,BC698E1FFA446375C97B9B7301DE31FA,30854,20,23,3,109.56889,18.27076,1763
92498,487FC583F0AF1414583ADA3127598053,60631,1,7,6,109.57778,18.27583,1814
92499,487FC583F0AF1414583ADA3127598053,31071,9,10,1,109.58257,18.28458,1815
92500,487FC583F0AF1414583ADA3127598053,31321,14,16,2,109.63799,18.23201,2007
92501,487FC583F0AF1414583ADA3127598053,31071,20,21,1,109.58257,18.28458,1815
92552,065F1687C35F3C827A2EA4A378A0E2C6,30851,6,8,2,109.5616,18.27396,1713
92553,065F1687C35F3C827A2EA4A378A0E2C6,30951,8,10,2,109.56208,18.25667,1761
92554,065F1687C35F3C827A2EA4A378A0E2C6,30851,11,21,10,109.5616,18.27396,1713
92575,3C09A11C854CBC0803237DC7A23AB0BC,31164,0,5,5,109.69993,18.27215,2263
92576,3C09A11C854CBC0803237DC7A23AB0BC,31851,6,9,3,109.71736,18.29007,2316
92577,3C09A11C854CBC0803237DC7A23AB0BC,38754,12,14,2,109.74667,18.37382,2430
92584,13166628932DF36C0AD7B1DB5811240A,30854,15,16,1,109.56889,18.27076,1763
92585,13166628932DF36C0AD7B1DB5811240A,60591,19,23,4,109.61118,18.21715,1904
92601,2DA5948E96121EADE6CCFA0D33794EFE,38251,2,10,8,109.49618,18.25493,1510
92602,2DA5948E96121EADE6CCFA0D33794EFE,31471,13,15,2,109.34583,18.29563,917
92603,2DA5948E96121EADE6CCFA0D33794EFE,31531,18,19,1,109.49583,18.25972,1461
92604,2DA5948E96121EADE6CCFA0D33794EFE,31031,19,23,4,109.49979,18.25382,1510
92608,B621E9075674E792CCB217233825F9D1,30851,2,6,4,109.5616,18.27396,1713
92609,B621E9075674E792CCB217233825F9D1,30854,11,12,1,109.56889,18.27076,1763
92610,B621E9075674E792CCB217233825F9D1,60631,14,15,1,109.57778,18.27583,1814
92621,6DF7485545B790F22810B0EDD8F1B356,31945,0,7,7,109.58021,18.29403,1817
92622,6DF7485545B790F22810B0EDD8F1B356,30854,10,11,1,109.56889,18.27076,1763
92623,6DF7485545B790F22810B0EDD8F1B356,31945,12,13,1,109.58021,18.29403,1817
92624,6DF7485545B790F22810B0EDD8F1B356,30854,14,16,2,109.56889,18.27076,1763
92625,6DF7485545B790F22810B0EDD8F1B356,31945,18,23,5,109.58021,18.29403,1817
92660,15A2A8790389D1537721C21B141A7A31,31071,9,14,5,109.58257,18.28458,1815
92661,15A2A8790389D1537721C21B141A7A31,61011,15,21,6,109.60653,18.19076,1900
92663,33608FFC68C65F89820708A4BDA9517A,60631,0,6,6,109.57778,18.27583,1814
92664,33608FFC68C65F89820708A4BDA9517A,31091,8,9,1,109.41201,18.31222,1170
92665,33608FFC68C65F89820708A4BDA9517A,30854,10,11,1,109.56889,18.27076,1763
92672,6D02659C8AB6FF777A098A468ACF74DA,31021,15,16,1,109.49021,18.27,1463
92673,6D02659C8AB6FF777A098A468ACF74DA,30461,19,20,1,109.5116,18.26313,1562
92704,77F5A37783010C53E376197FE3F1043D,30071,6,14,8,109.52819,18.30472,1619
92738,0F558B6653C655C7F0BAEA9D66B33F57,31071,0,7,7,109.58257,18.28458,1815
92739,0F558B6653C655C7F0BAEA9D66B33F57,30854,12,21,9,109.56889,18.27076,1763
92754,7421066246AAD1C230E7E2A7ADF06E9D,60631,0,6,6,109.57778,18.27583,1814
92755,7421066246AAD1C230E7E2A7ADF06E9D,30854,7,15,8,109.56889,18.27076,1763
92756,7421066246AAD1C230E7E2A7ADF06E9D,31071,17,18,1,109.58257,18.28458,1815
92757,7421066246AAD1C230E7E2A7ADF06E9D,30854,18,19,1,109.56889,18.27076,1763
92775,A01B4012B619D942E7CC3AC9B78722B4,31561,0,1,1,109.56792,18.28479,1765
92776,A01B4012B619D942E7CC3AC9B78722B4,30851,1,5,4,109.5616,18.27396,1713
92777,A01B4012B619D942E7CC3AC9B78722B4,39183,7,8,1,109.55542,18.28208,1715
92778,A01B4012B619D942E7CC3AC9B78722B4,31561,12,23,11,109.56792,18.28479,1765
92798,417408FFDA93B177641D270D3A5C4B2D,31071,2,14,12,109.58257,18.28458,1815
92799,417408FFDA93B177641D270D3A5C4B2D,60631,15,17,2,109.57778,18.27583,1814
92800,417408FFDA93B177641D270D3A5C4B2D,31071,21,23,2,109.58257,18.28458,1815
92804,8394F4F81295DA567F75BB12D1616CF3,60361,0,6,6,109.51938,18.29681,1567
92805,8394F4F81295DA567F75BB12D1616CF3,39111,8,11,3,109.5191,18.22597,1555
92806,8394F4F81295DA567F75BB12D1616CF3,38911,11,13,2,109.51674,18.24965,1559
92807,8394F4F81295DA567F75BB12D1616CF3,31521,13,16,3,109.51458,18.22542,1555
92808,8394F4F81295DA567F75BB12D1616CF3,31521,19,21,2,109.51458,18.22542,1555
92809,8394F4F81295DA567F75BB12D1616CF3,60361,22,23,1,109.51938,18.29681,1567
92855,28F7DFD4A036DBA4E68AFC71762D44D7,30851,0,5,5,109.5616,18.27396,1713
92856,28F7DFD4A036DBA4E68AFC71762D44D7,30951,8,9,1,109.56208,18.25667,1761
92857,28F7DFD4A036DBA4E68AFC71762D44D7,31421,9,10,1,109.55382,18.22347,1705
92858,28F7DFD4A036DBA4E68AFC71762D44D7,30951,11,12,1,109.56208,18.25667,1761
92859,28F7DFD4A036DBA4E68AFC71762D44D7,31421,13,15,2,109.55382,18.22347,1705
92871,0A9117B90774715AACE2ED3045D6F579,60041,0,7,7,109.39889,18.31944,1121
92872,0A9117B90774715AACE2ED3045D6F579,31081,9,10,1,109.44639,18.30181,1318
92873,0A9117B90774715AACE2ED3045D6F579,30761,13,15,2,109.45201,18.3,1318
92897,84633D8BA654ABD696C26ED03FF61CB6,30084,0,8,8,109.50118,18.26972,1513
92898,84633D8BA654ABD696C26ED03FF61CB6,30771,8,13,5,109.49938,18.26042,1511
92899,84633D8BA654ABD696C26ED03FF61CB6,60111,14,15,1,109.72556,18.31924,2371
92900,84633D8BA654ABD696C26ED03FF61CB6,30151,18,19,1,109.50986,18.25083,1560
92901,84633D8BA654ABD696C26ED03FF61CB6,60381,19,21,2,109.5241,18.22458,1605
92902,D537779863674D03BD86E245F9738004,38941,0,8,8,109.49625,18.25451,1510
92903,D537779863674D03BD86E245F9738004,30661,10,16,6,109.37028,18.24361,1008
92904,D537779863674D03BD86E245F9738004,38251,18,23,5,109.49618,18.25493,1510
92965,BD4652414D5C17466BA36FD4BD943A94,60221,2,3,1,109.52569,18.29188,1616
92966,BD4652414D5C17466BA36FD4BD943A94,30721,5,7,2,109.51597,18.28257,1565
92967,BD4652414D5C17466BA36FD4BD943A94,39183,9,11,2,109.55542,18.28208,1715
92968,BD4652414D5C17466BA36FD4BD943A94,39181,15,17,2,109.55153,18.28035,1715
92969,BD4652414D5C17466BA36FD4BD943A94,30421,18,20,2,109.50021,18.25861,1511
93037,FA1E5CA356F8B43CC7D8561CCE648EA2,31164,0,13,13,109.69993,18.27215,2263
93044,C64E9A6979E0B94B1A1E04B18E8DF9D7,30441,14,15,1,109.64021,18.25424,2010
93045,C64E9A6979E0B94B1A1E04B18E8DF9D7,31061,20,23,3,109.53333,18.23257,1607
93070,AFCD0831F8AAAE7DDAE42327797F10EB,30854,1,2,1,109.56889,18.27076,1763
93071,AFCD0831F8AAAE7DDAE42327797F10EB,31761,4,5,1,109.60521,18.27965,1914
93072,AFCD0831F8AAAE7DDAE42327797F10EB,30854,10,11,1,109.56889,18.27076,1763
93073,AFCD0831F8AAAE7DDAE42327797F10EB,31071,14,21,7,109.58257,18.28458,1815
93086,4EC6B926136B0B67456F56C4DC11DD27,38325,17,19,2,109.39792,18.2909,1116
93087,4EC6B926136B0B67456F56C4DC11DD27,30351,19,21,2,109.41701,18.29292,1217
93096,9BD0746EAD915C7FE62E448DC71186FA,30854,9,10,1,109.56889,18.27076,1763
93097,9BD0746EAD915C7FE62E448DC71186FA,30111,11,12,1,109.47583,18.30542,1419
93098,9BD0746EAD915C7FE62E448DC71186FA,31071,15,16,1,109.58257,18.28458,1815
93099,9BD0746EAD915C7FE62E448DC71186FA,30854,19,23,4,109.56889,18.27076,1763
93110,C85D0B931BEF54F05B9ABBBB03212DB7,30854,0,9,9,109.56889,18.27076,1763
93111,C85D0B931BEF54F05B9ABBBB03212DB7,31561,9,12,3,109.56792,18.28479,1765
93112,C85D0B931BEF54F05B9ABBBB03212DB7,30854,12,13,1,109.56889,18.27076,1763
93113,C85D0B931BEF54F05B9ABBBB03212DB7,31561,14,15,1,109.56792,18.28479,1765
93114,C85D0B931BEF54F05B9ABBBB03212DB7,30854,17,21,4,109.56889,18.27076,1763
93133,0E1DB444F47235AEDAD0A0404A7B75B4,31561,1,17,16,109.56792,18.28479,1765
93134,0E1DB444F47235AEDAD0A0404A7B75B4,39183,19,20,1,109.55542,18.28208,1715
93143,CBC603DF99C1D6981715077F3EA24CB6,31071,5,6,1,109.58257,18.28458,1815
93144,CBC603DF99C1D6981715077F3EA24CB6,30854,9,22,13,109.56889,18.27076,1763
93145,B37777551ADDE84A1FDFE1FF465C24DC,30921,0,1,1,109.53903,18.29451,1667
93146,B37777551ADDE84A1FDFE1FF465C24DC,31931,2,16,14,109.54771,18.29403,1667
93214,5053F169E26BA3D25B0C6902CA24AB79,31236,0,6,6,109.42965,18.29111,1216
93215,5053F169E26BA3D25B0C6902CA24AB79,31145,8,10,2,109.20431,18.30479,369
93216,5053F169E26BA3D25B0C6902CA24AB79,60054,13,14,1,109.3016,18.31229,770
93217,5053F169E26BA3D25B0C6902CA24AB79,31431,18,19,1,109.44639,18.29042,1316
93218,5053F169E26BA3D25B0C6902CA24AB79,31231,20,23,3,109.42597,18.29292,1217
93232,EBF906C5498076BCFA3E97DF6001B4F3,31206,0,1,1,109.50819,18.23549,1507
93233,EBF906C5498076BCFA3E97DF6001B4F3,60631,2,8,6,109.57778,18.27583,1814
93234,EBF906C5498076BCFA3E97DF6001B4F3,30854,8,11,3,109.56889,18.27076,1763
93235,EBF906C5498076BCFA3E97DF6001B4F3,60631,14,15,1,109.57778,18.27583,1814
93236,EBF906C5498076BCFA3E97DF6001B4F3,31561,16,17,1,109.56792,18.28479,1765
93239,856FED43C24F39C7284040D716161D86,60501,0,8,8,109.48701,18.29021,1466
93240,856FED43C24F39C7284040D716161D86,31081,8,19,11,109.44639,18.30181,1318
93262,2A6BA0678DDF16AF08BAC9E3FA3C9391,31561,0,5,5,109.56792,18.28479,1765
93263,2A6BA0678DDF16AF08BAC9E3FA3C9391,30854,9,19,10,109.56889,18.27076,1763
93264,2A6BA0678DDF16AF08BAC9E3FA3C9391,31561,22,23,1,109.56792,18.28479,1765
93281,928DF0385E8541CFD2F5858501C04155,30234,1,6,5,109.60681,18.29979,1918
93282,928DF0385E8541CFD2F5858501C04155,30854,9,22,13,109.56889,18.27076,1763
93283,E50C3F5EAF024523809A782B7E9AE8AE,60524,0,8,8,109.42951,18.28993,1216
93284,E50C3F5EAF024523809A782B7E9AE8AE,60131,9,11,2,109.49819,18.24778,1509
93285,E50C3F5EAF024523809A782B7E9AE8AE,30211,12,14,2,109.49882,18.23931,1508
93304,4847B7EE1BA09BE4FECC9A6B93CA773D,60054,13,15,2,109.3016,18.31229,770
93305,4847B7EE1BA09BE4FECC9A6B93CA773D,60491,19,23,4,109.43354,18.30847,1269
93315,75817DB682187A07461734D66E1E6492,60631,0,4,4,109.57778,18.27583,1814
93316,75817DB682187A07461734D66E1E6492,30854,6,12,6,109.56889,18.27076,1763
93317,75817DB682187A07461734D66E1E6492,30851,17,18,1,109.5616,18.27396,1713
93318,75817DB682187A07461734D66E1E6492,31061,19,20,1,109.53333,18.23257,1607
93319,75817DB682187A07461734D66E1E6492,60631,22,23,1,109.57778,18.27583,1814
93334,8AE547CC56788F82C32B9A8562096998,31071,0,7,7,109.58257,18.28458,1815
93335,8AE547CC56788F82C32B9A8562096998,30854,7,16,9,109.56889,18.27076,1763
93336,8AE547CC56788F82C32B9A8562096998,31071,16,18,2,109.58257,18.28458,1815
93346,E16204D131FCD957D5ADB9592C1DD0ED,31761,0,8,8,109.60521,18.27965,1914
93347,E16204D131FCD957D5ADB9592C1DD0ED,31071,11,23,12,109.58257,18.28458,1815
93415,ECCCA5770AD6AA7162B63EC395B55856,30854,16,19,3,109.56889,18.27076,1763
93416,ECCCA5770AD6AA7162B63EC395B55856,60631,20,23,3,109.57778,18.27583,1814
93420,34F3D64B41C252481F72E5CF931AC833,30854,2,10,8,109.56889,18.27076,1763
93421,34F3D64B41C252481F72E5CF931AC833,31071,11,22,11,109.58257,18.28458,1815
93474,95E09A72760B2799C2CC9BD7AF527107,31271,10,11,1,109.48958,18.26257,1462
93475,95E09A72760B2799C2CC9BD7AF527107,30854,12,23,11,109.56889,18.27076,1763
93499,4DA47CA7E0DF1887A4FCFA8DEF75F8FC,31761,0,7,7,109.60521,18.27965,1914
93500,4DA47CA7E0DF1887A4FCFA8DEF75F8FC,31421,8,10,2,109.55382,18.22347,1705
93501,4DA47CA7E0DF1887A4FCFA8DEF75F8FC,31551,12,13,1,109.55868,18.24222,1708
93502,4DA47CA7E0DF1887A4FCFA8DEF75F8FC,30951,14,15,1,109.56208,18.25667,1761
93503,4DA47CA7E0DF1887A4FCFA8DEF75F8FC,31421,15,17,2,109.55382,18.22347,1705
93504,4DA47CA7E0DF1887A4FCFA8DEF75F8FC,31761,18,23,5,109.60521,18.27965,1914
93513,A952750F25C558E5C17B3EB7DD935431,60371,0,12,12,109.53063,18.30056,1618
93514,A952750F25C558E5C17B3EB7DD935431,31931,16,18,2,109.54771,18.29403,1667
93522,ABCD0851CC1C78BCD7AF6DBDF2F5DE49,60551,0,1,1,109.42722,18.30111,1218
93523,ABCD0851CC1C78BCD7AF6DBDF2F5DE49,30821,1,5,4,109.43681,18.33639,1274
93524,ABCD0851CC1C78BCD7AF6DBDF2F5DE49,60552,6,19,13,109.41729,18.30014,1218
93525,5E97A4561E11AAC4FBC53FD068EAA52B,30854,0,1,1,109.56889,18.27076,1763
93526,5E97A4561E11AAC4FBC53FD068EAA52B,60631,1,6,5,109.57778,18.27583,1814
93527,5E97A4561E11AAC4FBC53FD068EAA52B,30854,6,8,2,109.56889,18.27076,1763
93528,5E97A4561E11AAC4FBC53FD068EAA52B,30531,8,18,10,109.53271,18.21472,1604
93529,5E97A4561E11AAC4FBC53FD068EAA52B,30854,19,21,2,109.56889,18.27076,1763
93536,D4C207A48CDA21DC9FBF47210897D49C,31261,20,23,3,109.51174,18.2466,1559
93537,15C6F0FDB0D12A4BF39783021C367350,38281,0,2,2,109.6525,18.23403,2057
93538,15C6F0FDB0D12A4BF39783021C367350,31321,2,7,5,109.63799,18.23201,2007
93539,15C6F0FDB0D12A4BF39783021C367350,31101,8,11,3,109.65389,18.23403,2057
93540,15C6F0FDB0D12A4BF39783021C367350,38281,15,17,2,109.6525,18.23403,2057
93541,15C6F0FDB0D12A4BF39783021C367350,30581,18,20,2,109.62257,18.24951,1959
93542,15C6F0FDB0D12A4BF39783021C367350,31101,20,22,2,109.65389,18.23403,2057
93568,E6541B4F346982101D887BAAF0315541,30854,0,1,1,109.56889,18.27076,1763
93569,E6541B4F346982101D887BAAF0315541,31931,1,2,1,109.54771,18.29403,1667
93570,E6541B4F346982101D887BAAF0315541,30854,4,5,1,109.56889,18.27076,1763
93571,E6541B4F346982101D887BAAF0315541,30232,5,7,2,109.6191,18.31701,1971
93572,E6541B4F346982101D887BAAF0315541,30854,12,14,2,109.56889,18.27076,1763
93573,E6541B4F346982101D887BAAF0315541,31561,15,17,2,109.56792,18.28479,1765
93574,E6541B4F346982101D887BAAF0315541,30854,18,19,1,109.56889,18.27076,1763
93579,D74E82C8588C75233DBA0141E4C07F1A,31251,0,10,10,109.18528,18.2975,317
93581,D74E82C8588C75233DBA0141E4C07F1A,31251,17,23,6,109.18528,18.2975,317
93593,37B1280251A3C52411E939549A58D078,38991,11,12,1,109.52681,18.30368,1618
93594,37B1280251A3C52411E939549A58D078,39183,12,23,11,109.55542,18.28208,1715
93609,8C84F1CB6E49AC2736E89C4CFE87B2BD,38094,16,17,1,109.45403,18.28778,1316
93610,8C84F1CB6E49AC2736E89C4CFE87B2BD,31391,19,23,4,109.50382,18.24285,1508
93630,7252A0F90E29EC78621699C082578EF7,31361,0,7,7,109.47417,18.28292,1415
93631,7252A0F90E29EC78621699C082578EF7,60111,12,13,1,109.72556,18.31924,2371
93632,7252A0F90E29EC78621699C082578EF7,60504,17,18,1,109.47917,18.28903,1416
93633,7252A0F90E29EC78621699C082578EF7,31361,21,23,2,109.47417,18.28292,1415
93735,6F25B46DE233F84CBE88187DB2427FA9,30201,0,6,6,109.4909,18.26465,1462
93736,6F25B46DE233F84CBE88187DB2427FA9,31021,7,8,1,109.49021,18.27,1463
93737,6F25B46DE233F84CBE88187DB2427FA9,30201,9,23,14,109.4909,18.26465,1462
93741,C75BC5F85072980078D1BA009D1D1AB7,31561,0,6,6,109.56792,18.28479,1765
93742,C75BC5F85072980078D1BA009D1D1AB7,39183,8,15,7,109.55542,18.28208,1715
93743,C75BC5F85072980078D1BA009D1D1AB7,31561,15,16,1,109.56792,18.28479,1765
93744,C75BC5F85072980078D1BA009D1D1AB7,39183,19,20,1,109.55542,18.28208,1715
93769,5426296000364EE32711CD0E73D782C8,30854,18,19,1,109.56889,18.27076,1763
93770,5426296000364EE32711CD0E73D782C8,31071,19,20,1,109.58257,18.28458,1815
93779,07015E22078E542DFD52967694C61F1D,30581,9,10,1,109.62257,18.24951,1959
93780,07015E22078E542DFD52967694C61F1D,31781,13,14,1,109.19847,18.2975,367
93781,07015E22078E542DFD52967694C61F1D,60054,16,17,1,109.3016,18.31229,770
93782,07015E22078E542DFD52967694C61F1D,60201,20,23,3,109.5041,18.2509,1510
93812,91EC74D2B208A10BECBB101C6735C578,38251,19,20,1,109.49618,18.25493,1510
93813,91EC74D2B208A10BECBB101C6735C578,31864,20,23,3,109.49014,18.28333,1465
93816,87C7A513DDAF08C0EAFDEC3998FDF6C5,30991,0,9,9,109.30847,18.44139,791
93817,87C7A513DDAF08C0EAFDEC3998FDF6C5,38754,13,15,2,109.74667,18.37382,2430
93818,87C7A513DDAF08C0EAFDEC3998FDF6C5,30991,18,23,5,109.30847,18.44139,791
93822,4995463B780282C9C030A19D9F49AEAC,31071,0,9,9,109.58257,18.28458,1815
93823,4995463B780282C9C030A19D9F49AEAC,30854,14,18,4,109.56889,18.27076,1763
93851,4E94ADAE7ABEB20EEFAF67519DFCC1BE,31081,0,8,8,109.44639,18.30181,1318
93852,4E94ADAE7ABEB20EEFAF67519DFCC1BE,31031,9,21,12,109.49979,18.25382,1510
93909,00FD2268DE6E83934D2916174E81532F,30764,0,2,2,109.45806,18.29486,1367
93910,00FD2268DE6E83934D2916174E81532F,30111,3,9,6,109.47583,18.30542,1419
93911,00FD2268DE6E83934D2916174E81532F,60472,11,15,4,109.46625,18.29542,1367
93912,00FD2268DE6E83934D2916174E81532F,30111,18,22,4,109.47583,18.30542,1419
93931,6F0540B756080DEA0630ADD22B34EFCA,30371,0,7,7,109.51,18.24771,1559
93932,6F0540B756080DEA0630ADD22B34EFCA,38801,8,17,9,109.51472,18.2584,1561
93933,6F0540B756080DEA0630ADD22B34EFCA,30421,18,19,1,109.50021,18.25861,1511
93934,6F0540B756080DEA0630ADD22B34EFCA,60201,19,21,2,109.5041,18.2509,1510
93935,6F0540B756080DEA0630ADD22B34EFCA,30371,21,23,2,109.51,18.24771,1559
93943,996C0D9500BF90CC0E7F5A04C49A464B,39183,0,7,7,109.55542,18.28208,1715
93944,996C0D9500BF90CC0E7F5A04C49A464B,31931,9,23,14,109.54771,18.29403,1667
93951,8C8DB7A18864109B823771C405E00B29,60351,0,6,6,109.58403,18.28958,1816
93952,8C8DB7A18864109B823771C405E00B29,30951,8,10,2,109.56208,18.25667,1761
93953,8C8DB7A18864109B823771C405E00B29,31421,12,14,2,109.55382,18.22347,1705
93954,8C8DB7A18864109B823771C405E00B29,30951,14,18,4,109.56208,18.25667,1761
93958,B340EDEF4A878E8DF5CBEC25E465EACE,31205,0,2,2,109.51111,18.23736,1557
93959,B340EDEF4A878E8DF5CBEC25E465EACE,30854,4,12,8,109.56889,18.27076,1763
93960,B340EDEF4A878E8DF5CBEC25E465EACE,31071,12,14,2,109.58257,18.28458,1815
93961,B340EDEF4A878E8DF5CBEC25E465EACE,30854,14,18,4,109.56889,18.27076,1763
94004,9FD9B533440DEDA093A3D6D9A5E4AA42,31945,0,10,10,109.58021,18.29403,1817
94005,9FD9B533440DEDA093A3D6D9A5E4AA42,30854,12,13,1,109.56889,18.27076,1763
94006,9FD9B533440DEDA093A3D6D9A5E4AA42,31071,15,17,2,109.58257,18.28458,1815
94007,9FD9B533440DEDA093A3D6D9A5E4AA42,30854,19,20,1,109.56889,18.27076,1763
94036,C860767955774E3494068CF38C009FB6,30711,14,16,2,109.50271,18.25347,1510
94037,C860767955774E3494068CF38C009FB6,60391,20,23,3,109.47667,18.28757,1416
94038,81877C19279066FF0F7BD49ABDF1498F,31571,0,8,8,109.61563,18.23326,1957
94039,81877C19279066FF0F7BD49ABDF1498F,38271,9,10,1,109.62632,18.23049,1956
94040,81877C19279066FF0F7BD49ABDF1498F,31571,11,12,1,109.61563,18.23326,1957
94041,81877C19279066FF0F7BD49ABDF1498F,38271,12,18,6,109.62632,18.23049,1956
94042,81877C19279066FF0F7BD49ABDF1498F,31571,18,19,1,109.61563,18.23326,1957
94043,81877C19279066FF0F7BD49ABDF1498F,38271,19,21,2,109.62632,18.23049,1956
94064,7334BFE245C0E1675EC3C07645407CF3,30661,0,2,2,109.37028,18.24361,1008
94065,7334BFE245C0E1675EC3C07645407CF3,60411,4,6,2,109.32514,18.30854,869
94066,7334BFE245C0E1675EC3C07645407CF3,30661,7,15,8,109.37028,18.24361,1008
94067,7334BFE245C0E1675EC3C07645407CF3,60411,19,21,2,109.32514,18.30854,869
94083,662D882A6A10D0E6C3566690F0A40636,31071,18,19,1,109.58257,18.28458,1815
94084,662D882A6A10D0E6C3566690F0A40636,30854,21,22,1,109.56889,18.27076,1763
94092,35C6EDC8AAC6B5ABA770190223528BA2,31061,0,7,7,109.53333,18.23257,1607
94093,35C6EDC8AAC6B5ABA770190223528BA2,60211,12,13,1,109.63549,18.26049,2011
94094,A9A791307A5B7D4473ED005FB1373B0C,38111,16,17,1,109.52007,18.22403,1555
94095,A9A791307A5B7D4473ED005FB1373B0C,60081,19,20,1,109.51097,18.22639,1556
94096,4FBCB285D931FD2B95794D1337FFA573,31351,20,21,1,109.4959,18.28417,1465
94097,4FBCB285D931FD2B95794D1337FFA573,48574,22,23,1,109.48931,18.28458,1465
94103,096D8D59612F82CD076740A6D0A18387,31181,0,6,6,109.50382,18.24813,1509
94104,096D8D59612F82CD076740A6D0A18387,31781,9,11,2,109.19847,18.2975,367
94105,096D8D59612F82CD076740A6D0A18387,60201,12,13,1,109.5041,18.2509,1510
94106,096D8D59612F82CD076740A6D0A18387,60221,19,20,1,109.52569,18.29188,1616
94107,096D8D59612F82CD076740A6D0A18387,60201,21,23,2,109.5041,18.2509,1510
94112,D9791177063A443C55FA7ED4CB011C40,31071,0,3,3,109.58257,18.28458,1815
94113,D9791177063A443C55FA7ED4CB011C40,30891,4,5,1,109.59431,18.28389,1865
94144,E2CFBC4AD8BA700D32898ABFA9A0C849,30191,0,1,1,109.50361,18.22701,1506
94145,E2CFBC4AD8BA700D32898ABFA9A0C849,30854,2,20,18,109.56889,18.27076,1763
94151,B43DB539B5964E15F0064080164C40C1,60631,0,8,8,109.57778,18.27583,1814
94152,B43DB539B5964E15F0064080164C40C1,38052,10,15,5,109.62618,18.23042,1956
94153,B43DB539B5964E15F0064080164C40C1,60631,19,20,1,109.57778,18.27583,1814
94154,B43DB539B5964E15F0064080164C40C1,30854,21,22,1,109.56889,18.27076,1763
94168,1C9FB52F3215AC60A67CACDC4AFA4355,60411,0,8,8,109.32514,18.30854,869
94169,1C9FB52F3215AC60A67CACDC4AFA4355,30901,8,20,12,109.27597,18.3134,670
94177,C7DDA9E77F8C62BD8452CDC497E27C81,39091,14,16,2,109.50097,18.25222,1510
94178,C7DDA9E77F8C62BD8452CDC497E27C81,30511,16,23,7,109.51069,18.24208,1558
94180,AE9453D604AF88F4293DEF99463B2345,31021,8,9,1,109.49021,18.27,1463
94181,AE9453D604AF88F4293DEF99463B2345,30809,11,14,3,109.4891,18.28229,1465
94182,AE9453D604AF88F4293DEF99463B2345,30721,16,17,1,109.51597,18.28257,1565
94228,FB69127E95B4D9EC5AF61282F8D7EEB7,31071,2,6,4,109.58257,18.28458,1815
94229,FB69127E95B4D9EC5AF61282F8D7EEB7,30854,7,8,1,109.56889,18.27076,1763
94230,FB69127E95B4D9EC5AF61282F8D7EEB7,30921,11,12,1,109.53903,18.29451,1667
94231,FB69127E95B4D9EC5AF61282F8D7EEB7,30854,12,22,10,109.56889,18.27076,1763
94236,0E0D6E55BB1995EBF85F6B7AA8765E55,60631,16,17,1,109.57778,18.27583,1814
94237,0E0D6E55BB1995EBF85F6B7AA8765E55,30854,21,22,1,109.56889,18.27076,1763
94264,C89001997385112DD8652171E248C7E4,31471,14,16,2,109.34583,18.29563,917
94265,C89001997385112DD8652171E248C7E4,30354,17,18,1,109.42813,18.29076,1216
94282,9BF5426DFC0160A2D3B0FE19AE17D04F,30611,0,18,18,109.74958,18.40188,2485
94283,9BF5426DFC0160A2D3B0FE19AE17D04F,30101,22,23,1,109.57299,18.33333,1773
94287,C1F9914EF577AE2A8300B1A3945A50FF,30851,4,20,16,109.5616,18.27396,1713
94288,C1F9914EF577AE2A8300B1A3945A50FF,31561,21,22,1,109.56792,18.28479,1765
94293,13D237E410EAFBC4C2D6799D5A976ACC,31303,0,7,7,109.15826,18.29549,217
94294,13D237E410EAFBC4C2D6799D5A976ACC,31091,8,10,2,109.41201,18.31222,1170
94295,13D237E410EAFBC4C2D6799D5A976ACC,31101,13,14,1,109.65389,18.23403,2057
94364,DC0EB400EA24BEE9EB39D315B0E6AEF0,31701,0,7,7,109.44132,18.28833,1266
94365,DC0EB400EA24BEE9EB39D315B0E6AEF0,31431,8,9,1,109.44639,18.29042,1316
94366,DC0EB400EA24BEE9EB39D315B0E6AEF0,60381,10,11,1,109.5241,18.22458,1605
94379,3968C9A12C216FF93EDF454D44490440,30854,1,6,5,109.56889,18.27076,1763
94380,3968C9A12C216FF93EDF454D44490440,30951,9,10,1,109.56208,18.25667,1761
94381,3968C9A12C216FF93EDF454D44490440,31421,11,13,2,109.55382,18.22347,1705
94382,3968C9A12C216FF93EDF454D44490440,30851,18,23,5,109.5616,18.27396,1713
94383,9FEA4B85EAE4FAEE1CAF0EABFF2FAEA1,31561,6,7,1,109.56792,18.28479,1765
94384,9FEA4B85EAE4FAEE1CAF0EABFF2FAEA1,39183,9,11,2,109.55542,18.28208,1715
94385,9FEA4B85EAE4FAEE1CAF0EABFF2FAEA1,31561,16,23,7,109.56792,18.28479,1765
94430,D076CF507E3E56063777BA96227D5E4D,60101,0,8,8,109.75465,18.40139,2485
94465,94C4D5691F7DFC1AB38806AFFAC1389E,31931,0,9,9,109.54771,18.29403,1667
94466,94C4D5691F7DFC1AB38806AFFAC1389E,39101,12,18,6,109.50132,18.24931,1509
94467,94C4D5691F7DFC1AB38806AFFAC1389E,30921,22,23,1,109.53903,18.29451,1667
94493,9FC721E86703223349C05C95FE4BBB6F,60081,1,10,9,109.51097,18.22639,1556
94494,9FC721E86703223349C05C95FE4BBB6F,31521,11,20,9,109.51458,18.22542,1555
94495,9FC721E86703223349C05C95FE4BBB6F,60087,21,23,2,109.50688,18.22299,1505
94524,3B61FEBF5683B498FDAA439DDB94BF3B,60381,19,20,1,109.5241,18.22458,1605
94525,3B61FEBF5683B498FDAA439DDB94BF3B,30731,21,23,2,109.50944,18.22306,1555
94530,A68637AA89BD62624E677D9E66C32FAD,30161,0,12,12,109.50042,18.24389,1508
94531,A68637AA89BD62624E677D9E66C32FAD,31391,12,16,4,109.50382,18.24285,1508
94534,E4199729A84482014747EE1ECF3FF7D9,30701,0,6,6,109.59313,18.32007,1871
94535,E4199729A84482014747EE1ECF3FF7D9,30931,7,23,16,109.55653,18.32722,1722
94550,3C7B93BB0A27C1CE56C61B7C28661B4D,31521,0,9,9,109.51458,18.22542,1555
94551,3C7B93BB0A27C1CE56C61B7C28661B4D,39081,12,15,3,109.19382,18.29111,366
94552,3C7B93BB0A27C1CE56C61B7C28661B4D,31521,18,19,1,109.51458,18.22542,1555
94553,3C7B93BB0A27C1CE56C61B7C28661B4D,30211,20,21,1,109.49882,18.23931,1508
94554,3C7B93BB0A27C1CE56C61B7C28661B4D,31521,22,23,1,109.51458,18.22542,1555
94561,CFCFA94681CDD57855D6405C244168DD,38291,0,1,1,109.51618,18.24313,1558
94562,CFCFA94681CDD57855D6405C244168DD,60381,2,4,2,109.5241,18.22458,1605
94563,CFCFA94681CDD57855D6405C244168DD,31521,4,5,1,109.51458,18.22542,1555
94564,CFCFA94681CDD57855D6405C244168DD,38891,12,17,5,109.51486,18.24118,1558
94565,CFCFA94681CDD57855D6405C244168DD,30511,21,23,2,109.51069,18.24208,1558
94566,B5EEA30F2FFAABF51AE99311CDE9203E,39111,0,15,15,109.5191,18.22597,1555
94577,5C958E9FBADCA0FB00CA547ED9076A9C,60463,15,17,2,109.52507,18.22438,1605
94612,F5339F338C91A3D42D29DA47F2F626F1,60552,0,1,1,109.41729,18.30014,1218
94613,F5339F338C91A3D42D29DA47F2F626F1,60081,2,4,2,109.51097,18.22639,1556
94614,F5339F338C91A3D42D29DA47F2F626F1,60551,5,9,4,109.42722,18.30111,1218
94617,8554F0A178316702A9146AC053A2336A,31231,0,5,5,109.42597,18.29292,1217
94618,8554F0A178316702A9146AC053A2336A,60401,6,7,1,109.47444,18.27583,1414
94619,8554F0A178316702A9146AC053A2336A,60161,7,8,1,109.49174,18.26181,1461
94620,8554F0A178316702A9146AC053A2336A,31251,12,14,2,109.18528,18.2975,317
94621,8554F0A178316702A9146AC053A2336A,31031,14,16,2,109.49979,18.25382,1510
94622,8554F0A178316702A9146AC053A2336A,30421,16,17,1,109.50021,18.25861,1511
94623,8554F0A178316702A9146AC053A2336A,31231,20,21,1,109.42597,18.29292,1217
94679,E6F5FC1A2EE909681CFC0853089D56BB,31471,13,15,2,109.34583,18.29563,917
94680,E6F5FC1A2EE909681CFC0853089D56BB,60054,16,18,2,109.3016,18.31229,770
94681,E6F5FC1A2EE909681CFC0853089D56BB,60491,19,23,4,109.43354,18.30847,1269
94699,F0C8EDCD3FE95FB2FF48130C40BB6671,60054,8,9,1,109.3016,18.31229,770
94700,F0C8EDCD3FE95FB2FF48130C40BB6671,31571,9,10,1,109.61563,18.23326,1957
94701,F0C8EDCD3FE95FB2FF48130C40BB6671,31761,11,12,1,109.60521,18.27965,1914
94702,F0C8EDCD3FE95FB2FF48130C40BB6671,30101,12,14,2,109.57299,18.33333,1773
94703,F0C8EDCD3FE95FB2FF48130C40BB6671,60054,14,15,1,109.3016,18.31229,770
94704,F0C8EDCD3FE95FB2FF48130C40BB6671,31124,16,18,2,109.17069,18.35,276
94717,09BC7492AFAC79ACDD6C82A3AF49EFB0,60361,0,6,6,109.51938,18.29681,1567
94718,09BC7492AFAC79ACDD6C82A3AF49EFB0,60552,8,9,1,109.41729,18.30014,1218
94719,09BC7492AFAC79ACDD6C82A3AF49EFB0,30854,10,12,2,109.56889,18.27076,1763
94720,09BC7492AFAC79ACDD6C82A3AF49EFB0,60491,14,23,9,109.43354,18.30847,1269
94741,7108C89027EB031E7A5F6707D053C8A4,38061,0,7,7,109.50597,18.23118,1506
94742,7108C89027EB031E7A5F6707D053C8A4,30501,8,18,10,109.72,18.34951,2326
94743,7108C89027EB031E7A5F6707D053C8A4,38061,20,23,3,109.50597,18.23118,1506
94750,39997DEFFD87AA0C9D18E1194544E438,30854,0,18,18,109.56889,18.27076,1763
94751,39997DEFFD87AA0C9D18E1194544E438,30891,19,20,1,109.59431,18.28389,1865
94798,A31156C6519BD5D8AB23829D811E9C63,30361,0,15,15,109.50347,18.24,1508
94799,A31156C6519BD5D8AB23829D811E9C63,31041,15,18,3,109.50278,18.23701,1507
94800,A31156C6519BD5D8AB23829D811E9C63,30511,20,23,3,109.51069,18.24208,1558
94846,47A18820FDA9856131F74091D44B6BCB,31071,0,7,7,109.58257,18.28458,1815
94847,47A18820FDA9856131F74091D44B6BCB,31561,9,15,6,109.56792,18.28479,1765
94848,47A18820FDA9856131F74091D44B6BCB,30851,15,18,3,109.5616,18.27396,1713
94849,47A18820FDA9856131F74091D44B6BCB,31561,19,21,2,109.56792,18.28479,1765
94889,B663EE883B81AEB709AC84DCCEC3D38E,31945,1,8,7,109.58021,18.29403,1817
94890,B663EE883B81AEB709AC84DCCEC3D38E,30854,9,12,3,109.56889,18.27076,1763
94891,B663EE883B81AEB709AC84DCCEC3D38E,31945,13,14,1,109.58021,18.29403,1817
94892,B663EE883B81AEB709AC84DCCEC3D38E,30854,15,19,4,109.56889,18.27076,1763
94893,A9FCE0049DB44FE004EAFBF5B783F4A5,39091,18,20,2,109.50097,18.25222,1510
94894,A9FCE0049DB44FE004EAFBF5B783F4A5,39091,21,22,1,109.50097,18.25222,1510
94897,CCBF1BE99DA9F84ADB162A21804AB04F,39183,15,17,2,109.55542,18.28208,1715
94898,CCBF1BE99DA9F84ADB162A21804AB04F,60361,19,22,3,109.51938,18.29681,1567
94919,7F592F4B1327F7868A94B76F9B2A9CA1,39191,0,7,7,109.51493,18.23472,1557
94920,7F592F4B1327F7868A94B76F9B2A9CA1,31781,11,13,2,109.19847,18.2975,367
94921,7F592F4B1327F7868A94B76F9B2A9CA1,31201,18,20,2,109.51042,18.23819,1558
94922,7F592F4B1327F7868A94B76F9B2A9CA1,39191,20,21,1,109.51493,18.23472,1557
94923,7F592F4B1327F7868A94B76F9B2A9CA1,31201,21,23,2,109.51042,18.23819,1558
94945,83644E968E3567A6F84BB990AA7D4C72,31841,16,18,2,109.73201,18.33382,2373
94965,2CE19795F2549AFE8556FD3526787FA2,31561,16,18,2,109.56792,18.28479,1765
94966,2CE19795F2549AFE8556FD3526787FA2,31071,20,23,3,109.58257,18.28458,1815
94967,CD910BF673AA13391E641010B292AF0E,39154,0,6,6,109.50201,18.25681,1511
94968,CD910BF673AA13391E641010B292AF0E,31461,6,7,1,109.5091,18.25389,1510
94969,CD910BF673AA13391E641010B292AF0E,31471,10,12,2,109.34583,18.29563,917
94970,CD910BF673AA13391E641010B292AF0E,31781,14,16,2,109.19847,18.2975,367
94971,CD910BF673AA13391E641010B292AF0E,38094,17,19,2,109.45403,18.28778,1316
94974,12A0D13AED64522A8A0ABBA021E92F4C,31811,0,1,1,109.54201,18.31806,1671
94975,12A0D13AED64522A8A0ABBA021E92F4C,60361,1,9,8,109.51938,18.29681,1567
94976,12A0D13AED64522A8A0ABBA021E92F4C,30391,10,17,7,109.4975,18.27118,1513
94977,12A0D13AED64522A8A0ABBA021E92F4C,60361,18,23,5,109.51938,18.29681,1567
94981,84DF4A7C208235D171EF56473BCCF210,31561,4,6,2,109.56792,18.28479,1765
94982,84DF4A7C208235D171EF56473BCCF210,60631,8,18,10,109.57778,18.27583,1814
94983,84DF4A7C208235D171EF56473BCCF210,30851,22,23,1,109.5616,18.27396,1713
94996,015CDEB9169BCE5537ABAE49B6A63F2B,31071,5,7,2,109.58257,18.28458,1815
94997,015CDEB9169BCE5537ABAE49B6A63F2B,30854,8,17,9,109.56889,18.27076,1763
94998,015CDEB9169BCE5537ABAE49B6A63F2B,31071,18,20,2,109.58257,18.28458,1815
94999,015CDEB9169BCE5537ABAE49B6A63F2B,31945,22,23,1,109.58021,18.29403,1817
95017,43018FB39803E31509A90CB37A66655B,31561,1,2,1,109.56792,18.28479,1765
95018,43018FB39803E31509A90CB37A66655B,31945,3,6,3,109.58021,18.29403,1817
95019,43018FB39803E31509A90CB37A66655B,33051,9,14,5,109.6475,18.46618,2096
95020,43018FB39803E31509A90CB37A66655B,60221,18,21,3,109.52569,18.29188,1616
95023,A94F66C88B84FF0658441320CD9F667C,31071,0,16,16,109.58257,18.28458,1815
95024,A94F66C88B84FF0658441320CD9F667C,30854,16,18,2,109.56889,18.27076,1763
95040,7024F3A14F6F554DC6E80063E30315F0,30854,0,1,1,109.56889,18.27076,1763
95041,7024F3A14F6F554DC6E80063E30315F0,31561,2,6,4,109.56792,18.28479,1765
95042,7024F3A14F6F554DC6E80063E30315F0,39183,9,10,1,109.55542,18.28208,1715
95065,C316CE65034FB3C77BE459147CBF943A,60291,0,7,7,109.50826,18.24639,1509
95066,C316CE65034FB3C77BE459147CBF943A,30161,10,12,2,109.50042,18.24389,1508
95067,C316CE65034FB3C77BE459147CBF943A,30161,14,16,2,109.50042,18.24389,1508
95068,C316CE65034FB3C77BE459147CBF943A,30161,16,17,1,109.50042,18.24389,1508
95069,C316CE65034FB3C77BE459147CBF943A,60291,20,23,3,109.50826,18.24639,1509
95116,D6A345956751BA2ACC5430EDF68A104F,39181,14,15,1,109.55153,18.28035,1715
95117,D6A345956751BA2ACC5430EDF68A104F,31931,16,18,2,109.54771,18.29403,1667
95118,D6A345956751BA2ACC5430EDF68A104F,39181,19,23,4,109.55153,18.28035,1715
95155,C50EC98EBB3AD6F34D76F87C749DAC01,39181,0,10,10,109.55153,18.28035,1715
95156,C50EC98EBB3AD6F34D76F87C749DAC01,31931,14,16,2,109.54771,18.29403,1667
95157,C50EC98EBB3AD6F34D76F87C749DAC01,39181,17,18,1,109.55153,18.28035,1715
95158,C50EC98EBB3AD6F34D76F87C749DAC01,39181,18,23,5,109.55153,18.28035,1715
95161,0D00E0CA974DDA00224ACCD00B993468,30851,0,1,1,109.5616,18.27396,1713
95162,0D00E0CA974DDA00224ACCD00B993468,30854,2,3,1,109.56889,18.27076,1763
95163,0D00E0CA974DDA00224ACCD00B993468,30851,3,6,3,109.5616,18.27396,1713
95164,0D00E0CA974DDA00224ACCD00B993468,30854,7,10,3,109.56889,18.27076,1763
95165,0D00E0CA974DDA00224ACCD00B993468,31561,12,13,1,109.56792,18.28479,1765
95166,0D00E0CA974DDA00224ACCD00B993468,30854,16,18,2,109.56889,18.27076,1763
95167,0D00E0CA974DDA00224ACCD00B993468,30851,21,23,2,109.5616,18.27396,1713
95182,5D6F65BD095966D13536BBBA7220DB9D,60371,1,7,6,109.53063,18.30056,1618
95183,5D6F65BD095966D13536BBBA7220DB9D,30071,9,11,2,109.52819,18.30472,1619
95184,AEED1E225CF3D1399AAF76E61B9A21EB,38951,0,12,12,109.48097,18.28868,1416
95185,AEED1E225CF3D1399AAF76E61B9A21EB,38951,14,16,2,109.48097,18.28868,1416
95186,AEED1E225CF3D1399AAF76E61B9A21EB,38951,17,22,5,109.48097,18.28868,1416
95198,F00821368F615DCDAF214035D8EC4A44,30854,14,16,2,109.56889,18.27076,1763
95199,F00821368F615DCDAF214035D8EC4A44,60631,20,21,1,109.57778,18.27583,1814
95220,934029FB5F97BCE114EDCE88F0393A63,31071,0,6,6,109.58257,18.28458,1815
95221,934029FB5F97BCE114EDCE88F0393A63,30854,10,11,1,109.56889,18.27076,1763
95222,934029FB5F97BCE114EDCE88F0393A63,31071,12,14,2,109.58257,18.28458,1815
95223,934029FB5F97BCE114EDCE88F0393A63,30234,15,17,2,109.60681,18.29979,1918
95224,934029FB5F97BCE114EDCE88F0393A63,31031,18,20,2,109.49979,18.25382,1510
95225,934029FB5F97BCE114EDCE88F0393A63,30854,20,22,2,109.56889,18.27076,1763
95226,8D7B9451E0189947198D6AC9CE51CFEE,30761,0,2,2,109.45201,18.3,1318
95227,8D7B9451E0189947198D6AC9CE51CFEE,60261,2,3,1,109.44326,18.3075,1319
95228,8D7B9451E0189947198D6AC9CE51CFEE,31091,4,18,14,109.41201,18.31222,1170
95237,96F98526707B06BE1263CCD4F72E07A1,30854,8,17,9,109.56889,18.27076,1763
95238,96F98526707B06BE1263CCD4F72E07A1,31071,17,18,1,109.58257,18.28458,1815
95239,513924E5F8EAB458027327A1E2BAE9DB,31071,2,7,5,109.58257,18.28458,1815
95240,513924E5F8EAB458027327A1E2BAE9DB,30854,8,23,15,109.56889,18.27076,1763
95249,D947D8D9432E18EA6A214259B6E2987E,60054,1,5,4,109.3016,18.31229,770
95250,D947D8D9432E18EA6A214259B6E2987E,30661,8,10,2,109.37028,18.24361,1008
95251,D947D8D9432E18EA6A214259B6E2987E,60411,12,18,6,109.32514,18.30854,869
95252,D947D8D9432E18EA6A214259B6E2987E,30661,19,23,4,109.37028,18.24361,1008
95253,335A7B1DE8538918FDA774EE3E402A76,30191,0,7,7,109.50361,18.22701,1506
95254,335A7B1DE8538918FDA774EE3E402A76,31521,7,13,6,109.51458,18.22542,1555
95255,335A7B1DE8538918FDA774EE3E402A76,30191,14,23,9,109.50361,18.22701,1506
95260,3EDEED23FD96D9ADA498E55D7B0F4A62,30281,0,7,7,109.50597,18.27583,1514
95261,3EDEED23FD96D9ADA498E55D7B0F4A62,31931,7,8,1,109.54771,18.29403,1667
95262,3EDEED23FD96D9ADA498E55D7B0F4A62,39183,11,13,2,109.55542,18.28208,1715
95263,24B9CD23EC5587BA3102D06F602ACE38,60171,0,6,6,109.51292,18.30694,1569
95264,24B9CD23EC5587BA3102D06F602ACE38,31561,7,8,1,109.56792,18.28479,1765
95265,24B9CD23EC5587BA3102D06F602ACE38,60171,8,11,3,109.51292,18.30694,1569
95266,24B9CD23EC5587BA3102D06F602ACE38,39183,12,13,1,109.55542,18.28208,1715
95267,24B9CD23EC5587BA3102D06F602ACE38,60171,13,21,8,109.51292,18.30694,1569
95286,D73D0E1690714CD7F442C709F67E4771,60361,0,6,6,109.51938,18.29681,1567
95287,D73D0E1690714CD7F442C709F67E4771,30851,8,9,1,109.5616,18.27396,1713
95288,D73D0E1690714CD7F442C709F67E4771,30951,12,15,3,109.56208,18.25667,1761
95289,D73D0E1690714CD7F442C709F67E4771,60361,19,23,4,109.51938,18.29681,1567
95321,A14C813C3E3A7182759DA822342505B5,31071,14,15,1,109.58257,18.28458,1815
95322,A14C813C3E3A7182759DA822342505B5,39183,18,23,5,109.55542,18.28208,1715
95329,F84D949DDCBF25D5530F771BC55E0B9D,61011,0,9,9,109.60653,18.19076,1900
95331,00E4BC24F22404A2FC4D45749054257A,31071,12,14,2,109.58257,18.28458,1815
95332,00E4BC24F22404A2FC4D45749054257A,60221,15,19,4,109.52569,18.29188,1616
95333,00E4BC24F22404A2FC4D45749054257A,30854,20,21,1,109.56889,18.27076,1763
95334,5EB38BD215239D8B45DDA43E874110D7,60641,0,7,7,109.53854,18.2359,1657
95345,07169E7114E4F14C073261BAAC0D4491,61011,1,3,2,109.60653,18.19076,1900
95347,07169E7114E4F14C073261BAAC0D4491,61011,19,23,4,109.60653,18.19076,1900
95355,6EF68F35CE79552C1164E70C67C72C02,30121,0,9,9,109.52861,18.27222,1613
95356,6EF68F35CE79552C1164E70C67C72C02,60031,10,11,1,109.49694,18.31632,1521
95357,6EF68F35CE79552C1164E70C67C72C02,30854,12,14,2,109.56889,18.27076,1763
95358,6EF68F35CE79552C1164E70C67C72C02,30121,17,23,6,109.52861,18.27222,1613
95373,6F590AF2C10C4B9F0F4E76B8E922550E,30854,15,19,4,109.56889,18.27076,1763
95374,6F590AF2C10C4B9F0F4E76B8E922550E,31945,21,23,2,109.58021,18.29403,1817
95424,8AE1DEDFE1A65A29B5153547EEA03A21,31071,1,7,6,109.58257,18.28458,1815
95425,8AE1DEDFE1A65A29B5153547EEA03A21,39183,9,20,11,109.55542,18.28208,1715
95430,9C1407835BC54BEBDB541F52E1DA1820,61011,14,23,9,109.60653,18.19076,1900
95512,8C3D244B6DAAE8C73F174808255E03C6,60011,0,1,1,109.48965,18.30222,1468
95513,8C3D244B6DAAE8C73F174808255E03C6,30111,3,11,8,109.47583,18.30542,1419
95514,8C3D244B6DAAE8C73F174808255E03C6,60011,12,13,1,109.48965,18.30222,1468
95515,8C3D244B6DAAE8C73F174808255E03C6,30764,14,15,1,109.45806,18.29486,1367
95516,8C3D244B6DAAE8C73F174808255E03C6,30111,15,17,2,109.47583,18.30542,1419
95517,8C3D244B6DAAE8C73F174808255E03C6,60011,21,23,2,109.48965,18.30222,1468
95523,0F082D992D3A79023540780AB4E5166C,61011,6,12,6,109.60653,18.19076,1900
95525,0F082D992D3A79023540780AB4E5166C,31071,18,20,2,109.58257,18.28458,1815
95526,0F082D992D3A79023540780AB4E5166C,61011,20,23,3,109.60653,18.19076,1900
95534,0A987E09994A8BF75281CD6678876931,30221,0,1,1,109.57833,18.20222,1802
95535,0A987E09994A8BF75281CD6678876931,30571,3,7,4,109.50243,18.21861,1504
95536,0A987E09994A8BF75281CD6678876931,30531,8,9,1,109.53271,18.21472,1604
95537,0A987E09994A8BF75281CD6678876931,30221,9,11,2,109.57833,18.20222,1802
95538,0A987E09994A8BF75281CD6678876931,31421,15,23,8,109.55382,18.22347,1705
95542,C054F0F1F6DF018C36D80DAC513476F7,60331,3,11,8,109.505,18.26507,1512
95543,C054F0F1F6DF018C36D80DAC513476F7,30151,11,12,1,109.50986,18.25083,1560
95544,C054F0F1F6DF018C36D80DAC513476F7,38754,13,15,2,109.74667,18.37382,2430
95545,C054F0F1F6DF018C36D80DAC513476F7,30151,16,18,2,109.50986,18.25083,1560
95551,47B1458A9E02196E213461CE7E46A4B3,31945,0,8,8,109.58021,18.29403,1817
95552,47B1458A9E02196E213461CE7E46A4B3,31071,12,14,2,109.58257,18.28458,1815
95553,47B1458A9E02196E213461CE7E46A4B3,30854,14,15,1,109.56889,18.27076,1763
95554,47B1458A9E02196E213461CE7E46A4B3,30711,17,18,1,109.50271,18.25347,1510
95555,47B1458A9E02196E213461CE7E46A4B3,31071,19,20,1,109.58257,18.28458,1815
95597,CCCD2290FB632A48009771412BE68ADD,31561,0,9,9,109.56792,18.28479,1765
95598,CCCD2290FB632A48009771412BE68ADD,30851,11,12,1,109.5616,18.27396,1713
95599,CCCD2290FB632A48009771412BE68ADD,31561,14,21,7,109.56792,18.28479,1765
95605,8799356B7181F28146A203E5F86C52F0,31351,0,9,9,109.4959,18.28417,1465
95606,8799356B7181F28146A203E5F86C52F0,38185,9,11,2,109.51333,18.27347,1563
95607,8799356B7181F28146A203E5F86C52F0,38834,12,13,1,109.47639,18.21146,1403
95613,73EAC1341C5005A58B26B1A52457F38B,39091,0,2,2,109.50097,18.25222,1510
95614,73EAC1341C5005A58B26B1A52457F38B,30161,2,17,15,109.50042,18.24389,1508
95636,99CBAA6A65A50998F0A10B72B36210E4,30271,0,1,1,109.49132,18.23153,1456
95637,99CBAA6A65A50998F0A10B72B36210E4,60231,2,18,16,109.49903,18.21972,1504
95638,99CBAA6A65A50998F0A10B72B36210E4,30271,19,20,1,109.49132,18.23153,1456
95650,84D09807769454188E86D49181B1B5D0,30421,0,8,8,109.50021,18.25861,1511
95651,84D09807769454188E86D49181B1B5D0,31145,10,15,5,109.20431,18.30479,369
95652,84D09807769454188E86D49181B1B5D0,30421,17,18,1,109.50021,18.25861,1511
95653,84D09807769454188E86D49181B1B5D0,60571,21,22,1,109.50722,18.25056,1510
95654,7EBC20D0E5F0FBA046CA1D08E7FF47C1,60631,0,7,7,109.57778,18.27583,1814
95655,7EBC20D0E5F0FBA046CA1D08E7FF47C1,30854,8,15,7,109.56889,18.27076,1763
95695,3A429390E0D19C5F409E32660585ED7B,31931,5,19,14,109.54771,18.29403,1667
95709,E00EF22F493557E868E52C93194870CF,31945,5,6,1,109.58021,18.29403,1817
95710,E00EF22F493557E868E52C93194870CF,30854,8,19,11,109.56889,18.27076,1763
95711,E00EF22F493557E868E52C93194870CF,39111,19,20,1,109.5191,18.22597,1555
95853,76F6A54588C8DF7DDADFC50CAA11D44C,31071,6,7,1,109.58257,18.28458,1815
95854,76F6A54588C8DF7DDADFC50CAA11D44C,30854,9,11,2,109.56889,18.27076,1763
95855,76F6A54588C8DF7DDADFC50CAA11D44C,38085,15,19,4,109.6291,18.23625,2007
95865,BACB6801ACA2D5F4ABE5F40B34865F7A,31561,1,2,1,109.56792,18.28479,1765
95866,BACB6801ACA2D5F4ABE5F40B34865F7A,60631,4,7,3,109.57778,18.27583,1814
95867,BACB6801ACA2D5F4ABE5F40B34865F7A,30851,9,11,2,109.5616,18.27396,1713
95882,A55D4129A4D1B105629D337545083A9E,39183,5,6,1,109.55542,18.28208,1715
95883,A55D4129A4D1B105629D337545083A9E,31561,8,11,3,109.56792,18.28479,1765
95884,A55D4129A4D1B105629D337545083A9E,39183,13,18,5,109.55542,18.28208,1715
95885,A55D4129A4D1B105629D337545083A9E,31561,19,21,2,109.56792,18.28479,1765
95916,46C761D2C5BB3E9FC0E036B374FF60F4,30171,1,10,9,109.48458,18.27139,1463
95917,46C761D2C5BB3E9FC0E036B374FF60F4,30854,12,22,10,109.56889,18.27076,1763
95937,51061B3DE820AF1C1C713EF684728003,31071,0,8,8,109.58257,18.28458,1815
95938,51061B3DE820AF1C1C713EF684728003,30854,8,11,3,109.56889,18.27076,1763
95939,51061B3DE820AF1C1C713EF684728003,31071,12,14,2,109.58257,18.28458,1815
95940,51061B3DE820AF1C1C713EF684728003,30854,14,15,1,109.56889,18.27076,1763
95941,51061B3DE820AF1C1C713EF684728003,30221,16,17,1,109.57833,18.20222,1802
95942,51061B3DE820AF1C1C713EF684728003,30854,17,23,6,109.56889,18.27076,1763
95943,012ABD06F231728C214A4BA917E75B1C,31561,2,5,3,109.56792,18.28479,1765
95944,012ABD06F231728C214A4BA917E75B1C,30851,6,7,1,109.5616,18.27396,1713
95945,012ABD06F231728C214A4BA917E75B1C,31561,8,10,2,109.56792,18.28479,1765
95946,012ABD06F231728C214A4BA917E75B1C,30851,11,12,1,109.5616,18.27396,1713
95947,012ABD06F231728C214A4BA917E75B1C,31561,12,17,5,109.56792,18.28479,1765
95948,012ABD06F231728C214A4BA917E75B1C,30851,22,23,1,109.5616,18.27396,1713
95949,A8E9C7BB918ADAD29A3EA7ACDDCD32D7,38951,0,20,20,109.48097,18.28868,1416
95950,A8E9C7BB918ADAD29A3EA7ACDDCD32D7,38951,22,23,1,109.48097,18.28868,1416
95966,F07DEBB70735DF37AC0D6CB973B7F289,30161,13,16,3,109.50042,18.24389,1508
95967,F07DEBB70735DF37AC0D6CB973B7F289,31951,17,19,2,109.52174,18.30299,1568
95986,1980C8D409DE9551539224B3D393CDAA,30071,0,1,1,109.52819,18.30472,1619
95987,1980C8D409DE9551539224B3D393CDAA,31951,3,5,2,109.52174,18.30299,1568
95988,1980C8D409DE9551539224B3D393CDAA,30071,5,23,18,109.52819,18.30472,1619
96009,CA63110F88D6457AD774A164FA870244,60231,3,9,6,109.49903,18.21972,1504
96010,CA63110F88D6457AD774A164FA870244,30661,11,12,1,109.37028,18.24361,1008
96011,CA63110F88D6457AD774A164FA870244,60231,15,20,5,109.49903,18.21972,1504
96020,BEE3A0C9BB09D7F210E3490BED90A1BE,30791,0,5,5,109.72333,18.40889,2386
96021,BEE3A0C9BB09D7F210E3490BED90A1BE,30071,7,10,3,109.52819,18.30472,1619
96022,BEE3A0C9BB09D7F210E3490BED90A1BE,30071,11,12,1,109.52819,18.30472,1619
96023,BEE3A0C9BB09D7F210E3490BED90A1BE,60371,12,14,2,109.53063,18.30056,1618
96024,BEE3A0C9BB09D7F210E3490BED90A1BE,30071,19,22,3,109.52819,18.30472,1619
96037,A50885B0567921CDC52AB88137329206,39321,16,18,2,109.529,18.2167,1604
96038,A50885B0567921CDC52AB88137329206,60381,18,20,2,109.5241,18.22458,1605
96039,A50885B0567921CDC52AB88137329206,31521,21,23,2,109.51458,18.22542,1555
96066,BCF2A283AE0436F3C991D66E0EA13EC0,31534,0,2,2,109.49368,18.25806,1461
96067,BCF2A283AE0436F3C991D66E0EA13EC0,30771,3,7,4,109.49938,18.26042,1511
96068,BCF2A283AE0436F3C991D66E0EA13EC0,31531,8,9,1,109.49583,18.25972,1461
96069,BCF2A283AE0436F3C991D66E0EA13EC0,31471,12,13,1,109.34583,18.29563,917
96070,BCF2A283AE0436F3C991D66E0EA13EC0,31471,15,16,1,109.34583,18.29563,917
96071,BCF2A283AE0436F3C991D66E0EA13EC0,30771,17,20,3,109.49938,18.26042,1511
96072,BCF2A283AE0436F3C991D66E0EA13EC0,31534,21,23,2,109.49368,18.25806,1461
96073,372B6FDE38B899AE3F54A72097165114,39183,0,17,17,109.55542,18.28208,1715
96074,372B6FDE38B899AE3F54A72097165114,31561,17,18,1,109.56792,18.28479,1765
96075,372B6FDE38B899AE3F54A72097165114,39183,21,22,1,109.55542,18.28208,1715
96110,2AA430AFC7D9CDE5B5FC859F65FEFEA7,31521,12,15,3,109.51458,18.22542,1555
96111,2AA430AFC7D9CDE5B5FC859F65FEFEA7,30201,19,20,1,109.4909,18.26465,1462
96112,2AA430AFC7D9CDE5B5FC859F65FEFEA7,31521,21,23,2,109.51458,18.22542,1555
96126,81C892F4C735FEF892157743AFC50956,30201,20,21,1,109.4909,18.26465,1462
96127,81C892F4C735FEF892157743AFC50956,31021,22,23,1,109.49021,18.27,1463
96174,9915B6FF17BD3BF50FFC7042D095278F,31851,11,15,4,109.71736,18.29007,2316
96175,9915B6FF17BD3BF50FFC7042D095278F,30854,19,20,1,109.56889,18.27076,1763
96185,2371AF49C13083A9B56BAFD9F258B46A,30721,1,7,6,109.51597,18.28257,1565
96186,2371AF49C13083A9B56BAFD9F258B46A,30341,10,17,7,109.3625,18.29167,966
96187,2371AF49C13083A9B56BAFD9F258B46A,30121,19,21,2,109.52861,18.27222,1613
96212,8752BC71725B50257436D50C6598F252,31071,0,6,6,109.58257,18.28458,1815
96213,8752BC71725B50257436D50C6598F252,30854,8,10,2,109.56889,18.27076,1763
96214,8752BC71725B50257436D50C6598F252,31071,12,13,1,109.58257,18.28458,1815
96215,8752BC71725B50257436D50C6598F252,30854,13,20,7,109.56889,18.27076,1763
96292,D4AA3869830031578B573FD0033C24A8,60371,2,8,6,109.53063,18.30056,1618
96293,D4AA3869830031578B573FD0033C24A8,31931,9,23,14,109.54771,18.29403,1667
96294,33A62A8066AF8B1342859DF4B906FBD2,30351,0,14,14,109.41701,18.29292,1217
96309,377A324496E54511961704972731A3D5,31821,0,8,8,109.51181,18.24924,1559
96310,377A324496E54511961704972731A3D5,39111,12,14,2,109.5191,18.22597,1555
96311,377A324496E54511961704972731A3D5,31391,16,18,2,109.50382,18.24285,1508
96312,377A324496E54511961704972731A3D5,30201,20,22,2,109.4909,18.26465,1462
96324,4639E7F597994307D62A7FF9CC65CC1D,31071,13,14,1,109.58257,18.28458,1815
96325,4639E7F597994307D62A7FF9CC65CC1D,30854,15,17,2,109.56889,18.27076,1763
96326,4639E7F597994307D62A7FF9CC65CC1D,31071,21,22,1,109.58257,18.28458,1815
96340,549FEB02FDCB1D950404939A4A6496A0,31931,0,6,6,109.54771,18.29403,1667
96371,89048436012E137B6C20E2880EE91E56,30201,0,8,8,109.4909,18.26465,1462
96391,1412BA3B65BC1A2354CCBE297098A0E1,31071,0,13,13,109.58257,18.28458,1815
96392,1412BA3B65BC1A2354CCBE297098A0E1,30854,15,21,6,109.56889,18.27076,1763
96393,1412BA3B65BC1A2354CCBE297098A0E1,31071,22,23,1,109.58257,18.28458,1815
96394,6D2A0FF2CE3C55DB71755FD38AD58190,31206,0,6,6,109.50819,18.23549,1507
96395,6D2A0FF2CE3C55DB71755FD38AD58190,31781,8,12,4,109.19847,18.2975,367
96396,6D2A0FF2CE3C55DB71755FD38AD58190,31201,16,17,1,109.51042,18.23819,1558
96397,6D2A0FF2CE3C55DB71755FD38AD58190,38094,17,19,2,109.45403,18.28778,1316
96398,6D2A0FF2CE3C55DB71755FD38AD58190,31206,20,23,3,109.50819,18.23549,1507
96421,A2698C501FCA00D8683EBFD8421BD0E5,31031,0,6,6,109.49979,18.25382,1510
96422,A2698C501FCA00D8683EBFD8421BD0E5,31021,11,23,12,109.49021,18.27,1463
96427,9AA959ED87D1ECC3053DED17290EFCBD,31561,4,6,2,109.56792,18.28479,1765
96428,9AA959ED87D1ECC3053DED17290EFCBD,39183,8,10,2,109.55542,18.28208,1715
96429,9AA959ED87D1ECC3053DED17290EFCBD,31561,10,11,1,109.56792,18.28479,1765
96430,9AA959ED87D1ECC3053DED17290EFCBD,30854,13,14,1,109.56889,18.27076,1763
96455,9EBFE19AEC38C3A6F47AE2D903294BAE,30854,0,15,15,109.56889,18.27076,1763
96456,9EBFE19AEC38C3A6F47AE2D903294BAE,31071,19,23,4,109.58257,18.28458,1815
96459,7890099D98AA300C5BF12527E7372DB0,60631,0,7,7,109.57778,18.27583,1814
96460,7890099D98AA300C5BF12527E7372DB0,30854,8,9,1,109.56889,18.27076,1763
96461,7890099D98AA300C5BF12527E7372DB0,31071,9,10,1,109.58257,18.28458,1815
96462,7890099D98AA300C5BF12527E7372DB0,60631,12,14,2,109.57778,18.27583,1814
96463,7890099D98AA300C5BF12527E7372DB0,30854,15,17,2,109.56889,18.27076,1763
96464,7890099D98AA300C5BF12527E7372DB0,60631,18,23,5,109.57778,18.27583,1814
96470,C1F80FD61770F46AF18F3BEF2B67E7ED,31551,0,8,8,109.55868,18.24222,1708
96471,C1F80FD61770F46AF18F3BEF2B67E7ED,30511,12,14,2,109.51069,18.24208,1558
96472,C1F80FD61770F46AF18F3BEF2B67E7ED,30251,18,19,1,109.50611,18.26653,1512
96473,C1F80FD61770F46AF18F3BEF2B67E7ED,31091,21,22,1,109.41201,18.31222,1170
96516,C2AA18BC64931E724BDFB06A100ECEC3,31521,3,10,7,109.51458,18.22542,1555
96517,C2AA18BC64931E724BDFB06A100ECEC3,31781,13,15,2,109.19847,18.2975,367
96518,C2AA18BC64931E724BDFB06A100ECEC3,60381,19,22,3,109.5241,18.22458,1605
96538,C6FE4CF0CD47303AD7F7EC5A71315B10,31391,17,19,2,109.50382,18.24285,1508
96539,C6FE4CF0CD47303AD7F7EC5A71315B10,39101,19,21,2,109.50132,18.24931,1509
96555,32D0EBFA645FCE8DAD65D018847E5043,30232,0,3,3,109.6191,18.31701,1971
96556,32D0EBFA645FCE8DAD65D018847E5043,31071,3,5,2,109.58257,18.28458,1815
96557,32D0EBFA645FCE8DAD65D018847E5043,30232,6,7,1,109.6191,18.31701,1971
96558,32D0EBFA645FCE8DAD65D018847E5043,30854,10,23,13,109.56889,18.27076,1763
96609,765E065B95790AB69D4C7204094FCA10,31071,0,6,6,109.58257,18.28458,1815
96610,765E065B95790AB69D4C7204094FCA10,30854,6,8,2,109.56889,18.27076,1763
96611,765E065B95790AB69D4C7204094FCA10,31071,10,20,10,109.58257,18.28458,1815
96612,BBE4D8242EE46AE73AD69A56A00F4408,30201,9,10,1,109.4909,18.26465,1462
96613,BBE4D8242EE46AE73AD69A56A00F4408,31271,12,16,4,109.48958,18.26257,1462
96614,BBE4D8242EE46AE73AD69A56A00F4408,31021,18,19,1,109.49021,18.27,1463
96615,BBE4D8242EE46AE73AD69A56A00F4408,30201,19,23,4,109.4909,18.26465,1462
96623,40285EE8CCE25C38988EC087545664EC,31071,1,7,6,109.58257,18.28458,1815
96624,40285EE8CCE25C38988EC087545664EC,30854,7,20,13,109.56889,18.27076,1763
96625,40285EE8CCE25C38988EC087545664EC,31071,20,21,1,109.58257,18.28458,1815
96628,8476D98176DA2968291F6BE79BE2B5AE,38903,0,6,6,109.39229,18.29243,1117
96629,8476D98176DA2968291F6BE79BE2B5AE,30854,8,9,1,109.56889,18.27076,1763
96630,8476D98176DA2968291F6BE79BE2B5AE,31071,14,15,1,109.58257,18.28458,1815
96631,8476D98176DA2968291F6BE79BE2B5AE,30854,16,17,1,109.56889,18.27076,1763
96632,8476D98176DA2968291F6BE79BE2B5AE,30271,21,22,1,109.49132,18.23153,1456
96686,00262F856825A94933CC2BDE5C3D9737,31421,0,9,9,109.55382,18.22347,1705
96687,00262F856825A94933CC2BDE5C3D9737,60581,14,16,2,109.59785,18.29931,1868
96688,00262F856825A94933CC2BDE5C3D9737,30951,16,22,6,109.56208,18.25667,1761
96722,C8922FAF66F21ECAECB6B717FCD5A53B,60391,0,1,1,109.47667,18.28757,1416
96723,C8922FAF66F21ECAECB6B717FCD5A53B,60614,1,6,5,109.48799,18.29521,1467
96724,C8922FAF66F21ECAECB6B717FCD5A53B,30761,6,9,3,109.45201,18.3,1318
96725,C8922FAF66F21ECAECB6B717FCD5A53B,60614,12,13,1,109.48799,18.29521,1467
96726,C8922FAF66F21ECAECB6B717FCD5A53B,60504,14,17,3,109.47917,18.28903,1416
96727,C8922FAF66F21ECAECB6B717FCD5A53B,60391,18,19,1,109.47667,18.28757,1416
96734,7D1ED6067ECBD941EFC43CE0A6ADAE71,30854,0,2,2,109.56889,18.27076,1763
96735,7D1ED6067ECBD941EFC43CE0A6ADAE71,31945,2,6,4,109.58021,18.29403,1817
96736,7D1ED6067ECBD941EFC43CE0A6ADAE71,30854,7,19,12,109.56889,18.27076,1763
96737,7D1ED6067ECBD941EFC43CE0A6ADAE71,31945,20,21,1,109.58021,18.29403,1817
96738,7D1ED6067ECBD941EFC43CE0A6ADAE71,30854,21,23,2,109.56889,18.27076,1763
96739,95D72611B2EA258C315A6529F3A1698E,30854,1,3,2,109.56889,18.27076,1763
96740,95D72611B2EA258C315A6529F3A1698E,31071,4,12,8,109.58257,18.28458,1815
96741,95D72611B2EA258C315A6529F3A1698E,30854,13,15,2,109.56889,18.27076,1763
96771,30D8A678A1441E4FFDF2E3F44AE24060,31071,1,15,14,109.58257,18.28458,1815
96772,30D8A678A1441E4FFDF2E3F44AE24060,30854,19,21,2,109.56889,18.27076,1763
96833,564220533658012885D64AC3FDD81E22,31701,17,18,1,109.44132,18.28833,1266
96834,564220533658012885D64AC3FDD81E22,60641,21,23,2,109.53854,18.2359,1657
96858,104AF40065ED94F83A7A7970F3C770A2,31521,0,8,8,109.51458,18.22542,1555
96859,104AF40065ED94F83A7A7970F3C770A2,31471,9,12,3,109.34583,18.29563,917
96860,104AF40065ED94F83A7A7970F3C770A2,31145,14,15,1,109.20431,18.30479,369
96861,104AF40065ED94F83A7A7970F3C770A2,38754,18,19,1,109.74667,18.37382,2430
96873,D4F66FB71406E4E38A7A105B0CD3164D,30711,0,15,15,109.50271,18.25347,1510
96874,D4F66FB71406E4E38A7A105B0CD3164D,60381,15,16,1,109.5241,18.22458,1605
96875,D4F66FB71406E4E38A7A105B0CD3164D,30711,17,23,6,109.50271,18.25347,1510
96925,E75CF54BA14775FEDD26504F9F6B7365,30854,12,16,4,109.56889,18.27076,1763
96926,E75CF54BA14775FEDD26504F9F6B7365,31561,17,18,1,109.56792,18.28479,1765
96927,E75CF54BA14775FEDD26504F9F6B7365,31071,20,21,1,109.58257,18.28458,1815
96928,E75CF54BA14775FEDD26504F9F6B7365,31945,22,23,1,109.58021,18.29403,1817
96929,00FC332040A284DA251A8D0705989FE9,31071,9,17,8,109.58257,18.28458,1815
96930,00FC332040A284DA251A8D0705989FE9,30421,19,22,3,109.50021,18.25861,1511
96995,7AEB94813E5780CDA0309050B78B09DB,31781,10,12,2,109.19847,18.2975,367
96996,7AEB94813E5780CDA0309050B78B09DB,31521,15,16,1,109.51458,18.22542,1555
96997,7AEB94813E5780CDA0309050B78B09DB,38094,17,19,2,109.45403,18.28778,1316
96998,7AEB94813E5780CDA0309050B78B09DB,30181,21,23,2,109.51597,18.23313,1557
97005,C24CAAFE002C4A637E7D01C4B7549E3D,30271,0,6,6,109.49132,18.23153,1456
97008,C24CAAFE002C4A637E7D01C4B7549E3D,30271,13,23,10,109.49132,18.23153,1456
97040,2AE38FAF341950B0B91404FFCE5A0F3E,30921,7,17,10,109.53903,18.29451,1667
97041,2AE38FAF341950B0B91404FFCE5A0F3E,31931,20,22,2,109.54771,18.29403,1667
97047,39F25FE146A03325C93C111F2A943B6C,31945,0,13,13,109.58021,18.29403,1817
97048,39F25FE146A03325C93C111F2A943B6C,30854,14,20,6,109.56889,18.27076,1763
97049,39F25FE146A03325C93C111F2A943B6C,31945,22,23,1,109.58021,18.29403,1817
97050,58418A9EA4A7DC03127CB79C039A5185,31071,0,14,14,109.58257,18.28458,1815
97051,58418A9EA4A7DC03127CB79C039A5185,30711,18,21,3,109.50271,18.25347,1510
97095,9ECDB9C3F97E311C1827C02496967431,60371,0,12,12,109.53063,18.30056,1618
97096,9ECDB9C3F97E311C1827C02496967431,30701,17,22,5,109.59313,18.32007,1871
97120,77A63CEB987CF3B94BF0EF731BFDDB75,30731,0,5,5,109.50944,18.22306,1555
97121,77A63CEB987CF3B94BF0EF731BFDDB75,31521,8,10,2,109.51458,18.22542,1555
97122,77A63CEB987CF3B94BF0EF731BFDDB75,31521,11,13,2,109.51458,18.22542,1555
97123,77A63CEB987CF3B94BF0EF731BFDDB75,38111,14,16,2,109.52007,18.22403,1555
97124,77A63CEB987CF3B94BF0EF731BFDDB75,31521,17,18,1,109.51458,18.22542,1555
97125,77A63CEB987CF3B94BF0EF731BFDDB75,38071,20,21,1,109.40722,18.30938,1169
97133,A6C9F0B973397747F0214C9B247DCED3,31471,11,12,1,109.34583,18.29563,917
97134,1E36640BE395A4EE8CCB2697222419A5,60631,0,6,6,109.57778,18.27583,1814
97135,1E36640BE395A4EE8CCB2697222419A5,30854,7,10,3,109.56889,18.27076,1763
97136,1E36640BE395A4EE8CCB2697222419A5,31071,14,16,2,109.58257,18.28458,1815
97137,1E36640BE395A4EE8CCB2697222419A5,30854,18,19,1,109.56889,18.27076,1763
97140,14AE6C820CE45F96077630992CABD33D,30851,0,11,11,109.5616,18.27396,1713
97141,14AE6C820CE45F96077630992CABD33D,30951,11,13,2,109.56208,18.25667,1761
97142,14AE6C820CE45F96077630992CABD33D,31551,17,22,5,109.55868,18.24222,1708
97173,B34415F599F0ED7D1A073EE314A60B9B,60041,3,4,1,109.39889,18.31944,1121
97174,B34415F599F0ED7D1A073EE314A60B9B,31671,8,22,14,109.38965,18.29813,1068
97191,2C9F9127F2AECFBA8069624790D23C60,30771,0,6,6,109.49938,18.26042,1511
97205,0CD3A9451B945A7EABB5A7155C5317AC,60401,2,8,6,109.47444,18.27583,1414
97206,0CD3A9451B945A7EABB5A7155C5317AC,60161,9,10,1,109.49174,18.26181,1461
97207,0CD3A9451B945A7EABB5A7155C5317AC,31251,12,14,2,109.18528,18.2975,317
97208,0CD3A9451B945A7EABB5A7155C5317AC,30421,14,17,3,109.50021,18.25861,1511
97209,0CD3A9451B945A7EABB5A7155C5317AC,38251,18,19,1,109.49618,18.25493,1510
97242,EC4B90EDBF35256FDB4D4F8B87DB8A04,31071,2,7,5,109.58257,18.28458,1815
97243,EC4B90EDBF35256FDB4D4F8B87DB8A04,30854,8,16,8,109.56889,18.27076,1763
97244,EC4B90EDBF35256FDB4D4F8B87DB8A04,31071,20,22,2,109.58257,18.28458,1815
97250,E0A24740E2C54F3B77DB561A91D2BED7,30151,0,5,5,109.50986,18.25083,1560
97251,E0A24740E2C54F3B77DB561A91D2BED7,30251,8,17,9,109.50611,18.26653,1512
97252,E0A24740E2C54F3B77DB561A91D2BED7,30151,18,23,5,109.50986,18.25083,1560
97281,B5D993AEFE332BB553AF00D1A5E8D804,31031,0,12,12,109.49979,18.25382,1510
97282,B5D993AEFE332BB553AF00D1A5E8D804,60411,16,23,7,109.32514,18.30854,869
97333,0D69669D4DBC1CEB06269A084D86E853,30854,0,8,8,109.56889,18.27076,1763
97334,0D69669D4DBC1CEB06269A084D86E853,30581,9,19,10,109.62257,18.24951,1959
97335,0D69669D4DBC1CEB06269A084D86E853,60631,20,22,2,109.57778,18.27583,1814
97359,D6B53309590D99FCA390E7D5BEFA02F3,38331,3,11,8,109.62465,18.22736,1956
97360,D6B53309590D99FCA390E7D5BEFA02F3,60441,15,16,1,109.46792,18.28604,1366
97430,F613CC88D209D7DC1A4E289F7CE1FEAE,38951,0,10,10,109.48097,18.28868,1416
97431,F613CC88D209D7DC1A4E289F7CE1FEAE,30731,11,15,4,109.50944,18.22306,1555
97432,F613CC88D209D7DC1A4E289F7CE1FEAE,30861,18,19,1,109.52722,18.22743,1606
97486,EA446444DFE25212830F95291C13D19D,31931,0,6,6,109.54771,18.29403,1667
97487,EA446444DFE25212830F95291C13D19D,39181,8,9,1,109.55153,18.28035,1715
97488,EA446444DFE25212830F95291C13D19D,31931,12,20,8,109.54771,18.29403,1667
97504,D5EC7DA388CFD5E0C4727105FD53AF35,31471,13,15,2,109.34583,18.29563,917
97505,D5EC7DA388CFD5E0C4727105FD53AF35,60491,19,22,3,109.43354,18.30847,1269
97524,7D3290551DAEC31B514E4A342C73F8C1,60221,16,18,2,109.52569,18.29188,1616
97525,7D3290551DAEC31B514E4A342C73F8C1,60381,20,21,1,109.5241,18.22458,1605
97570,EB0FCA476C45C6CACE4A77D6A3C2F286,30661,12,14,2,109.37028,18.24361,1008
97571,EB0FCA476C45C6CACE4A77D6A3C2F286,60054,14,15,1,109.3016,18.31229,770
97572,EB0FCA476C45C6CACE4A77D6A3C2F286,30854,19,21,2,109.56889,18.27076,1763
97581,A630522B62E8A37999528F086521024C,30771,8,10,2,109.49938,18.26042,1511
97582,A630522B62E8A37999528F086521024C,31931,14,22,8,109.54771,18.29403,1667
97583,27229B6D41BD7CDDDAA38911093865DB,31071,3,4,1,109.58257,18.28458,1815
97584,27229B6D41BD7CDDDAA38911093865DB,38085,5,16,11,109.6291,18.23625,2007
97585,27229B6D41BD7CDDDAA38911093865DB,30854,18,23,5,109.56889,18.27076,1763
97597,14F1CC63CDA098F9694EAC8584B9C7A5,31561,3,7,4,109.56792,18.28479,1765
97598,14F1CC63CDA098F9694EAC8584B9C7A5,30854,8,11,3,109.56889,18.27076,1763
97599,14F1CC63CDA098F9694EAC8584B9C7A5,31561,12,13,1,109.56792,18.28479,1765
97600,14F1CC63CDA098F9694EAC8584B9C7A5,31071,13,15,2,109.58257,18.28458,1815
97601,14F1CC63CDA098F9694EAC8584B9C7A5,30854,16,18,2,109.56889,18.27076,1763
97618,E218C587552A5DADC05C4E69685FE374,39183,0,6,6,109.55542,18.28208,1715
97619,E218C587552A5DADC05C4E69685FE374,30854,8,20,12,109.56889,18.27076,1763
97620,E218C587552A5DADC05C4E69685FE374,39183,21,23,2,109.55542,18.28208,1715
97647,2AA3869C77C7C14130E5A08E136B3824,30661,11,13,2,109.37028,18.24361,1008
97666,C80166F5FFCB47450453FB0F444BF2BD,60311,0,7,7,109.52097,18.24319,1558
97667,C80166F5FFCB47450453FB0F444BF2BD,30181,9,12,3,109.51597,18.23313,1557
97668,C80166F5FFCB47450453FB0F444BF2BD,60311,13,14,1,109.52097,18.24319,1558
97669,C80166F5FFCB47450453FB0F444BF2BD,38291,18,20,2,109.51618,18.24313,1558
97670,C80166F5FFCB47450453FB0F444BF2BD,60311,21,23,2,109.52097,18.24319,1558
97674,C8501DFE42E6954852B7593EDA5D3099,31304,9,13,4,109.15903,18.32854,223
97675,C8501DFE42E6954852B7593EDA5D3099,60381,18,21,3,109.5241,18.22458,1605
97686,1D8B814EC83D52D7C5F3FED99C129EE0,30854,0,1,1,109.56889,18.27076,1763
97687,1D8B814EC83D52D7C5F3FED99C129EE0,60631,4,6,2,109.57778,18.27583,1814
97688,1D8B814EC83D52D7C5F3FED99C129EE0,30854,11,18,7,109.56889,18.27076,1763
97716,D02479913B5C50E5D55D6F7DB176A542,31931,12,19,7,109.54771,18.29403,1667
97717,D02479913B5C50E5D55D6F7DB176A542,39183,20,21,1,109.55542,18.28208,1715
97755,C28CDF8C9B6CD50A00572DC343140C65,31321,0,13,13,109.63799,18.23201,2007
97756,C28CDF8C9B6CD50A00572DC343140C65,30921,13,14,1,109.53903,18.29451,1667
97757,C28CDF8C9B6CD50A00572DC343140C65,31321,17,23,6,109.63799,18.23201,2007
97805,6876B785B3B8E427F5B0017E0B0EC706,60391,0,8,8,109.47667,18.28757,1416
97806,6876B785B3B8E427F5B0017E0B0EC706,30434,11,12,1,109.17083,18.35861,278
97807,6876B785B3B8E427F5B0017E0B0EC706,30111,12,14,2,109.47583,18.30542,1419
97833,2D115D52FDAB55086A12D742071FDFC9,30232,0,3,3,109.6191,18.31701,1971
97834,2D115D52FDAB55086A12D742071FDFC9,30854,3,13,10,109.56889,18.27076,1763
97835,2D115D52FDAB55086A12D742071FDFC9,30232,14,20,6,109.6191,18.31701,1971
97844,0C3DD1EABA2D708A2506DA8150CEC148,31561,0,6,6,109.56792,18.28479,1765
97845,0C3DD1EABA2D708A2506DA8150CEC148,30854,8,9,1,109.56889,18.27076,1763
97846,0C3DD1EABA2D708A2506DA8150CEC148,31561,11,13,2,109.56792,18.28479,1765
97847,0C3DD1EABA2D708A2506DA8150CEC148,30854,14,17,3,109.56889,18.27076,1763
97848,0C3DD1EABA2D708A2506DA8150CEC148,31561,18,22,4,109.56792,18.28479,1765
97875,E844868356E195B198CAAC9A1F9C6634,31301,13,14,1,109.14493,18.31222,170
97876,E844868356E195B198CAAC9A1F9C6634,31471,15,17,2,109.34583,18.29563,917
97877,E844868356E195B198CAAC9A1F9C6634,31081,18,23,5,109.44639,18.30181,1318
97886,29EC5157E5B1494DF69814EF16E86079,30581,11,12,1,109.62257,18.24951,1959
97887,29EC5157E5B1494DF69814EF16E86079,31471,16,18,2,109.34583,18.29563,917
97899,2F64FEF19C86AA0A8AA3E3FA37CC4F2D,30854,0,16,16,109.56889,18.27076,1763
97900,2F64FEF19C86AA0A8AA3E3FA37CC4F2D,60631,18,20,2,109.57778,18.27583,1814
97905,AB43182259122294244C13D6FC66D4A1,60631,0,6,6,109.57778,18.27583,1814
97906,AB43182259122294244C13D6FC66D4A1,30851,9,18,9,109.5616,18.27396,1713
97907,AB43182259122294244C13D6FC66D4A1,60631,19,21,2,109.57778,18.27583,1814
97934,036DFEF8CA623F9034F928149FE2468D,30821,0,3,3,109.43681,18.33639,1274
97935,036DFEF8CA623F9034F928149FE2468D,30651,4,10,6,109.42611,18.385,1232
97936,036DFEF8CA623F9034F928149FE2468D,30821,10,12,2,109.43681,18.33639,1274
97963,8C65C7C4D4426221B9BBF10610754805,38251,2,10,8,109.49618,18.25493,1510
97964,8C65C7C4D4426221B9BBF10610754805,31471,13,16,3,109.34583,18.29563,917
97965,8C65C7C4D4426221B9BBF10610754805,60524,19,21,2,109.42951,18.28993,1216
97966,8C65C7C4D4426221B9BBF10610754805,38251,21,22,1,109.49618,18.25493,1510
97974,FCFB14BA36BDB7CD6A39612B9AE933B2,39181,12,13,1,109.55153,18.28035,1715
97975,FCFB14BA36BDB7CD6A39612B9AE933B2,31931,14,15,1,109.54771,18.29403,1667
97976,FCFB14BA36BDB7CD6A39612B9AE933B2,38127,18,23,5,109.50833,18.27222,1513
97977,F8D799D9161B0143E0D71C40472A357E,30071,0,8,8,109.52819,18.30472,1619
97978,F8D799D9161B0143E0D71C40472A357E,30071,11,13,2,109.52819,18.30472,1619
97979,F8D799D9161B0143E0D71C40472A357E,30071,17,19,2,109.52819,18.30472,1619
97980,F8D799D9161B0143E0D71C40472A357E,30071,20,23,3,109.52819,18.30472,1619
98003,5EE25A6E7DD554FFDA0C9C1A504114B7,30221,0,18,18,109.57833,18.20222,1802
98004,5EE25A6E7DD554FFDA0C9C1A504114B7,60291,20,23,3,109.50826,18.24639,1509
98013,C0CA4E58B15F58D7F48B8BEF10CEB35A,30891,0,5,5,109.59431,18.28389,1865
98014,C0CA4E58B15F58D7F48B8BEF10CEB35A,60591,9,12,3,109.61118,18.21715,1904
98022,7BF65E5054DA81A230AB5423620158E1,60631,2,13,11,109.57778,18.27583,1814
98023,7BF65E5054DA81A230AB5423620158E1,31071,15,16,1,109.58257,18.28458,1815
98024,7BF65E5054DA81A230AB5423620158E1,30854,17,20,3,109.56889,18.27076,1763
98025,7BF65E5054DA81A230AB5423620158E1,60631,22,23,1,109.57778,18.27583,1814
98050,D1A5E6081E70F748BFD3C6895B141C01,30661,0,4,4,109.37028,18.24361,1008
98051,D1A5E6081E70F748BFD3C6895B141C01,60411,7,13,6,109.32514,18.30854,869
98052,D1A5E6081E70F748BFD3C6895B141C01,30661,13,18,5,109.37028,18.24361,1008
98053,D1A5E6081E70F748BFD3C6895B141C01,30901,19,20,1,109.27597,18.3134,670
98062,FCF69C4EB20A61D7801C0D8953A36537,31071,0,6,6,109.58257,18.28458,1815
98063,FCF69C4EB20A61D7801C0D8953A36537,30851,8,9,1,109.5616,18.27396,1713
98064,FCF69C4EB20A61D7801C0D8953A36537,31071,11,13,2,109.58257,18.28458,1815
98065,FCF69C4EB20A61D7801C0D8953A36537,30851,15,17,2,109.5616,18.27396,1713
98066,FCF69C4EB20A61D7801C0D8953A36537,31071,18,22,4,109.58257,18.28458,1815
98126,C58D0182BFC61ED113EE3B09763C30B2,38185,0,6,6,109.51333,18.27347,1563
98127,C58D0182BFC61ED113EE3B09763C30B2,38127,9,13,4,109.50833,18.27222,1513
98128,C58D0182BFC61ED113EE3B09763C30B2,30291,16,18,2,109.50403,18.27028,1513
98129,C58D0182BFC61ED113EE3B09763C30B2,30281,18,19,1,109.50597,18.27583,1514
98130,C58D0182BFC61ED113EE3B09763C30B2,38185,20,23,3,109.51333,18.27347,1563
98156,079A114D194FE2EFB0C89059CA4EBC03,31251,0,4,4,109.18528,18.2975,317
98158,079A114D194FE2EFB0C89059CA4EBC03,31251,15,19,4,109.18528,18.2975,317
98167,E3C1178CAC9A3E9411032B65DEB10C88,31021,0,8,8,109.49021,18.27,1463
98168,E3C1178CAC9A3E9411032B65DEB10C88,30171,8,13,5,109.48458,18.27139,1463
98202,299097E06448608D5CB166194604D1AB,60401,0,6,6,109.47444,18.27583,1414
98203,299097E06448608D5CB166194604D1AB,31031,8,9,1,109.49979,18.25382,1510
98204,299097E06448608D5CB166194604D1AB,30241,12,13,1,109.26174,18.3275,622
98213,2115670ECBCEFE4CA16C55F5204DF607,31761,0,5,5,109.60521,18.27965,1914
98214,2115670ECBCEFE4CA16C55F5204DF607,30854,7,16,9,109.56889,18.27076,1763
98250,A09B207C65A3863769CA2406970EB62C,31031,2,9,7,109.49979,18.25382,1510
98251,A09B207C65A3863769CA2406970EB62C,60054,11,13,2,109.3016,18.31229,770
98252,A09B207C65A3863769CA2406970EB62C,60381,17,21,4,109.5241,18.22458,1605
98255,E649CF84A26278291AA1A5B5C5D01FCA,30854,1,15,14,109.56889,18.27076,1763
98256,E649CF84A26278291AA1A5B5C5D01FCA,31561,17,18,1,109.56792,18.28479,1765
98257,284AAA7F5DD511A2BA368F86EB7F7C95,30171,0,1,1,109.48458,18.27139,1463
98258,284AAA7F5DD511A2BA368F86EB7F7C95,31021,4,6,2,109.49021,18.27,1463
98277,9FF85E4A9ADF25BDF242774543CAC5B0,31251,1,16,15,109.18528,18.2975,317
98278,9FF85E4A9ADF25BDF242774543CAC5B0,30781,17,18,1,109.3275,18.37847,881
98305,C6C3BC01E542B810EF853FEEB6C81198,60361,0,5,5,109.51938,18.29681,1567
98306,C6C3BC01E542B810EF853FEEB6C81198,60221,6,7,1,109.52569,18.29188,1616
98307,C6C3BC01E542B810EF853FEEB6C81198,60361,8,17,9,109.51938,18.29681,1567
98330,66A967284CA30127D78C6190FA59CDE5,30931,15,16,1,109.55653,18.32722,1722
98331,66A967284CA30127D78C6190FA59CDE5,31811,16,19,3,109.54201,18.31806,1671
98346,6C0260646767B781577B5B8CE2471E51,38484,7,8,1,109.53028,18.31528,1620
98347,6C0260646767B781577B5B8CE2471E51,38241,8,9,1,109.54111,18.30542,1669
98348,6C0260646767B781577B5B8CE2471E51,38484,12,15,3,109.53028,18.31528,1620
98377,23D7FC719D517701236EF9ECE32A2B81,31571,15,16,1,109.61563,18.23326,1957
98378,23D7FC719D517701236EF9ECE32A2B81,31461,20,23,3,109.5091,18.25389,1510
98381,8F6EA1C108FADA76A214A7ED71ECE3D1,30232,0,1,1,109.6191,18.31701,1971
98382,8F6EA1C108FADA76A214A7ED71ECE3D1,39183,2,5,3,109.55542,18.28208,1715
98383,8F6EA1C108FADA76A214A7ED71ECE3D1,30854,8,13,5,109.56889,18.27076,1763
98418,A1C95B17C868D553635D99A0D1B2A324,39041,0,9,9,109.40021,18.29278,1117
98419,A1C95B17C868D553635D99A0D1B2A324,31041,12,13,1,109.50278,18.23701,1507
98420,A0680D5ED0E388BA19F0AA347FA69FA3,30361,18,20,2,109.50347,18.24,1508
98421,A0680D5ED0E388BA19F0AA347FA69FA3,39091,20,23,3,109.50097,18.25222,1510
98432,63B5E489F3503F8EC6E40A38F9D2117C,31951,11,14,3,109.52174,18.30299,1568
98433,63B5E489F3503F8EC6E40A38F9D2117C,60361,15,16,1,109.51938,18.29681,1567
98434,63B5E489F3503F8EC6E40A38F9D2117C,60171,20,22,2,109.51292,18.30694,1569
98456,4BDDDFE5CA0514443B2B3ACDA26168C5,31551,15,16,1,109.55868,18.24222,1708
98457,4BDDDFE5CA0514443B2B3ACDA26168C5,39183,19,20,1,109.55542,18.28208,1715
98466,FAC035CAF00431CACD74AF53D18C4996,60011,1,6,5,109.48965,18.30222,1468
98467,FAC035CAF00431CACD74AF53D18C4996,30111,7,10,3,109.47583,18.30542,1419
98468,FAC035CAF00431CACD74AF53D18C4996,60011,12,13,1,109.48965,18.30222,1468
98469,FAC035CAF00431CACD74AF53D18C4996,30764,14,18,4,109.45806,18.29486,1367
98470,FAC035CAF00431CACD74AF53D18C4996,60011,19,23,4,109.48965,18.30222,1468
98496,CFFDD1BF3134B9FDD71614F40E1DE0FD,31561,3,4,1,109.56792,18.28479,1765
98497,CFFDD1BF3134B9FDD71614F40E1DE0FD,31071,4,10,6,109.58257,18.28458,1815
98498,CFFDD1BF3134B9FDD71614F40E1DE0FD,30161,12,14,2,109.50042,18.24389,1508
98499,CFFDD1BF3134B9FDD71614F40E1DE0FD,30421,15,16,1,109.50021,18.25861,1511
98500,CFFDD1BF3134B9FDD71614F40E1DE0FD,31071,18,21,3,109.58257,18.28458,1815
98504,CF23638AEC60DB02FD0EB5D279C2EB23,60054,13,15,2,109.3016,18.31229,770
98505,CF23638AEC60DB02FD0EB5D279C2EB23,60401,19,20,1,109.47444,18.27583,1414
98506,CF23638AEC60DB02FD0EB5D279C2EB23,60641,21,23,2,109.53854,18.2359,1657
98524,075F360F88180B9A93BF11A5704B49F3,30961,16,17,1,109.74042,18.37903,2431
98525,075F360F88180B9A93BF11A5704B49F3,31351,18,23,5,109.4959,18.28417,1465
98528,31D00DA149ED0F3AB2E104B2D0E7E9F8,31931,14,16,2,109.54771,18.29403,1667
98529,31D00DA149ED0F3AB2E104B2D0E7E9F8,31864,16,18,2,109.49014,18.28333,1465
98530,31D00DA149ED0F3AB2E104B2D0E7E9F8,31761,21,23,2,109.60521,18.27965,1914
98550,F2E4A1707C14AD7AF444AE9628A7C8BD,31531,17,18,1,109.49583,18.25972,1461
98551,F2E4A1707C14AD7AF444AE9628A7C8BD,30711,19,21,2,109.50271,18.25347,1510
98576,FE95B3A32EFBC2838F293DF38F55FDD1,39183,2,3,1,109.55542,18.28208,1715
98577,FE95B3A32EFBC2838F293DF38F55FDD1,31931,6,8,2,109.54771,18.29403,1667
98578,FE95B3A32EFBC2838F293DF38F55FDD1,31561,8,10,2,109.56792,18.28479,1765
98579,FE95B3A32EFBC2838F293DF38F55FDD1,31931,14,16,2,109.54771,18.29403,1667
98580,FE95B3A32EFBC2838F293DF38F55FDD1,31561,17,19,2,109.56792,18.28479,1765
98607,FD9120CA3F85D3F015CEFB66B9BF2F3D,30721,0,6,6,109.51597,18.28257,1565
98608,FD9120CA3F85D3F015CEFB66B9BF2F3D,60301,8,15,7,109.60715,18.30993,1919
98609,FD9120CA3F85D3F015CEFB66B9BF2F3D,38291,19,21,2,109.51618,18.24313,1558
98610,FD9120CA3F85D3F015CEFB66B9BF2F3D,30721,22,23,1,109.51597,18.28257,1565
98631,FC8552628F8A5A5219C1C30314657039,60661,0,8,8,109.548,18.2377,1657
98632,FC8552628F8A5A5219C1C30314657039,30271,9,11,2,109.49132,18.23153,1456
98633,FC8552628F8A5A5219C1C30314657039,39191,12,13,1,109.51493,18.23472,1557
98662,E8BAAF476E8FE57075BAB1A8D4FF1780,30232,5,7,2,109.6191,18.31701,1971
98663,E8BAAF476E8FE57075BAB1A8D4FF1780,30854,7,10,3,109.56889,18.27076,1763
98664,E8BAAF476E8FE57075BAB1A8D4FF1780,30232,12,13,1,109.6191,18.31701,1971
98665,E8BAAF476E8FE57075BAB1A8D4FF1780,30854,14,17,3,109.56889,18.27076,1763
98666,E8BAAF476E8FE57075BAB1A8D4FF1780,60631,19,21,2,109.57778,18.27583,1814
98727,408C4FED868686E7B96333835F4C4205,30854,0,11,11,109.56889,18.27076,1763
98728,408C4FED868686E7B96333835F4C4205,31071,14,22,8,109.58257,18.28458,1815
98803,2377954659CB8C9B4B8B2CCE299C9CD9,31431,9,10,1,109.44639,18.29042,1316
98804,2377954659CB8C9B4B8B2CCE299C9CD9,31471,11,14,3,109.34583,18.29563,917
98805,2377954659CB8C9B4B8B2CCE299C9CD9,31431,15,23,8,109.44639,18.29042,1316
98813,9EA825CA50A62195A51752F975FDCF57,31071,3,15,12,109.58257,18.28458,1815
98814,9EA825CA50A62195A51752F975FDCF57,30854,15,17,2,109.56889,18.27076,1763
98815,9EA825CA50A62195A51752F975FDCF57,31071,18,20,2,109.58257,18.28458,1815
98840,9B979E9430BCD0DDB6C78BBE525EBD2D,30854,8,12,4,109.56889,18.27076,1763
98841,9B979E9430BCD0DDB6C78BBE525EBD2D,60631,12,14,2,109.57778,18.27583,1814
98842,9B979E9430BCD0DDB6C78BBE525EBD2D,30854,15,22,7,109.56889,18.27076,1763
98848,E4C7AB656E412C7E33554D18277C9478,60201,20,21,1,109.5041,18.2509,1510
98849,E4C7AB656E412C7E33554D18277C9478,30421,22,23,1,109.50021,18.25861,1511
98862,C1793DCC823463513E28F999E76F9ADC,31471,13,18,5,109.34583,18.29563,917
98863,C1793DCC823463513E28F999E76F9ADC,60054,19,23,4,109.3016,18.31229,770
98941,CB5F007F76485F10B183BBAD16560B77,31521,0,7,7,109.51458,18.22542,1555
98942,CB5F007F76485F10B183BBAD16560B77,30661,12,13,1,109.37028,18.24361,1008
98943,CB5F007F76485F10B183BBAD16560B77,31521,17,20,3,109.51458,18.22542,1555
98944,CB5F007F76485F10B183BBAD16560B77,31521,21,23,2,109.51458,18.22542,1555
98961,7F632B4875B2736225CD6D350CD25670,31221,9,11,2,109.61333,18.26833,1913
98962,7F632B4875B2736225CD6D350CD25670,30854,14,22,8,109.56889,18.27076,1763
98966,7F632B4875B2736225CD6D350CD25670,31071,3,7,4,109.58257,18.28458,1815
98967,7F632B4875B2736225CD6D350CD25670,30854,9,20,11,109.56889,18.27076,1763
98972,145444E87E9AD1AA916406CE6DA79363,60594,14,16,2,109.62694,18.22799,1956
98973,145444E87E9AD1AA916406CE6DA79363,38052,16,19,3,109.62618,18.23042,1956
98974,145444E87E9AD1AA916406CE6DA79363,60594,22,23,1,109.62694,18.22799,1956
98992,1B6EBBFF3B9D8A3E18753343B6A29EAE,31071,0,13,13,109.58257,18.28458,1815
98993,1B6EBBFF3B9D8A3E18753343B6A29EAE,30851,14,18,4,109.5616,18.27396,1713
98994,1B6EBBFF3B9D8A3E18753343B6A29EAE,31071,21,23,2,109.58257,18.28458,1815
99056,68DBE0B52FD0AB95F1DD47068FD7847F,30181,0,11,11,109.51597,18.23313,1557
99057,68DBE0B52FD0AB95F1DD47068FD7847F,31031,11,13,2,109.49979,18.25382,1510
99058,68DBE0B52FD0AB95F1DD47068FD7847F,30181,13,21,8,109.51597,18.23313,1557
99059,6E2CBF10F3FC7D7D7BBE8854343B165A,31521,2,12,10,109.51458,18.22542,1555
99060,6E2CBF10F3FC7D7D7BBE8854343B165A,31521,17,23,6,109.51458,18.22542,1555
99074,1CC4F70EB8D0B0448C9D518105647173,31561,1,7,6,109.56792,18.28479,1765
99075,1CC4F70EB8D0B0448C9D518105647173,31071,8,11,3,109.58257,18.28458,1815
99076,1CC4F70EB8D0B0448C9D518105647173,30421,13,14,1,109.50021,18.25861,1511
99077,1CC4F70EB8D0B0448C9D518105647173,31561,18,20,2,109.56792,18.28479,1765
99078,1CC4F70EB8D0B0448C9D518105647173,30854,21,23,2,109.56889,18.27076,1763
99079,23AE593C8624C8825587FC4F2A6916C1,31081,0,7,7,109.44639,18.30181,1318
99089,74206C862E4BA6236E7F7978D63D1D7D,30854,0,1,1,109.56889,18.27076,1763
99090,74206C862E4BA6236E7F7978D63D1D7D,60631,1,2,1,109.57778,18.27583,1814
99091,74206C862E4BA6236E7F7978D63D1D7D,30854,4,23,19,109.56889,18.27076,1763
99105,22CF7007721E0F1D863F25E4633BE1AD,60311,0,6,6,109.52097,18.24319,1558
99106,22CF7007721E0F1D863F25E4633BE1AD,31151,8,10,2,109.75549,18.4191,2488
99107,22CF7007721E0F1D863F25E4633BE1AD,31861,12,13,1,109.49042,18.27549,1464
99108,22CF7007721E0F1D863F25E4633BE1AD,38291,14,16,2,109.51618,18.24313,1558
99109,22CF7007721E0F1D863F25E4633BE1AD,30381,19,23,4,109.52521,18.24507,1609
99142,2D8DAA5F24A7C71335ED6C7E0756CEA1,30711,0,7,7,109.50271,18.25347,1510
99143,2D8DAA5F24A7C71335ED6C7E0756CEA1,38251,9,10,1,109.49618,18.25493,1510
99144,2D8DAA5F24A7C71335ED6C7E0756CEA1,60291,12,15,3,109.50826,18.24639,1509
99145,2D8DAA5F24A7C71335ED6C7E0756CEA1,60381,19,20,1,109.5241,18.22458,1605
99200,CF1922E57BC1E2D5DC4336E820C48B77,30361,18,20,2,109.50347,18.24,1508
99201,CF1922E57BC1E2D5DC4336E820C48B77,60411,22,23,1,109.32514,18.30854,869
99208,066CC6CBB5ADF978A93AF5D0C3292806,60361,18,19,1,109.51938,18.29681,1567
99209,066CC6CBB5ADF978A93AF5D0C3292806,31931,22,23,1,109.54771,18.29403,1667
99218,0EA31DC24D5B7028E03AA286B0DB11EF,60631,8,9,1,109.57778,18.27583,1814
99219,0EA31DC24D5B7028E03AA286B0DB11EF,31071,13,14,1,109.58257,18.28458,1815
99220,0EA31DC24D5B7028E03AA286B0DB11EF,30854,15,16,1,109.56889,18.27076,1763
99221,0EA31DC24D5B7028E03AA286B0DB11EF,60631,16,17,1,109.57778,18.27583,1814
99222,0EA31DC24D5B7028E03AA286B0DB11EF,31071,20,21,1,109.58257,18.28458,1815
99225,5D5B29A994BBA3635D38463A75BE58F6,30201,0,12,12,109.4909,18.26465,1462
99226,5D5B29A994BBA3635D38463A75BE58F6,31471,13,17,4,109.34583,18.29563,917
99227,5D5B29A994BBA3635D38463A75BE58F6,31206,21,22,1,109.50819,18.23549,1507
99231,25BF6C9BAFD17B1DFC50AB9CDF5F4CEE,31821,20,23,3,109.51181,18.24924,1559
99263,10B66D855AEA437CF12F1E3706E70AE7,31521,0,7,7,109.51458,18.22542,1555
99264,10B66D855AEA437CF12F1E3706E70AE7,39111,8,10,2,109.5191,18.22597,1555
99265,10B66D855AEA437CF12F1E3706E70AE7,31521,14,16,2,109.51458,18.22542,1555
99266,10B66D855AEA437CF12F1E3706E70AE7,60291,18,19,1,109.50826,18.24639,1509
99267,10B66D855AEA437CF12F1E3706E70AE7,60381,22,23,1,109.5241,18.22458,1605
99295,B175A0347ABEEA30E818C5CCD25E280F,30821,0,15,15,109.43681,18.33639,1274
99296,B175A0347ABEEA30E818C5CCD25E280F,30651,18,20,2,109.42611,18.385,1232
99311,8CA8213586CAC00347DCD29330308F27,31931,0,14,14,109.54771,18.29403,1667
99312,8CA8213586CAC00347DCD29330308F27,30071,16,17,1,109.52819,18.30472,1619
99313,8CA8213586CAC00347DCD29330308F27,31931,20,21,1,109.54771,18.29403,1667
99389,5BDB0B1B9F95859E0A3FF07772D3E435,39154,0,6,6,109.50201,18.25681,1511
99390,5BDB0B1B9F95859E0A3FF07772D3E435,31931,8,10,2,109.54771,18.29403,1667
99391,5BDB0B1B9F95859E0A3FF07772D3E435,39181,10,12,2,109.55153,18.28035,1715
99392,5BDB0B1B9F95859E0A3FF07772D3E435,39181,13,15,2,109.55153,18.28035,1715
99393,5BDB0B1B9F95859E0A3FF07772D3E435,39181,17,19,2,109.55153,18.28035,1715
99394,7171A8398911756415ECFCDCF96F249B,30121,0,6,6,109.52861,18.27222,1613
99395,7171A8398911756415ECFCDCF96F249B,31421,8,10,2,109.55382,18.22347,1705
99396,7171A8398911756415ECFCDCF96F249B,30851,11,22,11,109.5616,18.27396,1713
99409,246EF4D95FA494895EFB2D649512DAE7,60081,0,6,6,109.51097,18.22639,1556
99411,246EF4D95FA494895EFB2D649512DAE7,61011,11,16,5,109.60653,18.19076,1900
99413,246EF4D95FA494895EFB2D649512DAE7,60081,20,22,2,109.51097,18.22639,1556
99441,080247CC19405F981D4BEFE1A1E9D339,39181,0,3,3,109.55153,18.28035,1715
99442,080247CC19405F981D4BEFE1A1E9D339,31931,3,4,1,109.54771,18.29403,1667
99443,080247CC19405F981D4BEFE1A1E9D339,39181,5,19,14,109.55153,18.28035,1715
99444,080247CC19405F981D4BEFE1A1E9D339,31931,21,23,2,109.54771,18.29403,1667
99479,19F803FB996471824A8A9928BBFAB433,39181,0,6,6,109.55153,18.28035,1715
99480,19F803FB996471824A8A9928BBFAB433,31931,7,16,9,109.54771,18.29403,1667
99481,19F803FB996471824A8A9928BBFAB433,39181,18,23,5,109.55153,18.28035,1715
99487,E6546ADDD2155B08063BE71A9EAB8C5E,60401,0,3,3,109.47444,18.27583,1414
99488,E6546ADDD2155B08063BE71A9EAB8C5E,31031,3,7,4,109.49979,18.25382,1510
99489,E6546ADDD2155B08063BE71A9EAB8C5E,38251,8,10,2,109.49618,18.25493,1510
99490,E6546ADDD2155B08063BE71A9EAB8C5E,33101,11,12,1,109.68438,18.44368,2242
99491,E6546ADDD2155B08063BE71A9EAB8C5E,38251,15,16,1,109.49618,18.25493,1510
99492,E6546ADDD2155B08063BE71A9EAB8C5E,30711,17,19,2,109.50271,18.25347,1510
99602,45FA8AF959A216E06C82392E21728E7F,31071,0,4,4,109.58257,18.28458,1815
99603,45FA8AF959A216E06C82392E21728E7F,31561,5,6,1,109.56792,18.28479,1765
99604,45FA8AF959A216E06C82392E21728E7F,30851,9,10,1,109.5616,18.27396,1713
99605,45FA8AF959A216E06C82392E21728E7F,31561,13,18,5,109.56792,18.28479,1765
99606,45FA8AF959A216E06C82392E21728E7F,30851,20,21,1,109.5616,18.27396,1713
99647,D4EE8E1A4C04A1FF0596E4221D0B8B42,31071,0,7,7,109.58257,18.28458,1815
99648,D4EE8E1A4C04A1FF0596E4221D0B8B42,30854,9,22,13,109.56889,18.27076,1763
99651,7803AECF4FFC2BF233E3B7ACD0D2E9F8,39181,0,11,11,109.55153,18.28035,1715
99652,7803AECF4FFC2BF233E3B7ACD0D2E9F8,31931,12,14,2,109.54771,18.29403,1667
99653,7803AECF4FFC2BF233E3B7ACD0D2E9F8,39181,18,23,5,109.55153,18.28035,1715
99673,5A888DC7A3AA300CC584D9862C5384A1,60221,1,7,6,109.52569,18.29188,1616
99674,5A888DC7A3AA300CC584D9862C5384A1,39183,11,18,7,109.55542,18.28208,1715
99675,5A888DC7A3AA300CC584D9862C5384A1,31261,21,22,1,109.51174,18.2466,1559
99700,45FC4D7B7AEB1BB8222449DDC064C06B,30854,7,9,2,109.56889,18.27076,1763
99701,45FC4D7B7AEB1BB8222449DDC064C06B,31945,9,11,2,109.58021,18.29403,1817
99702,45FC4D7B7AEB1BB8222449DDC064C06B,39091,13,15,2,109.50097,18.25222,1510
99703,45FC4D7B7AEB1BB8222449DDC064C06B,31945,18,23,5,109.58021,18.29403,1817
99717,97CE5C717545A1CABCE7AAB167BFAFA3,31521,0,9,9,109.51458,18.22542,1555
99718,97CE5C717545A1CABCE7AAB167BFAFA3,38951,10,12,2,109.48097,18.28868,1416
99719,97CE5C717545A1CABCE7AAB167BFAFA3,38951,12,15,3,109.48097,18.28868,1416
99720,97CE5C717545A1CABCE7AAB167BFAFA3,60221,16,18,2,109.52569,18.29188,1616
99721,97CE5C717545A1CABCE7AAB167BFAFA3,38951,21,23,2,109.48097,18.28868,1416
99733,8CF08DEE8EF83AC7333B837D79034776,38171,1,6,5,109.50799,18.28139,1515
99735,8CF08DEE8EF83AC7333B837D79034776,30721,18,23,5,109.51597,18.28257,1565
99785,8AE8113E56204E191324933EBCC0418D,30181,0,1,1,109.51597,18.23313,1557
99786,8AE8113E56204E191324933EBCC0418D,31206,2,3,1,109.50819,18.23549,1507
99787,8AE8113E56204E191324933EBCC0418D,30181,4,5,1,109.51597,18.23313,1557
99794,6733B324E753B6172A50174A4CB1E5C2,31251,0,4,4,109.18528,18.2975,317
99796,6733B324E753B6172A50174A4CB1E5C2,31251,11,17,6,109.18528,18.2975,317
99827,60089DFF68909103D9A6D1DCB7C683F5,31864,12,13,1,109.49014,18.28333,1465
99880,B55755EE77AAB7159A5530B30083F834,60411,0,1,1,109.32514,18.30854,869
99881,B55755EE77AAB7159A5530B30083F834,30661,2,4,2,109.37028,18.24361,1008
99882,B55755EE77AAB7159A5530B30083F834,31471,4,7,3,109.34583,18.29563,917
99883,B55755EE77AAB7159A5530B30083F834,30661,8,13,5,109.37028,18.24361,1008
99886,C17F2EF1DEA79C8C951E3013EE071B2C,31071,2,8,6,109.58257,18.28458,1815
99887,C17F2EF1DEA79C8C951E3013EE071B2C,60421,8,9,1,109.46333,18.31743,1371
99888,C17F2EF1DEA79C8C951E3013EE071B2C,31071,10,15,5,109.58257,18.28458,1815
99919,D91289410D46E2838A7CD67AF8E32DCF,39091,16,18,2,109.50097,18.25222,1510
99920,D91289410D46E2838A7CD67AF8E32DCF,38185,18,23,5,109.51333,18.27347,1563
99983,A9C7C0A15D485E40B43093FA63B4F0D5,31521,0,8,8,109.51458,18.22542,1555
100007,C358285726113434A30FBBA8DED710E7,60371,0,9,9,109.53063,18.30056,1618
100008,C358285726113434A30FBBA8DED710E7,30071,11,12,1,109.52819,18.30472,1619
100009,C358285726113434A30FBBA8DED710E7,31621,15,16,1,109.51035,18.29826,1568
100010,6B56111B79E5EDEBB9E11EFC0935D50B,60131,0,7,7,109.49819,18.24778,1509
100011,6B56111B79E5EDEBB9E11EFC0935D50B,31781,9,12,3,109.19847,18.2975,367
100012,6B56111B79E5EDEBB9E11EFC0935D50B,31031,16,20,4,109.49979,18.25382,1510
100013,6B56111B79E5EDEBB9E11EFC0935D50B,60131,20,23,3,109.49819,18.24778,1509
100063,A5CE8EC163B2D3DFB2CA8F669B7180D4,31531,14,15,1,109.49583,18.25972,1461
100064,A5CE8EC163B2D3DFB2CA8F669B7180D4,31861,16,17,1,109.49042,18.27549,1464
100065,A5CE8EC163B2D3DFB2CA8F669B7180D4,30151,18,23,5,109.50986,18.25083,1560
100071,24E98C0EC4A6054CC486A2611C493128,30854,2,5,3,109.56889,18.27076,1763
100072,24E98C0EC4A6054CC486A2611C493128,31071,6,8,2,109.58257,18.28458,1815
100073,24E98C0EC4A6054CC486A2611C493128,30854,8,9,1,109.56889,18.27076,1763
100081,8621CFDF1B89A83351494618C53D033F,31071,1,8,7,109.58257,18.28458,1815
100082,8621CFDF1B89A83351494618C53D033F,39181,8,10,2,109.55153,18.28035,1715
100083,8621CFDF1B89A83351494618C53D033F,39181,10,13,3,109.55153,18.28035,1715
100084,8621CFDF1B89A83351494618C53D033F,39181,15,23,8,109.55153,18.28035,1715
100094,93A3718C0EC450CC77C4756F930E9D7C,39151,7,9,2,109.49875,18.25097,1510
100095,93A3718C0EC450CC77C4756F930E9D7C,60161,9,10,1,109.49174,18.26181,1461
100096,93A3718C0EC450CC77C4756F930E9D7C,38251,10,12,2,109.49618,18.25493,1510
100097,93A3718C0EC450CC77C4756F930E9D7C,60401,17,19,2,109.47444,18.27583,1414
100098,93A3718C0EC450CC77C4756F930E9D7C,60291,20,21,1,109.50826,18.24639,1509
100160,F6A539AAED9AF63EFFEF4F07EA46DEF3,60054,14,16,2,109.3016,18.31229,770
100161,F6A539AAED9AF63EFFEF4F07EA46DEF3,60621,21,23,2,109.48354,18.27451,1464
100162,BE7763F8096EB5A037146E1CC4190538,30854,20,21,1,109.56889,18.27076,1763
100163,BE7763F8096EB5A037146E1CC4190538,31561,21,23,2,109.56792,18.28479,1765
100168,E8BE10EF1C0A6A216F7B6C008ED029A8,60371,0,8,8,109.53063,18.30056,1618
100169,E8BE10EF1C0A6A216F7B6C008ED029A8,31571,9,10,1,109.61563,18.23326,1957
100170,E8BE10EF1C0A6A216F7B6C008ED029A8,38991,12,13,1,109.52681,18.30368,1618
100171,E8BE10EF1C0A6A216F7B6C008ED029A8,60226,17,18,1,109.5175,18.28778,1566
100172,E8BE10EF1C0A6A216F7B6C008ED029A8,38251,19,21,2,109.49618,18.25493,1510
100177,5A52D514A004C406B3CAF14D74C40F10,30461,13,17,4,109.5116,18.26313,1562
100178,85C1BD53669C6AB80E634D25EC9D5396,30711,17,18,1,109.50271,18.25347,1510
100179,85C1BD53669C6AB80E634D25EC9D5396,30711,21,23,2,109.50271,18.25347,1510
100191,B76381FBDC68F2B2041DDEC63195F0A7,39181,11,18,7,109.55153,18.28035,1715
100192,B76381FBDC68F2B2041DDEC63195F0A7,39181,19,21,2,109.55153,18.28035,1715
100193,B76381FBDC68F2B2041DDEC63195F0A7,31931,21,22,1,109.54771,18.29403,1667
100245,8B3125BACE32612AE7F9DC5599DC75E6,31521,0,7,7,109.51458,18.22542,1555
100246,8B3125BACE32612AE7F9DC5599DC75E6,30661,9,17,8,109.37028,18.24361,1008
100247,8B3125BACE32612AE7F9DC5599DC75E6,60081,18,23,5,109.51097,18.22639,1556
100313,F3E280D806C0279BCC08880D6A71DAC7,31031,20,21,1,109.49979,18.25382,1510
100314,F3E280D806C0279BCC08880D6A71DAC7,60621,22,23,1,109.48354,18.27451,1464
100319,D34A34E9CA4518B994A07E07D99BC875,31471,12,14,2,109.34583,18.29563,917
100320,D34A34E9CA4518B994A07E07D99BC875,60054,14,15,1,109.3016,18.31229,770
100321,D34A34E9CA4518B994A07E07D99BC875,31231,18,19,1,109.42597,18.29292,1217
100322,D34A34E9CA4518B994A07E07D99BC875,30351,20,23,3,109.41701,18.29292,1217
100325,EB316856896788EC8FD871E122E95728,30931,0,6,6,109.55653,18.32722,1722
100326,EB316856896788EC8FD871E122E95728,31811,11,12,1,109.54201,18.31806,1671
100327,EB316856896788EC8FD871E122E95728,30701,12,16,4,109.59313,18.32007,1871
100328,EB316856896788EC8FD871E122E95728,31811,17,18,1,109.54201,18.31806,1671
100329,EB316856896788EC8FD871E122E95728,30701,19,20,1,109.59313,18.32007,1871
100334,8F3DE08315D720DC64DC898C5903196E,30854,6,15,9,109.56889,18.27076,1763
100335,8F3DE08315D720DC64DC898C5903196E,60631,17,18,1,109.57778,18.27583,1814
100336,74A9CCA48CD6C2DA9FC7DFDB8817D50B,30851,2,3,1,109.5616,18.27396,1713
100337,74A9CCA48CD6C2DA9FC7DFDB8817D50B,31945,3,5,2,109.58021,18.29403,1817
100338,74A9CCA48CD6C2DA9FC7DFDB8817D50B,31071,8,10,2,109.58257,18.28458,1815
100372,878FC5EBB1B28FAABA6E6BFD01664318,30251,0,16,16,109.50611,18.26653,1512
100373,878FC5EBB1B28FAABA6E6BFD01664318,31181,17,18,1,109.50382,18.24813,1509
100374,878FC5EBB1B28FAABA6E6BFD01664318,30251,21,23,2,109.50611,18.26653,1512
100404,3C6C31F30579C628F9EDFADEE409AE9F,60241,14,15,1,109.53319,18.28667,1616
100405,3C6C31F30579C628F9EDFADEE409AE9F,30071,17,18,1,109.52819,18.30472,1619
100406,3C6C31F30579C628F9EDFADEE409AE9F,30711,18,21,3,109.50271,18.25347,1510
100491,5D06B39D1C4AAC35B6AB826D6203C7C7,31031,12,14,2,109.49979,18.25382,1510
100492,5D06B39D1C4AAC35B6AB826D6203C7C7,60401,16,17,1,109.47444,18.27583,1414
100493,5D06B39D1C4AAC35B6AB826D6203C7C7,31031,18,20,2,109.49979,18.25382,1510
100494,5D06B39D1C4AAC35B6AB826D6203C7C7,60401,21,23,2,109.47444,18.27583,1414
100538,2DDF3A993BD69F79020EB97CF3A71819,38171,0,6,6,109.50799,18.28139,1515
100539,2DDF3A993BD69F79020EB97CF3A71819,30161,10,15,5,109.50042,18.24389,1508
100540,2DDF3A993BD69F79020EB97CF3A71819,30161,17,19,2,109.50042,18.24389,1508
100541,2DDF3A993BD69F79020EB97CF3A71819,38171,21,23,2,109.50799,18.28139,1515
100544,632A9EB46E40EB8DE8C99AAD5A0CDFB2,30221,0,13,13,109.57833,18.20222,1802
100545,632A9EB46E40EB8DE8C99AAD5A0CDFB2,30854,14,15,1,109.56889,18.27076,1763
100546,632A9EB46E40EB8DE8C99AAD5A0CDFB2,30221,18,23,5,109.57833,18.20222,1802
100570,8EA475D017A01807E97E34F719EA95E4,30361,12,14,2,109.50347,18.24,1508
100571,8EA475D017A01807E97E34F719EA95E4,38315,15,17,2,109.48979,18.29764,1467
100581,C9D18F84DE09060EAAE7ED1445E46CDD,30771,1,2,1,109.49938,18.26042,1511
100582,C9D18F84DE09060EAAE7ED1445E46CDD,30911,2,9,7,109.50493,18.26181,1511
100583,C9D18F84DE09060EAAE7ED1445E46CDD,31351,12,14,2,109.4959,18.28417,1465
100584,EBD16061EA20EE33D9344D33735E5205,38891,0,6,6,109.51486,18.24118,1558
100585,EBD16061EA20EE33D9344D33735E5205,31201,11,13,2,109.51042,18.23819,1558
100586,EBD16061EA20EE33D9344D33735E5205,38291,14,17,3,109.51618,18.24313,1558
100602,34A1BA5A97F90C4ABB34EDC7004774A9,30851,0,17,17,109.5616,18.27396,1713
100603,34A1BA5A97F90C4ABB34EDC7004774A9,39371,19,21,2,109.56627,18.2646,1762
100612,5A848609D5F7F3D6FA074D3A44427904,30671,0,7,7,109.43611,18.30139,1268
100613,5A848609D5F7F3D6FA074D3A44427904,30321,7,9,2,109.49563,18.29611,1467
100633,4C18D34133535C99A4487BE59B40CD43,31421,0,7,7,109.55382,18.22347,1705
100634,4C18D34133535C99A4487BE59B40CD43,31781,9,11,2,109.19847,18.2975,367
100635,4C18D34133535C99A4487BE59B40CD43,31471,14,15,1,109.34583,18.29563,917
100688,92F9F53206FAF7EB9CC354C3DBB7190F,38212,0,8,8,109.48889,18.26306,1462
100689,92F9F53206FAF7EB9CC354C3DBB7190F,30851,11,13,2,109.5616,18.27396,1713
100690,92F9F53206FAF7EB9CC354C3DBB7190F,31561,14,15,1,109.56792,18.28479,1765
100691,92F9F53206FAF7EB9CC354C3DBB7190F,30361,19,20,1,109.50347,18.24,1508
100692,92F9F53206FAF7EB9CC354C3DBB7190F,38212,21,23,2,109.48889,18.26306,1462
100705,2F440A235E684ECEDD042B3100A4AE95,31071,0,7,7,109.58257,18.28458,1815
100706,2F440A235E684ECEDD042B3100A4AE95,30854,9,15,6,109.56889,18.27076,1763
100707,2F440A235E684ECEDD042B3100A4AE95,31561,18,19,1,109.56792,18.28479,1765
100718,0607630771850E9B096589D3130ADE6B,60631,18,19,1,109.57778,18.27583,1814
100728,ACDEAAF45B65DE48CF80A48DBD3C775E,30854,10,21,11,109.56889,18.27076,1763
100729,ACDEAAF45B65DE48CF80A48DBD3C775E,31071,21,23,2,109.58257,18.28458,1815
100734,CA0CAB48AE6A9854AFA11ACF88A2CB9C,30281,16,17,1,109.50597,18.27583,1514
100735,CA0CAB48AE6A9854AFA11ACF88A2CB9C,30281,20,23,3,109.50597,18.27583,1514
100744,A0F32304B8707E330B50C46F2DA1FB4F,31561,1,6,5,109.56792,18.28479,1765
100745,A0F32304B8707E330B50C46F2DA1FB4F,30854,7,9,2,109.56889,18.27076,1763
100778,3ED95B3B7DE39D1CC7F37C685EFCA5A0,31781,10,11,1,109.19847,18.2975,367
100779,3ED95B3B7DE39D1CC7F37C685EFCA5A0,31471,15,16,1,109.34583,18.29563,917
100780,3ED95B3B7DE39D1CC7F37C685EFCA5A0,60381,19,21,2,109.5241,18.22458,1605
100781,3ED95B3B7DE39D1CC7F37C685EFCA5A0,31521,21,23,2,109.51458,18.22542,1555
100799,7B1A07C39637E996C01DF0A3D287D3C6,30854,14,17,3,109.56889,18.27076,1763
100800,7B1A07C39637E996C01DF0A3D287D3C6,31071,21,22,1,109.58257,18.28458,1815
100803,DB4DF566D4757FF3BB488F82DE126248,31561,4,7,3,109.56792,18.28479,1765
100804,DB4DF566D4757FF3BB488F82DE126248,30851,7,9,2,109.5616,18.27396,1713
100805,DB4DF566D4757FF3BB488F82DE126248,31561,11,12,1,109.56792,18.28479,1765
100806,DB4DF566D4757FF3BB488F82DE126248,30851,17,18,1,109.5616,18.27396,1713
100807,DB4DF566D4757FF3BB488F82DE126248,60117,20,22,2,109.73604,18.35681,2427
100827,0312B43ACF9ED1D8304E325E851AEE29,30851,11,13,2,109.5616,18.27396,1713
100828,0312B43ACF9ED1D8304E325E851AEE29,31561,14,16,2,109.56792,18.28479,1765
100829,0312B43ACF9ED1D8304E325E851AEE29,30851,16,17,1,109.5616,18.27396,1713
100830,0312B43ACF9ED1D8304E325E851AEE29,31561,17,20,3,109.56792,18.28479,1765
100854,B55959B64746A18ECF5077B5F7359221,31561,0,6,6,109.56792,18.28479,1765
100855,B55959B64746A18ECF5077B5F7359221,39183,8,10,2,109.55542,18.28208,1715
100856,B55959B64746A18ECF5077B5F7359221,31561,11,14,3,109.56792,18.28479,1765
100893,67D30B307FD4639F5D7DA8C23EB3E033,60291,19,20,1,109.50826,18.24639,1509
100943,09390A13C8E5C15C1E5674E3DB9139EC,60201,8,10,2,109.5041,18.2509,1510
100944,09390A13C8E5C15C1E5674E3DB9139EC,30711,13,20,7,109.50271,18.25347,1510
101053,4F877A4B395C9E22C3B85958392F2EAB,30381,18,20,2,109.52521,18.24507,1609
101054,4F877A4B395C9E22C3B85958392F2EAB,31181,21,23,2,109.50382,18.24813,1509
101055,0C8D15C0488D521680F0DE3A28CFE111,30701,0,2,2,109.59313,18.32007,1871
101056,0C8D15C0488D521680F0DE3A28CFE111,31811,2,3,1,109.54201,18.31806,1671
101057,0C8D15C0488D521680F0DE3A28CFE111,30701,4,6,2,109.59313,18.32007,1871
101079,0410C9BFB4956092D2C91E696A83188B,31071,1,6,5,109.58257,18.28458,1815
101080,0410C9BFB4956092D2C91E696A83188B,30854,8,9,1,109.56889,18.27076,1763
101081,0410C9BFB4956092D2C91E696A83188B,31071,11,13,2,109.58257,18.28458,1815
101082,0410C9BFB4956092D2C91E696A83188B,30854,14,16,2,109.56889,18.27076,1763
101094,64F4CDF664AA04E7B79DE93C57128CF6,31931,0,6,6,109.54771,18.29403,1667
101095,64F4CDF664AA04E7B79DE93C57128CF6,39181,8,19,11,109.55153,18.28035,1715
101096,64F4CDF664AA04E7B79DE93C57128CF6,31931,19,22,3,109.54771,18.29403,1667
101097,554561FEA364578E822ED5561D209EEA,30221,0,13,13,109.57833,18.20222,1802
101098,554561FEA364578E822ED5561D209EEA,30854,14,15,1,109.56889,18.27076,1763
101099,554561FEA364578E822ED5561D209EEA,30221,18,23,5,109.57833,18.20222,1802
101100,0878243E331032B9659EF30304C4F81B,30151,0,8,8,109.50986,18.25083,1560
101101,0878243E331032B9659EF30304C4F81B,60054,9,10,1,109.3016,18.31229,770
101102,0878243E331032B9659EF30304C4F81B,30661,12,14,2,109.37028,18.24361,1008
101103,0878243E331032B9659EF30304C4F81B,60201,19,21,2,109.5041,18.2509,1510
101104,0878243E331032B9659EF30304C4F81B,30151,21,23,2,109.50986,18.25083,1560
101108,45CCFCD3EBDF941E1C92B70ED06E8B5E,30854,0,8,8,109.56889,18.27076,1763
101109,45CCFCD3EBDF941E1C92B70ED06E8B5E,31071,11,12,1,109.58257,18.28458,1815
101110,45CCFCD3EBDF941E1C92B70ED06E8B5E,30854,12,16,4,109.56889,18.27076,1763
101146,6B806948BC9187A91D033B4096721B00,31071,13,20,7,109.58257,18.28458,1815
101147,6B806948BC9187A91D033B4096721B00,31561,21,22,1,109.56792,18.28479,1765
101148,DE5024DB59D5BF6AE5857A85EB7680EA,30854,11,13,2,109.56889,18.27076,1763
101149,DE5024DB59D5BF6AE5857A85EB7680EA,60631,13,15,2,109.57778,18.27583,1814
101150,DE5024DB59D5BF6AE5857A85EB7680EA,30854,18,20,2,109.56889,18.27076,1763
101163,7B6FDF5112B5C4A0BB0F3BA724E8ED45,60081,17,19,2,109.51097,18.22639,1556
101164,7B6FDF5112B5C4A0BB0F3BA724E8ED45,31236,20,23,3,109.42965,18.29111,1216
101181,933C30058B1CA246EC59609197D7CAAB,31071,1,16,15,109.58257,18.28458,1815
101182,933C30058B1CA246EC59609197D7CAAB,38157,19,21,2,109.51483,18.26958,1563
101183,933C30058B1CA246EC59609197D7CAAB,31071,22,23,1,109.58257,18.28458,1815
101192,5A7A3D5F722F0EB2695C45BF16BBC483,38157,0,7,7,109.51483,18.26958,1563
101193,5A7A3D5F722F0EB2695C45BF16BBC483,60661,8,10,2,109.548,18.2377,1657
101194,5A7A3D5F722F0EB2695C45BF16BBC483,38271,14,15,1,109.62632,18.23049,1956
101195,5A7A3D5F722F0EB2695C45BF16BBC483,30861,17,19,2,109.52722,18.22743,1606
101196,5A7A3D5F722F0EB2695C45BF16BBC483,31206,20,22,2,109.50819,18.23549,1507
101250,2183AF5A97756EB05E1459D1CE0BD7C7,38251,19,21,2,109.49618,18.25493,1510
101251,2183AF5A97756EB05E1459D1CE0BD7C7,60371,22,23,1,109.53063,18.30056,1618
101263,D85BA1E720DE38375E6105B94C5C6FB9,30771,0,13,13,109.49938,18.26042,1511
101264,D85BA1E720DE38375E6105B94C5C6FB9,39321,13,16,3,109.529,18.2167,1604
101265,D85BA1E720DE38375E6105B94C5C6FB9,31671,17,18,1,109.38965,18.29813,1068
101266,D85BA1E720DE38375E6105B94C5C6FB9,60541,18,20,2,109.4084,18.29208,1167
101299,149F44702DEC8C73589BE6524F0A1FFD,30854,2,20,18,109.56889,18.27076,1763
101300,149F44702DEC8C73589BE6524F0A1FFD,39183,20,22,2,109.55542,18.28208,1715
101339,DD9F75DC35C7510FCB052A20368D2852,60381,13,15,2,109.5241,18.22458,1605
101340,DD9F75DC35C7510FCB052A20368D2852,31091,19,20,1,109.41201,18.31222,1170
101354,36ECFE49831F53ABE6FBD1CCA4C1DFA7,60391,0,2,2,109.47667,18.28757,1416
101355,36ECFE49831F53ABE6FBD1CCA4C1DFA7,60391,3,9,6,109.47667,18.28757,1416
101364,01FF2C535995B14A04DDA79B1FD40766,38903,0,1,1,109.39229,18.29243,1117
101365,01FF2C535995B14A04DDA79B1FD40766,38145,2,4,2,109.378,18.2912,1066
101366,01FF2C535995B14A04DDA79B1FD40766,31081,8,10,2,109.44639,18.30181,1318
101367,01FF2C535995B14A04DDA79B1FD40766,31101,13,16,3,109.65389,18.23403,2057
101378,C93386A9D86FE22A1FD4E5116045DD8D,31561,2,3,1,109.56792,18.28479,1765
101379,C93386A9D86FE22A1FD4E5116045DD8D,39183,7,15,8,109.55542,18.28208,1715
101380,C93386A9D86FE22A1FD4E5116045DD8D,30854,19,20,1,109.56889,18.27076,1763
101417,0D23DA79DAEC5FDA0A3AFC440101E568,31231,0,7,7,109.42597,18.29292,1217
101418,0D23DA79DAEC5FDA0A3AFC440101E568,31781,11,14,3,109.19847,18.2975,367
101421,2B8C748A18FA7D08D4335AD7C9DEF01B,31761,0,6,6,109.60521,18.27965,1914
101422,2B8C748A18FA7D08D4335AD7C9DEF01B,30951,9,15,6,109.56208,18.25667,1761
101423,2B8C748A18FA7D08D4335AD7C9DEF01B,31761,19,22,3,109.60521,18.27965,1914
101431,DCF02478AC5ACC5C3190CEB09210F280,60361,15,18,3,109.51938,18.29681,1567
101432,DCF02478AC5ACC5C3190CEB09210F280,31351,19,23,4,109.4959,18.28417,1465
101471,01C3A40E8C2D18FB80BE4CD2C78B4B61,39091,13,16,3,109.50097,18.25222,1510
101472,01C3A40E8C2D18FB80BE4CD2C78B4B61,39091,20,23,3,109.50097,18.25222,1510
101484,7B596B6BEF2AFA6C9AB0582C35D0C3A4,30361,20,22,2,109.50347,18.24,1508
101510,F7F87EAB6A1C95FDC3321C58C5D1E097,60281,13,16,3,109.51743,18.25924,1561
101515,73E2E1BE5471172391E67FF4D9056766,60231,0,1,1,109.49903,18.21972,1504
101516,73E2E1BE5471172391E67FF4D9056766,30051,5,6,1,109.48917,18.21215,1453
101517,73E2E1BE5471172391E67FF4D9056766,39301,8,10,2,109.48361,18.21153,1453
101518,73E2E1BE5471172391E67FF4D9056766,60054,12,14,2,109.3016,18.31229,770
101570,66290D92C6D91C5C0C9CFEAA9F85388C,31071,1,8,7,109.58257,18.28458,1815
101571,66290D92C6D91C5C0C9CFEAA9F85388C,30854,9,11,2,109.56889,18.27076,1763
101572,66290D92C6D91C5C0C9CFEAA9F85388C,30421,12,13,1,109.50021,18.25861,1511
101573,66290D92C6D91C5C0C9CFEAA9F85388C,30854,15,17,2,109.56889,18.27076,1763
101574,66290D92C6D91C5C0C9CFEAA9F85388C,30891,18,21,3,109.59431,18.28389,1865
101575,66290D92C6D91C5C0C9CFEAA9F85388C,30854,21,23,2,109.56889,18.27076,1763
101585,F925AC8C169C2BA20A1C0DA2437ACAA9,30854,8,9,1,109.56889,18.27076,1763
101586,F925AC8C169C2BA20A1C0DA2437ACAA9,39371,10,23,13,109.56627,18.2646,1762
101596,D37BF241A4A35F0F341582CAF9EF0DD2,31205,0,1,1,109.51111,18.23736,1557
101597,D37BF241A4A35F0F341582CAF9EF0DD2,31206,1,7,6,109.50819,18.23549,1507
101598,D37BF241A4A35F0F341582CAF9EF0DD2,60081,9,13,4,109.51097,18.22639,1556
101599,D37BF241A4A35F0F341582CAF9EF0DD2,39191,14,17,3,109.51493,18.23472,1557
101618,0133DDFFB5CECBB261CEDEF10A82D50B,31561,0,11,11,109.56792,18.28479,1765
101619,0133DDFFB5CECBB261CEDEF10A82D50B,31071,11,14,3,109.58257,18.28458,1815
101620,0133DDFFB5CECBB261CEDEF10A82D50B,30234,14,16,2,109.60681,18.29979,1918
101624,B55112D1732F2CB737866DB64BBAC4BE,60054,13,15,2,109.3016,18.31229,770
101625,B55112D1732F2CB737866DB64BBAC4BE,30731,19,23,4,109.50944,18.22306,1555
101627,38670F0FEE8D96783B5FC6DF69F10DA0,31145,12,13,1,109.20431,18.30479,369
101628,38670F0FEE8D96783B5FC6DF69F10DA0,31534,15,16,1,109.49368,18.25806,1461
101629,38670F0FEE8D96783B5FC6DF69F10DA0,31534,18,23,5,109.49368,18.25806,1461
101675,0E129C09250C0D46273B4BD7E5225556,30771,0,7,7,109.49938,18.26042,1511
101676,0E129C09250C0D46273B4BD7E5225556,60201,8,10,2,109.5041,18.2509,1510
101677,0E129C09250C0D46273B4BD7E5225556,31303,12,15,3,109.15826,18.29549,217
101694,A2D836A887588298B0C011C476E5DB59,38951,2,9,7,109.48097,18.28868,1416
101695,A2D836A887588298B0C011C476E5DB59,30361,10,12,2,109.50347,18.24,1508
101696,A2D836A887588298B0C011C476E5DB59,38951,12,23,11,109.48097,18.28868,1416
101706,01BB30E777A61FC32E55053983D0DA10,30661,13,15,2,109.37028,18.24361,1008
101707,01BB30E777A61FC32E55053983D0DA10,60411,19,22,3,109.32514,18.30854,869
101708,28A014E28BF177F21531ACBF364A202D,31471,0,7,7,109.34583,18.29563,917
101709,28A014E28BF177F21531ACBF364A202D,60201,9,10,1,109.5041,18.2509,1510
101715,5D256FA5279A932380FCBD0E1600B3E5,31864,0,7,7,109.49014,18.28333,1465
101716,5D256FA5279A932380FCBD0E1600B3E5,30791,12,17,5,109.72333,18.40889,2386
101717,5D256FA5279A932380FCBD0E1600B3E5,30771,20,22,2,109.49938,18.26042,1511
101718,5D256FA5279A932380FCBD0E1600B3E5,31864,22,23,1,109.49014,18.28333,1465
101732,90E761563218966BF6DD1FD6E24DA0E3,60321,0,10,10,109.63611,18.24306,2008
101736,90E761563218966BF6DD1FD6E24DA0E3,60321,21,23,2,109.63611,18.24306,2008
101742,65DB2325B6E1E7A0D88A5D2D920F9EA1,31081,0,3,3,109.44639,18.30181,1318
101743,65DB2325B6E1E7A0D88A5D2D920F9EA1,60552,6,9,3,109.41729,18.30014,1218
101744,65DB2325B6E1E7A0D88A5D2D920F9EA1,30821,13,17,4,109.43681,18.33639,1274
101745,65DB2325B6E1E7A0D88A5D2D920F9EA1,30671,19,20,1,109.43611,18.30139,1268
101746,65DB2325B6E1E7A0D88A5D2D920F9EA1,30761,20,22,2,109.45201,18.3,1318
101757,44CB5F545D2E3587ACF209AB2414C1A1,31071,0,7,7,109.58257,18.28458,1815
101758,44CB5F545D2E3587ACF209AB2414C1A1,30854,11,12,1,109.56889,18.27076,1763
101759,44CB5F545D2E3587ACF209AB2414C1A1,31071,16,18,2,109.58257,18.28458,1815
101760,44CB5F545D2E3587ACF209AB2414C1A1,31061,19,20,1,109.53333,18.23257,1607
101764,C709D01469E0800AF998DFAF42105CDC,31561,9,15,6,109.56792,18.28479,1765
101765,C709D01469E0800AF998DFAF42105CDC,30854,17,19,2,109.56889,18.27076,1763
101769,FE1EC0E71A7AFD40F1435A5CA011EA80,30111,0,1,1,109.47583,18.30542,1419
101770,FE1EC0E71A7AFD40F1435A5CA011EA80,60671,2,6,4,109.52979,18.31757,1621
101771,FE1EC0E71A7AFD40F1435A5CA011EA80,30111,7,9,2,109.47583,18.30542,1419
101772,FE1EC0E71A7AFD40F1435A5CA011EA80,31101,11,14,3,109.65389,18.23403,2057
101773,FE1EC0E71A7AFD40F1435A5CA011EA80,31031,15,17,2,109.49979,18.25382,1510
101774,FE1EC0E71A7AFD40F1435A5CA011EA80,38094,17,22,5,109.45403,18.28778,1316
101775,FE1EC0E71A7AFD40F1435A5CA011EA80,30111,22,23,1,109.47583,18.30542,1419
101787,173CD7A2B7B334BC53A50A1D248FBCFE,31071,0,7,7,109.58257,18.28458,1815
101788,173CD7A2B7B334BC53A50A1D248FBCFE,30854,7,9,2,109.56889,18.27076,1763
101789,173CD7A2B7B334BC53A50A1D248FBCFE,31071,12,20,8,109.58257,18.28458,1815
101793,451E2BF48CD7B253EB0892324E679BCC,38297,0,6,6,109.52576,18.24965,1609
101794,451E2BF48CD7B253EB0892324E679BCC,60281,7,19,12,109.51743,18.25924,1561
101795,451E2BF48CD7B253EB0892324E679BCC,60311,20,22,2,109.52097,18.24319,1558
101831,93715618B304E009FF2F157425BB5843,60504,0,6,6,109.47917,18.28903,1416
101832,93715618B304E009FF2F157425BB5843,38951,8,14,6,109.48097,18.28868,1416
101833,93715618B304E009FF2F157425BB5843,30421,16,18,2,109.50021,18.25861,1511
101834,93715618B304E009FF2F157425BB5843,38171,19,20,1,109.50799,18.28139,1515
101835,93715618B304E009FF2F157425BB5843,60504,20,23,3,109.47917,18.28903,1416
101858,0E5593A90D661690BE3DAAA17AD936E2,38127,1,3,2,109.50833,18.27222,1513
101859,0E5593A90D661690BE3DAAA17AD936E2,30281,4,7,3,109.50597,18.27583,1514
101860,0E5593A90D661690BE3DAAA17AD936E2,31801,9,12,3,109.20417,18.32118,371
101861,0E5593A90D661690BE3DAAA17AD936E2,38127,14,23,9,109.50833,18.27222,1513
101877,E8477DE34FB2A9C1B10F75E5CA292C71,60311,0,7,7,109.52097,18.24319,1558
101878,E8477DE34FB2A9C1B10F75E5CA292C71,31931,8,16,8,109.54771,18.29403,1667
101884,07FD145FE6C81328C98C6C5C8452E794,30854,1,8,7,109.56889,18.27076,1763
101885,07FD145FE6C81328C98C6C5C8452E794,39371,13,18,5,109.56627,18.2646,1762
101886,07FD145FE6C81328C98C6C5C8452E794,30232,19,22,3,109.6191,18.31701,1971
101887,2E10AE81CA4EDA6CD33CFF9EBE881FD8,31031,0,4,4,109.49979,18.25382,1510
101888,2E10AE81CA4EDA6CD33CFF9EBE881FD8,31031,4,13,9,109.49979,18.25382,1510
101889,2E10AE81CA4EDA6CD33CFF9EBE881FD8,31031,14,22,8,109.49979,18.25382,1510
101890,2E10AE81CA4EDA6CD33CFF9EBE881FD8,30711,22,23,1,109.50271,18.25347,1510
101891,529A14F498129B0238F7B12A9FC7F6F7,39101,14,17,3,109.50132,18.24931,1509
101892,529A14F498129B0238F7B12A9FC7F6F7,31411,18,19,1,109.5016,18.23576,1507
101893,529A14F498129B0238F7B12A9FC7F6F7,60381,22,23,1,109.5241,18.22458,1605
101895,EE70B470BE9E6D12149AAA71474AD3EA,60551,19,20,1,109.42722,18.30111,1218
101934,8FAAC7EA21AE7BB6F52A4D0F285944CD,38721,0,8,8,109.50368,18.27542,1514
101935,8FAAC7EA21AE7BB6F52A4D0F285944CD,30051,10,11,1,109.48917,18.21215,1453
101936,8FAAC7EA21AE7BB6F52A4D0F285944CD,30281,12,13,1,109.50597,18.27583,1514
101937,8FAAC7EA21AE7BB6F52A4D0F285944CD,30051,17,19,2,109.48917,18.21215,1453
101938,8FAAC7EA21AE7BB6F52A4D0F285944CD,60463,19,20,1,109.52507,18.22438,1605
101939,8FAAC7EA21AE7BB6F52A4D0F285944CD,30281,21,23,2,109.50597,18.27583,1514
101940,807F73DE76DFE56E472FA61396F0887C,31461,0,7,7,109.5091,18.25389,1510
101945,6BB908E717D43CA60DB426B647CF8DE4,31091,0,7,7,109.41201,18.31222,1170
101946,6BB908E717D43CA60DB426B647CF8DE4,60041,7,9,2,109.39889,18.31944,1121
101947,6BB908E717D43CA60DB426B647CF8DE4,31091,12,23,11,109.41201,18.31222,1170
101951,9C692D39B6FC0B82D57A48E7E89CEB65,31521,14,17,3,109.51458,18.22542,1555
101952,9C692D39B6FC0B82D57A48E7E89CEB65,60381,20,23,3,109.5241,18.22458,1605
101960,EACA311BE126BD9A58956463BF0B58C2,30631,0,9,9,109.34382,18.32778,922
101961,EACA311BE126BD9A58956463BF0B58C2,31691,10,11,1,109.36604,18.3075,1019
101962,EACA311BE126BD9A58956463BF0B58C2,30631,12,15,3,109.34382,18.32778,922
101963,EACA311BE126BD9A58956463BF0B58C2,31691,15,18,3,109.36604,18.3075,1019
101964,EACA311BE126BD9A58956463BF0B58C2,30631,19,20,1,109.34382,18.32778,922
101965,EACA311BE126BD9A58956463BF0B58C2,60201,21,23,2,109.5041,18.2509,1510
101969,866460FA5062A635337B6369BB2AADDA,39183,4,5,1,109.55542,18.28208,1715
101970,866460FA5062A635337B6369BB2AADDA,30854,6,17,11,109.56889,18.27076,1763
101980,0BAC26B2F5D5282A940EADE88973B981,30854,0,8,8,109.56889,18.27076,1763
101981,0BAC26B2F5D5282A940EADE88973B981,30731,11,17,6,109.50944,18.22306,1555
101989,283001ED673D8EDBEF7EEB00BDB31533,60231,3,4,1,109.49903,18.21972,1504
101990,283001ED673D8EDBEF7EEB00BDB31533,31181,6,14,8,109.50382,18.24813,1509
101991,283001ED673D8EDBEF7EEB00BDB31533,30571,18,21,3,109.50243,18.21861,1504
102006,42923D86FCA39B981325B127230BF145,30232,2,14,12,109.6191,18.31701,1971
102007,42923D86FCA39B981325B127230BF145,31221,15,17,2,109.61333,18.26833,1913
102008,42923D86FCA39B981325B127230BF145,30232,19,21,2,109.6191,18.31701,1971
102042,FD45DAD5A6F6BB711255CB29E453CFF1,30854,0,15,15,109.56889,18.27076,1763
102043,FD45DAD5A6F6BB711255CB29E453CFF1,60631,16,17,1,109.57778,18.27583,1814
102044,FD45DAD5A6F6BB711255CB29E453CFF1,30854,21,23,2,109.56889,18.27076,1763
102061,8DC3C0D11AFCC61DD6CB6DBA295B4AE4,30711,11,15,4,109.50271,18.25347,1510
102062,8DC3C0D11AFCC61DD6CB6DBA295B4AE4,31521,15,20,5,109.51458,18.22542,1555
102078,CB1C8502149DACE0B32B2F7416279EF2,30854,0,2,2,109.56889,18.27076,1763
102079,CB1C8502149DACE0B32B2F7416279EF2,31071,3,6,3,109.58257,18.28458,1815
102080,CB1C8502149DACE0B32B2F7416279EF2,30854,10,14,4,109.56889,18.27076,1763
102081,CB1C8502149DACE0B32B2F7416279EF2,31071,15,23,8,109.58257,18.28458,1815
102109,D39D64452E6BBEF7B3056CA239E1B86E,30854,0,6,6,109.56889,18.27076,1763
102110,D39D64452E6BBEF7B3056CA239E1B86E,31561,6,9,3,109.56792,18.28479,1765
102111,D39D64452E6BBEF7B3056CA239E1B86E,30854,9,23,14,109.56889,18.27076,1763
102155,903541A899A8579F62DD9230101F46FC,31521,0,8,8,109.51458,18.22542,1555
102156,903541A899A8579F62DD9230101F46FC,38951,10,11,1,109.48097,18.28868,1416
102157,903541A899A8579F62DD9230101F46FC,38951,11,14,3,109.48097,18.28868,1416
102158,903541A899A8579F62DD9230101F46FC,60221,15,19,4,109.52569,18.29188,1616
102159,903541A899A8579F62DD9230101F46FC,38951,20,23,3,109.48097,18.28868,1416
102195,D1B09D14086A317457A98E1E3E3BED6B,39181,0,14,14,109.55153,18.28035,1715
102196,D1B09D14086A317457A98E1E3E3BED6B,39181,15,23,8,109.55153,18.28035,1715
102235,1FE2866848043A2C10AD87212485FE15,31071,0,6,6,109.58257,18.28458,1815
102236,1FE2866848043A2C10AD87212485FE15,30854,7,11,4,109.56889,18.27076,1763
102237,1FE2866848043A2C10AD87212485FE15,31071,11,14,3,109.58257,18.28458,1815
102251,051FE6263045C46039F2A055A3D59821,30361,16,17,1,109.50347,18.24,1508
102252,051FE6263045C46039F2A055A3D59821,38951,19,21,2,109.48097,18.28868,1416
102253,051FE6263045C46039F2A055A3D59821,38951,21,22,1,109.48097,18.28868,1416
102258,A97645679390087E090050CF3F130352,31931,0,14,14,109.54771,18.29403,1667
102259,A97645679390087E090050CF3F130352,30921,14,15,1,109.53903,18.29451,1667
102260,A97645679390087E090050CF3F130352,31931,20,23,3,109.54771,18.29403,1667
102269,B5686BCA7E4C74E299FC4E3D24CAC39C,39151,0,9,9,109.49875,18.25097,1510
102270,B5686BCA7E4C74E299FC4E3D24CAC39C,31531,9,11,2,109.49583,18.25972,1461
102271,B5686BCA7E4C74E299FC4E3D24CAC39C,31031,12,14,2,109.49979,18.25382,1510
102272,B5686BCA7E4C74E299FC4E3D24CAC39C,60131,14,15,1,109.49819,18.24778,1509
102307,CD576F1C1CDFB89E6A99A20E65927346,31561,2,11,9,109.56792,18.28479,1765
102308,CD576F1C1CDFB89E6A99A20E65927346,30854,15,16,1,109.56889,18.27076,1763
102309,CD576F1C1CDFB89E6A99A20E65927346,31561,16,17,1,109.56792,18.28479,1765
102310,CD576F1C1CDFB89E6A99A20E65927346,30854,18,19,1,109.56889,18.27076,1763
102326,9C7AFD6F67C3677E74C4343080215938,60621,5,8,3,109.48354,18.27451,1464
102327,9C7AFD6F67C3677E74C4343080215938,30421,11,15,4,109.50021,18.25861,1511
102328,9C7AFD6F67C3677E74C4343080215938,60401,19,21,2,109.47444,18.27583,1414
102329,9C7AFD6F67C3677E74C4343080215938,30171,21,23,2,109.48458,18.27139,1463
102337,613BD9834E9B58F193261B0D819B4BF9,30854,0,2,2,109.56889,18.27076,1763
102338,613BD9834E9B58F193261B0D819B4BF9,31071,2,5,3,109.58257,18.28458,1815
102339,613BD9834E9B58F193261B0D819B4BF9,30854,7,9,2,109.56889,18.27076,1763
102358,B712327B6033C61F37801CFD6DAC08AD,31951,2,4,2,109.52174,18.30299,1568
102359,B712327B6033C61F37801CFD6DAC08AD,38484,6,10,4,109.53028,18.31528,1620
102360,B712327B6033C61F37801CFD6DAC08AD,38484,12,22,10,109.53028,18.31528,1620
102414,DE752C5E8A13F8A5D5BD49C4D2C8009D,38881,0,18,18,109.51618,18.26431,1562
102415,DE752C5E8A13F8A5D5BD49C4D2C8009D,31031,20,21,1,109.49979,18.25382,1510
102416,87ADC98470D754E65D1F229228B379D5,30854,4,6,2,109.56889,18.27076,1763
102417,87ADC98470D754E65D1F229228B379D5,30851,7,8,1,109.5616,18.27396,1713
102418,87ADC98470D754E65D1F229228B379D5,39183,10,12,2,109.55542,18.28208,1715
102419,87ADC98470D754E65D1F229228B379D5,31561,15,16,1,109.56792,18.28479,1765
102420,87ADC98470D754E65D1F229228B379D5,39183,16,18,2,109.55542,18.28208,1715
102421,87ADC98470D754E65D1F229228B379D5,30851,20,23,3,109.5616,18.27396,1713
102468,47C8C71AB8A291B23C6D0393C8109E46,38261,0,8,8,109.50361,18.28153,1515
102469,47C8C71AB8A291B23C6D0393C8109E46,31301,10,11,1,109.14493,18.31222,170
102470,47C8C71AB8A291B23C6D0393C8109E46,38171,15,17,2,109.50799,18.28139,1515
102471,47C8C71AB8A291B23C6D0393C8109E46,38261,18,23,5,109.50361,18.28153,1515
102492,47B3B30463DFC561429E6F7DBFD3AC56,31431,0,12,12,109.44639,18.29042,1316
102493,47B3B30463DFC561429E6F7DBFD3AC56,31561,14,15,1,109.56792,18.28479,1765
102494,47B3B30463DFC561429E6F7DBFD3AC56,31431,16,18,2,109.44639,18.29042,1316
102495,47B3B30463DFC561429E6F7DBFD3AC56,30361,19,20,1,109.50347,18.24,1508
102496,47B3B30463DFC561429E6F7DBFD3AC56,31431,21,23,2,109.44639,18.29042,1316
102499,5BC3B77CE4C9E3D80CA1E3D2AEFD4FF6,60381,18,19,1,109.5241,18.22458,1605
102500,5BC3B77CE4C9E3D80CA1E3D2AEFD4FF6,31271,20,22,2,109.48958,18.26257,1462
102503,89362A3CA3AE6F5B75871F2110924F99,30851,0,6,6,109.5616,18.27396,1713
102504,89362A3CA3AE6F5B75871F2110924F99,30951,10,11,1,109.56208,18.25667,1761
102505,89362A3CA3AE6F5B75871F2110924F99,39371,12,13,1,109.56627,18.2646,1762
102506,89362A3CA3AE6F5B75871F2110924F99,30951,13,17,4,109.56208,18.25667,1761
102507,89362A3CA3AE6F5B75871F2110924F99,30851,17,23,6,109.5616,18.27396,1713
102532,5C81DE179C8306F5FC21CD27B4FDA902,30854,0,1,1,109.56889,18.27076,1763
102533,5C81DE179C8306F5FC21CD27B4FDA902,31561,2,11,9,109.56792,18.28479,1765
102534,5C81DE179C8306F5FC21CD27B4FDA902,30854,14,15,1,109.56889,18.27076,1763
102551,E7B24ADBE691139494F24A8AB7EDA359,30854,19,20,1,109.56889,18.27076,1763
102552,E7B24ADBE691139494F24A8AB7EDA359,31761,21,23,2,109.60521,18.27965,1914
102578,09605A95AE7BE30FC92DC699DB3FCBD0,31181,2,10,8,109.50382,18.24813,1509
102579,09605A95AE7BE30FC92DC699DB3FCBD0,31461,13,15,2,109.5091,18.25389,1510
102580,09605A95AE7BE30FC92DC699DB3FCBD0,30291,16,17,1,109.50403,18.27028,1513
102581,09605A95AE7BE30FC92DC699DB3FCBD0,60201,18,20,2,109.5041,18.2509,1510
102608,7FF3C6569A3990C03CAF6C52D3C8BC6C,30921,0,18,18,109.53903,18.29451,1667
102609,7FF3C6569A3990C03CAF6C52D3C8BC6C,60241,19,20,1,109.53319,18.28667,1616
102642,E46795A590C643FCDE6B993B35621D2F,31931,1,5,4,109.54771,18.29403,1667
102643,E46795A590C643FCDE6B993B35621D2F,60552,8,9,1,109.41729,18.30014,1218
102644,1321BCF14E61D6FFFB82331DABDFE27C,31271,0,6,6,109.48958,18.26257,1462
102645,1321BCF14E61D6FFFB82331DABDFE27C,31781,9,12,3,109.19847,18.2975,367
102646,1321BCF14E61D6FFFB82331DABDFE27C,31145,12,13,1,109.20431,18.30479,369
102647,1321BCF14E61D6FFFB82331DABDFE27C,31471,14,16,2,109.34583,18.29563,917
102648,1321BCF14E61D6FFFB82331DABDFE27C,31271,19,23,4,109.48958,18.26257,1462
102651,AA2A5396AD753E9245AC53C94BAEDECD,61011,0,4,4,109.60653,18.19076,1900
102653,AA2A5396AD753E9245AC53C94BAEDECD,61011,7,9,2,109.60653,18.19076,1900
102655,AA2A5396AD753E9245AC53C94BAEDECD,61011,11,13,2,109.60653,18.19076,1900
102657,AA2A5396AD753E9245AC53C94BAEDECD,61011,17,19,2,109.60653,18.19076,1900
102671,5DE74CB2B600155A1EC2F7D01E1A8413,30731,0,10,10,109.50944,18.22306,1555
102672,5DE74CB2B600155A1EC2F7D01E1A8413,30581,13,15,2,109.62257,18.24951,1959
102673,5DE74CB2B600155A1EC2F7D01E1A8413,31345,16,23,7,109.39,18.29,1066
102674,B47BACC30D9A35D35F1E9FB0E5DF7D48,30854,0,2,2,109.56889,18.27076,1763
102675,B47BACC30D9A35D35F1E9FB0E5DF7D48,31071,2,4,2,109.58257,18.28458,1815
102699,9C3178C4C19F2E39C3D11C3827A035D5,30661,14,15,1,109.37028,18.24361,1008
102700,9C3178C4C19F2E39C3D11C3827A035D5,38071,18,20,2,109.40722,18.30938,1169
102701,48C2384D12D5B16772007E35CE360CBB,30721,0,8,8,109.51597,18.28257,1565
102702,48C2384D12D5B16772007E35CE360CBB,38105,8,17,9,109.40299,18.29229,1117
102703,48C2384D12D5B16772007E35CE360CBB,30421,18,20,2,109.50021,18.25861,1511
102704,48C2384D12D5B16772007E35CE360CBB,31345,21,22,1,109.39,18.29,1066
102776,18073AD9E71B8DFC1E520C5E3653B1BD,30721,0,6,6,109.51597,18.28257,1565
102778,18073AD9E71B8DFC1E520C5E3653B1BD,38881,15,22,7,109.51618,18.26431,1562
102781,30F5D42A1A8F1CF26F5C9617FCB06C4F,39181,8,11,3,109.55153,18.28035,1715
102782,30F5D42A1A8F1CF26F5C9617FCB06C4F,39183,15,17,2,109.55542,18.28208,1715
102783,30F5D42A1A8F1CF26F5C9617FCB06C4F,31561,18,19,1,109.56792,18.28479,1765
102806,5CB395EE61B203CDEC22915C029A400C,38325,16,19,3,109.39792,18.2909,1116
102807,5CB395EE61B203CDEC22915C029A400C,38105,21,23,2,109.40299,18.29229,1117
102827,A928E9F6C796FE1A60807BA003DE87BB,31071,2,5,3,109.58257,18.28458,1815
102828,A928E9F6C796FE1A60807BA003DE87BB,30854,6,8,2,109.56889,18.27076,1763
102829,A928E9F6C796FE1A60807BA003DE87BB,39181,8,16,8,109.55153,18.28035,1715
102830,A928E9F6C796FE1A60807BA003DE87BB,31071,18,20,2,109.58257,18.28458,1815
102831,A928E9F6C796FE1A60807BA003DE87BB,30854,21,23,2,109.56889,18.27076,1763
102832,76DA946F4DC1318DD46A32E1D303D6B7,31931,0,6,6,109.54771,18.29403,1667
102833,76DA946F4DC1318DD46A32E1D303D6B7,39181,7,9,2,109.55153,18.28035,1715
102834,76DA946F4DC1318DD46A32E1D303D6B7,39181,13,18,5,109.55153,18.28035,1715
102835,76DA946F4DC1318DD46A32E1D303D6B7,31931,19,22,3,109.54771,18.29403,1667
102848,975CB35586D2D95A387E2AA86A5AB719,30121,15,17,2,109.52861,18.27222,1613
102849,975CB35586D2D95A387E2AA86A5AB719,38154,18,23,5,109.5266,18.28278,1615
102859,D980F71EB1AF0D70119633B043EFD554,38334,1,11,10,109.65035,18.23785,2057
102860,D980F71EB1AF0D70119633B043EFD554,31071,13,14,1,109.58257,18.28458,1815
102861,D980F71EB1AF0D70119633B043EFD554,31101,15,17,2,109.65389,18.23403,2057
102881,DD056101D68CBFC24096E8F587CC747C,31931,0,2,2,109.54771,18.29403,1667
102882,DD056101D68CBFC24096E8F587CC747C,30071,7,20,13,109.52819,18.30472,1619
102883,DD056101D68CBFC24096E8F587CC747C,31931,20,23,3,109.54771,18.29403,1667
102916,D8B19999D42CFF7EB03B9BAFA13044AB,30111,1,12,11,109.47583,18.30542,1419
102917,D8B19999D42CFF7EB03B9BAFA13044AB,60011,12,14,2,109.48965,18.30222,1468
102918,D8B19999D42CFF7EB03B9BAFA13044AB,30351,18,20,2,109.41701,18.29292,1217
102919,D8B19999D42CFF7EB03B9BAFA13044AB,60421,21,22,1,109.46333,18.31743,1371
102935,807332CEC38772FA8DF98C48FBD8DD1E,31561,4,15,11,109.56792,18.28479,1765
102936,807332CEC38772FA8DF98C48FBD8DD1E,31071,19,22,3,109.58257,18.28458,1815
102943,A549C024E6F63EDBD3DC866F10DB11CE,30234,2,4,2,109.60681,18.29979,1918
102944,A549C024E6F63EDBD3DC866F10DB11CE,30854,7,23,16,109.56889,18.27076,1763
102984,A749E400BFD3B5908671E939EC104DEE,31071,0,6,6,109.58257,18.28458,1815
102985,A749E400BFD3B5908671E939EC104DEE,30854,8,18,10,109.56889,18.27076,1763
102986,A749E400BFD3B5908671E939EC104DEE,60084,19,20,1,109.4984,18.2334,1507
102987,A749E400BFD3B5908671E939EC104DEE,30854,22,23,1,109.56889,18.27076,1763
103003,E4B522EF4348156010E5C578EC13D60F,30854,0,13,13,109.56889,18.27076,1763
103004,E4B522EF4348156010E5C578EC13D60F,31945,13,14,1,109.58021,18.29403,1817
103005,E4B522EF4348156010E5C578EC13D60F,60211,18,21,3,109.63549,18.26049,2011
103006,7168F7EAD82B76A2A520C85DAB769D72,39183,0,16,16,109.55542,18.28208,1715
103007,7168F7EAD82B76A2A520C85DAB769D72,31561,18,19,1,109.56792,18.28479,1765
103032,608A55C14BAB2A5B627ACC1F39B89FB6,31945,0,7,7,109.58021,18.29403,1817
103033,608A55C14BAB2A5B627ACC1F39B89FB6,30854,7,17,10,109.56889,18.27076,1763
103034,608A55C14BAB2A5B627ACC1F39B89FB6,31945,18,22,4,109.58021,18.29403,1817
103047,7AFCA6A0135DD4739529823E28C762E3,30711,0,9,9,109.50271,18.25347,1510
103067,6A910172B0D8A7BBC31B1CD07364D7F6,31206,0,8,8,109.50819,18.23549,1507
103068,6A910172B0D8A7BBC31B1CD07364D7F6,30661,11,14,3,109.37028,18.24361,1008
103069,6A910172B0D8A7BBC31B1CD07364D7F6,31201,16,18,2,109.51042,18.23819,1558
103070,6A910172B0D8A7BBC31B1CD07364D7F6,60291,18,20,2,109.50826,18.24639,1509
103071,6A910172B0D8A7BBC31B1CD07364D7F6,31206,22,23,1,109.50819,18.23549,1507
103072,D5FE874FE4A1FA8F436099DBE974EE76,38951,0,8,8,109.48097,18.28868,1416
103073,D5FE874FE4A1FA8F436099DBE974EE76,30441,11,12,1,109.64021,18.25424,2010
103074,D5FE874FE4A1FA8F436099DBE974EE76,38951,15,23,8,109.48097,18.28868,1416
103077,1EBF477B1EE6E13F6E111854406233C6,38325,0,2,2,109.39792,18.2909,1116
103078,1EBF477B1EE6E13F6E111854406233C6,38251,4,5,1,109.49618,18.25493,1510
103079,1EBF477B1EE6E13F6E111854406233C6,31145,9,11,2,109.20431,18.30479,369
103080,1EBF477B1EE6E13F6E111854406233C6,31781,11,12,1,109.19847,18.2975,367
103139,10EBF762D28520B09848288F7052CFDE,30854,2,5,3,109.56889,18.27076,1763
103140,10EBF762D28520B09848288F7052CFDE,30161,8,11,3,109.50042,18.24389,1508
103141,10EBF762D28520B09848288F7052CFDE,39101,14,17,3,109.50132,18.24931,1509
103142,10EBF762D28520B09848288F7052CFDE,31561,19,21,2,109.56792,18.28479,1765
103145,3E01B14B28C0FDBF8BB343D61C8AA7D8,31931,0,10,10,109.54771,18.29403,1667
103146,3E01B14B28C0FDBF8BB343D61C8AA7D8,30721,14,17,3,109.51597,18.28257,1565
103147,3E01B14B28C0FDBF8BB343D61C8AA7D8,31931,19,20,1,109.54771,18.29403,1667
103148,3E01B14B28C0FDBF8BB343D61C8AA7D8,60241,22,23,1,109.53319,18.28667,1616
103182,963B5F4C98446446023B8ED177B869B3,60361,0,6,6,109.51938,18.29681,1567
103183,963B5F4C98446446023B8ED177B869B3,39183,7,15,8,109.55542,18.28208,1715
103184,963B5F4C98446446023B8ED177B869B3,60361,18,23,5,109.51938,18.29681,1567
103199,3307E282D5537E0AA5F104D069243EA1,30341,0,8,8,109.3625,18.29167,966
103200,3307E282D5537E0AA5F104D069243EA1,60561,9,10,1,109.38229,18.29785,1067
103201,3307E282D5537E0AA5F104D069243EA1,30341,11,16,5,109.3625,18.29167,966
103266,13166628932DF36C0AD7B1DB5811240A,60591,0,6,6,109.61118,18.21715,1904
103267,13166628932DF36C0AD7B1DB5811240A,30854,8,15,7,109.56889,18.27076,1763
103268,13166628932DF36C0AD7B1DB5811240A,60631,15,17,2,109.57778,18.27583,1814
103269,13166628932DF36C0AD7B1DB5811240A,60591,19,23,4,109.61118,18.21715,1904
103294,2DA5948E96121EADE6CCFA0D33794EFE,38251,0,8,8,109.49618,18.25493,1510
103295,2DA5948E96121EADE6CCFA0D33794EFE,33051,13,16,3,109.6475,18.46618,2096
103296,2DA5948E96121EADE6CCFA0D33794EFE,38251,20,23,3,109.49618,18.25493,1510
103300,6DF7485545B790F22810B0EDD8F1B356,31945,0,7,7,109.58021,18.29403,1817
103301,6DF7485545B790F22810B0EDD8F1B356,30854,7,10,3,109.56889,18.27076,1763
103302,6DF7485545B790F22810B0EDD8F1B356,31945,12,23,11,109.58021,18.29403,1817
103341,1B54321AAE3CB452580C4C49E7007657,38281,0,8,8,109.6525,18.23403,2057
103342,1B54321AAE3CB452580C4C49E7007657,30661,12,15,3,109.37028,18.24361,1008
103343,1B54321AAE3CB452580C4C49E7007657,38251,18,19,1,109.49618,18.25493,1510
103344,1B54321AAE3CB452580C4C49E7007657,31101,20,23,3,109.65389,18.23403,2057
103352,15A2A8790389D1537721C21B141A7A31,61011,12,21,9,109.60653,18.19076,1900
103360,6D02659C8AB6FF777A098A468ACF74DA,31021,14,17,3,109.49021,18.27,1463
103361,6D02659C8AB6FF777A098A468ACF74DA,31201,19,20,1,109.51042,18.23819,1558
103362,6D02659C8AB6FF777A098A468ACF74DA,60551,21,23,2,109.42722,18.30111,1218
103368,19E8353A2DD0F178EBFC3FFA3E623B24,31945,0,7,7,109.58021,18.29403,1817
103369,19E8353A2DD0F178EBFC3FFA3E623B24,30854,8,10,2,109.56889,18.27076,1763
103370,19E8353A2DD0F178EBFC3FFA3E623B24,31945,13,14,1,109.58021,18.29403,1817
103371,19E8353A2DD0F178EBFC3FFA3E623B24,30854,19,22,3,109.56889,18.27076,1763
103448,0F558B6653C655C7F0BAEA9D66B33F57,31071,2,6,4,109.58257,18.28458,1815
103449,0F558B6653C655C7F0BAEA9D66B33F57,30854,10,12,2,109.56889,18.27076,1763
103450,588D854C36F4A36488FDCCD50B5D19DD,31071,0,6,6,109.58257,18.28458,1815
103451,588D854C36F4A36488FDCCD50B5D19DD,30854,11,13,2,109.56889,18.27076,1763
103459,932D308A47BD924E11B570EA7CB7901D,31521,11,12,1,109.51458,18.22542,1555
103476,7421066246AAD1C230E7E2A7ADF06E9D,60631,1,7,6,109.57778,18.27583,1814
103477,7421066246AAD1C230E7E2A7ADF06E9D,31071,9,10,1,109.58257,18.28458,1815
103478,7421066246AAD1C230E7E2A7ADF06E9D,30854,10,15,5,109.56889,18.27076,1763
103479,7421066246AAD1C230E7E2A7ADF06E9D,30851,19,22,3,109.5616,18.27396,1713
103513,417408FFDA93B177641D270D3A5C4B2D,31071,0,7,7,109.58257,18.28458,1815
103514,417408FFDA93B177641D270D3A5C4B2D,60631,8,17,9,109.57778,18.27583,1814
103515,417408FFDA93B177641D270D3A5C4B2D,31071,21,23,2,109.58257,18.28458,1815
103577,28F7DFD4A036DBA4E68AFC71762D44D7,31421,8,9,1,109.55382,18.22347,1705
103578,28F7DFD4A036DBA4E68AFC71762D44D7,30951,11,13,2,109.56208,18.25667,1761
103579,28F7DFD4A036DBA4E68AFC71762D44D7,31421,15,18,3,109.55382,18.22347,1705
103580,28F7DFD4A036DBA4E68AFC71762D44D7,30951,18,20,2,109.56208,18.25667,1761
103581,8BD746060F2815A9C4F773DEDC3A1172,38023,0,8,8,109.37132,18.28993,1016
103582,8BD746060F2815A9C4F773DEDC3A1172,30341,9,12,3,109.3625,18.29167,966
103583,8BD746060F2815A9C4F773DEDC3A1172,60054,15,16,1,109.3016,18.31229,770
103584,8BD746060F2815A9C4F773DEDC3A1172,38025,18,19,1,109.36903,18.29167,1016
103607,D537779863674D03BD86E245F9738004,38251,6,14,8,109.49618,18.25493,1510
103608,D537779863674D03BD86E245F9738004,38941,17,18,1,109.49625,18.25451,1510
103609,D537779863674D03BD86E245F9738004,38251,20,22,2,109.49618,18.25493,1510
103632,EFFEF00C078D502D6D0D1D469ACBA466,30421,9,15,6,109.50021,18.25861,1511
103633,EFFEF00C078D502D6D0D1D469ACBA466,39151,19,21,2,109.49875,18.25097,1510
103634,EFFEF00C078D502D6D0D1D469ACBA466,30421,21,23,2,109.50021,18.25861,1511
103649,8351D15B3D6A299C2AB7E9544D4F31B1,60551,19,20,1,109.42722,18.30111,1218
103650,8351D15B3D6A299C2AB7E9544D4F31B1,60631,22,23,1,109.57778,18.27583,1814
103682,DF49F834C08C7E8FA6D78272EE1FB651,60361,0,7,7,109.51938,18.29681,1567
103683,DF49F834C08C7E8FA6D78272EE1FB651,30951,7,17,10,109.56208,18.25667,1761
103684,DF49F834C08C7E8FA6D78272EE1FB651,60361,19,23,4,109.51938,18.29681,1567
103701,8DD23AA43C0F7967C45F7488D66F9159,30854,15,17,2,109.56889,18.27076,1763
103702,8DD23AA43C0F7967C45F7488D66F9159,31071,18,21,3,109.58257,18.28458,1815
103703,8DD23AA43C0F7967C45F7488D66F9159,30854,21,23,2,109.56889,18.27076,1763
103715,39D0B119BCF23E40EF7A286F6A03CC6A,30201,0,9,9,109.4909,18.26465,1462
103716,39D0B119BCF23E40EF7A286F6A03CC6A,31271,10,11,1,109.48958,18.26257,1462
103717,39D0B119BCF23E40EF7A286F6A03CC6A,60594,13,16,3,109.62694,18.22799,1956
103718,39D0B119BCF23E40EF7A286F6A03CC6A,38052,17,23,6,109.62618,18.23042,1956
103725,3920BAEB33CD0C1B51E7B924FE380948,60401,0,7,7,109.47444,18.27583,1414
103726,3920BAEB33CD0C1B51E7B924FE380948,38251,7,8,1,109.49618,18.25493,1510
103727,3920BAEB33CD0C1B51E7B924FE380948,31781,13,14,1,109.19847,18.2975,367
103779,5AAB2BA860639221A739FD874CEC6C5E,30861,0,7,7,109.52722,18.22743,1606
103780,5AAB2BA860639221A739FD874CEC6C5E,31781,11,13,2,109.19847,18.2975,367
103781,5AAB2BA860639221A739FD874CEC6C5E,31471,13,15,2,109.34583,18.29563,917
103782,5AAB2BA860639221A739FD874CEC6C5E,60221,17,21,4,109.52569,18.29188,1616
103783,5AAB2BA860639221A739FD874CEC6C5E,30861,21,22,1,109.52722,18.22743,1606
103792,AFCD0831F8AAAE7DDAE42327797F10EB,31071,0,6,6,109.58257,18.28458,1815
103793,AFCD0831F8AAAE7DDAE42327797F10EB,31761,7,9,2,109.60521,18.27965,1914
103794,AFCD0831F8AAAE7DDAE42327797F10EB,31071,11,12,1,109.58257,18.28458,1815
103805,05C5BAA3E14983E15142EDC7A25768B1,31391,3,5,2,109.50382,18.24285,1508
103806,05C5BAA3E14983E15142EDC7A25768B1,30361,8,11,3,109.50347,18.24,1508
103807,05C5BAA3E14983E15142EDC7A25768B1,60371,11,13,2,109.53063,18.30056,1618
103823,9BD0746EAD915C7FE62E448DC71186FA,31071,0,1,1,109.58257,18.28458,1815
103824,9BD0746EAD915C7FE62E448DC71186FA,31945,2,7,5,109.58021,18.29403,1817
103825,9BD0746EAD915C7FE62E448DC71186FA,30854,7,14,7,109.56889,18.27076,1763
103834,C85D0B931BEF54F05B9ABBBB03212DB7,31071,2,3,1,109.58257,18.28458,1815
103835,C85D0B931BEF54F05B9ABBBB03212DB7,30854,3,6,3,109.56889,18.27076,1763
103836,C85D0B931BEF54F05B9ABBBB03212DB7,31561,6,15,9,109.56792,18.28479,1765
103837,C85D0B931BEF54F05B9ABBBB03212DB7,30854,15,18,3,109.56889,18.27076,1763
103838,C85D0B931BEF54F05B9ABBBB03212DB7,31071,19,20,1,109.58257,18.28458,1815
103839,C85D0B931BEF54F05B9ABBBB03212DB7,31561,20,22,2,109.56792,18.28479,1765
103853,EF4E8B2B57B33802A459B5C67E5DD022,38951,2,9,7,109.48097,18.28868,1416
103854,EF4E8B2B57B33802A459B5C67E5DD022,30361,11,12,1,109.50347,18.24,1508
103855,EF4E8B2B57B33802A459B5C67E5DD022,38951,12,23,11,109.48097,18.28868,1416
103874,CDA1EB7B89E47C48A7CAC823B0773234,38127,12,13,1,109.50833,18.27222,1513
103875,CDA1EB7B89E47C48A7CAC823B0773234,38871,15,18,3,109.44681,18.28625,1316
103876,CDA1EB7B89E47C48A7CAC823B0773234,31351,18,20,2,109.4959,18.28417,1465
103888,0E1DB444F47235AEDAD0A0404A7B75B4,31931,20,21,1,109.54771,18.29403,1667
103895,F6300B72B7EF2FA11171AFA8CE8E07F1,60401,3,5,2,109.47444,18.27583,1414
103896,F6300B72B7EF2FA11171AFA8CE8E07F1,30731,5,7,2,109.50944,18.22306,1555
103897,F6300B72B7EF2FA11171AFA8CE8E07F1,30051,9,12,3,109.48917,18.21215,1453
103898,F6300B72B7EF2FA11171AFA8CE8E07F1,60524,15,22,7,109.42951,18.28993,1216
103946,A1B6F712D4BC56F4FFD51F3D8AB7895D,30854,0,1,1,109.56889,18.27076,1763
103947,A1B6F712D4BC56F4FFD51F3D8AB7895D,31561,1,6,5,109.56792,18.28479,1765
103948,A1B6F712D4BC56F4FFD51F3D8AB7895D,30854,6,9,3,109.56889,18.27076,1763
103949,EA3A8DA5F296698D9CCABAE2F2FD40FF,38754,13,14,1,109.74667,18.37382,2430
103950,EA3A8DA5F296698D9CCABAE2F2FD40FF,31521,16,17,1,109.51458,18.22542,1555
103951,EA3A8DA5F296698D9CCABAE2F2FD40FF,31521,18,23,5,109.51458,18.22542,1555
103962,E58F7930139B2ED51DE79005F05C056D,39183,0,3,3,109.55542,18.28208,1715
103963,E58F7930139B2ED51DE79005F05C056D,31931,5,6,1,109.54771,18.29403,1667
103964,E58F7930139B2ED51DE79005F05C056D,39183,10,23,13,109.55542,18.28208,1715
103973,EBF906C5498076BCFA3E97DF6001B4F3,60631,18,19,1,109.57778,18.27583,1814
103974,EBF906C5498076BCFA3E97DF6001B4F3,30854,21,22,1,109.56889,18.27076,1763
103991,2A6BA0678DDF16AF08BAC9E3FA3C9391,31561,2,5,3,109.56792,18.28479,1765
103992,2A6BA0678DDF16AF08BAC9E3FA3C9391,30854,9,11,2,109.56889,18.27076,1763
103993,2A6BA0678DDF16AF08BAC9E3FA3C9391,31561,11,13,2,109.56792,18.28479,1765
103994,2A6BA0678DDF16AF08BAC9E3FA3C9391,30854,15,20,5,109.56889,18.27076,1763
104008,C5A446AC7123103DC030E8D43C03C155,60221,0,8,8,109.52569,18.29188,1616
104009,C5A446AC7123103DC030E8D43C03C155,38111,9,12,3,109.52007,18.22403,1555
104010,C5A446AC7123103DC030E8D43C03C155,60221,14,17,3,109.52569,18.29188,1616
104011,C5A446AC7123103DC030E8D43C03C155,30071,18,19,1,109.52819,18.30472,1619
104012,C5A446AC7123103DC030E8D43C03C155,60221,20,21,1,109.52569,18.29188,1616
104048,75817DB682187A07461734D66E1E6492,60631,0,4,4,109.57778,18.27583,1814
104049,75817DB682187A07461734D66E1E6492,30854,6,17,11,109.56889,18.27076,1763
104050,75817DB682187A07461734D66E1E6492,31061,19,20,1,109.53333,18.23257,1607
104051,75817DB682187A07461734D66E1E6492,60631,21,23,2,109.57778,18.27583,1814
104127,E8A62C362548F9D5791FD06549C42092,60054,0,12,12,109.3016,18.31229,770
104128,E8A62C362548F9D5791FD06549C42092,30661,12,14,2,109.37028,18.24361,1008
104129,E8A62C362548F9D5791FD06549C42092,60054,14,16,2,109.3016,18.31229,770
104130,E8A62C362548F9D5791FD06549C42092,60411,19,22,3,109.32514,18.30854,869
104142,38A4ADCA8BA2F0AA89E61BE32DF08B77,30181,13,14,1,109.51597,18.23313,1557
104143,38A4ADCA8BA2F0AA89E61BE32DF08B77,30361,15,16,1,109.50347,18.24,1508
104144,38A4ADCA8BA2F0AA89E61BE32DF08B77,30181,17,18,1,109.51597,18.23313,1557
104145,38A4ADCA8BA2F0AA89E61BE32DF08B77,30181,19,20,1,109.51597,18.23313,1557
104146,38A4ADCA8BA2F0AA89E61BE32DF08B77,31521,21,23,2,109.51458,18.22542,1555
104174,34F3D64B41C252481F72E5CF931AC833,30851,0,6,6,109.5616,18.27396,1713
104175,34F3D64B41C252481F72E5CF931AC833,31071,7,8,1,109.58257,18.28458,1815
104176,34F3D64B41C252481F72E5CF931AC833,60381,13,14,1,109.5241,18.22458,1605
104181,12D6F1B589329281D7FEE105AB4A11AB,31231,0,12,12,109.42597,18.29292,1217
104182,12D6F1B589329281D7FEE105AB4A11AB,31031,12,14,2,109.49979,18.25382,1510
104183,12D6F1B589329281D7FEE105AB4A11AB,38754,15,17,2,109.74667,18.37382,2430
104184,12D6F1B589329281D7FEE105AB4A11AB,30711,19,21,2,109.50271,18.25347,1510
104187,E6A26FB3A5537CE712195E9460AB99FB,30854,0,1,1,109.56889,18.27076,1763
104188,E6A26FB3A5537CE712195E9460AB99FB,60631,3,8,5,109.57778,18.27583,1814
104189,E6A26FB3A5537CE712195E9460AB99FB,30854,8,9,1,109.56889,18.27076,1763
104190,E6A26FB3A5537CE712195E9460AB99FB,38271,11,14,3,109.62632,18.23049,1956
104193,53875E69050EC42E511A64D3211FA7B3,30854,14,15,1,109.56889,18.27076,1763
104194,53875E69050EC42E511A64D3211FA7B3,31561,16,17,1,109.56792,18.28479,1765
104195,53875E69050EC42E511A64D3211FA7B3,60631,22,23,1,109.57778,18.27583,1814
104202,95E09A72760B2799C2CC9BD7AF527107,30854,0,3,3,109.56889,18.27076,1763
104203,95E09A72760B2799C2CC9BD7AF527107,31071,6,23,17,109.58257,18.28458,1815
104207,4DA47CA7E0DF1887A4FCFA8DEF75F8FC,39371,12,17,5,109.56627,18.2646,1762
104208,4DA47CA7E0DF1887A4FCFA8DEF75F8FC,31761,19,23,4,109.60521,18.27965,1914
104226,A952750F25C558E5C17B3EB7DD935431,60371,3,12,9,109.53063,18.30056,1618
104227,A952750F25C558E5C17B3EB7DD935431,31931,14,16,2,109.54771,18.29403,1667
104232,ABCD0851CC1C78BCD7AF6DBDF2F5DE49,60552,0,14,14,109.41729,18.30014,1218
104233,ABCD0851CC1C78BCD7AF6DBDF2F5DE49,60551,14,15,1,109.42722,18.30111,1218
104234,ABCD0851CC1C78BCD7AF6DBDF2F5DE49,31231,18,19,1,109.42597,18.29292,1217
104235,ABCD0851CC1C78BCD7AF6DBDF2F5DE49,60552,19,21,2,109.41729,18.30014,1218
104284,2BEDA68024795D9EC2B7C1E361D17605,39151,13,14,1,109.49875,18.25097,1510
104285,2BEDA68024795D9EC2B7C1E361D17605,30211,15,16,1,109.49882,18.23931,1508
104286,2BEDA68024795D9EC2B7C1E361D17605,30271,18,20,2,109.49132,18.23153,1456
104300,37B1280251A3C52411E939549A58D078,39183,0,6,6,109.55542,18.28208,1715
104301,37B1280251A3C52411E939549A58D078,39181,8,9,1,109.55153,18.28035,1715
104302,37B1280251A3C52411E939549A58D078,39183,10,20,10,109.55542,18.28208,1715
104319,B643AC77F8D8498A9694D45BA8B0F75F,60631,0,14,14,109.57778,18.27583,1814
104320,B643AC77F8D8498A9694D45BA8B0F75F,30854,16,17,1,109.56889,18.27076,1763
104321,B643AC77F8D8498A9694D45BA8B0F75F,31561,20,23,3,109.56792,18.28479,1765
104324,9D637EBA8B134F982FFF63FD06C371B9,38111,0,11,11,109.52007,18.22403,1555
104325,9D637EBA8B134F982FFF63FD06C371B9,60381,12,14,2,109.5241,18.22458,1605
104326,9D637EBA8B134F982FFF63FD06C371B9,31521,15,17,2,109.51458,18.22542,1555
104327,9D637EBA8B134F982FFF63FD06C371B9,30711,17,18,1,109.50271,18.25347,1510
104328,9D637EBA8B134F982FFF63FD06C371B9,60221,19,21,2,109.52569,18.29188,1616
104329,7252A0F90E29EC78621699C082578EF7,31361,0,7,7,109.47417,18.28292,1415
104330,7252A0F90E29EC78621699C082578EF7,31181,7,10,3,109.50382,18.24813,1509
104331,7252A0F90E29EC78621699C082578EF7,60504,13,15,2,109.47917,18.28903,1416
104332,7252A0F90E29EC78621699C082578EF7,60361,19,22,3,109.51938,18.29681,1567
104367,824DCA8F3B3A2543DC4C6574433D7232,30361,15,16,1,109.50347,18.24,1508
104368,824DCA8F3B3A2543DC4C6574433D7232,30441,19,23,4,109.64021,18.25424,2010
104432,27BCEF3137923B84211F08830816C810,31561,18,20,2,109.56792,18.28479,1765
104446,5426296000364EE32711CD0E73D782C8,30854,2,7,5,109.56889,18.27076,1763
104447,5426296000364EE32711CD0E73D782C8,31561,12,14,2,109.56792,18.28479,1765
104448,5426296000364EE32711CD0E73D782C8,31181,16,17,1,109.50382,18.24813,1509
104449,5426296000364EE32711CD0E73D782C8,30854,19,20,1,109.56889,18.27076,1763
104453,896E70230E917230ACB2F2222A93F438,30771,0,8,8,109.49938,18.26042,1511
104458,2361E8D6BAB0231B2E8E3C0F34517282,30084,0,7,7,109.50118,18.26972,1513
104459,2361E8D6BAB0231B2E8E3C0F34517282,31061,8,18,10,109.53333,18.23257,1607
104460,2361E8D6BAB0231B2E8E3C0F34517282,30081,19,23,4,109.50243,18.26632,1512
104472,07015E22078E542DFD52967694C61F1D,30711,18,23,5,109.50271,18.25347,1510
104479,4D944399BAAD1AD37CC1D68A51FA53FD,30161,0,10,10,109.50042,18.24389,1508
104480,4D944399BAAD1AD37CC1D68A51FA53FD,30161,11,18,7,109.50042,18.24389,1508
104483,91EC74D2B208A10BECBB101C6735C578,30171,13,14,1,109.48458,18.27139,1463
104484,91EC74D2B208A10BECBB101C6735C578,60171,17,18,1,109.51292,18.30694,1569
104485,91EC74D2B208A10BECBB101C6735C578,60161,21,23,2,109.49174,18.26181,1461
104491,87C7A513DDAF08C0EAFDEC3998FDF6C5,31291,19,21,2,109.30375,18.40729,786
104492,87C7A513DDAF08C0EAFDEC3998FDF6C5,30991,21,23,2,109.30847,18.44139,791
104501,4995463B780282C9C030A19D9F49AEAC,31071,1,7,6,109.58257,18.28458,1815
104502,4995463B780282C9C030A19D9F49AEAC,30854,7,18,11,109.56889,18.27076,1763
104503,4995463B780282C9C030A19D9F49AEAC,31071,19,21,2,109.58257,18.28458,1815
104506,22654C8C41FD843CC6C6A76B44EF7C2F,31781,18,23,5,109.19847,18.2975,367
104550,66F8B9488B97AC9181E1428AD12A7C79,38951,11,15,4,109.48097,18.28868,1416
104551,66F8B9488B97AC9181E1428AD12A7C79,38951,16,17,1,109.48097,18.28868,1416
104552,66F8B9488B97AC9181E1428AD12A7C79,38951,21,22,1,109.48097,18.28868,1416
104588,00FD2268DE6E83934D2916174E81532F,60011,1,2,1,109.48965,18.30222,1468
104589,00FD2268DE6E83934D2916174E81532F,30111,6,7,1,109.47583,18.30542,1419
104590,00FD2268DE6E83934D2916174E81532F,60472,8,9,1,109.46625,18.29542,1367
104591,00FD2268DE6E83934D2916174E81532F,30111,13,20,7,109.47583,18.30542,1419
104614,8C8DB7A18864109B823771C405E00B29,31421,2,7,5,109.55382,18.22347,1705
104615,8C8DB7A18864109B823771C405E00B29,30951,10,15,5,109.56208,18.25667,1761
104616,8C8DB7A18864109B823771C405E00B29,31071,19,23,4,109.58257,18.28458,1815
104619,B340EDEF4A878E8DF5CBEC25E465EACE,30854,2,5,3,109.56889,18.27076,1763
104620,B340EDEF4A878E8DF5CBEC25E465EACE,60631,9,11,2,109.57778,18.27583,1814
104621,B340EDEF4A878E8DF5CBEC25E465EACE,30854,13,18,5,109.56889,18.27076,1763
104622,B340EDEF4A878E8DF5CBEC25E465EACE,30391,21,22,1,109.4975,18.27118,1513
104648,F198CAA1F49ACA5D003FD8F8473B3798,31561,20,21,1,109.56792,18.28479,1765
104649,F198CAA1F49ACA5D003FD8F8473B3798,30854,22,23,1,109.56889,18.27076,1763
104650,C4BE65FD2368546A4993D06B712375A3,38211,18,19,1,109.49042,18.2625,1462
104651,C4BE65FD2368546A4993D06B712375A3,38094,20,23,3,109.45403,18.28778,1316
104694,7334BFE245C0E1675EC3C07645407CF3,30781,0,1,1,109.3275,18.37847,881
104695,7334BFE245C0E1675EC3C07645407CF3,60411,2,9,7,109.32514,18.30854,869
104696,7334BFE245C0E1675EC3C07645407CF3,30661,11,12,1,109.37028,18.24361,1008
104697,7334BFE245C0E1675EC3C07645407CF3,60054,15,17,2,109.3016,18.31229,770
104698,7334BFE245C0E1675EC3C07645407CF3,60411,19,20,1,109.32514,18.30854,869
104709,8A4E28BD435508BC5C081482DC8F5BBF,60391,20,22,2,109.47667,18.28757,1416
104712,9E3B1AC6114967CC1D1D48B3C4AF21E5,31521,0,13,13,109.51458,18.22542,1555
104713,9E3B1AC6114967CC1D1D48B3C4AF21E5,31471,15,17,2,109.34583,18.29563,917
104714,9E3B1AC6114967CC1D1D48B3C4AF21E5,30711,18,20,2,109.50271,18.25347,1510
104715,9E3B1AC6114967CC1D1D48B3C4AF21E5,38071,22,23,1,109.40722,18.30938,1169
104716,8C5A16299A6D294198C90C34C25C5949,39183,16,17,1,109.55542,18.28208,1715
104717,8C5A16299A6D294198C90C34C25C5949,31561,18,19,1,109.56792,18.28479,1765
104718,8C5A16299A6D294198C90C34C25C5949,39183,20,21,1,109.55542,18.28208,1715
104719,662D882A6A10D0E6C3566690F0A40636,30854,0,17,17,109.56889,18.27076,1763
104720,662D882A6A10D0E6C3566690F0A40636,31071,19,20,1,109.58257,18.28458,1815
104721,662D882A6A10D0E6C3566690F0A40636,30854,21,22,1,109.56889,18.27076,1763
104724,35C6EDC8AAC6B5ABA770190223528BA2,33521,8,9,1,109.66313,18.45174,2143
104725,35C6EDC8AAC6B5ABA770190223528BA2,60381,14,15,1,109.5241,18.22458,1605
104726,35C6EDC8AAC6B5ABA770190223528BA2,60121,19,22,3,109.74507,18.37472,2430
104747,096D8D59612F82CD076740A6D0A18387,38971,0,4,4,109.50743,18.25125,1510
104748,096D8D59612F82CD076740A6D0A18387,31461,5,8,3,109.5091,18.25389,1510
104749,096D8D59612F82CD076740A6D0A18387,33481,10,13,3,109.67278,18.41278,2187
104750,096D8D59612F82CD076740A6D0A18387,60201,16,18,2,109.5041,18.2509,1510
104751,096D8D59612F82CD076740A6D0A18387,30421,19,22,3,109.50021,18.25861,1511
104789,8BB035B44D009B4E567D4EFF10F50E4D,30854,19,23,4,109.56889,18.27076,1763
104813,AE9453D604AF88F4293DEF99463B2345,30281,14,15,1,109.50597,18.27583,1514
104814,AE9453D604AF88F4293DEF99463B2345,38754,19,21,2,109.74667,18.37382,2430
104819,D1EBD1A5A8A922DEF994C933F10DD8DB,31031,0,10,10,109.49979,18.25382,1510
104820,D1EBD1A5A8A922DEF994C933F10DD8DB,60381,14,17,3,109.5241,18.22458,1605
104821,D1EBD1A5A8A922DEF994C933F10DD8DB,30281,18,23,5,109.50597,18.27583,1514
104851,0E0D6E55BB1995EBF85F6B7AA8765E55,30854,2,9,7,109.56889,18.27076,1763
104852,0E0D6E55BB1995EBF85F6B7AA8765E55,31851,14,15,1,109.71736,18.29007,2316
104853,0E0D6E55BB1995EBF85F6B7AA8765E55,60631,18,20,2,109.57778,18.27583,1814
104854,0E0D6E55BB1995EBF85F6B7AA8765E55,30854,21,22,1,109.56889,18.27076,1763
104872,2D39AE6120F2674000C6DBB8A6E572A0,31945,0,7,7,109.58021,18.29403,1817
104873,2D39AE6120F2674000C6DBB8A6E572A0,30854,7,14,7,109.56889,18.27076,1763
104912,C1F9914EF577AE2A8300B1A3945A50FF,30854,12,14,2,109.56889,18.27076,1763
104913,C1F9914EF577AE2A8300B1A3945A50FF,31561,18,19,1,109.56792,18.28479,1765
104914,C1F9914EF577AE2A8300B1A3945A50FF,30851,21,23,2,109.5616,18.27396,1713
104926,B49997E558EBA6E6EDC3CFE777E3F80C,39181,0,7,7,109.55153,18.28035,1715
104927,B49997E558EBA6E6EDC3CFE777E3F80C,39181,10,13,3,109.55153,18.28035,1715
104928,B49997E558EBA6E6EDC3CFE777E3F80C,39181,16,17,1,109.55153,18.28035,1715
104929,B49997E558EBA6E6EDC3CFE777E3F80C,39181,18,23,5,109.55153,18.28035,1715
104949,F5FE23BF42FC224C310CD42E08B0B950,31431,0,7,7,109.44639,18.29042,1316
104950,F5FE23BF42FC224C310CD42E08B0B950,38094,10,14,4,109.45403,18.28778,1316
104951,F5FE23BF42FC224C310CD42E08B0B950,60441,14,15,1,109.46792,18.28604,1366
104952,F5FE23BF42FC224C310CD42E08B0B950,38094,16,18,2,109.45403,18.28778,1316
104953,F5FE23BF42FC224C310CD42E08B0B950,31431,18,19,1,109.44639,18.29042,1316
104954,F5FE23BF42FC224C310CD42E08B0B950,31701,19,23,4,109.44132,18.28833,1266
104957,12A8D64B0FFBA77A4E6F190F59F8F9F6,38951,1,8,7,109.48097,18.28868,1416
104958,12A8D64B0FFBA77A4E6F190F59F8F9F6,30201,9,12,3,109.4909,18.26465,1462
104959,12A8D64B0FFBA77A4E6F190F59F8F9F6,38951,14,23,9,109.48097,18.28868,1416
105109,BE8220A49F1231C0A022F4AA2075503E,31945,0,15,15,109.58021,18.29403,1817
105110,BE8220A49F1231C0A022F4AA2075503E,30854,15,22,7,109.56889,18.27076,1763
105111,F63244589FF36E109B6C600055B0AD94,31521,0,8,8,109.51458,18.22542,1555
105121,C3EF49B0098C6C3C4B26CC8869DE86AF,38271,12,17,5,109.62632,18.23049,1956
105122,C3EF49B0098C6C3C4B26CC8869DE86AF,30854,21,23,2,109.56889,18.27076,1763
105136,A1DF55C42D8446F7B3BDC698ADD3A56E,31071,2,7,5,109.58257,18.28458,1815
105137,A1DF55C42D8446F7B3BDC698ADD3A56E,30854,9,10,1,109.56889,18.27076,1763
105138,A1DF55C42D8446F7B3BDC698ADD3A56E,30421,12,13,1,109.50021,18.25861,1511
105139,A1DF55C42D8446F7B3BDC698ADD3A56E,30891,18,21,3,109.59431,18.28389,1865
105140,A1DF55C42D8446F7B3BDC698ADD3A56E,30854,21,22,1,109.56889,18.27076,1763
105154,9FC721E86703223349C05C95FE4BBB6F,60081,1,7,6,109.51097,18.22639,1556
105155,9FC721E86703223349C05C95FE4BBB6F,31521,9,11,2,109.51458,18.22542,1555
105156,9FC721E86703223349C05C95FE4BBB6F,60381,11,19,8,109.5241,18.22458,1605
105157,9FC721E86703223349C05C95FE4BBB6F,60081,21,23,2,109.51097,18.22639,1556
105174,14B910777C0D6CB8592C0F1A47ED8834,39183,0,8,8,109.55542,18.28208,1715
105175,14B910777C0D6CB8592C0F1A47ED8834,31561,8,11,3,109.56792,18.28479,1765
105176,14B910777C0D6CB8592C0F1A47ED8834,39183,11,13,2,109.55542,18.28208,1715
105187,67559C1EAE3B44D5B9638E1FCA4353EA,60614,17,18,1,109.48799,18.29521,1467
105188,67559C1EAE3B44D5B9638E1FCA4353EA,31206,21,22,1,109.50819,18.23549,1507
105205,E4199729A84482014747EE1ECF3FF7D9,30701,0,2,2,109.59313,18.32007,1871
105206,E4199729A84482014747EE1ECF3FF7D9,30931,2,22,20,109.55653,18.32722,1722
105229,2C0209770A37CBC62C92C1A37F9CD2E2,31521,14,19,5,109.51458,18.22542,1555
105230,2C0209770A37CBC62C92C1A37F9CD2E2,30361,19,21,2,109.50347,18.24,1508
105236,AAD7AB37FCCEE5FFD85BBA1A43FF0C73,30854,0,7,7,109.56889,18.27076,1763
105237,AAD7AB37FCCEE5FFD85BBA1A43FF0C73,31561,11,17,6,109.56792,18.28479,1765
105238,AAD7AB37FCCEE5FFD85BBA1A43FF0C73,30854,18,20,2,109.56889,18.27076,1763
105254,C98DECAAC7B1CEF53BA610BF4A518961,39321,0,16,16,109.529,18.2167,1604
105255,C98DECAAC7B1CEF53BA610BF4A518961,30161,18,20,2,109.50042,18.24389,1508
105256,C98DECAAC7B1CEF53BA610BF4A518961,30421,21,23,2,109.50021,18.25861,1511
105266,E38DC10DFD2C557684F4AC8C62B66FC7,31101,13,14,1,109.65389,18.23403,2057
105267,E38DC10DFD2C557684F4AC8C62B66FC7,30854,17,21,4,109.56889,18.27076,1763
105304,51F61C2B2AFEB6CE055DCFE40CCD58AD,60552,1,3,2,109.41729,18.30014,1218
105305,51F61C2B2AFEB6CE055DCFE40CCD58AD,30351,4,8,4,109.41701,18.29292,1217
105306,51F61C2B2AFEB6CE055DCFE40CCD58AD,60551,9,10,1,109.42722,18.30111,1218
105311,9A1C08A25191CFE5C0B470C25F3A19FD,31181,0,7,7,109.50382,18.24813,1509
105312,9A1C08A25191CFE5C0B470C25F3A19FD,31473,10,12,2,109.34792,18.29465,917
105313,9A1C08A25191CFE5C0B470C25F3A19FD,31471,12,14,2,109.34583,18.29563,917
105314,9A1C08A25191CFE5C0B470C25F3A19FD,31701,16,18,2,109.44132,18.28833,1266
105315,9A1C08A25191CFE5C0B470C25F3A19FD,38391,20,22,2,109.44111,18.29083,1266
105364,2576A40187A845D7B849E820F16B3DB1,30854,3,10,7,109.56889,18.27076,1763
105365,2576A40187A845D7B849E820F16B3DB1,31071,10,17,7,109.58257,18.28458,1815
105366,2576A40187A845D7B849E820F16B3DB1,30854,18,20,2,109.56889,18.27076,1763
105369,90B0A60855A43B2DB99A0964CE51D3AF,31071,0,6,6,109.58257,18.28458,1815
105370,90B0A60855A43B2DB99A0964CE51D3AF,30854,8,16,8,109.56889,18.27076,1763
105371,90B0A60855A43B2DB99A0964CE51D3AF,60463,19,21,2,109.52507,18.22438,1605
105445,E9166100808A4A843C75242C298C8C5D,38251,16,18,2,109.49618,18.25493,1510
105446,E9166100808A4A843C75242C298C8C5D,30361,19,20,1,109.50347,18.24,1508
105455,39997DEFFD87AA0C9D18E1194544E438,30854,5,6,1,109.56889,18.27076,1763
105456,39997DEFFD87AA0C9D18E1194544E438,39371,10,23,13,109.56627,18.2646,1762
105463,4DC58212A02FE5940554514185F78FA7,31521,0,13,13,109.51458,18.22542,1555
105464,4DC58212A02FE5940554514185F78FA7,38331,16,19,3,109.62465,18.22736,1956
105465,4DC58212A02FE5940554514185F78FA7,30581,20,21,1,109.62257,18.24951,1959
105466,4DC58212A02FE5940554514185F78FA7,31571,22,23,1,109.61563,18.23326,1957
105495,A31156C6519BD5D8AB23829D811E9C63,31041,1,9,8,109.50278,18.23701,1507
105496,A31156C6519BD5D8AB23829D811E9C63,60201,11,12,1,109.5041,18.2509,1510
105497,A31156C6519BD5D8AB23829D811E9C63,30361,13,23,10,109.50347,18.24,1508
105502,0D3DA8126B134D203BB35373EAFFB116,31071,0,5,5,109.58257,18.28458,1815
105503,0D3DA8126B134D203BB35373EAFFB116,30854,7,9,2,109.56889,18.27076,1763
105504,0D3DA8126B134D203BB35373EAFFB116,31071,11,22,11,109.58257,18.28458,1815
105527,2F3F10722345B5DB33B8FB4B7FFFF613,30854,12,14,2,109.56889,18.27076,1763
105528,2F3F10722345B5DB33B8FB4B7FFFF613,31521,16,23,7,109.51458,18.22542,1555
105559,47A18820FDA9856131F74091D44B6BCB,31561,3,13,10,109.56792,18.28479,1765
105560,47A18820FDA9856131F74091D44B6BCB,30851,14,16,2,109.5616,18.27396,1713
105561,47A18820FDA9856131F74091D44B6BCB,31561,19,20,1,109.56792,18.28479,1765
105629,B663EE883B81AEB709AC84DCCEC3D38E,31945,0,7,7,109.58021,18.29403,1817
105630,B663EE883B81AEB709AC84DCCEC3D38E,30854,8,12,4,109.56889,18.27076,1763
105631,B663EE883B81AEB709AC84DCCEC3D38E,31945,13,14,1,109.58021,18.29403,1817
105632,B663EE883B81AEB709AC84DCCEC3D38E,30854,16,18,2,109.56889,18.27076,1763
105633,B663EE883B81AEB709AC84DCCEC3D38E,31945,21,23,2,109.58021,18.29403,1817
105659,FB7BFB65FDD11A55BD33FE9788F97BC2,30854,20,21,1,109.56889,18.27076,1763
105660,FB7BFB65FDD11A55BD33FE9788F97BC2,31071,22,23,1,109.58257,18.28458,1815
105687,EFFD4571117B023D4BFFAE2F1C9E1510,39191,3,6,3,109.51493,18.23472,1557
105688,EFFD4571117B023D4BFFAE2F1C9E1510,31201,7,10,3,109.51042,18.23819,1558
105689,EFFD4571117B023D4BFFAE2F1C9E1510,30661,13,14,1,109.37028,18.24361,1008
105690,EFFD4571117B023D4BFFAE2F1C9E1510,31201,16,18,2,109.51042,18.23819,1558
105691,EFFD4571117B023D4BFFAE2F1C9E1510,60291,18,20,2,109.50826,18.24639,1509
105692,EFFD4571117B023D4BFFAE2F1C9E1510,38961,21,23,2,109.50847,18.23514,1507
105718,84DF4A7C208235D171EF56473BCCF210,30851,0,1,1,109.5616,18.27396,1713
105719,84DF4A7C208235D171EF56473BCCF210,31561,4,7,3,109.56792,18.28479,1765
105720,84DF4A7C208235D171EF56473BCCF210,60631,9,17,8,109.57778,18.27583,1814
105721,C0D9A8D1FC57A96EA766A127A0E8EAAC,60591,13,14,1,109.61118,18.21715,1904
105722,C0D9A8D1FC57A96EA766A127A0E8EAAC,30581,16,18,2,109.62257,18.24951,1959
105727,015CDEB9169BCE5537ABAE49B6A63F2B,31071,0,12,12,109.58257,18.28458,1815
105728,015CDEB9169BCE5537ABAE49B6A63F2B,30854,14,17,3,109.56889,18.27076,1763
105729,015CDEB9169BCE5537ABAE49B6A63F2B,38111,20,21,1,109.52007,18.22403,1555
105739,8205D8404DFD9A6EF3060E66802D375E,30854,0,14,14,109.56889,18.27076,1763
105740,8205D8404DFD9A6EF3060E66802D375E,31071,14,15,1,109.58257,18.28458,1815
105741,8205D8404DFD9A6EF3060E66802D375E,30854,17,23,6,109.56889,18.27076,1763
105754,DD7E0EAEDD4EFE17B18F06BF606BF2E5,31101,0,2,2,109.65389,18.23403,2057
105755,DD7E0EAEDD4EFE17B18F06BF606BF2E5,38134,3,4,1,109.63931,18.23451,2007
105756,DD7E0EAEDD4EFE17B18F06BF606BF2E5,30581,5,8,3,109.62257,18.24951,1959
105757,83F8DEFB45E9970F803B6E01CF53475C,60361,0,3,3,109.51938,18.29681,1567
105758,83F8DEFB45E9970F803B6E01CF53475C,31021,4,21,17,109.49021,18.27,1463
105759,83F8DEFB45E9970F803B6E01CF53475C,60361,21,23,2,109.51938,18.29681,1567
105760,A94F66C88B84FF0658441320CD9F667C,30854,0,12,12,109.56889,18.27076,1763
105761,A94F66C88B84FF0658441320CD9F667C,31761,12,14,2,109.60521,18.27965,1914
105762,A94F66C88B84FF0658441320CD9F667C,31071,14,16,2,109.58257,18.28458,1815
105763,A94F66C88B84FF0658441320CD9F667C,30854,17,20,3,109.56889,18.27076,1763
105764,A94F66C88B84FF0658441320CD9F667C,31071,21,23,2,109.58257,18.28458,1815
105814,8CE55AC8BC984D52D16D6CE4872EB6FC,31391,16,23,7,109.50382,18.24285,1508
105865,D6A345956751BA2ACC5430EDF68A104F,39181,0,6,6,109.55153,18.28035,1715
105866,D6A345956751BA2ACC5430EDF68A104F,31931,6,10,4,109.54771,18.29403,1667
105867,D6A345956751BA2ACC5430EDF68A104F,39181,11,13,2,109.55153,18.28035,1715
105868,D6A345956751BA2ACC5430EDF68A104F,31931,13,17,4,109.54771,18.29403,1667
105869,D6A345956751BA2ACC5430EDF68A104F,31071,19,23,4,109.58257,18.28458,1815
105870,812708400337F675A87A189BADB470F9,30854,0,13,13,109.56889,18.27076,1763
105871,812708400337F675A87A189BADB470F9,31071,14,23,9,109.58257,18.28458,1815
105886,663CE56232D73D50E42DEC41EA33269F,31931,2,9,7,109.54771,18.29403,1667
105887,663CE56232D73D50E42DEC41EA33269F,30921,10,11,1,109.53903,18.29451,1667
105888,663CE56232D73D50E42DEC41EA33269F,31931,11,15,4,109.54771,18.29403,1667
105889,0D00E0CA974DDA00224ACCD00B993468,30854,0,5,5,109.56889,18.27076,1763
105890,0D00E0CA974DDA00224ACCD00B993468,31561,8,9,1,109.56792,18.28479,1765
105891,0D00E0CA974DDA00224ACCD00B993468,30851,12,15,3,109.5616,18.27396,1713
105892,0D00E0CA974DDA00224ACCD00B993468,31071,19,21,2,109.58257,18.28458,1815
105913,561522A1ED5FFA63DCA382D0CB310A1A,30171,0,15,15,109.48458,18.27139,1463
105914,561522A1ED5FFA63DCA382D0CB310A1A,30171,17,23,6,109.48458,18.27139,1463
105918,AEED1E225CF3D1399AAF76E61B9A21EB,38951,0,6,6,109.48097,18.28868,1416
105919,AEED1E225CF3D1399AAF76E61B9A21EB,38951,7,8,1,109.48097,18.28868,1416
105920,AEED1E225CF3D1399AAF76E61B9A21EB,39321,9,10,1,109.529,18.2167,1604
105921,AEED1E225CF3D1399AAF76E61B9A21EB,60381,11,13,2,109.5241,18.22458,1605
105922,AEED1E225CF3D1399AAF76E61B9A21EB,38951,13,21,8,109.48097,18.28868,1416
105923,AEED1E225CF3D1399AAF76E61B9A21EB,38951,21,23,2,109.48097,18.28868,1416
105938,4A0A93A257347F50F0B6F0C8309FF3C3,31521,1,19,18,109.51458,18.22542,1555
105939,4A0A93A257347F50F0B6F0C8309FF3C3,30361,19,21,2,109.50347,18.24,1508
105940,4A0A93A257347F50F0B6F0C8309FF3C3,31521,21,23,2,109.51458,18.22542,1555
105948,F00821368F615DCDAF214035D8EC4A44,31071,1,6,5,109.58257,18.28458,1815
105949,F00821368F615DCDAF214035D8EC4A44,30854,10,16,6,109.56889,18.27076,1763
105950,F00821368F615DCDAF214035D8EC4A44,31071,18,20,2,109.58257,18.28458,1815
105961,0B0A4C0A7E61899F2C378BD8BB49E626,30661,15,16,1,109.37028,18.24361,1008
105962,0B0A4C0A7E61899F2C378BD8BB49E626,38071,19,20,1,109.40722,18.30938,1169
105982,6FE9D30AF9D5BAD1F717916B377146E9,31206,0,18,18,109.50819,18.23549,1507
105983,6FE9D30AF9D5BAD1F717916B377146E9,60291,18,21,3,109.50826,18.24639,1509
105984,6FE9D30AF9D5BAD1F717916B377146E9,38961,22,23,1,109.50847,18.23514,1507
105985,934029FB5F97BCE114EDCE88F0393A63,30854,0,6,6,109.56889,18.27076,1763
105986,934029FB5F97BCE114EDCE88F0393A63,30234,9,11,2,109.60681,18.29979,1918
105987,934029FB5F97BCE114EDCE88F0393A63,31945,12,13,1,109.58021,18.29403,1817
105990,C2CC718D695CB45C49C10B739F52F650,31031,1,11,10,109.49979,18.25382,1510
105991,C2CC718D695CB45C49C10B739F52F650,31031,12,14,2,109.49979,18.25382,1510
105992,C2CC718D695CB45C49C10B739F52F650,31031,15,23,8,109.49979,18.25382,1510
106001,96F98526707B06BE1263CCD4F72E07A1,30854,0,12,12,109.56889,18.27076,1763
106002,96F98526707B06BE1263CCD4F72E07A1,31071,16,18,2,109.58257,18.28458,1815
106003,96F98526707B06BE1263CCD4F72E07A1,30854,19,20,1,109.56889,18.27076,1763
106004,96F98526707B06BE1263CCD4F72E07A1,31945,20,22,2,109.58021,18.29403,1817
106005,513924E5F8EAB458027327A1E2BAE9DB,30854,0,7,7,109.56889,18.27076,1763
106006,513924E5F8EAB458027327A1E2BAE9DB,30731,12,17,5,109.50944,18.22306,1555
106015,335A7B1DE8538918FDA774EE3E402A76,30191,0,7,7,109.50361,18.22701,1506
106016,335A7B1DE8538918FDA774EE3E402A76,31521,7,16,9,109.51458,18.22542,1555
106017,335A7B1DE8538918FDA774EE3E402A76,30191,18,23,5,109.50361,18.22701,1506
106025,8D7B9451E0189947198D6AC9CE51CFEE,60504,1,3,2,109.47917,18.28903,1416
106026,8D7B9451E0189947198D6AC9CE51CFEE,31091,5,18,13,109.41201,18.31222,1170
106027,8D7B9451E0189947198D6AC9CE51CFEE,30111,18,23,5,109.47583,18.30542,1419
106041,AA17C9279A63248D7DCDF49F93EB8817,30854,0,6,6,109.56889,18.27076,1763
106042,AA17C9279A63248D7DCDF49F93EB8817,38275,8,16,8,109.62875,18.22938,2006
106068,D73D0E1690714CD7F442C709F67E4771,60361,0,7,7,109.51938,18.29681,1567
106069,D73D0E1690714CD7F442C709F67E4771,30851,8,10,2,109.5616,18.27396,1713
106070,D73D0E1690714CD7F442C709F67E4771,31551,10,12,2,109.55868,18.24222,1708
106071,D73D0E1690714CD7F442C709F67E4771,30951,14,17,3,109.56208,18.25667,1761
106072,D73D0E1690714CD7F442C709F67E4771,60361,18,23,5,109.51938,18.29681,1567
106109,A14C813C3E3A7182759DA822342505B5,39183,0,6,6,109.55542,18.28208,1715
106110,A14C813C3E3A7182759DA822342505B5,39181,7,8,1,109.55153,18.28035,1715
106111,A14C813C3E3A7182759DA822342505B5,39183,11,13,2,109.55542,18.28208,1715
106112,A14C813C3E3A7182759DA822342505B5,39181,13,23,10,109.55153,18.28035,1715
106123,F84D949DDCBF25D5530F771BC55E0B9D,61011,0,16,16,109.60653,18.19076,1900
106135,07169E7114E4F14C073261BAAC0D4491,61011,0,6,6,109.60653,18.19076,1900
106137,07169E7114E4F14C073261BAAC0D4491,61011,8,13,5,109.60653,18.19076,1900
106139,07169E7114E4F14C073261BAAC0D4491,61011,16,22,6,109.60653,18.19076,1900
106148,6E2021B014C4D0B652A2E4FE8D2CF038,31071,4,7,3,109.58257,18.28458,1815
106149,6E2021B014C4D0B652A2E4FE8D2CF038,30854,8,20,12,109.56889,18.27076,1763
106150,6E2021B014C4D0B652A2E4FE8D2CF038,31071,21,23,2,109.58257,18.28458,1815
106154,75BB5F056A285E641293B913E6CE7C17,30201,0,9,9,109.4909,18.26465,1462
106155,75BB5F056A285E641293B913E6CE7C17,39183,10,11,1,109.55542,18.28208,1715
106156,75BB5F056A285E641293B913E6CE7C17,38261,14,16,2,109.50361,18.28153,1515
106162,F2D05E21011627911E032EF5E2881C02,60054,12,14,2,109.3016,18.31229,770
106163,F2D05E21011627911E032EF5E2881C02,31521,17,23,6,109.51458,18.22542,1555
106197,0F5941C6E62F3F6BC38896A58D777D2A,30211,0,1,1,109.49882,18.23931,1508
106198,0F5941C6E62F3F6BC38896A58D777D2A,30211,3,7,4,109.49882,18.23931,1508
106199,0F5941C6E62F3F6BC38896A58D777D2A,31781,12,13,1,109.19847,18.2975,367
106200,0F5941C6E62F3F6BC38896A58D777D2A,31471,15,16,1,109.34583,18.29563,917
106201,0F5941C6E62F3F6BC38896A58D777D2A,60221,18,21,3,109.52569,18.29188,1616
106226,121138E269BBF0B506FA8CE6CEB3BF52,31931,0,15,15,109.54771,18.29403,1667
106227,121138E269BBF0B506FA8CE6CEB3BF52,39181,16,17,1,109.55153,18.28035,1715
106228,121138E269BBF0B506FA8CE6CEB3BF52,31931,18,23,5,109.54771,18.29403,1667
106242,9C1407835BC54BEBDB541F52E1DA1820,61011,0,1,1,109.60653,18.19076,1900
106244,9C1407835BC54BEBDB541F52E1DA1820,61011,7,15,8,109.60653,18.19076,1900
106246,9C1407835BC54BEBDB541F52E1DA1820,61011,21,23,2,109.60653,18.19076,1900
106274,A7B1A0DED13DE1A6767943346C42150E,38361,0,9,9,109.43667,18.29201,1267
106275,A7B1A0DED13DE1A6767943346C42150E,30661,11,13,2,109.37028,18.24361,1008
106299,231B029CF9822C5AF0B9A3E57B6E3364,60411,0,6,6,109.32514,18.30854,869
106300,231B029CF9822C5AF0B9A3E57B6E3364,31471,10,11,1,109.34583,18.29563,917
106301,231B029CF9822C5AF0B9A3E57B6E3364,60411,12,14,2,109.32514,18.30854,869
106302,231B029CF9822C5AF0B9A3E57B6E3364,31781,16,17,1,109.19847,18.2975,367
106303,231B029CF9822C5AF0B9A3E57B6E3364,60411,19,23,4,109.32514,18.30854,869
106334,6F5AC3BF8416D28CECE26673BD19B71D,38334,0,11,11,109.65035,18.23785,2057
106335,6F5AC3BF8416D28CECE26673BD19B71D,39183,13,14,1,109.55542,18.28208,1715
106336,6F5AC3BF8416D28CECE26673BD19B71D,31101,16,18,2,109.65389,18.23403,2057
106360,8C3D244B6DAAE8C73F174808255E03C6,60011,0,7,7,109.48965,18.30222,1468
106361,8C3D244B6DAAE8C73F174808255E03C6,30111,10,12,2,109.47583,18.30542,1419
106362,8C3D244B6DAAE8C73F174808255E03C6,30764,14,19,5,109.45806,18.29486,1367
106363,2A699167E9D3E245FFAC98B0B1AFC37B,30854,0,10,10,109.56889,18.27076,1763
106364,2A699167E9D3E245FFAC98B0B1AFC37B,31101,13,15,2,109.65389,18.23403,2057
106365,2A699167E9D3E245FFAC98B0B1AFC37B,30854,15,23,8,109.56889,18.27076,1763
106373,10BB72F4E7990A3695C663829F0D188E,30081,9,13,4,109.50243,18.26632,1512
106374,10BB72F4E7990A3695C663829F0D188E,31201,14,16,2,109.51042,18.23819,1558
106375,10BB72F4E7990A3695C663829F0D188E,30421,19,21,2,109.50021,18.25861,1511
106378,602A18E3D49AF3E12266148924C74085,30171,12,13,1,109.48458,18.27139,1463
106379,602A18E3D49AF3E12266148924C74085,38111,15,19,4,109.52007,18.22403,1555
106380,602A18E3D49AF3E12266148924C74085,30361,19,21,2,109.50347,18.24,1508
106415,B80D4B4CDBD08237A9C4254F8883AEF4,39151,0,7,7,109.49875,18.25097,1510
106416,B80D4B4CDBD08237A9C4254F8883AEF4,31181,8,9,1,109.50382,18.24813,1509
106417,B80D4B4CDBD08237A9C4254F8883AEF4,30711,12,14,2,109.50271,18.25347,1510
106418,B80D4B4CDBD08237A9C4254F8883AEF4,39091,18,23,5,109.50097,18.25222,1510
106419,777EC08CE4A1629F92050B8E45D8DE2E,38141,0,9,9,109.39479,18.2916,1116
106420,777EC08CE4A1629F92050B8E45D8DE2E,31471,13,14,1,109.34583,18.29563,917
106421,777EC08CE4A1629F92050B8E45D8DE2E,31391,18,19,1,109.50382,18.24285,1508
106422,777EC08CE4A1629F92050B8E45D8DE2E,38141,22,23,1,109.39479,18.2916,1116
106438,CCCD2290FB632A48009771412BE68ADD,31561,0,6,6,109.56792,18.28479,1765
106439,CCCD2290FB632A48009771412BE68ADD,39183,9,10,1,109.55542,18.28208,1715
106440,CCCD2290FB632A48009771412BE68ADD,31561,14,15,1,109.56792,18.28479,1765
106441,CCCD2290FB632A48009771412BE68ADD,39183,16,17,1,109.55542,18.28208,1715
106445,8799356B7181F28146A203E5F86C52F0,31351,2,7,5,109.4959,18.28417,1465
106446,8799356B7181F28146A203E5F86C52F0,38834,8,21,13,109.47639,18.21146,1403
106450,5B89269E4A739CCC648F48BDED79AD0C,31561,1,5,4,109.56792,18.28479,1765
106451,5B89269E4A739CCC648F48BDED79AD0C,30854,8,11,3,109.56889,18.27076,1763
106460,73EAC1341C5005A58B26B1A52457F38B,39101,0,2,2,109.50132,18.24931,1509
106461,73EAC1341C5005A58B26B1A52457F38B,31181,2,18,16,109.50382,18.24813,1509
106482,6300414882932A98E73E91790947DC62,60281,1,6,5,109.51743,18.25924,1561
106483,6300414882932A98E73E91790947DC62,30251,6,12,6,109.50611,18.26653,1512
106484,6300414882932A98E73E91790947DC62,60281,12,23,11,109.51743,18.25924,1561
106485,99CBAA6A65A50998F0A10B72B36210E4,30661,13,14,1,109.37028,18.24361,1008
106486,99CBAA6A65A50998F0A10B72B36210E4,60231,14,22,8,109.49903,18.21972,1504
106487,2FE0F3A82C27452F04A6B927F514EFA7,31551,3,8,5,109.55868,18.24222,1708
106488,2FE0F3A82C27452F04A6B927F514EFA7,31554,11,12,1,109.55521,18.2459,1709
106489,2FE0F3A82C27452F04A6B927F514EFA7,38541,15,17,2,109.73715,18.34875,2426
106490,2FE0F3A82C27452F04A6B927F514EFA7,31551,19,23,4,109.55868,18.24222,1708
106515,17367053A58C1678FB35004807ED1753,31031,6,18,12,109.49979,18.25382,1510
106516,17367053A58C1678FB35004807ED1753,38251,18,22,4,109.49618,18.25493,1510
106546,37D38EF0062E64D55C94EB554B76F9EE,31071,0,7,7,109.58257,18.28458,1815
106547,37D38EF0062E64D55C94EB554B76F9EE,30854,11,13,2,109.56889,18.27076,1763
106548,37D38EF0062E64D55C94EB554B76F9EE,31071,17,18,1,109.58257,18.28458,1815
106549,37D38EF0062E64D55C94EB554B76F9EE,31164,18,20,2,109.69993,18.27215,2263
106577,DF1914B7230B32BA806E8A8749CAD846,60491,1,16,15,109.43354,18.30847,1269
106578,DF1914B7230B32BA806E8A8749CAD846,60261,18,22,4,109.44326,18.3075,1319
106586,EF24901D99384F703B20FE07F2784FA0,30101,0,1,1,109.57299,18.33333,1773
106587,EF24901D99384F703B20FE07F2784FA0,31631,1,7,6,109.59542,18.36826,1879
106588,EF24901D99384F703B20FE07F2784FA0,30101,8,23,15,109.57299,18.33333,1773
106596,8439399E87DFE1E3AC58B89ABF1408A7,31521,0,8,8,109.51458,18.22542,1555
106597,8439399E87DFE1E3AC58B89ABF1408A7,60381,10,15,5,109.5241,18.22458,1605
106598,8439399E87DFE1E3AC58B89ABF1408A7,30711,19,22,3,109.50271,18.25347,1510
106649,A85947777B4AC51D2273D90B9113A029,30561,0,6,6,109.52778,18.31938,1621
106650,A85947777B4AC51D2273D90B9113A029,31951,7,9,2,109.52174,18.30299,1568
106651,A85947777B4AC51D2273D90B9113A029,30561,11,15,4,109.52778,18.31938,1621
106652,A85947777B4AC51D2273D90B9113A029,38484,15,16,1,109.53028,18.31528,1620
106653,A85947777B4AC51D2273D90B9113A029,30421,18,20,2,109.50021,18.25861,1511
106654,A85947777B4AC51D2273D90B9113A029,30561,21,23,2,109.52778,18.31938,1621
106672,020753EF78F0A0C39658113A3377EA1E,31561,3,8,5,109.56792,18.28479,1765
106673,020753EF78F0A0C39658113A3377EA1E,31931,8,10,2,109.54771,18.29403,1667
106675,05A57DE8DC0D94268B97E02566D1A0C9,60351,18,22,4,109.58403,18.28958,1816
106689,49B83C7F9A6DE289690C374F9AA78932,31151,0,17,17,109.75549,18.4191,2488
106690,49B83C7F9A6DE289690C374F9AA78932,30421,18,21,3,109.50021,18.25861,1511
106691,3971E288F0FB50DDE06A11C534E966DA,30854,0,16,16,109.56889,18.27076,1763
106692,3971E288F0FB50DDE06A11C534E966DA,30191,21,23,2,109.50361,18.22701,1506
106757,4A5667D82CB3C711D86862CBE82C4E19,38325,18,19,1,109.39792,18.2909,1116
106758,4A5667D82CB3C711D86862CBE82C4E19,38027,19,23,4,109.38833,18.2909,1066
106779,A55D4129A4D1B105629D337545083A9E,39183,0,11,11,109.55542,18.28208,1715
106780,A55D4129A4D1B105629D337545083A9E,31561,16,23,7,109.56792,18.28479,1765
106783,46FB195BB21573CE6CD85D42D7B06C1A,31071,2,8,6,109.58257,18.28458,1815
106784,46FB195BB21573CE6CD85D42D7B06C1A,30854,11,16,5,109.56889,18.27076,1763
106808,46C761D2C5BB3E9FC0E036B374FF60F4,30854,0,1,1,109.56889,18.27076,1763
106809,46C761D2C5BB3E9FC0E036B374FF60F4,31071,3,9,6,109.58257,18.28458,1815
106810,46C761D2C5BB3E9FC0E036B374FF60F4,30854,10,23,13,109.56889,18.27076,1763
106826,56F818D0924E7BDB02CCC04065747626,38205,1,16,15,109.62743,18.23139,1956
106827,56F818D0924E7BDB02CCC04065747626,31181,21,23,2,109.50382,18.24813,1509
106828,51061B3DE820AF1C1C713EF684728003,31071,1,3,2,109.58257,18.28458,1815
106829,51061B3DE820AF1C1C713EF684728003,30854,3,23,20,109.56889,18.27076,1763
106830,012ABD06F231728C214A4BA917E75B1C,30851,0,1,1,109.5616,18.27396,1713
106831,012ABD06F231728C214A4BA917E75B1C,31561,2,3,1,109.56792,18.28479,1765
106832,012ABD06F231728C214A4BA917E75B1C,30851,3,4,1,109.5616,18.27396,1713
106833,012ABD06F231728C214A4BA917E75B1C,31561,8,14,6,109.56792,18.28479,1765
106834,213AF2099653A4ADAEF799CCC144B279,30021,0,21,21,109.12014,18.40986,86
106836,A8E9C7BB918ADAD29A3EA7ACDDCD32D7,38951,0,8,8,109.48097,18.28868,1416
106837,A8E9C7BB918ADAD29A3EA7ACDDCD32D7,39041,8,14,6,109.40021,18.29278,1117
106838,A8E9C7BB918ADAD29A3EA7ACDDCD32D7,60041,15,16,1,109.39889,18.31944,1121
106839,A8E9C7BB918ADAD29A3EA7ACDDCD32D7,38951,18,22,4,109.48097,18.28868,1416
106845,ED52FAA860ECB2F5A4527D53311E0122,31071,6,7,1,109.58257,18.28458,1815
106846,ED52FAA860ECB2F5A4527D53311E0122,30854,7,13,6,109.56889,18.27076,1763
106877,1980C8D409DE9551539224B3D393CDAA,30071,1,17,16,109.52819,18.30472,1619
106878,1980C8D409DE9551539224B3D393CDAA,30071,18,23,5,109.52819,18.30472,1619
106912,635914FBAF9BDB855B8CB450E2AE782A,38834,0,1,1,109.47639,18.21146,1403
106913,635914FBAF9BDB855B8CB450E2AE782A,30051,4,7,3,109.48917,18.21215,1453
106914,635914FBAF9BDB855B8CB450E2AE782A,31031,11,13,2,109.49979,18.25382,1510
106915,635914FBAF9BDB855B8CB450E2AE782A,38315,14,17,3,109.48979,18.29764,1467
106930,BEE3A0C9BB09D7F210E3490BED90A1BE,60371,0,4,4,109.53063,18.30056,1618
106931,BEE3A0C9BB09D7F210E3490BED90A1BE,30071,4,7,3,109.52819,18.30472,1619
106932,BEE3A0C9BB09D7F210E3490BED90A1BE,30791,10,23,13,109.72333,18.40889,2386
106981,19528C4631F1EE713711638CA8EA470F,30111,6,15,9,109.47583,18.30542,1419
106982,19528C4631F1EE713711638CA8EA470F,31431,16,17,1,109.44639,18.29042,1316
106983,19528C4631F1EE713711638CA8EA470F,31521,17,19,2,109.51458,18.22542,1555
106984,19528C4631F1EE713711638CA8EA470F,31431,20,21,1,109.44639,18.29042,1316
107007,43E035AE85036EBD9891453E9567CB81,30151,0,7,7,109.50986,18.25083,1560
107008,43E035AE85036EBD9891453E9567CB81,60504,11,14,3,109.47917,18.28903,1416
107009,43E035AE85036EBD9891453E9567CB81,30151,19,23,4,109.50986,18.25083,1560
107010,782BCA908252809750EF6B8020D2A86A,39191,0,3,3,109.51493,18.23472,1557
107011,782BCA908252809750EF6B8020D2A86A,31201,3,10,7,109.51042,18.23819,1558
107012,782BCA908252809750EF6B8020D2A86A,30661,12,15,3,109.37028,18.24361,1008
107013,782BCA908252809750EF6B8020D2A86A,31201,16,18,2,109.51042,18.23819,1558
107014,782BCA908252809750EF6B8020D2A86A,60291,19,20,1,109.50826,18.24639,1509
107015,782BCA908252809750EF6B8020D2A86A,31201,21,23,2,109.51042,18.23819,1558
107079,6ADBEFDC21CA46F051933BF984A8E255,60631,0,5,5,109.57778,18.27583,1814
107080,6ADBEFDC21CA46F051933BF984A8E255,30961,7,9,2,109.74042,18.37903,2431
107081,6ADBEFDC21CA46F051933BF984A8E255,38706,11,13,2,109.74625,18.37097,2430
107135,33408B368FAE333E336D708FABDADA78,60241,2,4,2,109.53319,18.28667,1616
107136,33408B368FAE333E336D708FABDADA78,38154,5,6,1,109.5266,18.28278,1615
107137,33408B368FAE333E336D708FABDADA78,60241,6,9,3,109.53319,18.28667,1616
107138,EAA278A02518264B6E4A1535EA0B5763,31471,14,15,1,109.34583,18.29563,917
107139,EAA278A02518264B6E4A1535EA0B5763,30421,18,23,5,109.50021,18.25861,1511
107143,9D52111AAF3CBA9B2742D7EEE49670D6,60381,0,8,8,109.5241,18.22458,1605
107144,9D52111AAF3CBA9B2742D7EEE49670D6,31301,9,12,3,109.14493,18.31222,170
107145,9D52111AAF3CBA9B2742D7EEE49670D6,31471,13,15,2,109.34583,18.29563,917
107146,9D52111AAF3CBA9B2742D7EEE49670D6,30421,20,21,1,109.50021,18.25861,1511
107147,9D52111AAF3CBA9B2742D7EEE49670D6,60381,22,23,1,109.5241,18.22458,1605
107153,08077B5D5F0A9938A81D328635D03C8B,30854,0,6,6,109.56889,18.27076,1763
107154,08077B5D5F0A9938A81D328635D03C8B,30851,7,8,1,109.5616,18.27396,1713
107155,08077B5D5F0A9938A81D328635D03C8B,31071,10,12,2,109.58257,18.28458,1815
107156,08077B5D5F0A9938A81D328635D03C8B,30851,12,14,2,109.5616,18.27396,1713
107157,08077B5D5F0A9938A81D328635D03C8B,30854,16,17,1,109.56889,18.27076,1763
107158,08077B5D5F0A9938A81D328635D03C8B,38185,18,21,3,109.51333,18.27347,1563
107222,3EAE2CCEF780CC2E20C47963EA2CF3C6,30854,5,10,5,109.56889,18.27076,1763
107223,3EAE2CCEF780CC2E20C47963EA2CF3C6,31031,15,16,1,109.49979,18.25382,1510
107224,3EAE2CCEF780CC2E20C47963EA2CF3C6,31071,20,22,2,109.58257,18.28458,1815
107227,33A62A8066AF8B1342859DF4B906FBD2,31031,18,20,2,109.49979,18.25382,1510
107228,33A62A8066AF8B1342859DF4B906FBD2,30351,21,23,2,109.41701,18.29292,1217
107253,377A324496E54511961704972731A3D5,31821,0,6,6,109.51181,18.24924,1559
107254,377A324496E54511961704972731A3D5,38297,10,13,3,109.52576,18.24965,1609
107255,377A324496E54511961704972731A3D5,60311,17,18,1,109.52097,18.24319,1558
107256,377A324496E54511961704972731A3D5,31821,19,23,4,109.51181,18.24924,1559
107307,6422CB87ACC55DDEF6EBE8946593C808,31351,0,7,7,109.4959,18.28417,1465
107308,6422CB87ACC55DDEF6EBE8946593C808,38834,12,22,10,109.47639,18.21146,1403
107347,5B52C71F88DF5C7017D89C4E504F495B,33481,13,15,2,109.67278,18.41278,2187
107348,5B52C71F88DF5C7017D89C4E504F495B,31236,18,20,2,109.42965,18.29111,1216
107349,5B52C71F88DF5C7017D89C4E504F495B,30351,21,22,1,109.41701,18.29292,1217
107350,5E8B5EFA266A23DFEAAD400692EAF0EB,31071,0,9,9,109.58257,18.28458,1815
107351,5E8B5EFA266A23DFEAAD400692EAF0EB,30731,13,14,1,109.50944,18.22306,1555
107352,9AA959ED87D1ECC3053DED17290EFCBD,39181,13,16,3,109.55153,18.28035,1715
107353,9AA959ED87D1ECC3053DED17290EFCBD,31561,17,20,3,109.56792,18.28479,1765
107377,C1F80FD61770F46AF18F3BEF2B67E7ED,60291,0,1,1,109.50826,18.24639,1509
107378,C1F80FD61770F46AF18F3BEF2B67E7ED,31554,3,4,1,109.55521,18.2459,1709
107379,C1F80FD61770F46AF18F3BEF2B67E7ED,31551,6,8,2,109.55868,18.24222,1708
107380,C1F80FD61770F46AF18F3BEF2B67E7ED,60291,11,13,2,109.50826,18.24639,1509
107381,C1F80FD61770F46AF18F3BEF2B67E7ED,31781,14,16,2,109.19847,18.2975,367
107382,C1F80FD61770F46AF18F3BEF2B67E7ED,31551,19,21,2,109.55868,18.24222,1708
107426,18BFFD22383048F5AB93537F321F279D,31181,0,9,9,109.50382,18.24813,1509
107427,18BFFD22383048F5AB93537F321F279D,30661,12,13,1,109.37028,18.24361,1008
107428,18BFFD22383048F5AB93537F321F279D,31471,13,15,2,109.34583,18.29563,917
107429,18BFFD22383048F5AB93537F321F279D,31471,16,17,1,109.34583,18.29563,917
107430,18BFFD22383048F5AB93537F321F279D,31181,20,23,3,109.50382,18.24813,1509
107471,7084657DF30063A945AAA5EF4742695F,39181,0,8,8,109.55153,18.28035,1715
107472,7084657DF30063A945AAA5EF4742695F,39183,10,16,6,109.55542,18.28208,1715
107473,7084657DF30063A945AAA5EF4742695F,39181,17,23,6,109.55153,18.28035,1715
107526,C1DFDFC110B50DFE0D66E47848759FB2,39183,0,8,8,109.55542,18.28208,1715
107527,C1DFDFC110B50DFE0D66E47848759FB2,31071,12,22,10,109.58257,18.28458,1815
107548,BBE4D8242EE46AE73AD69A56A00F4408,30201,0,7,7,109.4909,18.26465,1462
107549,BBE4D8242EE46AE73AD69A56A00F4408,31271,8,17,9,109.48958,18.26257,1462
107550,BBE4D8242EE46AE73AD69A56A00F4408,31021,18,20,2,109.49021,18.27,1463
107551,BBE4D8242EE46AE73AD69A56A00F4408,30201,21,23,2,109.4909,18.26465,1462
107557,40285EE8CCE25C38988EC087545664EC,31071,1,7,6,109.58257,18.28458,1815
107558,40285EE8CCE25C38988EC087545664EC,30854,10,17,7,109.56889,18.27076,1763
107594,6EA0FFE27EED64A0685E81DBC5C13BFD,31521,0,10,10,109.51458,18.22542,1555
107595,6EA0FFE27EED64A0685E81DBC5C13BFD,31521,10,12,2,109.51458,18.22542,1555
107596,6EA0FFE27EED64A0685E81DBC5C13BFD,38754,12,13,1,109.74667,18.37382,2430
107597,6EA0FFE27EED64A0685E81DBC5C13BFD,30791,14,17,3,109.72333,18.40889,2386
107598,6EA0FFE27EED64A0685E81DBC5C13BFD,31521,18,20,2,109.51458,18.22542,1555
107599,6EA0FFE27EED64A0685E81DBC5C13BFD,30511,20,22,2,109.51069,18.24208,1558
107664,D9359F177293DE6337F7CC97B1116186,38052,13,17,4,109.62618,18.23042,1956
107665,D9359F177293DE6337F7CC97B1116186,60211,18,19,1,109.63549,18.26049,2011
107666,D9359F177293DE6337F7CC97B1116186,60594,21,23,2,109.62694,18.22799,1956
107682,C8922FAF66F21ECAECB6B717FCD5A53B,60614,7,8,1,109.48799,18.29521,1467
107683,C8922FAF66F21ECAECB6B717FCD5A53B,60391,8,10,2,109.47667,18.28757,1416
107684,C8922FAF66F21ECAECB6B717FCD5A53B,60614,10,14,4,109.48799,18.29521,1467
107685,C8922FAF66F21ECAECB6B717FCD5A53B,60391,15,19,4,109.47667,18.28757,1416
107686,C8922FAF66F21ECAECB6B717FCD5A53B,60391,22,23,1,109.47667,18.28757,1416
107690,017BB493E18067371C6FAA1A30D4BA4B,60231,14,15,1,109.49903,18.21972,1504
107691,017BB493E18067371C6FAA1A30D4BA4B,60201,16,18,2,109.5041,18.2509,1510
107761,033CEEC20746801745CF4A53CD517C31,30121,0,8,8,109.52861,18.27222,1613
107762,033CEEC20746801745CF4A53CD517C31,60241,12,14,2,109.53319,18.28667,1616
107763,033CEEC20746801745CF4A53CD517C31,30121,16,18,2,109.52861,18.27222,1613
107764,033CEEC20746801745CF4A53CD517C31,31181,20,22,2,109.50382,18.24813,1509
107786,F9DDAF94F02D470B0D29C2FB66604E6F,38145,0,4,4,109.378,18.2912,1066
107787,F9DDAF94F02D470B0D29C2FB66604E6F,39063,5,6,1,109.386,18.2919,1066
107788,F9DDAF94F02D470B0D29C2FB66604E6F,31081,8,10,2,109.44639,18.30181,1318
107802,E9E473F09C342630187345312F4A31D8,39181,0,14,14,109.55153,18.28035,1715
107803,E9E473F09C342630187345312F4A31D8,39181,15,23,8,109.55153,18.28035,1715
107829,08A066736557478B1013C0CF834491DF,30921,0,6,6,109.53903,18.29451,1667
107830,08A066736557478B1013C0CF834491DF,31931,9,11,2,109.54771,18.29403,1667
107860,E75CF54BA14775FEDD26504F9F6B7365,31945,0,5,5,109.58021,18.29403,1817
107861,E75CF54BA14775FEDD26504F9F6B7365,31561,7,16,9,109.56792,18.28479,1765
107862,E75CF54BA14775FEDD26504F9F6B7365,31071,20,21,1,109.58257,18.28458,1815
107863,00FC332040A284DA251A8D0705989FE9,31071,1,7,6,109.58257,18.28458,1815
107864,00FC332040A284DA251A8D0705989FE9,30854,7,22,15,109.56889,18.27076,1763
107887,156ACF9E791C8505B3E73D7CD02DD49B,60631,0,8,8,109.57778,18.27583,1814
107888,156ACF9E791C8505B3E73D7CD02DD49B,30854,11,13,2,109.56889,18.27076,1763
107889,156ACF9E791C8505B3E73D7CD02DD49B,60631,14,17,3,109.57778,18.27583,1814
107890,156ACF9E791C8505B3E73D7CD02DD49B,30854,20,21,1,109.56889,18.27076,1763
107894,FD03438E223C0F6B143E4444189350B6,31931,16,18,2,109.54771,18.29403,1667
107924,2981C8B3C1AD0C63670497656AA260BB,30721,0,7,7,109.51597,18.28257,1565
107925,2981C8B3C1AD0C63670497656AA260BB,60084,8,10,2,109.4984,18.2334,1507
107926,2981C8B3C1AD0C63670497656AA260BB,30721,12,15,3,109.51597,18.28257,1565
107927,2981C8B3C1AD0C63670497656AA260BB,38251,20,21,1,109.49618,18.25493,1510
107954,8DA877D3A30401F86E81FB7BC1CA2A00,30854,0,2,2,109.56889,18.27076,1763
107955,8DA877D3A30401F86E81FB7BC1CA2A00,31071,3,12,9,109.58257,18.28458,1815
107956,8DA877D3A30401F86E81FB7BC1CA2A00,30854,15,17,2,109.56889,18.27076,1763
107957,8DA877D3A30401F86E81FB7BC1CA2A00,31071,19,20,1,109.58257,18.28458,1815
107962,39F25FE146A03325C93C111F2A943B6C,31945,0,7,7,109.58021,18.29403,1817
107963,39F25FE146A03325C93C111F2A943B6C,30854,7,10,3,109.56889,18.27076,1763
107964,39F25FE146A03325C93C111F2A943B6C,31945,12,13,1,109.58021,18.29403,1817
107965,39F25FE146A03325C93C111F2A943B6C,30854,13,15,2,109.56889,18.27076,1763
107966,39F25FE146A03325C93C111F2A943B6C,31071,15,17,2,109.58257,18.28458,1815
107967,58418A9EA4A7DC03127CB79C039A5185,30854,2,6,4,109.56889,18.27076,1763
107968,58418A9EA4A7DC03127CB79C039A5185,31071,8,10,2,109.58257,18.28458,1815
107969,58418A9EA4A7DC03127CB79C039A5185,39154,11,12,1,109.50201,18.25681,1511
107973,523CCFE9EF18EE2D015CE7D473B58639,31931,5,13,8,109.54771,18.29403,1667
107974,523CCFE9EF18EE2D015CE7D473B58639,39181,15,16,1,109.55153,18.28035,1715
107975,523CCFE9EF18EE2D015CE7D473B58639,31931,17,21,4,109.54771,18.29403,1667
107982,5E45AD18E230EC804DA95D38FE90826D,30661,14,16,2,109.37028,18.24361,1008
107983,5E45AD18E230EC804DA95D38FE90826D,31021,18,19,1,109.49021,18.27,1463
108004,D07D8903CFEE851EFB894ED4A1E91CC9,60621,0,7,7,109.48354,18.27451,1464
108005,D07D8903CFEE851EFB894ED4A1E91CC9,60401,7,8,1,109.47444,18.27583,1414
108006,D07D8903CFEE851EFB894ED4A1E91CC9,31781,13,15,2,109.19847,18.2975,367
108007,D07D8903CFEE851EFB894ED4A1E91CC9,60381,19,21,2,109.5241,18.22458,1605
108024,9ECDB9C3F97E311C1827C02496967431,30701,12,13,1,109.59313,18.32007,1871
108025,9ECDB9C3F97E311C1827C02496967431,60371,14,16,2,109.53063,18.30056,1618
108026,9ECDB9C3F97E311C1827C02496967431,38484,20,23,3,109.53028,18.31528,1620
108033,A8122698FABBA2048A3896136E8B0BD3,39091,15,17,2,109.50097,18.25222,1510
108034,A8122698FABBA2048A3896136E8B0BD3,31561,20,23,3,109.56792,18.28479,1765
108046,1E36640BE395A4EE8CCB2697222419A5,38171,1,2,1,109.50799,18.28139,1515
108047,1E36640BE395A4EE8CCB2697222419A5,60631,3,4,1,109.57778,18.27583,1814
108048,1E36640BE395A4EE8CCB2697222419A5,31071,6,8,2,109.58257,18.28458,1815
108049,1E36640BE395A4EE8CCB2697222419A5,30854,12,13,1,109.56889,18.27076,1763
108050,1E36640BE395A4EE8CCB2697222419A5,31071,15,16,1,109.58257,18.28458,1815
108051,1E36640BE395A4EE8CCB2697222419A5,60631,16,18,2,109.57778,18.27583,1814
108052,14AE6C820CE45F96077630992CABD33D,31551,0,8,8,109.55868,18.24222,1708
108053,14AE6C820CE45F96077630992CABD33D,31421,9,10,1,109.55382,18.22347,1705
108054,14AE6C820CE45F96077630992CABD33D,30851,10,11,1,109.5616,18.27396,1713
108055,14AE6C820CE45F96077630992CABD33D,30951,12,17,5,109.56208,18.25667,1761
108056,14AE6C820CE45F96077630992CABD33D,31421,18,23,5,109.55382,18.22347,1705
108057,DFFF17B7FE30E79B8AABBB5CE171272F,31561,1,14,13,109.56792,18.28479,1765
108058,DFFF17B7FE30E79B8AABBB5CE171272F,39183,16,17,1,109.55542,18.28208,1715
108059,DFFF17B7FE30E79B8AABBB5CE171272F,31561,21,23,2,109.56792,18.28479,1765
108109,0CD3A9451B945A7EABB5A7155C5317AC,39151,3,8,5,109.49875,18.25097,1510
108110,0CD3A9451B945A7EABB5A7155C5317AC,60161,9,10,1,109.49174,18.26181,1461
108111,0CD3A9451B945A7EABB5A7155C5317AC,38754,12,14,2,109.74667,18.37382,2430
108112,0CD3A9451B945A7EABB5A7155C5317AC,38251,18,19,1,109.49618,18.25493,1510
108113,0CD3A9451B945A7EABB5A7155C5317AC,60161,20,21,1,109.49174,18.26181,1461
108134,EC4B90EDBF35256FDB4D4F8B87DB8A04,31071,2,6,4,109.58257,18.28458,1815
108135,EC4B90EDBF35256FDB4D4F8B87DB8A04,30854,11,12,1,109.56889,18.27076,1763
108136,EC4B90EDBF35256FDB4D4F8B87DB8A04,31071,12,22,10,109.58257,18.28458,1815
108146,F24FBE95123F70461DE48D51FEF5DE97,39183,5,7,2,109.55542,18.28208,1715
108147,F24FBE95123F70461DE48D51FEF5DE97,30854,10,11,1,109.56889,18.27076,1763
108153,E0A24740E2C54F3B77DB561A91D2BED7,30151,0,1,1,109.50986,18.25083,1560
108154,E0A24740E2C54F3B77DB561A91D2BED7,31821,3,8,5,109.51181,18.24924,1559
108155,E0A24740E2C54F3B77DB561A91D2BED7,30251,8,12,4,109.50611,18.26653,1512
108156,E0A24740E2C54F3B77DB561A91D2BED7,30251,12,17,5,109.50611,18.26653,1512
108157,E0A24740E2C54F3B77DB561A91D2BED7,30151,18,23,5,109.50986,18.25083,1560
108173,9FC826BE95FBAE5773887F54D86740C8,31101,0,10,10,109.65389,18.23403,2057
108174,9FC826BE95FBAE5773887F54D86740C8,30854,14,16,2,109.56889,18.27076,1763
108175,9FC826BE95FBAE5773887F54D86740C8,60631,20,21,1,109.57778,18.27583,1814
108305,69998C60A6E00459C2EA67259A550AAF,31271,15,17,2,109.48958,18.26257,1462
108306,69998C60A6E00459C2EA67259A550AAF,31271,18,23,5,109.48958,18.26257,1462
108324,622234A65D292D040A9E438A2770674C,30851,0,7,7,109.5616,18.27396,1713
108325,622234A65D292D040A9E438A2770674C,31561,7,9,2,109.56792,18.28479,1765
108326,622234A65D292D040A9E438A2770674C,30851,11,14,3,109.5616,18.27396,1713
108327,622234A65D292D040A9E438A2770674C,31561,15,16,1,109.56792,18.28479,1765
108328,622234A65D292D040A9E438A2770674C,30851,17,23,6,109.5616,18.27396,1713
108354,EA446444DFE25212830F95291C13D19D,31931,0,6,6,109.54771,18.29403,1667
108355,EA446444DFE25212830F95291C13D19D,39181,7,9,2,109.55153,18.28035,1715
108356,EA446444DFE25212830F95291C13D19D,39181,14,15,1,109.55153,18.28035,1715
108357,EA446444DFE25212830F95291C13D19D,30071,17,18,1,109.52819,18.30472,1619
108358,EA446444DFE25212830F95291C13D19D,31931,20,23,3,109.54771,18.29403,1667
108402,AC2BE2B0D2A9E2E1B52DE4DB520203D4,30071,0,6,6,109.52819,18.30472,1619
108403,AC2BE2B0D2A9E2E1B52DE4DB520203D4,31931,7,15,8,109.54771,18.29403,1667
108404,AC2BE2B0D2A9E2E1B52DE4DB520203D4,30071,19,20,1,109.52819,18.30472,1619
108405,AC2BE2B0D2A9E2E1B52DE4DB520203D4,30071,21,23,2,109.52819,18.30472,1619
108409,1CBE5FAAC6CDC5A885E2AFCD14FDBBB1,31031,13,14,1,109.49979,18.25382,1510
108410,1CBE5FAAC6CDC5A885E2AFCD14FDBBB1,60401,15,17,2,109.47444,18.27583,1414
108445,27229B6D41BD7CDDDAA38911093865DB,30854,0,5,5,109.56889,18.27076,1763
108446,27229B6D41BD7CDDDAA38911093865DB,38085,5,13,8,109.6291,18.23625,2007
108447,27229B6D41BD7CDDDAA38911093865DB,30854,14,16,2,109.56889,18.27076,1763
108448,27229B6D41BD7CDDDAA38911093865DB,30891,16,23,7,109.59431,18.28389,1865
108473,E218C587552A5DADC05C4E69685FE374,31561,12,13,1,109.56792,18.28479,1765
108474,E218C587552A5DADC05C4E69685FE374,30854,17,19,2,109.56889,18.27076,1763
108475,E218C587552A5DADC05C4E69685FE374,39183,21,23,2,109.55542,18.28208,1715
108481,508BE380191F799297A31A7295856BDA,38094,0,12,12,109.45403,18.28778,1316
108482,508BE380191F799297A31A7295856BDA,31701,16,18,2,109.44132,18.28833,1266
108483,508BE380191F799297A31A7295856BDA,38094,19,23,4,109.45403,18.28778,1316
108673,1B3E8931F1FF667205B6505EE53C6E2C,31071,0,3,3,109.58257,18.28458,1815
108674,1B3E8931F1FF667205B6505EE53C6E2C,30854,7,13,6,109.56889,18.27076,1763
108675,1B3E8931F1FF667205B6505EE53C6E2C,31071,15,23,8,109.58257,18.28458,1815
108676,6876B785B3B8E427F5B0017E0B0EC706,60472,0,8,8,109.46625,18.29542,1367
108677,6876B785B3B8E427F5B0017E0B0EC706,30181,8,10,2,109.51597,18.23313,1557
108678,6876B785B3B8E427F5B0017E0B0EC706,38291,10,11,1,109.51618,18.24313,1558
108679,6876B785B3B8E427F5B0017E0B0EC706,31861,12,13,1,109.49042,18.27549,1464
108680,6876B785B3B8E427F5B0017E0B0EC706,60391,18,20,2,109.47667,18.28757,1416
108681,6876B785B3B8E427F5B0017E0B0EC706,60391,22,23,1,109.47667,18.28757,1416
108688,E5B6732ECAB7D8ED8984846CAF5B9677,60411,1,2,1,109.32514,18.30854,869
108689,E5B6732ECAB7D8ED8984846CAF5B9677,30661,3,14,11,109.37028,18.24361,1008
108690,E5B6732ECAB7D8ED8984846CAF5B9677,60411,18,19,1,109.32514,18.30854,869
108691,E5B6732ECAB7D8ED8984846CAF5B9677,31471,20,22,2,109.34583,18.29563,917
108742,0C3DD1EABA2D708A2506DA8150CEC148,31561,0,6,6,109.56792,18.28479,1765
108743,0C3DD1EABA2D708A2506DA8150CEC148,30854,8,11,3,109.56889,18.27076,1763
108744,0C3DD1EABA2D708A2506DA8150CEC148,31561,11,23,12,109.56792,18.28479,1765
108846,AB43182259122294244C13D6FC66D4A1,60631,0,2,2,109.57778,18.27583,1814
108847,AB43182259122294244C13D6FC66D4A1,31071,4,5,1,109.58257,18.28458,1815
108848,AB43182259122294244C13D6FC66D4A1,31561,8,10,2,109.56792,18.28479,1765
108877,F8D799D9161B0143E0D71C40472A357E,38991,1,2,1,109.52681,18.30368,1618
108878,F8D799D9161B0143E0D71C40472A357E,30071,3,13,10,109.52819,18.30472,1619
108879,F8D799D9161B0143E0D71C40472A357E,60371,14,16,2,109.53063,18.30056,1618
108880,F8D799D9161B0143E0D71C40472A357E,30071,16,17,1,109.52819,18.30472,1619
108881,F8D799D9161B0143E0D71C40472A357E,60371,17,20,3,109.53063,18.30056,1618
108882,F8D799D9161B0143E0D71C40472A357E,30071,20,23,3,109.52819,18.30472,1619
108887,5EE25A6E7DD554FFDA0C9C1A504114B7,30221,0,17,17,109.57833,18.20222,1802
108888,5EE25A6E7DD554FFDA0C9C1A504114B7,30281,18,20,2,109.50597,18.27583,1514
108889,8BDE8C6966F9C7122ABA59EA6C195945,30201,0,6,6,109.4909,18.26465,1462
108890,8BDE8C6966F9C7122ABA59EA6C195945,60552,9,10,1,109.41729,18.30014,1218
108891,8BDE8C6966F9C7122ABA59EA6C195945,31081,12,23,11,109.44639,18.30181,1318
108900,599AFAF71D30C85AA4E0085C43FF5E03,31291,16,19,3,109.30375,18.40729,786
108901,599AFAF71D30C85AA4E0085C43FF5E03,30191,21,23,2,109.50361,18.22701,1506
108905,E7DB0F55EDE33BB4C08C98B80B7173BF,60371,0,15,15,109.53063,18.30056,1618
108906,E7DB0F55EDE33BB4C08C98B80B7173BF,30711,16,17,1,109.50271,18.25347,1510
108907,E7DB0F55EDE33BB4C08C98B80B7173BF,60371,21,23,2,109.53063,18.30056,1618
108908,7BF65E5054DA81A230AB5423620158E1,31071,0,1,1,109.58257,18.28458,1815
108909,7BF65E5054DA81A230AB5423620158E1,60631,1,7,6,109.57778,18.27583,1814
108910,7BF65E5054DA81A230AB5423620158E1,30854,7,18,11,109.56889,18.27076,1763
108968,728159D623DE360E7CBC8AEEC345E2FF,60661,0,9,9,109.548,18.2377,1657
108969,728159D623DE360E7CBC8AEEC345E2FF,31321,11,13,2,109.63799,18.23201,2007
108971,728159D623DE360E7CBC8AEEC345E2FF,60661,21,23,2,109.548,18.2377,1657
108990,079A114D194FE2EFB0C89059CA4EBC03,31251,8,11,3,109.18528,18.2975,317
108992,079A114D194FE2EFB0C89059CA4EBC03,31251,21,23,2,109.18528,18.2975,317
109011,41C1A1FB9866C68EBD84D3368C71BD84,60361,0,1,1,109.51938,18.29681,1567
109012,41C1A1FB9866C68EBD84D3368C71BD84,38991,3,4,1,109.52681,18.30368,1618
109059,E649CF84A26278291AA1A5B5C5D01FCA,31561,0,5,5,109.56792,18.28479,1765
109060,E649CF84A26278291AA1A5B5C5D01FCA,30854,6,18,12,109.56889,18.27076,1763
109061,E649CF84A26278291AA1A5B5C5D01FCA,31561,20,23,3,109.56792,18.28479,1765
109067,B918E6C7FDB4745FD59F18F0F2FA3EBF,60561,0,9,9,109.38229,18.29785,1067
109068,B918E6C7FDB4745FD59F18F0F2FA3EBF,31301,12,13,1,109.14493,18.31222,170
109069,B918E6C7FDB4745FD59F18F0F2FA3EBF,31471,14,16,2,109.34583,18.29563,917
109070,B918E6C7FDB4745FD59F18F0F2FA3EBF,31345,20,21,1,109.39,18.29,1066
109071,B918E6C7FDB4745FD59F18F0F2FA3EBF,60561,22,23,1,109.38229,18.29785,1067
109080,07E6DBC1CBF6E28010B852A4869AF3C1,38117,0,1,1,109.51611,18.22354,1555
109081,07E6DBC1CBF6E28010B852A4869AF3C1,31521,2,9,7,109.51458,18.22542,1555
109082,07E6DBC1CBF6E28010B852A4869AF3C1,31781,14,15,1,109.19847,18.2975,367
109083,07E6DBC1CBF6E28010B852A4869AF3C1,31521,19,20,1,109.51458,18.22542,1555
109091,0E8B1439B24B1B4D8878744BF677E6B0,31081,0,7,7,109.44639,18.30181,1318
109112,C6C3BC01E542B810EF853FEEB6C81198,60361,0,18,18,109.51938,18.29681,1567
109113,C6C3BC01E542B810EF853FEEB6C81198,31561,19,21,2,109.56792,18.28479,1765
109139,6C0260646767B781577B5B8CE2471E51,60361,8,9,1,109.51938,18.29681,1567
109140,6C0260646767B781577B5B8CE2471E51,38484,9,12,3,109.53028,18.31528,1620
109141,6C0260646767B781577B5B8CE2471E51,30561,13,17,4,109.52778,18.31938,1621
109142,6C0260646767B781577B5B8CE2471E51,38484,18,23,5,109.53028,18.31528,1620
109143,D8FC06AF709B18887F7AC647DFC080AD,31071,3,4,1,109.58257,18.28458,1815
109144,D8FC06AF709B18887F7AC647DFC080AD,30854,7,8,1,109.56889,18.27076,1763
109189,A1C95B17C868D553635D99A0D1B2A324,39041,0,10,10,109.40021,18.29278,1117
109191,A1C95B17C868D553635D99A0D1B2A324,60321,19,22,3,109.63611,18.24306,2008
109192,A1C95B17C868D553635D99A0D1B2A324,30441,22,23,1,109.64021,18.25424,2010
109238,FAC035CAF00431CACD74AF53D18C4996,60011,0,5,5,109.48965,18.30222,1468
109239,FAC035CAF00431CACD74AF53D18C4996,30764,8,9,1,109.45806,18.29486,1367
109240,FAC035CAF00431CACD74AF53D18C4996,60011,12,13,1,109.48965,18.30222,1468
109241,FAC035CAF00431CACD74AF53D18C4996,30111,14,20,6,109.47583,18.30542,1419
109242,FAC035CAF00431CACD74AF53D18C4996,60011,22,23,1,109.48965,18.30222,1468
109243,8039EB5AFB4AD782481BED6ABCE4707B,38961,0,7,7,109.50847,18.23514,1507
109244,8039EB5AFB4AD782481BED6ABCE4707B,31201,8,10,2,109.51042,18.23819,1558
109245,8039EB5AFB4AD782481BED6ABCE4707B,30661,11,14,3,109.37028,18.24361,1008
109246,8039EB5AFB4AD782481BED6ABCE4707B,60291,19,20,1,109.50826,18.24639,1509
109247,8039EB5AFB4AD782481BED6ABCE4707B,60081,22,23,1,109.51097,18.22639,1556
109255,A59893CF63A9A48BE0D9E2ED611A9BB2,30721,10,11,1,109.51597,18.28257,1565
109256,A59893CF63A9A48BE0D9E2ED611A9BB2,30361,14,15,1,109.50347,18.24,1508
109257,A59893CF63A9A48BE0D9E2ED611A9BB2,31181,15,16,1,109.50382,18.24813,1509
109280,7D72A79F2F964580140FF5C346A60898,30351,1,9,8,109.41701,18.29292,1217
109281,7D72A79F2F964580140FF5C346A60898,38951,11,22,11,109.48097,18.28868,1416
109310,8AABF5FDF2B06EB445749240A3894969,31851,14,16,2,109.71736,18.29007,2316
109311,8AABF5FDF2B06EB445749240A3894969,39183,18,19,1,109.55542,18.28208,1715
109312,8AABF5FDF2B06EB445749240A3894969,31071,21,22,1,109.58257,18.28458,1815
109378,1BFCB821873EA5E9C4E86C2745A476F9,31021,0,7,7,109.49021,18.27,1463
109379,1BFCB821873EA5E9C4E86C2745A476F9,38291,10,22,12,109.51618,18.24313,1558
109411,86360CBE83A45C2F8F04805EB9121831,31231,2,3,1,109.42597,18.29292,1217
109412,86360CBE83A45C2F8F04805EB9121831,60552,3,9,6,109.41729,18.30014,1218
109413,86360CBE83A45C2F8F04805EB9121831,31251,12,14,2,109.18528,18.2975,317
109414,86360CBE83A45C2F8F04805EB9121831,38157,15,17,2,109.51483,18.26958,1563
109415,86360CBE83A45C2F8F04805EB9121831,31061,19,21,2,109.53333,18.23257,1607
109416,86360CBE83A45C2F8F04805EB9121831,38157,22,23,1,109.51483,18.26958,1563
109417,61D3315701F57B042BD8C284665DED51,30181,0,9,9,109.51597,18.23313,1557
109418,61D3315701F57B042BD8C284665DED51,31521,10,14,4,109.51458,18.22542,1555
109419,61D3315701F57B042BD8C284665DED51,30181,14,16,2,109.51597,18.23313,1557
109420,61D3315701F57B042BD8C284665DED51,31521,19,20,1,109.51458,18.22542,1555
109421,61D3315701F57B042BD8C284665DED51,30181,21,23,2,109.51597,18.23313,1557
109438,E8BAAF476E8FE57075BAB1A8D4FF1780,60631,0,2,2,109.57778,18.27583,1814
109439,E8BAAF476E8FE57075BAB1A8D4FF1780,31071,2,5,3,109.58257,18.28458,1815
109440,E8BAAF476E8FE57075BAB1A8D4FF1780,30232,5,7,2,109.6191,18.31701,1971
109441,E8BAAF476E8FE57075BAB1A8D4FF1780,30151,19,21,2,109.50986,18.25083,1560
109442,E8BAAF476E8FE57075BAB1A8D4FF1780,39371,21,23,2,109.56627,18.2646,1762
109532,7C16827D646BDC874DE2BD7EE32189C5,30854,0,14,14,109.56889,18.27076,1763
109533,7C16827D646BDC874DE2BD7EE32189C5,30711,18,19,1,109.50271,18.25347,1510
109541,10BCCD747640470AAA03DB965CE24293,31931,18,19,1,109.54771,18.29403,1667
109542,10BCCD747640470AAA03DB965CE24293,30084,20,23,3,109.50118,18.26972,1513
109544,798BF3B08F72A16A6DEAAA235F1899BB,61011,1,10,9,109.60653,18.19076,1900
109590,078D60DC1D1055276AB6F3C64302289E,39191,0,2,2,109.51493,18.23472,1557
109591,078D60DC1D1055276AB6F3C64302289E,38157,2,9,7,109.51483,18.26958,1563
109595,209DF6A91F218920F5741E5EF3086DD3,60131,19,20,1,109.49819,18.24778,1509
109596,209DF6A91F218920F5741E5EF3086DD3,31071,22,23,1,109.58257,18.28458,1815
109622,D56A67341D1DA856D04BC2181FD404FB,60552,15,17,2,109.41729,18.30014,1218
109623,D56A67341D1DA856D04BC2181FD404FB,60541,21,23,2,109.4084,18.29208,1167
109751,1B6EBBFF3B9D8A3E18753343B6A29EAE,31071,0,13,13,109.58257,18.28458,1815
109752,1B6EBBFF3B9D8A3E18753343B6A29EAE,30851,14,17,3,109.5616,18.27396,1713
109753,1B6EBBFF3B9D8A3E18753343B6A29EAE,31071,22,23,1,109.58257,18.28458,1815
109775,45D6FEED987FF96C23D5532C0D645AC3,30281,0,8,8,109.50597,18.27583,1514
109776,45D6FEED987FF96C23D5532C0D645AC3,30361,9,11,2,109.50347,18.24,1508
109777,45D6FEED987FF96C23D5532C0D645AC3,38127,13,20,7,109.50833,18.27222,1513
109778,45D6FEED987FF96C23D5532C0D645AC3,30281,21,23,2,109.50597,18.27583,1514
109809,59F29435D748531F416A4F1636997ECF,31071,2,5,3,109.58257,18.28458,1815
109810,59F29435D748531F416A4F1636997ECF,60631,6,7,1,109.57778,18.27583,1814
109811,59F29435D748531F416A4F1636997ECF,30854,10,12,2,109.56889,18.27076,1763
109812,59F29435D748531F416A4F1636997ECF,60631,17,19,2,109.57778,18.27583,1814
109813,59F29435D748531F416A4F1636997ECF,30854,19,22,3,109.56889,18.27076,1763
109820,A8ABE4987042D12DD458C81CFD9663F5,30721,0,7,7,109.51597,18.28257,1565
109821,A8ABE4987042D12DD458C81CFD9663F5,30771,8,15,7,109.49938,18.26042,1511
109822,A8ABE4987042D12DD458C81CFD9663F5,38127,18,20,2,109.50833,18.27222,1513
109848,74206C862E4BA6236E7F7978D63D1D7D,60631,1,4,3,109.57778,18.27583,1814
109849,74206C862E4BA6236E7F7978D63D1D7D,30854,5,19,14,109.56889,18.27076,1763
109850,74206C862E4BA6236E7F7978D63D1D7D,60631,19,20,1,109.57778,18.27583,1814
109868,0B67294FA9DBD53325D63EA36C1B8784,30271,0,14,14,109.49132,18.23153,1456
109869,0B67294FA9DBD53325D63EA36C1B8784,30211,15,16,1,109.49882,18.23931,1508
109870,0B67294FA9DBD53325D63EA36C1B8784,30271,20,23,3,109.49132,18.23153,1456
109896,C87F469509749B351A8671696022A99C,31561,0,5,5,109.56792,18.28479,1765
109897,C87F469509749B351A8671696022A99C,30854,6,10,4,109.56889,18.27076,1763
109898,C87F469509749B351A8671696022A99C,31561,11,23,12,109.56792,18.28479,1765
109916,485CC43812013C7F1EB3AB947F1AE40F,30741,1,4,3,109.49833,18.28681,1516
109917,485CC43812013C7F1EB3AB947F1AE40F,31864,5,8,3,109.49014,18.28333,1465
109918,485CC43812013C7F1EB3AB947F1AE40F,60281,12,13,1,109.51743,18.25924,1561
109919,485CC43812013C7F1EB3AB947F1AE40F,38185,17,19,2,109.51333,18.27347,1563
109920,90EBD51E9F0794ACBFB06B2CFE74F920,38951,0,7,7,109.48097,18.28868,1416
109921,90EBD51E9F0794ACBFB06B2CFE74F920,30101,11,12,1,109.57299,18.33333,1773
109922,90EBD51E9F0794ACBFB06B2CFE74F920,30941,14,22,8,109.5559,18.33938,1724
109957,CF1922E57BC1E2D5DC4336E820C48B77,60411,1,19,18,109.32514,18.30854,869
109958,CF1922E57BC1E2D5DC4336E820C48B77,30711,21,23,2,109.50271,18.25347,1510
110036,16CCFF81838B15A70A44E8C4B6CCB914,30771,10,13,3,109.49938,18.26042,1511
110039,222E0B6922623CE9FBB280F81068D40E,60084,0,1,1,109.4984,18.2334,1507
110040,222E0B6922623CE9FBB280F81068D40E,30731,5,8,3,109.50944,18.22306,1555
110041,222E0B6922623CE9FBB280F81068D40E,60631,10,12,2,109.57778,18.27583,1814
110068,3A7681A070628480C91E38C95BBBD8F4,38185,0,6,6,109.51333,18.27347,1563
110087,90D91A493F9482486DCC3B27CF3F61EE,31071,10,12,2,109.58257,18.28458,1815
110088,90D91A493F9482486DCC3B27CF3F61EE,30854,15,17,2,109.56889,18.27076,1763
110089,90D91A493F9482486DCC3B27CF3F61EE,31071,21,22,1,109.58257,18.28458,1815
110095,7C68E1F4B8B2F3CBBD5427BF66BF9C2E,30854,2,5,3,109.56889,18.27076,1763
110096,7C68E1F4B8B2F3CBBD5427BF66BF9C2E,31571,8,11,3,109.61563,18.23326,1957
110097,7C68E1F4B8B2F3CBBD5427BF66BF9C2E,60214,15,16,1,109.63104,18.24493,2009
110139,7F6E66BC10419161F6457A6D79258EDB,31361,1,7,6,109.47417,18.28292,1415
110140,7F6E66BC10419161F6457A6D79258EDB,31431,8,10,2,109.44639,18.29042,1316
110141,7F6E66BC10419161F6457A6D79258EDB,38094,10,11,1,109.45403,18.28778,1316
110142,7F6E66BC10419161F6457A6D79258EDB,38251,11,13,2,109.49618,18.25493,1510
110143,7F6E66BC10419161F6457A6D79258EDB,30341,14,17,3,109.3625,18.29167,966
110144,7F6E66BC10419161F6457A6D79258EDB,60621,19,23,4,109.48354,18.27451,1464
110178,19F803FB996471824A8A9928BBFAB433,39181,0,6,6,109.55153,18.28035,1715
110179,19F803FB996471824A8A9928BBFAB433,31931,6,8,2,109.54771,18.29403,1667
110180,19F803FB996471824A8A9928BBFAB433,39181,11,13,2,109.55153,18.28035,1715
110181,19F803FB996471824A8A9928BBFAB433,31931,14,18,4,109.54771,18.29403,1667
110273,B530FB0D6C312ECBD89B74FD22C716DB,30361,11,14,3,109.50347,18.24,1508
110274,B530FB0D6C312ECBD89B74FD22C716DB,30181,18,19,1,109.51597,18.23313,1557
110275,B530FB0D6C312ECBD89B74FD22C716DB,30361,20,22,2,109.50347,18.24,1508
110306,45FA8AF959A216E06C82392E21728E7F,31071,0,7,7,109.58257,18.28458,1815
110307,45FA8AF959A216E06C82392E21728E7F,31561,8,10,2,109.56792,18.28479,1765
110308,45FA8AF959A216E06C82392E21728E7F,31071,13,14,1,109.58257,18.28458,1815
110309,45FA8AF959A216E06C82392E21728E7F,31561,14,23,9,109.56792,18.28479,1765
110310,C925EDC1C2C39BAEC75090090BF059D6,30741,0,9,9,109.49833,18.28681,1516
110311,C925EDC1C2C39BAEC75090090BF059D6,30741,11,12,1,109.49833,18.28681,1516
110312,C925EDC1C2C39BAEC75090090BF059D6,60472,13,15,2,109.46625,18.29542,1367
110313,C925EDC1C2C39BAEC75090090BF059D6,60381,18,21,3,109.5241,18.22458,1605
110317,F95DF9F1082F8C3737D4149B9D06BBC7,31031,13,15,2,109.49979,18.25382,1510
110345,D4EE8E1A4C04A1FF0596E4221D0B8B42,31071,0,7,7,109.58257,18.28458,1815
110346,D4EE8E1A4C04A1FF0596E4221D0B8B42,30581,9,11,2,109.62257,18.24951,1959
110347,D4EE8E1A4C04A1FF0596E4221D0B8B42,30854,13,14,1,109.56889,18.27076,1763
110348,D4EE8E1A4C04A1FF0596E4221D0B8B42,31071,16,17,1,109.58257,18.28458,1815
110349,D4EE8E1A4C04A1FF0596E4221D0B8B42,30854,17,19,2,109.56889,18.27076,1763
110353,DA63805BBCE023D492D9D90DCDDBF5FA,31521,2,19,17,109.51458,18.22542,1555
110354,DA63805BBCE023D492D9D90DCDDBF5FA,30421,20,21,1,109.50021,18.25861,1511
110370,5A888DC7A3AA300CC584D9862C5384A1,60361,0,5,5,109.51938,18.29681,1567
110371,5A888DC7A3AA300CC584D9862C5384A1,60221,6,8,2,109.52569,18.29188,1616
110372,5A888DC7A3AA300CC584D9862C5384A1,30421,9,11,2,109.50021,18.25861,1511
110373,5A888DC7A3AA300CC584D9862C5384A1,39183,15,17,2,109.55542,18.28208,1715
110374,5A888DC7A3AA300CC584D9862C5384A1,30421,21,23,2,109.50021,18.25861,1511
110394,0978FEE828281B6259B40272A2C5BBE2,38251,0,11,11,109.49618,18.25493,1510
110395,0978FEE828281B6259B40272A2C5BBE2,31031,11,23,12,109.49979,18.25382,1510
110481,D7D9352263CF977FD0E7820F34F6CA72,30151,0,12,12,109.50986,18.25083,1560
110482,D7D9352263CF977FD0E7820F34F6CA72,30511,14,15,1,109.51069,18.24208,1558
110483,D7D9352263CF977FD0E7820F34F6CA72,38111,19,20,1,109.52007,18.22403,1555
110494,6733B324E753B6172A50174A4CB1E5C2,31251,10,23,13,109.18528,18.2975,317
110542,8877F0646282478FC034CF7A2CC8A7FE,31521,18,19,1,109.51458,18.22542,1555
110543,8877F0646282478FC034CF7A2CC8A7FE,31031,20,21,1,109.49979,18.25382,1510
110608,B80D6AB96D3D5CEE71A70ED25275F830,38951,0,10,10,109.48097,18.28868,1416
110609,B80D6AB96D3D5CEE71A70ED25275F830,38951,11,12,1,109.48097,18.28868,1416
110610,B80D6AB96D3D5CEE71A70ED25275F830,31531,14,21,7,109.49583,18.25972,1461
110611,B80D6AB96D3D5CEE71A70ED25275F830,38951,22,23,1,109.48097,18.28868,1416
110669,A9C7C0A15D485E40B43093FA63B4F0D5,31521,0,8,8,109.51458,18.22542,1555
110670,A9C7C0A15D485E40B43093FA63B4F0D5,31521,8,13,5,109.51458,18.22542,1555
110671,A9C7C0A15D485E40B43093FA63B4F0D5,30201,13,15,2,109.4909,18.26465,1462
110672,A9C7C0A15D485E40B43093FA63B4F0D5,31521,17,19,2,109.51458,18.22542,1555
110673,A9C7C0A15D485E40B43093FA63B4F0D5,31521,19,23,4,109.51458,18.22542,1555
110692,9B24FEFE42610E15A8305E52C167D9B9,30854,1,2,1,109.56889,18.27076,1763
110693,9B24FEFE42610E15A8305E52C167D9B9,60241,3,4,1,109.53319,18.28667,1616
110694,9B24FEFE42610E15A8305E52C167D9B9,38154,6,7,1,109.5266,18.28278,1615
110702,81D70A3ED522BA9C5A3A11D0C612F029,30191,2,7,5,109.50361,18.22701,1506
110703,81D70A3ED522BA9C5A3A11D0C612F029,30661,12,16,4,109.37028,18.24361,1008
110704,81D70A3ED522BA9C5A3A11D0C612F029,30191,19,22,3,109.50361,18.22701,1506
110722,DE841C2C767041F00D7DAF75FFC633F6,30771,2,4,2,109.49938,18.26042,1511
110723,DE841C2C767041F00D7DAF75FFC633F6,30421,5,21,16,109.50021,18.25861,1511
110756,8621CFDF1B89A83351494618C53D033F,39181,3,10,7,109.55153,18.28035,1715
110757,8621CFDF1B89A83351494618C53D033F,31071,12,14,2,109.58257,18.28458,1815
110758,8621CFDF1B89A83351494618C53D033F,39181,14,20,6,109.55153,18.28035,1715
110759,8621CFDF1B89A83351494618C53D033F,39181,21,23,2,109.55153,18.28035,1715
110791,115CE8C7CCAA1288E5461F613949EE4B,60231,0,1,1,109.49903,18.21972,1504
110792,115CE8C7CCAA1288E5461F613949EE4B,60084,5,7,2,109.4984,18.2334,1507
110793,115CE8C7CCAA1288E5461F613949EE4B,60161,11,13,2,109.49174,18.26181,1461
110794,115CE8C7CCAA1288E5461F613949EE4B,30571,19,20,1,109.50243,18.21861,1504
110795,115CE8C7CCAA1288E5461F613949EE4B,60231,21,23,2,109.49903,18.21972,1504
110833,63CB222117AB8A54673799718246EF46,60211,0,1,1,109.63549,18.26049,2011
110834,63CB222117AB8A54673799718246EF46,30084,2,8,6,109.50118,18.26972,1513
110835,63CB222117AB8A54673799718246EF46,31031,9,12,3,109.49979,18.25382,1510
110836,63CB222117AB8A54673799718246EF46,30081,12,18,6,109.50243,18.26632,1512
110837,63CB222117AB8A54673799718246EF46,31041,18,19,1,109.50278,18.23701,1507
110838,63CB222117AB8A54673799718246EF46,39021,20,21,1,109.40368,18.41035,1186
110843,B76381FBDC68F2B2041DDEC63195F0A7,39181,0,13,13,109.55153,18.28035,1715
110844,B76381FBDC68F2B2041DDEC63195F0A7,39181,18,23,5,109.55153,18.28035,1715
110851,E88B3320D5DB9B353136C87713851D2A,31521,2,6,4,109.51458,18.22542,1555
110989,536FDE9EE57B9B41900B9D9A3C619439,38951,0,5,5,109.48097,18.28868,1416
110990,536FDE9EE57B9B41900B9D9A3C619439,38951,5,7,2,109.48097,18.28868,1416
110991,536FDE9EE57B9B41900B9D9A3C619439,30101,8,10,2,109.57299,18.33333,1773
110992,536FDE9EE57B9B41900B9D9A3C619439,30941,15,17,2,109.5559,18.33938,1724
110993,536FDE9EE57B9B41900B9D9A3C619439,31031,18,19,1,109.49979,18.25382,1510
110994,536FDE9EE57B9B41900B9D9A3C619439,30941,21,22,1,109.5559,18.33938,1724
111014,BC81783A71088C7320F6E595223A70F0,38017,17,21,4,109.49729,18.21424,1504
111015,BC81783A71088C7320F6E595223A70F0,38017,22,23,1,109.49729,18.21424,1504
111023,CD3BCBAB8571FB81953C842A434E5DB8,31071,0,2,2,109.58257,18.28458,1815
111024,CD3BCBAB8571FB81953C842A434E5DB8,39371,2,3,1,109.56627,18.2646,1762
111025,CD3BCBAB8571FB81953C842A434E5DB8,31071,3,6,3,109.58257,18.28458,1815
111026,CD3BCBAB8571FB81953C842A434E5DB8,30854,6,11,5,109.56889,18.27076,1763
111027,CD3BCBAB8571FB81953C842A434E5DB8,31071,12,14,2,109.58257,18.28458,1815
111028,CD3BCBAB8571FB81953C842A434E5DB8,30854,16,18,2,109.56889,18.27076,1763
111029,50AA1262E2A8C18D2F0FC1A87B60622A,31101,13,14,1,109.65389,18.23403,2057
111030,50AA1262E2A8C18D2F0FC1A87B60622A,31391,14,16,2,109.50382,18.24285,1508
111031,50AA1262E2A8C18D2F0FC1A87B60622A,30761,17,22,5,109.45201,18.3,1318
111032,3C6C31F30579C628F9EDFADEE409AE9F,60241,0,7,7,109.53319,18.28667,1616
111033,3C6C31F30579C628F9EDFADEE409AE9F,60201,8,9,1,109.5041,18.2509,1510
111034,3C6C31F30579C628F9EDFADEE409AE9F,30071,11,12,1,109.52819,18.30472,1619
111094,5D06B39D1C4AAC35B6AB826D6203C7C7,60401,0,4,4,109.47444,18.27583,1414
111095,5D06B39D1C4AAC35B6AB826D6203C7C7,39151,4,7,3,109.49875,18.25097,1510
111096,5D06B39D1C4AAC35B6AB826D6203C7C7,30051,10,11,1,109.48917,18.21215,1453
111097,5D06B39D1C4AAC35B6AB826D6203C7C7,60081,12,13,1,109.51097,18.22639,1556
111103,7B468825EC3CAA1A3172074B4283732A,38911,0,6,6,109.51674,18.24965,1559
111104,7B468825EC3CAA1A3172074B4283732A,31201,7,12,5,109.51042,18.23819,1558
111105,7B468825EC3CAA1A3172074B4283732A,31201,12,16,4,109.51042,18.23819,1558
111106,7B468825EC3CAA1A3172074B4283732A,31206,17,19,2,109.50819,18.23549,1507
111132,278D81878D480BD6212A8447217A6EDC,30941,14,16,2,109.5559,18.33938,1724
111133,278D81878D480BD6212A8447217A6EDC,38951,19,23,4,109.48097,18.28868,1416
111159,EBD16061EA20EE33D9344D33735E5205,38891,0,6,6,109.51486,18.24118,1558
111160,EBD16061EA20EE33D9344D33735E5205,38291,10,11,1,109.51618,18.24313,1558
111161,EBD16061EA20EE33D9344D33735E5205,38291,13,16,3,109.51618,18.24313,1558
111162,EBD16061EA20EE33D9344D33735E5205,31201,19,20,1,109.51042,18.23819,1558
111168,B29EF08BE3B3DB2A02535CE10F50F893,31931,9,19,10,109.54771,18.29403,1667
111169,B29EF08BE3B3DB2A02535CE10F50F893,30921,20,21,1,109.53903,18.29451,1667
111202,C0F04DA5BBC3EA089436357A9062298C,38117,1,3,2,109.51611,18.22354,1555
111203,C0F04DA5BBC3EA089436357A9062298C,31521,5,10,5,109.51458,18.22542,1555
111204,C0F04DA5BBC3EA089436357A9062298C,39321,11,13,2,109.529,18.2167,1604
111205,C0F04DA5BBC3EA089436357A9062298C,31521,14,16,2,109.51458,18.22542,1555
111206,C0F04DA5BBC3EA089436357A9062298C,38071,21,23,2,109.40722,18.30938,1169
111219,EE235D4EDEAD413BED10164C21875CA9,60551,0,7,7,109.42722,18.30111,1218
111220,EE235D4EDEAD413BED10164C21875CA9,30941,11,17,6,109.5559,18.33938,1724
111221,EE235D4EDEAD413BED10164C21875CA9,31031,20,23,3,109.49979,18.25382,1510
111226,5264833F0013AE6B294396000613EF89,30211,18,21,3,109.49882,18.23931,1508
111227,5264833F0013AE6B294396000613EF89,60201,21,23,2,109.5041,18.2509,1510
111242,ADAB51A6D99BADC8222FC392D72ADA01,60281,0,13,13,109.51743,18.25924,1561
111243,ADAB51A6D99BADC8222FC392D72ADA01,60311,14,18,4,109.52097,18.24319,1558
111244,ADAB51A6D99BADC8222FC392D72ADA01,60281,19,23,4,109.51743,18.25924,1561
111270,2F440A235E684ECEDD042B3100A4AE95,30854,13,18,5,109.56889,18.27076,1763
111271,2F440A235E684ECEDD042B3100A4AE95,31561,18,19,1,109.56792,18.28479,1765
111272,2F440A235E684ECEDD042B3100A4AE95,31071,21,23,2,109.58257,18.28458,1815
111285,ACDEAAF45B65DE48CF80A48DBD3C775E,31071,0,7,7,109.58257,18.28458,1815
111286,ACDEAAF45B65DE48CF80A48DBD3C775E,30854,10,11,1,109.56889,18.27076,1763
111287,ACDEAAF45B65DE48CF80A48DBD3C775E,31071,11,18,7,109.58257,18.28458,1815
111308,F3EA7BB85A440E2BE2D597787EA5279B,30051,0,7,7,109.48917,18.21215,1453
111309,F3EA7BB85A440E2BE2D597787EA5279B,38834,7,8,1,109.47639,18.21146,1403
111310,F3EA7BB85A440E2BE2D597787EA5279B,30051,9,13,4,109.48917,18.21215,1453
111311,F3EA7BB85A440E2BE2D597787EA5279B,30571,13,19,6,109.50243,18.21861,1504
111318,028777DBF8176CB8A735B293EDB3D71F,31931,0,1,1,109.54771,18.29403,1667
111319,028777DBF8176CB8A735B293EDB3D71F,39181,3,4,1,109.55153,18.28035,1715
111320,028777DBF8176CB8A735B293EDB3D71F,31931,6,9,3,109.54771,18.29403,1667
111321,028777DBF8176CB8A735B293EDB3D71F,39181,10,11,1,109.55153,18.28035,1715
111322,028777DBF8176CB8A735B293EDB3D71F,39181,17,19,2,109.55153,18.28035,1715
111323,028777DBF8176CB8A735B293EDB3D71F,31931,21,23,2,109.54771,18.29403,1667
111331,5395D4F841A8132E16F3DF02F491AC07,39191,0,1,1,109.51493,18.23472,1557
111332,5395D4F841A8132E16F3DF02F491AC07,31521,2,4,2,109.51458,18.22542,1555
111333,5395D4F841A8132E16F3DF02F491AC07,30181,5,7,2,109.51597,18.23313,1557
111334,5395D4F841A8132E16F3DF02F491AC07,31521,7,8,1,109.51458,18.22542,1555
111335,5395D4F841A8132E16F3DF02F491AC07,30181,9,23,14,109.51597,18.23313,1557
111348,DB4DF566D4757FF3BB488F82DE126248,31561,4,6,2,109.56792,18.28479,1765
111349,DB4DF566D4757FF3BB488F82DE126248,30851,6,9,3,109.5616,18.27396,1713
111350,DB4DF566D4757FF3BB488F82DE126248,31561,12,22,10,109.56792,18.28479,1765
111379,0312B43ACF9ED1D8304E325E851AEE29,31561,9,16,7,109.56792,18.28479,1765
111380,0312B43ACF9ED1D8304E325E851AEE29,30851,19,20,1,109.5616,18.27396,1713
111393,26F19CD72FDC9A2451096E387469F882,38951,0,13,13,109.48097,18.28868,1416
111394,26F19CD72FDC9A2451096E387469F882,60501,13,14,1,109.48701,18.29021,1466
111395,26F19CD72FDC9A2451096E387469F882,38951,15,23,8,109.48097,18.28868,1416
111423,67D30B307FD4639F5D7DA8C23EB3E033,30941,9,10,1,109.5559,18.33938,1724
111424,67D30B307FD4639F5D7DA8C23EB3E033,60291,12,14,2,109.50826,18.24639,1509
111425,67D30B307FD4639F5D7DA8C23EB3E033,31145,16,17,1,109.20431,18.30479,369
111427,AF8951243335C5641CA49F5E1C1B4359,30921,1,8,7,109.53903,18.29451,1667
111428,AF8951243335C5641CA49F5E1C1B4359,31931,9,10,1,109.54771,18.29403,1667
111429,AF8951243335C5641CA49F5E1C1B4359,30921,11,12,1,109.53903,18.29451,1667
111430,AF8951243335C5641CA49F5E1C1B4359,30721,19,20,1,109.51597,18.28257,1565
111431,AF8951243335C5641CA49F5E1C1B4359,30921,21,22,1,109.53903,18.29451,1667
111475,5CC1762A5E087A77C8027D2CC6A16A88,60371,15,16,1,109.53063,18.30056,1618
111476,5CC1762A5E087A77C8027D2CC6A16A88,38991,17,23,6,109.52681,18.30368,1618
111488,09390A13C8E5C15C1E5674E3DB9139EC,60201,3,4,1,109.5041,18.2509,1510
111489,09390A13C8E5C15C1E5674E3DB9139EC,30711,5,11,6,109.50271,18.25347,1510
111490,09390A13C8E5C15C1E5674E3DB9139EC,60161,15,17,2,109.49174,18.26181,1461
111491,09390A13C8E5C15C1E5674E3DB9139EC,60201,21,23,2,109.5041,18.2509,1510
111499,95995BA11779CD05AD5B8FAE514E91EC,60361,0,3,3,109.51938,18.29681,1567
111500,95995BA11779CD05AD5B8FAE514E91EC,30921,4,5,1,109.53903,18.29451,1667
111501,95995BA11779CD05AD5B8FAE514E91EC,30324,8,9,1,109.50326,18.29257,1517
111502,95995BA11779CD05AD5B8FAE514E91EC,60361,10,12,2,109.51938,18.29681,1567
111503,95995BA11779CD05AD5B8FAE514E91EC,30324,14,18,4,109.50326,18.29257,1517
111504,95995BA11779CD05AD5B8FAE514E91EC,60361,19,23,4,109.51938,18.29681,1567
111588,0C8D15C0488D521680F0DE3A28CFE111,31811,1,7,6,109.54201,18.31806,1671
111589,0C8D15C0488D521680F0DE3A28CFE111,30701,7,14,7,109.59313,18.32007,1871
111590,0C8D15C0488D521680F0DE3A28CFE111,31811,14,23,9,109.54201,18.31806,1671
111602,CA3896FB33E9BC68E91955EDFF5D709B,31071,0,6,6,109.58257,18.28458,1815
111603,CA3896FB33E9BC68E91955EDFF5D709B,30854,8,9,1,109.56889,18.27076,1763
111604,CA3896FB33E9BC68E91955EDFF5D709B,31945,13,16,3,109.58021,18.29403,1817
111615,0226E559545DD94A540AD0319E8FE2BE,31701,0,8,8,109.44132,18.28833,1266
111620,45CCFCD3EBDF941E1C92B70ED06E8B5E,31561,0,5,5,109.56792,18.28479,1765
111621,45CCFCD3EBDF941E1C92B70ED06E8B5E,30854,9,10,1,109.56889,18.27076,1763
111622,45CCFCD3EBDF941E1C92B70ED06E8B5E,31071,12,14,2,109.58257,18.28458,1815
111623,45CCFCD3EBDF941E1C92B70ED06E8B5E,30854,14,16,2,109.56889,18.27076,1763
111624,45CCFCD3EBDF941E1C92B70ED06E8B5E,38991,18,19,1,109.52681,18.30368,1618
111625,45CCFCD3EBDF941E1C92B70ED06E8B5E,31561,21,22,1,109.56792,18.28479,1765
111648,0004E9A02B9F97024FE46D8B36381EE9,31031,18,19,1,109.49979,18.25382,1510
111649,6B806948BC9187A91D033B4096721B00,30854,5,6,1,109.56889,18.27076,1763
111650,6B806948BC9187A91D033B4096721B00,31071,11,19,8,109.58257,18.28458,1815
111659,F621296F333E8058687ACD884B135C6E,30504,2,5,3,109.705,18.35368,2277
111660,F621296F333E8058687ACD884B135C6E,31181,6,7,1,109.50382,18.24813,1509
111661,F621296F333E8058687ACD884B135C6E,60291,8,9,1,109.50826,18.24639,1509
111724,1CB7DA025FB95AE18ED5AC1449EEA03C,31081,1,10,9,109.44639,18.30181,1318
111725,1CB7DA025FB95AE18ED5AC1449EEA03C,31145,12,15,3,109.20431,18.30479,369
111726,1CB7DA025FB95AE18ED5AC1449EEA03C,38754,16,17,1,109.74667,18.37382,2430
111727,1CB7DA025FB95AE18ED5AC1449EEA03C,30151,19,21,2,109.50986,18.25083,1560
111741,A378B693C957D4993D23498947213CD6,31181,18,19,1,109.50382,18.24813,1509
111754,E65658506C2BF9C993BA69EE6D38B3C6,60361,0,1,1,109.51938,18.29681,1567
111755,E65658506C2BF9C993BA69EE6D38B3C6,31951,2,3,1,109.52174,18.30299,1568
111756,E65658506C2BF9C993BA69EE6D38B3C6,60361,4,5,1,109.51938,18.29681,1567
111757,E65658506C2BF9C993BA69EE6D38B3C6,31951,6,14,8,109.52174,18.30299,1568
111758,E65658506C2BF9C993BA69EE6D38B3C6,60361,16,18,2,109.51938,18.29681,1567
111811,14DC9638CB494ECD60B58F300BAA61B6,39181,0,6,6,109.55153,18.28035,1715
111812,14DC9638CB494ECD60B58F300BAA61B6,39181,9,22,13,109.55153,18.28035,1715
111844,11150C7195A88F4196F1FFE1C448FD6F,31945,15,16,1,109.58021,18.29403,1817
111845,11150C7195A88F4196F1FFE1C448FD6F,60501,18,20,2,109.48701,18.29021,1466
111846,11150C7195A88F4196F1FFE1C448FD6F,31521,21,23,2,109.51458,18.22542,1555
111862,C93386A9D86FE22A1FD4E5116045DD8D,31561,0,6,6,109.56792,18.28479,1765
111863,C93386A9D86FE22A1FD4E5116045DD8D,39183,7,11,4,109.55542,18.28208,1715
111864,C93386A9D86FE22A1FD4E5116045DD8D,31561,12,13,1,109.56792,18.28479,1765
111865,C93386A9D86FE22A1FD4E5116045DD8D,39183,15,18,3,109.55542,18.28208,1715
111895,2B8C748A18FA7D08D4335AD7C9DEF01B,31761,0,6,6,109.60521,18.27965,1914
111896,2B8C748A18FA7D08D4335AD7C9DEF01B,30951,11,16,5,109.56208,18.25667,1761
111897,2B8C748A18FA7D08D4335AD7C9DEF01B,31761,18,22,4,109.60521,18.27965,1914
111908,D80AC69F36570B5458F4FDBA38D67740,60161,0,7,7,109.49174,18.26181,1461
111909,D80AC69F36570B5458F4FDBA38D67740,60201,8,9,1,109.5041,18.2509,1510
111910,D80AC69F36570B5458F4FDBA38D67740,31181,11,14,3,109.50382,18.24813,1509
111911,D80AC69F36570B5458F4FDBA38D67740,60161,14,18,4,109.49174,18.26181,1461
111912,57E5041E0C0E731808C5DA6C9EE240E2,31521,14,20,6,109.51458,18.22542,1555
111913,57E5041E0C0E731808C5DA6C9EE240E2,38071,21,22,1,109.40722,18.30938,1169
111914,BAFDD3A022A674BA6CCC93E365FAFC36,60131,0,7,7,109.49819,18.24778,1509
111915,BAFDD3A022A674BA6CCC93E365FAFC36,38721,9,11,2,109.50368,18.27542,1514
111916,BAFDD3A022A674BA6CCC93E365FAFC36,31461,13,14,1,109.5091,18.25389,1510
111917,BAFDD3A022A674BA6CCC93E365FAFC36,38721,15,18,3,109.50368,18.27542,1514
111943,6587551DA47309E484D1302521C8D417,60631,1,3,2,109.57778,18.27583,1814
111944,6587551DA47309E484D1302521C8D417,38275,7,11,4,109.62875,18.22938,2006
111945,6587551DA47309E484D1302521C8D417,60631,14,15,1,109.57778,18.27583,1814
111946,6587551DA47309E484D1302521C8D417,38275,17,22,5,109.62875,18.22938,2006
111965,BCF7902B3144684D44567B20BDAA780E,60614,0,7,7,109.48799,18.29521,1467
111966,BCF7902B3144684D44567B20BDAA780E,30971,7,11,4,109.48708,18.29319,1467
111967,BCF7902B3144684D44567B20BDAA780E,48647,12,14,2,109.48701,18.29042,1466
111985,73E2E1BE5471172391E67FF4D9056766,60401,0,7,7,109.47444,18.27583,1414
111986,73E2E1BE5471172391E67FF4D9056766,31031,11,12,1,109.49979,18.25382,1510
111998,3977578BE56276DA0700B04B81DC1356,30851,0,1,1,109.5616,18.27396,1713
111999,3977578BE56276DA0700B04B81DC1356,31561,2,3,1,109.56792,18.28479,1765
112000,3977578BE56276DA0700B04B81DC1356,30851,3,6,3,109.5616,18.27396,1713
112001,3977578BE56276DA0700B04B81DC1356,31561,6,15,9,109.56792,18.28479,1765
112002,3977578BE56276DA0700B04B81DC1356,31071,19,20,1,109.58257,18.28458,1815
112083,AD608A919061B1C684914F8654FB2493,30101,17,18,1,109.57299,18.33333,1773
112084,AD608A919061B1C684914F8654FB2493,30241,20,22,2,109.26174,18.3275,622
112157,42815E00E74F2DEE06DE8ADA6B858662,30854,9,10,1,109.56889,18.27076,1763
112158,42815E00E74F2DEE06DE8ADA6B858662,31561,11,12,1,109.56792,18.28479,1765
112159,42815E00E74F2DEE06DE8ADA6B858662,30854,14,16,2,109.56889,18.27076,1763
112196,44CB5F545D2E3587ACF209AB2414C1A1,30854,14,16,2,109.56889,18.27076,1763
112197,44CB5F545D2E3587ACF209AB2414C1A1,31071,18,20,2,109.58257,18.28458,1815
112198,56C8C781972E8BFAF8A768A19AD7F590,31861,0,1,1,109.49042,18.27549,1464
112199,56C8C781972E8BFAF8A768A19AD7F590,30281,1,7,6,109.50597,18.27583,1514
112210,5D4E252AC551D7DB97A6F7C764F981F2,31351,0,8,8,109.4959,18.28417,1465
112211,5D4E252AC551D7DB97A6F7C764F981F2,38127,10,12,2,109.50833,18.27222,1513
112212,5D4E252AC551D7DB97A6F7C764F981F2,30291,14,15,1,109.50403,18.27028,1513
112213,5D4E252AC551D7DB97A6F7C764F981F2,38127,15,17,2,109.50833,18.27222,1513
112214,5D4E252AC551D7DB97A6F7C764F981F2,31861,20,23,3,109.49042,18.27549,1464
112228,FE1EC0E71A7AFD40F1435A5CA011EA80,30111,0,21,21,109.47583,18.30542,1419
112229,FE1EC0E71A7AFD40F1435A5CA011EA80,38094,22,23,1,109.45403,18.28778,1316
112233,173CD7A2B7B334BC53A50A1D248FBCFE,30854,3,8,5,109.56889,18.27076,1763
112234,173CD7A2B7B334BC53A50A1D248FBCFE,31071,9,10,1,109.58257,18.28458,1815
112235,173CD7A2B7B334BC53A50A1D248FBCFE,30854,10,11,1,109.56889,18.27076,1763
112236,173CD7A2B7B334BC53A50A1D248FBCFE,31071,12,13,1,109.58257,18.28458,1815
112237,173CD7A2B7B334BC53A50A1D248FBCFE,30854,13,20,7,109.56889,18.27076,1763
112238,451E2BF48CD7B253EB0892324E679BCC,30711,16,17,1,109.50271,18.25347,1510
112239,451E2BF48CD7B253EB0892324E679BCC,38297,21,23,2,109.52576,18.24965,1609
112316,DDE77D3A656666992FC3458B84010D43,39183,0,5,5,109.55542,18.28208,1715
112317,DDE77D3A656666992FC3458B84010D43,31561,8,9,1,109.56792,18.28479,1765
112318,DDE77D3A656666992FC3458B84010D43,39183,11,14,3,109.55542,18.28208,1715
112319,DDE77D3A656666992FC3458B84010D43,31561,14,15,1,109.56792,18.28479,1765
112320,DDE77D3A656666992FC3458B84010D43,31931,15,17,2,109.54771,18.29403,1667
112321,DDE77D3A656666992FC3458B84010D43,31561,18,19,1,109.56792,18.28479,1765
112343,529A14F498129B0238F7B12A9FC7F6F7,31671,2,14,12,109.38965,18.29813,1068
112344,529A14F498129B0238F7B12A9FC7F6F7,30761,14,16,2,109.45201,18.3,1318
112345,529A14F498129B0238F7B12A9FC7F6F7,31671,18,20,2,109.38965,18.29813,1068
112346,529A14F498129B0238F7B12A9FC7F6F7,30671,21,22,1,109.43611,18.30139,1268
112351,5CF4A8FAA851F08835C66E9B9D9918DE,31521,12,14,2,109.51458,18.22542,1555
112352,5CF4A8FAA851F08835C66E9B9D9918DE,31471,16,17,1,109.34583,18.29563,917
112353,5CF4A8FAA851F08835C66E9B9D9918DE,60381,20,22,2,109.5241,18.22458,1605
112371,2C3BD53A8702A47FB82F05FB4993B683,31561,0,14,14,109.56792,18.28479,1765
112372,2C3BD53A8702A47FB82F05FB4993B683,39183,15,18,3,109.55542,18.28208,1715
112373,2C3BD53A8702A47FB82F05FB4993B683,31561,20,22,2,109.56792,18.28479,1765
112388,9646DACA260879D32095F9107B2CAA8C,31411,20,22,2,109.5016,18.23576,1507
112398,866460FA5062A635337B6369BB2AADDA,30854,15,20,5,109.56889,18.27076,1763
112399,866460FA5062A635337B6369BB2AADDA,60631,22,23,1,109.57778,18.27583,1814
112403,F6A1EBB84FE583E84185C423218578F5,31561,0,4,4,109.56792,18.28479,1765
112404,F6A1EBB84FE583E84185C423218578F5,30854,8,9,1,109.56889,18.27076,1763
112405,F6A1EBB84FE583E84185C423218578F5,31561,11,13,2,109.56792,18.28479,1765
112406,F6A1EBB84FE583E84185C423218578F5,39183,18,19,1,109.55542,18.28208,1715
112428,283001ED673D8EDBEF7EEB00BDB31533,30571,2,5,3,109.50243,18.21861,1504
112429,283001ED673D8EDBEF7EEB00BDB31533,31181,7,12,5,109.50382,18.24813,1509
112430,283001ED673D8EDBEF7EEB00BDB31533,60131,13,18,5,109.49819,18.24778,1509
112431,283001ED673D8EDBEF7EEB00BDB31533,30571,19,23,4,109.50243,18.21861,1504
112453,074529940A21272589048F79E19D41E0,30441,0,6,6,109.64021,18.25424,2010
112454,074529940A21272589048F79E19D41E0,38275,8,9,1,109.62875,18.22938,2006
112455,074529940A21272589048F79E19D41E0,31321,11,14,3,109.63799,18.23201,2007
112456,074529940A21272589048F79E19D41E0,60381,19,22,3,109.5241,18.22458,1605
112466,B5D5F035B558647FF9F44A76F16A1183,31041,1,8,7,109.50278,18.23701,1507
112468,B5D5F035B558647FF9F44A76F16A1183,31201,16,22,6,109.51042,18.23819,1558
112489,4E9347808E8F02AFB816F8344D637F34,31206,0,1,1,109.50819,18.23549,1507
112490,4E9347808E8F02AFB816F8344D637F34,31701,4,5,1,109.44132,18.28833,1266
112491,4E9347808E8F02AFB816F8344D637F34,30741,5,22,17,109.49833,18.28681,1516
112492,FD45DAD5A6F6BB711255CB29E453CFF1,30854,3,7,4,109.56889,18.27076,1763
112493,FD45DAD5A6F6BB711255CB29E453CFF1,31561,7,9,2,109.56792,18.28479,1765
112494,FD45DAD5A6F6BB711255CB29E453CFF1,30854,9,22,13,109.56889,18.27076,1763
112536,D39D64452E6BBEF7B3056CA239E1B86E,30854,0,6,6,109.56889,18.27076,1763
112537,D39D64452E6BBEF7B3056CA239E1B86E,31561,6,7,1,109.56792,18.28479,1765
112538,D39D64452E6BBEF7B3056CA239E1B86E,30854,11,14,3,109.56889,18.27076,1763
112539,D39D64452E6BBEF7B3056CA239E1B86E,31561,14,15,1,109.56792,18.28479,1765
112585,D6B54C643B88B86782DC30A38AD291FD,31561,2,8,6,109.56792,18.28479,1765
112586,D6B54C643B88B86782DC30A38AD291FD,30854,9,11,2,109.56889,18.27076,1763
112609,1FE2866848043A2C10AD87212485FE15,31071,1,7,6,109.58257,18.28458,1815
112610,1FE2866848043A2C10AD87212485FE15,30854,7,21,14,109.56889,18.27076,1763
112692,DE3ACBBFFF90250B316F62451B8DF01D,31781,17,20,3,109.19847,18.2975,367
112693,DE3ACBBFFF90250B316F62451B8DF01D,31781,21,22,1,109.19847,18.2975,367
112694,CD576F1C1CDFB89E6A99A20E65927346,31071,0,2,2,109.58257,18.28458,1815
112695,CD576F1C1CDFB89E6A99A20E65927346,30854,2,3,1,109.56889,18.27076,1763
112696,CD576F1C1CDFB89E6A99A20E65927346,31561,4,5,1,109.56792,18.28479,1765
112712,0695D4E7B3E726CA09D841B87798B560,30854,1,10,9,109.56889,18.27076,1763
112713,0695D4E7B3E726CA09D841B87798B560,30271,12,13,1,109.49132,18.23153,1456
112714,0695D4E7B3E726CA09D841B87798B560,31561,14,15,1,109.56792,18.28479,1765
112715,0695D4E7B3E726CA09D841B87798B560,30854,17,19,2,109.56889,18.27076,1763
112739,B712327B6033C61F37801CFD6DAC08AD,31951,5,6,1,109.52174,18.30299,1568
112740,B712327B6033C61F37801CFD6DAC08AD,38484,7,11,4,109.53028,18.31528,1620
112741,B712327B6033C61F37801CFD6DAC08AD,31951,13,14,1,109.52174,18.30299,1568
112742,B712327B6033C61F37801CFD6DAC08AD,38484,14,18,4,109.53028,18.31528,1620
112743,B712327B6033C61F37801CFD6DAC08AD,38484,18,21,3,109.53028,18.31528,1620
112744,234DDB978581BC47A9F93772F013DD01,60221,0,16,16,109.52569,18.29188,1616
112745,234DDB978581BC47A9F93772F013DD01,31181,19,22,3,109.50382,18.24813,1509
112758,63FBAC0202144B00077561285E6A7F87,30821,0,17,17,109.43681,18.33639,1274
112759,63FBAC0202144B00077561285E6A7F87,30651,17,19,2,109.42611,18.385,1232
112760,63FBAC0202144B00077561285E6A7F87,30821,19,23,4,109.43681,18.33639,1274
112779,070984703178D21DC5287E457C03691A,39181,0,11,11,109.55153,18.28035,1715
112780,070984703178D21DC5287E457C03691A,39181,15,16,1,109.55153,18.28035,1715
112781,070984703178D21DC5287E457C03691A,39181,19,23,4,109.55153,18.28035,1715
112789,87ADC98470D754E65D1F229228B379D5,30851,0,7,7,109.5616,18.27396,1713
112790,87ADC98470D754E65D1F229228B379D5,39183,9,13,4,109.55542,18.28208,1715
112791,87ADC98470D754E65D1F229228B379D5,30851,17,23,6,109.5616,18.27396,1713
112840,530F0AE3A2D48DD91CDC3A17D13BA70F,38707,0,21,21,109.73778,18.35368,2427
112841,530F0AE3A2D48DD91CDC3A17D13BA70F,60221,22,23,1,109.52569,18.29188,1616
112848,47C8C71AB8A291B23C6D0393C8109E46,38261,0,7,7,109.50361,18.28153,1515
112849,47C8C71AB8A291B23C6D0393C8109E46,31311,9,13,4,109.72299,18.27438,2364
112850,47C8C71AB8A291B23C6D0393C8109E46,38185,14,15,1,109.51333,18.27347,1563
112851,47C8C71AB8A291B23C6D0393C8109E46,38261,17,23,6,109.50361,18.28153,1515
112852,FD348BFB9AA55FE65CC3992170FAFF82,30241,11,14,3,109.26174,18.3275,622
112853,FD348BFB9AA55FE65CC3992170FAFF82,60614,17,18,1,109.48799,18.29521,1467
112868,89362A3CA3AE6F5B75871F2110924F99,30851,0,14,14,109.5616,18.27396,1713
112869,89362A3CA3AE6F5B75871F2110924F99,30951,14,16,2,109.56208,18.25667,1761
112870,89362A3CA3AE6F5B75871F2110924F99,30851,17,23,6,109.5616,18.27396,1713
112950,7FF3C6569A3990C03CAF6C52D3C8BC6C,30921,1,2,1,109.53903,18.29451,1667
112951,7FF3C6569A3990C03CAF6C52D3C8BC6C,31931,7,8,1,109.54771,18.29403,1667
112952,7FF3C6569A3990C03CAF6C52D3C8BC6C,30921,9,10,1,109.53903,18.29451,1667
112953,7FF3C6569A3990C03CAF6C52D3C8BC6C,60241,11,13,2,109.53319,18.28667,1616
112954,7FF3C6569A3990C03CAF6C52D3C8BC6C,31931,17,19,2,109.54771,18.29403,1667
112967,B78E7295CB13532B4E2C30EF158E297F,31931,0,6,6,109.54771,18.29403,1667
112968,B78E7295CB13532B4E2C30EF158E297F,39183,7,23,16,109.55542,18.28208,1715
112993,AA2A5396AD753E9245AC53C94BAEDECD,61011,0,19,19,109.60653,18.19076,1900
113035,192815485DBBC485508837480A81E25C,30051,0,8,8,109.48917,18.21215,1453
113036,192815485DBBC485508837480A81E25C,30571,11,16,5,109.50243,18.21861,1504
113037,192815485DBBC485508837480A81E25C,30571,17,18,1,109.50243,18.21861,1504
113038,192815485DBBC485508837480A81E25C,30051,18,20,2,109.48917,18.21215,1453
113039,192815485DBBC485508837480A81E25C,38881,21,23,2,109.51618,18.26431,1562
113043,48C2384D12D5B16772007E35CE360CBB,30721,0,7,7,109.51597,18.28257,1565
113044,48C2384D12D5B16772007E35CE360CBB,38105,8,10,2,109.40299,18.29229,1117
113045,48C2384D12D5B16772007E35CE360CBB,60541,14,17,3,109.4084,18.29208,1167
113046,48C2384D12D5B16772007E35CE360CBB,31345,21,22,1,109.39,18.29,1066
113060,60085C98EDC64770922E20845B09F807,31931,0,6,6,109.54771,18.29403,1667
113061,60085C98EDC64770922E20845B09F807,39183,7,8,1,109.55542,18.28208,1715
113062,60085C98EDC64770922E20845B09F807,31931,11,21,10,109.54771,18.29403,1667
113139,A928E9F6C796FE1A60807BA003DE87BB,39181,8,10,2,109.55153,18.28035,1715
113140,A928E9F6C796FE1A60807BA003DE87BB,30854,13,14,1,109.56889,18.27076,1763
113141,A928E9F6C796FE1A60807BA003DE87BB,39183,14,16,2,109.55542,18.28208,1715
113142,A928E9F6C796FE1A60807BA003DE87BB,30854,20,23,3,109.56889,18.27076,1763
113197,F7E62C7FDB1E97C4DC2EC3F48A6FAADB,30232,0,5,5,109.6191,18.31701,1971
113198,F7E62C7FDB1E97C4DC2EC3F48A6FAADB,30891,6,9,3,109.59431,18.28389,1865
113199,F7E62C7FDB1E97C4DC2EC3F48A6FAADB,31321,11,12,1,109.63799,18.23201,2007
113200,F7E62C7FDB1E97C4DC2EC3F48A6FAADB,60381,14,15,1,109.5241,18.22458,1605
113201,F7E62C7FDB1E97C4DC2EC3F48A6FAADB,60381,18,19,1,109.5241,18.22458,1605
113202,F7E62C7FDB1E97C4DC2EC3F48A6FAADB,31521,20,22,2,109.51458,18.22542,1555
113212,807332CEC38772FA8DF98C48FBD8DD1E,30851,2,5,3,109.5616,18.27396,1713
113213,807332CEC38772FA8DF98C48FBD8DD1E,31561,10,16,6,109.56792,18.28479,1765
113214,807332CEC38772FA8DF98C48FBD8DD1E,39183,17,18,1,109.55542,18.28208,1715
113215,807332CEC38772FA8DF98C48FBD8DD1E,31561,21,23,2,109.56792,18.28479,1765
113269,A749E400BFD3B5908671E939EC104DEE,30854,0,8,8,109.56889,18.27076,1763
113271,A749E400BFD3B5908671E939EC104DEE,30854,16,18,2,109.56889,18.27076,1763
113284,9AF351B3CC27394DFED45513F0E32162,60351,0,7,7,109.58403,18.28958,1816
113285,9AF351B3CC27394DFED45513F0E32162,31061,9,11,2,109.53333,18.23257,1607
113286,9AF351B3CC27394DFED45513F0E32162,39371,14,17,3,109.56627,18.2646,1762
113287,9AF351B3CC27394DFED45513F0E32162,60351,19,23,4,109.58403,18.28958,1816
113288,560794A44CA17A43FA34D0FA6C339747,30854,0,8,8,109.56889,18.27076,1763
113289,560794A44CA17A43FA34D0FA6C339747,31071,9,11,2,109.58257,18.28458,1815
113290,560794A44CA17A43FA34D0FA6C339747,30854,15,23,8,109.56889,18.27076,1763
113308,608A55C14BAB2A5B627ACC1F39B89FB6,31945,0,7,7,109.58021,18.29403,1817
113309,608A55C14BAB2A5B627ACC1F39B89FB6,30854,8,9,1,109.56889,18.27076,1763
113310,608A55C14BAB2A5B627ACC1F39B89FB6,31945,12,13,1,109.58021,18.29403,1817
113311,608A55C14BAB2A5B627ACC1F39B89FB6,30854,15,17,2,109.56889,18.27076,1763
113312,608A55C14BAB2A5B627ACC1F39B89FB6,31945,19,23,4,109.58021,18.29403,1817
113338,F2620FCAAD481C8B0F3979FFE2786ED4,38017,0,4,4,109.49729,18.21424,1504
113339,F2620FCAAD481C8B0F3979FFE2786ED4,38356,5,6,1,109.50201,18.21486,1504
113340,F2620FCAAD481C8B0F3979FFE2786ED4,38017,6,12,6,109.49729,18.21424,1504
113341,F2620FCAAD481C8B0F3979FFE2786ED4,30571,13,15,2,109.50243,18.21861,1504
113342,F2620FCAAD481C8B0F3979FFE2786ED4,38356,19,21,2,109.50201,18.21486,1504
113349,6631651FB15573A8B0C781F858B82603,31231,0,10,10,109.42597,18.29292,1217
113350,6631651FB15573A8B0C781F858B82603,31391,11,12,1,109.50382,18.24285,1508
113351,6631651FB15573A8B0C781F858B82603,33481,14,15,1,109.67278,18.41278,2187
113352,6631651FB15573A8B0C781F858B82603,30271,19,20,1,109.49132,18.23153,1456
113353,6631651FB15573A8B0C781F858B82603,31231,20,22,2,109.42597,18.29292,1217
113354,E232785024C88A21117B5209B44DB58B,31231,17,18,1,109.42597,18.29292,1217
113355,E232785024C88A21117B5209B44DB58B,30681,20,21,1,109.48493,18.26917,1463
113356,E232785024C88A21117B5209B44DB58B,31231,21,23,2,109.42597,18.29292,1217
113362,E8460AE5EC97FDCA776388340866C418,30854,13,15,2,109.56889,18.27076,1763
113363,E8460AE5EC97FDCA776388340866C418,31861,17,23,6,109.49042,18.27549,1464
113449,C61360C6C8202A54143E165C2C08120B,30951,2,11,9,109.56208,18.25667,1761
113450,C61360C6C8202A54143E165C2C08120B,30854,14,19,5,109.56889,18.27076,1763
113451,C61360C6C8202A54143E165C2C08120B,30951,21,23,2,109.56208,18.25667,1761
113511,13166628932DF36C0AD7B1DB5811240A,60631,13,15,2,109.57778,18.27583,1814
113512,13166628932DF36C0AD7B1DB5811240A,60591,18,23,5,109.61118,18.21715,1904
113518,2DA5948E96121EADE6CCFA0D33794EFE,38251,0,11,11,109.49618,18.25493,1510
113519,2DA5948E96121EADE6CCFA0D33794EFE,31031,14,17,3,109.49979,18.25382,1510
113520,2DA5948E96121EADE6CCFA0D33794EFE,31031,20,22,2,109.49979,18.25382,1510
113530,6DF7485545B790F22810B0EDD8F1B356,31945,0,13,13,109.58021,18.29403,1817
113531,6DF7485545B790F22810B0EDD8F1B356,30854,14,22,8,109.56889,18.27076,1763
113532,29C138323F7793FA5DE28E5154764E0B,60381,14,16,2,109.5241,18.22458,1605
113555,15A2A8790389D1537721C21B141A7A31,61011,3,8,5,109.60653,18.19076,1900
113556,15A2A8790389D1537721C21B141A7A31,31071,9,12,3,109.58257,18.28458,1815
113557,15A2A8790389D1537721C21B141A7A31,31571,13,14,1,109.61563,18.23326,1957
113559,15A2A8790389D1537721C21B141A7A31,61011,17,19,2,109.60653,18.19076,1900
113591,77F5A37783010C53E376197FE3F1043D,60671,4,5,1,109.52979,18.31757,1621
113592,77F5A37783010C53E376197FE3F1043D,30071,8,13,5,109.52819,18.30472,1619
113593,77F5A37783010C53E376197FE3F1043D,38991,14,16,2,109.52681,18.30368,1618
113594,77F5A37783010C53E376197FE3F1043D,60371,18,20,2,109.53063,18.30056,1618
113607,0F558B6653C655C7F0BAEA9D66B33F57,31071,2,7,5,109.58257,18.28458,1815
113608,0F558B6653C655C7F0BAEA9D66B33F57,30854,11,12,1,109.56889,18.27076,1763
113609,0F558B6653C655C7F0BAEA9D66B33F57,31071,17,23,6,109.58257,18.28458,1815
113630,7421066246AAD1C230E7E2A7ADF06E9D,30721,0,1,1,109.51597,18.28257,1565
113631,7421066246AAD1C230E7E2A7ADF06E9D,60631,2,6,4,109.57778,18.27583,1814
113632,7421066246AAD1C230E7E2A7ADF06E9D,30854,7,10,3,109.56889,18.27076,1763
113633,7421066246AAD1C230E7E2A7ADF06E9D,60631,12,13,1,109.57778,18.27583,1814
113634,7421066246AAD1C230E7E2A7ADF06E9D,31071,17,18,1,109.58257,18.28458,1815
113635,7421066246AAD1C230E7E2A7ADF06E9D,30854,18,20,2,109.56889,18.27076,1763
113636,7421066246AAD1C230E7E2A7ADF06E9D,60631,21,23,2,109.57778,18.27583,1814
113659,A01B4012B619D942E7CC3AC9B78722B4,30851,20,21,1,109.5616,18.27396,1713
113660,A01B4012B619D942E7CC3AC9B78722B4,31561,21,23,2,109.56792,18.28479,1765
113663,417408FFDA93B177641D270D3A5C4B2D,31071,0,5,5,109.58257,18.28458,1815
113664,417408FFDA93B177641D270D3A5C4B2D,60631,7,9,2,109.57778,18.27583,1814
113665,417408FFDA93B177641D270D3A5C4B2D,31071,12,13,1,109.58257,18.28458,1815
113666,417408FFDA93B177641D270D3A5C4B2D,60631,15,17,2,109.57778,18.27583,1814
113667,417408FFDA93B177641D270D3A5C4B2D,30854,18,19,1,109.56889,18.27076,1763
113668,417408FFDA93B177641D270D3A5C4B2D,31071,20,21,1,109.58257,18.28458,1815
113669,417408FFDA93B177641D270D3A5C4B2D,30854,21,23,2,109.56889,18.27076,1763
113673,A01E2FD84FFE4D782E40311D1ABC1ECB,38185,0,7,7,109.51333,18.27347,1563
113674,A01E2FD84FFE4D782E40311D1ABC1ECB,39151,11,13,2,109.49875,18.25097,1510
113675,A01E2FD84FFE4D782E40311D1ABC1ECB,30281,14,21,7,109.50597,18.27583,1514
113729,A4743972EC2FC58546DD11935BDC0E1A,30711,0,8,8,109.50271,18.25347,1510
113730,A4743972EC2FC58546DD11935BDC0E1A,30771,11,16,5,109.49938,18.26042,1511
113731,A4743972EC2FC58546DD11935BDC0E1A,39091,20,23,3,109.50097,18.25222,1510
113739,EA27C1DACC015E381783BB03940DBA88,38484,0,1,1,109.53028,18.31528,1620
113740,EA27C1DACC015E381783BB03940DBA88,31951,2,6,4,109.52174,18.30299,1568
113772,EFFEF00C078D502D6D0D1D469ACBA466,39154,0,7,7,109.50201,18.25681,1511
113773,EFFEF00C078D502D6D0D1D469ACBA466,31471,10,11,1,109.34583,18.29563,917
113774,EFFEF00C078D502D6D0D1D469ACBA466,38321,12,14,2,109.39854,18.29132,1116
113775,EFFEF00C078D502D6D0D1D469ACBA466,39151,19,20,1,109.49875,18.25097,1510
113776,EFFEF00C078D502D6D0D1D469ACBA466,39041,21,23,2,109.40021,18.29278,1117
113807,D2A5F87218CF25385163A2F3C4229CB8,30851,1,6,5,109.5616,18.27396,1713
113808,D2A5F87218CF25385163A2F3C4229CB8,31561,6,9,3,109.56792,18.28479,1765
113809,D2A5F87218CF25385163A2F3C4229CB8,30851,12,13,1,109.5616,18.27396,1713
113810,D2A5F87218CF25385163A2F3C4229CB8,31271,18,20,2,109.48958,18.26257,1462
113811,D2A5F87218CF25385163A2F3C4229CB8,31561,20,22,2,109.56792,18.28479,1765
113835,675E351075D065B9BC87550D5606DD5B,60621,0,9,9,109.48354,18.27451,1464
113836,675E351075D065B9BC87550D5606DD5B,31864,9,10,1,109.49014,18.28333,1465
113845,147470AD3D3B8724582C30D5F244A8B6,60421,2,5,3,109.46333,18.31743,1371
113846,147470AD3D3B8724582C30D5F244A8B6,30111,6,9,3,109.47583,18.30542,1419
113847,147470AD3D3B8724582C30D5F244A8B6,60421,9,19,10,109.46333,18.31743,1371
113851,BD4652414D5C17466BA36FD4BD943A94,30721,1,7,6,109.51597,18.28257,1565
113852,BD4652414D5C17466BA36FD4BD943A94,31931,8,10,2,109.54771,18.29403,1667
113853,BD4652414D5C17466BA36FD4BD943A94,39183,11,12,1,109.55542,18.28208,1715
113854,BD4652414D5C17466BA36FD4BD943A94,31931,13,14,1,109.54771,18.29403,1667
113855,BD4652414D5C17466BA36FD4BD943A94,39183,16,18,2,109.55542,18.28208,1715
113888,598A5BC9BEA86E74379689160E91B24E,30854,0,6,6,109.56889,18.27076,1763
113889,598A5BC9BEA86E74379689160E91B24E,31071,7,9,2,109.58257,18.28458,1815
113890,598A5BC9BEA86E74379689160E91B24E,30854,10,13,3,109.56889,18.27076,1763
113891,598A5BC9BEA86E74379689160E91B24E,39371,15,18,3,109.56627,18.2646,1762
113892,598A5BC9BEA86E74379689160E91B24E,30854,20,22,2,109.56889,18.27076,1763
113914,528F99F7FD8CA49B85B45B64A5D784BA,39181,12,13,1,109.55153,18.28035,1715
113915,528F99F7FD8CA49B85B45B64A5D784BA,30851,14,17,3,109.5616,18.27396,1713
113935,68D54610D4145F71460044C254B0ACFF,38951,0,7,7,109.48097,18.28868,1416
113936,68D54610D4145F71460044C254B0ACFF,30661,10,11,1,109.37028,18.24361,1008
113937,68D54610D4145F71460044C254B0ACFF,31471,15,17,2,109.34583,18.29563,917
113962,0E1DB444F47235AEDAD0A0404A7B75B4,31561,1,4,3,109.56792,18.28479,1765
113963,0E1DB444F47235AEDAD0A0404A7B75B4,39183,4,7,3,109.55542,18.28208,1715
113964,0E1DB444F47235AEDAD0A0404A7B75B4,31181,10,12,2,109.50382,18.24813,1509
113965,0E1DB444F47235AEDAD0A0404A7B75B4,31181,12,13,1,109.50382,18.24813,1509
113966,0E1DB444F47235AEDAD0A0404A7B75B4,31181,14,16,2,109.50382,18.24813,1509
113967,0E1DB444F47235AEDAD0A0404A7B75B4,31561,19,20,1,109.56792,18.28479,1765
113968,0E1DB444F47235AEDAD0A0404A7B75B4,39183,22,23,1,109.55542,18.28208,1715
113992,88518ED3B6347887E74E353A92E1996C,31421,0,7,7,109.55382,18.22347,1705
113993,88518ED3B6347887E74E353A92E1996C,30631,8,12,4,109.34382,18.32778,922
113994,88518ED3B6347887E74E353A92E1996C,31261,15,16,1,109.51174,18.2466,1559
113995,88518ED3B6347887E74E353A92E1996C,31421,19,22,3,109.55382,18.22347,1705
114005,EA3A8DA5F296698D9CCABAE2F2FD40FF,31521,17,21,4,109.51458,18.22542,1555
114006,EA3A8DA5F296698D9CCABAE2F2FD40FF,31391,21,22,1,109.50382,18.24285,1508
114014,032BA6C7F044E8806CEB432AECA246EE,38484,0,7,7,109.53028,18.31528,1620
114015,032BA6C7F044E8806CEB432AECA246EE,30071,7,11,4,109.52819,18.30472,1619
114016,032BA6C7F044E8806CEB432AECA246EE,30561,11,20,9,109.52778,18.31938,1621
114017,032BA6C7F044E8806CEB432AECA246EE,38484,22,23,1,109.53028,18.31528,1620
114020,258F9A09B3B0048D107FC9EF9EB27CDE,31521,0,6,6,109.51458,18.22542,1555
114021,258F9A09B3B0048D107FC9EF9EB27CDE,30941,11,13,2,109.5559,18.33938,1724
114022,258F9A09B3B0048D107FC9EF9EB27CDE,30421,15,17,2,109.50021,18.25861,1511
114023,258F9A09B3B0048D107FC9EF9EB27CDE,38251,18,21,3,109.49618,18.25493,1510
114033,E58F7930139B2ED51DE79005F05C056D,39183,0,7,7,109.55542,18.28208,1715
114034,E58F7930139B2ED51DE79005F05C056D,39181,8,16,8,109.55153,18.28035,1715
114035,E58F7930139B2ED51DE79005F05C056D,39183,18,20,2,109.55542,18.28208,1715
114036,E58F7930139B2ED51DE79005F05C056D,31561,22,23,1,109.56792,18.28479,1765
114055,2A6BA0678DDF16AF08BAC9E3FA3C9391,31561,0,5,5,109.56792,18.28479,1765
114056,2A6BA0678DDF16AF08BAC9E3FA3C9391,30854,8,16,8,109.56889,18.27076,1763
114071,400FDACE29FFB166CA6FB4D2811F30A0,60331,0,7,7,109.505,18.26507,1512
114072,400FDACE29FFB166CA6FB4D2811F30A0,30711,8,9,1,109.50271,18.25347,1510
114073,400FDACE29FFB166CA6FB4D2811F30A0,30911,9,11,2,109.50493,18.26181,1511
114074,400FDACE29FFB166CA6FB4D2811F30A0,30711,11,13,2,109.50271,18.25347,1510
114108,8BB15E7C959475309A269AAF24FD7109,60201,0,2,2,109.5041,18.2509,1510
114109,8BB15E7C959475309A269AAF24FD7109,39111,3,8,5,109.5191,18.22597,1555
114110,8BB15E7C959475309A269AAF24FD7109,38153,9,12,3,109.51819,18.25736,1561
114111,8BB15E7C959475309A269AAF24FD7109,60291,14,15,1,109.50826,18.24639,1509
114112,8BB15E7C959475309A269AAF24FD7109,60381,18,20,2,109.5241,18.22458,1605
114113,8BB15E7C959475309A269AAF24FD7109,60201,22,23,1,109.5041,18.2509,1510
114114,75817DB682187A07461734D66E1E6492,60631,0,4,4,109.57778,18.27583,1814
114115,75817DB682187A07461734D66E1E6492,30854,6,16,10,109.56889,18.27076,1763
114116,75817DB682187A07461734D66E1E6492,60631,21,23,2,109.57778,18.27583,1814
114176,E8A62C362548F9D5791FD06549C42092,60054,0,3,3,109.3016,18.31229,770
114177,E8A62C362548F9D5791FD06549C42092,31251,4,6,2,109.18528,18.2975,317
114178,E8A62C362548F9D5791FD06549C42092,30661,8,11,3,109.37028,18.24361,1008
114179,E8A62C362548F9D5791FD06549C42092,60054,13,23,10,109.3016,18.31229,770
114192,B3AE4D148E8E9AC234F14BAF6D4A9D67,31621,3,14,11,109.51035,18.29826,1568
114193,B3AE4D148E8E9AC234F14BAF6D4A9D67,60371,15,16,1,109.53063,18.30056,1618
114194,34F3D64B41C252481F72E5CF931AC833,39183,1,6,5,109.55542,18.28208,1715
114195,34F3D64B41C252481F72E5CF931AC833,30854,7,8,1,109.56889,18.27076,1763
114196,34F3D64B41C252481F72E5CF931AC833,31071,12,21,9,109.58257,18.28458,1815
114204,E6A26FB3A5537CE712195E9460AB99FB,30854,8,18,10,109.56889,18.27076,1763
114205,E6A26FB3A5537CE712195E9460AB99FB,60631,20,22,2,109.57778,18.27583,1814
114206,53875E69050EC42E511A64D3211FA7B3,60631,0,6,6,109.57778,18.27583,1814
114207,53875E69050EC42E511A64D3211FA7B3,30854,8,13,5,109.56889,18.27076,1763
114257,85E9F50B5ABCB1024F25DC89F0D41C6E,30151,0,1,1,109.50986,18.25083,1560
114258,85E9F50B5ABCB1024F25DC89F0D41C6E,60281,2,7,5,109.51743,18.25924,1561
114259,85E9F50B5ABCB1024F25DC89F0D41C6E,31041,7,8,1,109.50278,18.23701,1507
114260,85E9F50B5ABCB1024F25DC89F0D41C6E,60211,13,19,6,109.63549,18.26049,2011
114261,85E9F50B5ABCB1024F25DC89F0D41C6E,60551,21,22,1,109.42722,18.30111,1218
114266,5E97A4561E11AAC4FBC53FD068EAA52B,30854,0,6,6,109.56889,18.27076,1763
114267,5E97A4561E11AAC4FBC53FD068EAA52B,30531,8,18,10,109.53271,18.21472,1604
114268,5E97A4561E11AAC4FBC53FD068EAA52B,30854,20,22,2,109.56889,18.27076,1763
114277,1DCF37EE2927C479B1032CB369D26049,31534,1,7,6,109.49368,18.25806,1461
114278,1DCF37EE2927C479B1032CB369D26049,31331,10,11,1,109.38417,18.44111,1091
114279,1DCF37EE2927C479B1032CB369D26049,39021,12,14,2,109.40368,18.41035,1186
114280,1DCF37EE2927C479B1032CB369D26049,38991,16,17,1,109.52681,18.30368,1618
114281,1DCF37EE2927C479B1032CB369D26049,31534,21,23,2,109.49368,18.25806,1461
114282,C19430CE8DF26BDEF43903E57E682236,31561,0,6,6,109.56792,18.28479,1765
114283,C19430CE8DF26BDEF43903E57E682236,30854,7,9,2,109.56889,18.27076,1763
114284,C19430CE8DF26BDEF43903E57E682236,30271,11,13,2,109.49132,18.23153,1456
114285,C19430CE8DF26BDEF43903E57E682236,31561,14,15,1,109.56792,18.28479,1765
114286,C19430CE8DF26BDEF43903E57E682236,30854,16,18,2,109.56889,18.27076,1763
114287,C19430CE8DF26BDEF43903E57E682236,31561,21,23,2,109.56792,18.28479,1765
114313,F2DB26AB62973FED3773C4EB9C268E84,30271,16,18,2,109.49132,18.23153,1456
114314,F2DB26AB62973FED3773C4EB9C268E84,30371,20,22,2,109.51,18.24771,1559
114415,97C90F1B15489B9330C93C4DFFAA8B6A,38283,11,15,4,109.62229,18.22618,1956
114416,97C90F1B15489B9330C93C4DFFAA8B6A,31221,20,22,2,109.61333,18.26833,1913
114420,30CAD64949610A59C64AA42715A6D4D2,38951,0,6,6,109.48097,18.28868,1416
114421,30CAD64949610A59C64AA42715A6D4D2,30101,7,9,2,109.57299,18.33333,1773
114422,30CAD64949610A59C64AA42715A6D4D2,30931,12,13,1,109.55653,18.32722,1722
114423,30CAD64949610A59C64AA42715A6D4D2,38951,15,21,6,109.48097,18.28868,1416
114424,30CAD64949610A59C64AA42715A6D4D2,38951,21,23,2,109.48097,18.28868,1416
114436,27BCEF3137923B84211F08830816C810,60211,18,20,2,109.63549,18.26049,2011
114437,27BCEF3137923B84211F08830816C810,31206,22,23,1,109.50819,18.23549,1507
114445,5B4DC5AF57F8411F4FD156D83C128739,31531,0,8,8,109.49583,18.25972,1461
114449,D78BEC45274E639A1BD4DE3D90911CD3,60501,1,2,1,109.48701,18.29021,1466
114450,D78BEC45274E639A1BD4DE3D90911CD3,38951,5,6,1,109.48097,18.28868,1416
114451,D78BEC45274E639A1BD4DE3D90911CD3,30941,8,9,1,109.5559,18.33938,1724
114452,D78BEC45274E639A1BD4DE3D90911CD3,30161,11,12,1,109.50042,18.24389,1508
114453,D78BEC45274E639A1BD4DE3D90911CD3,60614,13,16,3,109.48799,18.29521,1467
114454,D78BEC45274E639A1BD4DE3D90911CD3,38951,19,20,1,109.48097,18.28868,1416
114455,D78BEC45274E639A1BD4DE3D90911CD3,38951,20,21,1,109.48097,18.28868,1416
114456,D78BEC45274E639A1BD4DE3D90911CD3,60614,21,23,2,109.48799,18.29521,1467
114466,1113DCEA20D725C81D58CC73EC20150A,30421,13,14,1,109.50021,18.25861,1511
114469,A909026355FEE8A2304F7999D83D79B3,31571,0,12,12,109.61563,18.23326,1957
114470,A909026355FEE8A2304F7999D83D79B3,38754,14,16,2,109.74667,18.37382,2430
114471,A909026355FEE8A2304F7999D83D79B3,31231,17,19,2,109.42597,18.29292,1217
114480,5426296000364EE32711CD0E73D782C8,30854,1,7,6,109.56889,18.27076,1763
114481,5426296000364EE32711CD0E73D782C8,31561,10,16,6,109.56792,18.28479,1765
114515,91EC74D2B208A10BECBB101C6735C578,60161,0,4,4,109.49174,18.26181,1461
114516,91EC74D2B208A10BECBB101C6735C578,31864,4,9,5,109.49014,18.28333,1465
114517,91EC74D2B208A10BECBB101C6735C578,60171,10,14,4,109.51292,18.30694,1569
114518,91EC74D2B208A10BECBB101C6735C578,30921,15,16,1,109.53903,18.29451,1667
114519,91EC74D2B208A10BECBB101C6735C578,60171,17,18,1,109.51292,18.30694,1569
114520,91EC74D2B208A10BECBB101C6735C578,31864,18,20,2,109.49014,18.28333,1465
114529,4995463B780282C9C030A19D9F49AEAC,31071,3,6,3,109.58257,18.28458,1815
114530,4995463B780282C9C030A19D9F49AEAC,30854,7,12,5,109.56889,18.27076,1763
114531,4995463B780282C9C030A19D9F49AEAC,31071,12,13,1,109.58257,18.28458,1815
114532,4995463B780282C9C030A19D9F49AEAC,30854,13,15,2,109.56889,18.27076,1763
114533,4995463B780282C9C030A19D9F49AEAC,31561,16,17,1,109.56792,18.28479,1765
114534,4995463B780282C9C030A19D9F49AEAC,31071,19,21,2,109.58257,18.28458,1815
114535,CF2A30FDEEDE024C38B6F95A666F3725,60491,0,15,15,109.43354,18.30847,1269
114536,CF2A30FDEEDE024C38B6F95A666F3725,38141,20,21,1,109.39479,18.2916,1116
114579,66F8B9488B97AC9181E1428AD12A7C79,60614,0,4,4,109.48799,18.29521,1467
114580,66F8B9488B97AC9181E1428AD12A7C79,38951,5,6,1,109.48097,18.28868,1416
114581,66F8B9488B97AC9181E1428AD12A7C79,30101,10,11,1,109.57299,18.33333,1773
114582,72D984C8386A232B13E9D168E7A1C5F8,60084,6,9,3,109.4984,18.2334,1507
114583,72D984C8386A232B13E9D168E7A1C5F8,30671,12,14,2,109.43611,18.30139,1268
114584,72D984C8386A232B13E9D168E7A1C5F8,60551,17,19,2,109.42722,18.30111,1218
114585,937F0B31443CC6355891AA9D2DB0C670,30854,20,22,2,109.56889,18.27076,1763
114586,937F0B31443CC6355891AA9D2DB0C670,31561,22,23,1,109.56792,18.28479,1765
114616,00FD2268DE6E83934D2916174E81532F,60472,2,4,2,109.46625,18.29542,1367
114617,00FD2268DE6E83934D2916174E81532F,30111,6,9,3,109.47583,18.30542,1419
114618,00FD2268DE6E83934D2916174E81532F,30761,9,12,3,109.45201,18.3,1318
114619,00FD2268DE6E83934D2916174E81532F,30111,15,23,8,109.47583,18.30542,1419
114639,996C0D9500BF90CC0E7F5A04C49A464B,31931,14,17,3,109.54771,18.29403,1667
114640,996C0D9500BF90CC0E7F5A04C49A464B,30921,19,22,3,109.53903,18.29451,1667
114645,B340EDEF4A878E8DF5CBEC25E465EACE,30854,2,4,2,109.56889,18.27076,1763
114646,B340EDEF4A878E8DF5CBEC25E465EACE,31071,5,6,1,109.58257,18.28458,1815
114647,B340EDEF4A878E8DF5CBEC25E465EACE,30854,11,16,5,109.56889,18.27076,1763
114668,F198CAA1F49ACA5D003FD8F8473B3798,30854,0,1,1,109.56889,18.27076,1763
114669,F198CAA1F49ACA5D003FD8F8473B3798,31071,1,7,6,109.58257,18.28458,1815
114670,F198CAA1F49ACA5D003FD8F8473B3798,30854,7,23,16,109.56889,18.27076,1763
114705,C860767955774E3494068CF38C009FB6,60391,0,8,8,109.47667,18.28757,1416
114706,C860767955774E3494068CF38C009FB6,30191,12,13,1,109.50361,18.22701,1506
114707,C860767955774E3494068CF38C009FB6,31061,14,15,1,109.53333,18.23257,1607
114728,B2447A087C8F374ABEBA0025E60F3E7C,31521,0,7,7,109.51458,18.22542,1555
114729,B2447A087C8F374ABEBA0025E60F3E7C,30731,9,11,2,109.50944,18.22306,1555
114730,B2447A087C8F374ABEBA0025E60F3E7C,38111,11,13,2,109.52007,18.22403,1555
114731,B2447A087C8F374ABEBA0025E60F3E7C,30201,13,15,2,109.4909,18.26465,1462
114732,B2447A087C8F374ABEBA0025E60F3E7C,60381,17,18,1,109.5241,18.22458,1605
114733,B2447A087C8F374ABEBA0025E60F3E7C,31521,19,23,4,109.51458,18.22542,1555
114736,DAB08D254D49BF150533311BD904D49C,39321,0,12,12,109.529,18.2167,1604
114737,DAB08D254D49BF150533311BD904D49C,38881,13,15,2,109.51618,18.26431,1562
114756,8C5A16299A6D294198C90C34C25C5949,39183,0,2,2,109.55542,18.28208,1715
114757,8C5A16299A6D294198C90C34C25C5949,31561,3,4,1,109.56792,18.28479,1765
114758,8C5A16299A6D294198C90C34C25C5949,30854,4,5,1,109.56889,18.27076,1763
114771,096D8D59612F82CD076740A6D0A18387,38971,0,9,9,109.50743,18.25125,1510
114772,096D8D59612F82CD076740A6D0A18387,30151,10,13,3,109.50986,18.25083,1560
114773,096D8D59612F82CD076740A6D0A18387,38971,13,17,4,109.50743,18.25125,1510
114774,096D8D59612F82CD076740A6D0A18387,30421,17,18,1,109.50021,18.25861,1511
114777,8BB035B44D009B4E567D4EFF10F50E4D,30854,0,3,3,109.56889,18.27076,1763
114778,8BB035B44D009B4E567D4EFF10F50E4D,30851,3,4,1,109.5616,18.27396,1713
114779,8BB035B44D009B4E567D4EFF10F50E4D,30854,5,23,18,109.56889,18.27076,1763
114826,AE9453D604AF88F4293DEF99463B2345,30421,17,20,3,109.50021,18.25861,1511
114831,51015BF65833D98716A0309741D1F1C2,38871,3,4,1,109.44681,18.28625,1316
114832,51015BF65833D98716A0309741D1F1C2,39151,5,8,3,109.49875,18.25097,1510
114833,51015BF65833D98716A0309741D1F1C2,30854,13,15,2,109.56889,18.27076,1763
114834,51015BF65833D98716A0309741D1F1C2,60381,19,21,2,109.5241,18.22458,1605
114860,0E0D6E55BB1995EBF85F6B7AA8765E55,60631,0,1,1,109.57778,18.27583,1814
114861,0E0D6E55BB1995EBF85F6B7AA8765E55,30854,4,10,6,109.56889,18.27076,1763
114862,0E0D6E55BB1995EBF85F6B7AA8765E55,30151,11,14,3,109.50986,18.25083,1560
114873,C711EA8F4B039EAC279F7CFC24309A8A,38991,1,9,8,109.52681,18.30368,1618
114874,C711EA8F4B039EAC279F7CFC24309A8A,38484,11,15,4,109.53028,18.31528,1620
114875,C711EA8F4B039EAC279F7CFC24309A8A,30281,19,22,3,109.50597,18.27583,1514
114879,2D39AE6120F2674000C6DBB8A6E572A0,31945,0,7,7,109.58021,18.29403,1817
114880,2D39AE6120F2674000C6DBB8A6E572A0,30854,8,9,1,109.56889,18.27076,1763
114881,2D39AE6120F2674000C6DBB8A6E572A0,31945,12,13,1,109.58021,18.29403,1817
114882,2D39AE6120F2674000C6DBB8A6E572A0,30854,18,21,3,109.56889,18.27076,1763
114909,C1F9914EF577AE2A8300B1A3945A50FF,31561,2,3,1,109.56792,18.28479,1765
114910,C1F9914EF577AE2A8300B1A3945A50FF,30851,3,6,3,109.5616,18.27396,1713
114911,C1F9914EF577AE2A8300B1A3945A50FF,31561,7,9,2,109.56792,18.28479,1765
114912,C1F9914EF577AE2A8300B1A3945A50FF,31101,13,14,1,109.65389,18.23403,2057
114952,B825FA0510D0C7066F611121CA360EF4,31071,12,18,6,109.58257,18.28458,1815
114953,B825FA0510D0C7066F611121CA360EF4,60291,21,22,1,109.50826,18.24639,1509
114974,9FEA4B85EAE4FAEE1CAF0EABFF2FAEA1,31561,0,6,6,109.56792,18.28479,1765
114975,9FEA4B85EAE4FAEE1CAF0EABFF2FAEA1,39183,8,11,3,109.55542,18.28208,1715
114976,9FEA4B85EAE4FAEE1CAF0EABFF2FAEA1,31561,12,13,1,109.56792,18.28479,1765
114977,9FEA4B85EAE4FAEE1CAF0EABFF2FAEA1,39183,14,16,2,109.55542,18.28208,1715
114978,9FEA4B85EAE4FAEE1CAF0EABFF2FAEA1,31561,17,19,2,109.56792,18.28479,1765
115045,BE8220A49F1231C0A022F4AA2075503E,31945,0,7,7,109.58021,18.29403,1817
115046,BE8220A49F1231C0A022F4AA2075503E,30854,8,11,3,109.56889,18.27076,1763
115047,BE8220A49F1231C0A022F4AA2075503E,31945,13,14,1,109.58021,18.29403,1817
115048,BE8220A49F1231C0A022F4AA2075503E,60463,19,20,1,109.52507,18.22438,1605
115049,BE8220A49F1231C0A022F4AA2075503E,31945,21,23,2,109.58021,18.29403,1817
115050,94C4D5691F7DFC1AB38806AFFAC1389E,31931,5,8,3,109.54771,18.29403,1667
115051,94C4D5691F7DFC1AB38806AFFAC1389E,39101,11,12,1,109.50132,18.24931,1509
115052,94C4D5691F7DFC1AB38806AFFAC1389E,31931,12,13,1,109.54771,18.29403,1667
115055,C3EF49B0098C6C3C4B26CC8869DE86AF,30854,0,7,7,109.56889,18.27076,1763
115056,C3EF49B0098C6C3C4B26CC8869DE86AF,38271,9,14,5,109.62632,18.23049,1956
115057,C3EF49B0098C6C3C4B26CC8869DE86AF,31031,15,16,1,109.49979,18.25382,1510
115058,C3EF49B0098C6C3C4B26CC8869DE86AF,30854,20,23,3,109.56889,18.27076,1763
115071,A1DF55C42D8446F7B3BDC698ADD3A56E,31071,4,7,3,109.58257,18.28458,1815
115072,A1DF55C42D8446F7B3BDC698ADD3A56E,30854,10,11,1,109.56889,18.27076,1763
115073,A1DF55C42D8446F7B3BDC698ADD3A56E,31164,12,14,2,109.69993,18.27215,2263
115074,A1DF55C42D8446F7B3BDC698ADD3A56E,38071,19,20,1,109.40722,18.30938,1169
115083,D73FCA3456BB16A6D4FCD107B208A3A9,30661,20,21,1,109.37028,18.24361,1008
115084,D73FCA3456BB16A6D4FCD107B208A3A9,30721,21,23,2,109.51597,18.28257,1565
115141,C8344836EA156DB60E8D025C0A473C2E,31521,0,1,1,109.51458,18.22542,1555
115142,C8344836EA156DB60E8D025C0A473C2E,30181,2,10,8,109.51597,18.23313,1557
115143,C8344836EA156DB60E8D025C0A473C2E,31145,11,14,3,109.20431,18.30479,369
115144,C8344836EA156DB60E8D025C0A473C2E,30181,15,23,8,109.51597,18.23313,1557
115162,C98DECAAC7B1CEF53BA610BF4A518961,60331,0,1,1,109.505,18.26507,1512
115163,C98DECAAC7B1CEF53BA610BF4A518961,39321,1,9,8,109.529,18.2167,1604
115164,C98DECAAC7B1CEF53BA610BF4A518961,30731,9,10,1,109.50944,18.22306,1555
115165,C98DECAAC7B1CEF53BA610BF4A518961,30161,12,13,1,109.50042,18.24389,1508
115175,C6E39197478B854A74FABF400B391655,31205,0,1,1,109.51111,18.23736,1557
115176,C6E39197478B854A74FABF400B391655,60291,2,13,11,109.50826,18.24639,1509
115177,C6E39197478B854A74FABF400B391655,39104,13,14,1,109.50104,18.2525,1510
115182,87FF4B28ACF2D28B36F6296AA66D2D6F,38707,0,4,4,109.73778,18.35368,2427
115183,87FF4B28ACF2D28B36F6296AA66D2D6F,38541,4,9,5,109.73715,18.34875,2426
115198,8554F0A178316702A9146AC053A2336A,38251,1,2,1,109.49618,18.25493,1510
115199,8554F0A178316702A9146AC053A2336A,31231,2,7,5,109.42597,18.29292,1217
115200,8554F0A178316702A9146AC053A2336A,60161,7,9,2,109.49174,18.26181,1461
115201,8554F0A178316702A9146AC053A2336A,30711,15,16,1,109.50271,18.25347,1510
115202,8554F0A178316702A9146AC053A2336A,31534,17,19,2,109.49368,18.25806,1461
115203,8554F0A178316702A9146AC053A2336A,30421,20,23,3,109.50021,18.25861,1511
115205,702E913D8A0DA920C3A5175221B874F5,60661,16,17,1,109.548,18.2377,1657
115206,702E913D8A0DA920C3A5175221B874F5,38017,19,21,2,109.49729,18.21424,1504
115207,702E913D8A0DA920C3A5175221B874F5,60661,21,23,2,109.548,18.2377,1657
115232,0A80AC29DC2E111565D686AEC8FAB306,31031,2,11,9,109.49979,18.25382,1510
115233,0A80AC29DC2E111565D686AEC8FAB306,30711,13,15,2,109.50271,18.25347,1510
115234,0A80AC29DC2E111565D686AEC8FAB306,39321,19,20,1,109.529,18.2167,1604
115235,0A80AC29DC2E111565D686AEC8FAB306,60381,20,22,2,109.5241,18.22458,1605
115252,B40C23F05DF669D1A7928A9352D650F2,31205,0,1,1,109.51111,18.23736,1557
115253,B40C23F05DF669D1A7928A9352D650F2,30161,1,15,14,109.50042,18.24389,1508
115254,B40C23F05DF669D1A7928A9352D650F2,30511,15,17,2,109.51069,18.24208,1558
115255,B40C23F05DF669D1A7928A9352D650F2,30161,18,20,2,109.50042,18.24389,1508
115270,41BFDF202AA15C7D0EC7487840A4D094,30854,8,22,14,109.56889,18.27076,1763
115271,41BFDF202AA15C7D0EC7487840A4D094,60631,22,23,1,109.57778,18.27583,1814
115287,30B65052F35DDEF849EA88BF5D44AAAC,60361,6,8,2,109.51938,18.29681,1567
115288,30B65052F35DDEF849EA88BF5D44AAAC,31951,11,13,2,109.52174,18.30299,1568
115289,30B65052F35DDEF849EA88BF5D44AAAC,60171,13,16,3,109.51292,18.30694,1569
115341,099FE0090B4EE7DA6124F36A27A26FB9,60117,12,17,5,109.73604,18.35681,2427
115347,C7D3CA692B6956D76CF35EE9AAABE2A2,60614,0,5,5,109.48799,18.29521,1467
115348,C7D3CA692B6956D76CF35EE9AAABE2A2,38951,6,8,2,109.48097,18.28868,1416
115349,C7D3CA692B6956D76CF35EE9AAABE2A2,30101,10,11,1,109.57299,18.33333,1773
115350,C7D3CA692B6956D76CF35EE9AAABE2A2,30941,14,16,2,109.5559,18.33938,1724
115359,0D3DA8126B134D203BB35373EAFFB116,31071,0,13,13,109.58257,18.28458,1815
115360,0D3DA8126B134D203BB35373EAFFB116,30854,14,17,3,109.56889,18.27076,1763
115361,0D3DA8126B134D203BB35373EAFFB116,31071,17,22,5,109.58257,18.28458,1815
115378,D7B2DAA840D69B7CEAE96D3574ED744F,60401,18,20,2,109.47444,18.27583,1414
115379,D7B2DAA840D69B7CEAE96D3574ED744F,31361,20,23,3,109.47417,18.28292,1415
115416,97D875EE9D54268657EF259BD5962949,30854,14,15,1,109.56889,18.27076,1763
115417,97D875EE9D54268657EF259BD5962949,31071,15,17,2,109.58257,18.28458,1815
115454,4FBB8B54B037ADDE5478A2AF9D4004A8,31221,1,17,16,109.61333,18.26833,1913
115455,4FBB8B54B037ADDE5478A2AF9D4004A8,30854,20,22,2,109.56889,18.27076,1763
115458,A9FCE0049DB44FE004EAFBF5B783F4A5,31945,2,7,5,109.58021,18.29403,1817
115459,A9FCE0049DB44FE004EAFBF5B783F4A5,30854,8,9,1,109.56889,18.27076,1763
115530,84DF4A7C208235D171EF56473BCCF210,30851,1,2,1,109.5616,18.27396,1713
115531,84DF4A7C208235D171EF56473BCCF210,31561,3,7,4,109.56792,18.28479,1765
115532,84DF4A7C208235D171EF56473BCCF210,60631,10,18,8,109.57778,18.27583,1814
115533,84DF4A7C208235D171EF56473BCCF210,30851,19,23,4,109.5616,18.27396,1713
115537,C0D9A8D1FC57A96EA766A127A0E8EAAC,30854,0,6,6,109.56889,18.27076,1763
115538,C0D9A8D1FC57A96EA766A127A0E8EAAC,60591,10,13,3,109.61118,18.21715,1904
115539,C0D9A8D1FC57A96EA766A127A0E8EAAC,31101,17,18,1,109.65389,18.23403,2057
115540,C0D9A8D1FC57A96EA766A127A0E8EAAC,60631,22,23,1,109.57778,18.27583,1814
115558,0B3E12180DEB0629FE3A7717272ACE4A,31221,5,6,1,109.61333,18.26833,1913
115559,0B3E12180DEB0629FE3A7717272ACE4A,30581,8,11,3,109.62257,18.24951,1959
115560,0B3E12180DEB0629FE3A7717272ACE4A,31221,13,15,2,109.61333,18.26833,1913
115561,0B3E12180DEB0629FE3A7717272ACE4A,30854,18,22,4,109.56889,18.27076,1763
115562,43018FB39803E31509A90CB37A66655B,31071,1,5,4,109.58257,18.28458,1815
115563,43018FB39803E31509A90CB37A66655B,31945,6,7,1,109.58021,18.29403,1817
115564,43018FB39803E31509A90CB37A66655B,38754,12,14,2,109.74667,18.37382,2430
115565,43018FB39803E31509A90CB37A66655B,31321,17,19,2,109.63799,18.23201,2007
115597,9905C3E423D151CCE1280F3A1732CE90,30854,0,6,6,109.56889,18.27076,1763
115598,9905C3E423D151CCE1280F3A1732CE90,31071,6,17,11,109.58257,18.28458,1815
115599,9905C3E423D151CCE1280F3A1732CE90,30854,18,23,5,109.56889,18.27076,1763
115600,8EB27D2E0095A9FF48E016863044B329,31945,0,8,8,109.58021,18.29403,1817
115601,8EB27D2E0095A9FF48E016863044B329,30854,10,17,7,109.56889,18.27076,1763
115602,8EB27D2E0095A9FF48E016863044B329,30371,21,22,1,109.51,18.24771,1559
115618,5F5F21B79C1AD0925177661E61E6C3C9,31231,0,6,6,109.42597,18.29292,1217
115619,5F5F21B79C1AD0925177661E61E6C3C9,30351,8,12,4,109.41701,18.29292,1217
115642,833001CDF394BB3F6E4F040C2A70AC27,30854,3,11,8,109.56889,18.27076,1763
115643,833001CDF394BB3F6E4F040C2A70AC27,31071,13,14,1,109.58257,18.28458,1815
115644,833001CDF394BB3F6E4F040C2A70AC27,30854,15,23,8,109.56889,18.27076,1763
115652,40D62DAB923B148A7A4FFB3BCA6C7343,60501,0,8,8,109.48701,18.29021,1466
115653,40D62DAB923B148A7A4FFB3BCA6C7343,38951,9,20,11,109.48097,18.28868,1416
115654,F6B0C4B9BFBC5C0F5D704098C64B8B01,30711,13,15,2,109.50271,18.25347,1510
115655,F6B0C4B9BFBC5C0F5D704098C64B8B01,31864,16,20,4,109.49014,18.28333,1465
115667,9A00C7B4C2F6CD44CC775BCA8584229C,38754,13,14,1,109.74667,18.37382,2430
115668,9A00C7B4C2F6CD44CC775BCA8584229C,60401,19,20,1,109.47444,18.27583,1414
115669,70D1132966731D0A7E75BEB7E2796B8B,31521,0,7,7,109.51458,18.22542,1555
115678,561522A1ED5FFA63DCA382D0CB310A1A,30171,0,8,8,109.48458,18.27139,1463
115679,561522A1ED5FFA63DCA382D0CB310A1A,30941,9,10,1,109.5559,18.33938,1724
115680,561522A1ED5FFA63DCA382D0CB310A1A,38271,14,15,1,109.62632,18.23049,1956
115681,561522A1ED5FFA63DCA382D0CB310A1A,60221,19,20,1,109.52569,18.29188,1616
115682,63B50A7073912A66CD527ABAF79EDA78,30351,0,7,7,109.41701,18.29292,1217
115683,63B50A7073912A66CD527ABAF79EDA78,31231,8,13,5,109.42597,18.29292,1217
115684,63B50A7073912A66CD527ABAF79EDA78,60291,13,14,1,109.50826,18.24639,1509
115685,63B50A7073912A66CD527ABAF79EDA78,60401,18,19,1,109.47444,18.27583,1414
115691,15CA17640E986E8C98B5D094DF385F19,31931,18,19,1,109.54771,18.29403,1667
115692,F00821368F615DCDAF214035D8EC4A44,60631,2,3,1,109.57778,18.27583,1814
115693,F00821368F615DCDAF214035D8EC4A44,31071,5,6,1,109.58257,18.28458,1815
115694,F00821368F615DCDAF214035D8EC4A44,30854,7,9,2,109.56889,18.27076,1763
115695,F00821368F615DCDAF214035D8EC4A44,31931,9,10,1,109.54771,18.29403,1667
115696,F00821368F615DCDAF214035D8EC4A44,30854,11,15,4,109.56889,18.27076,1763
115705,8D7B9451E0189947198D6AC9CE51CFEE,30764,0,1,1,109.45806,18.29486,1367
115706,8D7B9451E0189947198D6AC9CE51CFEE,60391,2,4,2,109.47667,18.28757,1416
115707,8D7B9451E0189947198D6AC9CE51CFEE,31091,4,18,14,109.41201,18.31222,1170
115708,8D7B9451E0189947198D6AC9CE51CFEE,30764,19,21,2,109.45806,18.29486,1367
115709,8D7B9451E0189947198D6AC9CE51CFEE,30111,21,23,2,109.47583,18.30542,1419
115712,C2CC718D695CB45C49C10B739F52F650,31031,0,9,9,109.49979,18.25382,1510
115713,C2CC718D695CB45C49C10B739F52F650,31031,10,13,3,109.49979,18.25382,1510
115714,C2CC718D695CB45C49C10B739F52F650,60084,14,16,2,109.4984,18.2334,1507
115724,96F98526707B06BE1263CCD4F72E07A1,30854,1,2,1,109.56889,18.27076,1763
115725,96F98526707B06BE1263CCD4F72E07A1,31071,4,5,1,109.58257,18.28458,1815
115726,96F98526707B06BE1263CCD4F72E07A1,30854,5,7,2,109.56889,18.27076,1763
115727,96F98526707B06BE1263CCD4F72E07A1,31071,11,12,1,109.58257,18.28458,1815
115728,96F98526707B06BE1263CCD4F72E07A1,30854,15,21,6,109.56889,18.27076,1763
115729,4521A8D92A7219267FD46990BC1A5213,30232,0,4,4,109.6191,18.31701,1971
115730,4521A8D92A7219267FD46990BC1A5213,31561,5,6,1,109.56792,18.28479,1765
115731,4521A8D92A7219267FD46990BC1A5213,30232,7,23,16,109.6191,18.31701,1971
115735,335A7B1DE8538918FDA774EE3E402A76,30191,0,7,7,109.50361,18.22701,1506
115736,335A7B1DE8538918FDA774EE3E402A76,31521,7,13,6,109.51458,18.22542,1555
115737,335A7B1DE8538918FDA774EE3E402A76,30191,17,23,6,109.50361,18.22701,1506
115744,E082FB5BD091C5B334EC1176FF352EE0,60371,14,15,1,109.53063,18.30056,1618
115745,E082FB5BD091C5B334EC1176FF352EE0,31931,16,19,3,109.54771,18.29403,1667
115746,E082FB5BD091C5B334EC1176FF352EE0,60371,21,22,1,109.53063,18.30056,1618
115794,316EB27B7555943C1D6557CD7E5A08F6,60381,19,20,1,109.5241,18.22458,1605
115799,B6B23D46E3670BB19F6DC30ED4B33D5E,31864,8,9,1,109.49014,18.28333,1465
115800,B6B23D46E3670BB19F6DC30ED4B33D5E,31431,9,10,1,109.44639,18.29042,1316
115801,B6B23D46E3670BB19F6DC30ED4B33D5E,39061,12,13,1,109.38222,18.28958,1066
115802,B6B23D46E3670BB19F6DC30ED4B33D5E,30341,14,16,2,109.3625,18.29167,966
115803,B6B23D46E3670BB19F6DC30ED4B33D5E,31431,17,18,1,109.44639,18.29042,1316
115804,B6B23D46E3670BB19F6DC30ED4B33D5E,31031,18,20,2,109.49979,18.25382,1510
115815,3E59E08BDB351E3995CE0492C62E7C87,60281,19,23,4,109.51743,18.25924,1561
115816,F84D949DDCBF25D5530F771BC55E0B9D,61011,0,5,5,109.60653,18.19076,1900
115818,F84D949DDCBF25D5530F771BC55E0B9D,31321,9,10,1,109.63799,18.23201,2007
115820,A14C813C3E3A7182759DA822342505B5,30851,14,15,1,109.5616,18.27396,1713
115821,A14C813C3E3A7182759DA822342505B5,39183,18,23,5,109.55542,18.28208,1715
115873,6F590AF2C10C4B9F0F4E76B8E922550E,30854,9,11,2,109.56889,18.27076,1763
115874,6F590AF2C10C4B9F0F4E76B8E922550E,31945,15,22,7,109.58021,18.29403,1817
115894,07169E7114E4F14C073261BAAC0D4491,61011,6,13,7,109.60653,18.19076,1900
115919,9C1407835BC54BEBDB541F52E1DA1820,61011,2,5,3,109.60653,18.19076,1900
115921,9C1407835BC54BEBDB541F52E1DA1820,61011,7,9,2,109.60653,18.19076,1900
116004,2A699167E9D3E245FFAC98B0B1AFC37B,30854,0,6,6,109.56889,18.27076,1763
116005,2A699167E9D3E245FFAC98B0B1AFC37B,31071,7,8,1,109.58257,18.28458,1815
116006,2A699167E9D3E245FFAC98B0B1AFC37B,30854,9,15,6,109.56889,18.27076,1763
116012,10BB72F4E7990A3695C663829F0D188E,30081,1,8,7,109.50243,18.26632,1512
116013,10BB72F4E7990A3695C663829F0D188E,39183,10,12,2,109.55542,18.28208,1715
116014,10BB72F4E7990A3695C663829F0D188E,30081,12,14,2,109.50243,18.26632,1512
116020,1F5A515C5AC85D4C79D71950DF5477FB,30571,1,7,6,109.50243,18.21861,1504
116021,1F5A515C5AC85D4C79D71950DF5477FB,38347,8,10,2,109.4934,18.21444,1454
116022,1F5A515C5AC85D4C79D71950DF5477FB,30571,11,14,3,109.50243,18.21861,1504
116023,1F5A515C5AC85D4C79D71950DF5477FB,38347,14,16,2,109.4934,18.21444,1454
116024,1F5A515C5AC85D4C79D71950DF5477FB,60381,17,20,3,109.5241,18.22458,1605
116025,1F5A515C5AC85D4C79D71950DF5477FB,30571,20,22,2,109.50243,18.21861,1504
116063,DBB710D279E76C79F1E4B0766F579F8A,31071,0,14,14,109.58257,18.28458,1815
116064,DBB710D279E76C79F1E4B0766F579F8A,30854,14,15,1,109.56889,18.27076,1763
116071,B7F915A1F0C284599515D9E8632C5B0A,30771,19,20,1,109.49938,18.26042,1511
116072,B7F915A1F0C284599515D9E8632C5B0A,38941,21,23,2,109.49625,18.25451,1510
116107,DC29C676832347947F366933ECB88090,31561,0,15,15,109.56792,18.28479,1765
116108,DC29C676832347947F366933ECB88090,39183,15,18,3,109.55542,18.28208,1715
116109,DC29C676832347947F366933ECB88090,31561,20,23,3,109.56792,18.28479,1765
116112,73EAC1341C5005A58B26B1A52457F38B,30361,0,2,2,109.50347,18.24,1508
116113,73EAC1341C5005A58B26B1A52457F38B,30161,2,19,17,109.50042,18.24389,1508
116137,99CBAA6A65A50998F0A10B72B36210E4,60161,19,21,2,109.49174,18.26181,1461
116138,99CBAA6A65A50998F0A10B72B36210E4,38251,21,22,1,109.49618,18.25493,1510
116199,37D38EF0062E64D55C94EB554B76F9EE,31945,1,8,7,109.58021,18.29403,1817
116200,37D38EF0062E64D55C94EB554B76F9EE,30854,11,23,12,109.56889,18.27076,1763
116205,3C5AEA306E8A69C707195C4150E77D90,60361,15,17,2,109.51938,18.29681,1567
116206,3C5AEA306E8A69C707195C4150E77D90,31931,19,21,2,109.54771,18.29403,1667
116227,EF24901D99384F703B20FE07F2784FA0,30101,0,1,1,109.57299,18.33333,1773
116228,EF24901D99384F703B20FE07F2784FA0,31631,1,10,9,109.59542,18.36826,1879
116229,EF24901D99384F703B20FE07F2784FA0,30101,12,23,11,109.57299,18.33333,1773
116245,7784022BDEFABB0258B32ABBB5E13027,30251,0,4,4,109.50611,18.26653,1512
116246,7784022BDEFABB0258B32ABBB5E13027,31491,9,10,1,109.73042,18.38771,2382
116247,7784022BDEFABB0258B32ABBB5E13027,31161,11,13,2,109.70229,18.31361,2270
116248,7784022BDEFABB0258B32ABBB5E13027,38185,17,22,5,109.51333,18.27347,1563
116253,DE44A87559E9DEE84B37BE840DB2C4AC,60054,0,3,3,109.3016,18.31229,770
116254,DE44A87559E9DEE84B37BE840DB2C4AC,30661,5,7,2,109.37028,18.24361,1008
116255,DE44A87559E9DEE84B37BE840DB2C4AC,60411,7,8,1,109.32514,18.30854,869
116256,DE44A87559E9DEE84B37BE840DB2C4AC,60054,12,14,2,109.3016,18.31229,770
116257,DE44A87559E9DEE84B37BE840DB2C4AC,31471,14,16,2,109.34583,18.29563,917
116258,DE44A87559E9DEE84B37BE840DB2C4AC,60054,19,23,4,109.3016,18.31229,770
116281,05A57DE8DC0D94268B97E02566D1A0C9,30851,0,1,1,109.5616,18.27396,1713
116282,05A57DE8DC0D94268B97E02566D1A0C9,60631,1,2,1,109.57778,18.27583,1814
116283,05A57DE8DC0D94268B97E02566D1A0C9,30851,2,4,2,109.5616,18.27396,1713
116284,05A57DE8DC0D94268B97E02566D1A0C9,31071,5,9,4,109.58257,18.28458,1815
116285,05A57DE8DC0D94268B97E02566D1A0C9,60351,11,14,3,109.58403,18.28958,1816
116286,05A57DE8DC0D94268B97E02566D1A0C9,60463,15,17,2,109.52507,18.22438,1605
116287,05A57DE8DC0D94268B97E02566D1A0C9,30421,18,19,1,109.50021,18.25861,1511
116288,05A57DE8DC0D94268B97E02566D1A0C9,60381,20,21,1,109.5241,18.22458,1605
116289,05A57DE8DC0D94268B97E02566D1A0C9,60631,21,23,2,109.57778,18.27583,1814
116298,020753EF78F0A0C39658113A3377EA1E,30851,0,1,1,109.5616,18.27396,1713
116299,020753EF78F0A0C39658113A3377EA1E,31561,2,12,10,109.56792,18.28479,1765
116300,020753EF78F0A0C39658113A3377EA1E,39183,15,16,1,109.55542,18.28208,1715
116327,76F6A54588C8DF7DDADFC50CAA11D44C,30854,6,9,3,109.56889,18.27076,1763
116328,76F6A54588C8DF7DDADFC50CAA11D44C,39183,12,14,2,109.55542,18.28208,1715
116360,46FB195BB21573CE6CD85D42D7B06C1A,31945,2,7,5,109.58021,18.29403,1817
116361,46FB195BB21573CE6CD85D42D7B06C1A,30854,8,10,2,109.56889,18.27076,1763
116362,46FB195BB21573CE6CD85D42D7B06C1A,60381,12,13,1,109.5241,18.22458,1605
116363,46FB195BB21573CE6CD85D42D7B06C1A,30361,18,20,2,109.50347,18.24,1508
116383,55FA3BE97AB69587B64175CB8C2296AB,60031,16,19,3,109.49694,18.31632,1521
116384,55FA3BE97AB69587B64175CB8C2296AB,60171,19,20,1,109.51292,18.30694,1569
116411,012ABD06F231728C214A4BA917E75B1C,31561,0,21,21,109.56792,18.28479,1765
116412,012ABD06F231728C214A4BA917E75B1C,30851,21,22,1,109.5616,18.27396,1713
116413,51061B3DE820AF1C1C713EF684728003,31071,1,7,6,109.58257,18.28458,1815
116414,51061B3DE820AF1C1C713EF684728003,30854,7,22,15,109.56889,18.27076,1763
116417,213AF2099653A4ADAEF799CCC144B279,30021,0,18,18,109.12014,18.40986,86
116435,F3652FF504BC297E68234A33C1877043,30854,1,2,1,109.56889,18.27076,1763
116436,F3652FF504BC297E68234A33C1877043,31945,4,7,3,109.58021,18.29403,1817
116437,F3652FF504BC297E68234A33C1877043,31561,8,9,1,109.56792,18.28479,1765
116438,F3652FF504BC297E68234A33C1877043,31945,12,14,2,109.58021,18.29403,1817
116439,F3652FF504BC297E68234A33C1877043,30854,14,16,2,109.56889,18.27076,1763
116449,1980C8D409DE9551539224B3D393CDAA,30071,0,4,4,109.52819,18.30472,1619
116450,1980C8D409DE9551539224B3D393CDAA,31951,7,8,1,109.52174,18.30299,1568
116451,1980C8D409DE9551539224B3D393CDAA,30071,8,13,5,109.52819,18.30472,1619
116452,1980C8D409DE9551539224B3D393CDAA,31951,14,17,3,109.52174,18.30299,1568
116473,A0CFD24F8D50ABCF6002C5FC96CEAB76,39181,0,6,6,109.55153,18.28035,1715
116474,A0CFD24F8D50ABCF6002C5FC96CEAB76,39183,9,23,14,109.55542,18.28208,1715
116520,ED29249A053BF56728ABCAD759306411,31571,15,16,1,109.61563,18.23326,1957
116521,ED29249A053BF56728ABCAD759306411,31554,18,21,3,109.55521,18.2459,1709
116522,ED29249A053BF56728ABCAD759306411,60661,22,23,1,109.548,18.2377,1657
116527,1B645349DC6CB7B3B9225190248F2C33,31431,0,8,8,109.44639,18.29042,1316
116528,1B645349DC6CB7B3B9225190248F2C33,31471,11,12,1,109.34583,18.29563,917
116529,1B645349DC6CB7B3B9225190248F2C33,31431,12,16,4,109.44639,18.29042,1316
116530,1B645349DC6CB7B3B9225190248F2C33,30711,18,20,2,109.50271,18.25347,1510
116531,1B645349DC6CB7B3B9225190248F2C33,38871,21,22,1,109.44681,18.28625,1316
116552,FA0EB766C44C307B69FC2247C53C674E,31031,0,7,7,109.49979,18.25382,1510
116553,FA0EB766C44C307B69FC2247C53C674E,60321,8,11,3,109.63611,18.24306,2008
116554,FA0EB766C44C307B69FC2247C53C674E,30291,13,14,1,109.50403,18.27028,1513
116555,FA0EB766C44C307B69FC2247C53C674E,31031,17,20,3,109.49979,18.25382,1510
116590,43E035AE85036EBD9891453E9567CB81,30151,0,10,10,109.50986,18.25083,1560
116591,43E035AE85036EBD9891453E9567CB81,30151,13,15,2,109.50986,18.25083,1560
116592,43E035AE85036EBD9891453E9567CB81,30151,18,23,5,109.50986,18.25083,1560
116593,9AC1B73A6A57A1A8B7B76A628C70874E,31071,1,14,13,109.58257,18.28458,1815
116594,9AC1B73A6A57A1A8B7B76A628C70874E,30854,18,19,1,109.56889,18.27076,1763
116595,9AC1B73A6A57A1A8B7B76A628C70874E,31071,20,22,2,109.58257,18.28458,1815
116615,9915B6FF17BD3BF50FFC7042D095278F,31851,10,17,7,109.71736,18.29007,2316
116616,9915B6FF17BD3BF50FFC7042D095278F,30854,20,22,2,109.56889,18.27076,1763
116652,8752BC71725B50257436D50C6598F252,31761,0,2,2,109.60521,18.27965,1914
116653,8752BC71725B50257436D50C6598F252,31071,4,6,2,109.58257,18.28458,1815
116654,8752BC71725B50257436D50C6598F252,30581,10,11,1,109.62257,18.24951,1959
116655,8752BC71725B50257436D50C6598F252,31071,12,14,2,109.58257,18.28458,1815
116667,0C200F5A8783CCD7D36445E86B433691,31351,3,7,4,109.4959,18.28417,1465
116697,9D52111AAF3CBA9B2742D7EEE49670D6,60381,0,8,8,109.5241,18.22458,1605
116698,9D52111AAF3CBA9B2742D7EEE49670D6,60552,9,10,1,109.41729,18.30014,1218
116700,9D52111AAF3CBA9B2742D7EEE49670D6,60071,16,18,2,109.75674,18.31583,2470
116701,9D52111AAF3CBA9B2742D7EEE49670D6,60381,20,22,2,109.5241,18.22458,1605
116702,6A6113C1376DC676D51836D1E415DD5E,38271,0,7,7,109.62632,18.23049,1956
116703,6A6113C1376DC676D51836D1E415DD5E,60321,8,9,1,109.63611,18.24306,2008
116704,6A6113C1376DC676D51836D1E415DD5E,38271,10,12,2,109.62632,18.23049,1956
116705,6A6113C1376DC676D51836D1E415DD5E,31521,17,20,3,109.51458,18.22542,1555
116706,08077B5D5F0A9938A81D328635D03C8B,30854,8,13,5,109.56889,18.27076,1763
116707,08077B5D5F0A9938A81D328635D03C8B,31071,14,16,2,109.58257,18.28458,1815
116708,12D8E06C2EC8C969710FB791DF137B2B,31071,0,8,8,109.58257,18.28458,1815
116709,12D8E06C2EC8C969710FB791DF137B2B,30854,8,10,2,109.56889,18.27076,1763
116710,12D8E06C2EC8C969710FB791DF137B2B,31071,12,14,2,109.58257,18.28458,1815
116711,12D8E06C2EC8C969710FB791DF137B2B,30854,17,19,2,109.56889,18.27076,1763
116712,12D8E06C2EC8C969710FB791DF137B2B,31071,19,21,2,109.58257,18.28458,1815
116724,C983E73D646629A775690ECA8920EB29,31631,6,7,1,109.59542,18.36826,1879
116725,C983E73D646629A775690ECA8920EB29,30101,7,11,4,109.57299,18.33333,1773
116726,C983E73D646629A775690ECA8920EB29,31631,12,21,9,109.59542,18.36826,1879
116729,6ABF30CD5F14455AA21662324DAC8186,60431,5,9,4,109.46139,18.32861,1373
116730,6ABF30CD5F14455AA21662324DAC8186,30421,10,11,1,109.50021,18.25861,1511
116731,65E24749B82F3001547ADE54BE753319,60371,0,8,8,109.53063,18.30056,1618
116769,9896B385073DFAEA729E29349544053D,31231,0,7,7,109.42597,18.29292,1217
116770,9896B385073DFAEA729E29349544053D,31081,8,9,1,109.44639,18.30181,1318
116771,9896B385073DFAEA729E29349544053D,33481,11,12,1,109.67278,18.41278,2187
116804,377A324496E54511961704972731A3D5,30961,13,14,1,109.74042,18.37903,2431
116805,377A324496E54511961704972731A3D5,39111,15,19,4,109.5191,18.22597,1555
116806,377A324496E54511961704972731A3D5,31261,20,23,3,109.51174,18.2466,1559
116820,01223FE8507EEE7E795307EF66CB7588,39091,18,20,2,109.50097,18.25222,1510
116821,01223FE8507EEE7E795307EF66CB7588,30151,21,23,2,109.50986,18.25083,1560
116834,6422CB87ACC55DDEF6EBE8946593C808,31351,0,6,6,109.4959,18.28417,1465
116835,6422CB87ACC55DDEF6EBE8946593C808,31851,7,10,3,109.71736,18.29007,2316
116836,6422CB87ACC55DDEF6EBE8946593C808,30571,12,18,6,109.50243,18.21861,1504
116837,6422CB87ACC55DDEF6EBE8946593C808,31351,20,23,3,109.4959,18.28417,1465
116847,1412BA3B65BC1A2354CCBE297098A0E1,31071,4,8,4,109.58257,18.28458,1815
116848,1412BA3B65BC1A2354CCBE297098A0E1,30854,10,12,2,109.56889,18.27076,1763
116849,1412BA3B65BC1A2354CCBE297098A0E1,31071,12,14,2,109.58257,18.28458,1815
116850,1412BA3B65BC1A2354CCBE297098A0E1,30854,15,21,6,109.56889,18.27076,1763
116895,53453D8B736810206EC5A6632D159BE6,31931,0,16,16,109.54771,18.29403,1667
116896,53453D8B736810206EC5A6632D159BE6,60371,16,20,4,109.53063,18.30056,1618
116897,53453D8B736810206EC5A6632D159BE6,31931,20,23,3,109.54771,18.29403,1667
116898,117CDF2D41FFFF099F62724091D8605A,30854,8,16,8,109.56889,18.27076,1763
116899,117CDF2D41FFFF099F62724091D8605A,30851,19,20,1,109.5616,18.27396,1713
116900,5B52C71F88DF5C7017D89C4E504F495B,30351,0,1,1,109.41701,18.29292,1217
116901,5B52C71F88DF5C7017D89C4E504F495B,60551,2,5,3,109.42722,18.30111,1218
116902,5B52C71F88DF5C7017D89C4E504F495B,30351,8,11,3,109.41701,18.29292,1217
116903,5B52C71F88DF5C7017D89C4E504F495B,31236,12,14,2,109.42965,18.29111,1216
116904,5B52C71F88DF5C7017D89C4E504F495B,38071,16,17,1,109.40722,18.30938,1169
116911,9AA959ED87D1ECC3053DED17290EFCBD,31561,3,5,2,109.56792,18.28479,1765
116912,9AA959ED87D1ECC3053DED17290EFCBD,39183,7,10,3,109.55542,18.28208,1715
116913,9AA959ED87D1ECC3053DED17290EFCBD,31561,11,13,2,109.56792,18.28479,1765
116914,9AA959ED87D1ECC3053DED17290EFCBD,39183,13,16,3,109.55542,18.28208,1715
116933,2573068C2CC7CB293855DF48A4D4CF2F,38484,18,19,1,109.53028,18.31528,1620
116934,2573068C2CC7CB293855DF48A4D4CF2F,48621,19,21,2,109.52882,18.31743,1621
116935,2573068C2CC7CB293855DF48A4D4CF2F,31951,21,23,2,109.52174,18.30299,1568
116936,9EBFE19AEC38C3A6F47AE2D903294BAE,30854,0,7,7,109.56889,18.27076,1763
116937,9EBFE19AEC38C3A6F47AE2D903294BAE,31164,8,10,2,109.69993,18.27215,2263
116938,9EBFE19AEC38C3A6F47AE2D903294BAE,31761,12,13,1,109.60521,18.27965,1914
116939,9EBFE19AEC38C3A6F47AE2D903294BAE,31164,16,18,2,109.69993,18.27215,2263
116940,9EBFE19AEC38C3A6F47AE2D903294BAE,30854,19,20,1,109.56889,18.27076,1763
116950,C1F80FD61770F46AF18F3BEF2B67E7ED,31554,0,8,8,109.55521,18.2459,1709
116951,C1F80FD61770F46AF18F3BEF2B67E7ED,30511,12,13,1,109.51069,18.24208,1558
116952,C1F80FD61770F46AF18F3BEF2B67E7ED,31781,14,17,3,109.19847,18.2975,367
116953,C1F80FD61770F46AF18F3BEF2B67E7ED,31551,21,23,2,109.55868,18.24222,1708
116972,E475FCBFD73C578507E18D91DA2D8451,38951,2,7,5,109.48097,18.28868,1416
116973,E475FCBFD73C578507E18D91DA2D8451,30971,10,12,2,109.48708,18.29319,1467
116974,E475FCBFD73C578507E18D91DA2D8451,38951,12,13,1,109.48097,18.28868,1416
116975,E475FCBFD73C578507E18D91DA2D8451,60614,14,15,1,109.48799,18.29521,1467
116991,66DE47A85B6B5866022FF6341586F6EA,60211,12,15,3,109.63549,18.26049,2011
116992,66DE47A85B6B5866022FF6341586F6EA,30861,16,19,3,109.52722,18.22743,1606
116993,66DE47A85B6B5866022FF6341586F6EA,30854,20,21,1,109.56889,18.27076,1763
117014,32D0EBFA645FCE8DAD65D018847E5043,39371,0,7,7,109.56627,18.2646,1762
117015,32D0EBFA645FCE8DAD65D018847E5043,30854,9,10,1,109.56889,18.27076,1763
117016,32D0EBFA645FCE8DAD65D018847E5043,39371,12,15,3,109.56627,18.2646,1762
117017,32D0EBFA645FCE8DAD65D018847E5043,30854,19,21,2,109.56889,18.27076,1763
117020,A3F1A757214C25A449688115E5C4321B,31931,14,16,2,109.54771,18.29403,1667
117021,A3F1A757214C25A449688115E5C4321B,38315,18,20,2,109.48979,18.29764,1467
117072,40285EE8CCE25C38988EC087545664EC,31071,0,7,7,109.58257,18.28458,1815
117073,40285EE8CCE25C38988EC087545664EC,30854,12,22,10,109.56889,18.27076,1763
117074,BBE4D8242EE46AE73AD69A56A00F4408,30201,0,7,7,109.4909,18.26465,1462
117075,BBE4D8242EE46AE73AD69A56A00F4408,31021,7,10,3,109.49021,18.27,1463
117076,BBE4D8242EE46AE73AD69A56A00F4408,31271,12,16,4,109.48958,18.26257,1462
117077,BBE4D8242EE46AE73AD69A56A00F4408,30201,19,22,3,109.4909,18.26465,1462
117085,06AC458FB19CD4D4F5767460007C5371,30181,0,9,9,109.51597,18.23313,1557
117086,06AC458FB19CD4D4F5767460007C5371,38754,9,11,2,109.74667,18.37382,2430
117087,06AC458FB19CD4D4F5767460007C5371,30964,12,16,4,109.73528,18.38875,2433
117088,06AC458FB19CD4D4F5767460007C5371,30181,19,20,1,109.51597,18.23313,1557
117093,6EA0FFE27EED64A0685E81DBC5C13BFD,31521,0,11,11,109.51458,18.22542,1555
117116,107A36F770604E4BC54DCA0F196F27FF,31521,0,1,1,109.51458,18.22542,1555
117117,107A36F770604E4BC54DCA0F196F27FF,30181,2,5,3,109.51597,18.23313,1557
117118,107A36F770604E4BC54DCA0F196F27FF,60291,5,7,2,109.50826,18.24639,1509
117119,107A36F770604E4BC54DCA0F196F27FF,30181,7,10,3,109.51597,18.23313,1557
117120,107A36F770604E4BC54DCA0F196F27FF,31145,12,14,2,109.20431,18.30479,369
117121,107A36F770604E4BC54DCA0F196F27FF,30181,16,23,7,109.51597,18.23313,1557
117128,C8922FAF66F21ECAECB6B717FCD5A53B,60614,1,6,5,109.48799,18.29521,1467
117129,C8922FAF66F21ECAECB6B717FCD5A53B,60391,6,10,4,109.47667,18.28757,1416
117130,C8922FAF66F21ECAECB6B717FCD5A53B,60614,13,17,4,109.48799,18.29521,1467
117131,C8922FAF66F21ECAECB6B717FCD5A53B,60391,18,19,1,109.47667,18.28757,1416
117132,C8922FAF66F21ECAECB6B717FCD5A53B,60614,21,23,2,109.48799,18.29521,1467
117156,D9359F177293DE6337F7CC97B1116186,31571,0,4,4,109.61563,18.23326,1957
117157,D9359F177293DE6337F7CC97B1116186,60594,8,14,6,109.62694,18.22799,1956
117164,017BB493E18067371C6FAA1A30D4BA4B,30571,13,15,2,109.50243,18.21861,1504
117165,017BB493E18067371C6FAA1A30D4BA4B,60084,16,19,3,109.4984,18.2334,1507
117226,04ABA8BFD5D63DDF1B83BA0577C9019C,30232,2,3,1,109.6191,18.31701,1971
117227,04ABA8BFD5D63DDF1B83BA0577C9019C,31421,4,7,3,109.55382,18.22347,1705
117228,04ABA8BFD5D63DDF1B83BA0577C9019C,31351,11,21,10,109.4959,18.28417,1465
117272,F9DDAF94F02D470B0D29C2FB66604E6F,39063,0,1,1,109.386,18.2919,1066
117273,F9DDAF94F02D470B0D29C2FB66604E6F,38145,2,6,4,109.378,18.2912,1066
117274,F9DDAF94F02D470B0D29C2FB66604E6F,38325,8,9,1,109.39792,18.2909,1116
117275,F9DDAF94F02D470B0D29C2FB66604E6F,38145,13,14,1,109.378,18.2912,1066
117276,F9DDAF94F02D470B0D29C2FB66604E6F,31671,18,20,2,109.38965,18.29813,1068
117287,E9E473F09C342630187345312F4A31D8,39181,0,14,14,109.55153,18.28035,1715
117288,E9E473F09C342630187345312F4A31D8,39181,15,18,3,109.55153,18.28035,1715
117289,E9E473F09C342630187345312F4A31D8,60171,21,22,1,109.51292,18.30694,1569
117300,08A066736557478B1013C0CF834491DF,30921,0,7,7,109.53903,18.29451,1667
117301,08A066736557478B1013C0CF834491DF,31931,10,23,13,109.54771,18.29403,1667
117343,E75CF54BA14775FEDD26504F9F6B7365,31945,0,5,5,109.58021,18.29403,1817
117344,E75CF54BA14775FEDD26504F9F6B7365,31561,6,11,5,109.56792,18.28479,1765
117345,00FC332040A284DA251A8D0705989FE9,31071,2,13,11,109.58257,18.28458,1815
117346,00FC332040A284DA251A8D0705989FE9,30854,14,20,6,109.56889,18.27076,1763
117378,5169AE4C4AE9067320D7FAAA8A39A4BE,31511,16,23,7,109.26326,18.40521,635
117399,8DA877D3A30401F86E81FB7BC1CA2A00,31071,1,7,6,109.58257,18.28458,1815
117400,8DA877D3A30401F86E81FB7BC1CA2A00,30854,12,13,1,109.56889,18.27076,1763
117401,8DA877D3A30401F86E81FB7BC1CA2A00,31071,14,15,1,109.58257,18.28458,1815
117402,8DA877D3A30401F86E81FB7BC1CA2A00,30854,16,17,1,109.56889,18.27076,1763
117403,8DA877D3A30401F86E81FB7BC1CA2A00,31071,18,19,1,109.58257,18.28458,1815
117408,39F25FE146A03325C93C111F2A943B6C,31945,1,7,6,109.58021,18.29403,1817
117409,39F25FE146A03325C93C111F2A943B6C,30854,7,10,3,109.56889,18.27076,1763
117410,39F25FE146A03325C93C111F2A943B6C,31945,12,13,1,109.58021,18.29403,1817
117411,39F25FE146A03325C93C111F2A943B6C,30854,19,20,1,109.56889,18.27076,1763
117412,39F25FE146A03325C93C111F2A943B6C,31945,22,23,1,109.58021,18.29403,1817
117501,F96339A49EA24867AF66AA212A3AA3FA,30764,0,8,8,109.45806,18.29486,1367
117502,F96339A49EA24867AF66AA212A3AA3FA,31231,8,9,1,109.42597,18.29292,1217
117503,F96339A49EA24867AF66AA212A3AA3FA,39191,13,15,2,109.51493,18.23472,1557
117504,F96339A49EA24867AF66AA212A3AA3FA,60381,15,18,3,109.5241,18.22458,1605
117505,F96339A49EA24867AF66AA212A3AA3FA,30201,19,21,2,109.4909,18.26465,1462
117506,1E36640BE395A4EE8CCB2697222419A5,60631,0,7,7,109.57778,18.27583,1814
117507,1E36640BE395A4EE8CCB2697222419A5,30854,11,17,6,109.56889,18.27076,1763
117508,1E36640BE395A4EE8CCB2697222419A5,30191,21,23,2,109.50361,18.22701,1506
117509,14AE6C820CE45F96077630992CABD33D,31421,0,9,9,109.55382,18.22347,1705
117510,14AE6C820CE45F96077630992CABD33D,30851,11,12,1,109.5616,18.27396,1713
117511,DFFF17B7FE30E79B8AABBB5CE171272F,31561,0,1,1,109.56792,18.28479,1765
117512,DFFF17B7FE30E79B8AABBB5CE171272F,30854,4,6,2,109.56889,18.27076,1763
117513,DFFF17B7FE30E79B8AABBB5CE171272F,39183,10,11,1,109.55542,18.28208,1715
117514,DFFF17B7FE30E79B8AABBB5CE171272F,31561,12,13,1,109.56792,18.28479,1765
117515,DFFF17B7FE30E79B8AABBB5CE171272F,30854,15,16,1,109.56889,18.27076,1763
117535,B34415F599F0ED7D1A073EE314A60B9B,31671,5,12,7,109.38965,18.29813,1068
117536,B34415F599F0ED7D1A073EE314A60B9B,31681,13,14,1,109.40396,18.29979,1168
117537,B34415F599F0ED7D1A073EE314A60B9B,31671,15,19,4,109.38965,18.29813,1068
117538,EBA892C672C9F4A4DF6308E74156462F,30854,1,2,1,109.56889,18.27076,1763
117539,EBA892C672C9F4A4DF6308E74156462F,31071,4,23,19,109.58257,18.28458,1815
117566,0CD3A9451B945A7EABB5A7155C5317AC,38251,0,2,2,109.49618,18.25493,1510
117567,0CD3A9451B945A7EABB5A7155C5317AC,60161,3,8,5,109.49174,18.26181,1461
117568,0CD3A9451B945A7EABB5A7155C5317AC,60401,9,10,1,109.47444,18.27583,1414
117569,0CD3A9451B945A7EABB5A7155C5317AC,31534,18,20,2,109.49368,18.25806,1461
117570,0CD3A9451B945A7EABB5A7155C5317AC,30421,20,23,3,109.50021,18.25861,1511
117589,8CD15CF6B5FB4821940FF9AFE6D6CB84,31931,16,19,3,109.54771,18.29403,1667
117590,8CD15CF6B5FB4821940FF9AFE6D6CB84,39181,21,22,1,109.55153,18.28035,1715
117598,E0A24740E2C54F3B77DB561A91D2BED7,30151,0,1,1,109.50986,18.25083,1560
117599,E0A24740E2C54F3B77DB561A91D2BED7,30151,2,7,5,109.50986,18.25083,1560
117600,E0A24740E2C54F3B77DB561A91D2BED7,30251,8,17,9,109.50611,18.26653,1512
117601,E0A24740E2C54F3B77DB561A91D2BED7,30151,18,23,5,109.50986,18.25083,1560
117619,10E6DCB22C04D9E1B01193CDA87B3193,60221,0,6,6,109.52569,18.29188,1616
117620,10E6DCB22C04D9E1B01193CDA87B3193,31561,10,11,1,109.56792,18.28479,1765
117621,10E6DCB22C04D9E1B01193CDA87B3193,30854,14,17,3,109.56889,18.27076,1763
117633,0D69669D4DBC1CEB06269A084D86E853,31571,10,16,6,109.61563,18.23326,1957
117634,0D69669D4DBC1CEB06269A084D86E853,60631,20,22,2,109.57778,18.27583,1814
117716,E99517AC3D59974611C317AE256FC926,60221,0,4,4,109.52569,18.29188,1616
117717,E99517AC3D59974611C317AE256FC926,31671,7,9,2,109.38965,18.29813,1068
117718,E99517AC3D59974611C317AE256FC926,30341,9,10,1,109.3625,18.29167,966
117725,049185A0C662803A38BF69324E3059A7,30361,16,18,2,109.50347,18.24,1508
117726,049185A0C662803A38BF69324E3059A7,38951,19,23,4,109.48097,18.28868,1416
117765,1CBE5FAAC6CDC5A885E2AFCD14FDBBB1,31231,0,2,2,109.42597,18.29292,1217
117766,1CBE5FAAC6CDC5A885E2AFCD14FDBBB1,60524,3,4,1,109.42951,18.28993,1216
117767,1CBE5FAAC6CDC5A885E2AFCD14FDBBB1,60401,5,6,1,109.47444,18.27583,1414
117768,1CBE5FAAC6CDC5A885E2AFCD14FDBBB1,60081,12,14,2,109.51097,18.22639,1556
117769,1CBE5FAAC6CDC5A885E2AFCD14FDBBB1,60401,15,16,1,109.47444,18.27583,1414
117770,1CBE5FAAC6CDC5A885E2AFCD14FDBBB1,38094,16,17,1,109.45403,18.28778,1316
117771,1CBE5FAAC6CDC5A885E2AFCD14FDBBB1,60401,22,23,1,109.47444,18.27583,1414
117774,D20C070E72B2E72E0898232810D95CC4,31521,0,9,9,109.51458,18.22542,1555
117775,D20C070E72B2E72E0898232810D95CC4,30851,13,16,3,109.5616,18.27396,1713
117776,D20C070E72B2E72E0898232810D95CC4,31521,18,23,5,109.51458,18.22542,1555
117803,27229B6D41BD7CDDDAA38911093865DB,30891,0,4,4,109.59431,18.28389,1865
117804,27229B6D41BD7CDDDAA38911093865DB,38085,5,17,12,109.6291,18.23625,2007
117818,14F1CC63CDA098F9694EAC8584B9C7A5,31561,6,15,9,109.56792,18.28479,1765
117819,14F1CC63CDA098F9694EAC8584B9C7A5,30854,17,18,1,109.56889,18.27076,1763
117892,3B0211CCC2785B2EDDB7E5C34BFDD9A3,31236,0,1,1,109.42965,18.29111,1216
117893,3B0211CCC2785B2EDDB7E5C34BFDD9A3,60524,2,9,7,109.42951,18.28993,1216
117894,3B0211CCC2785B2EDDB7E5C34BFDD9A3,31231,10,13,3,109.42597,18.29292,1217
117895,3B0211CCC2785B2EDDB7E5C34BFDD9A3,30211,14,15,1,109.49882,18.23931,1508
117896,3B0211CCC2785B2EDDB7E5C34BFDD9A3,60161,17,18,1,109.49174,18.26181,1461
117916,8F38E05146537B1A75A31B873BB68479,30854,20,21,1,109.56889,18.27076,1763
117917,8F38E05146537B1A75A31B873BB68479,30891,21,23,2,109.59431,18.28389,1865
117930,C881B9140448216999DAAEBF36FD2690,60171,13,19,6,109.51292,18.30694,1569
117931,C881B9140448216999DAAEBF36FD2690,30351,20,22,2,109.41701,18.29292,1217
117978,16C6AF30AB7E330E51881042B3420D65,30361,0,8,8,109.50347,18.24,1508
117979,16C6AF30AB7E330E51881042B3420D65,31041,9,11,2,109.50278,18.23701,1507
118068,7C4B45B599684104AFE3AA992CD3924A,60211,0,7,7,109.63549,18.26049,2011
118069,7C4B45B599684104AFE3AA992CD3924A,30421,9,10,1,109.50021,18.25861,1511
118070,7C4B45B599684104AFE3AA992CD3924A,31351,11,12,1,109.4959,18.28417,1465
118071,7C4B45B599684104AFE3AA992CD3924A,30711,12,14,2,109.50271,18.25347,1510
118072,7C4B45B599684104AFE3AA992CD3924A,31321,15,16,1,109.63799,18.23201,2007
118073,7C4B45B599684104AFE3AA992CD3924A,60211,21,23,2,109.63549,18.26049,2011
118111,FA51666CEC588E3810FF6A1AD2DC07A0,31521,1,10,9,109.51458,18.22542,1555
118112,FA51666CEC588E3810FF6A1AD2DC07A0,38811,11,12,1,109.50875,18.2175,1504
118113,FA51666CEC588E3810FF6A1AD2DC07A0,39183,15,17,2,109.55542,18.28208,1715
118114,FA51666CEC588E3810FF6A1AD2DC07A0,31521,20,23,3,109.51458,18.22542,1555
118124,752B4C65CCCA1EA27D3C6EA24E289B9C,30854,8,16,8,109.56889,18.27076,1763
118125,752B4C65CCCA1EA27D3C6EA24E289B9C,39371,16,23,7,109.56627,18.2646,1762
118134,36180D21AA0C286539A1A187C28A99B4,30421,0,6,6,109.50021,18.25861,1511
118135,36180D21AA0C286539A1A187C28A99B4,30711,6,7,1,109.50271,18.25347,1510
118136,36180D21AA0C286539A1A187C28A99B4,31781,10,12,2,109.19847,18.2975,367
118137,36180D21AA0C286539A1A187C28A99B4,30421,17,19,2,109.50021,18.25861,1511
118138,36180D21AA0C286539A1A187C28A99B4,30421,21,23,2,109.50021,18.25861,1511
118147,BCC6D1A50E04898FABDF906024A98CE5,31761,0,10,10,109.60521,18.27965,1914
118148,BCC6D1A50E04898FABDF906024A98CE5,30711,11,12,1,109.50271,18.25347,1510
118149,BCC6D1A50E04898FABDF906024A98CE5,39091,14,16,2,109.50097,18.25222,1510
118150,BCC6D1A50E04898FABDF906024A98CE5,31761,20,23,3,109.60521,18.27965,1914
118156,D626C213FA0AAEAFB4EA6E1A519D93E5,31521,0,2,2,109.51458,18.22542,1555
118157,D626C213FA0AAEAFB4EA6E1A519D93E5,39321,3,13,10,109.529,18.2167,1604
118158,D626C213FA0AAEAFB4EA6E1A519D93E5,31521,14,15,1,109.51458,18.22542,1555
118159,D626C213FA0AAEAFB4EA6E1A519D93E5,60381,19,23,4,109.5241,18.22458,1605
118218,F8D799D9161B0143E0D71C40472A357E,30071,0,14,14,109.52819,18.30472,1619
118219,F8D799D9161B0143E0D71C40472A357E,60371,17,19,2,109.53063,18.30056,1618
118220,FCFB14BA36BDB7CD6A39612B9AE933B2,39181,12,14,2,109.55153,18.28035,1715
118221,FCFB14BA36BDB7CD6A39612B9AE933B2,38127,19,23,4,109.50833,18.27222,1513
118244,CFE1C91972E0069E23C7B471A067D251,30251,0,8,8,109.50611,18.26653,1512
118245,CFE1C91972E0069E23C7B471A067D251,38315,9,10,1,109.48979,18.29764,1467
118256,7BF65E5054DA81A230AB5423620158E1,60631,0,5,5,109.57778,18.27583,1814
118257,7BF65E5054DA81A230AB5423620158E1,30854,7,12,5,109.56889,18.27076,1763
118258,7BF65E5054DA81A230AB5423620158E1,60631,12,13,1,109.57778,18.27583,1814
118259,7BF65E5054DA81A230AB5423620158E1,30854,15,19,4,109.56889,18.27076,1763
118284,C58D0182BFC61ED113EE3B09763C30B2,31931,9,11,2,109.54771,18.29403,1667
118285,C58D0182BFC61ED113EE3B09763C30B2,38185,14,16,2,109.51333,18.27347,1563
118317,079A114D194FE2EFB0C89059CA4EBC03,31251,0,8,8,109.18528,18.2975,317
118319,079A114D194FE2EFB0C89059CA4EBC03,31251,10,23,13,109.18528,18.2975,317
118364,362CF58B32D978DCF17B65B310F5E090,31181,18,20,2,109.50382,18.24813,1509
118365,362CF58B32D978DCF17B65B310F5E090,30381,20,23,3,109.52521,18.24507,1609
118373,B918E6C7FDB4745FD59F18F0F2FA3EBF,60561,0,7,7,109.38229,18.29785,1067
118374,B918E6C7FDB4745FD59F18F0F2FA3EBF,31781,9,11,2,109.19847,18.2975,367
118375,B918E6C7FDB4745FD59F18F0F2FA3EBF,60561,14,17,3,109.38229,18.29785,1067
118390,C6C3BC01E542B810EF853FEEB6C81198,60361,0,14,14,109.51938,18.29681,1567
118391,C6C3BC01E542B810EF853FEEB6C81198,60221,15,16,1,109.52569,18.29188,1616
118392,C6C3BC01E542B810EF853FEEB6C81198,60361,17,19,2,109.51938,18.29681,1567
118395,3871846CD20CC7E3D76BFB165D15B326,30854,0,6,6,109.56889,18.27076,1763
118396,3871846CD20CC7E3D76BFB165D15B326,31561,7,9,2,109.56792,18.28479,1765
118397,3871846CD20CC7E3D76BFB165D15B326,30854,12,23,11,109.56889,18.27076,1763
118412,6C0260646767B781577B5B8CE2471E51,38484,1,6,5,109.53028,18.31528,1620
118413,6C0260646767B781577B5B8CE2471E51,38484,9,13,4,109.53028,18.31528,1620
118414,6C0260646767B781577B5B8CE2471E51,38484,14,17,3,109.53028,18.31528,1620
118415,6C0260646767B781577B5B8CE2471E51,30321,18,19,1,109.49563,18.29611,1467
118416,6C0260646767B781577B5B8CE2471E51,38484,20,22,2,109.53028,18.31528,1620
118456,63B5E489F3503F8EC6E40A38F9D2117C,31951,13,14,1,109.52174,18.30299,1568
118457,63B5E489F3503F8EC6E40A38F9D2117C,60171,15,19,4,109.51292,18.30694,1569
118458,63B5E489F3503F8EC6E40A38F9D2117C,60361,21,22,1,109.51938,18.29681,1567
118488,7D72A79F2F964580140FF5C346A60898,60501,0,6,6,109.48701,18.29021,1466
118489,7D72A79F2F964580140FF5C346A60898,30161,11,12,1,109.50042,18.24389,1508
118493,FF811E88FEA9CBDF12E5CC54DEE7CCA1,39371,4,7,3,109.56627,18.2646,1762
118494,FF811E88FEA9CBDF12E5CC54DEE7CCA1,30891,8,9,1,109.59431,18.28389,1865
118495,FF811E88FEA9CBDF12E5CC54DEE7CCA1,30854,9,10,1,109.56889,18.27076,1763
118505,0BC523536561C072856E101229AE8902,30854,0,6,6,109.56889,18.27076,1763
118506,0BC523536561C072856E101229AE8902,30581,9,12,3,109.62257,18.24951,1959
118507,0BC523536561C072856E101229AE8902,31071,14,21,7,109.58257,18.28458,1815
118508,0BC523536561C072856E101229AE8902,60631,21,23,2,109.57778,18.27583,1814
118536,36EE9562308F3103777DD131118390D9,30711,22,23,1,109.50271,18.25347,1510
118537,4FAFA7B85E3244F55624961F3F495B99,30371,2,21,19,109.51,18.24771,1559
118538,4FAFA7B85E3244F55624961F3F495B99,31821,22,23,1,109.51181,18.24924,1559
118568,9EF6440DA421994ED152A57FAE59B45B,31261,12,15,3,109.51174,18.2466,1559
118569,9EF6440DA421994ED152A57FAE59B45B,30861,17,21,4,109.52722,18.22743,1606
118570,9EF6440DA421994ED152A57FAE59B45B,31261,21,23,2,109.51174,18.2466,1559
118575,FE95B3A32EFBC2838F293DF38F55FDD1,39183,2,5,3,109.55542,18.28208,1715
118576,FE95B3A32EFBC2838F293DF38F55FDD1,31931,6,8,2,109.54771,18.29403,1667
118577,FE95B3A32EFBC2838F293DF38F55FDD1,39183,8,19,11,109.55542,18.28208,1715
118578,A515C2BA2B0AE21CADC42FF4E7FC0007,31931,13,14,1,109.54771,18.29403,1667
118579,A515C2BA2B0AE21CADC42FF4E7FC0007,39181,15,23,8,109.55153,18.28035,1715
118610,5A6C2C4A9B4DF43C379FCADC2CCFC5BC,38171,1,7,6,109.50799,18.28139,1515
118611,5A6C2C4A9B4DF43C379FCADC2CCFC5BC,38261,10,11,1,109.50361,18.28153,1515
118612,5A6C2C4A9B4DF43C379FCADC2CCFC5BC,38171,13,18,5,109.50799,18.28139,1515
118613,5A6C2C4A9B4DF43C379FCADC2CCFC5BC,31531,18,23,5,109.49583,18.25972,1461
118629,A295CDC40521CA815718307440F6AFE6,60504,0,4,4,109.47917,18.28903,1416
118630,A295CDC40521CA815718307440F6AFE6,30671,4,7,3,109.43611,18.30139,1268
118631,A295CDC40521CA815718307440F6AFE6,60551,12,14,2,109.42722,18.30111,1218
118632,86360CBE83A45C2F8F04805EB9121831,38157,0,1,1,109.51483,18.26958,1563
118633,86360CBE83A45C2F8F04805EB9121831,30741,2,7,5,109.49833,18.28681,1516
118634,86360CBE83A45C2F8F04805EB9121831,31231,10,11,1,109.42597,18.29292,1217
118635,86360CBE83A45C2F8F04805EB9121831,30721,14,23,9,109.51597,18.28257,1565
118641,1F96BBD2F640FBF201B5039048AA680E,38951,17,20,3,109.48097,18.28868,1416
118642,1F96BBD2F640FBF201B5039048AA680E,60614,21,23,2,109.48799,18.29521,1467
118643,51ED683608E55A4EDEADC423E7C7B6C3,31471,13,15,2,109.34583,18.29563,917
118644,51ED683608E55A4EDEADC423E7C7B6C3,30661,16,17,1,109.37028,18.24361,1008
118645,E8BAAF476E8FE57075BAB1A8D4FF1780,39371,6,17,11,109.56627,18.2646,1762
118646,E8BAAF476E8FE57075BAB1A8D4FF1780,31031,19,20,1,109.49979,18.25382,1510
118669,30CE72A519D49881F23B8123486E3A02,60411,0,9,9,109.32514,18.30854,869
118670,30CE72A519D49881F23B8123486E3A02,31471,12,16,4,109.34583,18.29563,917
118671,30CE72A519D49881F23B8123486E3A02,60411,19,23,4,109.32514,18.30854,869
118800,8173BA5756C17B85ED9415F619E926FB,30201,0,10,10,109.4909,18.26465,1462
118818,D56A67341D1DA856D04BC2181FD404FB,60541,0,7,7,109.4084,18.29208,1167
118819,D56A67341D1DA856D04BC2181FD404FB,30351,9,10,1,109.41701,18.29292,1217
118820,D56A67341D1DA856D04BC2181FD404FB,60541,13,14,1,109.4084,18.29208,1167
118863,E4C7AB656E412C7E33554D18277C9478,60291,8,14,6,109.50826,18.24639,1509
118864,E4C7AB656E412C7E33554D18277C9478,30181,17,18,1,109.51597,18.23313,1557
118865,E4C7AB656E412C7E33554D18277C9478,31461,19,20,1,109.5091,18.25389,1510
118877,C1793DCC823463513E28F999E76F9ADC,60054,0,3,3,109.3016,18.31229,770
118878,C1793DCC823463513E28F999E76F9ADC,30661,3,6,3,109.37028,18.24361,1008
118879,C1793DCC823463513E28F999E76F9ADC,31471,7,8,1,109.34583,18.29563,917
118880,C1793DCC823463513E28F999E76F9ADC,60054,12,23,11,109.3016,18.31229,770
118905,C6FE5B8DD9D562FE8289A1B2F6DDFCD0,31345,19,20,1,109.39,18.29,1066
118918,FA93329D43DE3EEACED8008F20EF0365,38023,0,12,12,109.37132,18.28993,1016
118919,FA93329D43DE3EEACED8008F20EF0365,31471,12,14,2,109.34583,18.29563,917
118920,FA93329D43DE3EEACED8008F20EF0365,38023,17,23,6,109.37132,18.28993,1016
118942,2887AD84D7F343407DB74995AA80F829,30771,0,7,7,109.49938,18.26042,1511
118943,2887AD84D7F343407DB74995AA80F829,30081,8,9,1,109.50243,18.26632,1512
118944,7F632B4875B2736225CD6D350CD25670,31071,11,12,1,109.58257,18.28458,1815
118945,7F632B4875B2736225CD6D350CD25670,30854,13,23,10,109.56889,18.27076,1763
118949,7F632B4875B2736225CD6D350CD25670,30854,7,18,11,109.56889,18.27076,1763
118950,7F632B4875B2736225CD6D350CD25670,31821,19,20,1,109.51181,18.24924,1559
118979,1B6EBBFF3B9D8A3E18753343B6A29EAE,31071,0,6,6,109.58257,18.28458,1815
118980,1B6EBBFF3B9D8A3E18753343B6A29EAE,30851,7,16,9,109.5616,18.27396,1713
118981,1B6EBBFF3B9D8A3E18753343B6A29EAE,31071,19,23,4,109.58257,18.28458,1815
118982,E65D3D1BA13018960174E494A9D95E0B,38116,17,18,1,109.50799,18.21882,1504
118983,E65D3D1BA13018960174E494A9D95E0B,31521,20,22,2,109.51458,18.22542,1555
119018,004C4A1986E184D2F11887515F258CC6,60031,6,11,5,109.49694,18.31632,1521
119028,39CA4FE8290F03A5AE8EA1D8371B2A6D,30121,0,7,7,109.52861,18.27222,1613
119031,39CA4FE8290F03A5AE8EA1D8371B2A6D,30121,21,23,2,109.52861,18.27222,1613
119083,4D4289AE0DFBF4B5C79A47559DC2EBDD,31945,2,6,4,109.58021,18.29403,1817
119084,4D4289AE0DFBF4B5C79A47559DC2EBDD,30854,8,19,11,109.56889,18.27076,1763
119092,59F29435D748531F416A4F1636997ECF,31071,0,6,6,109.58257,18.28458,1815
119093,59F29435D748531F416A4F1636997ECF,30854,9,16,7,109.56889,18.27076,1763
119099,68DBE0B52FD0AB95F1DD47068FD7847F,30181,0,9,9,109.51597,18.23313,1557
119100,68DBE0B52FD0AB95F1DD47068FD7847F,60381,13,15,2,109.5241,18.22458,1605
119101,68DBE0B52FD0AB95F1DD47068FD7847F,30181,18,20,2,109.51597,18.23313,1557
119102,68DBE0B52FD0AB95F1DD47068FD7847F,30381,20,23,3,109.52521,18.24507,1609
119178,22CF7007721E0F1D863F25E4633BE1AD,60311,0,8,8,109.52097,18.24319,1558
119179,22CF7007721E0F1D863F25E4633BE1AD,30281,12,13,1,109.50597,18.27583,1514
119180,22CF7007721E0F1D863F25E4633BE1AD,31261,14,15,1,109.51174,18.2466,1559
119181,22CF7007721E0F1D863F25E4633BE1AD,38291,15,16,1,109.51618,18.24313,1558
119182,22CF7007721E0F1D863F25E4633BE1AD,60311,19,23,4,109.52097,18.24319,1558
119183,BCBE041A7FC025F9D2DFD86A6CB75E1D,30651,9,10,1,109.42611,18.385,1232
119184,BCBE041A7FC025F9D2DFD86A6CB75E1D,30821,11,13,2,109.43681,18.33639,1274
119208,C87F469509749B351A8671696022A99C,31561,0,20,20,109.56792,18.28479,1765
119209,C87F469509749B351A8671696022A99C,31071,20,22,2,109.58257,18.28458,1815
119236,7E95AEA91A37473FF71C625BDD54FD92,60226,7,16,9,109.5175,18.28778,1566
119237,7E95AEA91A37473FF71C625BDD54FD92,60361,16,23,7,109.51938,18.29681,1567
119256,C7B596C3998F49DC6B86FB54AB7111B3,31071,0,5,5,109.58257,18.28458,1815
119257,C7B596C3998F49DC6B86FB54AB7111B3,30101,7,8,1,109.57299,18.33333,1773
119258,C7B596C3998F49DC6B86FB54AB7111B3,30706,9,10,1,109.58833,18.31125,1820
119259,C7B596C3998F49DC6B86FB54AB7111B3,31071,10,21,11,109.58257,18.28458,1815
119272,CF1922E57BC1E2D5DC4336E820C48B77,60411,0,1,1,109.32514,18.30854,869
119273,CF1922E57BC1E2D5DC4336E820C48B77,31471,2,5,3,109.34583,18.29563,917
119274,CF1922E57BC1E2D5DC4336E820C48B77,60411,7,18,11,109.32514,18.30854,869
119280,066CC6CBB5ADF978A93AF5D0C3292806,31931,0,7,7,109.54771,18.29403,1667
119281,066CC6CBB5ADF978A93AF5D0C3292806,38991,9,16,7,109.52681,18.30368,1618
119291,01339F6C6B37B246DACBDB2C4FDB46D0,30101,1,3,2,109.57299,18.33333,1773
119292,01339F6C6B37B246DACBDB2C4FDB46D0,30941,3,4,1,109.5559,18.33938,1724
119293,01339F6C6B37B246DACBDB2C4FDB46D0,30101,6,7,1,109.57299,18.33333,1773
119294,01339F6C6B37B246DACBDB2C4FDB46D0,30941,7,9,2,109.5559,18.33938,1724
119302,E5A1549025A878E1962E8B6F03111655,30731,0,11,11,109.50944,18.22306,1555
119303,E5A1549025A878E1962E8B6F03111655,30181,11,13,2,109.51597,18.23313,1557
119304,E5A1549025A878E1962E8B6F03111655,30361,14,15,1,109.50347,18.24,1508
119305,E5A1549025A878E1962E8B6F03111655,30181,15,17,2,109.51597,18.23313,1557
119306,E5A1549025A878E1962E8B6F03111655,31201,17,18,1,109.51042,18.23819,1558
119310,019CCF25DBCE9B21B5D2698F82FCE788,30234,0,6,6,109.60681,18.29979,1918
119311,019CCF25DBCE9B21B5D2698F82FCE788,30391,11,12,1,109.4975,18.27118,1513
119312,019CCF25DBCE9B21B5D2698F82FCE788,30234,14,16,2,109.60681,18.29979,1918
119343,044D77694C91C25EFC530EE742974330,31071,14,15,1,109.58257,18.28458,1815
119344,044D77694C91C25EFC530EE742974330,30854,18,21,3,109.56889,18.27076,1763
119362,8C28D637CC74662A6171660AC17A06B6,38241,0,7,7,109.54111,18.30542,1669
119363,8C28D637CC74662A6171660AC17A06B6,31951,7,8,1,109.52174,18.30299,1568
119364,8C28D637CC74662A6171660AC17A06B6,60371,11,13,2,109.53063,18.30056,1618
119365,8C28D637CC74662A6171660AC17A06B6,30854,16,17,1,109.56889,18.27076,1763
119413,0497B45A677421313CD12BA36905EF33,30161,0,6,6,109.50042,18.24389,1508
119430,46D10B971C10D2856504DC61068F66E7,60221,0,7,7,109.52569,18.29188,1616
119431,46D10B971C10D2856504DC61068F66E7,30111,8,9,1,109.47583,18.30542,1419
119514,E8AC07651C1D8B89FF48AC7202C59CAD,60381,16,17,1,109.5241,18.22458,1605
119515,E8AC07651C1D8B89FF48AC7202C59CAD,30861,17,21,4,109.52722,18.22743,1606
119524,21E7DFEFE05758D554D56FCB14C3C3E9,39091,17,19,2,109.50097,18.25222,1510
119525,21E7DFEFE05758D554D56FCB14C3C3E9,31181,21,23,2,109.50382,18.24813,1509
119528,5403ECE41AD9921A5DEF63FF6DE6A9D1,30854,11,12,1,109.56889,18.27076,1763
119529,5403ECE41AD9921A5DEF63FF6DE6A9D1,31271,14,15,1,109.48958,18.26257,1462
119530,5403ECE41AD9921A5DEF63FF6DE6A9D1,30854,17,22,5,109.56889,18.27076,1763
119541,9BD095517798346F169AD6D898CA1A42,60361,0,6,6,109.51938,18.29681,1567
119542,9BD095517798346F169AD6D898CA1A42,38154,6,8,2,109.5266,18.28278,1615
119543,9BD095517798346F169AD6D898CA1A42,60361,10,23,13,109.51938,18.29681,1567
119560,7171A8398911756415ECFCDCF96F249B,39183,1,3,2,109.55542,18.28208,1715
119561,7171A8398911756415ECFCDCF96F249B,39371,5,6,1,109.56627,18.2646,1762
119562,7171A8398911756415ECFCDCF96F249B,30851,7,11,4,109.5616,18.27396,1713
119563,7171A8398911756415ECFCDCF96F249B,30121,16,21,5,109.52861,18.27222,1613
119564,7171A8398911756415ECFCDCF96F249B,31521,21,22,1,109.51458,18.22542,1555
119577,BD5D5103B08534F20AF53FB58E9A43CA,38171,14,15,1,109.50799,18.28139,1515
119578,BD5D5103B08534F20AF53FB58E9A43CA,30321,19,20,1,109.49563,18.29611,1467
119582,061A86146605D753C12EC5BC04F2EF03,38297,20,21,1,109.52576,18.24965,1609
119583,061A86146605D753C12EC5BC04F2EF03,30381,21,22,1,109.52521,18.24507,1609
119605,DD8DCE806AFFEAC5D779812E5F8F2B3D,30221,0,10,10,109.57833,18.20222,1802
119606,DD8DCE806AFFEAC5D779812E5F8F2B3D,31561,12,16,4,109.56792,18.28479,1765
119609,372A5433078073EAD18922D679CE0A73,60054,9,13,4,109.3016,18.31229,770
119610,372A5433078073EAD18922D679CE0A73,60411,16,17,1,109.32514,18.30854,869
119611,372A5433078073EAD18922D679CE0A73,60054,17,22,5,109.3016,18.31229,770
119634,19F803FB996471824A8A9928BBFAB433,39181,0,5,5,109.55153,18.28035,1715
119635,19F803FB996471824A8A9928BBFAB433,39181,7,8,1,109.55153,18.28035,1715
119636,19F803FB996471824A8A9928BBFAB433,31931,11,12,1,109.54771,18.29403,1667
119751,B530FB0D6C312ECBD89B74FD22C716DB,30181,0,2,2,109.51597,18.23313,1557
119752,B530FB0D6C312ECBD89B74FD22C716DB,30181,3,11,8,109.51597,18.23313,1557
119753,B530FB0D6C312ECBD89B74FD22C716DB,30361,12,14,2,109.50347,18.24,1508
119754,B530FB0D6C312ECBD89B74FD22C716DB,38283,15,23,8,109.62229,18.22618,1956
119766,762ECFC7D57A8248759B8DD73DC6A9B3,38683,13,17,4,109.4266,18.29097,1216
119767,762ECFC7D57A8248759B8DD73DC6A9B3,30151,18,20,2,109.50986,18.25083,1560
119768,762ECFC7D57A8248759B8DD73DC6A9B3,38683,21,23,2,109.4266,18.29097,1216
119776,BA987FAAC62A550769ECB5E13AC256A5,38261,0,8,8,109.50361,18.28153,1515
119777,BA987FAAC62A550769ECB5E13AC256A5,31931,8,12,4,109.54771,18.29403,1667
119778,BA987FAAC62A550769ECB5E13AC256A5,38171,13,15,2,109.50799,18.28139,1515
119779,BA987FAAC62A550769ECB5E13AC256A5,31931,15,18,3,109.54771,18.29403,1667
119780,BA987FAAC62A550769ECB5E13AC256A5,38171,21,23,2,109.50799,18.28139,1515
119804,B172E1B17A92EA23226EC822FB6F7B82,60131,18,21,3,109.49819,18.24778,1509
119805,B172E1B17A92EA23226EC822FB6F7B82,30181,22,23,1,109.51597,18.23313,1557
119835,7BDC7962058E5B3507F7C37155585188,38157,2,7,5,109.51483,18.26958,1563
119836,7BDC7962058E5B3507F7C37155585188,30121,12,23,11,109.52861,18.27222,1613
119839,D4EE8E1A4C04A1FF0596E4221D0B8B42,30854,0,18,18,109.56889,18.27076,1763
119840,D4EE8E1A4C04A1FF0596E4221D0B8B42,31164,20,21,1,109.69993,18.27215,2263
119863,C8FB2E5ADC3F708918DEFE9C1D5B12F5,31461,0,1,1,109.5091,18.25389,1510
119864,C8FB2E5ADC3F708918DEFE9C1D5B12F5,30421,2,10,8,109.50021,18.25861,1511
119865,C8FB2E5ADC3F708918DEFE9C1D5B12F5,60331,10,13,3,109.505,18.26507,1512
119866,C8FB2E5ADC3F708918DEFE9C1D5B12F5,60221,14,18,4,109.52569,18.29188,1616
119867,C8FB2E5ADC3F708918DEFE9C1D5B12F5,60281,18,21,3,109.51743,18.25924,1561
119877,5A888DC7A3AA300CC584D9862C5384A1,30421,0,2,2,109.50021,18.25861,1511
119878,5A888DC7A3AA300CC584D9862C5384A1,31261,2,3,1,109.51174,18.2466,1559
119879,5A888DC7A3AA300CC584D9862C5384A1,30421,4,7,3,109.50021,18.25861,1511
119880,5A888DC7A3AA300CC584D9862C5384A1,39183,11,17,6,109.55542,18.28208,1715
119881,5A888DC7A3AA300CC584D9862C5384A1,30421,22,23,1,109.50021,18.25861,1511
119899,875F4B80762D0E664890361D764F907D,60081,0,7,7,109.51097,18.22639,1556
119900,875F4B80762D0E664890361D764F907D,30571,7,20,13,109.50243,18.21861,1504
119901,875F4B80762D0E664890361D764F907D,30711,20,21,1,109.50271,18.25347,1510
120013,5FCC504E23B9FEA010C8EF1104C6415E,38334,0,9,9,109.65035,18.23785,2057
120014,5FCC504E23B9FEA010C8EF1104C6415E,31471,12,15,3,109.34583,18.29563,917
120015,5FCC504E23B9FEA010C8EF1104C6415E,38334,19,20,1,109.65035,18.23785,2057
120016,5FCC504E23B9FEA010C8EF1104C6415E,38271,21,22,1,109.62632,18.23049,1956
120051,6733B324E753B6172A50174A4CB1E5C2,31251,0,14,14,109.18528,18.2975,317
120053,6733B324E753B6172A50174A4CB1E5C2,31251,18,22,4,109.18528,18.2975,317
120092,02E6D039B6BFD47098D3B420FA457233,38961,0,8,8,109.50847,18.23514,1507
120093,02E6D039B6BFD47098D3B420FA457233,31471,13,14,1,109.34583,18.29563,917
120094,02E6D039B6BFD47098D3B420FA457233,38961,19,22,3,109.50847,18.23514,1507
120095,3D06CD7850C0CF1D3ED2E185AFD87930,31521,14,16,2,109.51458,18.22542,1555
120096,3D06CD7850C0CF1D3ED2E185AFD87930,31521,19,21,2,109.51458,18.22542,1555
120110,FD741240540EA611084A00540F097CB4,39183,19,20,1,109.55542,18.28208,1715
120111,FD741240540EA611084A00540F097CB4,38071,21,23,2,109.40722,18.30938,1169
120148,B55755EE77AAB7159A5530B30083F834,30661,0,7,7,109.37028,18.24361,1008
120149,B55755EE77AAB7159A5530B30083F834,31471,9,10,1,109.34583,18.29563,917
120150,B55755EE77AAB7159A5530B30083F834,30661,12,13,1,109.37028,18.24361,1008
120151,B55755EE77AAB7159A5530B30083F834,60411,16,18,2,109.32514,18.30854,869
120152,B55755EE77AAB7159A5530B30083F834,31091,20,21,1,109.41201,18.31222,1170
120159,887B4CB1328C20D61945E5BC833B406E,60371,11,20,9,109.53063,18.30056,1618
120160,887B4CB1328C20D61945E5BC833B406E,30071,20,22,2,109.52819,18.30472,1619
120167,C17F2EF1DEA79C8C951E3013EE071B2C,31071,1,15,14,109.58257,18.28458,1815
120168,C17F2EF1DEA79C8C951E3013EE071B2C,38154,19,20,1,109.5266,18.28278,1615
120169,C17F2EF1DEA79C8C951E3013EE071B2C,30771,21,22,1,109.49938,18.26042,1511
120170,F266F55F764384E7872EAB5493D7B12B,38334,0,9,9,109.65035,18.23785,2057
120171,F266F55F764384E7872EAB5493D7B12B,31471,12,15,3,109.34583,18.29563,917
120172,F266F55F764384E7872EAB5493D7B12B,38334,19,20,1,109.65035,18.23785,2057
120173,F266F55F764384E7872EAB5493D7B12B,38271,20,22,2,109.62632,18.23049,1956
120179,8E244E94833DBF281BCBFE2F4A36E102,60641,0,16,16,109.53854,18.2359,1657
120180,8E244E94833DBF281BCBFE2F4A36E102,30741,17,19,2,109.49833,18.28681,1516
120181,8E244E94833DBF281BCBFE2F4A36E102,60641,20,22,2,109.53854,18.2359,1657
120199,D91289410D46E2838A7CD67AF8E32DCF,30921,21,23,2,109.53903,18.29451,1667
120231,17D13F6A66037B54FAB5668CDC734401,30721,0,6,6,109.51597,18.28257,1565
120232,17D13F6A66037B54FAB5668CDC734401,39181,10,11,1,109.55153,18.28035,1715
120233,17D13F6A66037B54FAB5668CDC734401,30721,13,23,10,109.51597,18.28257,1565
120263,1C67859AC074D33800F75471EB5E573E,60631,0,7,7,109.57778,18.27583,1814
120264,1C67859AC074D33800F75471EB5E573E,31071,9,12,3,109.58257,18.28458,1815
120265,1C67859AC074D33800F75471EB5E573E,60631,12,14,2,109.57778,18.27583,1814
120266,1C67859AC074D33800F75471EB5E573E,30854,16,18,2,109.56889,18.27076,1763
120267,1C67859AC074D33800F75471EB5E573E,60631,22,23,1,109.57778,18.27583,1814
120296,9B24FEFE42610E15A8305E52C167D9B9,38154,1,8,7,109.5266,18.28278,1615
120297,9B24FEFE42610E15A8305E52C167D9B9,30854,10,11,1,109.56889,18.27076,1763
120298,9B24FEFE42610E15A8305E52C167D9B9,38154,12,13,1,109.5266,18.28278,1615
120299,9B24FEFE42610E15A8305E52C167D9B9,30854,16,17,1,109.56889,18.27076,1763
120336,F3BDE391723935123283DAC5132B46D2,31311,0,9,9,109.72299,18.27438,2364
120338,F3BDE391723935123283DAC5132B46D2,31311,18,22,4,109.72299,18.27438,2364
120340,F7AAD8355D0FB48A1E8C914954424109,31145,11,12,1,109.20431,18.30479,369
120341,F7AAD8355D0FB48A1E8C914954424109,31861,16,23,7,109.49042,18.27549,1464
120342,855D815DC19AA779325469411A9E7B8A,30251,1,13,12,109.50611,18.26653,1512
120343,855D815DC19AA779325469411A9E7B8A,38157,13,17,4,109.51483,18.26958,1563
120406,8621CFDF1B89A83351494618C53D033F,39181,0,12,12,109.55153,18.28035,1715
120407,8621CFDF1B89A83351494618C53D033F,31071,13,15,2,109.58257,18.28458,1815
120408,8621CFDF1B89A83351494618C53D033F,39181,16,23,7,109.55153,18.28035,1715
120454,115CE8C7CCAA1288E5461F613949EE4B,31671,5,6,1,109.38965,18.29813,1068
120455,115CE8C7CCAA1288E5461F613949EE4B,60231,6,7,1,109.49903,18.21972,1504
120456,115CE8C7CCAA1288E5461F613949EE4B,30571,10,12,2,109.50243,18.21861,1504
120476,08A627C32003E101BA399C2208217139,38251,0,8,8,109.49618,18.25493,1510
120486,8D4ACBD3925B9BC67CB90B513BB008F6,60101,15,16,1,109.75465,18.40139,2485
120487,8D4ACBD3925B9BC67CB90B513BB008F6,30961,17,20,3,109.74042,18.37903,2431
120488,8D4ACBD3925B9BC67CB90B513BB008F6,31881,21,22,1,109.7441,18.40785,2436
120489,22B987DE38F8C4435934FE5E6190C4A2,60631,1,11,10,109.57778,18.27583,1814
120490,22B987DE38F8C4435934FE5E6190C4A2,30581,16,18,2,109.62257,18.24951,1959
120491,22B987DE38F8C4435934FE5E6190C4A2,60631,22,23,1,109.57778,18.27583,1814
120492,BE7763F8096EB5A037146E1CC4190538,31561,1,2,1,109.56792,18.28479,1765
120493,BE7763F8096EB5A037146E1CC4190538,30854,4,5,1,109.56889,18.27076,1763
120494,BE7763F8096EB5A037146E1CC4190538,30161,8,9,1,109.50042,18.24389,1508
120495,BE7763F8096EB5A037146E1CC4190538,30324,14,17,3,109.50326,18.29257,1517
120496,BE7763F8096EB5A037146E1CC4190538,30854,21,23,2,109.56889,18.27076,1763
120554,52D77D00506AFA664CC2385DBA703BDD,60111,0,7,7,109.72556,18.31924,2371
120555,52D77D00506AFA664CC2385DBA703BDD,31161,8,11,3,109.70229,18.31361,2270
120556,52D77D00506AFA664CC2385DBA703BDD,60381,12,15,3,109.5241,18.22458,1605
120557,52D77D00506AFA664CC2385DBA703BDD,31181,15,17,2,109.50382,18.24813,1509
120558,52D77D00506AFA664CC2385DBA703BDD,31161,19,23,4,109.70229,18.31361,2270
120559,4D190727D19452A2A511EC780EEEE090,31931,1,16,15,109.54771,18.29403,1667
120560,4D190727D19452A2A511EC780EEEE090,30921,17,20,3,109.53903,18.29451,1667
120612,F3E280D806C0279BCC08880D6A71DAC7,60621,0,7,7,109.48354,18.27451,1464
120613,F3E280D806C0279BCC08880D6A71DAC7,30861,8,10,2,109.52722,18.22743,1606
120614,F3E280D806C0279BCC08880D6A71DAC7,30711,10,12,2,109.50271,18.25347,1510
120615,F3E280D806C0279BCC08880D6A71DAC7,30861,12,14,2,109.52722,18.22743,1606
120641,9702FCEDFD09C98955AD4D2BA1E889FB,30221,0,9,9,109.57833,18.20222,1802
120642,9702FCEDFD09C98955AD4D2BA1E889FB,30161,12,15,3,109.50042,18.24389,1508
120643,9702FCEDFD09C98955AD4D2BA1E889FB,60381,15,16,1,109.5241,18.22458,1605
120651,EB316856896788EC8FD871E122E95728,31811,2,16,14,109.54201,18.31806,1671
120652,EB316856896788EC8FD871E122E95728,30701,20,23,3,109.59313,18.32007,1871
120658,8F3DE08315D720DC64DC898C5903196E,30854,0,12,12,109.56889,18.27076,1763
120659,8F3DE08315D720DC64DC898C5903196E,60631,16,17,1,109.57778,18.27583,1814
120660,8F3DE08315D720DC64DC898C5903196E,30854,21,23,2,109.56889,18.27076,1763
120698,878FC5EBB1B28FAABA6E6BFD01664318,30251,0,16,16,109.50611,18.26653,1512
120699,878FC5EBB1B28FAABA6E6BFD01664318,30711,21,22,1,109.50271,18.25347,1510
120711,BC81783A71088C7320F6E595223A70F0,39111,17,18,1,109.5191,18.22597,1555
120712,BC81783A71088C7320F6E595223A70F0,30571,19,22,3,109.50243,18.21861,1504
120720,50AA1262E2A8C18D2F0FC1A87B60622A,30761,0,7,7,109.45201,18.3,1318
120721,50AA1262E2A8C18D2F0FC1A87B60622A,31473,9,10,1,109.34792,18.29465,917
120722,50AA1262E2A8C18D2F0FC1A87B60622A,39281,11,13,2,109.21333,18.30271,418
120723,50AA1262E2A8C18D2F0FC1A87B60622A,30504,13,14,1,109.705,18.35368,2277
120795,7B468825EC3CAA1A3172074B4283732A,38911,3,5,2,109.51674,18.24965,1559
120796,7B468825EC3CAA1A3172074B4283732A,31201,7,19,12,109.51042,18.23819,1558
120797,7B468825EC3CAA1A3172074B4283732A,38291,19,21,2,109.51618,18.24313,1558
120837,278D81878D480BD6212A8447217A6EDC,38951,0,7,7,109.48097,18.28868,1416
120838,278D81878D480BD6212A8447217A6EDC,30731,9,10,1,109.50944,18.22306,1555
120840,278D81878D480BD6212A8447217A6EDC,38951,19,20,1,109.48097,18.28868,1416
120843,D8898064D7FB8C9B8CE800B6EE2F87B6,39371,0,3,3,109.56627,18.2646,1762
120844,D8898064D7FB8C9B8CE800B6EE2F87B6,30232,4,6,2,109.6191,18.31701,1971
120845,C8A5539982743C3D86E28F8FF2DA3472,30851,0,1,1,109.5616,18.27396,1713
120846,C8A5539982743C3D86E28F8FF2DA3472,39183,3,5,2,109.55542,18.28208,1715
120847,C8A5539982743C3D86E28F8FF2DA3472,30851,5,9,4,109.5616,18.27396,1713
120848,C8A5539982743C3D86E28F8FF2DA3472,30951,13,16,3,109.56208,18.25667,1761
120849,C8A5539982743C3D86E28F8FF2DA3472,30851,16,18,2,109.5616,18.27396,1713
120850,C8A5539982743C3D86E28F8FF2DA3472,30951,18,23,5,109.56208,18.25667,1761
120871,0752016172D76C2FA5B502EA35B445D1,31061,13,15,2,109.53333,18.23257,1607
120873,EBD16061EA20EE33D9344D33735E5205,60291,14,15,1,109.50826,18.24639,1509
120874,EBD16061EA20EE33D9344D33735E5205,31261,16,18,2,109.51174,18.2466,1559
120875,EBD16061EA20EE33D9344D33735E5205,31201,18,19,1,109.51042,18.23819,1558
120890,E5683D11169421C37F2AD1C30BD8C50E,31701,12,13,1,109.44132,18.28833,1266
120891,E5683D11169421C37F2AD1C30BD8C50E,38871,14,16,2,109.44681,18.28625,1316
120892,E5683D11169421C37F2AD1C30BD8C50E,31701,17,23,6,109.44132,18.28833,1266
120915,B164B8C0AEC0E295C9ED3DBE75B5D547,30391,0,7,7,109.4975,18.27118,1513
120916,B164B8C0AEC0E295C9ED3DBE75B5D547,31145,11,14,3,109.20431,18.30479,369
120917,B164B8C0AEC0E295C9ED3DBE75B5D547,60241,16,19,3,109.53319,18.28667,1616
120918,6EC37ACBAC0C5AEE7B19344F1CE4D7FD,60371,1,10,9,109.53063,18.30056,1618
120919,6EC37ACBAC0C5AEE7B19344F1CE4D7FD,30171,11,18,7,109.48458,18.27139,1463
120946,227F65E7B24D316553263A366D9E7A26,60054,17,18,1,109.3016,18.31229,770
120947,227F65E7B24D316553263A366D9E7A26,38316,19,20,1,109.48542,18.27424,1464
120948,227F65E7B24D316553263A366D9E7A26,38361,21,23,2,109.43667,18.29201,1267
120970,E0ECAC4E0CFA2260974D12289822AE4D,60344,13,14,1,109.68847,18.31931,2221
120983,8BF73979F60E5F1BAAE4266406EB9535,31071,0,1,1,109.58257,18.28458,1815
120984,8BF73979F60E5F1BAAE4266406EB9535,60631,6,14,8,109.57778,18.27583,1814
121025,383B8096A1AEABDC9C7425EF83D01D0D,30764,0,5,5,109.45806,18.29486,1367
121026,383B8096A1AEABDC9C7425EF83D01D0D,31145,10,13,3,109.20431,18.30479,369
121027,383B8096A1AEABDC9C7425EF83D01D0D,38071,17,18,1,109.40722,18.30938,1169
121051,5EBEA276FCB4A19AC5C987F5C7CC8908,38361,0,3,3,109.43667,18.29201,1267
121052,5EBEA276FCB4A19AC5C987F5C7CC8908,60504,4,7,3,109.47917,18.28903,1416
121053,5EBEA276FCB4A19AC5C987F5C7CC8908,38361,12,20,8,109.43667,18.29201,1267
121054,5EBEA276FCB4A19AC5C987F5C7CC8908,60552,21,22,1,109.41729,18.30014,1218
121069,7B1A07C39637E996C01DF0A3D287D3C6,30711,8,10,2,109.50271,18.25347,1510
121070,7B1A07C39637E996C01DF0A3D287D3C6,30421,11,15,4,109.50021,18.25861,1511
121071,7B1A07C39637E996C01DF0A3D287D3C6,30854,17,20,3,109.56889,18.27076,1763
121072,7B1A07C39637E996C01DF0A3D287D3C6,31071,20,21,1,109.58257,18.28458,1815
121077,A6EB260DA8BD57CCA91D7ED5707C036F,60551,19,20,1,109.42722,18.30111,1218
121078,A6EB260DA8BD57CCA91D7ED5707C036F,31081,21,23,2,109.44639,18.30181,1318
121079,DB4DF566D4757FF3BB488F82DE126248,31561,0,6,6,109.56792,18.28479,1765
121080,DB4DF566D4757FF3BB488F82DE126248,30851,9,12,3,109.5616,18.27396,1713
121081,DB4DF566D4757FF3BB488F82DE126248,31561,14,20,6,109.56792,18.28479,1765
121096,FBC323A047041F71D8997C22FDE88F17,30181,0,9,9,109.51597,18.23313,1557
121102,0312B43ACF9ED1D8304E325E851AEE29,30851,7,11,4,109.5616,18.27396,1713
121103,0312B43ACF9ED1D8304E325E851AEE29,31561,14,17,3,109.56792,18.28479,1765
121104,0312B43ACF9ED1D8304E325E851AEE29,30851,18,21,3,109.5616,18.27396,1713
121148,67D30B307FD4639F5D7DA8C23EB3E033,31521,21,23,2,109.51458,18.22542,1555
121239,4EEB87EFD2F33BBAF42BE530271C40CA,60211,0,11,11,109.63549,18.26049,2011
121273,6D96BF634D820B0C16A2EAF0705D9C13,38105,0,9,9,109.40299,18.29229,1117
121274,6D96BF634D820B0C16A2EAF0705D9C13,30711,10,13,3,109.50271,18.25347,1510
121275,6D96BF634D820B0C16A2EAF0705D9C13,30351,18,19,1,109.41701,18.29292,1217
121276,6D96BF634D820B0C16A2EAF0705D9C13,31236,19,21,2,109.42965,18.29111,1216
121277,6D96BF634D820B0C16A2EAF0705D9C13,38105,21,23,2,109.40299,18.29229,1117
121348,B4FB57E4B2E989AA5D9886D07ECD1856,31021,11,13,2,109.49021,18.27,1463
121393,0C8D15C0488D521680F0DE3A28CFE111,31811,0,6,6,109.54201,18.31806,1671
121394,0C8D15C0488D521680F0DE3A28CFE111,30701,7,12,5,109.59313,18.32007,1871
121395,0C8D15C0488D521680F0DE3A28CFE111,31811,16,19,3,109.54201,18.31806,1671
121421,CA3896FB33E9BC68E91955EDFF5D709B,30854,0,7,7,109.56889,18.27076,1763
121422,CA3896FB33E9BC68E91955EDFF5D709B,31945,12,13,1,109.58021,18.29403,1817
121423,CA3896FB33E9BC68E91955EDFF5D709B,30854,13,14,1,109.56889,18.27076,1763
121424,CA3896FB33E9BC68E91955EDFF5D709B,31071,18,20,2,109.58257,18.28458,1815
121437,45CCFCD3EBDF941E1C92B70ED06E8B5E,30854,1,8,7,109.56889,18.27076,1763
121447,FAEBF0037C912F8E011A2CDDDE2F2A72,31561,0,20,20,109.56792,18.28479,1765
121448,FAEBF0037C912F8E011A2CDDDE2F2A72,31931,21,22,1,109.54771,18.29403,1667
121476,A2F498F18C66416187F7445E3041DB7D,38154,0,18,18,109.5266,18.28278,1615
121477,A2F498F18C66416187F7445E3041DB7D,31031,18,20,2,109.49979,18.25382,1510
121478,A2F498F18C66416187F7445E3041DB7D,30121,21,23,2,109.52861,18.27222,1613
121519,35011D65DB8F346A960E649EB3FC56D5,30181,1,8,7,109.51597,18.23313,1557
121520,35011D65DB8F346A960E649EB3FC56D5,31781,9,11,2,109.19847,18.2975,367
121521,35011D65DB8F346A960E649EB3FC56D5,31471,12,14,2,109.34583,18.29563,917
121522,35011D65DB8F346A960E649EB3FC56D5,60381,18,19,1,109.5241,18.22458,1605
121677,6AF6E3AFD18EC04099B3351F858D9C1A,38251,1,5,4,109.49618,18.25493,1510
121678,6AF6E3AFD18EC04099B3351F858D9C1A,30421,5,7,2,109.50021,18.25861,1511
121679,6AF6E3AFD18EC04099B3351F858D9C1A,30941,8,11,3,109.5559,18.33938,1724
121680,6AF6E3AFD18EC04099B3351F858D9C1A,30421,13,17,4,109.50021,18.25861,1511
121681,6AF6E3AFD18EC04099B3351F858D9C1A,31031,17,18,1,109.49979,18.25382,1510
121682,6AF6E3AFD18EC04099B3351F858D9C1A,38251,20,21,1,109.49618,18.25493,1510
121683,6AF6E3AFD18EC04099B3351F858D9C1A,30421,22,23,1,109.50021,18.25861,1511
121706,14DC9638CB494ECD60B58F300BAA61B6,39181,0,6,6,109.55153,18.28035,1715
121707,14DC9638CB494ECD60B58F300BAA61B6,39181,7,11,4,109.55153,18.28035,1715
121708,14DC9638CB494ECD60B58F300BAA61B6,31931,16,17,1,109.54771,18.29403,1667
121709,14DC9638CB494ECD60B58F300BAA61B6,39181,17,23,6,109.55153,18.28035,1715
121717,AF27DD9820BE593B2206448B2F0BE633,30731,16,17,1,109.50944,18.22306,1555
121718,AF27DD9820BE593B2206448B2F0BE633,30421,21,23,2,109.50021,18.25861,1511
121721,FD7C837735324857FB2455A0BEC9A52A,30771,0,6,6,109.49938,18.26042,1511
121732,11150C7195A88F4196F1FFE1C448FD6F,60631,13,16,3,109.57778,18.27583,1814
121733,11150C7195A88F4196F1FFE1C448FD6F,31521,19,23,4,109.51458,18.22542,1555
121758,EF0AF6DFF11E792E87881ED5E6F91398,38154,0,5,5,109.5266,18.28278,1615
121759,EF0AF6DFF11E792E87881ED5E6F91398,39183,10,17,7,109.55542,18.28208,1715
121760,EF0AF6DFF11E792E87881ED5E6F91398,30721,18,23,5,109.51597,18.28257,1565
121764,C93386A9D86FE22A1FD4E5116045DD8D,31561,0,5,5,109.56792,18.28479,1765
121765,C93386A9D86FE22A1FD4E5116045DD8D,39183,7,11,4,109.55542,18.28208,1715
121766,C93386A9D86FE22A1FD4E5116045DD8D,31561,11,12,1,109.56792,18.28479,1765
121767,C93386A9D86FE22A1FD4E5116045DD8D,39183,13,18,5,109.55542,18.28208,1715
121815,5DECC6165B3BF52A1C1296A87F7EEF96,60614,0,6,6,109.48799,18.29521,1467
121816,5DECC6165B3BF52A1C1296A87F7EEF96,30731,9,10,1,109.50944,18.22306,1555
121818,BAFDD3A022A674BA6CCC93E365FAFC36,30084,0,1,1,109.50118,18.26972,1513
121819,BAFDD3A022A674BA6CCC93E365FAFC36,30201,1,8,7,109.4909,18.26465,1462
121820,BAFDD3A022A674BA6CCC93E365FAFC36,31461,12,13,1,109.5091,18.25389,1510
121822,386A993804AE7686717510E63DEFF753,30161,20,21,1,109.50042,18.24389,1508
121829,6922BA0A8A687E9D4AF0B3AA8BA87031,30371,11,12,1,109.51,18.24771,1559
121870,7B596B6BEF2AFA6C9AB0582C35D0C3A4,30681,0,8,8,109.48493,18.26917,1463
121871,7B596B6BEF2AFA6C9AB0582C35D0C3A4,31473,9,11,2,109.34792,18.29465,917
121872,7B596B6BEF2AFA6C9AB0582C35D0C3A4,60121,12,13,1,109.74507,18.37472,2430
121873,7B596B6BEF2AFA6C9AB0582C35D0C3A4,31931,17,20,3,109.54771,18.29403,1667
121912,3977578BE56276DA0700B04B81DC1356,31561,10,20,10,109.56792,18.28479,1765
121913,3977578BE56276DA0700B04B81DC1356,30851,20,23,3,109.5616,18.27396,1713
121955,919B6D6CA33899F0F2E7C2D48DA4283C,39321,0,9,9,109.529,18.2167,1604
121985,6587551DA47309E484D1302521C8D417,60381,18,19,1,109.5241,18.22458,1605
121986,6587551DA47309E484D1302521C8D417,60631,20,21,1,109.57778,18.27583,1814
121998,F906020841F7A567A604408BD6917A8B,30371,0,1,1,109.51,18.24771,1559
121999,F906020841F7A567A604408BD6917A8B,31201,1,3,2,109.51042,18.23819,1558
122000,F906020841F7A567A604408BD6917A8B,39191,3,7,4,109.51493,18.23472,1557
122001,F906020841F7A567A604408BD6917A8B,31206,7,9,2,109.50819,18.23549,1507
122002,F906020841F7A567A604408BD6917A8B,30361,10,11,1,109.50347,18.24,1508
122003,F906020841F7A567A604408BD6917A8B,31205,17,19,2,109.51111,18.23736,1557
122004,F906020841F7A567A604408BD6917A8B,31206,20,22,2,109.50819,18.23549,1507
122024,AD608A919061B1C684914F8654FB2493,60041,0,1,1,109.39889,18.31944,1121
122025,AD608A919061B1C684914F8654FB2493,30221,4,5,1,109.57833,18.20222,1802
122026,AD608A919061B1C684914F8654FB2493,31471,7,9,2,109.34583,18.29563,917
122027,AD608A919061B1C684914F8654FB2493,30651,11,15,4,109.42611,18.385,1232
122028,D37BF241A4A35F0F341582CAF9EF0DD2,39101,0,8,8,109.50132,18.24931,1509
122029,D37BF241A4A35F0F341582CAF9EF0DD2,30421,8,11,3,109.50021,18.25861,1511
122030,D37BF241A4A35F0F341582CAF9EF0DD2,30711,13,14,1,109.50271,18.25347,1510
122033,A445ADAE9143F5DE61C0D7609DA16439,60131,0,6,6,109.49819,18.24778,1509
122034,A445ADAE9143F5DE61C0D7609DA16439,30681,6,7,1,109.48493,18.26917,1463
122035,A445ADAE9143F5DE61C0D7609DA16439,31781,11,13,2,109.19847,18.2975,367
122036,A445ADAE9143F5DE61C0D7609DA16439,38754,16,19,3,109.74667,18.37382,2430
122037,A445ADAE9143F5DE61C0D7609DA16439,30211,22,23,1,109.49882,18.23931,1508
122099,9111D45CF0ACFF1F78F6B2A96D11CE9D,31145,13,15,2,109.20431,18.30479,369
122100,9111D45CF0ACFF1F78F6B2A96D11CE9D,60431,16,19,3,109.46139,18.32861,1373
122101,9111D45CF0ACFF1F78F6B2A96D11CE9D,31351,21,23,2,109.4959,18.28417,1465
122105,0E129C09250C0D46273B4BD7E5225556,30151,0,7,7,109.50986,18.25083,1560
122106,0E129C09250C0D46273B4BD7E5225556,60201,8,11,3,109.5041,18.2509,1510
122107,0E129C09250C0D46273B4BD7E5225556,60441,14,16,2,109.46792,18.28604,1366
122108,0E129C09250C0D46273B4BD7E5225556,30151,21,23,2,109.50986,18.25083,1560
122123,42815E00E74F2DEE06DE8ADA6B858662,31561,0,2,2,109.56792,18.28479,1765
122124,42815E00E74F2DEE06DE8ADA6B858662,31071,3,4,1,109.58257,18.28458,1815
122125,42815E00E74F2DEE06DE8ADA6B858662,31561,5,8,3,109.56792,18.28479,1765
122126,42815E00E74F2DEE06DE8ADA6B858662,30854,8,12,4,109.56889,18.27076,1763
122127,42815E00E74F2DEE06DE8ADA6B858662,31561,15,17,2,109.56792,18.28479,1765
122128,42815E00E74F2DEE06DE8ADA6B858662,30854,20,23,3,109.56889,18.27076,1763
122129,8CF3C85B5C8D39E684EB13FC9B018A44,38157,0,16,16,109.51483,18.26958,1563
122130,8CF3C85B5C8D39E684EB13FC9B018A44,39101,17,19,2,109.50132,18.24931,1509
122131,8CF3C85B5C8D39E684EB13FC9B018A44,30201,19,20,1,109.4909,18.26465,1462
122141,1D4558B4C0B5F77B61048106C84086AA,31091,0,6,6,109.41201,18.31222,1170
122142,1D4558B4C0B5F77B61048106C84086AA,30354,6,11,5,109.42813,18.29076,1216
122143,1D4558B4C0B5F77B61048106C84086AA,31231,13,15,2,109.42597,18.29292,1217
122162,56C8C781972E8BFAF8A768A19AD7F590,38127,19,23,4,109.50833,18.27222,1513
122163,44CB5F545D2E3587ACF209AB2414C1A1,30854,16,18,2,109.56889,18.27076,1763
122164,44CB5F545D2E3587ACF209AB2414C1A1,31071,18,20,2,109.58257,18.28458,1815
122179,C709D01469E0800AF998DFAF42105CDC,30854,0,1,1,109.56889,18.27076,1763
122180,C709D01469E0800AF998DFAF42105CDC,31561,6,17,11,109.56792,18.28479,1765
122181,C709D01469E0800AF998DFAF42105CDC,60661,18,20,2,109.548,18.2377,1657
122203,173CD7A2B7B334BC53A50A1D248FBCFE,31071,2,18,16,109.58257,18.28458,1815
122204,173CD7A2B7B334BC53A50A1D248FBCFE,30854,19,22,3,109.56889,18.27076,1763
122205,173CD7A2B7B334BC53A50A1D248FBCFE,31071,22,23,1,109.58257,18.28458,1815
122210,451E2BF48CD7B253EB0892324E679BCC,60281,7,9,2,109.51743,18.25924,1561
122211,451E2BF48CD7B253EB0892324E679BCC,38291,9,13,4,109.51618,18.24313,1558
122212,451E2BF48CD7B253EB0892324E679BCC,60281,13,18,5,109.51743,18.25924,1561
122213,451E2BF48CD7B253EB0892324E679BCC,38291,18,21,3,109.51618,18.24313,1558
122225,4DB778A581941E2A7955D8DA3B7ADAFE,30721,0,6,6,109.51597,18.28257,1565
122226,4DB778A581941E2A7955D8DA3B7ADAFE,31521,10,11,1,109.51458,18.22542,1555
122227,4DB778A581941E2A7955D8DA3B7ADAFE,31321,15,18,3,109.63799,18.23201,2007
122228,4DB778A581941E2A7955D8DA3B7ADAFE,30721,20,23,3,109.51597,18.28257,1565
122334,DDE77D3A656666992FC3458B84010D43,39183,0,3,3,109.55542,18.28208,1715
122335,DDE77D3A656666992FC3458B84010D43,31561,7,8,1,109.56792,18.28479,1765
122336,DDE77D3A656666992FC3458B84010D43,39183,11,23,12,109.55542,18.28208,1715
122349,529A14F498129B0238F7B12A9FC7F6F7,31205,0,2,2,109.51111,18.23736,1557
122350,529A14F498129B0238F7B12A9FC7F6F7,31671,3,6,3,109.38965,18.29813,1068
122351,529A14F498129B0238F7B12A9FC7F6F7,60561,6,7,1,109.38229,18.29785,1067
122364,38A8595594DC26AD8BE733FC85DB4CA6,31631,0,6,6,109.59542,18.36826,1879
122365,38A8595594DC26AD8BE733FC85DB4CA6,30101,7,8,1,109.57299,18.33333,1773
122366,38A8595594DC26AD8BE733FC85DB4CA6,31631,10,15,5,109.59542,18.36826,1879
122367,38A8595594DC26AD8BE733FC85DB4CA6,30101,16,20,4,109.57299,18.33333,1773
122368,38A8595594DC26AD8BE733FC85DB4CA6,31631,21,23,2,109.59542,18.36826,1879
122369,2C3BD53A8702A47FB82F05FB4993B683,31561,0,5,5,109.56792,18.28479,1765
122370,2C3BD53A8702A47FB82F05FB4993B683,39183,8,9,1,109.55542,18.28208,1715
122371,2C3BD53A8702A47FB82F05FB4993B683,31561,12,13,1,109.56792,18.28479,1765
122372,2C3BD53A8702A47FB82F05FB4993B683,39181,16,17,1,109.55153,18.28035,1715
122405,9646DACA260879D32095F9107B2CAA8C,31861,0,8,8,109.49042,18.27549,1464
122406,9646DACA260879D32095F9107B2CAA8C,30581,12,15,3,109.62257,18.24951,1959
122407,9646DACA260879D32095F9107B2CAA8C,31101,15,17,2,109.65389,18.23403,2057
122408,9646DACA260879D32095F9107B2CAA8C,60281,18,23,5,109.51743,18.25924,1561
122432,6EA0DFD1737FA2AEC669564CE705470D,31471,12,15,3,109.34583,18.29563,917
122433,6EA0DFD1737FA2AEC669564CE705470D,39321,18,23,5,109.529,18.2167,1604
122434,F6A1EBB84FE583E84185C423218578F5,31561,0,5,5,109.56792,18.28479,1765
122435,F6A1EBB84FE583E84185C423218578F5,39183,6,7,1,109.55542,18.28208,1715
122436,F6A1EBB84FE583E84185C423218578F5,31561,12,20,8,109.56792,18.28479,1765
122459,6C7ED3624E68752261C6DDD9B9B25EC7,30771,0,6,6,109.49938,18.26042,1511
122470,DBBA2FA4D62490D0FF290E7C10C068BA,33051,12,15,3,109.6475,18.46618,2096
122471,DBBA2FA4D62490D0FF290E7C10C068BA,30361,18,20,2,109.50347,18.24,1508
122529,B0D3EC92066D758E0973317388F707DC,31091,9,11,2,109.41201,18.31222,1170
122546,0E1B3CFC64EBB658DA96D0DCA834701E,61011,0,3,3,109.60653,18.19076,1900
122548,0E1B3CFC64EBB658DA96D0DCA834701E,61011,5,6,1,109.60653,18.19076,1900
122550,0E1B3CFC64EBB658DA96D0DCA834701E,61011,13,15,2,109.60653,18.19076,1900
122552,0E1B3CFC64EBB658DA96D0DCA834701E,61011,19,21,2,109.60653,18.19076,1900
122563,0E56047C2113CB9384943BEBAA9FF06B,31031,0,10,10,109.49979,18.25382,1510
122564,0E56047C2113CB9384943BEBAA9FF06B,30711,13,14,1,109.50271,18.25347,1510
122565,0E56047C2113CB9384943BEBAA9FF06B,31031,16,17,1,109.49979,18.25382,1510
122566,0E56047C2113CB9384943BEBAA9FF06B,38251,20,22,2,109.49618,18.25493,1510
122596,9A97E6A6C28BF8601BAF2B58A288DD94,30181,0,8,8,109.51597,18.23313,1557
122597,9A97E6A6C28BF8601BAF2B58A288DD94,31521,9,11,2,109.51458,18.22542,1555
122618,D39D64452E6BBEF7B3056CA239E1B86E,30854,0,5,5,109.56889,18.27076,1763
122619,D39D64452E6BBEF7B3056CA239E1B86E,31561,7,11,4,109.56792,18.28479,1765
122620,D39D64452E6BBEF7B3056CA239E1B86E,30854,11,23,12,109.56889,18.27076,1763
122639,27807A90EEF89DC13670DAE71E12FEAA,31021,1,5,4,109.49021,18.27,1463
122640,27807A90EEF89DC13670DAE71E12FEAA,31861,5,8,3,109.49042,18.27549,1464
122641,27807A90EEF89DC13670DAE71E12FEAA,31021,8,10,2,109.49021,18.27,1463
122642,27807A90EEF89DC13670DAE71E12FEAA,31471,11,13,2,109.34583,18.29563,917
122643,27807A90EEF89DC13670DAE71E12FEAA,30201,15,21,6,109.4909,18.26465,1462
122657,40C57F24FE0409ABB752B2031C349577,38951,0,12,12,109.48097,18.28868,1416
122658,40C57F24FE0409ABB752B2031C349577,60041,13,15,2,109.39889,18.31944,1121
122659,40C57F24FE0409ABB752B2031C349577,31171,17,21,4,109.50938,18.24917,1559
122728,1FE2866848043A2C10AD87212485FE15,31071,14,15,1,109.58257,18.28458,1815
122729,1FE2866848043A2C10AD87212485FE15,30854,17,22,5,109.56889,18.27076,1763
122730,34AB502A442AA8EA4A7FB30471B204DB,60621,0,7,7,109.48354,18.27451,1464
122731,34AB502A442AA8EA4A7FB30471B204DB,31431,8,9,1,109.44639,18.29042,1316
122732,34AB502A442AA8EA4A7FB30471B204DB,60441,10,14,4,109.46792,18.28604,1366
122733,34AB502A442AA8EA4A7FB30471B204DB,38251,14,15,1,109.49618,18.25493,1510
122734,34AB502A442AA8EA4A7FB30471B204DB,30341,16,17,1,109.3625,18.29167,966
122735,34AB502A442AA8EA4A7FB30471B204DB,60621,21,23,2,109.48354,18.27451,1464
122739,82591CF1D9AFC5ADCA95A1BAF87D07E3,60361,0,18,18,109.51938,18.29681,1567
122740,82591CF1D9AFC5ADCA95A1BAF87D07E3,30771,20,23,3,109.49938,18.26042,1511
122798,CD576F1C1CDFB89E6A99A20E65927346,30854,0,14,14,109.56889,18.27076,1763
122799,CD576F1C1CDFB89E6A99A20E65927346,31561,14,18,4,109.56792,18.28479,1765
122814,9C7AFD6F67C3677E74C4343080215938,60401,0,1,1,109.47444,18.27583,1414
122815,9C7AFD6F67C3677E74C4343080215938,60621,1,7,6,109.48354,18.27451,1464
122816,9C7AFD6F67C3677E74C4343080215938,60401,8,10,2,109.47444,18.27583,1414
122817,9C7AFD6F67C3677E74C4343080215938,38754,13,17,4,109.74667,18.37382,2430
122818,9C7AFD6F67C3677E74C4343080215938,31851,21,23,2,109.71736,18.29007,2316
122854,DA3C0DB0AE9C0567FD2B83AC70391599,30084,20,23,3,109.50118,18.26972,1513
122868,0695D4E7B3E726CA09D841B87798B560,31561,0,2,2,109.56792,18.28479,1765
122869,0695D4E7B3E726CA09D841B87798B560,30854,5,21,16,109.56889,18.27076,1763
122871,0DA898A124E97B49A3BF26529562DEF2,39091,8,11,3,109.50097,18.25222,1510
122876,B712327B6033C61F37801CFD6DAC08AD,38484,0,14,14,109.53028,18.31528,1620
122877,B712327B6033C61F37801CFD6DAC08AD,38484,15,18,3,109.53028,18.31528,1620
122878,B712327B6033C61F37801CFD6DAC08AD,38484,19,22,3,109.53028,18.31528,1620
122886,35EC94F70B365181176929B34C1D5C52,60361,0,1,1,109.51938,18.29681,1567
122887,35EC94F70B365181176929B34C1D5C52,60221,2,8,6,109.52569,18.29188,1616
122888,35EC94F70B365181176929B34C1D5C52,60361,9,20,11,109.51938,18.29681,1567
122889,35EC94F70B365181176929B34C1D5C52,60221,21,23,2,109.52569,18.29188,1616
122896,F03C6507100C5B3FC97B83BF7CB2B714,31201,1,3,2,109.51042,18.23819,1558
122897,F03C6507100C5B3FC97B83BF7CB2B714,38094,4,8,4,109.45403,18.28778,1316
122898,F03C6507100C5B3FC97B83BF7CB2B714,31431,10,11,1,109.44639,18.29042,1316
122899,F03C6507100C5B3FC97B83BF7CB2B714,31031,12,13,1,109.49979,18.25382,1510
122986,6E33AC2E8E3C9A7A56D11F6F1ADE42AD,31471,15,16,1,109.34583,18.29563,917
122987,6E33AC2E8E3C9A7A56D11F6F1ADE42AD,30661,19,20,1,109.37028,18.24361,1008
123124,7FF3C6569A3990C03CAF6C52D3C8BC6C,31931,9,10,1,109.54771,18.29403,1667
123125,7FF3C6569A3990C03CAF6C52D3C8BC6C,60241,12,13,1,109.53319,18.28667,1616
123126,7FF3C6569A3990C03CAF6C52D3C8BC6C,30921,15,17,2,109.53903,18.29451,1667
123160,B78E7295CB13532B4E2C30EF158E297F,30851,0,1,1,109.5616,18.27396,1713
123161,B78E7295CB13532B4E2C30EF158E297F,31931,2,6,4,109.54771,18.29403,1667
123162,B78E7295CB13532B4E2C30EF158E297F,39183,9,10,1,109.55542,18.28208,1715
123163,B78E7295CB13532B4E2C30EF158E297F,30854,12,13,1,109.56889,18.27076,1763
123164,B78E7295CB13532B4E2C30EF158E297F,39183,16,18,2,109.55542,18.28208,1715
123166,0ACD42FBA28A767F44D73783967C8C23,31561,10,11,1,109.56792,18.28479,1765
123203,811CE7E060D5A10FC7748D88604CC4FD,31231,0,6,6,109.42597,18.29292,1217
123204,811CE7E060D5A10FC7748D88604CC4FD,30351,7,8,1,109.41701,18.29292,1217
123205,811CE7E060D5A10FC7748D88604CC4FD,30661,13,15,2,109.37028,18.24361,1008
123206,811CE7E060D5A10FC7748D88604CC4FD,30351,18,19,1,109.41701,18.29292,1217
123207,811CE7E060D5A10FC7748D88604CC4FD,31231,19,21,2,109.42597,18.29292,1217
123208,811CE7E060D5A10FC7748D88604CC4FD,30351,21,23,2,109.41701,18.29292,1217
123212,F47C4E1E39056C43B0AD32AC994AB7C0,31931,1,9,8,109.54771,18.29403,1667
123213,F47C4E1E39056C43B0AD32AC994AB7C0,30921,10,12,2,109.53903,18.29451,1667
123214,F47C4E1E39056C43B0AD32AC994AB7C0,31931,13,14,1,109.54771,18.29403,1667
123233,64EA917EAAD3EB55DA2ABB227203C131,60631,0,7,7,109.57778,18.27583,1814
123234,64EA917EAAD3EB55DA2ABB227203C131,30851,9,11,2,109.5616,18.27396,1713
123235,64EA917EAAD3EB55DA2ABB227203C131,60631,11,13,2,109.57778,18.27583,1814
123257,093E5BB31B9532442353DAE32D399080,30711,12,15,3,109.50271,18.25347,1510
123301,0F23B6E4E3B228AFE54C52B9B3D593D7,60524,0,9,9,109.42951,18.28993,1216
123302,0F23B6E4E3B228AFE54C52B9B3D593D7,60551,9,15,6,109.42722,18.30111,1218
123303,0F23B6E4E3B228AFE54C52B9B3D593D7,60524,18,21,3,109.42951,18.28993,1216
123330,3A5AE4532B56D7B0975BA947CDAB0880,30711,17,19,2,109.50271,18.25347,1510
123331,3A5AE4532B56D7B0975BA947CDAB0880,38071,21,22,1,109.40722,18.30938,1169
123355,A928E9F6C796FE1A60807BA003DE87BB,39181,8,11,3,109.55153,18.28035,1715
123356,A928E9F6C796FE1A60807BA003DE87BB,30854,13,23,10,109.56889,18.27076,1763
123361,90C3DF1010756987F34232E3F39A7CF0,38754,14,15,1,109.74667,18.37382,2430
123380,80B72DFF870E58099F17893CA96A269C,31071,12,13,1,109.58257,18.28458,1815
123381,80B72DFF870E58099F17893CA96A269C,30711,17,19,2,109.50271,18.25347,1510
123382,80B72DFF870E58099F17893CA96A269C,31071,21,23,2,109.58257,18.28458,1815
123389,C52340445432E2026C0064423DB01697,39091,20,21,1,109.50097,18.25222,1510
123390,C52340445432E2026C0064423DB01697,30081,22,23,1,109.50243,18.26632,1512
123444,807332CEC38772FA8DF98C48FBD8DD1E,31561,7,13,6,109.56792,18.28479,1765
123445,807332CEC38772FA8DF98C48FBD8DD1E,39183,14,16,2,109.55542,18.28208,1715
123446,807332CEC38772FA8DF98C48FBD8DD1E,31561,16,18,2,109.56792,18.28479,1765
123447,97C31877CA4226D0F1BA1C0E12066B56,60331,0,6,6,109.505,18.26507,1512
123448,97C31877CA4226D0F1BA1C0E12066B56,30854,7,11,4,109.56889,18.27076,1763
123449,97C31877CA4226D0F1BA1C0E12066B56,31071,13,14,1,109.58257,18.28458,1815
123450,97C31877CA4226D0F1BA1C0E12066B56,30854,15,16,1,109.56889,18.27076,1763
123454,A549C024E6F63EDBD3DC866F10DB11CE,31071,0,2,2,109.58257,18.28458,1815
123455,A549C024E6F63EDBD3DC866F10DB11CE,30234,2,4,2,109.60681,18.29979,1918
123456,A549C024E6F63EDBD3DC866F10DB11CE,30854,8,20,12,109.56889,18.27076,1763
123457,D8681498A4BDCBE5A54E7CD864E651F0,38991,0,3,3,109.52681,18.30368,1618
123458,D8681498A4BDCBE5A54E7CD864E651F0,60371,4,5,1,109.53063,18.30056,1618
123463,70A62761FE79F922D082380DA7747243,30854,1,2,1,109.56889,18.27076,1763
123464,70A62761FE79F922D082380DA7747243,31561,2,4,2,109.56792,18.28479,1765
123465,70A62761FE79F922D082380DA7747243,30854,8,22,14,109.56889,18.27076,1763
123522,608A55C14BAB2A5B627ACC1F39B89FB6,31945,0,7,7,109.58021,18.29403,1817
123523,608A55C14BAB2A5B627ACC1F39B89FB6,30854,8,11,3,109.56889,18.27076,1763
123524,608A55C14BAB2A5B627ACC1F39B89FB6,31945,12,13,1,109.58021,18.29403,1817
123525,608A55C14BAB2A5B627ACC1F39B89FB6,30854,15,17,2,109.56889,18.27076,1763
123526,608A55C14BAB2A5B627ACC1F39B89FB6,31041,19,21,2,109.50278,18.23701,1507
123527,608A55C14BAB2A5B627ACC1F39B89FB6,31945,21,23,2,109.58021,18.29403,1817
123534,F2620FCAAD481C8B0F3979FFE2786ED4,38356,2,13,11,109.50201,18.21486,1504
123535,F2620FCAAD481C8B0F3979FFE2786ED4,38017,17,18,1,109.49729,18.21424,1504
123536,F2620FCAAD481C8B0F3979FFE2786ED4,38356,19,21,2,109.50201,18.21486,1504
123545,331C93B6083F5634586EEDFC958D0A76,60361,18,23,5,109.51938,18.29681,1567
123551,6631651FB15573A8B0C781F858B82603,38325,4,6,2,109.39792,18.2909,1116
123552,6631651FB15573A8B0C781F858B82603,31231,7,9,2,109.42597,18.29292,1217
123553,6631651FB15573A8B0C781F858B82603,38251,10,11,1,109.49618,18.25493,1510
123554,6631651FB15573A8B0C781F858B82603,30441,14,22,8,109.64021,18.25424,2010
123558,A42FFEAFA5B9964BE3187EAFF6B5CA9B,48647,0,9,9,109.48701,18.29042,1466
123590,8827A35309A216F0F6E4CBB2FFAC456D,30581,0,9,9,109.62257,18.24951,1959
123591,8827A35309A216F0F6E4CBB2FFAC456D,30441,10,12,2,109.64021,18.25424,2010
123598,AAB15CE7237752BF27667A21F2C9A310,31143,0,11,11,109.19986,18.29875,368
123599,AAB15CE7237752BF27667A21F2C9A310,31471,12,13,1,109.34583,18.29563,917
123600,AAB15CE7237752BF27667A21F2C9A310,31701,17,23,6,109.44132,18.28833,1266
123609,CFAA4900917F16A6BB33BA227F202636,30854,1,13,12,109.56889,18.27076,1763
123610,CFAA4900917F16A6BB33BA227F202636,31071,16,17,1,109.58257,18.28458,1815
123630,10EBF762D28520B09848288F7052CFDE,30854,0,6,6,109.56889,18.27076,1763
123631,10EBF762D28520B09848288F7052CFDE,39101,7,12,5,109.50132,18.24931,1509
123632,10EBF762D28520B09848288F7052CFDE,39101,13,19,6,109.50132,18.24931,1509
123633,10EBF762D28520B09848288F7052CFDE,39183,20,21,1,109.55542,18.28208,1715
123648,6E6193514D8E876D83956A94AD4F3FB1,31931,12,13,1,109.54771,18.29403,1667
123649,6E6193514D8E876D83956A94AD4F3FB1,30921,14,15,1,109.53903,18.29451,1667
123650,6E6193514D8E876D83956A94AD4F3FB1,31931,16,22,6,109.54771,18.29403,1667
123691,319C385C256C2264D15D0D4ABF1C5A6B,60221,16,19,3,109.52569,18.29188,1616
123692,319C385C256C2264D15D0D4ABF1C5A6B,31061,21,23,2,109.53333,18.23257,1607
123710,AAB3DCB18BAF89954DC0C8A658A6D766,31951,0,6,6,109.52174,18.30299,1568
123711,AAB3DCB18BAF89954DC0C8A658A6D766,38881,7,15,8,109.51618,18.26431,1562
123712,AAB3DCB18BAF89954DC0C8A658A6D766,30071,20,23,3,109.52819,18.30472,1619
123716,BE84D9BAD945F657EF3BFD7A07C2842B,31145,12,15,3,109.20431,18.30479,369
123717,BE84D9BAD945F657EF3BFD7A07C2842B,31321,18,20,2,109.63799,18.23201,2007
123718,BE84D9BAD945F657EF3BFD7A07C2842B,38054,22,23,1,109.63479,18.23097,2006
123732,39B496BBEDAF80FAB2852AC3F417A930,31021,9,10,1,109.49021,18.27,1463
123790,3066D3BA0EF6F55E10FAD924A6ADDDEF,30381,21,22,1,109.52521,18.24507,1609
123800,36CE0B7F7E529688FFEB22B8E93ED58F,30361,1,8,7,109.50347,18.24,1508
123801,36CE0B7F7E529688FFEB22B8E93ED58F,30241,10,11,1,109.26174,18.3275,622
123802,36CE0B7F7E529688FFEB22B8E93ED58F,31071,13,21,8,109.58257,18.28458,1815
123803,13166628932DF36C0AD7B1DB5811240A,39371,12,13,1,109.56627,18.2646,1762
123804,13166628932DF36C0AD7B1DB5811240A,30854,14,16,2,109.56889,18.27076,1763
123805,13166628932DF36C0AD7B1DB5811240A,39183,16,17,1,109.55542,18.28208,1715
123806,13166628932DF36C0AD7B1DB5811240A,60591,19,23,4,109.61118,18.21715,1904
123829,E605B26D53F08A0D3360A4541E09F4E2,30121,0,7,7,109.52861,18.27222,1613
123830,E605B26D53F08A0D3360A4541E09F4E2,38283,10,21,11,109.62229,18.22618,1956
123834,6DF7485545B790F22810B0EDD8F1B356,31945,0,7,7,109.58021,18.29403,1817
123835,6DF7485545B790F22810B0EDD8F1B356,30854,7,8,1,109.56889,18.27076,1763
123836,6DF7485545B790F22810B0EDD8F1B356,31945,12,13,1,109.58021,18.29403,1817
123837,6DF7485545B790F22810B0EDD8F1B356,30854,13,16,3,109.56889,18.27076,1763
123838,6DF7485545B790F22810B0EDD8F1B356,30151,17,19,2,109.50986,18.25083,1560
123839,6DF7485545B790F22810B0EDD8F1B356,31945,21,23,2,109.58021,18.29403,1817
123843,9837FB962D7F62E426A73EBD66CBBE03,30271,20,21,1,109.49132,18.23153,1456
123844,9837FB962D7F62E426A73EBD66CBBE03,30681,22,23,1,109.48493,18.26917,1463
123845,6D0CBC29417959EBDF12F1FD604A5C61,60661,0,5,5,109.548,18.2377,1657
123846,6D0CBC29417959EBDF12F1FD604A5C61,60381,7,8,1,109.5241,18.22458,1605
123847,6D0CBC29417959EBDF12F1FD604A5C61,39321,9,11,2,109.529,18.2167,1604
123851,DF410547949833E8F7EB071905643771,60524,1,3,2,109.42951,18.28993,1216
123852,DF410547949833E8F7EB071905643771,31861,6,7,1,109.49042,18.27549,1464
123853,DF410547949833E8F7EB071905643771,30441,11,13,2,109.64021,18.25424,2010
123854,DF410547949833E8F7EB071905643771,60221,15,18,3,109.52569,18.29188,1616
123855,DF410547949833E8F7EB071905643771,31861,19,23,4,109.49042,18.27549,1464
123962,0F558B6653C655C7F0BAEA9D66B33F57,31071,2,7,5,109.58257,18.28458,1815
123963,0F558B6653C655C7F0BAEA9D66B33F57,30854,7,22,15,109.56889,18.27076,1763
123964,0A29B4A7718F7E72873D130D95F796DA,38094,0,8,8,109.45403,18.28778,1316
123965,0A29B4A7718F7E72873D130D95F796DA,30764,10,11,1,109.45806,18.29486,1367
123966,0A29B4A7718F7E72873D130D95F796DA,60441,15,16,1,109.46792,18.28604,1366
123967,1026894DC5FF9A7FAF3A2EE28B95E239,30854,1,5,4,109.56889,18.27076,1763
123968,1026894DC5FF9A7FAF3A2EE28B95E239,39183,8,10,2,109.55542,18.28208,1715
123969,1026894DC5FF9A7FAF3A2EE28B95E239,30891,12,14,2,109.59431,18.28389,1865
123973,E732CF7BA1CEEB13C4CFF7B9D98D47F2,31181,14,15,1,109.50382,18.24813,1509
123974,E732CF7BA1CEEB13C4CFF7B9D98D47F2,60371,15,19,4,109.53063,18.30056,1618
123975,F9F2694056D54C70B8E94D439CF649C0,31571,1,9,8,109.61563,18.23326,1957
123976,F9F2694056D54C70B8E94D439CF649C0,31471,11,15,4,109.34583,18.29563,917
123977,F9F2694056D54C70B8E94D439CF649C0,30711,17,18,1,109.50271,18.25347,1510
123978,F9F2694056D54C70B8E94D439CF649C0,31221,20,21,1,109.61333,18.26833,1913
123979,F9F2694056D54C70B8E94D439CF649C0,38052,22,23,1,109.62618,18.23042,1956
123996,7421066246AAD1C230E7E2A7ADF06E9D,31071,1,2,1,109.58257,18.28458,1815
123997,7421066246AAD1C230E7E2A7ADF06E9D,60631,3,4,1,109.57778,18.27583,1814
123998,7421066246AAD1C230E7E2A7ADF06E9D,31071,9,10,1,109.58257,18.28458,1815
123999,7421066246AAD1C230E7E2A7ADF06E9D,30854,13,22,9,109.56889,18.27076,1763
124016,635490684ED92BDBB56F8F8FF98E24D2,39091,0,8,8,109.50097,18.25222,1510
124018,635490684ED92BDBB56F8F8FF98E24D2,30711,21,23,2,109.50271,18.25347,1510
124019,10026EC528DC65E6B062D4E8B47727C1,30281,18,22,4,109.50597,18.27583,1514
124020,10026EC528DC65E6B062D4E8B47727C1,31351,22,23,1,109.4959,18.28417,1465
124037,A01B4012B619D942E7CC3AC9B78722B4,31561,0,13,13,109.56792,18.28479,1765
124038,A01B4012B619D942E7CC3AC9B78722B4,39183,14,16,2,109.55542,18.28208,1715
124053,417408FFDA93B177641D270D3A5C4B2D,30854,0,4,4,109.56889,18.27076,1763
124054,417408FFDA93B177641D270D3A5C4B2D,31071,4,5,1,109.58257,18.28458,1815
124055,417408FFDA93B177641D270D3A5C4B2D,60631,6,10,4,109.57778,18.27583,1814
124056,417408FFDA93B177641D270D3A5C4B2D,30854,10,11,1,109.56889,18.27076,1763
124057,417408FFDA93B177641D270D3A5C4B2D,31071,13,14,1,109.58257,18.28458,1815
124058,417408FFDA93B177641D270D3A5C4B2D,60631,16,18,2,109.57778,18.27583,1814
124059,417408FFDA93B177641D270D3A5C4B2D,30854,20,23,3,109.56889,18.27076,1763
124090,6DA8429267883939CEB3C36824DAAEC3,31811,15,16,1,109.54201,18.31806,1671
124146,A4743972EC2FC58546DD11935BDC0E1A,39091,0,8,8,109.50097,18.25222,1510
124147,A4743972EC2FC58546DD11935BDC0E1A,30711,10,13,3,109.50271,18.25347,1510
124148,A4743972EC2FC58546DD11935BDC0E1A,39091,16,17,1,109.50097,18.25222,1510
124149,A4743972EC2FC58546DD11935BDC0E1A,39091,19,20,1,109.50097,18.25222,1510
124150,A4743972EC2FC58546DD11935BDC0E1A,31931,22,23,1,109.54771,18.29403,1667
124211,EFFEF00C078D502D6D0D1D469ACBA466,39041,0,8,8,109.40021,18.29278,1117
124212,EFFEF00C078D502D6D0D1D469ACBA466,31471,9,11,2,109.34583,18.29563,917
124213,EFFEF00C078D502D6D0D1D469ACBA466,39041,12,14,2,109.40021,18.29278,1117
124214,C5D5953F1870A58B2AFFAAD0551D4A89,60331,0,7,7,109.505,18.26507,1512
124215,C5D5953F1870A58B2AFFAAD0551D4A89,31931,9,10,1,109.54771,18.29403,1667
124216,C5D5953F1870A58B2AFFAAD0551D4A89,31351,12,13,1,109.4959,18.28417,1465
124217,C5D5953F1870A58B2AFFAAD0551D4A89,31931,13,14,1,109.54771,18.29403,1667
124218,C5D5953F1870A58B2AFFAAD0551D4A89,30911,18,23,5,109.50493,18.26181,1511
124270,D2A5F87218CF25385163A2F3C4229CB8,31561,0,5,5,109.56792,18.28479,1765
124271,D2A5F87218CF25385163A2F3C4229CB8,30851,5,22,17,109.5616,18.27396,1713
124280,561C33446D67FC6E6E2ADA3F2F9F59D1,38271,0,4,4,109.62632,18.23049,1956
124281,561C33446D67FC6E6E2ADA3F2F9F59D1,31321,5,8,3,109.63799,18.23201,2007
124282,561C33446D67FC6E6E2ADA3F2F9F59D1,38271,8,13,5,109.62632,18.23049,1956
124283,561C33446D67FC6E6E2ADA3F2F9F59D1,60071,14,23,9,109.75674,18.31583,2470
124305,147470AD3D3B8724582C30D5F244A8B6,60421,0,6,6,109.46333,18.31743,1371
124306,147470AD3D3B8724582C30D5F244A8B6,30111,7,10,3,109.47583,18.30542,1419
124307,147470AD3D3B8724582C30D5F244A8B6,60421,10,17,7,109.46333,18.31743,1371
124308,147470AD3D3B8724582C30D5F244A8B6,30111,18,20,2,109.47583,18.30542,1419
124314,39D0B119BCF23E40EF7A286F6A03CC6A,60594,0,2,2,109.62694,18.22799,1956
124315,39D0B119BCF23E40EF7A286F6A03CC6A,30131,2,6,4,109.6959,18.215,2254
124316,39D0B119BCF23E40EF7A286F6A03CC6A,38052,8,10,2,109.62618,18.23042,1956
124317,39D0B119BCF23E40EF7A286F6A03CC6A,60594,12,16,4,109.62694,18.22799,1956
124318,39D0B119BCF23E40EF7A286F6A03CC6A,38052,17,21,4,109.62618,18.23042,1956
124319,39D0B119BCF23E40EF7A286F6A03CC6A,60594,21,23,2,109.62694,18.22799,1956
124328,BD4652414D5C17466BA36FD4BD943A94,30721,1,2,1,109.51597,18.28257,1565
124329,BD4652414D5C17466BA36FD4BD943A94,60221,4,7,3,109.52569,18.29188,1616
124330,BD4652414D5C17466BA36FD4BD943A94,60381,12,14,2,109.5241,18.22458,1605
124331,BD4652414D5C17466BA36FD4BD943A94,60221,16,18,2,109.52569,18.29188,1616
124332,BD4652414D5C17466BA36FD4BD943A94,31041,22,23,1,109.50278,18.23701,1507
124394,0D62B1A1AE4A27E0E66F6B7C8CF804F4,31041,1,2,1,109.50278,18.23701,1507
124395,0D62B1A1AE4A27E0E66F6B7C8CF804F4,30181,2,6,4,109.51597,18.23313,1557
124396,0D62B1A1AE4A27E0E66F6B7C8CF804F4,31041,8,10,2,109.50278,18.23701,1507
124453,C85D0B931BEF54F05B9ABBBB03212DB7,30854,9,11,2,109.56889,18.27076,1763
124454,C85D0B931BEF54F05B9ABBBB03212DB7,31561,13,17,4,109.56792,18.28479,1765
124455,C85D0B931BEF54F05B9ABBBB03212DB7,30854,18,20,2,109.56889,18.27076,1763
124462,9A3188B823DC0B814D36D0F4BE27142F,31071,0,9,9,109.58257,18.28458,1815
124463,9A3188B823DC0B814D36D0F4BE27142F,31101,9,12,3,109.65389,18.23403,2057
124464,9A3188B823DC0B814D36D0F4BE27142F,31071,13,17,4,109.58257,18.28458,1815
124465,CDA1EB7B89E47C48A7CAC823B0773234,30391,0,8,8,109.4975,18.27118,1513
124466,CDA1EB7B89E47C48A7CAC823B0773234,30234,8,10,2,109.60681,18.29979,1918
124467,CDA1EB7B89E47C48A7CAC823B0773234,31161,10,13,3,109.70229,18.31361,2270
124476,0E1DB444F47235AEDAD0A0404A7B75B4,31561,0,7,7,109.56792,18.28479,1765
124477,0E1DB444F47235AEDAD0A0404A7B75B4,39181,9,12,3,109.55153,18.28035,1715
124478,0E1DB444F47235AEDAD0A0404A7B75B4,39183,14,18,4,109.55542,18.28208,1715
124479,0E1DB444F47235AEDAD0A0404A7B75B4,31561,19,20,1,109.56792,18.28479,1765
124480,0E1DB444F47235AEDAD0A0404A7B75B4,39183,20,23,3,109.55542,18.28208,1715
124524,88518ED3B6347887E74E353A92E1996C,31421,0,5,5,109.55382,18.22347,1705
124525,88518ED3B6347887E74E353A92E1996C,30681,7,8,1,109.48493,18.26917,1463
124526,88518ED3B6347887E74E353A92E1996C,60291,9,10,1,109.50826,18.24639,1509
124527,88518ED3B6347887E74E353A92E1996C,38325,12,13,1,109.39792,18.2909,1116
124528,88518ED3B6347887E74E353A92E1996C,60131,14,16,2,109.49819,18.24778,1509
124529,88518ED3B6347887E74E353A92E1996C,60281,17,21,4,109.51743,18.25924,1561
124582,258F9A09B3B0048D107FC9EF9EB27CDE,30421,8,11,3,109.50021,18.25861,1511
124583,258F9A09B3B0048D107FC9EF9EB27CDE,30711,11,12,1,109.50271,18.25347,1510
124584,258F9A09B3B0048D107FC9EF9EB27CDE,30421,14,16,2,109.50021,18.25861,1511
124585,258F9A09B3B0048D107FC9EF9EB27CDE,30421,17,20,3,109.50021,18.25861,1511
124586,258F9A09B3B0048D107FC9EF9EB27CDE,30421,20,23,3,109.50021,18.25861,1511
124604,82F42D74CE1CC00D6CC7F8D17CCF784D,31851,0,10,10,109.71736,18.29007,2316
124605,82F42D74CE1CC00D6CC7F8D17CCF784D,30361,12,13,1,109.50347,18.24,1508
124606,82F42D74CE1CC00D6CC7F8D17CCF784D,31931,16,22,6,109.54771,18.29403,1667
124627,C5A446AC7123103DC030E8D43C03C155,60221,0,9,9,109.52569,18.29188,1616
124628,C5A446AC7123103DC030E8D43C03C155,30421,12,13,1,109.50021,18.25861,1511
124629,C5A446AC7123103DC030E8D43C03C155,31031,13,15,2,109.49979,18.25382,1510
124630,C5A446AC7123103DC030E8D43C03C155,60221,16,22,6,109.52569,18.29188,1616
124652,F432BE98F277FF953CE263D7467BFC47,60381,17,19,2,109.5241,18.22458,1605
124653,F432BE98F277FF953CE263D7467BFC47,30351,19,23,4,109.41701,18.29292,1217
124658,044B260BB5F12A7C76BF06F0DD8F09A0,31521,16,18,2,109.51458,18.22542,1555
124659,044B260BB5F12A7C76BF06F0DD8F09A0,30181,19,20,1,109.51597,18.23313,1557
124752,34F3D64B41C252481F72E5CF931AC833,30851,18,21,3,109.5616,18.27396,1713
124753,34F3D64B41C252481F72E5CF931AC833,30854,22,23,1,109.56889,18.27076,1763
124769,53875E69050EC42E511A64D3211FA7B3,60631,3,4,1,109.57778,18.27583,1814
124770,53875E69050EC42E511A64D3211FA7B3,31071,5,6,1,109.58257,18.28458,1815
124771,53875E69050EC42E511A64D3211FA7B3,30854,10,11,1,109.56889,18.27076,1763
124791,95E09A72760B2799C2CC9BD7AF527107,30854,0,2,2,109.56889,18.27076,1763
124792,95E09A72760B2799C2CC9BD7AF527107,31071,4,23,19,109.58257,18.28458,1815
124800,C99018C5FE7BE36145E83B623599A9D0,31521,7,8,1,109.51458,18.22542,1555
124801,C99018C5FE7BE36145E83B623599A9D0,31521,9,16,7,109.51458,18.22542,1555
124802,C99018C5FE7BE36145E83B623599A9D0,31521,17,19,2,109.51458,18.22542,1555
124803,C99018C5FE7BE36145E83B623599A9D0,31521,20,23,3,109.51458,18.22542,1555
124809,8D8AA41210FC9E2D5DD4D81CF4DB18D7,30191,15,18,3,109.50361,18.22701,1506
124810,8D8AA41210FC9E2D5DD4D81CF4DB18D7,30281,19,21,2,109.50597,18.27583,1514
124814,BAB9B8A3D1E7FB96DB94A06687C464B3,60504,0,7,7,109.47917,18.28903,1416
124815,BAB9B8A3D1E7FB96DB94A06687C464B3,30581,9,14,5,109.62257,18.24951,1959
124816,BAB9B8A3D1E7FB96DB94A06687C464B3,38991,16,17,1,109.52681,18.30368,1618
124817,BAB9B8A3D1E7FB96DB94A06687C464B3,60571,18,21,3,109.50722,18.25056,1510
124818,BAB9B8A3D1E7FB96DB94A06687C464B3,60381,21,23,2,109.5241,18.22458,1605
124836,C3FE81ED5256B04BAEEBFAC334C8D570,30861,17,21,4,109.52722,18.22743,1606
124837,C3FE81ED5256B04BAEEBFAC334C8D570,31061,22,23,1,109.53333,18.23257,1607
124844,A952750F25C558E5C17B3EB7DD935431,31931,14,15,1,109.54771,18.29403,1667
124845,A952750F25C558E5C17B3EB7DD935431,60371,17,18,1,109.53063,18.30056,1618
124846,A952750F25C558E5C17B3EB7DD935431,31951,22,23,1,109.52174,18.30299,1568
124850,ABCD0851CC1C78BCD7AF6DBDF2F5DE49,60041,4,6,2,109.39889,18.31944,1121
124851,ABCD0851CC1C78BCD7AF6DBDF2F5DE49,60552,8,12,4,109.41729,18.30014,1218
124852,ABCD0851CC1C78BCD7AF6DBDF2F5DE49,60524,16,17,1,109.42951,18.28993,1216
124853,ABCD0851CC1C78BCD7AF6DBDF2F5DE49,60552,18,21,3,109.41729,18.30014,1218
124854,5E97A4561E11AAC4FBC53FD068EAA52B,30891,0,6,6,109.59431,18.28389,1865
124855,5E97A4561E11AAC4FBC53FD068EAA52B,30854,7,22,15,109.56889,18.27076,1763
124884,E6541B4F346982101D887BAAF0315541,30161,19,20,1,109.50042,18.24389,1508
124885,E6541B4F346982101D887BAAF0315541,31261,22,23,1,109.51174,18.2466,1559
124905,E5088AAA29200A61CA8A4F0D8DC29FB9,31521,16,21,5,109.51458,18.22542,1555
124906,E5088AAA29200A61CA8A4F0D8DC29FB9,30731,21,23,2,109.50944,18.22306,1555
124953,D792C662B1DB3D5110ED9FC86834DD73,31841,0,11,11,109.73201,18.33382,2373
124954,D792C662B1DB3D5110ED9FC86834DD73,39321,15,16,1,109.529,18.2167,1604
124955,D792C662B1DB3D5110ED9FC86834DD73,38094,18,19,1,109.45403,18.28778,1316
124956,D792C662B1DB3D5110ED9FC86834DD73,38071,20,22,2,109.40722,18.30938,1169
124957,B643AC77F8D8498A9694D45BA8B0F75F,60631,0,16,16,109.57778,18.27583,1814
124958,B643AC77F8D8498A9694D45BA8B0F75F,30854,21,22,1,109.56889,18.27076,1763
124999,63EC2A869FC00ECA459FA43A119B0B4B,60201,16,21,5,109.5041,18.2509,1510
125004,98EB1CF842CD30ED85E927AB3226642D,30234,3,6,3,109.60681,18.29979,1918
125005,98EB1CF842CD30ED85E927AB3226642D,30891,6,8,2,109.59431,18.28389,1865
125006,98EB1CF842CD30ED85E927AB3226642D,31071,11,23,12,109.58257,18.28458,1815
125036,F0276D651C6FE98B640C5224E9458C5B,60361,0,6,6,109.51938,18.29681,1567
125037,F0276D651C6FE98B640C5224E9458C5B,30681,8,9,1,109.48493,18.26917,1463
125038,F0276D651C6FE98B640C5224E9458C5B,38315,12,15,3,109.48979,18.29764,1467
125098,27BCEF3137923B84211F08830816C810,30851,18,23,5,109.5616,18.27396,1713
125129,E8EFAA5D1A201DE1B09CA7FAC04D4F91,38826,4,7,3,109.50326,18.25514,1510
125130,E8EFAA5D1A201DE1B09CA7FAC04D4F91,31781,11,13,2,109.19847,18.2975,367
125131,E8EFAA5D1A201DE1B09CA7FAC04D4F91,60221,18,20,2,109.52569,18.29188,1616
125132,E8EFAA5D1A201DE1B09CA7FAC04D4F91,30421,21,22,1,109.50021,18.25861,1511
125181,4D944399BAAD1AD37CC1D68A51FA53FD,30161,15,23,8,109.50042,18.24389,1508
125222,12B727D6483DEDBBC92CB35708DC3CFE,30281,0,6,6,109.50597,18.27583,1514
125223,12B727D6483DEDBBC92CB35708DC3CFE,30281,7,8,1,109.50597,18.27583,1514
125224,12B727D6483DEDBBC92CB35708DC3CFE,30211,11,12,1,109.49882,18.23931,1508
125225,12B727D6483DEDBBC92CB35708DC3CFE,30281,13,20,7,109.50597,18.27583,1514
125226,12B727D6483DEDBBC92CB35708DC3CFE,30281,20,23,3,109.50597,18.27583,1514
125229,283C1DB08EC53022FE9E85C662A0B611,38951,1,6,5,109.48097,18.28868,1416
125230,283C1DB08EC53022FE9E85C662A0B611,30941,7,9,2,109.5559,18.33938,1724
125231,283C1DB08EC53022FE9E85C662A0B611,38951,10,22,12,109.48097,18.28868,1416
125236,72D984C8386A232B13E9D168E7A1C5F8,60551,0,7,7,109.42722,18.30111,1218
125237,72D984C8386A232B13E9D168E7A1C5F8,30671,7,9,2,109.43611,18.30139,1268
125238,72D984C8386A232B13E9D168E7A1C5F8,38094,13,14,1,109.45403,18.28778,1316
125239,72D984C8386A232B13E9D168E7A1C5F8,60541,18,19,1,109.4084,18.29208,1167
125268,00FD2268DE6E83934D2916174E81532F,30111,2,3,1,109.47583,18.30542,1419
125269,00FD2268DE6E83934D2916174E81532F,30761,5,7,2,109.45201,18.3,1318
125270,00FD2268DE6E83934D2916174E81532F,60472,9,10,1,109.46625,18.29542,1367
125271,00FD2268DE6E83934D2916174E81532F,30111,11,22,11,109.47583,18.30542,1419
125309,B87EA32D7A8C628CB2B89E95996DDE3E,60371,1,7,6,109.53063,18.30056,1618
125310,B87EA32D7A8C628CB2B89E95996DDE3E,31931,12,16,4,109.54771,18.29403,1667
125311,B87EA32D7A8C628CB2B89E95996DDE3E,30921,16,21,5,109.53903,18.29451,1667
125312,B87EA32D7A8C628CB2B89E95996DDE3E,60371,22,23,1,109.53063,18.30056,1618
125313,B95D5FCFC7327770C14B6F9FFDB772BC,31071,1,4,3,109.58257,18.28458,1815
125314,B95D5FCFC7327770C14B6F9FFDB772BC,30854,7,8,1,109.56889,18.27076,1763
125315,B95D5FCFC7327770C14B6F9FFDB772BC,31071,8,9,1,109.58257,18.28458,1815
125335,B340EDEF4A878E8DF5CBEC25E465EACE,30854,3,12,9,109.56889,18.27076,1763
125336,B340EDEF4A878E8DF5CBEC25E465EACE,31071,12,14,2,109.58257,18.28458,1815
125337,B340EDEF4A878E8DF5CBEC25E465EACE,30854,14,22,8,109.56889,18.27076,1763
125373,F198CAA1F49ACA5D003FD8F8473B3798,30854,0,17,17,109.56889,18.27076,1763
125374,F198CAA1F49ACA5D003FD8F8473B3798,60463,18,21,3,109.52507,18.22438,1605
125442,C7A58F45156649A612134237290C5B69,30821,0,17,17,109.43681,18.33639,1274
125443,C7A58F45156649A612134237290C5B69,31081,20,21,1,109.44639,18.30181,1318
125455,8C5A16299A6D294198C90C34C25C5949,31561,0,2,2,109.56792,18.28479,1765
125456,8C5A16299A6D294198C90C34C25C5949,30854,3,23,20,109.56889,18.27076,1763
125459,552B98A65A23DB4CD390E78F3246E9C5,60241,0,8,8,109.53319,18.28667,1616
125460,552B98A65A23DB4CD390E78F3246E9C5,31931,9,10,1,109.54771,18.29403,1667
125461,552B98A65A23DB4CD390E78F3246E9C5,30921,13,14,1,109.53903,18.29451,1667
125462,552B98A65A23DB4CD390E78F3246E9C5,31931,15,17,2,109.54771,18.29403,1667
125463,552B98A65A23DB4CD390E78F3246E9C5,60241,21,23,2,109.53319,18.28667,1616
125492,E2CFBC4AD8BA700D32898ABFA9A0C849,30854,1,21,20,109.56889,18.27076,1763
125493,E2CFBC4AD8BA700D32898ABFA9A0C849,60631,21,22,1,109.57778,18.27583,1814
125494,B4A8648DE41BAD1E29E1F905692C2DB7,31031,19,20,1,109.49979,18.25382,1510
125495,B4A8648DE41BAD1E29E1F905692C2DB7,31531,21,23,2,109.49583,18.25972,1461
125545,51015BF65833D98716A0309741D1F1C2,30854,0,16,16,109.56889,18.27076,1763
125546,51015BF65833D98716A0309741D1F1C2,60463,18,21,3,109.52507,18.22438,1605
125554,C12FB46046E6CB3AEC59B310176A356F,31521,0,8,8,109.51458,18.22542,1555
125555,C12FB46046E6CB3AEC59B310176A356F,31691,10,12,2,109.36604,18.3075,1019
125556,C12FB46046E6CB3AEC59B310176A356F,31521,16,17,1,109.51458,18.22542,1555
125557,C12FB46046E6CB3AEC59B310176A356F,31031,18,19,1,109.49979,18.25382,1510
125558,C12FB46046E6CB3AEC59B310176A356F,31521,20,22,2,109.51458,18.22542,1555
125566,EA45533158A318D0CC45EE1B8E7FE07E,38073,3,8,5,109.40813,18.30958,1169
125567,EA45533158A318D0CC45EE1B8E7FE07E,30941,11,13,2,109.5559,18.33938,1724
125568,EA45533158A318D0CC45EE1B8E7FE07E,60221,16,18,2,109.52569,18.29188,1616
125569,EA45533158A318D0CC45EE1B8E7FE07E,39151,19,21,2,109.49875,18.25097,1510
125570,77E0479537D8350123531CE1FA2E6649,60631,0,7,7,109.57778,18.27583,1814
125571,77E0479537D8350123531CE1FA2E6649,31321,10,14,4,109.63799,18.23201,2007
125572,77E0479537D8350123531CE1FA2E6649,30854,16,22,6,109.56889,18.27076,1763
125597,0E0D6E55BB1995EBF85F6B7AA8765E55,30854,0,7,7,109.56889,18.27076,1763
125598,0E0D6E55BB1995EBF85F6B7AA8765E55,60631,8,9,1,109.57778,18.27583,1814
125599,0E0D6E55BB1995EBF85F6B7AA8765E55,30854,10,20,10,109.56889,18.27076,1763
125615,4BE8FEB7C7A1255367E8FF1F934ACEB2,30101,13,18,5,109.57299,18.33333,1773
125617,7AE891083A2B2C0292CFD40014FEF0E4,38973,0,8,8,109.51097,18.25389,1560
125619,7AE891083A2B2C0292CFD40014FEF0E4,30151,17,23,6,109.50986,18.25083,1560
125620,2D39AE6120F2674000C6DBB8A6E572A0,31945,0,7,7,109.58021,18.29403,1817
125621,2D39AE6120F2674000C6DBB8A6E572A0,30854,7,12,5,109.56889,18.27076,1763
125622,2D39AE6120F2674000C6DBB8A6E572A0,31945,12,13,1,109.58021,18.29403,1817
125623,2D39AE6120F2674000C6DBB8A6E572A0,31071,18,19,1,109.58257,18.28458,1815
125658,2D683B3AD358B28A27E068E80E3AA9C8,31945,2,3,1,109.58021,18.29403,1817
125659,2D683B3AD358B28A27E068E80E3AA9C8,31071,6,7,1,109.58257,18.28458,1815
125660,2D683B3AD358B28A27E068E80E3AA9C8,30854,7,21,14,109.56889,18.27076,1763
125673,770A00BDAFE9BCA8C9E9FA68066EED7D,31071,0,8,8,109.58257,18.28458,1815
125674,770A00BDAFE9BCA8C9E9FA68066EED7D,30851,9,13,4,109.5616,18.27396,1713
125675,770A00BDAFE9BCA8C9E9FA68066EED7D,31561,15,18,3,109.56792,18.28479,1765
125676,770A00BDAFE9BCA8C9E9FA68066EED7D,31071,20,23,3,109.58257,18.28458,1815
125679,C1F9914EF577AE2A8300B1A3945A50FF,30851,12,13,1,109.5616,18.27396,1713
125680,C1F9914EF577AE2A8300B1A3945A50FF,31071,14,22,8,109.58257,18.28458,1815
125686,FDC2B4BB960ACDA9822626D3DCBE25AF,31071,0,9,9,109.58257,18.28458,1815
125687,FDC2B4BB960ACDA9822626D3DCBE25AF,30854,12,20,8,109.56889,18.27076,1763
125769,533C598FBE9A80A69F24B4E517B0CF08,31351,0,19,19,109.4959,18.28417,1465
125770,533C598FBE9A80A69F24B4E517B0CF08,38251,20,21,1,109.49618,18.25493,1510
125801,60E3CB2A4B8EEDBCF8F5092F0306C0A3,30351,0,1,1,109.41701,18.29292,1217
125802,60E3CB2A4B8EEDBCF8F5092F0306C0A3,31231,2,7,5,109.42597,18.29292,1217
125862,41BDAE8841B5E7F15F794B60F93978D9,31031,18,20,2,109.49979,18.25382,1510
125863,41BDAE8841B5E7F15F794B60F93978D9,38251,21,23,2,109.49618,18.25493,1510
125903,BE8220A49F1231C0A022F4AA2075503E,31945,1,15,14,109.58021,18.29403,1817
125904,BE8220A49F1231C0A022F4AA2075503E,60031,18,20,2,109.49694,18.31632,1521
125921,B4818124F65C5DECA65889607824561E,30181,0,7,7,109.51597,18.23313,1557
125922,B4818124F65C5DECA65889607824561E,31521,12,13,1,109.51458,18.22542,1555
125923,B4818124F65C5DECA65889607824561E,30181,14,15,1,109.51597,18.23313,1557
125924,94C4D5691F7DFC1AB38806AFFAC1389E,31931,5,8,3,109.54771,18.29403,1667
125925,94C4D5691F7DFC1AB38806AFFAC1389E,39091,8,11,3,109.50097,18.25222,1510
125926,94C4D5691F7DFC1AB38806AFFAC1389E,31931,11,14,3,109.54771,18.29403,1667
125942,FFA78E97945507AFD9DEF992A707C4AC,31145,13,14,1,109.20431,18.30479,369
125943,FFA78E97945507AFD9DEF992A707C4AC,31471,15,17,2,109.34583,18.29563,917
125944,FFA78E97945507AFD9DEF992A707C4AC,31461,19,23,4,109.5091,18.25389,1510
125987,9FC721E86703223349C05C95FE4BBB6F,60081,0,10,10,109.51097,18.22639,1556
125988,9FC721E86703223349C05C95FE4BBB6F,60381,11,16,5,109.5241,18.22458,1605
125989,9FC721E86703223349C05C95FE4BBB6F,31521,17,19,2,109.51458,18.22542,1555
125990,9FC721E86703223349C05C95FE4BBB6F,60087,20,23,3,109.50688,18.22299,1505
125998,8DA382180751D7D787A12E9A5D5EEBBE,39141,0,13,13,109.2009,18.29431,367
125999,8DA382180751D7D787A12E9A5D5EEBBE,31531,14,15,1,109.49583,18.25972,1461
126000,8DA382180751D7D787A12E9A5D5EEBBE,31554,18,23,5,109.55521,18.2459,1709
126036,07F004282B66F8FFF4893B155B27BCEE,30351,16,18,2,109.41701,18.29292,1217
126037,07F004282B66F8FFF4893B155B27BCEE,60552,19,20,1,109.41729,18.30014,1218
126053,2C0209770A37CBC62C92C1A37F9CD2E2,60381,0,1,1,109.5241,18.22458,1605
126054,2C0209770A37CBC62C92C1A37F9CD2E2,31521,5,8,3,109.51458,18.22542,1555
126055,2C0209770A37CBC62C92C1A37F9CD2E2,31145,10,13,3,109.20431,18.30479,369
126056,2C0209770A37CBC62C92C1A37F9CD2E2,31521,16,19,3,109.51458,18.22542,1555
126057,2C0209770A37CBC62C92C1A37F9CD2E2,60381,19,23,4,109.5241,18.22458,1605
126061,50A45076AF8C91AD6E4AEFAAB7160170,30151,0,8,8,109.50986,18.25083,1560
126062,50A45076AF8C91AD6E4AEFAAB7160170,31321,9,11,2,109.63799,18.23201,2007
126069,1FC565965746807D5CEEE5746DEC2EDB,30731,0,2,2,109.50944,18.22306,1555
126070,1FC565965746807D5CEEE5746DEC2EDB,30571,2,3,1,109.50243,18.21861,1504
126071,1FC565965746807D5CEEE5746DEC2EDB,30731,4,16,12,109.50944,18.22306,1555
126086,1F06AA918C76552C10500EE5591E8312,31531,20,21,1,109.49583,18.25972,1461
126087,1F06AA918C76552C10500EE5591E8312,31031,21,23,2,109.49979,18.25382,1510
126187,0A80AC29DC2E111565D686AEC8FAB306,60381,17,20,3,109.5241,18.22458,1605
126188,0A80AC29DC2E111565D686AEC8FAB306,31521,21,23,2,109.51458,18.22542,1555
126198,2576A40187A845D7B849E820F16B3DB1,30854,0,1,1,109.56889,18.27076,1763
126199,2576A40187A845D7B849E820F16B3DB1,31071,2,5,3,109.58257,18.28458,1815
126200,2576A40187A845D7B849E820F16B3DB1,30854,6,12,6,109.56889,18.27076,1763
126201,2576A40187A845D7B849E820F16B3DB1,31071,14,15,1,109.58257,18.28458,1815
126202,2576A40187A845D7B849E820F16B3DB1,30854,16,18,2,109.56889,18.27076,1763
126203,2576A40187A845D7B849E820F16B3DB1,31181,22,23,1,109.50382,18.24813,1509
126211,90B0A60855A43B2DB99A0964CE51D3AF,30851,16,17,1,109.5616,18.27396,1713
126212,90B0A60855A43B2DB99A0964CE51D3AF,30771,18,19,1,109.49938,18.26042,1511
126382,47A18820FDA9856131F74091D44B6BCB,31561,0,7,7,109.56792,18.28479,1765
126383,47A18820FDA9856131F74091D44B6BCB,30851,10,22,12,109.5616,18.27396,1713
126384,5274FB91D917823AD6AE120EE7F21099,31931,0,6,6,109.54771,18.29403,1667
126385,5274FB91D917823AD6AE120EE7F21099,60241,7,8,1,109.53319,18.28667,1616
126386,5274FB91D917823AD6AE120EE7F21099,31931,11,22,11,109.54771,18.29403,1667
126416,48416008147DAB01F8E510488F0426BA,60171,13,15,2,109.51292,18.30694,1569
126417,48416008147DAB01F8E510488F0426BA,38991,16,18,2,109.52681,18.30368,1618
126440,74AD1AF2EA5153BD40BCF9A3F3F2C4E3,30854,1,2,1,109.56889,18.27076,1763
126441,74AD1AF2EA5153BD40BCF9A3F3F2C4E3,31071,2,6,4,109.58257,18.28458,1815
126442,74AD1AF2EA5153BD40BCF9A3F3F2C4E3,30854,7,12,5,109.56889,18.27076,1763
126464,B663EE883B81AEB709AC84DCCEC3D38E,31945,0,7,7,109.58021,18.29403,1817
126465,B663EE883B81AEB709AC84DCCEC3D38E,30854,11,12,1,109.56889,18.27076,1763
126466,B663EE883B81AEB709AC84DCCEC3D38E,31945,13,14,1,109.58021,18.29403,1817
126467,B663EE883B81AEB709AC84DCCEC3D38E,31071,15,17,2,109.58257,18.28458,1815
126468,B663EE883B81AEB709AC84DCCEC3D38E,30854,18,23,5,109.56889,18.27076,1763
126491,A9FCE0049DB44FE004EAFBF5B783F4A5,38154,19,20,1,109.5266,18.28278,1615
126492,A9FCE0049DB44FE004EAFBF5B783F4A5,30421,21,23,2,109.50021,18.25861,1511
126513,E21BDA79D452CC6D5F26BA60A43939EC,38911,15,16,1,109.51674,18.24965,1559
126514,E21BDA79D452CC6D5F26BA60A43939EC,30381,18,19,1,109.52521,18.24507,1609
126515,E21BDA79D452CC6D5F26BA60A43939EC,30371,20,22,2,109.51,18.24771,1559
126560,84DF4A7C208235D171EF56473BCCF210,30851,1,4,3,109.5616,18.27396,1713
126561,84DF4A7C208235D171EF56473BCCF210,31561,4,7,3,109.56792,18.28479,1765
126562,84DF4A7C208235D171EF56473BCCF210,60631,8,17,9,109.57778,18.27583,1814
126624,7024F3A14F6F554DC6E80063E30315F0,31561,4,5,1,109.56792,18.28479,1765
126625,7024F3A14F6F554DC6E80063E30315F0,39183,9,15,6,109.55542,18.28208,1715
126659,53108F311C210CF417B0D8E14F0347CF,31781,11,13,2,109.19847,18.2975,367
126660,53108F311C210CF417B0D8E14F0347CF,38071,17,18,1,109.40722,18.30938,1169
126663,C316CE65034FB3C77BE459147CBF943A,60291,0,8,8,109.50826,18.24639,1509
126664,C316CE65034FB3C77BE459147CBF943A,30161,9,19,10,109.50042,18.24389,1508
126665,C316CE65034FB3C77BE459147CBF943A,60291,20,22,2,109.50826,18.24639,1509
126686,8CE55AC8BC984D52D16D6CE4872EB6FC,31091,1,2,1,109.41201,18.31222,1170
126687,8CE55AC8BC984D52D16D6CE4872EB6FC,31391,4,18,14,109.50382,18.24285,1508
126688,8CE55AC8BC984D52D16D6CE4872EB6FC,38754,20,21,1,109.74667,18.37382,2430
126689,8CE55AC8BC984D52D16D6CE4872EB6FC,30511,22,23,1,109.51069,18.24208,1558
126690,C04EA069938282DB5BB0C38C2CD8C103,30511,0,9,9,109.51069,18.24208,1558
126719,833001CDF394BB3F6E4F040C2A70AC27,31071,3,6,3,109.58257,18.28458,1815
126720,833001CDF394BB3F6E4F040C2A70AC27,30854,7,17,10,109.56889,18.27076,1763
126729,663CE56232D73D50E42DEC41EA33269F,31931,2,8,6,109.54771,18.29403,1667
126730,663CE56232D73D50E42DEC41EA33269F,31571,11,13,2,109.61563,18.23326,1957
126731,663CE56232D73D50E42DEC41EA33269F,30921,14,16,2,109.53903,18.29451,1667
126744,44D0BB13B5123E75A8BB6EBED6897096,39061,0,6,6,109.38222,18.28958,1066
126745,44D0BB13B5123E75A8BB6EBED6897096,31781,10,12,2,109.19847,18.2975,367
126746,44D0BB13B5123E75A8BB6EBED6897096,60054,14,15,1,109.3016,18.31229,770
126765,0D00E0CA974DDA00224ACCD00B993468,30851,0,4,4,109.5616,18.27396,1713
126766,0D00E0CA974DDA00224ACCD00B993468,39183,4,5,1,109.55542,18.28208,1715
126767,0D00E0CA974DDA00224ACCD00B993468,30854,8,9,1,109.56889,18.27076,1763
126768,0D00E0CA974DDA00224ACCD00B993468,31561,10,15,5,109.56792,18.28479,1765
126769,0D00E0CA974DDA00224ACCD00B993468,31071,18,22,4,109.58257,18.28458,1815
126790,63B50A7073912A66CD527ABAF79EDA78,30271,1,3,2,109.49132,18.23153,1456
126791,63B50A7073912A66CD527ABAF79EDA78,60084,3,4,1,109.4984,18.2334,1507
126792,63B50A7073912A66CD527ABAF79EDA78,60291,9,10,1,109.50826,18.24639,1509
126793,567BF1868FBA42FA9B3B29F2CA13F65D,31931,3,5,2,109.54771,18.29403,1667
126794,567BF1868FBA42FA9B3B29F2CA13F65D,30921,7,12,5,109.53903,18.29451,1667
126795,567BF1868FBA42FA9B3B29F2CA13F65D,31931,15,18,3,109.54771,18.29403,1667
126796,567BF1868FBA42FA9B3B29F2CA13F65D,30221,19,22,3,109.57833,18.20222,1802
126806,4A0A93A257347F50F0B6F0C8309FF3C3,31521,16,17,1,109.51458,18.22542,1555
126807,4A0A93A257347F50F0B6F0C8309FF3C3,60381,17,21,4,109.5241,18.22458,1605
126808,4A0A93A257347F50F0B6F0C8309FF3C3,31521,21,22,1,109.51458,18.22542,1555
126809,931F0CE96CB3E3BDA4D1114A4A6C2A83,31851,0,3,3,109.71736,18.29007,2316
126810,931F0CE96CB3E3BDA4D1114A4A6C2A83,30854,6,8,2,109.56889,18.27076,1763
126811,931F0CE96CB3E3BDA4D1114A4A6C2A83,31071,11,13,2,109.58257,18.28458,1815
126812,931F0CE96CB3E3BDA4D1114A4A6C2A83,30854,14,15,1,109.56889,18.27076,1763
126813,931F0CE96CB3E3BDA4D1114A4A6C2A83,31031,19,21,2,109.49979,18.25382,1510
126814,F00821368F615DCDAF214035D8EC4A44,31071,0,7,7,109.58257,18.28458,1815
126815,F00821368F615DCDAF214035D8EC4A44,30854,8,17,9,109.56889,18.27076,1763
126844,934029FB5F97BCE114EDCE88F0393A63,30232,0,4,4,109.6191,18.31701,1971
126845,934029FB5F97BCE114EDCE88F0393A63,30854,6,19,13,109.56889,18.27076,1763
126846,934029FB5F97BCE114EDCE88F0393A63,39371,21,23,2,109.56627,18.2646,1762
126847,8D7B9451E0189947198D6AC9CE51CFEE,60504,0,2,2,109.47917,18.28903,1416
126848,8D7B9451E0189947198D6AC9CE51CFEE,31091,5,20,15,109.41201,18.31222,1170
126849,8D7B9451E0189947198D6AC9CE51CFEE,60261,22,23,1,109.44326,18.3075,1319
126856,4521A8D92A7219267FD46990BC1A5213,30232,0,4,4,109.6191,18.31701,1971
126857,4521A8D92A7219267FD46990BC1A5213,31561,5,6,1,109.56792,18.28479,1765
126858,4521A8D92A7219267FD46990BC1A5213,30232,10,23,13,109.6191,18.31701,1971
126872,E082FB5BD091C5B334EC1176FF352EE0,60371,0,8,8,109.53063,18.30056,1618
126873,E082FB5BD091C5B334EC1176FF352EE0,39181,9,11,2,109.55153,18.28035,1715
126874,E082FB5BD091C5B334EC1176FF352EE0,31931,11,12,1,109.54771,18.29403,1667
126875,E082FB5BD091C5B334EC1176FF352EE0,39181,14,16,2,109.55153,18.28035,1715
126876,E082FB5BD091C5B334EC1176FF352EE0,30071,20,22,2,109.52819,18.30472,1619
126888,4290A01FCBC2456E9D2F061E9D5E5D68,60371,18,23,5,109.53063,18.30056,1618
126902,AA17C9279A63248D7DCDF49F93EB8817,39183,2,9,7,109.55542,18.28208,1715
126903,AA17C9279A63248D7DCDF49F93EB8817,60381,13,15,2,109.5241,18.22458,1605
126904,AA17C9279A63248D7DCDF49F93EB8817,30854,19,20,1,109.56889,18.27076,1763
126951,7050D1E0A5553A00BB03B768ACFBCA8F,30361,11,13,2,109.50347,18.24,1508
126952,7050D1E0A5553A00BB03B768ACFBCA8F,31461,13,17,4,109.5091,18.25389,1510
126953,7050D1E0A5553A00BB03B768ACFBCA8F,60361,19,22,3,109.51938,18.29681,1567
126956,B93185B4820D7E0DEE74EBEA00941D15,60201,0,1,1,109.5041,18.2509,1510
126957,B93185B4820D7E0DEE74EBEA00941D15,30911,4,17,13,109.50493,18.26181,1511
126958,B93185B4820D7E0DEE74EBEA00941D15,31181,18,23,5,109.50382,18.24813,1509
126974,926E22A5E8101C23324E16D288147F19,38094,12,13,1,109.45403,18.28778,1316
126975,926E22A5E8101C23324E16D288147F19,60281,13,15,2,109.51743,18.25924,1561
126987,F84D949DDCBF25D5530F771BC55E0B9D,61011,0,3,3,109.60653,18.19076,1900
126994,409F5E8F01172D32BBE91132149C037E,31864,18,20,2,109.49014,18.28333,1465
126995,409F5E8F01172D32BBE91132149C037E,31861,21,22,1,109.49042,18.27549,1464
126996,07169E7114E4F14C073261BAAC0D4491,61011,0,8,8,109.60653,18.19076,1900
126998,07169E7114E4F14C073261BAAC0D4491,61011,12,16,4,109.60653,18.19076,1900
127000,53490AD77ACCA93C3ED0F3DE79CA488B,31071,7,9,2,109.58257,18.28458,1815
127001,53490AD77ACCA93C3ED0F3DE79CA488B,30854,10,12,2,109.56889,18.27076,1763
127002,53490AD77ACCA93C3ED0F3DE79CA488B,31071,16,17,1,109.58257,18.28458,1815
127003,53490AD77ACCA93C3ED0F3DE79CA488B,30854,18,21,3,109.56889,18.27076,1763
127013,B7A51644BA2B41C2F23A67608468F705,31561,0,20,20,109.56792,18.28479,1765
127014,B7A51644BA2B41C2F23A67608468F705,30854,22,23,1,109.56889,18.27076,1763
127029,6F590AF2C10C4B9F0F4E76B8E922550E,31945,0,17,17,109.58021,18.29403,1817
127030,6F590AF2C10C4B9F0F4E76B8E922550E,60381,17,20,3,109.5241,18.22458,1605
127064,088D66324A5ED1F3FDE9B38E9377D275,31841,1,8,7,109.73201,18.33382,2373
127065,088D66324A5ED1F3FDE9B38E9377D275,31471,12,13,1,109.34583,18.29563,917
127066,088D66324A5ED1F3FDE9B38E9377D275,31701,15,16,1,109.44132,18.28833,1266
127067,088D66324A5ED1F3FDE9B38E9377D275,30361,17,19,2,109.50347,18.24,1508
127070,C75EDA4A0DFCA4C39E64550333886E59,31561,0,6,6,109.56792,18.28479,1765
127071,C75EDA4A0DFCA4C39E64550333886E59,31071,7,9,2,109.58257,18.28458,1815
127072,C75EDA4A0DFCA4C39E64550333886E59,31561,10,20,10,109.56792,18.28479,1765
127073,C75EDA4A0DFCA4C39E64550333886E59,31071,20,21,1,109.58257,18.28458,1815
127074,121138E269BBF0B506FA8CE6CEB3BF52,31931,0,7,7,109.54771,18.29403,1667
127075,121138E269BBF0B506FA8CE6CEB3BF52,39181,10,11,1,109.55153,18.28035,1715
127098,9C1407835BC54BEBDB541F52E1DA1820,61011,5,10,5,109.60653,18.19076,1900
127100,9C1407835BC54BEBDB541F52E1DA1820,61011,15,21,6,109.60653,18.19076,1900
127125,3520FED22A4D572CBFE1B08BD2743E22,31181,0,1,1,109.50382,18.24813,1509
127126,3520FED22A4D572CBFE1B08BD2743E22,60291,4,9,5,109.50826,18.24639,1509
127127,3520FED22A4D572CBFE1B08BD2743E22,30161,11,16,5,109.50042,18.24389,1508
127128,3520FED22A4D572CBFE1B08BD2743E22,30764,16,17,1,109.45806,18.29486,1367
127129,3520FED22A4D572CBFE1B08BD2743E22,60381,19,20,1,109.5241,18.22458,1605
127130,3520FED22A4D572CBFE1B08BD2743E22,60291,22,23,1,109.50826,18.24639,1509
127153,8E5F3B2493DD0AA38315FE1AF112101A,31391,0,5,5,109.50382,18.24285,1508
127154,8E5F3B2493DD0AA38315FE1AF112101A,31781,8,10,2,109.19847,18.2975,367
127155,8E5F3B2493DD0AA38315FE1AF112101A,31145,10,13,3,109.20431,18.30479,369
127156,8E5F3B2493DD0AA38315FE1AF112101A,60054,13,14,1,109.3016,18.31229,770
127162,832CED7A9767F731540B7A7E7B00DB89,60361,15,16,1,109.51938,18.29681,1567
127163,832CED7A9767F731540B7A7E7B00DB89,60631,18,22,4,109.57778,18.27583,1814
127221,2A699167E9D3E245FFAC98B0B1AFC37B,31071,0,7,7,109.58257,18.28458,1815
127222,2A699167E9D3E245FFAC98B0B1AFC37B,60381,9,11,2,109.5241,18.22458,1605
127223,2A699167E9D3E245FFAC98B0B1AFC37B,30854,14,17,3,109.56889,18.27076,1763
127224,2A699167E9D3E245FFAC98B0B1AFC37B,31071,19,20,1,109.58257,18.28458,1815
127231,4568F4CB3839A063AA85BE5AD656F1DE,30911,17,18,1,109.50493,18.26181,1511
127232,4568F4CB3839A063AA85BE5AD656F1DE,31461,18,20,2,109.5091,18.25389,1510
127233,4568F4CB3839A063AA85BE5AD656F1DE,30721,20,23,3,109.51597,18.28257,1565
127240,A8E275DD27FBBA73D05B585FBDDEE684,60594,1,6,5,109.62694,18.22799,1956
127241,A8E275DD27FBBA73D05B585FBDDEE684,38052,8,10,2,109.62618,18.23042,1956
127242,8C3D244B6DAAE8C73F174808255E03C6,60011,0,6,6,109.48965,18.30222,1468
127243,8C3D244B6DAAE8C73F174808255E03C6,30764,7,17,10,109.45806,18.29486,1367
127247,9BF28B433E02EDD44843729C864FE002,30711,9,10,1,109.50271,18.25347,1510
127248,9BF28B433E02EDD44843729C864FE002,31461,11,13,2,109.5091,18.25389,1510
127249,9BF28B433E02EDD44843729C864FE002,31145,15,17,2,109.20431,18.30479,369
127250,9BF28B433E02EDD44843729C864FE002,31461,18,23,5,109.5091,18.25389,1510
127258,1F5A515C5AC85D4C79D71950DF5477FB,30571,1,12,11,109.50243,18.21861,1504
127259,1F5A515C5AC85D4C79D71950DF5477FB,38017,13,14,1,109.49729,18.21424,1504
127260,1F5A515C5AC85D4C79D71950DF5477FB,38071,15,16,1,109.40722,18.30938,1169
127286,DBB710D279E76C79F1E4B0766F579F8A,31071,0,7,7,109.58257,18.28458,1815
127287,DBB710D279E76C79F1E4B0766F579F8A,30854,8,9,1,109.56889,18.27076,1763
127288,DBB710D279E76C79F1E4B0766F579F8A,31071,12,14,2,109.58257,18.28458,1815
127289,DBB710D279E76C79F1E4B0766F579F8A,30854,14,18,4,109.56889,18.27076,1763
127302,AD24687CE009DD38418E30D2A06E4D4E,60381,17,19,2,109.5241,18.22458,1605
127303,AD24687CE009DD38418E30D2A06E4D4E,31864,20,23,3,109.49014,18.28333,1465
127365,99CBAA6A65A50998F0A10B72B36210E4,60231,2,4,2,109.49903,18.21972,1504
127366,99CBAA6A65A50998F0A10B72B36210E4,30271,4,5,1,109.49132,18.23153,1456
127367,99CBAA6A65A50998F0A10B72B36210E4,60231,6,7,1,109.49903,18.21972,1504
127368,99CBAA6A65A50998F0A10B72B36210E4,30341,12,14,2,109.3625,18.29167,966
127369,99CBAA6A65A50998F0A10B72B36210E4,30661,15,16,1,109.37028,18.24361,1008
127370,99CBAA6A65A50998F0A10B72B36210E4,60161,19,23,4,109.49174,18.26181,1461
127437,3DC27A2CD4FE63FAF7640F6DDBACB36E,60131,0,9,9,109.49819,18.24778,1509
127438,3DC27A2CD4FE63FAF7640F6DDBACB36E,31531,11,12,1,109.49583,18.25972,1461
127439,3DC27A2CD4FE63FAF7640F6DDBACB36E,60131,12,13,1,109.49819,18.24778,1509
127440,3DC27A2CD4FE63FAF7640F6DDBACB36E,30571,17,18,1,109.50243,18.21861,1504
127441,3DC27A2CD4FE63FAF7640F6DDBACB36E,38017,22,23,1,109.49729,18.21424,1504
127452,55FA72F7A9567EE8C2569F2A3640F92B,60371,0,5,5,109.53063,18.30056,1618
127453,55FA72F7A9567EE8C2569F2A3640F92B,39181,7,18,11,109.55153,18.28035,1715
127454,55FA72F7A9567EE8C2569F2A3640F92B,60371,21,22,1,109.53063,18.30056,1618
127463,37D38EF0062E64D55C94EB554B76F9EE,31945,0,6,6,109.58021,18.29403,1817
127464,37D38EF0062E64D55C94EB554B76F9EE,30854,8,9,1,109.56889,18.27076,1763
127480,E34FF61340C5B86CF9FD0AD454D26266,60331,0,6,6,109.505,18.26507,1512
127481,E34FF61340C5B86CF9FD0AD454D26266,30324,8,10,2,109.50326,18.29257,1517
127482,E34FF61340C5B86CF9FD0AD454D26266,60331,11,14,3,109.505,18.26507,1512
127483,E34FF61340C5B86CF9FD0AD454D26266,30911,17,18,1,109.50493,18.26181,1511
127484,E34FF61340C5B86CF9FD0AD454D26266,38127,18,20,2,109.50833,18.27222,1513
127485,E34FF61340C5B86CF9FD0AD454D26266,30081,21,23,2,109.50243,18.26632,1512
127538,2986E42C864F9C3503A05721F57A75DB,31931,0,7,7,109.54771,18.29403,1667
127539,2986E42C864F9C3503A05721F57A75DB,39101,9,10,1,109.50132,18.24931,1509
127540,2986E42C864F9C3503A05721F57A75DB,31931,11,13,2,109.54771,18.29403,1667
127557,7784022BDEFABB0258B32ABBB5E13027,38754,13,14,1,109.74667,18.37382,2430
127558,7784022BDEFABB0258B32ABBB5E13027,60291,18,19,1,109.50826,18.24639,1509
127559,7784022BDEFABB0258B32ABBB5E13027,30861,21,23,2,109.52722,18.22743,1606
127565,92A2864B24BF6E1A0CE547DBC05D8536,31471,15,17,2,109.34583,18.29563,917
127566,92A2864B24BF6E1A0CE547DBC05D8536,31311,20,22,2,109.72299,18.27438,2364
127580,DE44A87559E9DEE84B37BE840DB2C4AC,60054,0,7,7,109.3016,18.31229,770
127581,DE44A87559E9DEE84B37BE840DB2C4AC,31471,7,8,1,109.34583,18.29563,917
127582,DE44A87559E9DEE84B37BE840DB2C4AC,60054,8,23,15,109.3016,18.31229,770
127613,020753EF78F0A0C39658113A3377EA1E,31561,0,5,5,109.56792,18.28479,1765
127614,020753EF78F0A0C39658113A3377EA1E,39183,8,11,3,109.55542,18.28208,1715
127615,020753EF78F0A0C39658113A3377EA1E,31561,11,15,4,109.56792,18.28479,1765
127640,70E36A4B82878626B569C66E46C7827C,31101,15,23,8,109.65389,18.23403,2057
127680,76F6A54588C8DF7DDADFC50CAA11D44C,30854,10,12,2,109.56889,18.27076,1763
127681,76F6A54588C8DF7DDADFC50CAA11D44C,38085,15,16,1,109.6291,18.23625,2007
127705,11BA48A87BA84CE63B9512A0940BAB43,31851,0,10,10,109.71736,18.29007,2316
127706,11BA48A87BA84CE63B9512A0940BAB43,30711,11,15,4,109.50271,18.25347,1510
127707,11BA48A87BA84CE63B9512A0940BAB43,31851,16,23,7,109.71736,18.29007,2316
127769,56F818D0924E7BDB02CCC04065747626,38205,0,7,7,109.62743,18.23139,1956
127771,56F818D0924E7BDB02CCC04065747626,38205,15,22,7,109.62743,18.23139,1956
127774,51061B3DE820AF1C1C713EF684728003,30854,0,2,2,109.56889,18.27076,1763
127775,51061B3DE820AF1C1C713EF684728003,31071,5,7,2,109.58257,18.28458,1815
127776,51061B3DE820AF1C1C713EF684728003,30854,9,11,2,109.56889,18.27076,1763
127777,51061B3DE820AF1C1C713EF684728003,31071,13,14,1,109.58257,18.28458,1815
127778,51061B3DE820AF1C1C713EF684728003,30854,14,22,8,109.56889,18.27076,1763
127785,A8E9C7BB918ADAD29A3EA7ACDDCD32D7,38951,0,2,2,109.48097,18.28868,1416
127786,A8E9C7BB918ADAD29A3EA7ACDDCD32D7,38951,2,12,10,109.48097,18.28868,1416
127787,A8E9C7BB918ADAD29A3EA7ACDDCD32D7,60041,13,14,1,109.39889,18.31944,1121
127788,A8E9C7BB918ADAD29A3EA7ACDDCD32D7,31171,16,22,6,109.50938,18.24917,1559
127799,012ABD06F231728C214A4BA917E75B1C,31561,0,2,2,109.56792,18.28479,1765
127800,012ABD06F231728C214A4BA917E75B1C,30851,6,7,1,109.5616,18.27396,1713
127801,012ABD06F231728C214A4BA917E75B1C,31561,9,13,4,109.56792,18.28479,1765
127802,012ABD06F231728C214A4BA917E75B1C,30851,13,15,2,109.5616,18.27396,1713
127803,012ABD06F231728C214A4BA917E75B1C,31561,15,17,2,109.56792,18.28479,1765
127804,012ABD06F231728C214A4BA917E75B1C,30851,17,23,6,109.5616,18.27396,1713
127824,F3652FF504BC297E68234A33C1877043,31071,3,7,4,109.58257,18.28458,1815
127825,F3652FF504BC297E68234A33C1877043,31945,12,14,2,109.58021,18.29403,1817
127826,F3652FF504BC297E68234A33C1877043,30854,16,17,1,109.56889,18.27076,1763
127874,A0CFD24F8D50ABCF6002C5FC96CEAB76,39183,0,6,6,109.55542,18.28208,1715
127875,A0CFD24F8D50ABCF6002C5FC96CEAB76,31931,7,8,1,109.54771,18.29403,1667
127876,A0CFD24F8D50ABCF6002C5FC96CEAB76,39181,9,15,6,109.55153,18.28035,1715
127877,A0CFD24F8D50ABCF6002C5FC96CEAB76,39183,16,22,6,109.55542,18.28208,1715
127951,D61883A9E0C7F2103C981F95E51C66DA,30921,19,20,1,109.53903,18.29451,1667
127952,D61883A9E0C7F2103C981F95E51C66DA,31931,21,22,1,109.54771,18.29403,1667
127968,43E035AE85036EBD9891453E9567CB81,30151,0,13,13,109.50986,18.25083,1560
127969,43E035AE85036EBD9891453E9567CB81,30321,14,17,3,109.49563,18.29611,1467
127970,43E035AE85036EBD9891453E9567CB81,30151,18,23,5,109.50986,18.25083,1560
128001,A77997C0827AC67795C1E20276F47342,31471,12,13,1,109.34583,18.29563,917
128002,A77997C0827AC67795C1E20276F47342,30101,16,22,6,109.57299,18.33333,1773
128052,8752BC71725B50257436D50C6598F252,31071,0,7,7,109.58257,18.28458,1815
128053,8752BC71725B50257436D50C6598F252,30854,7,19,12,109.56889,18.27076,1763
128133,08077B5D5F0A9938A81D328635D03C8B,30234,2,6,4,109.60681,18.29979,1918
128134,08077B5D5F0A9938A81D328635D03C8B,30854,7,12,5,109.56889,18.27076,1763
128146,DC9973204E62AA99FA79F0696CF6C0F6,30854,0,10,10,109.56889,18.27076,1763
128147,DC9973204E62AA99FA79F0696CF6C0F6,31945,10,13,3,109.58021,18.29403,1817
128157,6ABF30CD5F14455AA21662324DAC8186,31561,6,7,1,109.56792,18.28479,1765
128158,6ABF30CD5F14455AA21662324DAC8186,30854,10,11,1,109.56889,18.27076,1763
128159,6ABF30CD5F14455AA21662324DAC8186,31071,15,16,1,109.58257,18.28458,1815
128160,6ABF30CD5F14455AA21662324DAC8186,31561,17,20,3,109.56792,18.28479,1765
128194,33A62A8066AF8B1342859DF4B906FBD2,30741,0,10,10,109.49833,18.28681,1516
128195,33A62A8066AF8B1342859DF4B906FBD2,30351,11,12,1,109.41701,18.29292,1217
128197,A29C3DFD5E3ED4F98E6C43DA6AE0D5D6,60131,0,2,2,109.49819,18.24778,1509
128198,A29C3DFD5E3ED4F98E6C43DA6AE0D5D6,39091,3,7,4,109.50097,18.25222,1510
128199,A29C3DFD5E3ED4F98E6C43DA6AE0D5D6,39151,7,13,6,109.49875,18.25097,1510
128200,A29C3DFD5E3ED4F98E6C43DA6AE0D5D6,31031,13,15,2,109.49979,18.25382,1510
128201,A29C3DFD5E3ED4F98E6C43DA6AE0D5D6,31031,18,20,2,109.49979,18.25382,1510
128230,377A324496E54511961704972731A3D5,31821,0,7,7,109.51181,18.24924,1559
128231,377A324496E54511961704972731A3D5,31521,11,20,9,109.51458,18.22542,1555
128232,377A324496E54511961704972731A3D5,31261,21,23,2,109.51174,18.2466,1559
128269,7A8A49FBFD114425697B8C888A41840A,60631,0,17,17,109.57778,18.27583,1814
128270,7A8A49FBFD114425697B8C888A41840A,31071,19,23,4,109.58257,18.28458,1815
128271,BA7DDC5AF6FA3B9E59DB2783070090EF,31471,16,17,1,109.34583,18.29563,917
128272,BA7DDC5AF6FA3B9E59DB2783070090EF,60084,20,23,3,109.4984,18.2334,1507
128273,FED6A35BC679413EC0346D897F15EB66,38321,1,11,10,109.39854,18.29132,1116
128274,FED6A35BC679413EC0346D897F15EB66,38754,14,15,1,109.74667,18.37382,2430
128275,FED6A35BC679413EC0346D897F15EB66,38325,18,23,5,109.39792,18.2909,1116
128320,1412BA3B65BC1A2354CCBE297098A0E1,31071,1,11,10,109.58257,18.28458,1815
128321,1412BA3B65BC1A2354CCBE297098A0E1,30854,15,18,3,109.56889,18.27076,1763
128392,7890099D98AA300C5BF12527E7372DB0,60631,0,7,7,109.57778,18.27583,1814
128393,7890099D98AA300C5BF12527E7372DB0,31071,8,10,2,109.58257,18.28458,1815
128394,7890099D98AA300C5BF12527E7372DB0,60631,12,20,8,109.57778,18.27583,1814
128395,7890099D98AA300C5BF12527E7372DB0,30891,21,22,1,109.59431,18.28389,1865
128461,C6FE4CF0CD47303AD7F7EC5A71315B10,60631,6,7,1,109.57778,18.27583,1814
128462,C6FE4CF0CD47303AD7F7EC5A71315B10,38275,10,20,10,109.62875,18.22938,2006
128475,D2AB5CB6DDBFA91923528DA022D6A566,30854,0,5,5,109.56889,18.27076,1763
128476,D2AB5CB6DDBFA91923528DA022D6A566,30361,9,10,1,109.50347,18.24,1508
128477,D2AB5CB6DDBFA91923528DA022D6A566,30101,12,14,2,109.57299,18.33333,1773
128551,BBE4D8242EE46AE73AD69A56A00F4408,30201,0,15,15,109.4909,18.26465,1462
128552,BBE4D8242EE46AE73AD69A56A00F4408,31271,16,18,2,109.48958,18.26257,1462
128553,BBE4D8242EE46AE73AD69A56A00F4408,30201,20,23,3,109.4909,18.26465,1462
128559,40285EE8CCE25C38988EC087545664EC,31071,16,18,2,109.58257,18.28458,1815
128560,40285EE8CCE25C38988EC087545664EC,31821,19,20,1,109.51181,18.24924,1559
128561,40285EE8CCE25C38988EC087545664EC,31206,21,23,2,109.50819,18.23549,1507
128579,686584B2BD5C98E8E504E785E36CD6B3,38951,0,6,6,109.48097,18.28868,1416
128580,686584B2BD5C98E8E504E785E36CD6B3,30941,8,12,4,109.5559,18.33938,1724
128581,686584B2BD5C98E8E504E785E36CD6B3,38951,13,23,10,109.48097,18.28868,1416
128647,D9359F177293DE6337F7CC97B1116186,60594,1,2,1,109.62694,18.22799,1956
128648,D9359F177293DE6337F7CC97B1116186,31571,5,7,2,109.61563,18.23326,1957
128654,C8922FAF66F21ECAECB6B717FCD5A53B,60614,0,7,7,109.48799,18.29521,1467
128655,C8922FAF66F21ECAECB6B717FCD5A53B,60391,7,9,2,109.47667,18.28757,1416
128656,C8922FAF66F21ECAECB6B717FCD5A53B,60614,9,14,5,109.48799,18.29521,1467
128657,C8922FAF66F21ECAECB6B717FCD5A53B,60391,14,19,5,109.47667,18.28757,1416
128658,C8922FAF66F21ECAECB6B717FCD5A53B,60614,19,23,4,109.48799,18.29521,1467
128659,7D1ED6067ECBD941EFC43CE0A6ADAE71,30854,0,15,15,109.56889,18.27076,1763
128660,7D1ED6067ECBD941EFC43CE0A6ADAE71,30421,18,22,4,109.50021,18.25861,1511
128661,FD359EB3CAC5C54CC64F5DDAD6DDAE97,31061,0,16,16,109.53333,18.23257,1607
128662,FD359EB3CAC5C54CC64F5DDAD6DDAE97,31021,18,20,2,109.49021,18.27,1463
128667,9E8746086915F9D4A063A74CF0B5B7AB,30851,3,5,2,109.5616,18.27396,1713
128668,9E8746086915F9D4A063A74CF0B5B7AB,31561,6,7,1,109.56792,18.28479,1765
128669,9E8746086915F9D4A063A74CF0B5B7AB,39183,7,8,1,109.55542,18.28208,1715
128670,9E8746086915F9D4A063A74CF0B5B7AB,31561,12,14,2,109.56792,18.28479,1765
128671,9E8746086915F9D4A063A74CF0B5B7AB,39183,14,15,1,109.55542,18.28208,1715
128680,017BB493E18067371C6FAA1A30D4BA4B,60161,9,10,1,109.49174,18.26181,1461
128681,017BB493E18067371C6FAA1A30D4BA4B,60441,12,16,4,109.46792,18.28604,1366
128682,017BB493E18067371C6FAA1A30D4BA4B,60231,19,20,1,109.49903,18.21972,1504
128702,8A19D38C67DEBBE2072401E23B2467C5,60114,18,19,1,109.73028,18.33847,2374
128703,8A19D38C67DEBBE2072401E23B2467C5,31161,21,23,2,109.70229,18.31361,2270
128715,FD5B9AB034F15F72E8BEF02193669238,31931,8,9,1,109.54771,18.29403,1667
128716,FD5B9AB034F15F72E8BEF02193669238,60241,12,22,10,109.53319,18.28667,1616
128738,04ABA8BFD5D63DDF1B83BA0577C9019C,31071,10,17,7,109.58257,18.28458,1815
128739,04ABA8BFD5D63DDF1B83BA0577C9019C,30232,21,22,1,109.6191,18.31701,1971
128742,C56FFEC7A513E811F8A8716FF6938EBC,39091,0,9,9,109.50097,18.25222,1510
128744,C56FFEC7A513E811F8A8716FF6938EBC,30711,19,23,4,109.50271,18.25347,1510
128774,564220533658012885D64AC3FDD81E22,30361,16,17,1,109.50347,18.24,1508
128775,564220533658012885D64AC3FDD81E22,60381,18,23,5,109.5241,18.22458,1605
128781,55D663E94101F000896F2C3F897BA6C9,30561,0,4,4,109.52778,18.31938,1621
128782,55D663E94101F000896F2C3F897BA6C9,30031,4,15,11,109.53681,18.33313,1673
128783,55D663E94101F000896F2C3F897BA6C9,60381,16,17,1,109.5241,18.22458,1605
128784,55D663E94101F000896F2C3F897BA6C9,30031,20,21,1,109.53681,18.33313,1673
128785,55D663E94101F000896F2C3F897BA6C9,30561,21,23,2,109.52778,18.31938,1621
128822,E9E473F09C342630187345312F4A31D8,39181,0,19,19,109.55153,18.28035,1715
128823,E9E473F09C342630187345312F4A31D8,39181,20,23,3,109.55153,18.28035,1715
128846,08A066736557478B1013C0CF834491DF,30921,0,6,6,109.53903,18.29451,1667
128847,08A066736557478B1013C0CF834491DF,31931,9,13,4,109.54771,18.29403,1667
128848,08A066736557478B1013C0CF834491DF,30921,17,18,1,109.53903,18.29451,1667
128849,08A066736557478B1013C0CF834491DF,31931,19,20,1,109.54771,18.29403,1667
128850,08A066736557478B1013C0CF834491DF,30921,22,23,1,109.53903,18.29451,1667
128863,A1657F2E26148E87604D8FB77783D52A,31231,0,8,8,109.42597,18.29292,1217
128864,A1657F2E26148E87604D8FB77783D52A,38241,11,12,1,109.54111,18.30542,1669
128865,A1657F2E26148E87604D8FB77783D52A,31231,13,17,4,109.42597,18.29292,1217
128866,A1657F2E26148E87604D8FB77783D52A,31461,19,20,1,109.5091,18.25389,1510
128867,A1657F2E26148E87604D8FB77783D52A,31231,21,23,2,109.42597,18.29292,1217
128876,E24CDF8EE180624B3803A186364F1593,60171,11,12,1,109.51292,18.30694,1569
128877,E24CDF8EE180624B3803A186364F1593,30761,13,14,1,109.45201,18.3,1318
128888,892C8CDA0BCAF97A4A9B5DDF3BB8D7F0,30854,17,18,1,109.56889,18.27076,1763
128889,892C8CDA0BCAF97A4A9B5DDF3BB8D7F0,31071,20,22,2,109.58257,18.28458,1815
128934,00FC332040A284DA251A8D0705989FE9,31071,2,7,5,109.58257,18.28458,1815
128935,00FC332040A284DA251A8D0705989FE9,30854,8,17,9,109.56889,18.27076,1763
128936,00FC332040A284DA251A8D0705989FE9,39181,17,19,2,109.55153,18.28035,1715
128966,32E97C71348406BC9AE60C6CB8F1E953,60371,18,23,5,109.53063,18.30056,1618
129010,2AE38FAF341950B0B91404FFCE5A0F3E,30921,6,18,12,109.53903,18.29451,1667
129011,2AE38FAF341950B0B91404FFCE5A0F3E,31931,20,22,2,109.54771,18.29403,1667
129016,8DA877D3A30401F86E81FB7BC1CA2A00,31071,0,10,10,109.58257,18.28458,1815
129017,8DA877D3A30401F86E81FB7BC1CA2A00,30854,10,12,2,109.56889,18.27076,1763
129018,8DA877D3A30401F86E81FB7BC1CA2A00,31071,14,20,6,109.58257,18.28458,1815
129022,39F25FE146A03325C93C111F2A943B6C,31945,0,7,7,109.58021,18.29403,1817
129023,39F25FE146A03325C93C111F2A943B6C,30854,9,12,3,109.56889,18.27076,1763
129024,39F25FE146A03325C93C111F2A943B6C,31945,12,13,1,109.58021,18.29403,1817
129025,39F25FE146A03325C93C111F2A943B6C,30854,15,16,1,109.56889,18.27076,1763
129026,39F25FE146A03325C93C111F2A943B6C,31071,16,17,1,109.58257,18.28458,1815
129027,39F25FE146A03325C93C111F2A943B6C,31041,20,21,1,109.50278,18.23701,1507
129028,58418A9EA4A7DC03127CB79C039A5185,31071,0,8,8,109.58257,18.28458,1815
129029,58418A9EA4A7DC03127CB79C039A5185,38754,11,16,5,109.74667,18.37382,2430
129030,58418A9EA4A7DC03127CB79C039A5185,39091,18,23,5,109.50097,18.25222,1510
129104,9F5F8E6110AC554161BA0F6410145CFE,30671,14,15,1,109.43611,18.30139,1268
129105,9F5F8E6110AC554161BA0F6410145CFE,31231,16,18,2,109.42597,18.29292,1217
129106,9F5F8E6110AC554161BA0F6410145CFE,30351,20,23,3,109.41701,18.29292,1217
129135,AB8F95D841F69DCC3177A6274025E5E6,39183,0,13,13,109.55542,18.28208,1715
129136,AB8F95D841F69DCC3177A6274025E5E6,31931,14,15,1,109.54771,18.29403,1667
129137,AB8F95D841F69DCC3177A6274025E5E6,39183,16,23,7,109.55542,18.28208,1715
129140,DFFF17B7FE30E79B8AABBB5CE171272F,39183,3,4,1,109.55542,18.28208,1715
129141,DFFF17B7FE30E79B8AABBB5CE171272F,31561,7,20,13,109.56792,18.28479,1765
129142,DFFF17B7FE30E79B8AABBB5CE171272F,39183,21,23,2,109.55542,18.28208,1715
129175,B34415F599F0ED7D1A073EE314A60B9B,60541,0,7,7,109.4084,18.29208,1167
129176,B34415F599F0ED7D1A073EE314A60B9B,31671,7,21,14,109.38965,18.29813,1068
129216,6780524A249B8A38CA7BA3C9D25990DC,60541,18,19,1,109.4084,18.29208,1167
129217,6780524A249B8A38CA7BA3C9D25990DC,31681,21,23,2,109.40396,18.29979,1168
129243,EC4B90EDBF35256FDB4D4F8B87DB8A04,31071,0,16,16,109.58257,18.28458,1815
129244,EC4B90EDBF35256FDB4D4F8B87DB8A04,30854,20,22,2,109.56889,18.27076,1763
129245,8CD15CF6B5FB4821940FF9AFE6D6CB84,39181,1,5,4,109.55153,18.28035,1715
129246,8CD15CF6B5FB4821940FF9AFE6D6CB84,60371,6,7,1,109.53063,18.30056,1618
129247,8CD15CF6B5FB4821940FF9AFE6D6CB84,30921,8,10,2,109.53903,18.29451,1667
129248,E0A24740E2C54F3B77DB561A91D2BED7,31821,0,1,1,109.51181,18.24924,1559
129249,E0A24740E2C54F3B77DB561A91D2BED7,30151,6,7,1,109.50986,18.25083,1560
129250,E0A24740E2C54F3B77DB561A91D2BED7,30251,8,17,9,109.50611,18.26653,1512
129251,E0A24740E2C54F3B77DB561A91D2BED7,31461,17,20,3,109.5091,18.25389,1510
129252,E0A24740E2C54F3B77DB561A91D2BED7,60571,21,23,2,109.50722,18.25056,1510
129281,10E6DCB22C04D9E1B01193CDA87B3193,60221,19,21,2,109.52569,18.29188,1616
129282,10E6DCB22C04D9E1B01193CDA87B3193,30721,21,23,2,109.51597,18.28257,1565
129309,03DA52CB04D303C32B3FDE6BAFCAF395,31521,0,14,14,109.51458,18.22542,1555
129310,03DA52CB04D303C32B3FDE6BAFCAF395,30854,15,18,3,109.56889,18.27076,1763
129311,03DA52CB04D303C32B3FDE6BAFCAF395,31521,19,23,4,109.51458,18.22542,1555
129326,9E75E21F61DD725C83C4FFC35907ACC9,60221,16,17,1,109.52569,18.29188,1616
129327,9E75E21F61DD725C83C4FFC35907ACC9,31701,18,21,3,109.44132,18.28833,1266
129328,9E75E21F61DD725C83C4FFC35907ACC9,38871,22,23,1,109.44681,18.28625,1316
129421,3272381C6A94F906EDCE0D12EAC755B5,30361,1,9,8,109.50347,18.24,1508
129422,3272381C6A94F906EDCE0D12EAC755B5,31411,9,11,2,109.5016,18.23576,1507
129423,3272381C6A94F906EDCE0D12EAC755B5,30711,12,13,1,109.50271,18.25347,1510
129424,3272381C6A94F906EDCE0D12EAC755B5,38361,14,18,4,109.43667,18.29201,1267
129425,3272381C6A94F906EDCE0D12EAC755B5,39191,19,20,1,109.51493,18.23472,1557
129427,F284433312BF32177275D1EBBDCED548,31145,11,14,3,109.20431,18.30479,369
129446,03CEC0FDDD5484124514C6D24A63D4DD,31561,2,13,11,109.56792,18.28479,1765
129447,03CEC0FDDD5484124514C6D24A63D4DD,39183,13,16,3,109.55542,18.28208,1715
129448,03CEC0FDDD5484124514C6D24A63D4DD,31561,18,20,2,109.56792,18.28479,1765
129453,87ACF3C6ADE430D2B9DFB3C954E0C031,39183,15,16,1,109.55542,18.28208,1715
129454,87ACF3C6ADE430D2B9DFB3C954E0C031,30854,16,18,2,109.56889,18.27076,1763
129470,EA446444DFE25212830F95291C13D19D,31931,0,6,6,109.54771,18.29403,1667
129471,EA446444DFE25212830F95291C13D19D,39181,9,11,2,109.55153,18.28035,1715
129472,EA446444DFE25212830F95291C13D19D,31931,11,21,10,109.54771,18.29403,1667
129532,D20C070E72B2E72E0898232810D95CC4,31521,0,7,7,109.51458,18.22542,1555
129533,D20C070E72B2E72E0898232810D95CC4,30851,9,12,3,109.5616,18.27396,1713
129534,D20C070E72B2E72E0898232810D95CC4,31521,12,23,11,109.51458,18.22542,1555
129543,AF125EFCC483E24833CBDDBC7248BDF1,31201,15,16,1,109.51042,18.23819,1558
129544,AF125EFCC483E24833CBDDBC7248BDF1,30421,18,20,2,109.50021,18.25861,1511
129545,AF125EFCC483E24833CBDDBC7248BDF1,31206,21,22,1,109.50819,18.23549,1507
129570,14F1CC63CDA098F9694EAC8584B9C7A5,31561,0,7,7,109.56792,18.28479,1765
129571,14F1CC63CDA098F9694EAC8584B9C7A5,30854,11,12,1,109.56889,18.27076,1763
129572,14F1CC63CDA098F9694EAC8584B9C7A5,31561,14,15,1,109.56792,18.28479,1765
129604,12D34EABAB055EE48AA4835BB7A9952C,30771,0,10,10,109.49938,18.26042,1511
129605,12D34EABAB055EE48AA4835BB7A9952C,30771,12,15,3,109.49938,18.26042,1511
129608,12D34EABAB055EE48AA4835BB7A9952C,30771,21,23,2,109.49938,18.26042,1511
129644,C8501DFE42E6954852B7593EDA5D3099,30371,3,9,6,109.51,18.24771,1559
129645,C8501DFE42E6954852B7593EDA5D3099,30084,11,12,1,109.50118,18.26972,1513
129656,1D8B814EC83D52D7C5F3FED99C129EE0,38271,12,20,8,109.62632,18.23049,1956
129657,1D8B814EC83D52D7C5F3FED99C129EE0,39183,22,23,1,109.55542,18.28208,1715
129733,F04654AC056A2E82B670DFA8C627A5F2,60331,0,6,6,109.505,18.26507,1512
129734,F04654AC056A2E82B670DFA8C627A5F2,31561,9,18,9,109.56792,18.28479,1765
129739,8880BF3B03853247B5235ADF19775070,31261,0,3,3,109.51174,18.2466,1559
129740,8880BF3B03853247B5235ADF19775070,30371,6,12,6,109.51,18.24771,1559
129741,8880BF3B03853247B5235ADF19775070,30371,12,23,11,109.51,18.24771,1559
129747,AB8B051428E5E5EDACDABEECED7F5A35,31421,4,10,6,109.55382,18.22347,1705
129748,AB8B051428E5E5EDACDABEECED7F5A35,31071,12,14,2,109.58257,18.28458,1815
129749,AB8B051428E5E5EDACDABEECED7F5A35,31421,15,23,8,109.55382,18.22347,1705
129825,93F22684CF6BFF2B98A28D1F2EA5D875,30711,13,15,2,109.50271,18.25347,1510
129826,93F22684CF6BFF2B98A28D1F2EA5D875,31171,16,17,1,109.50938,18.24917,1559
129827,93F22684CF6BFF2B98A28D1F2EA5D875,30711,18,19,1,109.50271,18.25347,1510
129828,93F22684CF6BFF2B98A28D1F2EA5D875,31461,22,23,1,109.5091,18.25389,1510
129835,6876B785B3B8E427F5B0017E0B0EC706,60472,0,7,7,109.46625,18.29542,1367
129836,6876B785B3B8E427F5B0017E0B0EC706,31021,8,10,2,109.49021,18.27,1463
129837,6876B785B3B8E427F5B0017E0B0EC706,30611,12,14,2,109.74958,18.40188,2485
129838,6876B785B3B8E427F5B0017E0B0EC706,30211,18,20,2,109.49882,18.23931,1508
129839,6876B785B3B8E427F5B0017E0B0EC706,38127,21,23,2,109.50833,18.27222,1513
129842,1B3E8931F1FF667205B6505EE53C6E2C,31071,2,9,7,109.58257,18.28458,1815
129843,1B3E8931F1FF667205B6505EE53C6E2C,30854,14,15,1,109.56889,18.27076,1763
129844,1B3E8931F1FF667205B6505EE53C6E2C,31071,15,16,1,109.58257,18.28458,1815
129845,1B3E8931F1FF667205B6505EE53C6E2C,30854,17,19,2,109.56889,18.27076,1763
129862,EEC6B662D07BE95423A2DC77D2E69188,31071,12,14,2,109.58257,18.28458,1815
129863,EEC6B662D07BE95423A2DC77D2E69188,30854,14,17,3,109.56889,18.27076,1763
129980,452F0FF6BC36839041DCBEF2292D6E55,60661,0,8,8,109.548,18.2377,1657
129981,452F0FF6BC36839041DCBEF2292D6E55,31421,9,10,1,109.55382,18.22347,1705
129982,452F0FF6BC36839041DCBEF2292D6E55,30281,13,14,1,109.50597,18.27583,1514
129983,452F0FF6BC36839041DCBEF2292D6E55,60381,15,17,2,109.5241,18.22458,1605
129984,452F0FF6BC36839041DCBEF2292D6E55,31421,18,19,1,109.55382,18.22347,1705
129985,452F0FF6BC36839041DCBEF2292D6E55,60661,22,23,1,109.548,18.2377,1657
130026,AB43182259122294244C13D6FC66D4A1,30891,1,6,5,109.59431,18.28389,1865
130027,AB43182259122294244C13D6FC66D4A1,30851,8,10,2,109.5616,18.27396,1713
130028,AB43182259122294244C13D6FC66D4A1,31561,12,18,6,109.56792,18.28479,1765
130029,AB43182259122294244C13D6FC66D4A1,30891,19,20,1,109.59431,18.28389,1865
130030,AB43182259122294244C13D6FC66D4A1,60631,22,23,1,109.57778,18.27583,1814
130064,4E5EF6715EF8F99087B1600B906A4C49,30131,0,16,16,109.6959,18.215,2254
130065,4E5EF6715EF8F99087B1600B906A4C49,30861,18,19,1,109.52722,18.22743,1606
130066,4E5EF6715EF8F99087B1600B906A4C49,30131,21,23,2,109.6959,18.215,2254
130097,599AFAF71D30C85AA4E0085C43FF5E03,31206,1,11,10,109.50819,18.23549,1507
130098,599AFAF71D30C85AA4E0085C43FF5E03,38291,14,20,6,109.51618,18.24313,1558
130099,599AFAF71D30C85AA4E0085C43FF5E03,39154,21,23,2,109.50201,18.25681,1511
130104,4BA42026831E7F4B42D17FDF4BDEE62E,31931,0,15,15,109.54771,18.29403,1667
130105,4BA42026831E7F4B42D17FDF4BDEE62E,38127,19,20,1,109.50833,18.27222,1513
130142,7BF65E5054DA81A230AB5423620158E1,31071,0,4,4,109.58257,18.28458,1815
130143,7BF65E5054DA81A230AB5423620158E1,60631,5,7,2,109.57778,18.27583,1814
130144,7BF65E5054DA81A230AB5423620158E1,30854,7,16,9,109.56889,18.27076,1763
130145,7BF65E5054DA81A230AB5423620158E1,60631,21,23,2,109.57778,18.27583,1814
130146,CDB754188DCCAD5F0F53165537428C84,39091,15,16,1,109.50097,18.25222,1510
130147,CDB754188DCCAD5F0F53165537428C84,60411,21,23,2,109.32514,18.30854,869
130156,D1A5E6081E70F748BFD3C6895B141C01,60411,0,9,9,109.32514,18.30854,869
130157,D1A5E6081E70F748BFD3C6895B141C01,30661,11,15,4,109.37028,18.24361,1008
130158,D1A5E6081E70F748BFD3C6895B141C01,60411,16,18,2,109.32514,18.30854,869
130183,C58D0182BFC61ED113EE3B09763C30B2,38185,0,6,6,109.51333,18.27347,1563
130184,C58D0182BFC61ED113EE3B09763C30B2,31461,7,8,1,109.5091,18.25389,1510
130185,C58D0182BFC61ED113EE3B09763C30B2,38157,9,13,4,109.51483,18.26958,1563
130186,C58D0182BFC61ED113EE3B09763C30B2,39181,14,15,1,109.55153,18.28035,1715
130187,C58D0182BFC61ED113EE3B09763C30B2,60131,19,20,1,109.49819,18.24778,1509
130188,C58D0182BFC61ED113EE3B09763C30B2,38185,21,23,2,109.51333,18.27347,1563
130256,9352766CE000C006A9C46226806783DB,31071,0,6,6,109.58257,18.28458,1815
130257,9352766CE000C006A9C46226806783DB,30131,8,13,5,109.6959,18.215,2254
130258,9352766CE000C006A9C46226806783DB,31071,15,16,1,109.58257,18.28458,1815
130259,9352766CE000C006A9C46226806783DB,31561,16,18,2,109.56792,18.28479,1765
130326,86B0297E36D6ADB85661F97C0262CD46,30151,10,11,1,109.50986,18.25083,1560
130327,86B0297E36D6ADB85661F97C0262CD46,31181,12,15,3,109.50382,18.24813,1509
130328,86B0297E36D6ADB85661F97C0262CD46,60381,18,19,1,109.5241,18.22458,1605
130352,3871846CD20CC7E3D76BFB165D15B326,60401,16,17,1,109.47444,18.27583,1414
130353,3871846CD20CC7E3D76BFB165D15B326,30854,21,23,2,109.56889,18.27076,1763
130367,C6C3BC01E542B810EF853FEEB6C81198,60361,0,18,18,109.51938,18.29681,1567
130368,C6C3BC01E542B810EF853FEEB6C81198,31071,21,22,1,109.58257,18.28458,1815
130391,6C0260646767B781577B5B8CE2471E51,38484,1,16,15,109.53028,18.31528,1620
130392,6C0260646767B781577B5B8CE2471E51,30321,17,19,2,109.49563,18.29611,1467
130393,6C0260646767B781577B5B8CE2471E51,38484,19,20,1,109.53028,18.31528,1620
130394,6C0260646767B781577B5B8CE2471E51,38484,22,23,1,109.53028,18.31528,1620
130399,20C15B76A1E0DF79D86EDEAC7BC3D7B7,31071,0,18,18,109.58257,18.28458,1815
130400,20C15B76A1E0DF79D86EDEAC7BC3D7B7,31161,19,21,2,109.70229,18.31361,2270
130417,39D4F14340B4650E084697607335F122,30161,1,9,8,109.50042,18.24389,1508
130418,39D4F14340B4650E084697607335F122,39101,13,14,1,109.50132,18.24931,1509
130419,39D4F14340B4650E084697607335F122,31931,18,20,2,109.54771,18.29403,1667
130420,39D4F14340B4650E084697607335F122,39101,21,22,1,109.50132,18.24931,1509
130450,C1C69C0EAD4ABEFD1467543102429D9B,39183,1,3,2,109.55542,18.28208,1715
130451,C1C69C0EAD4ABEFD1467543102429D9B,30854,4,6,2,109.56889,18.27076,1763
130452,C1C69C0EAD4ABEFD1467543102429D9B,39183,6,7,1,109.55542,18.28208,1715
130453,C1C69C0EAD4ABEFD1467543102429D9B,60301,11,12,1,109.60715,18.30993,1919
130454,C1C69C0EAD4ABEFD1467543102429D9B,30281,14,15,1,109.50597,18.27583,1514
130455,C1C69C0EAD4ABEFD1467543102429D9B,39183,16,18,2,109.55542,18.28208,1715
130482,63B5E489F3503F8EC6E40A38F9D2117C,31931,2,4,2,109.54771,18.29403,1667
130483,63B5E489F3503F8EC6E40A38F9D2117C,60241,6,7,1,109.53319,18.28667,1616
130484,63B5E489F3503F8EC6E40A38F9D2117C,60361,8,10,2,109.51938,18.29681,1567
130485,63B5E489F3503F8EC6E40A38F9D2117C,31951,13,14,1,109.52174,18.30299,1568
130486,63B5E489F3503F8EC6E40A38F9D2117C,60171,17,19,2,109.51292,18.30694,1569
130513,FAC035CAF00431CACD74AF53D18C4996,30111,0,6,6,109.47583,18.30542,1419
130514,FAC035CAF00431CACD74AF53D18C4996,30764,7,9,2,109.45806,18.29486,1367
130515,FAC035CAF00431CACD74AF53D18C4996,30111,12,13,1,109.47583,18.30542,1419
130516,FAC035CAF00431CACD74AF53D18C4996,30764,14,18,4,109.45806,18.29486,1367
130517,FAC035CAF00431CACD74AF53D18C4996,60011,19,20,1,109.48965,18.30222,1468
130518,FAC035CAF00431CACD74AF53D18C4996,30111,20,22,2,109.47583,18.30542,1419
130555,7D72A79F2F964580140FF5C346A60898,60614,0,6,6,109.48799,18.29521,1467
130556,7D72A79F2F964580140FF5C346A60898,30941,9,11,2,109.5559,18.33938,1724
130557,7D72A79F2F964580140FF5C346A60898,38951,15,18,3,109.48097,18.28868,1416
130558,7D72A79F2F964580140FF5C346A60898,60614,19,20,1,109.48799,18.29521,1467
130566,CFFDD1BF3134B9FDD71614F40E1DE0FD,31561,1,3,2,109.56792,18.28479,1765
130567,CFFDD1BF3134B9FDD71614F40E1DE0FD,31071,5,9,4,109.58257,18.28458,1815
130568,CFFDD1BF3134B9FDD71614F40E1DE0FD,30851,10,11,1,109.5616,18.27396,1713
130569,CFFDD1BF3134B9FDD71614F40E1DE0FD,31071,12,15,3,109.58257,18.28458,1815
130570,CFFDD1BF3134B9FDD71614F40E1DE0FD,30851,18,19,1,109.5616,18.27396,1713
130571,CFFDD1BF3134B9FDD71614F40E1DE0FD,31071,21,23,2,109.58257,18.28458,1815
130596,8AABF5FDF2B06EB445749240A3894969,30854,1,2,1,109.56889,18.27076,1763
130597,8AABF5FDF2B06EB445749240A3894969,31071,4,8,4,109.58257,18.28458,1815
130598,8AABF5FDF2B06EB445749240A3894969,30854,10,12,2,109.56889,18.27076,1763
130599,34AA33805012BEA88EDC4AD9018BC70E,31181,1,14,13,109.50382,18.24813,1509
130600,34AA33805012BEA88EDC4AD9018BC70E,30421,15,16,1,109.50021,18.25861,1511
130601,34AA33805012BEA88EDC4AD9018BC70E,31181,20,22,2,109.50382,18.24813,1509
130641,9EF6440DA421994ED152A57FAE59B45B,31261,0,6,6,109.51174,18.2466,1559
130642,9EF6440DA421994ED152A57FAE59B45B,38291,6,10,4,109.51618,18.24313,1558
130643,9EF6440DA421994ED152A57FAE59B45B,30571,11,13,2,109.50243,18.21861,1504
130644,9EF6440DA421994ED152A57FAE59B45B,30051,13,14,1,109.48917,18.21215,1453
130645,9EF6440DA421994ED152A57FAE59B45B,60231,14,15,1,109.49903,18.21972,1504
130646,9EF6440DA421994ED152A57FAE59B45B,38911,18,19,1,109.51674,18.24965,1559
130647,9EF6440DA421994ED152A57FAE59B45B,31261,20,23,3,109.51174,18.2466,1559
130658,A515C2BA2B0AE21CADC42FF4E7FC0007,39181,0,6,6,109.55153,18.28035,1715
130659,A515C2BA2B0AE21CADC42FF4E7FC0007,39181,10,23,13,109.55153,18.28035,1715
130663,FE95B3A32EFBC2838F293DF38F55FDD1,39183,15,16,1,109.55542,18.28208,1715
130664,FE95B3A32EFBC2838F293DF38F55FDD1,30854,17,18,1,109.56889,18.27076,1763
130688,6C0D826A77A1C04C0B62713EC9E3496E,38141,0,10,10,109.39479,18.2916,1116
130689,6C0D826A77A1C04C0B62713EC9E3496E,31471,12,14,2,109.34583,18.29563,917
130690,6C0D826A77A1C04C0B62713EC9E3496E,30361,16,18,2,109.50347,18.24,1508
130691,6C0D826A77A1C04C0B62713EC9E3496E,38325,21,23,2,109.39792,18.2909,1116
130794,30CE72A519D49881F23B8123486E3A02,31471,17,19,2,109.34583,18.29563,917
130795,30CE72A519D49881F23B8123486E3A02,60411,20,21,1,109.32514,18.30854,869
130796,30CE72A519D49881F23B8123486E3A02,60054,21,22,1,109.3016,18.31229,770
130821,AAAED401E69F3FED1BCF91F4DEF17254,31471,15,17,2,109.34583,18.29563,917
130822,AAAED401E69F3FED1BCF91F4DEF17254,31841,21,23,2,109.73201,18.33382,2373
130860,408C4FED868686E7B96333835F4C4205,30854,0,7,7,109.56889,18.27076,1763
130861,408C4FED868686E7B96333835F4C4205,31071,8,15,7,109.58257,18.28458,1815
130862,408C4FED868686E7B96333835F4C4205,30201,18,20,2,109.4909,18.26465,1462
130888,10BCCD747640470AAA03DB965CE24293,30291,0,7,7,109.50403,18.27028,1513
130889,10BCCD747640470AAA03DB965CE24293,31951,12,16,4,109.52174,18.30299,1568
130890,10BCCD747640470AAA03DB965CE24293,38061,18,20,2,109.50597,18.23118,1506
130895,798BF3B08F72A16A6DEAAA235F1899BB,61011,8,23,15,109.60653,18.19076,1900
130924,4BD5B88B6C62E9E50471E319F2898EED,31081,0,7,7,109.44639,18.30181,1318
130925,4BD5B88B6C62E9E50471E319F2898EED,31301,8,10,2,109.14493,18.31222,170
130926,4BD5B88B6C62E9E50471E319F2898EED,31471,12,14,2,109.34583,18.29563,917
130927,B4CEE67D4055F0121BB3723E506478C1,60131,0,7,7,109.49819,18.24778,1509
130928,B4CEE67D4055F0121BB3723E506478C1,60381,8,10,2,109.5241,18.22458,1605
130929,B4CEE67D4055F0121BB3723E506478C1,30421,15,17,2,109.50021,18.25861,1511
130930,B4CEE67D4055F0121BB3723E506478C1,60621,19,23,4,109.48354,18.27451,1464
130986,A83BF34FB3DF79FCF76C955C7C1B2AAC,31421,15,16,1,109.55382,18.22347,1705
130987,A83BF34FB3DF79FCF76C955C7C1B2AAC,30421,16,18,2,109.50021,18.25861,1511
130988,A83BF34FB3DF79FCF76C955C7C1B2AAC,38171,19,20,1,109.50799,18.28139,1515
130989,A83BF34FB3DF79FCF76C955C7C1B2AAC,60381,20,23,3,109.5241,18.22458,1605
131042,FEF1B208BFBEDDE7B3E7A77BB07513A4,30341,14,23,9,109.3625,18.29167,966
131043,9B979E9430BCD0DDB6C78BBE525EBD2D,60631,4,5,1,109.57778,18.27583,1814
131044,9B979E9430BCD0DDB6C78BBE525EBD2D,30854,8,20,12,109.56889,18.27076,1763
131045,9B979E9430BCD0DDB6C78BBE525EBD2D,60631,22,23,1,109.57778,18.27583,1814
131046,D2ADB4C0F26D2E7501D600522A8254AC,60551,4,8,4,109.42722,18.30111,1218
131047,D2ADB4C0F26D2E7501D600522A8254AC,38361,8,12,4,109.43667,18.29201,1267
131048,D2ADB4C0F26D2E7501D600522A8254AC,60551,13,14,1,109.42722,18.30111,1218
131049,D2ADB4C0F26D2E7501D600522A8254AC,30361,15,18,3,109.50347,18.24,1508
131050,D2ADB4C0F26D2E7501D600522A8254AC,38361,21,23,2,109.43667,18.29201,1267
131064,C1793DCC823463513E28F999E76F9ADC,60054,0,6,6,109.3016,18.31229,770
131065,C1793DCC823463513E28F999E76F9ADC,31471,6,17,11,109.34583,18.29563,917
131066,C1793DCC823463513E28F999E76F9ADC,60054,19,23,4,109.3016,18.31229,770
131162,6751CEC3CF9B2AE78246C7287443D2B4,31945,0,7,7,109.58021,18.29403,1817
131163,6751CEC3CF9B2AE78246C7287443D2B4,30854,8,18,10,109.56889,18.27076,1763
131164,6751CEC3CF9B2AE78246C7287443D2B4,31945,20,23,3,109.58021,18.29403,1817
131172,7F632B4875B2736225CD6D350CD25670,30854,15,18,3,109.56889,18.27076,1763
131173,7F632B4875B2736225CD6D350CD25670,38251,21,22,1,109.49618,18.25493,1510
131186,4552AE0C0FB78BA3063EBA5C903C87F0,31421,0,6,6,109.55382,18.22347,1705
131190,4294195F192797A89367A7AA50405953,30201,0,9,9,109.4909,18.26465,1462
131191,4294195F192797A89367A7AA50405953,60524,9,11,2,109.42951,18.28993,1216
131192,4294195F192797A89367A7AA50405953,31061,14,16,2,109.53333,18.23257,1607
131193,4294195F192797A89367A7AA50405953,60641,17,23,6,109.53854,18.2359,1657
131214,51D8741123978D021DF7DCEBAD567A54,30711,0,8,8,109.50271,18.25347,1510
131215,51D8741123978D021DF7DCEBAD567A54,38251,8,9,1,109.49618,18.25493,1510
131242,DD045376657AFD220DDDD1E2A8CFE636,31861,16,20,4,109.49042,18.27549,1464
131275,59F29435D748531F416A4F1636997ECF,60381,15,16,1,109.5241,18.22458,1605
131276,59F29435D748531F416A4F1636997ECF,31041,19,23,4,109.50278,18.23701,1507
131280,FBC5739CB4FF6DA3B4E28BEEAB3F9194,60221,0,9,9,109.52569,18.29188,1616
131281,FBC5739CB4FF6DA3B4E28BEEAB3F9194,38251,11,12,1,109.49618,18.25493,1510
131282,FBC5739CB4FF6DA3B4E28BEEAB3F9194,30711,12,13,1,109.50271,18.25347,1510
131283,FBC5739CB4FF6DA3B4E28BEEAB3F9194,30711,14,15,1,109.50271,18.25347,1510
131284,FBC5739CB4FF6DA3B4E28BEEAB3F9194,30771,16,17,1,109.49938,18.26042,1511
131285,FBC5739CB4FF6DA3B4E28BEEAB3F9194,60221,21,23,2,109.52569,18.29188,1616
131286,2D0506173E3FD672D1B56E46B7843F5D,38754,14,16,2,109.74667,18.37382,2430
131287,2D0506173E3FD672D1B56E46B7843F5D,30191,21,22,1,109.50361,18.22701,1506
131291,68DBE0B52FD0AB95F1DD47068FD7847F,60311,0,8,8,109.52097,18.24319,1558
131292,68DBE0B52FD0AB95F1DD47068FD7847F,38291,8,10,2,109.51618,18.24313,1558
131293,68DBE0B52FD0AB95F1DD47068FD7847F,60311,11,12,1,109.52097,18.24319,1558
131294,68DBE0B52FD0AB95F1DD47068FD7847F,30181,13,15,2,109.51597,18.23313,1557
131295,68DBE0B52FD0AB95F1DD47068FD7847F,60311,18,22,4,109.52097,18.24319,1558
131319,A8ABE4987042D12DD458C81CFD9663F5,30711,17,18,1,109.50271,18.25347,1510
131320,A8ABE4987042D12DD458C81CFD9663F5,38127,18,23,5,109.50833,18.27222,1513
131331,9955D8331F1866B4F8C7C7981EBD1A88,31206,0,17,17,109.50819,18.23549,1507
131332,9955D8331F1866B4F8C7C7981EBD1A88,30181,18,19,1,109.51597,18.23313,1557
131337,B54CA9FDA6F9A4F01A3EC25BB60F0B4A,30731,0,9,9,109.50944,18.22306,1555
131338,B54CA9FDA6F9A4F01A3EC25BB60F0B4A,31521,9,11,2,109.51458,18.22542,1555
131339,B54CA9FDA6F9A4F01A3EC25BB60F0B4A,30731,13,14,1,109.50944,18.22306,1555
131340,B54CA9FDA6F9A4F01A3EC25BB60F0B4A,31521,15,16,1,109.51458,18.22542,1555
131341,B54CA9FDA6F9A4F01A3EC25BB60F0B4A,30731,20,22,2,109.50944,18.22306,1555
131355,74206C862E4BA6236E7F7978D63D1D7D,60631,4,7,3,109.57778,18.27583,1814
131356,74206C862E4BA6236E7F7978D63D1D7D,30854,7,8,1,109.56889,18.27076,1763
131374,5F458C24FFFBC33D1CB0F07B19ED30E6,38017,4,5,1,109.49729,18.21424,1504
131375,5F458C24FFFBC33D1CB0F07B19ED30E6,30051,7,8,1,109.48917,18.21215,1453
131376,5F458C24FFFBC33D1CB0F07B19ED30E6,31521,12,14,2,109.51458,18.22542,1555
131377,5F458C24FFFBC33D1CB0F07B19ED30E6,30571,16,18,2,109.50243,18.21861,1504
131378,5F458C24FFFBC33D1CB0F07B19ED30E6,30854,19,21,2,109.56889,18.27076,1763
131396,E58E5EFF0A1D7ADABE8F5BBEE665ED0D,30861,19,21,2,109.52722,18.22743,1606
131397,E58E5EFF0A1D7ADABE8F5BBEE665ED0D,60641,21,23,2,109.53854,18.2359,1657
131406,DECB7B3FC95BFA8620EFD8D9DE328252,31945,9,19,10,109.58021,18.29403,1817
131407,DECB7B3FC95BFA8620EFD8D9DE328252,30854,19,23,4,109.56889,18.27076,1763
131415,7E95AEA91A37473FF71C625BDD54FD92,60361,14,15,1,109.51938,18.29681,1567
131416,7E95AEA91A37473FF71C625BDD54FD92,60226,19,20,1,109.5175,18.28778,1566
131417,DF2AB4A2AE483AAADBD33D9CC2795C10,30854,0,13,13,109.56889,18.27076,1763
131418,DF2AB4A2AE483AAADBD33D9CC2795C10,31071,14,15,1,109.58257,18.28458,1815
131419,DF2AB4A2AE483AAADBD33D9CC2795C10,30854,18,20,2,109.56889,18.27076,1763
131420,DF2AB4A2AE483AAADBD33D9CC2795C10,31071,20,23,3,109.58257,18.28458,1815
131437,C7B596C3998F49DC6B86FB54AB7111B3,31071,0,5,5,109.58257,18.28458,1815
131438,C7B596C3998F49DC6B86FB54AB7111B3,30706,6,8,2,109.58833,18.31125,1820
131439,C7B596C3998F49DC6B86FB54AB7111B3,31071,9,23,14,109.58257,18.28458,1815
131488,407AE188132462D6A2BFC7C6B4E99CAE,38251,1,11,10,109.49618,18.25493,1510
131489,407AE188132462D6A2BFC7C6B4E99CAE,31101,13,16,3,109.65389,18.23403,2057
131490,407AE188132462D6A2BFC7C6B4E99CAE,38281,17,19,2,109.6525,18.23403,2057
131491,407AE188132462D6A2BFC7C6B4E99CAE,31101,21,23,2,109.65389,18.23403,2057
131492,0EA31DC24D5B7028E03AA286B0DB11EF,31071,0,6,6,109.58257,18.28458,1815
131493,0EA31DC24D5B7028E03AA286B0DB11EF,60631,10,12,2,109.57778,18.27583,1814
131494,0EA31DC24D5B7028E03AA286B0DB11EF,31071,16,17,1,109.58257,18.28458,1815
131518,FE6376AB53578CB7B343C13E491275A1,30771,6,7,1,109.49938,18.26042,1511
131519,FE6376AB53578CB7B343C13E491275A1,39154,11,13,2,109.50201,18.25681,1511
131520,FE6376AB53578CB7B343C13E491275A1,30201,14,19,5,109.4909,18.26465,1462
131558,222E0B6922623CE9FBB280F81068D40E,30854,15,19,4,109.56889,18.27076,1763
131559,222E0B6922623CE9FBB280F81068D40E,30081,19,20,1,109.50243,18.26632,1512
131584,46D10B971C10D2856504DC61068F66E7,31091,13,18,5,109.41201,18.31222,1170
131585,46D10B971C10D2856504DC61068F66E7,30921,19,21,2,109.53903,18.29451,1667
131586,46D10B971C10D2856504DC61068F66E7,60221,21,23,2,109.52569,18.29188,1616
131601,8CA8213586CAC00347DCD29330308F27,30571,18,19,1,109.50243,18.21861,1504
131602,8CA8213586CAC00347DCD29330308F27,31031,20,21,1,109.49979,18.25382,1510
131620,7C68E1F4B8B2F3CBBD5427BF66BF9C2E,30891,0,1,1,109.59431,18.28389,1865
131621,7C68E1F4B8B2F3CBBD5427BF66BF9C2E,30854,4,7,3,109.56889,18.27076,1763
131622,7C68E1F4B8B2F3CBBD5427BF66BF9C2E,31571,8,10,2,109.61563,18.23326,1957
131623,7C68E1F4B8B2F3CBBD5427BF66BF9C2E,38054,11,13,2,109.63479,18.23097,2006
131629,9BD095517798346F169AD6D898CA1A42,60361,0,6,6,109.51938,18.29681,1567
131630,9BD095517798346F169AD6D898CA1A42,60221,6,7,1,109.52569,18.29188,1616
131631,9BD095517798346F169AD6D898CA1A42,60361,11,15,4,109.51938,18.29681,1567
131632,9BD095517798346F169AD6D898CA1A42,60221,20,22,2,109.52569,18.29188,1616
131636,5403ECE41AD9921A5DEF63FF6DE6A9D1,30854,0,1,1,109.56889,18.27076,1763
131637,5403ECE41AD9921A5DEF63FF6DE6A9D1,31071,2,9,7,109.58257,18.28458,1815
131638,5403ECE41AD9921A5DEF63FF6DE6A9D1,30854,10,18,8,109.56889,18.27076,1763
131639,5403ECE41AD9921A5DEF63FF6DE6A9D1,31071,20,21,1,109.58257,18.28458,1815
131640,5403ECE41AD9921A5DEF63FF6DE6A9D1,30854,22,23,1,109.56889,18.27076,1763
131655,15195C578D4A8081B069C4B518039EFC,60371,15,17,2,109.53063,18.30056,1618
131656,15195C578D4A8081B069C4B518039EFC,60221,18,19,1,109.52569,18.29188,1616
131657,15195C578D4A8081B069C4B518039EFC,31031,20,23,3,109.49979,18.25382,1510
131696,C97A61E87ADF22CB0CED7FFED3A35BC3,30951,15,18,3,109.56208,18.25667,1761
131710,080247CC19405F981D4BEFE1A1E9D339,39181,0,1,1,109.55153,18.28035,1715
131711,080247CC19405F981D4BEFE1A1E9D339,31931,2,5,3,109.54771,18.29403,1667
131712,080247CC19405F981D4BEFE1A1E9D339,60671,9,10,1,109.52979,18.31757,1621
131735,66F845C21313F6E347B30C7E8BF089D2,60621,0,6,6,109.48354,18.27451,1464
131736,66F845C21313F6E347B30C7E8BF089D2,60501,7,9,2,109.48701,18.29021,1466
131737,66F845C21313F6E347B30C7E8BF089D2,30371,13,14,1,109.51,18.24771,1559
131738,66F845C21313F6E347B30C7E8BF089D2,30371,15,18,3,109.51,18.24771,1559
131739,66F845C21313F6E347B30C7E8BF089D2,30084,20,21,1,109.50118,18.26972,1513
131740,66F845C21313F6E347B30C7E8BF089D2,31531,22,23,1,109.49583,18.25972,1461
131741,6784729F492E40D40F1F209931B40EB9,31031,20,21,1,109.49979,18.25382,1510
131742,6784729F492E40D40F1F209931B40EB9,30351,21,23,2,109.41701,18.29292,1217
131845,9316856FC9B7BE008DD2CC2209708EA4,30131,0,7,7,109.6959,18.215,2254
131846,9316856FC9B7BE008DD2CC2209708EA4,30121,9,11,2,109.52861,18.27222,1613
131847,9316856FC9B7BE008DD2CC2209708EA4,30161,12,13,1,109.50042,18.24389,1508
131848,9316856FC9B7BE008DD2CC2209708EA4,30121,15,18,3,109.52861,18.27222,1613
131849,9316856FC9B7BE008DD2CC2209708EA4,30131,19,23,4,109.6959,18.215,2254
131927,002C7A8161A15E55D29FBC7F9B584A32,31304,5,6,1,109.15903,18.32854,223
131929,002C7A8161A15E55D29FBC7F9B584A32,31304,13,15,2,109.15903,18.32854,223
131951,BA987FAAC62A550769ECB5E13AC256A5,38171,0,8,8,109.50799,18.28139,1515
131952,BA987FAAC62A550769ECB5E13AC256A5,31931,9,10,1,109.54771,18.29403,1667
131953,BA987FAAC62A550769ECB5E13AC256A5,30151,12,13,1,109.50986,18.25083,1560
131954,BA987FAAC62A550769ECB5E13AC256A5,38171,13,15,2,109.50799,18.28139,1515
131963,4A6E6277F47F7550E2618B9C1ADC3166,30361,0,9,9,109.50347,18.24,1508
131964,4A6E6277F47F7550E2618B9C1ADC3166,31391,10,11,1,109.50382,18.24285,1508
131965,4A6E6277F47F7550E2618B9C1ADC3166,30361,13,23,10,109.50347,18.24,1508
131966,39E5C7923C3234177BB4A3BFF8D867ED,30361,0,11,11,109.50347,18.24,1508
131967,39E5C7923C3234177BB4A3BFF8D867ED,60054,13,15,2,109.3016,18.31229,770
131968,39E5C7923C3234177BB4A3BFF8D867ED,30361,18,23,5,109.50347,18.24,1508
132058,5A888DC7A3AA300CC584D9862C5384A1,30421,0,1,1,109.50021,18.25861,1511
132059,5A888DC7A3AA300CC584D9862C5384A1,31461,4,7,3,109.5091,18.25389,1510
132060,5A888DC7A3AA300CC584D9862C5384A1,39181,12,14,2,109.55153,18.28035,1715
132061,5A888DC7A3AA300CC584D9862C5384A1,31931,14,15,1,109.54771,18.29403,1667
132085,1CE7F29C06B3E8D5875212BD6805BDFB,31071,0,7,7,109.58257,18.28458,1815
132086,1CE7F29C06B3E8D5875212BD6805BDFB,30161,11,16,5,109.50042,18.24389,1508
132087,875F4B80762D0E664890361D764F907D,60081,0,7,7,109.51097,18.22639,1556
132088,875F4B80762D0E664890361D764F907D,30571,7,18,11,109.50243,18.21861,1504
132089,875F4B80762D0E664890361D764F907D,60081,19,23,4,109.51097,18.22639,1556
132170,C0A84E293FFFD544F9A2EE258D4D51EC,31461,1,5,4,109.5091,18.25389,1510
132171,C0A84E293FFFD544F9A2EE258D4D51EC,39154,6,10,4,109.50201,18.25681,1511
132172,C0A84E293FFFD544F9A2EE258D4D51EC,31471,11,13,2,109.34583,18.29563,917
132173,C0A84E293FFFD544F9A2EE258D4D51EC,31471,13,14,1,109.34583,18.29563,917
132199,302C193EE9901423C2412C2BB087FCC7,30351,12,14,2,109.41701,18.29292,1217
132200,302C193EE9901423C2412C2BB087FCC7,31091,15,20,5,109.41201,18.31222,1170
132201,302C193EE9901423C2412C2BB087FCC7,31231,20,21,1,109.42597,18.29292,1217
132202,302C193EE9901423C2412C2BB087FCC7,30351,22,23,1,109.41701,18.29292,1217
132206,9B389AE8E9B004176803CCEAFF69104A,60631,1,5,4,109.57778,18.27583,1814
132207,9B389AE8E9B004176803CCEAFF69104A,31071,7,9,2,109.58257,18.28458,1815
132208,9B389AE8E9B004176803CCEAFF69104A,60631,13,19,6,109.57778,18.27583,1814
132243,8877F0646282478FC034CF7A2CC8A7FE,31521,0,2,2,109.51458,18.22542,1555
132244,8877F0646282478FC034CF7A2CC8A7FE,60291,2,6,4,109.50826,18.24639,1509
132253,DADE85815C8ECCC9738CA3D0741CB1B3,31471,14,17,3,109.34583,18.29563,917
132254,DADE85815C8ECCC9738CA3D0741CB1B3,60381,18,20,2,109.5241,18.22458,1605
132255,DADE85815C8ECCC9738CA3D0741CB1B3,31421,21,22,1,109.55382,18.22347,1705
132256,CE045EEE305A10957A4EB0B7223F0776,31031,0,7,7,109.49979,18.25382,1510
132257,CE045EEE305A10957A4EB0B7223F0776,31781,9,10,1,109.19847,18.2975,367
132258,CE045EEE305A10957A4EB0B7223F0776,31471,12,14,2,109.34583,18.29563,917
132274,47DB633DCEAA585A5A9E2D686518C9D0,30854,0,15,15,109.56889,18.27076,1763
132275,47DB633DCEAA585A5A9E2D686518C9D0,30851,16,17,1,109.5616,18.27396,1713
132276,47DB633DCEAA585A5A9E2D686518C9D0,30854,19,20,1,109.56889,18.27076,1763
132290,887B4CB1328C20D61945E5BC833B406E,30071,0,6,6,109.52819,18.30472,1619
132291,887B4CB1328C20D61945E5BC833B406E,60371,6,13,7,109.53063,18.30056,1618
132292,887B4CB1328C20D61945E5BC833B406E,30031,14,15,1,109.53681,18.33313,1673
132293,887B4CB1328C20D61945E5BC833B406E,60371,18,19,1,109.53063,18.30056,1618
132294,887B4CB1328C20D61945E5BC833B406E,60221,19,23,4,109.52569,18.29188,1616
132321,B80D6AB96D3D5CEE71A70ED25275F830,38951,0,9,9,109.48097,18.28868,1416
132322,B80D6AB96D3D5CEE71A70ED25275F830,38951,11,12,1,109.48097,18.28868,1416
132323,B80D6AB96D3D5CEE71A70ED25275F830,31531,14,23,9,109.49583,18.25972,1461
132332,17D13F6A66037B54FAB5668CDC734401,30721,0,6,6,109.51597,18.28257,1565
132333,17D13F6A66037B54FAB5668CDC734401,31931,7,10,3,109.54771,18.29403,1667
132334,17D13F6A66037B54FAB5668CDC734401,30721,13,23,10,109.51597,18.28257,1565
132462,CBEABB1E72916DEDB4C30D20E0746E11,30354,0,8,8,109.42813,18.29076,1216
132463,CBEABB1E72916DEDB4C30D20E0746E11,31781,10,13,3,109.19847,18.2975,367
132464,CBEABB1E72916DEDB4C30D20E0746E11,30354,17,23,6,109.42813,18.29076,1216
132474,81D70A3ED522BA9C5A3A11D0C612F029,30731,0,1,1,109.50944,18.22306,1555
132475,81D70A3ED522BA9C5A3A11D0C612F029,30731,2,6,4,109.50944,18.22306,1555
132476,81D70A3ED522BA9C5A3A11D0C612F029,30221,9,11,2,109.57833,18.20222,1802
132477,81D70A3ED522BA9C5A3A11D0C612F029,30191,16,17,1,109.50361,18.22701,1506
132565,355E9BABB06A4EA2083D2B98B74A3F80,39321,13,14,1,109.529,18.2167,1604
132566,355E9BABB06A4EA2083D2B98B74A3F80,39091,15,17,2,109.50097,18.25222,1510
132567,355E9BABB06A4EA2083D2B98B74A3F80,30891,18,20,2,109.59431,18.28389,1865
132574,8621CFDF1B89A83351494618C53D033F,39181,0,8,8,109.55153,18.28035,1715
132575,8621CFDF1B89A83351494618C53D033F,31071,9,10,1,109.58257,18.28458,1815
132576,8621CFDF1B89A83351494618C53D033F,39181,11,14,3,109.55153,18.28035,1715
132577,8621CFDF1B89A83351494618C53D033F,31071,14,15,1,109.58257,18.28458,1815
132578,8621CFDF1B89A83351494618C53D033F,39181,15,20,5,109.55153,18.28035,1715
132579,8621CFDF1B89A83351494618C53D033F,39181,20,22,2,109.55153,18.28035,1715
132664,BE7763F8096EB5A037146E1CC4190538,30854,1,2,1,109.56889,18.27076,1763
132665,BE7763F8096EB5A037146E1CC4190538,30324,7,16,9,109.50326,18.29257,1517
132712,FD0AE67B2089C3E18D5A20F1644632E4,31437,0,8,8,109.45049,18.29146,1316
132713,FD0AE67B2089C3E18D5A20F1644632E4,31145,10,12,2,109.20431,18.30479,369
132714,FD0AE67B2089C3E18D5A20F1644632E4,60054,14,16,2,109.3016,18.31229,770
132715,FD0AE67B2089C3E18D5A20F1644632E4,31437,20,23,3,109.45049,18.29146,1316
132863,EB316856896788EC8FD871E122E95728,31811,0,3,3,109.54201,18.31806,1671
132864,EB316856896788EC8FD871E122E95728,30701,3,7,4,109.59313,18.32007,1871
132865,EB316856896788EC8FD871E122E95728,31811,7,17,10,109.54201,18.31806,1671
132866,EB316856896788EC8FD871E122E95728,30701,21,23,2,109.59313,18.32007,1871
132869,8F3DE08315D720DC64DC898C5903196E,30854,0,3,3,109.56889,18.27076,1763
132870,8F3DE08315D720DC64DC898C5903196E,39371,4,5,1,109.56627,18.2646,1762
132871,8F3DE08315D720DC64DC898C5903196E,60631,8,9,1,109.57778,18.27583,1814
132872,8F3DE08315D720DC64DC898C5903196E,30854,12,23,11,109.56889,18.27076,1763
132876,13C882817D5EF3329D8612AEE7E0F34D,31864,0,11,11,109.49014,18.28333,1465
132877,13C882817D5EF3329D8612AEE7E0F34D,30961,14,15,1,109.74042,18.37903,2431
132878,13C882817D5EF3329D8612AEE7E0F34D,31091,19,20,1,109.41201,18.31222,1170
132905,878FC5EBB1B28FAABA6E6BFD01664318,30251,0,17,17,109.50611,18.26653,1512
132906,878FC5EBB1B28FAABA6E6BFD01664318,31031,18,19,1,109.49979,18.25382,1510
132942,3C6C31F30579C628F9EDFADEE409AE9F,60671,14,16,2,109.52979,18.31757,1621
132943,3C6C31F30579C628F9EDFADEE409AE9F,30921,17,19,2,109.53903,18.29451,1667
132944,3C6C31F30579C628F9EDFADEE409AE9F,30101,19,22,3,109.57299,18.33333,1773
133008,58DE8A719D3ADBEDAE163213845B460A,31071,0,7,7,109.58257,18.28458,1815
133009,58DE8A719D3ADBEDAE163213845B460A,30854,8,11,3,109.56889,18.27076,1763
133010,58DE8A719D3ADBEDAE163213845B460A,31071,12,23,11,109.58257,18.28458,1815
133073,F83D748D9AC433CCB24E3050C5762E35,30661,0,5,5,109.37028,18.24361,1008
133074,F83D748D9AC433CCB24E3050C5762E35,38023,7,9,2,109.37132,18.28993,1016
133075,F83D748D9AC433CCB24E3050C5762E35,31471,10,11,1,109.34583,18.29563,917
133076,F83D748D9AC433CCB24E3050C5762E35,31471,12,14,2,109.34583,18.29563,917
133077,F83D748D9AC433CCB24E3050C5762E35,31101,16,23,7,109.65389,18.23403,2057
133096,C8A5539982743C3D86E28F8FF2DA3472,39183,2,8,6,109.55542,18.28208,1715
133097,C8A5539982743C3D86E28F8FF2DA3472,30951,9,17,8,109.56208,18.25667,1761
133098,C8A5539982743C3D86E28F8FF2DA3472,31421,17,18,1,109.55382,18.22347,1705
133099,C8A5539982743C3D86E28F8FF2DA3472,30951,21,23,2,109.56208,18.25667,1761
133130,64E97CAFCF024F6A9B1AA7827CD1E4FF,31206,17,18,1,109.50819,18.23549,1507
133131,64E97CAFCF024F6A9B1AA7827CD1E4FF,30671,21,22,1,109.43611,18.30139,1268
133170,5264833F0013AE6B294396000613EF89,31411,19,20,1,109.5016,18.23576,1507
133171,5264833F0013AE6B294396000613EF89,31461,21,23,2,109.5091,18.25389,1510
133178,AE6DC7ACB81DB5F351E45AC25E5F5A3B,31201,0,2,2,109.51042,18.23819,1558
133179,AE6DC7ACB81DB5F351E45AC25E5F5A3B,30161,2,4,2,109.50042,18.24389,1508
133180,AE6DC7ACB81DB5F351E45AC25E5F5A3B,38297,5,10,5,109.52576,18.24965,1609
133181,AE6DC7ACB81DB5F351E45AC25E5F5A3B,60281,10,11,1,109.51743,18.25924,1561
133182,AE6DC7ACB81DB5F351E45AC25E5F5A3B,38297,12,14,2,109.52576,18.24965,1609
133207,DE85A2F9432633114A7B9A1B323B8AE9,30051,0,6,6,109.48917,18.21215,1453
133208,DE85A2F9432633114A7B9A1B323B8AE9,30571,7,8,1,109.50243,18.21861,1504
133209,DE85A2F9432633114A7B9A1B323B8AE9,30051,12,15,3,109.48917,18.21215,1453
133210,DE85A2F9432633114A7B9A1B323B8AE9,60231,16,17,1,109.49903,18.21972,1504
133211,DE85A2F9432633114A7B9A1B323B8AE9,30051,17,23,6,109.48917,18.21215,1453
133217,2F440A235E684ECEDD042B3100A4AE95,31071,0,7,7,109.58257,18.28458,1815
133218,2F440A235E684ECEDD042B3100A4AE95,30101,9,10,1,109.57299,18.33333,1773
133219,2F440A235E684ECEDD042B3100A4AE95,30854,13,18,5,109.56889,18.27076,1763
133220,2F440A235E684ECEDD042B3100A4AE95,31071,18,23,5,109.58257,18.28458,1815
133281,5EBEA276FCB4A19AC5C987F5C7CC8908,60472,2,7,5,109.46625,18.29542,1367
133282,5EBEA276FCB4A19AC5C987F5C7CC8908,60401,10,12,2,109.47444,18.27583,1414
133283,5EBEA276FCB4A19AC5C987F5C7CC8908,38361,12,15,3,109.43667,18.29201,1267
133284,5EBEA276FCB4A19AC5C987F5C7CC8908,60552,18,21,3,109.41729,18.30014,1218
133298,11ACC233938E27960515F82E3D9CDE84,39321,0,7,7,109.529,18.2167,1604
133299,11ACC233938E27960515F82E3D9CDE84,30391,9,11,2,109.4975,18.27118,1513
133300,11ACC233938E27960515F82E3D9CDE84,30861,11,12,1,109.52722,18.22743,1606
133301,11ACC233938E27960515F82E3D9CDE84,39321,12,16,4,109.529,18.2167,1604
133302,11ACC233938E27960515F82E3D9CDE84,38127,17,21,4,109.50833,18.27222,1513
133311,7B1A07C39637E996C01DF0A3D287D3C6,30854,3,13,10,109.56889,18.27076,1763
133312,7B1A07C39637E996C01DF0A3D287D3C6,31071,14,16,2,109.58257,18.28458,1815
133313,7B1A07C39637E996C01DF0A3D287D3C6,30854,16,21,5,109.56889,18.27076,1763
133328,4F6A6D6BDB1CA40A8AF45B87F3BE9E9C,31881,1,7,6,109.7441,18.40785,2436
133329,4F6A6D6BDB1CA40A8AF45B87F3BE9E9C,30791,7,8,1,109.72333,18.40889,2386
133330,4F6A6D6BDB1CA40A8AF45B87F3BE9E9C,31841,13,14,1,109.73201,18.33382,2373
133333,DB4DF566D4757FF3BB488F82DE126248,31561,0,16,16,109.56792,18.28479,1765
133334,DB4DF566D4757FF3BB488F82DE126248,30851,16,18,2,109.5616,18.27396,1713
133335,DB4DF566D4757FF3BB488F82DE126248,31561,19,22,3,109.56792,18.28479,1765
133364,0312B43ACF9ED1D8304E325E851AEE29,31561,7,17,10,109.56792,18.28479,1765
133365,0312B43ACF9ED1D8304E325E851AEE29,30851,17,20,3,109.5616,18.27396,1713
133366,0312B43ACF9ED1D8304E325E851AEE29,31561,20,21,1,109.56792,18.28479,1765
133381,2683DB6FF8EE2860DFC386D0B7C69394,38991,0,6,6,109.52681,18.30368,1618
133382,2683DB6FF8EE2860DFC386D0B7C69394,31931,9,15,6,109.54771,18.29403,1667
133383,2683DB6FF8EE2860DFC386D0B7C69394,60371,20,22,2,109.53063,18.30056,1618
133406,B55959B64746A18ECF5077B5F7359221,39183,15,17,2,109.55542,18.28208,1715
133407,B55959B64746A18ECF5077B5F7359221,30854,18,22,4,109.56889,18.27076,1763
133465,5CC1762A5E087A77C8027D2CC6A16A88,30071,0,8,8,109.52819,18.30472,1619
133466,5CC1762A5E087A77C8027D2CC6A16A88,38991,11,23,12,109.52681,18.30368,1618
133520,18EEDE3CAC40E34C9E86FDF8437ADA92,31391,0,7,7,109.50382,18.24285,1508
133521,18EEDE3CAC40E34C9E86FDF8437ADA92,31201,7,10,3,109.51042,18.23819,1558
133522,18EEDE3CAC40E34C9E86FDF8437ADA92,30181,10,18,8,109.51597,18.23313,1557
133523,18EEDE3CAC40E34C9E86FDF8437ADA92,30181,19,23,4,109.51597,18.23313,1557
133635,0C8D15C0488D521680F0DE3A28CFE111,31811,0,7,7,109.54201,18.31806,1671
133636,0C8D15C0488D521680F0DE3A28CFE111,30701,7,9,2,109.59313,18.32007,1871
133637,0C8D15C0488D521680F0DE3A28CFE111,31811,10,11,1,109.54201,18.31806,1671
133638,0C8D15C0488D521680F0DE3A28CFE111,30701,12,16,4,109.59313,18.32007,1871
133639,0C8D15C0488D521680F0DE3A28CFE111,31811,17,21,4,109.54201,18.31806,1671
133640,0C8D15C0488D521680F0DE3A28CFE111,30701,21,23,2,109.59313,18.32007,1871
133720,6B806948BC9187A91D033B4096721B00,31561,0,3,3,109.56792,18.28479,1765
133721,6B806948BC9187A91D033B4096721B00,30854,5,7,2,109.56889,18.27076,1763
133722,6B806948BC9187A91D033B4096721B00,31071,8,18,10,109.58257,18.28458,1815
133723,6B806948BC9187A91D033B4096721B00,31561,20,21,1,109.56792,18.28479,1765
133765,5A7A3D5F722F0EB2695C45BF16BBC483,38157,0,10,10,109.51483,18.26958,1563
133766,5A7A3D5F722F0EB2695C45BF16BBC483,30421,10,12,2,109.50021,18.25861,1511
133767,5A7A3D5F722F0EB2695C45BF16BBC483,60291,12,13,1,109.50826,18.24639,1509
133768,5A7A3D5F722F0EB2695C45BF16BBC483,38157,15,18,3,109.51483,18.26958,1563
133769,5A7A3D5F722F0EB2695C45BF16BBC483,39111,21,22,1,109.5191,18.22597,1555
133795,35011D65DB8F346A960E649EB3FC56D5,30181,0,8,8,109.51597,18.23313,1557
133797,35011D65DB8F346A960E649EB3FC56D5,31311,13,15,2,109.72299,18.27438,2364
133798,35011D65DB8F346A960E649EB3FC56D5,31521,16,17,1,109.51458,18.22542,1555
133799,35011D65DB8F346A960E649EB3FC56D5,30181,18,22,4,109.51597,18.23313,1557
133815,C608AF81E00885FA602816017BA139C9,30854,0,4,4,109.56889,18.27076,1763
133816,C608AF81E00885FA602816017BA139C9,30891,7,16,9,109.59431,18.28389,1865
133817,C608AF81E00885FA602816017BA139C9,39371,17,18,1,109.56627,18.2646,1762
133818,C608AF81E00885FA602816017BA139C9,30854,22,23,1,109.56889,18.27076,1763
133944,B3E95D5FEFF26E73B4387678C52BCA45,38171,19,23,4,109.50799,18.28139,1515
133964,6AF6E3AFD18EC04099B3351F858D9C1A,30421,0,6,6,109.50021,18.25861,1511
133965,6AF6E3AFD18EC04099B3351F858D9C1A,33051,10,12,2,109.6475,18.46618,2096
133966,6AF6E3AFD18EC04099B3351F858D9C1A,38251,14,15,1,109.49618,18.25493,1510
133967,6AF6E3AFD18EC04099B3351F858D9C1A,30421,16,18,2,109.50021,18.25861,1511
134014,EF0AF6DFF11E792E87881ED5E6F91398,38154,0,5,5,109.5266,18.28278,1615
134015,EF0AF6DFF11E792E87881ED5E6F91398,30851,9,11,2,109.5616,18.27396,1713
134016,EF0AF6DFF11E792E87881ED5E6F91398,39183,12,18,6,109.55542,18.28208,1715
134017,EF0AF6DFF11E792E87881ED5E6F91398,30721,20,22,2,109.51597,18.28257,1565
134026,C93386A9D86FE22A1FD4E5116045DD8D,31561,0,3,3,109.56792,18.28479,1765
134027,C93386A9D86FE22A1FD4E5116045DD8D,39183,7,9,2,109.55542,18.28208,1715
134028,C93386A9D86FE22A1FD4E5116045DD8D,31561,10,12,2,109.56792,18.28479,1765
134029,C93386A9D86FE22A1FD4E5116045DD8D,39183,15,18,3,109.55542,18.28208,1715
134030,C93386A9D86FE22A1FD4E5116045DD8D,31561,21,23,2,109.56792,18.28479,1765
134074,386A993804AE7686717510E63DEFF753,31841,0,8,8,109.73201,18.33382,2373
134075,386A993804AE7686717510E63DEFF753,33481,10,12,2,109.67278,18.41278,2187
134083,AE549D1F82210589834DD25B264622B0,31864,1,10,9,109.49014,18.28333,1465
134084,AE549D1F82210589834DD25B264622B0,60281,13,14,1,109.51743,18.25924,1561
134085,AE549D1F82210589834DD25B264622B0,31534,15,17,2,109.49368,18.25806,1461
134098,6587551DA47309E484D1302521C8D417,60631,0,7,7,109.57778,18.27583,1814
134099,6587551DA47309E484D1302521C8D417,38275,8,20,12,109.62875,18.22938,2006
134100,6587551DA47309E484D1302521C8D417,30854,20,22,2,109.56889,18.27076,1763
134127,EFDE35289FEC1E13D6F34EFEE66A8AD2,60631,0,7,7,109.57778,18.27583,1814
134128,EFDE35289FEC1E13D6F34EFEE66A8AD2,31071,11,12,1,109.58257,18.28458,1815
134129,EFDE35289FEC1E13D6F34EFEE66A8AD2,30854,15,16,1,109.56889,18.27076,1763
134130,EFDE35289FEC1E13D6F34EFEE66A8AD2,60631,17,23,6,109.57778,18.27583,1814
134139,B207231D4D7F99627BB65117B9554A5E,60381,0,4,4,109.5241,18.22458,1605
134140,B207231D4D7F99627BB65117B9554A5E,31521,8,9,1,109.51458,18.22542,1555
134141,B207231D4D7F99627BB65117B9554A5E,31781,12,14,2,109.19847,18.2975,367
134151,3977578BE56276DA0700B04B81DC1356,31561,0,11,11,109.56792,18.28479,1765
134152,3977578BE56276DA0700B04B81DC1356,30161,14,15,1,109.50042,18.24389,1508
134153,3977578BE56276DA0700B04B81DC1356,31561,17,21,4,109.56792,18.28479,1765
134159,E5DA2FC779B1E8E31A367E849D1BF38A,38127,0,5,5,109.50833,18.27222,1513
134160,E5DA2FC779B1E8E31A367E849D1BF38A,31461,8,9,1,109.5091,18.25389,1510
134161,E5DA2FC779B1E8E31A367E849D1BF38A,30511,11,15,4,109.51069,18.24208,1558
134162,E5DA2FC779B1E8E31A367E849D1BF38A,38127,16,19,3,109.50833,18.27222,1513
134163,E5DA2FC779B1E8E31A367E849D1BF38A,31071,20,22,2,109.58257,18.28458,1815
134164,E5DA2FC779B1E8E31A367E849D1BF38A,30854,22,23,1,109.56889,18.27076,1763
134238,F203E94EEA8913AD49AA02E37C0DFB8F,30821,13,14,1,109.43681,18.33639,1274
134239,F203E94EEA8913AD49AA02E37C0DFB8F,60041,17,20,3,109.39889,18.31944,1121
134255,AD608A919061B1C684914F8654FB2493,30241,8,9,1,109.26174,18.3275,622
134256,AD608A919061B1C684914F8654FB2493,30651,14,15,1,109.42611,18.385,1232
134257,D37BF241A4A35F0F341582CAF9EF0DD2,30161,16,18,2,109.50042,18.24389,1508
134258,D37BF241A4A35F0F341582CAF9EF0DD2,39101,19,23,4,109.50132,18.24931,1509
134316,9111D45CF0ACFF1F78F6B2A96D11CE9D,31351,0,7,7,109.4959,18.28417,1465
134317,9111D45CF0ACFF1F78F6B2A96D11CE9D,30741,8,10,2,109.49833,18.28681,1516
134326,0E129C09250C0D46273B4BD7E5225556,60441,16,17,1,109.46792,18.28604,1366
134327,0E129C09250C0D46273B4BD7E5225556,60201,18,20,2,109.5041,18.2509,1510
134328,0E129C09250C0D46273B4BD7E5225556,60281,21,22,1,109.51743,18.25924,1561
134329,0E129C09250C0D46273B4BD7E5225556,30151,22,23,1,109.50986,18.25083,1560
134336,221D8AFDF93613700F6F08A099FC19BF,60201,0,8,8,109.5041,18.2509,1510
134337,221D8AFDF93613700F6F08A099FC19BF,60301,9,10,1,109.60715,18.30993,1919
134338,221D8AFDF93613700F6F08A099FC19BF,38754,10,12,2,109.74667,18.37382,2430
134339,221D8AFDF93613700F6F08A099FC19BF,31461,14,17,3,109.5091,18.25389,1510
134340,221D8AFDF93613700F6F08A099FC19BF,31391,18,19,1,109.50382,18.24285,1508
134341,221D8AFDF93613700F6F08A099FC19BF,31461,21,23,2,109.5091,18.25389,1510
134397,56C8C781972E8BFAF8A768A19AD7F590,38127,0,7,7,109.50833,18.27222,1513
134399,56C8C781972E8BFAF8A768A19AD7F590,30281,19,22,3,109.50597,18.27583,1514
134404,44CB5F545D2E3587ACF209AB2414C1A1,31071,0,3,3,109.58257,18.28458,1815
134405,44CB5F545D2E3587ACF209AB2414C1A1,30854,4,6,2,109.56889,18.27076,1763
134406,44CB5F545D2E3587ACF209AB2414C1A1,31071,6,8,2,109.58257,18.28458,1815
134407,44CB5F545D2E3587ACF209AB2414C1A1,30854,15,16,1,109.56889,18.27076,1763
134408,44CB5F545D2E3587ACF209AB2414C1A1,31071,17,23,6,109.58257,18.28458,1815
134419,C709D01469E0800AF998DFAF42105CDC,60631,0,1,1,109.57778,18.27583,1814
134420,C709D01469E0800AF998DFAF42105CDC,31561,5,16,11,109.56792,18.28479,1765
134421,C709D01469E0800AF998DFAF42105CDC,30854,19,23,4,109.56889,18.27076,1763
134432,6CB2262427E621944253A1554B6D79F3,31251,5,22,17,109.18528,18.2975,317
134446,173CD7A2B7B334BC53A50A1D248FBCFE,31071,5,6,1,109.58257,18.28458,1815
134447,173CD7A2B7B334BC53A50A1D248FBCFE,30854,8,10,2,109.56889,18.27076,1763
134448,173CD7A2B7B334BC53A50A1D248FBCFE,31071,11,13,2,109.58257,18.28458,1815
134449,173CD7A2B7B334BC53A50A1D248FBCFE,60381,15,17,2,109.5241,18.22458,1605
134450,173CD7A2B7B334BC53A50A1D248FBCFE,30854,18,19,1,109.56889,18.27076,1763
134451,173CD7A2B7B334BC53A50A1D248FBCFE,31071,21,22,1,109.58257,18.28458,1815
134456,451E2BF48CD7B253EB0892324E679BCC,38297,0,5,5,109.52576,18.24965,1609
134457,451E2BF48CD7B253EB0892324E679BCC,60281,7,18,11,109.51743,18.25924,1561
134458,451E2BF48CD7B253EB0892324E679BCC,38291,20,22,2,109.51618,18.24313,1558
134476,A1751D2F2B129C8CC66D88935FEF0CD4,30891,0,8,8,109.59431,18.28389,1865
134477,A1751D2F2B129C8CC66D88935FEF0CD4,30854,10,14,4,109.56889,18.27076,1763
134478,A1751D2F2B129C8CC66D88935FEF0CD4,30891,14,15,1,109.59431,18.28389,1865
134479,A1751D2F2B129C8CC66D88935FEF0CD4,30854,16,21,5,109.56889,18.27076,1763
134480,32B282E0D9D6AD6484A59DFBF2B8EAC5,31681,0,6,6,109.40396,18.29979,1168
134481,32B282E0D9D6AD6484A59DFBF2B8EAC5,38105,7,8,1,109.40299,18.29229,1117
134482,32B282E0D9D6AD6484A59DFBF2B8EAC5,31301,11,12,1,109.14493,18.31222,170
134483,8A0382A2385C362EFE2664E8795F133E,39183,0,3,3,109.55542,18.28208,1715
134484,8A0382A2385C362EFE2664E8795F133E,31561,3,5,2,109.56792,18.28479,1765
134485,8A0382A2385C362EFE2664E8795F133E,39183,7,16,9,109.55542,18.28208,1715
134486,8A0382A2385C362EFE2664E8795F133E,31561,21,23,2,109.56792,18.28479,1765
134519,8883DF5E66B5FC284A8EF97DE8EAAAB3,30854,0,2,2,109.56889,18.27076,1763
134520,8883DF5E66B5FC284A8EF97DE8EAAAB3,60631,3,4,1,109.57778,18.27583,1814
134521,8883DF5E66B5FC284A8EF97DE8EAAAB3,30854,5,6,1,109.56889,18.27076,1763
134600,3E8DFE6B8A4FF70B43F1C2C8FF289AC0,31101,0,2,2,109.65389,18.23403,2057
134601,3E8DFE6B8A4FF70B43F1C2C8FF289AC0,38331,2,4,2,109.62465,18.22736,1956
134602,3E8DFE6B8A4FF70B43F1C2C8FF289AC0,60381,8,9,1,109.5241,18.22458,1605
134603,3E8DFE6B8A4FF70B43F1C2C8FF289AC0,31781,11,14,3,109.19847,18.2975,367
134604,3E8DFE6B8A4FF70B43F1C2C8FF289AC0,31471,16,17,1,109.34583,18.29563,917
134605,3E8DFE6B8A4FF70B43F1C2C8FF289AC0,31723,20,23,3,109.68563,18.23701,2207
134617,529A14F498129B0238F7B12A9FC7F6F7,31205,0,2,2,109.51111,18.23736,1557
134618,529A14F498129B0238F7B12A9FC7F6F7,31261,3,4,1,109.51174,18.2466,1559
134619,529A14F498129B0238F7B12A9FC7F6F7,31671,5,14,9,109.38965,18.29813,1068
134620,529A14F498129B0238F7B12A9FC7F6F7,30761,15,18,3,109.45201,18.3,1318
134621,529A14F498129B0238F7B12A9FC7F6F7,30711,20,21,1,109.50271,18.25347,1510
134657,3C9D5DF00C57B6E7794B9A51846C6621,31121,0,7,7,109.16292,18.37063,230
134658,3C9D5DF00C57B6E7794B9A51846C6621,31261,9,11,2,109.51174,18.2466,1559
134659,3C9D5DF00C57B6E7794B9A51846C6621,31031,11,14,3,109.49979,18.25382,1510
134660,3C9D5DF00C57B6E7794B9A51846C6621,31121,19,23,4,109.16292,18.37063,230
134691,866460FA5062A635337B6369BB2AADDA,30854,2,7,5,109.56889,18.27076,1763
134692,866460FA5062A635337B6369BB2AADDA,60591,11,12,1,109.61118,18.21715,1904
134697,0BB1CA81E48C2B6566102295CAE07E5D,30121,15,18,3,109.52861,18.27222,1613
134698,0BB1CA81E48C2B6566102295CAE07E5D,31071,20,21,1,109.58257,18.28458,1815
134699,F6A1EBB84FE583E84185C423218578F5,31561,0,5,5,109.56792,18.28479,1765
134700,F6A1EBB84FE583E84185C423218578F5,30854,7,8,1,109.56889,18.27076,1763
134701,F6A1EBB84FE583E84185C423218578F5,31561,10,23,13,109.56792,18.28479,1765
134766,B07D1803AC15C12AA319092ED1E797D8,60381,0,8,8,109.5241,18.22458,1605
134767,B07D1803AC15C12AA319092ED1E797D8,31471,12,13,1,109.34583,18.29563,917
134768,B07D1803AC15C12AA319092ED1E797D8,31471,14,15,1,109.34583,18.29563,917
134769,B07D1803AC15C12AA319092ED1E797D8,38315,16,17,1,109.48979,18.29764,1467
134789,02F7708F1CFAC98CD0B107132A271A25,60463,14,15,1,109.52507,18.22438,1605
134790,02F7708F1CFAC98CD0B107132A271A25,48574,16,20,4,109.48931,18.28458,1465
134804,6A8C883D29A8AF90E102449F92489A64,38821,18,19,1,109.50354,18.25243,1510
134805,6A8C883D29A8AF90E102449F92489A64,30854,20,22,2,109.56889,18.27076,1763
134820,0E1B3CFC64EBB658DA96D0DCA834701E,61011,4,10,6,109.60653,18.19076,1900
134822,0E1B3CFC64EBB658DA96D0DCA834701E,61011,17,21,4,109.60653,18.19076,1900
134824,0E56047C2113CB9384943BEBAA9FF06B,31031,0,16,16,109.49979,18.25382,1510
134825,0E56047C2113CB9384943BEBAA9FF06B,38315,16,17,1,109.48979,18.29764,1467
134843,CB1C8502149DACE0B32B2F7416279EF2,31071,0,9,9,109.58257,18.28458,1815
134844,CB1C8502149DACE0B32B2F7416279EF2,30854,9,19,10,109.56889,18.27076,1763
134845,69376C55C8883D60B733443073E6E40F,31861,0,9,9,109.49042,18.27549,1464
134846,69376C55C8883D60B733443073E6E40F,31801,11,13,2,109.20417,18.32118,371
134847,69376C55C8883D60B733443073E6E40F,60411,15,16,1,109.32514,18.30854,869
134917,40C57F24FE0409ABB752B2031C349577,38951,1,13,12,109.48097,18.28868,1416
134918,40C57F24FE0409ABB752B2031C349577,60463,16,20,4,109.52507,18.22438,1605
134919,40C57F24FE0409ABB752B2031C349577,38951,21,23,2,109.48097,18.28868,1416
134944,D6B54C643B88B86782DC30A38AD291FD,31561,3,13,10,109.56792,18.28479,1765
134945,D6B54C643B88B86782DC30A38AD291FD,30854,15,21,6,109.56889,18.27076,1763
134984,1FE2866848043A2C10AD87212485FE15,31181,1,2,1,109.50382,18.24813,1509
134985,1FE2866848043A2C10AD87212485FE15,31071,3,7,4,109.58257,18.28458,1815
134986,1FE2866848043A2C10AD87212485FE15,30854,10,23,13,109.56889,18.27076,1763
135058,4920907824EB321BE55C3B9CE4B6FB57,38541,0,1,1,109.73715,18.34875,2426
135060,4920907824EB321BE55C3B9CE4B6FB57,38541,3,8,5,109.73715,18.34875,2426
135098,B0D7DAF8D84656FF4C7229ABB8EA1350,31561,0,9,9,109.56792,18.28479,1765
135099,B0D7DAF8D84656FF4C7229ABB8EA1350,31071,11,14,3,109.58257,18.28458,1815
135100,B0D7DAF8D84656FF4C7229ABB8EA1350,30854,15,21,6,109.56889,18.27076,1763
135101,B0D7DAF8D84656FF4C7229ABB8EA1350,31561,21,22,1,109.56792,18.28479,1765
135148,B712327B6033C61F37801CFD6DAC08AD,31951,0,3,3,109.52174,18.30299,1568
135149,B712327B6033C61F37801CFD6DAC08AD,38991,3,4,1,109.52681,18.30368,1618
135150,B712327B6033C61F37801CFD6DAC08AD,38484,5,14,9,109.53028,18.31528,1620
135151,B712327B6033C61F37801CFD6DAC08AD,38484,14,18,4,109.53028,18.31528,1620
135152,B712327B6033C61F37801CFD6DAC08AD,30561,20,22,2,109.52778,18.31938,1621
135153,63FBAC0202144B00077561285E6A7F87,30821,0,6,6,109.43681,18.33639,1274
135154,63FBAC0202144B00077561285E6A7F87,30651,7,8,1,109.42611,18.385,1232
135155,63FBAC0202144B00077561285E6A7F87,30821,8,22,14,109.43681,18.33639,1274
135224,530F0AE3A2D48DD91CDC3A17D13BA70F,38707,0,11,11,109.73778,18.35368,2427
135225,530F0AE3A2D48DD91CDC3A17D13BA70F,30531,15,16,1,109.53271,18.21472,1604
135226,530F0AE3A2D48DD91CDC3A17D13BA70F,38707,17,19,2,109.73778,18.35368,2427
135255,6CF89A30BF6785DF298A05F3A844C4F4,30821,0,3,3,109.43681,18.33639,1274
135256,6CF89A30BF6785DF298A05F3A844C4F4,60421,3,6,3,109.46333,18.31743,1371
135257,6CF89A30BF6785DF298A05F3A844C4F4,31781,9,11,2,109.19847,18.2975,367
135258,6CF89A30BF6785DF298A05F3A844C4F4,30661,11,13,2,109.37028,18.24361,1008
135276,202E088A34F33462A1153A80AD45CA6B,31231,13,17,4,109.42597,18.29292,1217
135277,202E088A34F33462A1153A80AD45CA6B,60524,19,23,4,109.42951,18.28993,1216
135297,7D632B68A96EBB9D6582527232D6634C,31461,0,9,9,109.5091,18.25389,1510
135298,7D632B68A96EBB9D6582527232D6634C,30081,11,12,1,109.50243,18.26632,1512
135299,7D632B68A96EBB9D6582527232D6634C,30421,14,15,1,109.50021,18.25861,1511
135300,1EE9007A08685A1EA943EBCDEA8805C7,31471,13,14,1,109.34583,18.29563,917
135373,06CCC403601D7C9C1AA6BF102B163D95,60161,14,16,2,109.49174,18.26181,1461
135374,06CCC403601D7C9C1AA6BF102B163D95,60231,17,18,1,109.49903,18.21972,1504
135399,B78E7295CB13532B4E2C30EF158E297F,39183,0,12,12,109.55542,18.28208,1715
135400,B78E7295CB13532B4E2C30EF158E297F,31561,17,18,1,109.56792,18.28479,1765
135401,B78E7295CB13532B4E2C30EF158E297F,39183,20,21,1,109.55542,18.28208,1715
135408,3842150E551101E5C7EA3E39AF0BFFE0,31061,0,6,6,109.53333,18.23257,1607
135418,F47C4E1E39056C43B0AD32AC994AB7C0,31931,1,20,19,109.54771,18.29403,1667
135419,F47C4E1E39056C43B0AD32AC994AB7C0,60361,21,22,1,109.51938,18.29681,1567
135424,811CE7E060D5A10FC7748D88604CC4FD,31231,0,9,9,109.42597,18.29292,1217
135425,811CE7E060D5A10FC7748D88604CC4FD,30671,10,11,1,109.43611,18.30139,1268
135426,811CE7E060D5A10FC7748D88604CC4FD,30941,15,16,1,109.5559,18.33938,1724
135427,811CE7E060D5A10FC7748D88604CC4FD,31231,21,22,1,109.42597,18.29292,1217
135433,0B3D35BF2B857D2477B6F03BDBF1D90C,31471,14,16,2,109.34583,18.29563,917
135434,0B3D35BF2B857D2477B6F03BDBF1D90C,30361,19,20,1,109.50347,18.24,1508
135435,0B3D35BF2B857D2477B6F03BDBF1D90C,30211,21,22,1,109.49882,18.23931,1508
135443,64EA917EAAD3EB55DA2ABB227203C131,60631,0,7,7,109.57778,18.27583,1814
135444,64EA917EAAD3EB55DA2ABB227203C131,31071,8,9,1,109.58257,18.28458,1815
135445,64EA917EAAD3EB55DA2ABB227203C131,60631,14,22,8,109.57778,18.27583,1814
135539,30F5D42A1A8F1CF26F5C9617FCB06C4F,30854,17,19,2,109.56889,18.27076,1763
135540,30F5D42A1A8F1CF26F5C9617FCB06C4F,31561,19,21,2,109.56792,18.28479,1765
135556,608CD70841FB78E12CBE2B3DBFC716D5,31761,0,1,1,109.60521,18.27965,1914
135557,608CD70841FB78E12CBE2B3DBFC716D5,39371,2,3,1,109.56627,18.2646,1762
135558,608CD70841FB78E12CBE2B3DBFC716D5,30854,3,7,4,109.56889,18.27076,1763
135559,608CD70841FB78E12CBE2B3DBFC716D5,31071,10,11,1,109.58257,18.28458,1815
135560,608CD70841FB78E12CBE2B3DBFC716D5,30854,11,23,12,109.56889,18.27076,1763
135595,A928E9F6C796FE1A60807BA003DE87BB,30854,0,5,5,109.56889,18.27076,1763
135596,A928E9F6C796FE1A60807BA003DE87BB,31071,7,8,1,109.58257,18.28458,1815
135597,A928E9F6C796FE1A60807BA003DE87BB,33481,9,14,5,109.67278,18.41278,2187
135598,A928E9F6C796FE1A60807BA003DE87BB,30854,15,18,3,109.56889,18.27076,1763
135599,A928E9F6C796FE1A60807BA003DE87BB,31071,18,19,1,109.58257,18.28458,1815
135600,A928E9F6C796FE1A60807BA003DE87BB,30854,20,22,2,109.56889,18.27076,1763
135646,3F320FCC97654DBDACE66BB1BF09E301,30711,10,13,3,109.50271,18.25347,1510
135686,97C31877CA4226D0F1BA1C0E12066B56,60331,0,6,6,109.505,18.26507,1512
135687,97C31877CA4226D0F1BA1C0E12066B56,30854,7,13,6,109.56889,18.27076,1763
135688,97C31877CA4226D0F1BA1C0E12066B56,31561,14,15,1,109.56792,18.28479,1765
135689,97C31877CA4226D0F1BA1C0E12066B56,30251,18,21,3,109.50611,18.26653,1512
135690,97C31877CA4226D0F1BA1C0E12066B56,60331,21,23,2,109.505,18.26507,1512
135696,A549C024E6F63EDBD3DC866F10DB11CE,31071,0,4,4,109.58257,18.28458,1815
135697,A549C024E6F63EDBD3DC866F10DB11CE,30854,8,19,11,109.56889,18.27076,1763
135698,A549C024E6F63EDBD3DC866F10DB11CE,31071,19,21,2,109.58257,18.28458,1815
135709,21FBB6F0F825A6B1E89545963BB6C9D3,30854,0,20,20,109.56889,18.27076,1763
135710,21FBB6F0F825A6B1E89545963BB6C9D3,60631,22,23,1,109.57778,18.27583,1814
135752,A749E400BFD3B5908671E939EC104DEE,30854,0,9,9,109.56889,18.27076,1763
135753,A749E400BFD3B5908671E939EC104DEE,31491,12,14,2,109.73042,18.38771,2382
135754,A749E400BFD3B5908671E939EC104DEE,30854,17,20,3,109.56889,18.27076,1763
135783,7CB856FEE9B622309A7C94CB5E258253,31411,13,14,1,109.5016,18.23576,1507
135784,7CB856FEE9B622309A7C94CB5E258253,39183,15,17,2,109.55542,18.28208,1715
135790,695007B4E6ED5E35BFB785EA24AE0E83,30921,0,17,17,109.53903,18.29451,1667
135791,695007B4E6ED5E35BFB785EA24AE0E83,31931,18,19,1,109.54771,18.29403,1667
135792,695007B4E6ED5E35BFB785EA24AE0E83,30921,21,22,1,109.53903,18.29451,1667
135793,560794A44CA17A43FA34D0FA6C339747,30854,0,1,1,109.56889,18.27076,1763
135794,560794A44CA17A43FA34D0FA6C339747,31071,4,5,1,109.58257,18.28458,1815
135795,560794A44CA17A43FA34D0FA6C339747,30854,5,7,2,109.56889,18.27076,1763
135805,DA759AC2EBBA8078FBC390D09D5C4EC7,31101,11,14,3,109.65389,18.23403,2057
135806,DA759AC2EBBA8078FBC390D09D5C4EC7,30854,15,19,4,109.56889,18.27076,1763
135820,331C93B6083F5634586EEDFC958D0A76,60361,0,8,8,109.51938,18.29681,1567
135821,331C93B6083F5634586EEDFC958D0A76,31145,9,15,6,109.20431,18.30479,369
135830,6176265D4B047A058BFE39B579C63226,31521,0,8,8,109.51458,18.22542,1555
135831,6176265D4B047A058BFE39B579C63226,31471,11,13,2,109.34583,18.29563,917
135832,6176265D4B047A058BFE39B579C63226,31521,14,22,8,109.51458,18.22542,1555
135833,9AC9BAB6FD8AF8D8ECCEB379050F672F,31701,0,8,8,109.44132,18.28833,1266
135834,9AC9BAB6FD8AF8D8ECCEB379050F672F,31781,12,13,1,109.19847,18.2975,367
135835,9AC9BAB6FD8AF8D8ECCEB379050F672F,31701,18,23,5,109.44132,18.28833,1266
135886,D75F3D28EEDDC3AAB22F587F99A79102,30851,0,2,2,109.5616,18.27396,1713
135887,D75F3D28EEDDC3AAB22F587F99A79102,30854,2,8,6,109.56889,18.27076,1763
135888,D75F3D28EEDDC3AAB22F587F99A79102,31071,9,10,1,109.58257,18.28458,1815
135897,10EBF762D28520B09848288F7052CFDE,30854,0,5,5,109.56889,18.27076,1763
135898,10EBF762D28520B09848288F7052CFDE,39101,7,17,10,109.50132,18.24931,1509
135899,10EBF762D28520B09848288F7052CFDE,30854,18,20,2,109.56889,18.27076,1763
135903,3E01B14B28C0FDBF8BB343D61C8AA7D8,31931,0,9,9,109.54771,18.29403,1667
135904,3E01B14B28C0FDBF8BB343D61C8AA7D8,31301,14,17,3,109.14493,18.31222,170
135905,3E01B14B28C0FDBF8BB343D61C8AA7D8,60241,21,23,2,109.53319,18.28667,1616
135936,66DAA2740440F603A26B0FC0D4309DF2,31931,9,23,14,109.54771,18.29403,1667
135948,9856C1F2599E76C49A61F2B51C803266,38951,0,11,11,109.48097,18.28868,1416
135949,9856C1F2599E76C49A61F2B51C803266,31031,11,13,2,109.49979,18.25382,1510
135950,9856C1F2599E76C49A61F2B51C803266,31031,13,16,3,109.49979,18.25382,1510
135951,9856C1F2599E76C49A61F2B51C803266,38951,17,20,3,109.48097,18.28868,1416
135955,EF2DD50D8910ACE6DC9CDC38ED663FB8,31561,2,13,11,109.56792,18.28479,1765
135956,EF2DD50D8910ACE6DC9CDC38ED663FB8,30854,14,16,2,109.56889,18.27076,1763
135974,319C385C256C2264D15D0D4ABF1C5A6B,31061,0,9,9,109.53333,18.23257,1607
135975,319C385C256C2264D15D0D4ABF1C5A6B,60084,10,11,1,109.4984,18.2334,1507
135976,319C385C256C2264D15D0D4ABF1C5A6B,30861,12,13,1,109.52722,18.22743,1606
135977,319C385C256C2264D15D0D4ABF1C5A6B,30111,14,18,4,109.47583,18.30542,1419
135978,C61360C6C8202A54143E165C2C08120B,30232,0,2,2,109.6191,18.31701,1971
135979,C61360C6C8202A54143E165C2C08120B,30951,2,13,11,109.56208,18.25667,1761
135987,487FC583F0AF1414583ADA3127598053,60631,1,6,5,109.57778,18.27583,1814
135988,487FC583F0AF1414583ADA3127598053,30854,10,11,1,109.56889,18.27076,1763
135989,487FC583F0AF1414583ADA3127598053,31071,12,14,2,109.58257,18.28458,1815
136000,5E6F81A7DA23F57413C15AC7514275E5,31945,1,7,6,109.58021,18.29403,1817
136001,5E6F81A7DA23F57413C15AC7514275E5,31071,7,13,6,109.58257,18.28458,1815
136002,5E6F81A7DA23F57413C15AC7514275E5,31945,15,18,3,109.58021,18.29403,1817
136003,5E6F81A7DA23F57413C15AC7514275E5,31561,18,21,3,109.56792,18.28479,1765
136004,19A7A932E03C63EDA78541C31E010D15,38903,0,6,6,109.39229,18.29243,1117
136005,19A7A932E03C63EDA78541C31E010D15,38141,8,10,2,109.39479,18.2916,1116
136006,19A7A932E03C63EDA78541C31E010D15,30361,10,13,3,109.50347,18.24,1508
136007,19A7A932E03C63EDA78541C31E010D15,60541,15,22,7,109.4084,18.29208,1167
136044,065F1687C35F3C827A2EA4A378A0E2C6,30851,10,11,1,109.5616,18.27396,1713
136045,065F1687C35F3C827A2EA4A378A0E2C6,39371,14,15,1,109.56627,18.2646,1762
136046,065F1687C35F3C827A2EA4A378A0E2C6,30851,16,18,2,109.5616,18.27396,1713
136047,75A6390EC6BFC646EB62C94B6457CC0E,31521,0,8,8,109.51458,18.22542,1555
136048,75A6390EC6BFC646EB62C94B6457CC0E,30661,11,12,1,109.37028,18.24361,1008
136049,75A6390EC6BFC646EB62C94B6457CC0E,60381,15,19,4,109.5241,18.22458,1605
136050,75A6390EC6BFC646EB62C94B6457CC0E,31521,20,23,3,109.51458,18.22542,1555
136082,13166628932DF36C0AD7B1DB5811240A,60591,0,6,6,109.61118,18.21715,1904
136083,13166628932DF36C0AD7B1DB5811240A,30854,9,16,7,109.56889,18.27076,1763
136084,13166628932DF36C0AD7B1DB5811240A,60591,19,23,4,109.61118,18.21715,1904
136112,2DA5948E96121EADE6CCFA0D33794EFE,38251,0,2,2,109.49618,18.25493,1510
136113,2DA5948E96121EADE6CCFA0D33794EFE,60131,5,7,2,109.49819,18.24778,1509
136114,2DA5948E96121EADE6CCFA0D33794EFE,30711,7,12,5,109.50271,18.25347,1510
136115,2DA5948E96121EADE6CCFA0D33794EFE,30741,13,14,1,109.49833,18.28681,1516
136116,2DA5948E96121EADE6CCFA0D33794EFE,31531,15,17,2,109.49583,18.25972,1461
136117,2DA5948E96121EADE6CCFA0D33794EFE,30711,18,22,4,109.50271,18.25347,1510
136122,D947329382FD9474122243533197BA56,60501,0,10,10,109.48701,18.29021,1466
136123,D947329382FD9474122243533197BA56,39154,12,14,2,109.50201,18.25681,1511
136125,D947329382FD9474122243533197BA56,39154,21,23,2,109.50201,18.25681,1511
136127,389CF830723A2E0E3A1A739A3938F222,31521,12,14,2,109.51458,18.22542,1555
136128,389CF830723A2E0E3A1A739A3938F222,31471,16,17,1,109.34583,18.29563,917
136129,389CF830723A2E0E3A1A739A3938F222,31521,18,23,5,109.51458,18.22542,1555
136130,B621E9075674E792CCB217233825F9D1,30851,1,3,2,109.5616,18.27396,1713
136131,B621E9075674E792CCB217233825F9D1,30232,3,6,3,109.6191,18.31701,1971
136132,B621E9075674E792CCB217233825F9D1,30854,7,8,1,109.56889,18.27076,1763
136133,B621E9075674E792CCB217233825F9D1,60591,10,12,2,109.61118,18.21715,1904
136134,B621E9075674E792CCB217233825F9D1,30854,20,22,2,109.56889,18.27076,1763
136135,B621E9075674E792CCB217233825F9D1,60631,22,23,1,109.57778,18.27583,1814
136136,E605B26D53F08A0D3360A4541E09F4E2,30721,0,5,5,109.51597,18.28257,1565
136137,E605B26D53F08A0D3360A4541E09F4E2,38283,8,11,3,109.62229,18.22618,1956
136138,E605B26D53F08A0D3360A4541E09F4E2,38283,13,23,10,109.62229,18.22618,1956
136176,9837FB962D7F62E426A73EBD66CBBE03,60524,20,21,1,109.42951,18.28993,1216
136177,9837FB962D7F62E426A73EBD66CBBE03,30721,22,23,1,109.51597,18.28257,1565
136236,26EBB7631BF09CB3B33D334FA74CC499,39111,0,6,6,109.5191,18.22597,1555
136237,26EBB7631BF09CB3B33D334FA74CC499,30711,6,13,7,109.50271,18.25347,1510
136238,26EBB7631BF09CB3B33D334FA74CC499,31521,16,18,2,109.51458,18.22542,1555
136239,26EBB7631BF09CB3B33D334FA74CC499,31521,19,23,4,109.51458,18.22542,1555
136260,7AF4921BC4D1712A961904D0ECC91550,30071,0,10,10,109.52819,18.30472,1619
136261,7AF4921BC4D1712A961904D0ECC91550,30421,14,15,1,109.50021,18.25861,1511
136274,0F558B6653C655C7F0BAEA9D66B33F57,30721,0,1,1,109.51597,18.28257,1565
136275,0F558B6653C655C7F0BAEA9D66B33F57,31071,2,7,5,109.58257,18.28458,1815
136276,0F558B6653C655C7F0BAEA9D66B33F57,30854,8,20,12,109.56889,18.27076,1763
136289,7421066246AAD1C230E7E2A7ADF06E9D,60631,0,5,5,109.57778,18.27583,1814
136290,7421066246AAD1C230E7E2A7ADF06E9D,30854,7,11,4,109.56889,18.27076,1763
136291,7421066246AAD1C230E7E2A7ADF06E9D,60381,15,17,2,109.5241,18.22458,1605
136292,7421066246AAD1C230E7E2A7ADF06E9D,31071,20,21,1,109.58257,18.28458,1815
136314,6E580E35F1856BA2850385BDFB597BF5,39371,1,13,12,109.56627,18.2646,1762
136316,A01B4012B619D942E7CC3AC9B78722B4,31561,0,1,1,109.56792,18.28479,1765
136317,A01B4012B619D942E7CC3AC9B78722B4,39181,4,5,1,109.55153,18.28035,1715
136318,A01B4012B619D942E7CC3AC9B78722B4,31561,9,23,14,109.56792,18.28479,1765
136326,E2A4A2ABBE2AAFDE32C6FA06BCCC268D,31071,0,16,16,109.58257,18.28458,1815
136327,E2A4A2ABBE2AAFDE32C6FA06BCCC268D,30854,20,23,3,109.56889,18.27076,1763
136346,C153552CEA2677B0FF473AE565EA979E,30821,0,12,12,109.43681,18.33639,1274
136347,C153552CEA2677B0FF473AE565EA979E,30651,12,13,1,109.42611,18.385,1232
136348,C153552CEA2677B0FF473AE565EA979E,30821,13,19,6,109.43681,18.33639,1274
136352,417408FFDA93B177641D270D3A5C4B2D,31071,10,14,4,109.58257,18.28458,1815
136353,417408FFDA93B177641D270D3A5C4B2D,30854,14,17,3,109.56889,18.27076,1763
136354,417408FFDA93B177641D270D3A5C4B2D,31071,21,23,2,109.58257,18.28458,1815
136358,A5E738BCE3A14BFC61D30835FD8302F3,38321,0,9,9,109.39854,18.29132,1116
136359,A5E738BCE3A14BFC61D30835FD8302F3,31471,10,11,1,109.34583,18.29563,917
136360,A5E738BCE3A14BFC61D30835FD8302F3,31031,15,18,3,109.49979,18.25382,1510
136361,A5E738BCE3A14BFC61D30835FD8302F3,38105,19,23,4,109.40299,18.29229,1117
136403,C1788356D6298A19C2039F0E2F1C2CF1,31071,2,6,4,109.58257,18.28458,1815
136404,C1788356D6298A19C2039F0E2F1C2CF1,30891,6,9,3,109.59431,18.28389,1865
136405,C1788356D6298A19C2039F0E2F1C2CF1,39183,11,12,1,109.55542,18.28208,1715
136406,C1788356D6298A19C2039F0E2F1C2CF1,39321,13,14,1,109.529,18.2167,1604
136435,2087FDBE09ECB215FF50CC16A9791DF1,31534,0,8,8,109.49368,18.25806,1461
136437,2087FDBE09ECB215FF50CC16A9791DF1,31471,13,15,2,109.34583,18.29563,917
136438,2087FDBE09ECB215FF50CC16A9791DF1,31431,17,18,1,109.44639,18.29042,1316
136439,2087FDBE09ECB215FF50CC16A9791DF1,31534,18,23,5,109.49368,18.25806,1461
136444,AD6CE74FEECB42F7806A62DA7A4CECCA,30851,0,1,1,109.5616,18.27396,1713
136445,AD6CE74FEECB42F7806A62DA7A4CECCA,30854,2,6,4,109.56889,18.27076,1763
136446,AD6CE74FEECB42F7806A62DA7A4CECCA,30851,7,9,2,109.5616,18.27396,1713
136449,EA27C1DACC015E381783BB03940DBA88,31561,18,20,2,109.56792,18.28479,1765
136450,EA27C1DACC015E381783BB03940DBA88,38484,21,23,2,109.53028,18.31528,1620
136502,FE1026339FD332D4A4F5FBDF23B53B96,31031,11,16,5,109.49979,18.25382,1510
136503,FE1026339FD332D4A4F5FBDF23B53B96,60291,18,19,1,109.50826,18.24639,1509
136575,4EDFE7100E9EE56C14E553A61B670292,30854,15,16,1,109.56889,18.27076,1763
136576,4EDFE7100E9EE56C14E553A61B670292,31071,19,20,1,109.58257,18.28458,1815
136587,8DD23AA43C0F7967C45F7488D66F9159,31521,17,20,3,109.51458,18.22542,1555
136588,8DD23AA43C0F7967C45F7488D66F9159,30191,21,23,2,109.50361,18.22701,1506
136596,147470AD3D3B8724582C30D5F244A8B6,60421,0,7,7,109.46333,18.31743,1371
136597,147470AD3D3B8724582C30D5F244A8B6,30111,8,10,2,109.47583,18.30542,1419
136598,147470AD3D3B8724582C30D5F244A8B6,60421,11,13,2,109.46333,18.31743,1371
136599,147470AD3D3B8724582C30D5F244A8B6,30111,13,18,5,109.47583,18.30542,1419
136600,147470AD3D3B8724582C30D5F244A8B6,60421,18,22,4,109.46333,18.31743,1371
136673,598A5BC9BEA86E74379689160E91B24E,30854,0,12,12,109.56889,18.27076,1763
136674,598A5BC9BEA86E74379689160E91B24E,31071,15,17,2,109.58257,18.28458,1815
136694,528F99F7FD8CA49B85B45B64A5D784BA,39183,1,3,2,109.55542,18.28208,1715
136695,528F99F7FD8CA49B85B45B64A5D784BA,30851,7,12,5,109.5616,18.27396,1713
136762,0E1DB444F47235AEDAD0A0404A7B75B4,31561,0,8,8,109.56792,18.28479,1765
136763,0E1DB444F47235AEDAD0A0404A7B75B4,39183,11,22,11,109.55542,18.28208,1715
136826,324899445F811D5785FB336DE18DAC0E,31531,0,5,5,109.49583,18.25972,1461
136892,EBF906C5498076BCFA3E97DF6001B4F3,60631,2,10,8,109.57778,18.27583,1814
136893,EBF906C5498076BCFA3E97DF6001B4F3,30854,15,23,8,109.56889,18.27076,1763
136917,2A6BA0678DDF16AF08BAC9E3FA3C9391,31561,0,1,1,109.56792,18.28479,1765
136918,2A6BA0678DDF16AF08BAC9E3FA3C9391,30854,3,19,16,109.56889,18.27076,1763
136919,2A6BA0678DDF16AF08BAC9E3FA3C9391,31561,21,23,2,109.56792,18.28479,1765
136930,E6F34D056CDFAA8A4D106C82CFE2C31C,30191,17,19,2,109.50361,18.22701,1506
136952,258F9A09B3B0048D107FC9EF9EB27CDE,30771,0,6,6,109.49938,18.26042,1511
136953,258F9A09B3B0048D107FC9EF9EB27CDE,30421,6,11,5,109.50021,18.25861,1511
136954,258F9A09B3B0048D107FC9EF9EB27CDE,30421,12,14,2,109.50021,18.25861,1511
136955,258F9A09B3B0048D107FC9EF9EB27CDE,30421,17,19,2,109.50021,18.25861,1511
136956,258F9A09B3B0048D107FC9EF9EB27CDE,38251,19,22,3,109.49618,18.25493,1510
136972,F432BE98F277FF953CE263D7467BFC47,38671,0,7,7,109.41576,18.29285,1167
136974,F432BE98F277FF953CE263D7467BFC47,31571,14,15,1,109.61563,18.23326,1957
136975,F432BE98F277FF953CE263D7467BFC47,31701,16,19,3,109.44132,18.28833,1266
136976,178271E30A0C49B9F554254AB4E98C73,31391,2,4,2,109.50382,18.24285,1508
136977,178271E30A0C49B9F554254AB4E98C73,31181,5,6,1,109.50382,18.24813,1509
136978,178271E30A0C49B9F554254AB4E98C73,31391,7,8,1,109.50382,18.24285,1508
136985,75817DB682187A07461734D66E1E6492,60631,0,4,4,109.57778,18.27583,1814
136986,75817DB682187A07461734D66E1E6492,30854,8,18,10,109.56889,18.27076,1763
136987,75817DB682187A07461734D66E1E6492,60631,18,23,5,109.57778,18.27583,1814
137018,E16204D131FCD957D5ADB9592C1DD0ED,30854,1,7,6,109.56889,18.27076,1763
137019,E16204D131FCD957D5ADB9592C1DD0ED,31071,7,11,4,109.58257,18.28458,1815
137020,E16204D131FCD957D5ADB9592C1DD0ED,38754,12,13,1,109.74667,18.37382,2430
137021,E16204D131FCD957D5ADB9592C1DD0ED,30731,17,22,5,109.50944,18.22306,1555
137098,A249BB92E18839D454C438B797D69714,38291,0,16,16,109.51618,18.24313,1558
137099,A249BB92E18839D454C438B797D69714,38891,19,21,2,109.51486,18.24118,1558
137100,A249BB92E18839D454C438B797D69714,38291,21,23,2,109.51618,18.24313,1558
137101,BB31C40AF9668A41ED1DCCB876852450,31061,0,7,7,109.53333,18.23257,1607
137121,05B8E3BA98D31919D00565FFE318CEF9,31231,0,7,7,109.42597,18.29292,1217
137122,05B8E3BA98D31919D00565FFE318CEF9,60054,12,13,1,109.3016,18.31229,770
137123,05B8E3BA98D31919D00565FFE318CEF9,31231,15,16,1,109.42597,18.29292,1217
137124,05B8E3BA98D31919D00565FFE318CEF9,30181,18,19,1,109.51597,18.23313,1557
137125,4CE6A4570746D2FE13DAD47FED742E4E,31521,0,4,4,109.51458,18.22542,1555
137126,4CE6A4570746D2FE13DAD47FED742E4E,60381,6,7,1,109.5241,18.22458,1605
137127,4CE6A4570746D2FE13DAD47FED742E4E,31521,8,11,3,109.51458,18.22542,1555
137128,4CE6A4570746D2FE13DAD47FED742E4E,30681,13,14,1,109.48493,18.26917,1463
137129,4CE6A4570746D2FE13DAD47FED742E4E,38251,16,17,1,109.49618,18.25493,1510
137130,4CE6A4570746D2FE13DAD47FED742E4E,31021,20,21,1,109.49021,18.27,1463
137131,4CE6A4570746D2FE13DAD47FED742E4E,30681,22,23,1,109.48493,18.26917,1463
137132,53875E69050EC42E511A64D3211FA7B3,31071,2,6,4,109.58257,18.28458,1815
137133,53875E69050EC42E511A64D3211FA7B3,30854,8,9,1,109.56889,18.27076,1763
137134,53875E69050EC42E511A64D3211FA7B3,30851,12,13,1,109.5616,18.27396,1713
137138,06FCF67485A2B44C8ABC96FDB92547C5,61011,0,2,2,109.60653,18.19076,1900
137140,06FCF67485A2B44C8ABC96FDB92547C5,61011,6,7,1,109.60653,18.19076,1900
137165,95E09A72760B2799C2CC9BD7AF527107,31071,0,12,12,109.58257,18.28458,1815
137166,95E09A72760B2799C2CC9BD7AF527107,30854,14,18,4,109.56889,18.27076,1763
137167,95E09A72760B2799C2CC9BD7AF527107,31071,19,20,1,109.58257,18.28458,1815
137168,95E09A72760B2799C2CC9BD7AF527107,30854,20,21,1,109.56889,18.27076,1763
137177,C99018C5FE7BE36145E83B623599A9D0,31521,0,7,7,109.51458,18.22542,1555
137178,C99018C5FE7BE36145E83B623599A9D0,31521,7,9,2,109.51458,18.22542,1555
137179,C99018C5FE7BE36145E83B623599A9D0,31521,10,23,13,109.51458,18.22542,1555
137186,BAB9B8A3D1E7FB96DB94A06687C464B3,38154,1,7,6,109.5266,18.28278,1615
137187,BAB9B8A3D1E7FB96DB94A06687C464B3,31311,9,16,7,109.72299,18.27438,2364
137188,BAB9B8A3D1E7FB96DB94A06687C464B3,31361,20,23,3,109.47417,18.28292,1415
137205,A952750F25C558E5C17B3EB7DD935431,60371,2,6,4,109.53063,18.30056,1618
137206,A952750F25C558E5C17B3EB7DD935431,31931,9,12,3,109.54771,18.29403,1667
137207,A952750F25C558E5C17B3EB7DD935431,60371,12,13,1,109.53063,18.30056,1618
137208,A952750F25C558E5C17B3EB7DD935431,31931,15,20,5,109.54771,18.29403,1667
137209,A952750F25C558E5C17B3EB7DD935431,60371,20,22,2,109.53063,18.30056,1618
137217,ABCD0851CC1C78BCD7AF6DBDF2F5DE49,60524,0,6,6,109.42951,18.28993,1216
137218,ABCD0851CC1C78BCD7AF6DBDF2F5DE49,30211,6,11,5,109.49882,18.23931,1508
137219,ABCD0851CC1C78BCD7AF6DBDF2F5DE49,60552,12,13,1,109.41729,18.30014,1218
137220,ABCD0851CC1C78BCD7AF6DBDF2F5DE49,30051,14,18,4,109.48917,18.21215,1453
137221,ABCD0851CC1C78BCD7AF6DBDF2F5DE49,30821,18,22,4,109.43681,18.33639,1274
137224,5E97A4561E11AAC4FBC53FD068EAA52B,60631,0,1,1,109.57778,18.27583,1814
137225,5E97A4561E11AAC4FBC53FD068EAA52B,30854,3,21,18,109.56889,18.27076,1763
137267,E6541B4F346982101D887BAAF0315541,30854,1,6,5,109.56889,18.27076,1763
137268,E6541B4F346982101D887BAAF0315541,31561,9,10,1,109.56792,18.28479,1765
137269,E6541B4F346982101D887BAAF0315541,30854,12,23,11,109.56889,18.27076,1763
137279,9EB99F27F9127F01C16DB7BA7D10B6E0,38754,10,12,2,109.74667,18.37382,2430
137280,9EB99F27F9127F01C16DB7BA7D10B6E0,30854,13,14,1,109.56889,18.27076,1763
137281,9EB99F27F9127F01C16DB7BA7D10B6E0,31071,15,22,7,109.58257,18.28458,1815
137292,B0E741288CA2FC33FD0EC2387A571BD4,38683,0,8,8,109.4266,18.29097,1216
137293,B0E741288CA2FC33FD0EC2387A571BD4,31781,10,11,1,109.19847,18.2975,367
137294,B0E741288CA2FC33FD0EC2387A571BD4,31145,11,12,1,109.20431,18.30479,369
137320,B643AC77F8D8498A9694D45BA8B0F75F,31561,3,5,2,109.56792,18.28479,1765
137321,B643AC77F8D8498A9694D45BA8B0F75F,60631,8,16,8,109.57778,18.27583,1814
137368,6593F76DF8B5BF518604AD69943FBD58,30854,12,15,3,109.56889,18.27076,1763
137369,6593F76DF8B5BF518604AD69943FBD58,31071,17,18,1,109.58257,18.28458,1815
137437,BAC7E51B2D0D207ECF67D07957EC28B1,60501,20,21,1,109.48701,18.29021,1466
137438,BAC7E51B2D0D207ECF67D07957EC28B1,30111,21,23,2,109.47583,18.30542,1419
137460,27BCEF3137923B84211F08830816C810,30851,1,7,6,109.5616,18.27396,1713
137461,27BCEF3137923B84211F08830816C810,61011,11,12,1,109.60653,18.19076,1900
137486,E8EFAA5D1A201DE1B09CA7FAC04D4F91,30421,17,21,4,109.50021,18.25861,1511
137487,E8EFAA5D1A201DE1B09CA7FAC04D4F91,60131,22,23,1,109.49819,18.24778,1509
137494,439C404954398764464D854D76F475D8,31345,19,20,1,109.39,18.29,1066
137495,439C404954398764464D854D76F475D8,31345,21,23,2,109.39,18.29,1066
137547,4995463B780282C9C030A19D9F49AEAC,30721,0,1,1,109.51597,18.28257,1565
137548,4995463B780282C9C030A19D9F49AEAC,31071,2,5,3,109.58257,18.28458,1815
137549,4995463B780282C9C030A19D9F49AEAC,30854,8,12,4,109.56889,18.27076,1763
137550,4995463B780282C9C030A19D9F49AEAC,31171,15,23,8,109.50938,18.24917,1559
137584,937F0B31443CC6355891AA9D2DB0C670,31561,0,2,2,109.56792,18.28479,1765
137585,937F0B31443CC6355891AA9D2DB0C670,31071,2,5,3,109.58257,18.28458,1815
137586,937F0B31443CC6355891AA9D2DB0C670,31561,6,15,9,109.56792,18.28479,1765
137587,937F0B31443CC6355891AA9D2DB0C670,30854,16,18,2,109.56889,18.27076,1763
137588,937F0B31443CC6355891AA9D2DB0C670,31561,19,23,4,109.56792,18.28479,1765
137605,C69C9580000F43E4250576851966C975,30661,0,7,7,109.37028,18.24361,1008
137606,C69C9580000F43E4250576851966C975,31781,12,14,2,109.19847,18.2975,367
137632,00FD2268DE6E83934D2916174E81532F,60472,13,14,1,109.46625,18.29542,1367
137633,00FD2268DE6E83934D2916174E81532F,30111,17,23,6,109.47583,18.30542,1419
137650,057935907C2B481CA4E4D08E6E9B9029,30771,18,21,3,109.49938,18.26042,1511
137662,22130435C432F057AB9DDA7C1A223C66,60084,0,10,10,109.4984,18.2334,1507
137663,22130435C432F057AB9DDA7C1A223C66,30051,11,12,1,109.48917,18.21215,1453
137664,22130435C432F057AB9DDA7C1A223C66,31521,13,14,1,109.51458,18.22542,1555
137665,22130435C432F057AB9DDA7C1A223C66,60381,16,17,1,109.5241,18.22458,1605
137666,22130435C432F057AB9DDA7C1A223C66,60084,18,23,5,109.4984,18.2334,1507
137674,B340EDEF4A878E8DF5CBEC25E465EACE,31071,1,3,2,109.58257,18.28458,1815
137675,B340EDEF4A878E8DF5CBEC25E465EACE,30854,5,7,2,109.56889,18.27076,1763
137676,B340EDEF4A878E8DF5CBEC25E465EACE,31071,7,8,1,109.58257,18.28458,1815
137677,B340EDEF4A878E8DF5CBEC25E465EACE,30854,8,23,15,109.56889,18.27076,1763
137693,F198CAA1F49ACA5D003FD8F8473B3798,31071,0,7,7,109.58257,18.28458,1815
137694,F198CAA1F49ACA5D003FD8F8473B3798,30854,9,11,2,109.56889,18.27076,1763
137753,BB341BA09AFD6F1A65DDB2B3AF49B6CA,31031,16,17,1,109.49979,18.25382,1510
137764,DAB08D254D49BF150533311BD904D49C,39191,0,12,12,109.51493,18.23472,1557
137765,DAB08D254D49BF150533311BD904D49C,31071,13,16,3,109.58257,18.28458,1815
137766,DAB08D254D49BF150533311BD904D49C,38154,19,21,2,109.5266,18.28278,1615
137767,DAB08D254D49BF150533311BD904D49C,30721,21,23,2,109.51597,18.28257,1565
137768,B2447A087C8F374ABEBA0025E60F3E7C,31521,0,7,7,109.51458,18.22542,1555
137769,B2447A087C8F374ABEBA0025E60F3E7C,31521,8,9,1,109.51458,18.22542,1555
137770,B2447A087C8F374ABEBA0025E60F3E7C,31303,12,14,2,109.15826,18.29549,217
137771,B2447A087C8F374ABEBA0025E60F3E7C,60381,16,20,4,109.5241,18.22458,1605
137772,B2447A087C8F374ABEBA0025E60F3E7C,39321,21,22,1,109.529,18.2167,1604
137773,B32E0C141A5BC7BD81AEFEA867DBF2BA,30854,0,3,3,109.56889,18.27076,1763
137774,B32E0C141A5BC7BD81AEFEA867DBF2BA,39371,4,5,1,109.56627,18.2646,1762
137775,B32E0C141A5BC7BD81AEFEA867DBF2BA,30854,6,22,16,109.56889,18.27076,1763
137776,6AA1FDAFF316CF8CAED7100E9AF3DC53,60551,0,7,7,109.42722,18.30111,1218
137777,6AA1FDAFF316CF8CAED7100E9AF3DC53,31781,9,11,2,109.19847,18.2975,367
137778,6AA1FDAFF316CF8CAED7100E9AF3DC53,31145,11,13,2,109.20431,18.30479,369
137779,6AA1FDAFF316CF8CAED7100E9AF3DC53,60552,16,17,1,109.41729,18.30014,1218
137780,6AA1FDAFF316CF8CAED7100E9AF3DC53,60551,18,23,5,109.42722,18.30111,1218
137793,1B2AAA05011DB9CAB121805410EE3612,38951,19,21,2,109.48097,18.28868,1416
137794,1B2AAA05011DB9CAB121805410EE3612,38951,22,23,1,109.48097,18.28868,1416
137798,800DFCEC5F68D621508C6DD1FAD20726,31431,2,9,7,109.44639,18.29042,1316
137799,800DFCEC5F68D621508C6DD1FAD20726,30854,13,14,1,109.56889,18.27076,1763
137800,800DFCEC5F68D621508C6DD1FAD20726,60621,16,17,1,109.48354,18.27451,1464
137801,800DFCEC5F68D621508C6DD1FAD20726,31431,20,23,3,109.44639,18.29042,1316
137802,420DF8F1B34A98719142CDFE3AAEB3D3,60381,3,11,8,109.5241,18.22458,1605
137803,420DF8F1B34A98719142CDFE3AAEB3D3,38754,14,17,3,109.74667,18.37382,2430
137804,420DF8F1B34A98719142CDFE3AAEB3D3,31521,17,20,3,109.51458,18.22542,1555
137805,420DF8F1B34A98719142CDFE3AAEB3D3,31521,20,23,3,109.51458,18.22542,1555
137810,552B98A65A23DB4CD390E78F3246E9C5,30071,0,6,6,109.52819,18.30472,1619
137811,552B98A65A23DB4CD390E78F3246E9C5,31931,9,19,10,109.54771,18.29403,1667
137812,552B98A65A23DB4CD390E78F3246E9C5,30921,20,23,3,109.53903,18.29451,1667
137837,C2EDA129DED7B4E10FC6588761A88D65,38171,0,15,15,109.50799,18.28139,1515
137873,AFCE3351168C576BE2AA828A190DD579,60401,11,13,2,109.47444,18.27583,1414
137874,AFCE3351168C576BE2AA828A190DD579,60221,16,17,1,109.52569,18.29188,1616
137875,AFCE3351168C576BE2AA828A190DD579,31031,18,20,2,109.49979,18.25382,1510
137876,AFCE3351168C576BE2AA828A190DD579,31231,20,23,3,109.42597,18.29292,1217
137878,AE9453D604AF88F4293DEF99463B2345,30421,17,19,2,109.50021,18.25861,1511
137899,51015BF65833D98716A0309741D1F1C2,30854,0,15,15,109.56889,18.27076,1763
137900,51015BF65833D98716A0309741D1F1C2,60231,16,17,1,109.49903,18.21972,1504
137901,51015BF65833D98716A0309741D1F1C2,39091,18,20,2,109.50097,18.25222,1510
137905,0A5FE7A49BFEAE015B4E071389173366,30791,18,22,4,109.72333,18.40889,2386
137929,A91F346055333341B878D926F011AB58,31061,0,7,7,109.53333,18.23257,1607
137937,0E0D6E55BB1995EBF85F6B7AA8765E55,39183,17,18,1,109.55542,18.28208,1715
137938,0E0D6E55BB1995EBF85F6B7AA8765E55,30854,19,23,4,109.56889,18.27076,1763
137949,7AE891083A2B2C0292CFD40014FEF0E4,38973,0,9,9,109.51097,18.25389,1560
137950,7AE891083A2B2C0292CFD40014FEF0E4,30711,10,13,3,109.50271,18.25347,1510
137951,7AE891083A2B2C0292CFD40014FEF0E4,30151,13,15,2,109.50986,18.25083,1560
137952,7AE891083A2B2C0292CFD40014FEF0E4,60114,19,21,2,109.73028,18.33847,2374
137955,2D39AE6120F2674000C6DBB8A6E572A0,30854,11,12,1,109.56889,18.27076,1763
137956,2D39AE6120F2674000C6DBB8A6E572A0,31945,14,16,2,109.58021,18.29403,1817
137957,2D39AE6120F2674000C6DBB8A6E572A0,30854,18,19,1,109.56889,18.27076,1763
137958,2D39AE6120F2674000C6DBB8A6E572A0,60631,19,20,1,109.57778,18.27583,1814
137981,2D683B3AD358B28A27E068E80E3AA9C8,33481,9,13,4,109.67278,18.41278,2187
137982,2D683B3AD358B28A27E068E80E3AA9C8,31071,16,18,2,109.58257,18.28458,1815
137983,2D683B3AD358B28A27E068E80E3AA9C8,30854,19,23,4,109.56889,18.27076,1763
138001,C1F9914EF577AE2A8300B1A3945A50FF,30851,0,7,7,109.5616,18.27396,1713
138002,C1F9914EF577AE2A8300B1A3945A50FF,31561,7,8,1,109.56792,18.28479,1765
138003,C1F9914EF577AE2A8300B1A3945A50FF,30851,11,12,1,109.5616,18.27396,1713
138026,21EA50B7F2072F2024B9F3B7B9174B94,31561,16,17,1,109.56792,18.28479,1765
138027,21EA50B7F2072F2024B9F3B7B9174B94,30234,17,19,2,109.60681,18.29979,1918
138028,21EA50B7F2072F2024B9F3B7B9174B94,30321,21,22,1,109.49563,18.29611,1467
138052,3BB007FDF28DB0E7E883BA594F721FFE,31181,0,6,6,109.50382,18.24813,1509
138053,3BB007FDF28DB0E7E883BA594F721FFE,31181,7,8,1,109.50382,18.24813,1509
138054,3BB007FDF28DB0E7E883BA594F721FFE,31181,9,22,13,109.50382,18.24813,1509
138092,D3FB1B9D3C241050E5FB29B7C0AA31BE,31021,14,16,2,109.49021,18.27,1463
138093,D3FB1B9D3C241050E5FB29B7C0AA31BE,31611,18,23,5,109.63076,18.34944,2026
138219,361A6FA452CCBED9D72BF58E7EB7C21F,60524,0,7,7,109.42951,18.28993,1216
138220,361A6FA452CCBED9D72BF58E7EB7C21F,60054,12,13,1,109.3016,18.31229,770
138221,361A6FA452CCBED9D72BF58E7EB7C21F,60221,16,17,1,109.52569,18.29188,1616
138222,361A6FA452CCBED9D72BF58E7EB7C21F,60524,19,23,4,109.42951,18.28993,1216
138339,FFA78E97945507AFD9DEF992A707C4AC,31461,0,7,7,109.5091,18.25389,1510
138340,FFA78E97945507AFD9DEF992A707C4AC,31081,8,10,2,109.44639,18.30181,1318
138342,FFA78E97945507AFD9DEF992A707C4AC,31031,19,20,1,109.49979,18.25382,1510
138343,FFA78E97945507AFD9DEF992A707C4AC,31461,20,23,3,109.5091,18.25389,1510
138371,E191BF114A3C2277CB7C3323BAA13F43,30854,0,16,16,109.56889,18.27076,1763
138372,E191BF114A3C2277CB7C3323BAA13F43,30191,21,23,2,109.50361,18.22701,1506
138373,9FC721E86703223349C05C95FE4BBB6F,60087,0,1,1,109.50688,18.22299,1505
138374,9FC721E86703223349C05C95FE4BBB6F,60081,1,11,10,109.51097,18.22639,1556
138375,9FC721E86703223349C05C95FE4BBB6F,31521,11,14,3,109.51458,18.22542,1555
138376,9FC721E86703223349C05C95FE4BBB6F,60381,14,19,5,109.5241,18.22458,1605
138377,9FC721E86703223349C05C95FE4BBB6F,30731,20,21,1,109.50944,18.22306,1555
138378,34CDE58722D425921983509B878EB515,30181,0,6,6,109.51597,18.23313,1557
138379,34CDE58722D425921983509B878EB515,31151,8,11,3,109.75549,18.4191,2488
138380,34CDE58722D425921983509B878EB515,31841,12,14,2,109.73201,18.33382,2373
138383,C28E7C5F7B366223D185D96F76A4BF8F,38094,0,7,7,109.45403,18.28778,1316
138384,C28E7C5F7B366223D185D96F76A4BF8F,31781,12,14,2,109.19847,18.2975,367
138421,07F004282B66F8FFF4893B155B27BCEE,60524,0,6,6,109.42951,18.28993,1216
138450,2C0209770A37CBC62C92C1A37F9CD2E2,31521,0,6,6,109.51458,18.22542,1555
138451,2C0209770A37CBC62C92C1A37F9CD2E2,60381,6,10,4,109.5241,18.22458,1605
138452,2C0209770A37CBC62C92C1A37F9CD2E2,31521,11,12,1,109.51458,18.22542,1555
138453,2C0209770A37CBC62C92C1A37F9CD2E2,38111,13,16,3,109.52007,18.22403,1555
138454,2C0209770A37CBC62C92C1A37F9CD2E2,38071,18,21,3,109.40722,18.30938,1169
138482,C145E18C3951CC141DA56187AFB95CCF,31271,0,7,7,109.48958,18.26257,1462
138483,C145E18C3951CC141DA56187AFB95CCF,31471,12,14,2,109.34583,18.29563,917
138484,C145E18C3951CC141DA56187AFB95CCF,31271,18,23,5,109.48958,18.26257,1462
138490,CFCFA94681CDD57855D6405C244168DD,38891,2,6,4,109.51486,18.24118,1558
138491,CFCFA94681CDD57855D6405C244168DD,30911,7,8,1,109.50493,18.26181,1511
138492,CFCFA94681CDD57855D6405C244168DD,38291,10,11,1,109.51618,18.24313,1558
138493,CFCFA94681CDD57855D6405C244168DD,31201,12,15,3,109.51042,18.23819,1558
138494,CFCFA94681CDD57855D6405C244168DD,31261,17,19,2,109.51174,18.2466,1559
138495,CFCFA94681CDD57855D6405C244168DD,38251,22,23,1,109.49618,18.25493,1510
138608,2576A40187A845D7B849E820F16B3DB1,30854,2,8,6,109.56889,18.27076,1763
138609,2576A40187A845D7B849E820F16B3DB1,31561,10,19,9,109.56792,18.28479,1765
138610,2576A40187A845D7B849E820F16B3DB1,30854,19,23,4,109.56889,18.27076,1763
138740,0D3DA8126B134D203BB35373EAFFB116,31071,0,17,17,109.58257,18.28458,1815
138741,0D3DA8126B134D203BB35373EAFFB116,30854,19,23,4,109.56889,18.27076,1763
138750,AF1EA8B0A2B2E2169B1942DA5F1F6F92,30201,0,7,7,109.4909,18.26465,1462
138773,C78747A0453D40EE772827559A626260,38111,0,10,10,109.52007,18.22403,1555
138774,C78747A0453D40EE772827559A626260,31471,12,13,1,109.34583,18.29563,917
138775,C78747A0453D40EE772827559A626260,30361,16,19,3,109.50347,18.24,1508
138776,C78747A0453D40EE772827559A626260,38111,19,21,2,109.52007,18.22403,1555
138791,5274FB91D917823AD6AE120EE7F21099,31931,0,5,5,109.54771,18.29403,1667
138792,5274FB91D917823AD6AE120EE7F21099,60361,8,12,4,109.51938,18.29681,1567
138793,5274FB91D917823AD6AE120EE7F21099,31931,14,18,4,109.54771,18.29403,1667
138802,3B2F0B1EB2C18CFD96A1AF866AE54E56,60161,0,2,2,109.49174,18.26181,1461
138803,3B2F0B1EB2C18CFD96A1AF866AE54E56,60231,3,8,5,109.49903,18.21972,1504
138817,47A18820FDA9856131F74091D44B6BCB,31071,0,6,6,109.58257,18.28458,1815
138818,47A18820FDA9856131F74091D44B6BCB,30851,8,12,4,109.5616,18.27396,1713
138819,47A18820FDA9856131F74091D44B6BCB,31561,15,17,2,109.56792,18.28479,1765
138867,26CDE97E277FCC5CCED61585339A0A32,60084,0,6,6,109.4984,18.2334,1507
138868,26CDE97E277FCC5CCED61585339A0A32,31471,8,10,2,109.34583,18.29563,917
138869,26CDE97E277FCC5CCED61585339A0A32,31145,13,14,1,109.20431,18.30479,369
138870,26CDE97E277FCC5CCED61585339A0A32,30821,15,17,2,109.43681,18.33639,1274
138873,46486D9DD250B380A793A8C24723F284,31431,0,8,8,109.44639,18.29042,1316
138877,011180B62F4B74096321FE5AD83DEDE5,31701,0,8,8,109.44132,18.28833,1266
138878,011180B62F4B74096321FE5AD83DEDE5,31781,12,13,1,109.19847,18.2975,367
138879,011180B62F4B74096321FE5AD83DEDE5,60054,14,15,1,109.3016,18.31229,770
138880,011180B62F4B74096321FE5AD83DEDE5,31701,16,23,7,109.44132,18.28833,1266
138899,A9FCE0049DB44FE004EAFBF5B783F4A5,31945,0,7,7,109.58021,18.29403,1817
138900,A9FCE0049DB44FE004EAFBF5B783F4A5,30854,7,15,8,109.56889,18.27076,1763
138912,32ADC32EC334C9A30E8F811D3E7356C7,38251,0,2,2,109.49618,18.25493,1510
138913,32ADC32EC334C9A30E8F811D3E7356C7,60161,3,8,5,109.49174,18.26181,1461
138919,2D913891935203F66178BF4BFC3F9DA5,60641,0,11,11,109.53854,18.2359,1657
138921,2D913891935203F66178BF4BFC3F9DA5,30461,19,21,2,109.5116,18.26313,1562
138922,2D913891935203F66178BF4BFC3F9DA5,30461,22,23,1,109.5116,18.26313,1562
138928,A64494D6F3A0AF8BF93D9FAA1169011A,38811,0,15,15,109.50875,18.2175,1504
138929,A64494D6F3A0AF8BF93D9FAA1169011A,30741,17,20,3,109.49833,18.28681,1516
138930,A64494D6F3A0AF8BF93D9FAA1169011A,31534,21,22,1,109.49368,18.25806,1461
138957,3AC2F24CA8FAEF79CE1BF617A79038A2,31471,12,13,1,109.34583,18.29563,917
138958,3AC2F24CA8FAEF79CE1BF617A79038A2,60411,15,17,2,109.32514,18.30854,869
138976,8E06EAC16B0EF776FA1BAAC5B9747325,30511,0,6,6,109.51069,18.24208,1558
138977,8E06EAC16B0EF776FA1BAAC5B9747325,60114,11,18,7,109.73028,18.33847,2374
138978,8E06EAC16B0EF776FA1BAAC5B9747325,30511,19,23,4,109.51069,18.24208,1558
138992,84DF4A7C208235D171EF56473BCCF210,30851,0,3,3,109.5616,18.27396,1713
138993,84DF4A7C208235D171EF56473BCCF210,31561,3,7,4,109.56792,18.28479,1765
138994,84DF4A7C208235D171EF56473BCCF210,30854,7,8,1,109.56889,18.27076,1763
138995,84DF4A7C208235D171EF56473BCCF210,60631,8,17,9,109.57778,18.27583,1814
138996,84DF4A7C208235D171EF56473BCCF210,30851,20,23,3,109.5616,18.27396,1713
139009,88EA7986E36BDB47723EEA4FDCFA624A,30354,0,8,8,109.42813,18.29076,1216
139010,88EA7986E36BDB47723EEA4FDCFA624A,31781,9,13,4,109.19847,18.2975,367
139011,88EA7986E36BDB47723EEA4FDCFA624A,30354,17,23,6,109.42813,18.29076,1216
139050,A94F66C88B84FF0658441320CD9F667C,30854,0,13,13,109.56889,18.27076,1763
139051,A94F66C88B84FF0658441320CD9F667C,31071,15,16,1,109.58257,18.28458,1815
139052,A94F66C88B84FF0658441320CD9F667C,30854,17,20,3,109.56889,18.27076,1763
139061,7024F3A14F6F554DC6E80063E30315F0,31561,1,6,5,109.56792,18.28479,1765
139062,7024F3A14F6F554DC6E80063E30315F0,39183,8,16,8,109.55542,18.28208,1715
139111,8CE55AC8BC984D52D16D6CE4872EB6FC,30511,0,5,5,109.51069,18.24208,1558
139112,8CE55AC8BC984D52D16D6CE4872EB6FC,30161,7,11,4,109.50042,18.24389,1508
139113,8CE55AC8BC984D52D16D6CE4872EB6FC,31031,12,13,1,109.49979,18.25382,1510
139180,663CE56232D73D50E42DEC41EA33269F,31931,0,1,1,109.54771,18.29403,1667
139181,663CE56232D73D50E42DEC41EA33269F,30921,4,9,5,109.53903,18.29451,1667
139182,663CE56232D73D50E42DEC41EA33269F,31931,13,20,7,109.54771,18.29403,1667
139234,188C304BB598010A42FAC48FFAD2E905,60524,0,7,7,109.42951,18.28993,1216
139235,188C304BB598010A42FAC48FFAD2E905,31781,10,11,1,109.19847,18.2975,367
139236,188C304BB598010A42FAC48FFAD2E905,31471,13,15,2,109.34583,18.29563,917
139237,188C304BB598010A42FAC48FFAD2E905,31431,17,18,1,109.44639,18.29042,1316
139238,F00821368F615DCDAF214035D8EC4A44,31071,2,7,5,109.58257,18.28458,1815
139239,F00821368F615DCDAF214035D8EC4A44,30854,8,16,8,109.56889,18.27076,1763
139266,934029FB5F97BCE114EDCE88F0393A63,30854,16,19,3,109.56889,18.27076,1763
139267,934029FB5F97BCE114EDCE88F0393A63,30234,22,23,1,109.60681,18.29979,1918
139277,96F98526707B06BE1263CCD4F72E07A1,31071,0,9,9,109.58257,18.28458,1815
139278,96F98526707B06BE1263CCD4F72E07A1,30854,9,11,2,109.56889,18.27076,1763
139279,96F98526707B06BE1263CCD4F72E07A1,31071,12,13,1,109.58257,18.28458,1815
139280,96F98526707B06BE1263CCD4F72E07A1,31945,15,16,1,109.58021,18.29403,1817
139281,96F98526707B06BE1263CCD4F72E07A1,30854,19,21,2,109.56889,18.27076,1763
139282,4521A8D92A7219267FD46990BC1A5213,30232,0,3,3,109.6191,18.31701,1971
139283,4521A8D92A7219267FD46990BC1A5213,31561,4,5,1,109.56792,18.28479,1765
139284,4521A8D92A7219267FD46990BC1A5213,30232,7,23,16,109.6191,18.31701,1971
139289,335A7B1DE8538918FDA774EE3E402A76,30191,0,7,7,109.50361,18.22701,1506
139290,335A7B1DE8538918FDA774EE3E402A76,60381,8,12,4,109.5241,18.22458,1605
139291,335A7B1DE8538918FDA774EE3E402A76,30191,13,23,10,109.50361,18.22701,1506
139299,33B6215E88E05EAC96C763C8595FD5B3,60621,0,8,8,109.48354,18.27451,1464
139309,0500828DD6E0C85C8CBD75C0F0AE1363,31431,0,6,6,109.44639,18.29042,1316
139310,0500828DD6E0C85C8CBD75C0F0AE1363,31781,10,11,1,109.19847,18.2975,367
139316,AB89AD6D2E26F2802EB970B91FAAF097,38111,9,16,7,109.52007,18.22403,1555
139317,AB89AD6D2E26F2802EB970B91FAAF097,38111,17,19,2,109.52007,18.22403,1555
139332,AA17C9279A63248D7DCDF49F93EB8817,30854,1,12,11,109.56889,18.27076,1763
139333,AA17C9279A63248D7DCDF49F93EB8817,60463,17,20,3,109.52507,18.22438,1605
139334,AA17C9279A63248D7DCDF49F93EB8817,30854,21,23,2,109.56889,18.27076,1763
139347,ECE5F9061BD873B365108DCE1A2E8E9E,38134,2,7,5,109.63931,18.23451,2007
139348,ECE5F9061BD873B365108DCE1A2E8E9E,31321,8,9,1,109.63799,18.23201,2007
139349,ECE5F9061BD873B365108DCE1A2E8E9E,38271,10,17,7,109.62632,18.23049,1956
139350,ECE5F9061BD873B365108DCE1A2E8E9E,30361,18,19,1,109.50347,18.24,1508
139351,ECE5F9061BD873B365108DCE1A2E8E9E,31321,21,23,2,109.63799,18.23201,2007
139371,A3BD759CB67CAA27775E36B23655EA26,38134,0,7,7,109.63931,18.23451,2007
139372,A3BD759CB67CAA27775E36B23655EA26,38271,7,9,2,109.62632,18.23049,1956
139373,A3BD759CB67CAA27775E36B23655EA26,31471,11,13,2,109.34583,18.29563,917
139374,A3BD759CB67CAA27775E36B23655EA26,31781,15,16,1,109.19847,18.2975,367
139375,A3BD759CB67CAA27775E36B23655EA26,38134,21,23,2,109.63931,18.23451,2007
139386,36566106CC9CFD386F41AE364EF63663,30341,14,16,2,109.3625,18.29167,966
139393,B93185B4820D7E0DEE74EBEA00941D15,60201,0,2,2,109.5041,18.2509,1510
139394,B93185B4820D7E0DEE74EBEA00941D15,30911,2,9,7,109.50493,18.26181,1511
139395,B93185B4820D7E0DEE74EBEA00941D15,60201,12,20,8,109.5041,18.2509,1510
139396,B93185B4820D7E0DEE74EBEA00941D15,30911,20,22,2,109.50493,18.26181,1511
139427,00E4BC24F22404A2FC4D45749054257A,30854,13,18,5,109.56889,18.27076,1763
139428,00E4BC24F22404A2FC4D45749054257A,31071,20,22,2,109.58257,18.28458,1815
139434,F84D949DDCBF25D5530F771BC55E0B9D,61011,0,6,6,109.60653,18.19076,1900
139436,F84D949DDCBF25D5530F771BC55E0B9D,61011,10,11,1,109.60653,18.19076,1900
139460,07169E7114E4F14C073261BAAC0D4491,61011,1,6,5,109.60653,18.19076,1900
139462,07169E7114E4F14C073261BAAC0D4491,61011,9,11,2,109.60653,18.19076,1900
139473,53490AD77ACCA93C3ED0F3DE79CA488B,31071,8,16,8,109.58257,18.28458,1815
139474,53490AD77ACCA93C3ED0F3DE79CA488B,30854,19,21,2,109.56889,18.27076,1763
139495,6F590AF2C10C4B9F0F4E76B8E922550E,31945,1,15,14,109.58021,18.29403,1817
139496,6F590AF2C10C4B9F0F4E76B8E922550E,31071,15,17,2,109.58257,18.28458,1815
139497,6F590AF2C10C4B9F0F4E76B8E922550E,31945,20,23,3,109.58021,18.29403,1817
139526,0958879F2092FEC51B8948C9F5C46956,60054,15,16,1,109.3016,18.31229,770
139527,0958879F2092FEC51B8948C9F5C46956,60381,18,19,1,109.5241,18.22458,1605
139528,0958879F2092FEC51B8948C9F5C46956,31231,21,23,2,109.42597,18.29292,1217
139570,B1CCD68E3CC8A7232EF2DE7E986C4789,30911,0,1,1,109.50493,18.26181,1511
139571,B1CCD68E3CC8A7232EF2DE7E986C4789,30971,1,9,8,109.48708,18.29319,1467
139572,B1CCD68E3CC8A7232EF2DE7E986C4789,60504,13,14,1,109.47917,18.28903,1416
139573,B1CCD68E3CC8A7232EF2DE7E986C4789,60381,15,17,2,109.5241,18.22458,1605
139574,B1CCD68E3CC8A7232EF2DE7E986C4789,30681,22,23,1,109.48493,18.26917,1463
139575,9C1407835BC54BEBDB541F52E1DA1820,61011,0,11,11,109.60653,18.19076,1900
139577,9C1407835BC54BEBDB541F52E1DA1820,61011,15,23,8,109.60653,18.19076,1900
139610,3520FED22A4D572CBFE1B08BD2743E22,60291,4,9,5,109.50826,18.24639,1509
139611,3520FED22A4D572CBFE1B08BD2743E22,31181,10,11,1,109.50382,18.24813,1509
139612,3520FED22A4D572CBFE1B08BD2743E22,31311,14,15,1,109.72299,18.27438,2364
139613,3520FED22A4D572CBFE1B08BD2743E22,38361,16,18,2,109.43667,18.29201,1267
139614,3520FED22A4D572CBFE1B08BD2743E22,31031,18,20,2,109.49979,18.25382,1510
139615,3520FED22A4D572CBFE1B08BD2743E22,38291,20,22,2,109.51618,18.24313,1558
139622,3A4E228E5E71900953BAD30C430563D8,60371,0,6,6,109.53063,18.30056,1618
139623,3A4E228E5E71900953BAD30C430563D8,31945,10,11,1,109.58021,18.29403,1817
139624,3A4E228E5E71900953BAD30C430563D8,60371,13,22,9,109.53063,18.30056,1618
139718,8C3D244B6DAAE8C73F174808255E03C6,60011,0,6,6,109.48965,18.30222,1468
139719,8C3D244B6DAAE8C73F174808255E03C6,30764,7,15,8,109.45806,18.29486,1367
139720,8C3D244B6DAAE8C73F174808255E03C6,30761,16,18,2,109.45201,18.3,1318
139721,8C3D244B6DAAE8C73F174808255E03C6,30111,20,21,1,109.47583,18.30542,1419
139722,8C3D244B6DAAE8C73F174808255E03C6,60011,21,23,2,109.48965,18.30222,1468
139733,D9D5ADF124CBC7323CAE219AA0CE2AB6,31271,0,9,9,109.48958,18.26257,1462
139734,D9D5ADF124CBC7323CAE219AA0CE2AB6,31471,13,15,2,109.34583,18.29563,917
139735,D9D5ADF124CBC7323CAE219AA0CE2AB6,31031,18,20,2,109.49979,18.25382,1510
139736,D9D5ADF124CBC7323CAE219AA0CE2AB6,31531,21,23,2,109.49583,18.25972,1461
139792,DBB710D279E76C79F1E4B0766F579F8A,30441,2,3,1,109.64021,18.25424,2010
139793,DBB710D279E76C79F1E4B0766F579F8A,31071,4,6,2,109.58257,18.28458,1815
139794,DBB710D279E76C79F1E4B0766F579F8A,30854,10,15,5,109.56889,18.27076,1763
139816,CCCD2290FB632A48009771412BE68ADD,31561,0,13,13,109.56792,18.28479,1765
139817,CCCD2290FB632A48009771412BE68ADD,39183,14,18,4,109.55542,18.28208,1715
139818,CCCD2290FB632A48009771412BE68ADD,31561,19,22,3,109.56792,18.28479,1765
139866,73EAC1341C5005A58B26B1A52457F38B,31181,0,4,4,109.50382,18.24813,1509
139867,73EAC1341C5005A58B26B1A52457F38B,60641,4,7,3,109.53854,18.2359,1657
139868,73EAC1341C5005A58B26B1A52457F38B,39101,8,9,1,109.50132,18.24931,1509
139869,73EAC1341C5005A58B26B1A52457F38B,31181,10,15,5,109.50382,18.24813,1509
139870,73EAC1341C5005A58B26B1A52457F38B,30711,18,23,5,109.50271,18.25347,1510
139906,99CBAA6A65A50998F0A10B72B36210E4,60231,0,3,3,109.49903,18.21972,1504
139907,99CBAA6A65A50998F0A10B72B36210E4,60084,7,8,1,109.4984,18.2334,1507
139908,99CBAA6A65A50998F0A10B72B36210E4,60231,12,13,1,109.49903,18.21972,1504
139909,99CBAA6A65A50998F0A10B72B36210E4,60161,18,20,2,109.49174,18.26181,1461
139910,99CBAA6A65A50998F0A10B72B36210E4,38251,20,21,1,109.49618,18.25493,1510
139916,43922725F0A46A5D2B5FC870E087F339,31071,16,17,1,109.58257,18.28458,1815
139917,43922725F0A46A5D2B5FC870E087F339,30854,20,22,2,109.56889,18.27076,1763
139971,55FA72F7A9567EE8C2569F2A3640F92B,60371,0,4,4,109.53063,18.30056,1618
139972,55FA72F7A9567EE8C2569F2A3640F92B,31931,5,7,2,109.54771,18.29403,1667
139973,55FA72F7A9567EE8C2569F2A3640F92B,39181,8,14,6,109.55153,18.28035,1715
139974,55FA72F7A9567EE8C2569F2A3640F92B,39181,14,17,3,109.55153,18.28035,1715
139975,55FA72F7A9567EE8C2569F2A3640F92B,31931,21,23,2,109.54771,18.29403,1667
139979,37D38EF0062E64D55C94EB554B76F9EE,30854,10,13,3,109.56889,18.27076,1763
139980,37D38EF0062E64D55C94EB554B76F9EE,31071,17,18,1,109.58257,18.28458,1815
139981,37D38EF0062E64D55C94EB554B76F9EE,30854,20,21,1,109.56889,18.27076,1763
139985,3A429390E0D19C5F409E32660585ED7B,30571,0,2,2,109.50243,18.21861,1504
139996,3C5AEA306E8A69C707195C4150E77D90,60371,0,6,6,109.53063,18.30056,1618
139997,3C5AEA306E8A69C707195C4150E77D90,39181,7,11,4,109.55153,18.28035,1715
139998,3C5AEA306E8A69C707195C4150E77D90,31931,11,19,8,109.54771,18.29403,1667
139999,3C5AEA306E8A69C707195C4150E77D90,39181,22,23,1,109.55153,18.28035,1715
140032,EF24901D99384F703B20FE07F2784FA0,30101,0,4,4,109.57299,18.33333,1773
140033,EF24901D99384F703B20FE07F2784FA0,31631,5,9,4,109.59542,18.36826,1879
140034,EF24901D99384F703B20FE07F2784FA0,30101,13,16,3,109.57299,18.33333,1773
140035,EF24901D99384F703B20FE07F2784FA0,31631,16,18,2,109.59542,18.36826,1879
140045,D2B9DF4FCA3149F43DC5DB6395F8ACBA,38105,0,10,10,109.40299,18.29229,1117
140046,D2B9DF4FCA3149F43DC5DB6395F8ACBA,31781,12,13,1,109.19847,18.2975,367
140047,D2B9DF4FCA3149F43DC5DB6395F8ACBA,30361,15,16,1,109.50347,18.24,1508
140048,D2B9DF4FCA3149F43DC5DB6395F8ACBA,38105,20,23,3,109.40299,18.29229,1117
140059,E5E2DA460104E389257158E8D8C9FBDA,60281,0,5,5,109.51743,18.25924,1561
140060,E5E2DA460104E389257158E8D8C9FBDA,31261,6,11,5,109.51174,18.2466,1559
140061,E5E2DA460104E389257158E8D8C9FBDA,60281,15,23,8,109.51743,18.25924,1561
140118,020753EF78F0A0C39658113A3377EA1E,31561,0,15,15,109.56792,18.28479,1765
140119,020753EF78F0A0C39658113A3377EA1E,30851,17,18,1,109.5616,18.27396,1713
140142,70E36A4B82878626B569C66E46C7827C,31101,0,8,8,109.65389,18.23403,2057
140143,70E36A4B82878626B569C66E46C7827C,31145,10,12,2,109.20431,18.30479,369
140144,70E36A4B82878626B569C66E46C7827C,31471,13,14,1,109.34583,18.29563,917
140145,70E36A4B82878626B569C66E46C7827C,60221,16,17,1,109.52569,18.29188,1616
140146,70E36A4B82878626B569C66E46C7827C,60381,18,20,2,109.5241,18.22458,1605
140147,70E36A4B82878626B569C66E46C7827C,31101,21,23,2,109.65389,18.23403,2057
140165,F9B937F9F26C2F09039C158F4674A0AD,30711,0,13,13,109.50271,18.25347,1510
140166,F9B937F9F26C2F09039C158F4674A0AD,30711,13,21,8,109.50271,18.25347,1510
140167,F9B937F9F26C2F09039C158F4674A0AD,60291,21,23,2,109.50826,18.24639,1509
140168,EB0139E0BBB300F5407E4F7BCDA3B148,30151,0,4,4,109.50986,18.25083,1560
140169,EB0139E0BBB300F5407E4F7BCDA3B148,38291,6,10,4,109.51618,18.24313,1558
140170,EB0139E0BBB300F5407E4F7BCDA3B148,33481,11,15,4,109.67278,18.41278,2187
140171,EB0139E0BBB300F5407E4F7BCDA3B148,31861,18,22,4,109.49042,18.27549,1464
140236,D9E8C2A0E8C0B92A69D34C40543135ED,30731,0,1,1,109.50944,18.22306,1555
140237,D9E8C2A0E8C0B92A69D34C40543135ED,60081,3,6,3,109.51097,18.22639,1556
140238,D9E8C2A0E8C0B92A69D34C40543135ED,30241,9,10,1,109.26174,18.3275,622
140239,D9E8C2A0E8C0B92A69D34C40543135ED,31781,12,13,1,109.19847,18.2975,367
140240,D9E8C2A0E8C0B92A69D34C40543135ED,31471,14,16,2,109.34583,18.29563,917
140294,FB38B30A8888B4A30D6BD4705441E645,38094,0,5,5,109.45403,18.28778,1316
140295,FB38B30A8888B4A30D6BD4705441E645,31781,10,12,2,109.19847,18.2975,367
140296,FB38B30A8888B4A30D6BD4705441E645,38094,17,18,1,109.45403,18.28778,1316
140301,51061B3DE820AF1C1C713EF684728003,30854,0,5,5,109.56889,18.27076,1763
140302,51061B3DE820AF1C1C713EF684728003,31071,7,11,4,109.58257,18.28458,1815
140303,51061B3DE820AF1C1C713EF684728003,30854,13,23,10,109.56889,18.27076,1763
140307,A8E9C7BB918ADAD29A3EA7ACDDCD32D7,38951,0,12,12,109.48097,18.28868,1416
140308,A8E9C7BB918ADAD29A3EA7ACDDCD32D7,30711,13,17,4,109.50271,18.25347,1510
140309,A8E9C7BB918ADAD29A3EA7ACDDCD32D7,38951,18,22,4,109.48097,18.28868,1416
140314,012ABD06F231728C214A4BA917E75B1C,31561,3,7,4,109.56792,18.28479,1765
140315,012ABD06F231728C214A4BA917E75B1C,30851,9,22,13,109.5616,18.27396,1713
140316,012ABD06F231728C214A4BA917E75B1C,31561,22,23,1,109.56792,18.28479,1765
140342,1C13A323A75285DF0344A33D367E6C75,31471,13,16,3,109.34583,18.29563,917
140431,6EB2B3F5283FD4FC75239E7A3DF1C160,31461,0,5,5,109.5091,18.25389,1510
140432,6EB2B3F5283FD4FC75239E7A3DF1C160,30711,6,7,1,109.50271,18.25347,1510
140433,6EB2B3F5283FD4FC75239E7A3DF1C160,31081,8,9,1,109.44639,18.30181,1318
140434,6EB2B3F5283FD4FC75239E7A3DF1C160,31461,19,20,1,109.5091,18.25389,1510
140435,6EB2B3F5283FD4FC75239E7A3DF1C160,60201,20,23,3,109.5041,18.2509,1510
140452,ACC390C77025BECAF4CD259D41E8F314,30232,1,5,4,109.6191,18.31701,1971
140453,ACC390C77025BECAF4CD259D41E8F314,30854,9,11,2,109.56889,18.27076,1763
140454,ACC390C77025BECAF4CD259D41E8F314,39371,16,17,1,109.56627,18.2646,1762
140455,ACC390C77025BECAF4CD259D41E8F314,30854,19,20,1,109.56889,18.27076,1763
140483,43E035AE85036EBD9891453E9567CB81,30151,0,7,7,109.50986,18.25083,1560
140484,43E035AE85036EBD9891453E9567CB81,60221,7,9,2,109.52569,18.29188,1616
140485,43E035AE85036EBD9891453E9567CB81,30151,12,14,2,109.50986,18.25083,1560
140506,6B4FAB397217C25457DFB4FC930EC14C,30111,11,14,3,109.47583,18.30542,1419
140530,2A1AB09F11CECAAFA5576058E9461FEA,30661,0,1,1,109.37028,18.24361,1008
140531,2A1AB09F11CECAAFA5576058E9461FEA,31231,2,3,1,109.42597,18.29292,1217
140532,2A1AB09F11CECAAFA5576058E9461FEA,60161,7,8,1,109.49174,18.26181,1461
140533,2A1AB09F11CECAAFA5576058E9461FEA,31231,9,11,2,109.42597,18.29292,1217
140534,2A1AB09F11CECAAFA5576058E9461FEA,60084,13,14,1,109.4984,18.2334,1507
140570,8752BC71725B50257436D50C6598F252,31071,2,6,4,109.58257,18.28458,1815
140571,8752BC71725B50257436D50C6598F252,30854,7,12,5,109.56889,18.27076,1763
140572,8752BC71725B50257436D50C6598F252,31071,12,13,1,109.58257,18.28458,1815
140573,8752BC71725B50257436D50C6598F252,30854,17,22,5,109.56889,18.27076,1763
140574,6ADBEFDC21CA46F051933BF984A8E255,30854,9,13,4,109.56889,18.27076,1763
140575,6ADBEFDC21CA46F051933BF984A8E255,38706,16,17,1,109.74625,18.37097,2430
140576,6ADBEFDC21CA46F051933BF984A8E255,30961,20,21,1,109.74042,18.37903,2431
140577,6ADBEFDC21CA46F051933BF984A8E255,38706,22,23,1,109.74625,18.37097,2430
140597,8177A8185FF91F7A3E5BC89BE108D19E,30211,4,6,2,109.49882,18.23931,1508
140598,8177A8185FF91F7A3E5BC89BE108D19E,31145,9,12,3,109.20431,18.30479,369
140599,8177A8185FF91F7A3E5BC89BE108D19E,31471,13,16,3,109.34583,18.29563,917
140649,020DAC5EBA12079D2F27F5BC84508A6E,30361,0,10,10,109.50347,18.24,1508
140650,020DAC5EBA12079D2F27F5BC84508A6E,60054,14,15,1,109.3016,18.31229,770
140651,020DAC5EBA12079D2F27F5BC84508A6E,30361,18,20,2,109.50347,18.24,1508
140652,020DAC5EBA12079D2F27F5BC84508A6E,30361,21,23,2,109.50347,18.24,1508
140690,1A3FFDC65E8E8B2347B759A77F2F6BEE,60381,0,5,5,109.5241,18.22458,1605
140691,1A3FFDC65E8E8B2347B759A77F2F6BEE,30191,6,7,1,109.50361,18.22701,1506
140692,1A3FFDC65E8E8B2347B759A77F2F6BEE,31781,12,13,1,109.19847,18.2975,367
140693,1A3FFDC65E8E8B2347B759A77F2F6BEE,31521,16,18,2,109.51458,18.22542,1555
140694,1A3FFDC65E8E8B2347B759A77F2F6BEE,30361,19,21,2,109.50347,18.24,1508
140703,08077B5D5F0A9938A81D328635D03C8B,30851,0,5,5,109.5616,18.27396,1713
140704,08077B5D5F0A9938A81D328635D03C8B,30854,5,13,8,109.56889,18.27076,1763
140723,C983E73D646629A775690ECA8920EB29,30101,16,19,3,109.57299,18.33333,1773
140781,CCBE9BD27BE45DF1D524AAA2624A3639,38121,0,7,7,109.51361,18.27813,1564
140782,CCBE9BD27BE45DF1D524AAA2624A3639,31951,9,12,3,109.52174,18.30299,1568
140783,CCBE9BD27BE45DF1D524AAA2624A3639,30324,13,14,1,109.50326,18.29257,1517
140801,F1FA54BCDE7297F39D6C0507CA898D49,30731,0,7,7,109.50944,18.22306,1555
140802,F1FA54BCDE7297F39D6C0507CA898D49,38361,11,23,12,109.43667,18.29201,1267
140809,3EAE2CCEF780CC2E20C47963EA2CF3C6,30854,5,12,7,109.56889,18.27076,1763
140810,3EAE2CCEF780CC2E20C47963EA2CF3C6,31561,12,23,11,109.56792,18.28479,1765
140843,377A324496E54511961704972731A3D5,38121,13,14,1,109.51361,18.27813,1564
140844,377A324496E54511961704972731A3D5,31521,14,22,8,109.51458,18.22542,1555
141001,F4D58A766EF9F9F31794D51DC3B7202C,30854,16,17,1,109.56889,18.27076,1763
141002,F4D58A766EF9F9F31794D51DC3B7202C,31071,21,23,2,109.58257,18.28458,1815
141022,E8C4FD393F72FBBB76050B5970191821,31071,1,7,6,109.58257,18.28458,1815
141023,E8C4FD393F72FBBB76050B5970191821,31945,7,20,13,109.58021,18.29403,1817
141024,9AA959ED87D1ECC3053DED17290EFCBD,30854,0,3,3,109.56889,18.27076,1763
141025,9AA959ED87D1ECC3053DED17290EFCBD,31561,3,23,20,109.56792,18.28479,1765
141064,BA3D3DE13D22E6DD1BA5A0B2CACB0B94,30361,12,14,2,109.50347,18.24,1508
141065,BA3D3DE13D22E6DD1BA5A0B2CACB0B94,30441,17,18,1,109.64021,18.25424,2010
141066,BA3D3DE13D22E6DD1BA5A0B2CACB0B94,60594,21,22,1,109.62694,18.22799,1956
141067,83ED041A7C5392602E387EAC8E5436E3,38751,2,13,11,109.74903,18.37639,2481
141068,83ED041A7C5392602E387EAC8E5436E3,31221,14,15,1,109.61333,18.26833,1913
141069,83ED041A7C5392602E387EAC8E5436E3,30511,19,20,1,109.51069,18.24208,1558
141092,7890099D98AA300C5BF12527E7372DB0,31071,12,13,1,109.58257,18.28458,1815
141093,7890099D98AA300C5BF12527E7372DB0,30854,15,17,2,109.56889,18.27076,1763
141094,7890099D98AA300C5BF12527E7372DB0,60631,21,23,2,109.57778,18.27583,1814
141095,7B9A787C6833CBFA52C05ADBB8F5D371,31031,0,7,7,109.49979,18.25382,1510
141096,7B9A787C6833CBFA52C05ADBB8F5D371,31471,9,10,1,109.34583,18.29563,917
141097,7B9A787C6833CBFA52C05ADBB8F5D371,31031,14,16,2,109.49979,18.25382,1510
141112,7171DFF8DAFC6575B222E1F303C150CC,38721,17,19,2,109.50368,18.27542,1514
141113,7171DFF8DAFC6575B222E1F303C150CC,39101,20,22,2,109.50132,18.24931,1509
141123,AECCCA10F076AF0904633347B64B94DB,31521,17,18,1,109.51458,18.22542,1555
141124,AECCCA10F076AF0904633347B64B94DB,30361,19,21,2,109.50347,18.24,1508
141157,C1DFDFC110B50DFE0D66E47848759FB2,30861,11,17,6,109.52722,18.22743,1606
141158,C1DFDFC110B50DFE0D66E47848759FB2,39183,17,18,1,109.55542,18.28208,1715
141195,BBE4D8242EE46AE73AD69A56A00F4408,30201,0,7,7,109.4909,18.26465,1462
141196,BBE4D8242EE46AE73AD69A56A00F4408,31271,9,11,2,109.48958,18.26257,1462
141197,BBE4D8242EE46AE73AD69A56A00F4408,30681,11,12,1,109.48493,18.26917,1463
141198,BBE4D8242EE46AE73AD69A56A00F4408,31021,13,15,2,109.49021,18.27,1463
141199,BBE4D8242EE46AE73AD69A56A00F4408,30201,19,23,4,109.4909,18.26465,1462
141207,40285EE8CCE25C38988EC087545664EC,31071,1,6,5,109.58257,18.28458,1815
141208,40285EE8CCE25C38988EC087545664EC,30854,10,17,7,109.56889,18.27076,1763
141281,528DF0E8B4B73FA0C9FB75037E21B5BA,31931,14,15,1,109.54771,18.29403,1667
141282,528DF0E8B4B73FA0C9FB75037E21B5BA,60241,17,18,1,109.53319,18.28667,1616
141283,528DF0E8B4B73FA0C9FB75037E21B5BA,31931,20,23,3,109.54771,18.29403,1667
141304,C8922FAF66F21ECAECB6B717FCD5A53B,60614,0,7,7,109.48799,18.29521,1467
141305,C8922FAF66F21ECAECB6B717FCD5A53B,60391,9,11,2,109.47667,18.28757,1416
141306,C8922FAF66F21ECAECB6B717FCD5A53B,60614,12,23,11,109.48799,18.29521,1467
141307,7D1ED6067ECBD941EFC43CE0A6ADAE71,30854,1,16,15,109.56889,18.27076,1763
141308,7D1ED6067ECBD941EFC43CE0A6ADAE71,60381,18,19,1,109.5241,18.22458,1605
141309,7D1ED6067ECBD941EFC43CE0A6ADAE71,30854,20,22,2,109.56889,18.27076,1763
141310,3A06664B5E8646E5D468635B6C6056D9,60641,0,7,7,109.53854,18.2359,1657
141311,3A06664B5E8646E5D468635B6C6056D9,31041,9,11,2,109.50278,18.23701,1507
141312,3A06664B5E8646E5D468635B6C6056D9,60641,13,14,1,109.53854,18.2359,1657
141322,9E8746086915F9D4A063A74CF0B5B7AB,31561,1,2,1,109.56792,18.28479,1765
141323,9E8746086915F9D4A063A74CF0B5B7AB,30851,3,5,2,109.5616,18.27396,1713
141324,9E8746086915F9D4A063A74CF0B5B7AB,31561,6,20,14,109.56792,18.28479,1765
141328,219D03D2345568C24C18853ACF5CAE7D,31781,12,14,2,109.19847,18.2975,367
141329,219D03D2345568C24C18853ACF5CAE7D,31201,17,18,1,109.51042,18.23819,1558
141364,2825FD87EFD45342A281A57765BF5EE8,38541,0,9,9,109.73715,18.34875,2426
141365,2825FD87EFD45342A281A57765BF5EE8,31061,13,14,1,109.53333,18.23257,1607
141366,2825FD87EFD45342A281A57765BF5EE8,38541,15,23,8,109.73715,18.34875,2426
141384,04ABA8BFD5D63DDF1B83BA0577C9019C,31421,4,5,1,109.55382,18.22347,1705
141385,04ABA8BFD5D63DDF1B83BA0577C9019C,39183,7,8,1,109.55542,18.28208,1715
141386,04ABA8BFD5D63DDF1B83BA0577C9019C,30854,8,22,14,109.56889,18.27076,1763
141411,B7C4E049ABEA8BC374DE2818E1AEEA50,31941,9,11,2,109.62451,18.31222,1970
141412,B7C4E049ABEA8BC374DE2818E1AEEA50,30084,13,15,2,109.50118,18.26972,1513
141413,B7C4E049ABEA8BC374DE2818E1AEEA50,30711,16,18,2,109.50271,18.25347,1510
141419,55D663E94101F000896F2C3F897BA6C9,30561,0,1,1,109.52778,18.31938,1621
141420,55D663E94101F000896F2C3F897BA6C9,30031,3,12,9,109.53681,18.33313,1673
141421,55D663E94101F000896F2C3F897BA6C9,31145,15,16,1,109.20431,18.30479,369
141422,55D663E94101F000896F2C3F897BA6C9,60381,18,22,4,109.5241,18.22458,1605
141461,8C37E67F8CE10233D1BCF73CC89419C9,60371,0,2,2,109.53063,18.30056,1618
141462,8C37E67F8CE10233D1BCF73CC89419C9,60361,2,4,2,109.51938,18.29681,1567
141463,8C37E67F8CE10233D1BCF73CC89419C9,60371,4,5,1,109.53063,18.30056,1618
141478,E9E473F09C342630187345312F4A31D8,39181,0,8,8,109.55153,18.28035,1715
141479,E9E473F09C342630187345312F4A31D8,39181,10,15,5,109.55153,18.28035,1715
141480,E9E473F09C342630187345312F4A31D8,39181,16,18,2,109.55153,18.28035,1715
141521,E75CF54BA14775FEDD26504F9F6B7365,31945,0,6,6,109.58021,18.29403,1817
141522,E75CF54BA14775FEDD26504F9F6B7365,31561,6,17,11,109.56792,18.28479,1765
141531,96C474E5BFF92BC21432A4ADDD7A543D,30854,0,17,17,109.56889,18.27076,1763
141532,96C474E5BFF92BC21432A4ADDD7A543D,31761,21,22,1,109.60521,18.27965,1914
141533,00FC332040A284DA251A8D0705989FE9,31071,0,7,7,109.58257,18.28458,1815
141534,00FC332040A284DA251A8D0705989FE9,30854,9,10,1,109.56889,18.27076,1763
141535,00FC332040A284DA251A8D0705989FE9,31071,12,13,1,109.58257,18.28458,1815
141536,00FC332040A284DA251A8D0705989FE9,30854,15,20,5,109.56889,18.27076,1763
141613,2AE38FAF341950B0B91404FFCE5A0F3E,39183,0,1,1,109.55542,18.28208,1715
141614,2AE38FAF341950B0B91404FFCE5A0F3E,31931,3,4,1,109.54771,18.29403,1667
141615,2AE38FAF341950B0B91404FFCE5A0F3E,30921,7,18,11,109.53903,18.29451,1667
141616,2AE38FAF341950B0B91404FFCE5A0F3E,31931,21,23,2,109.54771,18.29403,1667
141631,39F25FE146A03325C93C111F2A943B6C,31945,0,14,14,109.58021,18.29403,1817
141632,39F25FE146A03325C93C111F2A943B6C,31071,14,16,2,109.58257,18.28458,1815
141633,39F25FE146A03325C93C111F2A943B6C,30854,19,21,2,109.56889,18.27076,1763
141634,58418A9EA4A7DC03127CB79C039A5185,31071,0,9,9,109.58257,18.28458,1815
141635,58418A9EA4A7DC03127CB79C039A5185,39371,10,13,3,109.56627,18.2646,1762
141636,58418A9EA4A7DC03127CB79C039A5185,30151,18,19,1,109.50986,18.25083,1560
141714,1E36640BE395A4EE8CCB2697222419A5,31071,0,2,2,109.58257,18.28458,1815
141715,1E36640BE395A4EE8CCB2697222419A5,60631,3,17,14,109.57778,18.27583,1814
141716,A29628211427A99C58B8892C5311895B,60661,0,7,7,109.548,18.2377,1657
141717,A29628211427A99C58B8892C5311895B,31461,8,17,9,109.5091,18.25389,1510
141718,A29628211427A99C58B8892C5311895B,60661,19,23,4,109.548,18.2377,1657
141719,3430E8CEDCC22A1F95C5B7D0C18C0DE6,38911,3,7,4,109.51674,18.24965,1559
141720,3430E8CEDCC22A1F95C5B7D0C18C0DE6,30051,10,17,7,109.48917,18.21215,1453
141721,3430E8CEDCC22A1F95C5B7D0C18C0DE6,30084,19,21,2,109.50118,18.26972,1513
141722,3430E8CEDCC22A1F95C5B7D0C18C0DE6,31261,21,22,1,109.51174,18.2466,1559
141727,DFFF17B7FE30E79B8AABBB5CE171272F,31561,5,18,13,109.56792,18.28479,1765
141728,DFFF17B7FE30E79B8AABBB5CE171272F,39183,18,20,2,109.55542,18.28208,1715
141829,EC4B90EDBF35256FDB4D4F8B87DB8A04,31071,0,7,7,109.58257,18.28458,1815
141830,EC4B90EDBF35256FDB4D4F8B87DB8A04,30854,11,12,1,109.56889,18.27076,1763
141831,EC4B90EDBF35256FDB4D4F8B87DB8A04,31071,13,15,2,109.58257,18.28458,1815
141832,EC4B90EDBF35256FDB4D4F8B87DB8A04,30854,17,20,3,109.56889,18.27076,1763
141841,E0A24740E2C54F3B77DB561A91D2BED7,38911,1,4,3,109.51674,18.24965,1559
141842,E0A24740E2C54F3B77DB561A91D2BED7,30151,6,15,9,109.50986,18.25083,1560
141843,E0A24740E2C54F3B77DB561A91D2BED7,30151,15,23,8,109.50986,18.25083,1560
141859,63BCEBE172D1624AB431F458DD97DAC7,31864,0,8,8,109.49014,18.28333,1465
141860,63BCEBE172D1624AB431F458DD97DAC7,60054,11,12,1,109.3016,18.31229,770
141861,63BCEBE172D1624AB431F458DD97DAC7,31781,16,17,1,109.19847,18.2975,367
141897,0D69669D4DBC1CEB06269A084D86E853,60631,0,5,5,109.57778,18.27583,1814
141898,0D69669D4DBC1CEB06269A084D86E853,31571,7,16,9,109.61563,18.23326,1957
141899,0D69669D4DBC1CEB06269A084D86E853,60631,18,22,4,109.57778,18.27583,1814
141900,03DA52CB04D303C32B3FDE6BAFCAF395,31521,0,12,12,109.51458,18.22542,1555
141901,03DA52CB04D303C32B3FDE6BAFCAF395,30854,15,18,3,109.56889,18.27076,1763
141902,03DA52CB04D303C32B3FDE6BAFCAF395,31521,19,23,4,109.51458,18.22542,1555
141969,85F98999C51742A0E8D410E1B8BA2FC0,30761,0,6,6,109.45201,18.3,1318
141999,C53C007230CE5B7B1302C51A9FDED3D1,31521,0,4,4,109.51458,18.22542,1555
142000,C53C007230CE5B7B1302C51A9FDED3D1,39111,5,6,1,109.5191,18.22597,1555
142001,C53C007230CE5B7B1302C51A9FDED3D1,60552,8,9,1,109.41729,18.30014,1218
142002,C53C007230CE5B7B1302C51A9FDED3D1,30341,10,13,3,109.3625,18.29167,966
142003,C53C007230CE5B7B1302C51A9FDED3D1,30181,15,16,1,109.51597,18.23313,1557
142030,CCC0948C8F9216D11E617BCBE962EF82,30861,15,18,3,109.52722,18.22743,1606
142031,CCC0948C8F9216D11E617BCBE962EF82,60211,20,23,3,109.63549,18.26049,2011
142035,BA4F535914401174601F6D052DC24E0D,30731,0,2,2,109.50944,18.22306,1555
142036,BA4F535914401174601F6D052DC24E0D,38061,3,11,8,109.50597,18.23118,1506
142038,3272381C6A94F906EDCE0D12EAC755B5,38361,1,9,8,109.43667,18.29201,1267
142062,622234A65D292D040A9E438A2770674C,30851,0,7,7,109.5616,18.27396,1713
142063,622234A65D292D040A9E438A2770674C,31561,7,9,2,109.56792,18.28479,1765
142064,622234A65D292D040A9E438A2770674C,30851,12,23,11,109.5616,18.27396,1713
142072,03CEC0FDDD5484124514C6D24A63D4DD,31561,16,18,2,109.56792,18.28479,1765
142073,03CEC0FDDD5484124514C6D24A63D4DD,30854,21,22,1,109.56889,18.27076,1763
142077,87ACF3C6ADE430D2B9DFB3C954E0C031,39183,0,12,12,109.55542,18.28208,1715
142078,87ACF3C6ADE430D2B9DFB3C954E0C031,31071,12,15,3,109.58257,18.28458,1815
142079,87ACF3C6ADE430D2B9DFB3C954E0C031,30854,15,23,8,109.56889,18.27076,1763
142122,14BAF7EA9BDBA3487944890AC6AB30A3,38157,0,10,10,109.51483,18.26958,1563
142123,14BAF7EA9BDBA3487944890AC6AB30A3,38157,13,22,9,109.51483,18.26958,1563
142228,E218C587552A5DADC05C4E69685FE374,39183,0,7,7,109.55542,18.28208,1715
142229,E218C587552A5DADC05C4E69685FE374,30854,10,12,2,109.56889,18.27076,1763
142230,E218C587552A5DADC05C4E69685FE374,31841,13,16,3,109.73201,18.33382,2373
142231,E218C587552A5DADC05C4E69685FE374,39183,17,22,5,109.55542,18.28208,1715
142232,610DBC389A8D19B34D0871DB44596B0A,31861,0,11,11,109.49042,18.27549,1464
142233,610DBC389A8D19B34D0871DB44596B0A,60054,13,15,2,109.3016,18.31229,770
142234,610DBC389A8D19B34D0871DB44596B0A,31861,17,19,2,109.49042,18.27549,1464
142235,610DBC389A8D19B34D0871DB44596B0A,60463,21,23,2,109.52507,18.22438,1605
142261,269D3761ED337530C37A42787A175B92,31304,0,8,8,109.15903,18.32854,223
142262,269D3761ED337530C37A42787A175B92,30711,9,11,2,109.50271,18.25347,1510
142263,269D3761ED337530C37A42787A175B92,30711,11,15,4,109.50271,18.25347,1510
142264,269D3761ED337530C37A42787A175B92,31304,18,23,5,109.15903,18.32854,223
142289,1D8B814EC83D52D7C5F3FED99C129EE0,60631,3,5,2,109.57778,18.27583,1814
142290,1D8B814EC83D52D7C5F3FED99C129EE0,30854,7,10,3,109.56889,18.27076,1763
142291,1D8B814EC83D52D7C5F3FED99C129EE0,38271,12,20,8,109.62632,18.23049,1956
142313,43935A511269713B543CB39B6901EBBD,60463,0,1,1,109.52507,18.22438,1605
142314,43935A511269713B543CB39B6901EBBD,30711,1,12,11,109.50271,18.25347,1510
142315,43935A511269713B543CB39B6901EBBD,30361,12,16,4,109.50347,18.24,1508
142344,2225A928A5F41EC3C7691341B4D74A48,38297,12,13,1,109.52576,18.24965,1609
142345,2225A928A5F41EC3C7691341B4D74A48,60311,13,15,2,109.52097,18.24319,1558
142346,2225A928A5F41EC3C7691341B4D74A48,38297,18,19,1,109.52576,18.24965,1609
142383,8880BF3B03853247B5235ADF19775070,30511,1,7,6,109.51069,18.24208,1558
142384,8880BF3B03853247B5235ADF19775070,31261,7,10,3,109.51174,18.2466,1559
142385,8880BF3B03853247B5235ADF19775070,60381,11,14,3,109.5241,18.22458,1605
142386,8880BF3B03853247B5235ADF19775070,31521,14,15,1,109.51458,18.22542,1555
142387,8880BF3B03853247B5235ADF19775070,60381,15,23,8,109.5241,18.22458,1605
142465,93F22684CF6BFF2B98A28D1F2EA5D875,60291,0,2,2,109.50826,18.24639,1509
142466,93F22684CF6BFF2B98A28D1F2EA5D875,30711,4,5,1,109.50271,18.25347,1510
142467,93F22684CF6BFF2B98A28D1F2EA5D875,31781,10,12,2,109.19847,18.2975,367
142468,93F22684CF6BFF2B98A28D1F2EA5D875,30711,16,20,4,109.50271,18.25347,1510
142474,7C4B45B599684104AFE3AA992CD3924A,60211,0,9,9,109.63549,18.26049,2011
142475,7C4B45B599684104AFE3AA992CD3924A,30811,10,19,9,109.65188,18.26257,2062
142476,1B3E8931F1FF667205B6505EE53C6E2C,60631,0,8,8,109.57778,18.27583,1814
142477,1B3E8931F1FF667205B6505EE53C6E2C,30854,11,20,9,109.56889,18.27076,1763
142507,7B84211769976A29D6F3DD47508547C2,31781,8,12,4,109.19847,18.2975,367
142508,7B84211769976A29D6F3DD47508547C2,60054,14,15,1,109.3016,18.31229,770
142509,7B84211769976A29D6F3DD47508547C2,30361,18,23,5,109.50347,18.24,1508
142553,A041475A7C7BA79F49047DBAA4FC5EC4,30921,0,16,16,109.53903,18.29451,1667
142554,A041475A7C7BA79F49047DBAA4FC5EC4,31931,20,21,1,109.54771,18.29403,1667
142555,A041475A7C7BA79F49047DBAA4FC5EC4,30921,21,22,1,109.53903,18.29451,1667
142584,D626C213FA0AAEAFB4EA6E1A519D93E5,38111,0,1,1,109.52007,18.22403,1555
142585,D626C213FA0AAEAFB4EA6E1A519D93E5,39321,2,4,2,109.529,18.2167,1604
142586,D626C213FA0AAEAFB4EA6E1A519D93E5,31521,4,8,4,109.51458,18.22542,1555
142587,D626C213FA0AAEAFB4EA6E1A519D93E5,39321,8,9,1,109.529,18.2167,1604
142588,D626C213FA0AAEAFB4EA6E1A519D93E5,31521,11,12,1,109.51458,18.22542,1555
142589,D626C213FA0AAEAFB4EA6E1A519D93E5,60381,12,13,1,109.5241,18.22458,1605
142590,D626C213FA0AAEAFB4EA6E1A519D93E5,39321,14,15,1,109.529,18.2167,1604
142591,D626C213FA0AAEAFB4EA6E1A519D93E5,31521,15,17,2,109.51458,18.22542,1555
142609,452F0FF6BC36839041DCBEF2292D6E55,30151,13,15,2,109.50986,18.25083,1560
142610,452F0FF6BC36839041DCBEF2292D6E55,60661,20,21,1,109.548,18.2377,1657
142611,9DC42534658C1F6AF8E261B5948D5230,38903,3,7,4,109.39229,18.29243,1117
142612,9DC42534658C1F6AF8E261B5948D5230,38325,8,9,1,109.39792,18.2909,1116
142613,9DC42534658C1F6AF8E261B5948D5230,31801,11,13,2,109.20417,18.32118,371
142614,9DC42534658C1F6AF8E261B5948D5230,31471,13,14,1,109.34583,18.29563,917
142615,9DC42534658C1F6AF8E261B5948D5230,30361,16,22,6,109.50347,18.24,1508
142644,C462628FF36F8FF2D0B7493E6DDA38BB,30661,3,11,8,109.37028,18.24361,1008
142645,C462628FF36F8FF2D0B7493E6DDA38BB,60411,11,14,3,109.32514,18.30854,869
142646,C462628FF36F8FF2D0B7493E6DDA38BB,30661,15,21,6,109.37028,18.24361,1008
142682,C17A8098B013F904BD9DA05D90234A30,31071,11,13,2,109.58257,18.28458,1815
142683,C17A8098B013F904BD9DA05D90234A30,30711,14,15,1,109.50271,18.25347,1510
142694,FCFB14BA36BDB7CD6A39612B9AE933B2,38127,0,7,7,109.50833,18.27222,1513
142695,FCFB14BA36BDB7CD6A39612B9AE933B2,31931,10,11,1,109.54771,18.29403,1667
142696,FCFB14BA36BDB7CD6A39612B9AE933B2,39181,12,13,1,109.55153,18.28035,1715
142697,DE91F768E6CCDB78867FF54F078574C9,30854,2,10,8,109.56889,18.27076,1763
142698,DE91F768E6CCDB78867FF54F078574C9,30084,12,14,2,109.50118,18.26972,1513
142699,DE91F768E6CCDB78867FF54F078574C9,30854,14,20,6,109.56889,18.27076,1763
142787,C58D0182BFC61ED113EE3B09763C30B2,38157,0,16,16,109.51483,18.26958,1563
142788,C58D0182BFC61ED113EE3B09763C30B2,38185,19,23,4,109.51333,18.27347,1563
142826,9352766CE000C006A9C46226806783DB,31561,1,7,6,109.56792,18.28479,1765
142827,9352766CE000C006A9C46226806783DB,30031,9,16,7,109.53681,18.33313,1673
142828,9352766CE000C006A9C46226806783DB,31561,18,19,1,109.56792,18.28479,1765
142913,E872AA2C9381997C1534BFD4E63418EE,31461,0,6,6,109.5091,18.25389,1510
142914,E872AA2C9381997C1534BFD4E63418EE,30711,6,7,1,109.50271,18.25347,1510
142915,E872AA2C9381997C1534BFD4E63418EE,31081,8,9,1,109.44639,18.30181,1318
142916,E872AA2C9381997C1534BFD4E63418EE,38094,17,18,1,109.45403,18.28778,1316
142917,E872AA2C9381997C1534BFD4E63418EE,31461,20,23,3,109.5091,18.25389,1510
142955,2461E97B3A29F94DA6EAE9F74EF592A3,30211,17,20,3,109.49882,18.23931,1508
142956,2461E97B3A29F94DA6EAE9F74EF592A3,30211,21,23,2,109.49882,18.23931,1508
142964,E649CF84A26278291AA1A5B5C5D01FCA,30854,0,8,8,109.56889,18.27076,1763
142965,E649CF84A26278291AA1A5B5C5D01FCA,31561,9,10,1,109.56792,18.28479,1765
142966,E649CF84A26278291AA1A5B5C5D01FCA,38171,11,12,1,109.50799,18.28139,1515
142967,E649CF84A26278291AA1A5B5C5D01FCA,31071,18,20,2,109.58257,18.28458,1815
142968,E649CF84A26278291AA1A5B5C5D01FCA,30191,21,23,2,109.50361,18.22701,1506
142977,86B0297E36D6ADB85661F97C0262CD46,39151,0,7,7,109.49875,18.25097,1510
142978,86B0297E36D6ADB85661F97C0262CD46,38251,7,10,3,109.49618,18.25493,1510
142979,86B0297E36D6ADB85661F97C0262CD46,30361,14,15,1,109.50347,18.24,1508
143012,14F21534C21254001A38352AD4BB0EF6,30854,1,4,3,109.56889,18.27076,1763
143013,14F21534C21254001A38352AD4BB0EF6,31071,8,15,7,109.58257,18.28458,1815
143014,14F21534C21254001A38352AD4BB0EF6,30854,17,18,1,109.56889,18.27076,1763
143020,73AB39A458E40C81DB636B20F7F8FD9B,31251,0,1,1,109.18528,18.2975,317
143022,73AB39A458E40C81DB636B20F7F8FD9B,31251,11,16,5,109.18528,18.2975,317
143024,73AB39A458E40C81DB636B20F7F8FD9B,31251,19,22,3,109.18528,18.2975,317
143044,A05C5224EBD39E4769ABC987F547C22B,31611,0,7,7,109.63076,18.34944,2026
143045,A05C5224EBD39E4769ABC987F547C22B,30051,11,12,1,109.48917,18.21215,1453
143046,A05C5224EBD39E4769ABC987F547C22B,38185,13,14,1,109.51333,18.27347,1563
143047,A05C5224EBD39E4769ABC987F547C22B,30281,15,17,2,109.50597,18.27583,1514
143048,A05C5224EBD39E4769ABC987F547C22B,31611,18,23,5,109.63076,18.34944,2026
143059,6C0260646767B781577B5B8CE2471E51,30561,0,3,3,109.52778,18.31938,1621
143060,6C0260646767B781577B5B8CE2471E51,38484,3,23,20,109.53028,18.31528,1620
143071,52626520133C58C019E9712FB19D3224,30511,19,20,1,109.51069,18.24208,1558
143072,52626520133C58C019E9712FB19D3224,38171,22,23,1,109.50799,18.28139,1515
143133,63B5E489F3503F8EC6E40A38F9D2117C,31951,10,12,2,109.52174,18.30299,1568
143134,63B5E489F3503F8EC6E40A38F9D2117C,60171,13,17,4,109.51292,18.30694,1569
143135,63B5E489F3503F8EC6E40A38F9D2117C,31951,21,22,1,109.52174,18.30299,1568
143173,FAC035CAF00431CACD74AF53D18C4996,30111,0,5,5,109.47583,18.30542,1419
143174,FAC035CAF00431CACD74AF53D18C4996,30764,7,12,5,109.45806,18.29486,1367
143175,FAC035CAF00431CACD74AF53D18C4996,60011,12,13,1,109.48965,18.30222,1468
143176,FAC035CAF00431CACD74AF53D18C4996,30764,14,18,4,109.45806,18.29486,1367
143177,FAC035CAF00431CACD74AF53D18C4996,60011,22,23,1,109.48965,18.30222,1468
143256,BB6A9729DE557ADD6D3E7E09F28116DB,60281,13,15,2,109.51743,18.25924,1561
143257,BB6A9729DE557ADD6D3E7E09F28116DB,31031,15,18,3,109.49979,18.25382,1510
143258,BB6A9729DE557ADD6D3E7E09F28116DB,60081,20,21,1,109.51097,18.22639,1556
143294,4B6FFEFB36770528DA20871CE9291F99,31521,3,13,10,109.51458,18.22542,1555
143295,4B6FFEFB36770528DA20871CE9291F99,60381,13,14,1,109.5241,18.22458,1605
143296,4B6FFEFB36770528DA20871CE9291F99,31521,15,21,6,109.51458,18.22542,1555
143307,B2035C0684FF9CA861B7EB217CE5A160,31473,12,17,5,109.34792,18.29465,917
143308,B2035C0684FF9CA861B7EB217CE5A160,60552,18,19,1,109.41729,18.30014,1218
143309,B2035C0684FF9CA861B7EB217CE5A160,60041,20,21,1,109.39889,18.31944,1121
143314,9EF6440DA421994ED152A57FAE59B45B,31261,0,7,7,109.51174,18.2466,1559
143315,9EF6440DA421994ED152A57FAE59B45B,38911,12,17,5,109.51674,18.24965,1559
143316,9EF6440DA421994ED152A57FAE59B45B,31821,19,23,4,109.51181,18.24924,1559
143336,ABFA7703F593D5D792FA2E32D1AEB9E3,60351,0,9,9,109.58403,18.28958,1816
143337,ABFA7703F593D5D792FA2E32D1AEB9E3,31021,9,11,2,109.49021,18.27,1463
143338,ABFA7703F593D5D792FA2E32D1AEB9E3,30771,12,13,1,109.49938,18.26042,1511
143340,ABFA7703F593D5D792FA2E32D1AEB9E3,60351,20,23,3,109.58403,18.28958,1816
143349,FE95B3A32EFBC2838F293DF38F55FDD1,31561,16,18,2,109.56792,18.28479,1765
143350,FE95B3A32EFBC2838F293DF38F55FDD1,39183,18,23,5,109.55542,18.28208,1715
143369,FD9120CA3F85D3F015CEFB66B9BF2F3D,30721,0,15,15,109.51597,18.28257,1565
143370,FD9120CA3F85D3F015CEFB66B9BF2F3D,60301,17,19,2,109.60715,18.30993,1919
143371,FD9120CA3F85D3F015CEFB66B9BF2F3D,30721,21,23,2,109.51597,18.28257,1565
143392,53807C5DF0C6352AACADAB2463D03770,38127,1,3,2,109.50833,18.27222,1513
143393,53807C5DF0C6352AACADAB2463D03770,30251,3,6,3,109.50611,18.26653,1512
143394,53807C5DF0C6352AACADAB2463D03770,38127,6,15,9,109.50833,18.27222,1513
143395,53807C5DF0C6352AACADAB2463D03770,30191,18,21,3,109.50361,18.22701,1506
143431,E8BAAF476E8FE57075BAB1A8D4FF1780,30232,0,4,4,109.6191,18.31701,1971
143432,E8BAAF476E8FE57075BAB1A8D4FF1780,39371,8,22,14,109.56627,18.2646,1762
143449,30CE72A519D49881F23B8123486E3A02,60054,0,6,6,109.3016,18.31229,770
143450,30CE72A519D49881F23B8123486E3A02,31851,8,11,3,109.71736,18.29007,2316
143451,30CE72A519D49881F23B8123486E3A02,60411,12,15,3,109.32514,18.30854,869
143511,9A1D1AA5EE2CD156CC396C667ED8C5B9,31071,0,6,6,109.58257,18.28458,1815
143512,9A1D1AA5EE2CD156CC396C667ED8C5B9,30854,10,18,8,109.56889,18.27076,1763
143513,9A1D1AA5EE2CD156CC396C667ED8C5B9,31041,19,23,4,109.50278,18.23701,1507
143534,BAF784C90E903A1C0CEDF594F05C3F50,38171,0,13,13,109.50799,18.28139,1515
143535,BAF784C90E903A1C0CEDF594F05C3F50,60661,15,16,1,109.548,18.2377,1657
143536,BAF784C90E903A1C0CEDF594F05C3F50,30121,20,23,3,109.52861,18.27222,1613
143574,798BF3B08F72A16A6DEAAA235F1899BB,61011,0,8,8,109.60653,18.19076,1900
143576,798BF3B08F72A16A6DEAAA235F1899BB,61011,22,23,1,109.60653,18.19076,1900
143595,0D48FD835B207ED202CAB110B7436DC2,30151,18,20,2,109.50986,18.25083,1560
143596,0D48FD835B207ED202CAB110B7436DC2,30854,20,23,3,109.56889,18.27076,1763
143652,6A36867DD00EFE141723506DB0350D1F,38321,0,9,9,109.39854,18.29132,1116
143653,6A36867DD00EFE141723506DB0350D1F,60054,11,14,3,109.3016,18.31229,770
143654,6A36867DD00EFE141723506DB0350D1F,38251,16,18,2,109.49618,18.25493,1510
143655,6A36867DD00EFE141723506DB0350D1F,38321,19,23,4,109.39854,18.29132,1116
143696,A83BF34FB3DF79FCF76C955C7C1B2AAC,60381,0,1,1,109.5241,18.22458,1605
143697,A83BF34FB3DF79FCF76C955C7C1B2AAC,60661,2,15,13,109.548,18.2377,1657
143698,A83BF34FB3DF79FCF76C955C7C1B2AAC,31061,18,19,1,109.53333,18.23257,1607
143716,91F59FD84A5A011AF1877621EDB85B69,39183,0,8,8,109.55542,18.28208,1715
143717,91F59FD84A5A011AF1877621EDB85B69,30854,8,10,2,109.56889,18.27076,1763
143718,91F59FD84A5A011AF1877621EDB85B69,60341,11,13,2,109.70597,18.31778,2271
143749,7E2EA58FE60AC1C253C1CC188337CCC8,31521,21,23,2,109.51458,18.22542,1555
143771,FC9B7FD2465F862BBF1D529A5948B21C,60161,0,10,10,109.49174,18.26181,1461
143773,FC9B7FD2465F862BBF1D529A5948B21C,30201,18,23,5,109.4909,18.26465,1462
143774,9B979E9430BCD0DDB6C78BBE525EBD2D,60631,0,2,2,109.57778,18.27583,1814
143775,9B979E9430BCD0DDB6C78BBE525EBD2D,30854,2,3,1,109.56889,18.27076,1763
143776,9B979E9430BCD0DDB6C78BBE525EBD2D,60631,5,6,1,109.57778,18.27583,1814
143777,9B979E9430BCD0DDB6C78BBE525EBD2D,30854,8,18,10,109.56889,18.27076,1763
143778,9B979E9430BCD0DDB6C78BBE525EBD2D,39371,21,22,1,109.56627,18.2646,1762
143783,E4C7AB656E412C7E33554D18277C9478,60291,0,12,12,109.50826,18.24639,1509
143784,E4C7AB656E412C7E33554D18277C9478,31461,17,18,1,109.5091,18.25389,1510
143785,E4C7AB656E412C7E33554D18277C9478,30511,19,21,2,109.51069,18.24208,1558
143854,0E2E791F47920A60A5F7E41FFDC79CF5,31071,17,23,6,109.58257,18.28458,1815
143875,084391752080FAB778036174C9E3D4FE,31171,0,20,20,109.50938,18.24917,1559
143876,084391752080FAB778036174C9E3D4FE,30151,21,23,2,109.50986,18.25083,1560
143880,7F632B4875B2736225CD6D350CD25670,60631,9,10,1,109.57778,18.27583,1814
143881,7F632B4875B2736225CD6D350CD25670,31071,10,12,2,109.58257,18.28458,1815
143882,7F632B4875B2736225CD6D350CD25670,30854,15,21,6,109.56889,18.27076,1763
143889,4552AE0C0FB78BA3063EBA5C903C87F0,31421,0,7,7,109.55382,18.22347,1705
143890,4552AE0C0FB78BA3063EBA5C903C87F0,60171,11,12,1,109.51292,18.30694,1569
143891,4552AE0C0FB78BA3063EBA5C903C87F0,30361,13,14,1,109.50347,18.24,1508
143892,4552AE0C0FB78BA3063EBA5C903C87F0,31421,14,18,4,109.55382,18.22347,1705
143893,4552AE0C0FB78BA3063EBA5C903C87F0,60661,22,23,1,109.548,18.2377,1657
143925,DAEBC1B20700AEACAB1016AEE13DF8AE,60411,0,15,15,109.32514,18.30854,869
143926,DAEBC1B20700AEACAB1016AEE13DF8AE,30901,19,22,3,109.27597,18.3134,670
143935,45D6FEED987FF96C23D5532C0D645AC3,30291,2,4,2,109.50403,18.27028,1513
143936,45D6FEED987FF96C23D5532C0D645AC3,38127,6,23,17,109.50833,18.27222,1513
143978,59F29435D748531F416A4F1636997ECF,31071,0,5,5,109.58257,18.28458,1815
143979,59F29435D748531F416A4F1636997ECF,60631,7,8,1,109.57778,18.27583,1814
143980,59F29435D748531F416A4F1636997ECF,30854,9,23,14,109.56889,18.27076,1763
143981,80330CDF40FA4F7E847EE63DBBD75A32,31061,0,8,8,109.53333,18.23257,1607
143982,80330CDF40FA4F7E847EE63DBBD75A32,31521,9,17,8,109.51458,18.22542,1555
143983,80330CDF40FA4F7E847EE63DBBD75A32,30361,18,19,1,109.50347,18.24,1508
143984,80330CDF40FA4F7E847EE63DBBD75A32,31521,20,23,3,109.51458,18.22542,1555
143985,2D0506173E3FD672D1B56E46B7843F5D,60131,2,8,6,109.49819,18.24778,1509
143986,2D0506173E3FD672D1B56E46B7843F5D,30361,13,14,1,109.50347,18.24,1508
143987,2D0506173E3FD672D1B56E46B7843F5D,31231,15,18,3,109.42597,18.29292,1217
143988,2D0506173E3FD672D1B56E46B7843F5D,60552,18,20,2,109.41729,18.30014,1218
143999,68DBE0B52FD0AB95F1DD47068FD7847F,60311,0,14,14,109.52097,18.24319,1558
144000,68DBE0B52FD0AB95F1DD47068FD7847F,31521,14,16,2,109.51458,18.22542,1555
144001,68DBE0B52FD0AB95F1DD47068FD7847F,38291,17,19,2,109.51618,18.24313,1558
144002,68DBE0B52FD0AB95F1DD47068FD7847F,60311,21,22,1,109.52097,18.24319,1558
144008,A8ABE4987042D12DD458C81CFD9663F5,38127,0,5,5,109.50833,18.27222,1513
144009,A8ABE4987042D12DD458C81CFD9663F5,30951,9,11,2,109.56208,18.25667,1761
144010,A8ABE4987042D12DD458C81CFD9663F5,30771,12,14,2,109.49938,18.26042,1511
144011,A8ABE4987042D12DD458C81CFD9663F5,30771,17,23,6,109.49938,18.26042,1511
144017,860C13CBFA013D0236AC6B4CB1CB4DEE,31931,3,4,1,109.54771,18.29403,1667
144018,860C13CBFA013D0236AC6B4CB1CB4DEE,30324,6,8,2,109.50326,18.29257,1517
144019,860C13CBFA013D0236AC6B4CB1CB4DEE,31461,10,14,4,109.5091,18.25389,1510
144020,860C13CBFA013D0236AC6B4CB1CB4DEE,30721,17,18,1,109.51597,18.28257,1565
144037,BAC047B6079E6BEA7B1F8943C9D7A733,30854,0,12,12,109.56889,18.27076,1763
144038,BAC047B6079E6BEA7B1F8943C9D7A733,31071,16,22,6,109.58257,18.28458,1815
144061,E8DB631088E68D5FF25F35789654CC79,60344,0,2,2,109.68847,18.31931,2221
144062,E8DB631088E68D5FF25F35789654CC79,38171,4,7,3,109.50799,18.28139,1515
144063,E8DB631088E68D5FF25F35789654CC79,38336,9,10,1,109.61111,18.21806,1904
144064,E8DB631088E68D5FF25F35789654CC79,30931,11,13,2,109.55653,18.32722,1722
144065,E8DB631088E68D5FF25F35789654CC79,30711,14,15,1,109.50271,18.25347,1510
144087,21654650140FAEB6349280DE7F7F6D8E,30891,15,16,1,109.59431,18.28389,1865
144088,21654650140FAEB6349280DE7F7F6D8E,30854,17,18,1,109.56889,18.27076,1763
144089,21654650140FAEB6349280DE7F7F6D8E,30891,21,22,1,109.59431,18.28389,1865
144096,55CDDB1A84A2F40D42C80C17393C28FB,38951,16,19,3,109.48097,18.28868,1416
144097,55CDDB1A84A2F40D42C80C17393C28FB,38951,19,23,4,109.48097,18.28868,1416
144100,BD38467346E00D9FC913492A38FA335E,31071,0,14,14,109.58257,18.28458,1815
144101,BD38467346E00D9FC913492A38FA335E,30861,17,18,1,109.52722,18.22743,1606
144106,D5F511343821CDCEF81ED534E668B0E7,30051,11,12,1,109.48917,18.21215,1453
144107,D5F511343821CDCEF81ED534E668B0E7,30271,14,16,2,109.49132,18.23153,1456
144108,D5F511343821CDCEF81ED534E668B0E7,30051,16,22,6,109.48917,18.21215,1453
144112,DECB7B3FC95BFA8620EFD8D9DE328252,30854,1,5,4,109.56889,18.27076,1763
144113,DECB7B3FC95BFA8620EFD8D9DE328252,31945,7,8,1,109.58021,18.29403,1817
144114,DECB7B3FC95BFA8620EFD8D9DE328252,30854,12,13,1,109.56889,18.27076,1763
144150,066CC6CBB5ADF978A93AF5D0C3292806,60371,0,1,1,109.53063,18.30056,1618
144151,066CC6CBB5ADF978A93AF5D0C3292806,31931,4,23,19,109.54771,18.29403,1667
144230,46D10B971C10D2856504DC61068F66E7,60221,0,9,9,109.52569,18.29188,1616
144231,46D10B971C10D2856504DC61068F66E7,31091,13,15,2,109.41201,18.31222,1170
144288,7C68E1F4B8B2F3CBBD5427BF66BF9C2E,30581,11,12,1,109.62257,18.24951,1959
144289,7C68E1F4B8B2F3CBBD5427BF66BF9C2E,31571,15,17,2,109.61563,18.23326,1957
144290,7C68E1F4B8B2F3CBBD5427BF66BF9C2E,30891,19,20,1,109.59431,18.28389,1865
144295,FF4FFCE42CAA120B76F0E344A1E34B45,31471,13,15,2,109.34583,18.29563,917
144296,FF4FFCE42CAA120B76F0E344A1E34B45,31271,18,19,1,109.48958,18.26257,1462
144297,FF4FFCE42CAA120B76F0E344A1E34B45,60391,20,23,3,109.47667,18.28757,1416
144318,5403ECE41AD9921A5DEF63FF6DE6A9D1,30854,0,3,3,109.56889,18.27076,1763
144319,5403ECE41AD9921A5DEF63FF6DE6A9D1,31071,3,4,1,109.58257,18.28458,1815
144320,5403ECE41AD9921A5DEF63FF6DE6A9D1,30854,5,23,18,109.56889,18.27076,1763
144363,7171A8398911756415ECFCDCF96F249B,30851,0,7,7,109.5616,18.27396,1713
144364,7171A8398911756415ECFCDCF96F249B,30951,9,10,1,109.56208,18.25667,1761
144365,7171A8398911756415ECFCDCF96F249B,30851,10,15,5,109.5616,18.27396,1713
144375,BD5D5103B08534F20AF53FB58E9A43CA,60371,18,20,2,109.53063,18.30056,1618
144376,BD5D5103B08534F20AF53FB58E9A43CA,31931,21,23,2,109.54771,18.29403,1667
144377,246EF4D95FA494895EFB2D649512DAE7,60081,0,7,7,109.51097,18.22639,1556
144378,246EF4D95FA494895EFB2D649512DAE7,61011,8,16,8,109.60653,18.19076,1900
144380,246EF4D95FA494895EFB2D649512DAE7,31521,20,23,3,109.51458,18.22542,1555
144384,C97A61E87ADF22CB0CED7FFED3A35BC3,30851,14,16,2,109.5616,18.27396,1713
144385,C97A61E87ADF22CB0CED7FFED3A35BC3,30951,20,23,3,109.56208,18.25667,1761
144398,080247CC19405F981D4BEFE1A1E9D339,31931,0,3,3,109.54771,18.29403,1667
144399,080247CC19405F981D4BEFE1A1E9D339,39181,3,4,1,109.55153,18.28035,1715
144400,080247CC19405F981D4BEFE1A1E9D339,31931,5,7,2,109.54771,18.29403,1667
144401,080247CC19405F981D4BEFE1A1E9D339,39181,11,14,3,109.55153,18.28035,1715
144402,080247CC19405F981D4BEFE1A1E9D339,31931,19,22,3,109.54771,18.29403,1667
144412,372A5433078073EAD18922D679CE0A73,60411,1,2,1,109.32514,18.30854,869
144413,372A5433078073EAD18922D679CE0A73,60054,3,17,14,109.3016,18.31229,770
144414,372A5433078073EAD18922D679CE0A73,30661,19,20,1,109.37028,18.24361,1008
144415,372A5433078073EAD18922D679CE0A73,60411,21,22,1,109.32514,18.30854,869
144461,120AF04D254D2FF4D02F1F05C67DC087,60221,18,21,3,109.52569,18.29188,1616
144462,120AF04D254D2FF4D02F1F05C67DC087,38251,22,23,1,109.49618,18.25493,1510
144472,4316F4C2A6A1B3B05695481348115DEA,31421,0,2,2,109.55382,18.22347,1705
144473,4316F4C2A6A1B3B05695481348115DEA,60381,3,4,1,109.5241,18.22458,1605
144474,4316F4C2A6A1B3B05695481348115DEA,31145,9,11,2,109.20431,18.30479,369
144475,4316F4C2A6A1B3B05695481348115DEA,31781,11,12,1,109.19847,18.2975,367
144476,4316F4C2A6A1B3B05695481348115DEA,60281,19,21,2,109.51743,18.25924,1561
144477,4316F4C2A6A1B3B05695481348115DEA,31421,21,23,2,109.55382,18.22347,1705
144636,D4EE8E1A4C04A1FF0596E4221D0B8B42,31071,0,8,8,109.58257,18.28458,1815
144637,D4EE8E1A4C04A1FF0596E4221D0B8B42,30854,8,12,4,109.56889,18.27076,1763
144638,D4EE8E1A4C04A1FF0596E4221D0B8B42,31071,12,13,1,109.58257,18.28458,1815
144639,D4EE8E1A4C04A1FF0596E4221D0B8B42,30854,17,18,1,109.56889,18.27076,1763
144640,D4EE8E1A4C04A1FF0596E4221D0B8B42,31461,19,21,2,109.5091,18.25389,1510
144641,D4EE8E1A4C04A1FF0596E4221D0B8B42,31071,22,23,1,109.58257,18.28458,1815
144670,5A888DC7A3AA300CC584D9862C5384A1,30421,0,6,6,109.50021,18.25861,1511
144671,5A888DC7A3AA300CC584D9862C5384A1,39183,8,12,4,109.55542,18.28208,1715
144672,5A888DC7A3AA300CC584D9862C5384A1,39181,12,13,1,109.55153,18.28035,1715
144673,5A888DC7A3AA300CC584D9862C5384A1,39183,14,17,3,109.55542,18.28208,1715
144674,5A888DC7A3AA300CC584D9862C5384A1,30771,20,21,1,109.49938,18.26042,1511
144675,5A888DC7A3AA300CC584D9862C5384A1,30421,21,23,2,109.50021,18.25861,1511
144688,875F4B80762D0E664890361D764F907D,60081,0,7,7,109.51097,18.22639,1556
144689,875F4B80762D0E664890361D764F907D,30571,7,18,11,109.50243,18.21861,1504
144690,875F4B80762D0E664890361D764F907D,60081,19,23,4,109.51097,18.22639,1556
144695,45FC4D7B7AEB1BB8222449DDC064C06B,31945,0,16,16,109.58021,18.29403,1817
144696,45FC4D7B7AEB1BB8222449DDC064C06B,31031,19,20,1,109.49979,18.25382,1510
144697,45FC4D7B7AEB1BB8222449DDC064C06B,60291,20,22,2,109.50826,18.24639,1509
144735,8CF08DEE8EF83AC7333B837D79034776,38121,0,10,10,109.51361,18.27813,1564
144736,8CF08DEE8EF83AC7333B837D79034776,31531,12,20,8,109.49583,18.25972,1461
144794,5127AAE654D4D4E9D3B44D4B22E94180,31071,0,15,15,109.58257,18.28458,1815
144795,5127AAE654D4D4E9D3B44D4B22E94180,30854,16,17,1,109.56889,18.27076,1763
144801,9B389AE8E9B004176803CCEAFF69104A,60631,7,9,2,109.57778,18.27583,1814
144802,9B389AE8E9B004176803CCEAFF69104A,31071,9,13,4,109.58257,18.28458,1815
144803,9B389AE8E9B004176803CCEAFF69104A,60631,13,22,9,109.57778,18.27583,1814
144810,302C193EE9901423C2412C2BB087FCC7,30351,7,9,2,109.41701,18.29292,1217
144811,302C193EE9901423C2412C2BB087FCC7,30861,13,21,8,109.52722,18.22743,1606
144812,302C193EE9901423C2412C2BB087FCC7,31091,22,23,1,109.41201,18.31222,1170
144860,EDA7FD9B0EED945E31B5E28BA44B79A6,30084,0,8,8,109.50118,18.26972,1513
144861,EDA7FD9B0EED945E31B5E28BA44B79A6,30084,13,15,2,109.50118,18.26972,1513
144871,283E90F84EEBCE43BF6B6D42BDFBC3E7,39111,0,9,9,109.5191,18.22597,1555
144872,283E90F84EEBCE43BF6B6D42BDFBC3E7,31471,12,16,4,109.34583,18.29563,917
144873,283E90F84EEBCE43BF6B6D42BDFBC3E7,39111,20,23,3,109.5191,18.22597,1555
144900,887B4CB1328C20D61945E5BC833B406E,60371,0,2,2,109.53063,18.30056,1618
144901,887B4CB1328C20D61945E5BC833B406E,38991,2,3,1,109.52681,18.30368,1618
144902,887B4CB1328C20D61945E5BC833B406E,60371,5,8,3,109.53063,18.30056,1618
144903,887B4CB1328C20D61945E5BC833B406E,30031,9,10,1,109.53681,18.33313,1673
144911,7B35A311846C912B678B880E5F54AFB9,31231,0,5,5,109.42597,18.29292,1217
144912,7B35A311846C912B678B880E5F54AFB9,31231,6,12,6,109.42597,18.29292,1217
144913,7B35A311846C912B678B880E5F54AFB9,30854,14,18,4,109.56889,18.27076,1763
144914,7B35A311846C912B678B880E5F54AFB9,31071,19,22,3,109.58257,18.28458,1815
144921,0E47EABA6E2AA714B8511218BE042510,30854,0,10,10,109.56889,18.27076,1763
144936,8E244E94833DBF281BCBFE2F4A36E102,30581,1,6,5,109.62257,18.24951,1959
144937,8E244E94833DBF281BCBFE2F4A36E102,60641,10,15,5,109.53854,18.2359,1657
144938,8E244E94833DBF281BCBFE2F4A36E102,30151,19,20,1,109.50986,18.25083,1560
144972,4714721B3653AF0BFB4036AA672A88A7,31231,11,12,1,109.42597,18.29292,1217
144973,4714721B3653AF0BFB4036AA672A88A7,30854,14,19,5,109.56889,18.27076,1763
144974,4714721B3653AF0BFB4036AA672A88A7,31071,19,21,2,109.58257,18.28458,1815
144975,4714721B3653AF0BFB4036AA672A88A7,30854,22,23,1,109.56889,18.27076,1763
145013,1C67859AC074D33800F75471EB5E573E,31071,0,2,2,109.58257,18.28458,1815
145014,1C67859AC074D33800F75471EB5E573E,30854,2,4,2,109.56889,18.27076,1763
145015,1C67859AC074D33800F75471EB5E573E,31071,6,7,1,109.58257,18.28458,1815
145016,1C67859AC074D33800F75471EB5E573E,30854,10,11,1,109.56889,18.27076,1763
145017,1C67859AC074D33800F75471EB5E573E,31071,15,17,2,109.58257,18.28458,1815
145018,1C67859AC074D33800F75471EB5E573E,30854,17,20,3,109.56889,18.27076,1763
145047,DFA412D9BD2157FFEE8B040EC4F14C2E,30931,1,4,3,109.55653,18.32722,1722
145048,DFA412D9BD2157FFEE8B040EC4F14C2E,30701,6,15,9,109.59313,18.32007,1871
145049,DFA412D9BD2157FFEE8B040EC4F14C2E,31811,18,23,5,109.54201,18.31806,1671
145133,8621CFDF1B89A83351494618C53D033F,39181,1,2,1,109.55153,18.28035,1715
145134,8621CFDF1B89A83351494618C53D033F,31071,4,6,2,109.58257,18.28458,1815
145135,8621CFDF1B89A83351494618C53D033F,39181,6,12,6,109.55153,18.28035,1715
145136,8621CFDF1B89A83351494618C53D033F,39181,13,15,2,109.55153,18.28035,1715
145137,8621CFDF1B89A83351494618C53D033F,39181,15,22,7,109.55153,18.28035,1715
145144,D5F7EFA0DFDB55DFCF47173578729EA6,30581,1,2,1,109.62257,18.24951,1959
145145,D5F7EFA0DFDB55DFCF47173578729EA6,60214,2,9,7,109.63104,18.24493,2009
145146,D5F7EFA0DFDB55DFCF47173578729EA6,30581,10,11,1,109.62257,18.24951,1959
145150,CAA77ED111F233A95D550D9E8F270524,30351,18,20,2,109.41701,18.29292,1217
145151,CAA77ED111F233A95D550D9E8F270524,30351,21,23,2,109.41701,18.29292,1217
145194,F6A539AAED9AF63EFFEF4F07EA46DEF3,60621,0,6,6,109.48354,18.27451,1464
145195,F6A539AAED9AF63EFFEF4F07EA46DEF3,31781,9,15,6,109.19847,18.2975,367
145196,F6A539AAED9AF63EFFEF4F07EA46DEF3,60541,19,21,2,109.4084,18.29208,1167
145202,613C19D70986B2841FFE30ACA302B5BF,31781,10,12,2,109.19847,18.2975,367
145203,613C19D70986B2841FFE30ACA302B5BF,30241,13,14,1,109.26174,18.3275,622
145204,613C19D70986B2841FFE30ACA302B5BF,30764,16,21,5,109.45806,18.29486,1367
145205,22B987DE38F8C4435934FE5E6190C4A2,30441,9,10,1,109.64021,18.25424,2010
145206,22B987DE38F8C4435934FE5E6190C4A2,30581,12,14,2,109.62257,18.24951,1959
145207,22B987DE38F8C4435934FE5E6190C4A2,30441,14,17,3,109.64021,18.25424,2010
145213,BE7763F8096EB5A037146E1CC4190538,30854,0,2,2,109.56889,18.27076,1763
145214,BE7763F8096EB5A037146E1CC4190538,31561,4,5,1,109.56792,18.28479,1765
145215,BE7763F8096EB5A037146E1CC4190538,30324,8,14,6,109.50326,18.29257,1517
145304,4D190727D19452A2A511EC780EEEE090,31931,0,12,12,109.54771,18.29403,1667
145305,4D190727D19452A2A511EC780EEEE090,30921,12,14,2,109.53903,18.29451,1667
145306,4D190727D19452A2A511EC780EEEE090,31931,14,23,9,109.54771,18.29403,1667
145323,8B3125BACE32612AE7F9DC5599DC75E6,30661,13,18,5,109.37028,18.24361,1008
145324,8B3125BACE32612AE7F9DC5599DC75E6,30191,19,20,1,109.50361,18.22701,1506
145325,8B3125BACE32612AE7F9DC5599DC75E6,30731,20,23,3,109.50944,18.22306,1555
145406,EB316856896788EC8FD871E122E95728,30701,0,1,1,109.59313,18.32007,1871
145407,EB316856896788EC8FD871E122E95728,31811,2,10,8,109.54201,18.31806,1671
145408,EB316856896788EC8FD871E122E95728,30701,11,14,3,109.59313,18.32007,1871
145409,EB316856896788EC8FD871E122E95728,31811,14,15,1,109.54201,18.31806,1671
145410,EB316856896788EC8FD871E122E95728,30701,16,23,7,109.59313,18.32007,1871
145411,8F3DE08315D720DC64DC898C5903196E,30854,5,8,3,109.56889,18.27076,1763
145412,8F3DE08315D720DC64DC898C5903196E,31071,12,13,1,109.58257,18.28458,1815
145413,8F3DE08315D720DC64DC898C5903196E,30854,14,15,1,109.56889,18.27076,1763
145532,FA6D7510012E571D09E23E75BE9DD4E6,38094,0,3,3,109.45403,18.28778,1316
145533,FA6D7510012E571D09E23E75BE9DD4E6,30111,4,5,1,109.47583,18.30542,1419
145534,FA6D7510012E571D09E23E75BE9DD4E6,60441,5,6,1,109.46792,18.28604,1366
145535,FA6D7510012E571D09E23E75BE9DD4E6,31781,11,15,4,109.19847,18.2975,367
145536,FA6D7510012E571D09E23E75BE9DD4E6,31781,15,16,1,109.19847,18.2975,367
145569,9BB39A24BC97A0FBACA2CD185E234B22,31681,9,10,1,109.40396,18.29979,1168
145570,9BB39A24BC97A0FBACA2CD185E234B22,38105,14,18,4,109.40299,18.29229,1117
145571,9BB39A24BC97A0FBACA2CD185E234B22,38127,19,20,1,109.50833,18.27222,1513
145579,D5ED0B56415F07DD214B0DC3E9293672,30854,17,18,1,109.56889,18.27076,1763
145580,D5ED0B56415F07DD214B0DC3E9293672,39371,21,22,1,109.56627,18.2646,1762
145611,706B8E0F0F5D1C9FC2F8EBB2574EE89F,30711,0,4,4,109.50271,18.25347,1510
145612,706B8E0F0F5D1C9FC2F8EBB2574EE89F,31461,5,7,2,109.5091,18.25389,1510
145613,706B8E0F0F5D1C9FC2F8EBB2574EE89F,30711,7,13,6,109.50271,18.25347,1510
145614,706B8E0F0F5D1C9FC2F8EBB2574EE89F,60131,14,15,1,109.49819,18.24778,1509
145615,706B8E0F0F5D1C9FC2F8EBB2574EE89F,60201,18,20,2,109.5041,18.2509,1510
145620,C8A5539982743C3D86E28F8FF2DA3472,30951,0,10,10,109.56208,18.25667,1761
145621,C8A5539982743C3D86E28F8FF2DA3472,31421,12,13,1,109.55382,18.22347,1705
145622,C8A5539982743C3D86E28F8FF2DA3472,30951,14,22,8,109.56208,18.25667,1761
145731,5C8B80BEC63DDEFB9892A030CF73AEB3,31071,16,23,7,109.58257,18.28458,1815
145737,5264833F0013AE6B294396000613EF89,30361,15,16,1,109.50347,18.24,1508
145738,5264833F0013AE6B294396000613EF89,38881,19,22,3,109.51618,18.26431,1562
145794,50942B7AD3E1DC9B7C014E537BF17F88,31391,0,6,6,109.50382,18.24285,1508
145795,50942B7AD3E1DC9B7C014E537BF17F88,31521,8,9,1,109.51458,18.22542,1555
145796,50942B7AD3E1DC9B7C014E537BF17F88,33051,12,15,3,109.6475,18.46618,2096
145797,50942B7AD3E1DC9B7C014E537BF17F88,31521,18,22,4,109.51458,18.22542,1555
145824,8F0B95EE20D5923AECD1F781FE6A4D19,60054,12,23,11,109.3016,18.31229,770
145843,5EBEA276FCB4A19AC5C987F5C7CC8908,60504,0,9,9,109.47917,18.28903,1416
145844,5EBEA276FCB4A19AC5C987F5C7CC8908,38361,10,16,6,109.43667,18.29201,1267
145845,5EBEA276FCB4A19AC5C987F5C7CC8908,60504,17,18,1,109.47917,18.28903,1416
145846,5EBEA276FCB4A19AC5C987F5C7CC8908,60401,20,23,3,109.47444,18.27583,1414
145847,3B6FF1F8D896A0A62DC7E65967011999,31561,0,1,1,109.56792,18.28479,1765
145848,3B6FF1F8D896A0A62DC7E65967011999,39183,5,14,9,109.55542,18.28208,1715
145849,3B6FF1F8D896A0A62DC7E65967011999,31561,14,15,1,109.56792,18.28479,1765
145860,7B1A07C39637E996C01DF0A3D287D3C6,30854,15,18,3,109.56889,18.27076,1763
145861,7B1A07C39637E996C01DF0A3D287D3C6,31071,18,19,1,109.58257,18.28458,1815
145862,7B1A07C39637E996C01DF0A3D287D3C6,30854,19,22,3,109.56889,18.27076,1763
145869,DB4DF566D4757FF3BB488F82DE126248,31561,1,14,13,109.56792,18.28479,1765
145870,DB4DF566D4757FF3BB488F82DE126248,30851,15,18,3,109.5616,18.27396,1713
145871,DB4DF566D4757FF3BB488F82DE126248,31561,18,22,4,109.56792,18.28479,1765
145903,0312B43ACF9ED1D8304E325E851AEE29,31561,7,10,3,109.56792,18.28479,1765
145904,0312B43ACF9ED1D8304E325E851AEE29,30851,10,12,2,109.5616,18.27396,1713
145905,0312B43ACF9ED1D8304E325E851AEE29,31561,14,18,4,109.56792,18.28479,1765
145906,0312B43ACF9ED1D8304E325E851AEE29,30851,18,21,3,109.5616,18.27396,1713
145915,1FC5887E4053936D3ED4D738338DC172,30121,0,7,7,109.52861,18.27222,1613
145916,1FC5887E4053936D3ED4D738338DC172,30851,7,10,3,109.5616,18.27396,1713
145917,1FC5887E4053936D3ED4D738338DC172,30951,10,17,7,109.56208,18.25667,1761
145981,B6DAE56480B5807A4F8E22B536AE66D4,31761,0,3,3,109.60521,18.27965,1914
145982,B6DAE56480B5807A4F8E22B536AE66D4,31071,3,4,1,109.58257,18.28458,1815
145983,B6DAE56480B5807A4F8E22B536AE66D4,30854,8,12,4,109.56889,18.27076,1763
145984,B6DAE56480B5807A4F8E22B536AE66D4,31561,14,16,2,109.56792,18.28479,1765
145985,B6DAE56480B5807A4F8E22B536AE66D4,31071,17,20,3,109.58257,18.28458,1815
146071,4EEB87EFD2F33BBAF42BE530271C40CA,31161,15,16,1,109.70229,18.31361,2270
146073,4EEB87EFD2F33BBAF42BE530271C40CA,31161,20,23,3,109.70229,18.31361,2270
146093,18DB7A828EB46A46D7669F7F83E646D2,31071,16,18,2,109.58257,18.28458,1815
146094,18DB7A828EB46A46D7669F7F83E646D2,38071,19,20,1,109.40722,18.30938,1169
146167,F3CB7C11E7F651A3E5E683B713A65912,30531,0,8,8,109.53271,18.21472,1604
146168,F3CB7C11E7F651A3E5E683B713A65912,31781,12,13,1,109.19847,18.2975,367
146169,F3CB7C11E7F651A3E5E683B713A65912,60221,15,17,2,109.52569,18.29188,1616
146170,F3CB7C11E7F651A3E5E683B713A65912,30531,20,22,2,109.53271,18.21472,1604
146176,CA3896FB33E9BC68E91955EDFF5D709B,30854,14,16,2,109.56889,18.27076,1763
146177,CA3896FB33E9BC68E91955EDFF5D709B,31761,19,20,1,109.60521,18.27965,1914
146178,CA3896FB33E9BC68E91955EDFF5D709B,30854,21,22,1,109.56889,18.27076,1763
146183,64F4CDF664AA04E7B79DE93C57128CF6,31931,0,6,6,109.54771,18.29403,1667
146184,64F4CDF664AA04E7B79DE93C57128CF6,39181,8,10,2,109.55153,18.28035,1715
146185,64F4CDF664AA04E7B79DE93C57128CF6,39183,12,17,5,109.55542,18.28208,1715
146186,64F4CDF664AA04E7B79DE93C57128CF6,31931,19,20,1,109.54771,18.29403,1667
146193,45CCFCD3EBDF941E1C92B70ED06E8B5E,30854,0,14,14,109.56889,18.27076,1763
146194,45CCFCD3EBDF941E1C92B70ED06E8B5E,31561,16,18,2,109.56792,18.28479,1765
146195,45CCFCD3EBDF941E1C92B70ED06E8B5E,30854,20,21,1,109.56889,18.27076,1763
146231,6B806948BC9187A91D033B4096721B00,31561,4,7,3,109.56792,18.28479,1765
146232,6B806948BC9187A91D033B4096721B00,31071,9,19,10,109.58257,18.28458,1815
146233,6B806948BC9187A91D033B4096721B00,30854,20,22,2,109.56889,18.27076,1763
146234,6B806948BC9187A91D033B4096721B00,31561,22,23,1,109.56792,18.28479,1765
146238,DE5024DB59D5BF6AE5857A85EB7680EA,30281,19,20,1,109.50597,18.27583,1514
146239,DE5024DB59D5BF6AE5857A85EB7680EA,38185,20,22,2,109.51333,18.27347,1563
146369,E65658506C2BF9C993BA69EE6D38B3C6,31951,0,17,17,109.52174,18.30299,1568
146370,E65658506C2BF9C993BA69EE6D38B3C6,60361,18,19,1,109.51938,18.29681,1567
146371,E65658506C2BF9C993BA69EE6D38B3C6,31951,19,20,1,109.52174,18.30299,1568
146372,E65658506C2BF9C993BA69EE6D38B3C6,31561,21,22,1,109.56792,18.28479,1765
146375,25419DDF60017295279E872003D6F9C0,60501,17,23,6,109.48701,18.29021,1466
146396,E292D83051830D054E89D209EEABA4B9,30854,1,5,4,109.56889,18.27076,1763
146397,E292D83051830D054E89D209EEABA4B9,31561,9,21,12,109.56792,18.28479,1765
146408,886165CD4CCF3674607C202B8ADD28B5,31221,14,15,1,109.61333,18.26833,1913
146409,886165CD4CCF3674607C202B8ADD28B5,38052,16,18,2,109.62618,18.23042,1956
146428,6AF6E3AFD18EC04099B3351F858D9C1A,31031,14,16,2,109.49979,18.25382,1510
146429,6AF6E3AFD18EC04099B3351F858D9C1A,30421,17,18,1,109.50021,18.25861,1511
146430,6AF6E3AFD18EC04099B3351F858D9C1A,38251,18,20,2,109.49618,18.25493,1510
146493,EF0AF6DFF11E792E87881ED5E6F91398,38154,0,6,6,109.5266,18.28278,1615
146494,EF0AF6DFF11E792E87881ED5E6F91398,39183,7,8,1,109.55542,18.28208,1715
146497,C93386A9D86FE22A1FD4E5116045DD8D,39183,13,17,4,109.55542,18.28208,1715
146498,C93386A9D86FE22A1FD4E5116045DD8D,31561,22,23,1,109.56792,18.28479,1765
146526,2B8C748A18FA7D08D4335AD7C9DEF01B,31761,0,7,7,109.60521,18.27965,1914
146527,2B8C748A18FA7D08D4335AD7C9DEF01B,31551,11,14,3,109.55868,18.24222,1708
146528,2B8C748A18FA7D08D4335AD7C9DEF01B,31761,18,23,5,109.60521,18.27965,1914
146541,DED64374A4602648AE7C998119F6E01F,31421,0,6,6,109.55382,18.22347,1705
146542,DED64374A4602648AE7C998119F6E01F,38261,8,12,4,109.50361,18.28153,1515
146543,DED64374A4602648AE7C998119F6E01F,60171,13,14,1,109.51292,18.30694,1569
146544,DED64374A4602648AE7C998119F6E01F,38261,14,17,3,109.50361,18.28153,1515
146551,7DABBE2EA1D8427C873A3C78CE560DA5,30351,18,19,1,109.41701,18.29292,1217
146552,7DABBE2EA1D8427C873A3C78CE560DA5,38141,20,21,1,109.39479,18.2916,1116
146562,6587551DA47309E484D1302521C8D417,60631,1,14,13,109.57778,18.27583,1814
146563,6587551DA47309E484D1302521C8D417,30854,17,18,1,109.56889,18.27076,1763
146564,6587551DA47309E484D1302521C8D417,60631,20,21,1,109.57778,18.27583,1814
146570,01C3A40E8C2D18FB80BE4CD2C78B4B61,30711,0,8,8,109.50271,18.25347,1510
146616,EFDE35289FEC1E13D6F34EFEE66A8AD2,60631,0,15,15,109.57778,18.27583,1814
146617,EFDE35289FEC1E13D6F34EFEE66A8AD2,30854,18,20,2,109.56889,18.27076,1763
146618,EFDE35289FEC1E13D6F34EFEE66A8AD2,31071,21,22,1,109.58257,18.28458,1815
146705,0133DDFFB5CECBB261CEDEF10A82D50B,30854,0,6,6,109.56889,18.27076,1763
146706,0133DDFFB5CECBB261CEDEF10A82D50B,31561,10,11,1,109.56792,18.28479,1765
146715,B6AB556CC50BF965F5C24E069B82A8CD,60261,0,12,12,109.44326,18.3075,1319
146716,B6AB556CC50BF965F5C24E069B82A8CD,38315,12,13,1,109.48979,18.29764,1467
146752,28B366167501D3E270BF1F5EDB4474EC,31071,2,7,5,109.58257,18.28458,1815
146753,28B366167501D3E270BF1F5EDB4474EC,31561,8,18,10,109.56792,18.28479,1765
146754,28B366167501D3E270BF1F5EDB4474EC,31071,19,21,2,109.58257,18.28458,1815
146784,209169FA99384242F6A8B020D13CF1D1,60594,0,6,6,109.62694,18.22799,1956
146785,209169FA99384242F6A8B020D13CF1D1,38052,9,21,12,109.62618,18.23042,1956
146810,5D4E252AC551D7DB97A6F7C764F981F2,38721,14,15,1,109.50368,18.27542,1514
146811,5D4E252AC551D7DB97A6F7C764F981F2,30741,18,23,5,109.49833,18.28681,1516
146831,C709D01469E0800AF998DFAF42105CDC,30854,0,4,4,109.56889,18.27076,1763
146832,C709D01469E0800AF998DFAF42105CDC,31561,5,19,14,109.56792,18.28479,1765
146833,C709D01469E0800AF998DFAF42105CDC,30854,19,21,2,109.56889,18.27076,1763
146860,E9F915B7CAC1919ECC27AEE8F91CE820,31031,19,20,1,109.49979,18.25382,1510
146861,E9F915B7CAC1919ECC27AEE8F91CE820,60551,22,23,1,109.42722,18.30111,1218
146862,173CD7A2B7B334BC53A50A1D248FBCFE,30854,1,5,4,109.56889,18.27076,1763
146863,173CD7A2B7B334BC53A50A1D248FBCFE,31071,8,10,2,109.58257,18.28458,1815
146864,173CD7A2B7B334BC53A50A1D248FBCFE,30854,15,19,4,109.56889,18.27076,1763
146867,451E2BF48CD7B253EB0892324E679BCC,60281,6,10,4,109.51743,18.25924,1561
146868,451E2BF48CD7B253EB0892324E679BCC,38291,12,14,2,109.51618,18.24313,1558
146869,451E2BF48CD7B253EB0892324E679BCC,60281,15,17,2,109.51743,18.25924,1561
146870,451E2BF48CD7B253EB0892324E679BCC,38297,17,21,4,109.52576,18.24965,1609
146871,451E2BF48CD7B253EB0892324E679BCC,31461,21,22,1,109.5091,18.25389,1510
146898,32B282E0D9D6AD6484A59DFBF2B8EAC5,38105,0,11,11,109.40299,18.29229,1117
146899,32B282E0D9D6AD6484A59DFBF2B8EAC5,31521,12,14,2,109.51458,18.22542,1555
146900,32B282E0D9D6AD6484A59DFBF2B8EAC5,60541,15,17,2,109.4084,18.29208,1167
146934,8883DF5E66B5FC284A8EF97DE8EAAAB3,31571,16,17,1,109.61563,18.23326,1957
146935,8883DF5E66B5FC284A8EF97DE8EAAAB3,31071,20,22,2,109.58257,18.28458,1815
146957,0E00D7E0174B24239144B08D52B998E8,31931,0,9,9,109.54771,18.29403,1667
146958,0E00D7E0174B24239144B08D52B998E8,60371,10,11,1,109.53063,18.30056,1618
146959,0E00D7E0174B24239144B08D52B998E8,31931,12,17,5,109.54771,18.29403,1667
146981,0E5593A90D661690BE3DAAA17AD936E2,30281,12,15,3,109.50597,18.27583,1514
146982,0E5593A90D661690BE3DAAA17AD936E2,31271,19,21,2,109.48958,18.26257,1462
147006,529A14F498129B0238F7B12A9FC7F6F7,30761,15,16,1,109.45201,18.3,1318
147007,529A14F498129B0238F7B12A9FC7F6F7,60561,18,19,1,109.38229,18.29785,1067
147030,C8B662CAEBDC359FAD2D68CB046F51F0,30681,0,15,15,109.48493,18.26917,1463
147031,C8B662CAEBDC359FAD2D68CB046F51F0,60401,15,17,2,109.47444,18.27583,1414
147032,C8B662CAEBDC359FAD2D68CB046F51F0,30171,17,20,3,109.48458,18.27139,1463
147033,C8B662CAEBDC359FAD2D68CB046F51F0,30681,21,23,2,109.48493,18.26917,1463
147034,09DBC2D12A2F2AE7770BC11D858FDC44,60131,17,19,2,109.49819,18.24778,1509
147035,09DBC2D12A2F2AE7770BC11D858FDC44,38105,20,22,2,109.40299,18.29229,1117
147064,866460FA5062A635337B6369BB2AADDA,31571,11,17,6,109.61563,18.23326,1957
147065,866460FA5062A635337B6369BB2AADDA,30854,20,23,3,109.56889,18.27076,1763
147074,68CF2FB8FE76D27AF8CCF53FD9DC9FD2,31431,0,8,8,109.44639,18.29042,1316
147075,68CF2FB8FE76D27AF8CCF53FD9DC9FD2,38094,11,23,12,109.45403,18.28778,1316
147079,C2622C284BAD8F487DCD454B3FAF9432,60361,0,6,6,109.51938,18.29681,1567
147080,C2622C284BAD8F487DCD454B3FAF9432,30721,9,12,3,109.51597,18.28257,1565
147081,C2622C284BAD8F487DCD454B3FAF9432,31121,13,21,8,109.16292,18.37063,230
147089,905E2A0CDA32B9AB6A7856433550079B,31145,14,15,1,109.20431,18.30479,369
147090,905E2A0CDA32B9AB6A7856433550079B,31431,16,18,2,109.44639,18.29042,1316
147091,905E2A0CDA32B9AB6A7856433550079B,31351,21,23,2,109.4959,18.28417,1465
147117,283001ED673D8EDBEF7EEB00BDB31533,38017,0,2,2,109.49729,18.21424,1504
147118,283001ED673D8EDBEF7EEB00BDB31533,30571,2,4,2,109.50243,18.21861,1504
147119,283001ED673D8EDBEF7EEB00BDB31533,60201,7,9,2,109.5041,18.2509,1510
147136,5AF85D9ED958D0E5348613692DAC5B4D,30771,0,7,7,109.49938,18.26042,1511
147162,FD45DAD5A6F6BB711255CB29E453CFF1,30854,0,8,8,109.56889,18.27076,1763
147163,FD45DAD5A6F6BB711255CB29E453CFF1,31071,8,9,1,109.58257,18.28458,1815
147164,FD45DAD5A6F6BB711255CB29E453CFF1,39183,13,14,1,109.55542,18.28208,1715
147174,0E1B3CFC64EBB658DA96D0DCA834701E,61011,0,5,5,109.60653,18.19076,1900
147176,0E1B3CFC64EBB658DA96D0DCA834701E,61011,12,17,5,109.60653,18.19076,1900
147195,CB1C8502149DACE0B32B2F7416279EF2,31071,0,7,7,109.58257,18.28458,1815
147196,CB1C8502149DACE0B32B2F7416279EF2,30854,7,8,1,109.56889,18.27076,1763
147197,CB1C8502149DACE0B32B2F7416279EF2,31071,12,14,2,109.58257,18.28458,1815
147198,CB1C8502149DACE0B32B2F7416279EF2,30854,17,18,1,109.56889,18.27076,1763
147240,D39D64452E6BBEF7B3056CA239E1B86E,30851,0,1,1,109.5616,18.27396,1713
147241,D39D64452E6BBEF7B3056CA239E1B86E,30854,2,6,4,109.56889,18.27076,1763
147242,D39D64452E6BBEF7B3056CA239E1B86E,31561,6,8,2,109.56792,18.28479,1765
147243,D39D64452E6BBEF7B3056CA239E1B86E,30854,13,14,1,109.56889,18.27076,1763
147244,D39D64452E6BBEF7B3056CA239E1B86E,31561,14,16,2,109.56792,18.28479,1765
147245,D39D64452E6BBEF7B3056CA239E1B86E,30854,17,23,6,109.56889,18.27076,1763
147258,40C57F24FE0409ABB752B2031C349577,38951,0,8,8,109.48097,18.28868,1416
147259,40C57F24FE0409ABB752B2031C349577,39041,8,15,7,109.40021,18.29278,1117
147260,40C57F24FE0409ABB752B2031C349577,38951,19,23,4,109.48097,18.28868,1416
147267,9DAE997BEB986F0CF4B419431BF5F5C1,60201,13,16,3,109.5041,18.2509,1510
147268,9DAE997BEB986F0CF4B419431BF5F5C1,38111,18,20,2,109.52007,18.22403,1555
147269,9DAE997BEB986F0CF4B419431BF5F5C1,60201,20,22,2,109.5041,18.2509,1510
147335,1FE2866848043A2C10AD87212485FE15,31071,0,2,2,109.58257,18.28458,1815
147336,1FE2866848043A2C10AD87212485FE15,30854,6,13,7,109.56889,18.27076,1763
147337,1FE2866848043A2C10AD87212485FE15,31071,14,15,1,109.58257,18.28458,1815
147338,1FE2866848043A2C10AD87212485FE15,30854,18,20,2,109.56889,18.27076,1763
147357,1A1B5C664F8D6460240C73AB76187420,39091,18,19,1,109.50097,18.25222,1510
147358,1A1B5C664F8D6460240C73AB76187420,31071,22,23,1,109.58257,18.28458,1815
147426,0D61EA75C03A93303AE1706E6D1B22F4,30201,0,7,7,109.4909,18.26465,1462
147427,0D61EA75C03A93303AE1706E6D1B22F4,38153,8,10,2,109.51819,18.25736,1561
147428,0D61EA75C03A93303AE1706E6D1B22F4,31461,14,17,3,109.5091,18.25389,1510
147429,0D61EA75C03A93303AE1706E6D1B22F4,60361,18,19,1,109.51938,18.29681,1567
147430,0D61EA75C03A93303AE1706E6D1B22F4,30201,20,23,3,109.4909,18.26465,1462
147438,0695D4E7B3E726CA09D841B87798B560,30854,3,7,4,109.56889,18.27076,1763
147439,0695D4E7B3E726CA09D841B87798B560,31071,7,8,1,109.58257,18.28458,1815
147440,0695D4E7B3E726CA09D841B87798B560,30854,10,21,11,109.56889,18.27076,1763
147459,B712327B6033C61F37801CFD6DAC08AD,38484,4,5,1,109.53028,18.31528,1620
147460,B712327B6033C61F37801CFD6DAC08AD,38484,7,17,10,109.53028,18.31528,1620
147461,B712327B6033C61F37801CFD6DAC08AD,31951,18,19,1,109.52174,18.30299,1568
147462,B712327B6033C61F37801CFD6DAC08AD,38484,19,23,4,109.53028,18.31528,1620
147502,B81C37BC332023335C0BA8EE3FC6F3B6,60221,16,17,1,109.52569,18.29188,1616
147503,B81C37BC332023335C0BA8EE3FC6F3B6,38251,19,21,2,109.49618,18.25493,1510
147514,79AB721DDB2EAA1CD0308535004E6A67,31071,0,9,9,109.58257,18.28458,1815
147515,79AB721DDB2EAA1CD0308535004E6A67,30854,11,13,2,109.56889,18.27076,1763
147516,79AB721DDB2EAA1CD0308535004E6A67,31071,13,15,2,109.58257,18.28458,1815
147517,79AB721DDB2EAA1CD0308535004E6A67,30854,16,18,2,109.56889,18.27076,1763
147533,8EF00336DF81276A821E166696CFF524,30324,0,8,8,109.50326,18.29257,1517
147534,8EF00336DF81276A821E166696CFF524,38903,12,17,5,109.39229,18.29243,1117
147535,8EF00336DF81276A821E166696CFF524,38141,18,23,5,109.39479,18.2916,1116
147575,530F0AE3A2D48DD91CDC3A17D13BA70F,38707,0,14,14,109.73778,18.35368,2427
147576,530F0AE3A2D48DD91CDC3A17D13BA70F,38707,18,23,5,109.73778,18.35368,2427
147612,89362A3CA3AE6F5B75871F2110924F99,30851,0,7,7,109.5616,18.27396,1713
147613,89362A3CA3AE6F5B75871F2110924F99,30951,7,8,1,109.56208,18.25667,1761
147614,89362A3CA3AE6F5B75871F2110924F99,31551,8,10,2,109.55868,18.24222,1708
147615,89362A3CA3AE6F5B75871F2110924F99,30951,10,17,7,109.56208,18.25667,1761
147616,89362A3CA3AE6F5B75871F2110924F99,30851,21,23,2,109.5616,18.27396,1713
147639,7D632B68A96EBB9D6582527232D6634C,30911,0,8,8,109.50493,18.26181,1511
147640,7D632B68A96EBB9D6582527232D6634C,30151,10,16,6,109.50986,18.25083,1560
147641,7D632B68A96EBB9D6582527232D6634C,30721,18,20,2,109.51597,18.28257,1565
147642,7D632B68A96EBB9D6582527232D6634C,31461,22,23,1,109.5091,18.25389,1510
147686,32A9B525F749A542977BF021ED61F7D7,30151,0,2,2,109.50986,18.25083,1560
147687,32A9B525F749A542977BF021ED61F7D7,30151,5,6,1,109.50986,18.25083,1560
147688,32A9B525F749A542977BF021ED61F7D7,30371,7,10,3,109.51,18.24771,1559
147689,32A9B525F749A542977BF021ED61F7D7,30151,11,16,5,109.50986,18.25083,1560
147690,32A9B525F749A542977BF021ED61F7D7,30151,16,21,5,109.50986,18.25083,1560
147729,7FF3C6569A3990C03CAF6C52D3C8BC6C,31931,15,17,2,109.54771,18.29403,1667
147730,7FF3C6569A3990C03CAF6C52D3C8BC6C,60241,18,20,2,109.53319,18.28667,1616
147764,AA2A5396AD753E9245AC53C94BAEDECD,61011,1,4,3,109.60653,18.19076,1900
147766,AA2A5396AD753E9245AC53C94BAEDECD,61011,8,19,11,109.60653,18.19076,1900
147768,9B4D51D619C13878F9CB21B880DF4E45,30761,1,6,5,109.45201,18.3,1318
147769,9B4D51D619C13878F9CB21B880DF4E45,30111,6,11,5,109.47583,18.30542,1419
147770,9B4D51D619C13878F9CB21B880DF4E45,60054,13,15,2,109.3016,18.31229,770
147776,F47C4E1E39056C43B0AD32AC994AB7C0,31931,0,13,13,109.54771,18.29403,1667
147777,F47C4E1E39056C43B0AD32AC994AB7C0,60361,13,17,4,109.51938,18.29681,1567
147778,F47C4E1E39056C43B0AD32AC994AB7C0,31931,19,23,4,109.54771,18.29403,1667
147802,192815485DBBC485508837480A81E25C,31461,0,7,7,109.5091,18.25389,1510
147803,192815485DBBC485508837480A81E25C,30151,11,15,4,109.50986,18.25083,1560
147804,192815485DBBC485508837480A81E25C,30151,15,17,2,109.50986,18.25083,1560
147805,192815485DBBC485508837480A81E25C,60463,20,22,2,109.52507,18.22438,1605
147836,B8DD8B95F813909FEB8C25204CE776AE,31091,3,6,3,109.41201,18.31222,1170
147837,B8DD8B95F813909FEB8C25204CE776AE,31231,7,12,5,109.42597,18.29292,1217
147838,B8DD8B95F813909FEB8C25204CE776AE,30854,17,20,3,109.56889,18.27076,1763
147839,B8DD8B95F813909FEB8C25204CE776AE,31071,21,22,1,109.58257,18.28458,1815
147879,0F23B6E4E3B228AFE54C52B9B3D593D7,60551,1,5,4,109.42722,18.30111,1218
147880,0F23B6E4E3B228AFE54C52B9B3D593D7,60524,5,10,5,109.42951,18.28993,1216
147881,0F23B6E4E3B228AFE54C52B9B3D593D7,60551,14,17,3,109.42722,18.30111,1218
147882,0F23B6E4E3B228AFE54C52B9B3D593D7,60524,18,19,1,109.42951,18.28993,1216
147883,0F23B6E4E3B228AFE54C52B9B3D593D7,60551,21,23,2,109.42722,18.30111,1218
147925,A928E9F6C796FE1A60807BA003DE87BB,30854,5,7,2,109.56889,18.27076,1763
147926,A928E9F6C796FE1A60807BA003DE87BB,39183,8,9,1,109.55542,18.28208,1715
147927,A928E9F6C796FE1A60807BA003DE87BB,30854,13,21,8,109.56889,18.27076,1763
147973,E4D6271627F68F0A6924319AF3674CF6,30324,0,9,9,109.50326,18.29257,1517
147974,E4D6271627F68F0A6924319AF3674CF6,30921,10,12,2,109.53903,18.29451,1667
148012,8E03A6760BDEE4B1D6F55B7F42573793,38094,0,7,7,109.45403,18.28778,1316
148013,8E03A6760BDEE4B1D6F55B7F42573793,31781,11,12,1,109.19847,18.2975,367
148014,8E03A6760BDEE4B1D6F55B7F42573793,60054,14,15,1,109.3016,18.31229,770
148015,8E03A6760BDEE4B1D6F55B7F42573793,60221,16,18,2,109.52569,18.29188,1616
148016,8E03A6760BDEE4B1D6F55B7F42573793,38094,21,23,2,109.45403,18.28778,1316
148017,807332CEC38772FA8DF98C48FBD8DD1E,31561,6,15,9,109.56792,18.28479,1765
148018,807332CEC38772FA8DF98C48FBD8DD1E,39183,16,18,2,109.55542,18.28208,1715
148019,807332CEC38772FA8DF98C48FBD8DD1E,31561,18,20,2,109.56792,18.28479,1765
148020,807332CEC38772FA8DF98C48FBD8DD1E,30851,20,23,3,109.5616,18.27396,1713
148028,A549C024E6F63EDBD3DC866F10DB11CE,30234,0,6,6,109.60681,18.29979,1918
148029,A549C024E6F63EDBD3DC866F10DB11CE,30854,10,21,11,109.56889,18.27076,1763
148040,70A62761FE79F922D082380DA7747243,31561,0,6,6,109.56792,18.28479,1765
148041,70A62761FE79F922D082380DA7747243,30854,6,21,15,109.56889,18.27076,1763
148061,0F09C2BE6A190F4BF3D635D6A9F19FD3,31951,0,8,8,109.52174,18.30299,1568
148062,0F09C2BE6A190F4BF3D635D6A9F19FD3,31061,9,11,2,109.53333,18.23257,1607
148063,0F09C2BE6A190F4BF3D635D6A9F19FD3,30121,12,14,2,109.52861,18.27222,1613
148064,0F09C2BE6A190F4BF3D635D6A9F19FD3,60661,17,21,4,109.548,18.2377,1657
148065,0F09C2BE6A190F4BF3D635D6A9F19FD3,60371,21,22,1,109.53063,18.30056,1618
148079,8C2A72A3EA8DBE7544B4A433B2BC3FE0,38361,0,11,11,109.43667,18.29201,1267
148080,8C2A72A3EA8DBE7544B4A433B2BC3FE0,31321,14,16,2,109.63799,18.23201,2007
148081,8C2A72A3EA8DBE7544B4A433B2BC3FE0,31391,19,21,2,109.50382,18.24285,1508
148094,E4B522EF4348156010E5C578EC13D60F,30854,0,2,2,109.56889,18.27076,1763
148095,E4B522EF4348156010E5C578EC13D60F,30234,3,5,2,109.60681,18.29979,1918
148096,E4B522EF4348156010E5C578EC13D60F,30854,5,6,1,109.56889,18.27076,1763
148097,E4B522EF4348156010E5C578EC13D60F,30221,9,12,3,109.57833,18.20222,1802
148098,E4B522EF4348156010E5C578EC13D60F,30854,16,23,7,109.56889,18.27076,1763
148104,F25102D4BE48A66B8AE50787215C5331,31181,12,20,8,109.50382,18.24813,1509
148105,F25102D4BE48A66B8AE50787215C5331,60291,21,23,2,109.50826,18.24639,1509
148109,9AF351B3CC27394DFED45513F0E32162,60351,0,6,6,109.58403,18.28958,1816
148110,9AF351B3CC27394DFED45513F0E32162,31551,8,12,4,109.55868,18.24222,1708
148111,9AF351B3CC27394DFED45513F0E32162,30951,13,16,3,109.56208,18.25667,1761
148112,9AF351B3CC27394DFED45513F0E32162,31071,18,20,2,109.58257,18.28458,1815
148113,9AF351B3CC27394DFED45513F0E32162,60351,20,22,2,109.58403,18.28958,1816
148116,560794A44CA17A43FA34D0FA6C339747,30854,0,9,9,109.56889,18.27076,1763
148117,560794A44CA17A43FA34D0FA6C339747,39104,9,11,2,109.50104,18.2525,1510
148118,560794A44CA17A43FA34D0FA6C339747,30854,13,19,6,109.56889,18.27076,1763
148122,86435198F57620D5DAC23B4A4DA78009,31931,5,6,1,109.54771,18.29403,1667
148123,86435198F57620D5DAC23B4A4DA78009,39183,6,7,1,109.55542,18.28208,1715
148124,86435198F57620D5DAC23B4A4DA78009,31931,9,23,14,109.54771,18.29403,1667
148140,608A55C14BAB2A5B627ACC1F39B89FB6,31071,1,3,2,109.58257,18.28458,1815
148141,608A55C14BAB2A5B627ACC1F39B89FB6,30854,7,9,2,109.56889,18.27076,1763
148142,608A55C14BAB2A5B627ACC1F39B89FB6,31945,12,13,1,109.58021,18.29403,1817
148178,52820FDF38F5A08FADB7112AE77AAA8C,38023,0,10,10,109.37132,18.28993,1016
148179,52820FDF38F5A08FADB7112AE77AAA8C,60291,14,15,1,109.50826,18.24639,1509
148180,52820FDF38F5A08FADB7112AE77AAA8C,60201,16,22,6,109.5041,18.2509,1510
148205,410DD8A32244BC0C8E0A44B87218A19E,30854,0,10,10,109.56889,18.27076,1763
148206,410DD8A32244BC0C8E0A44B87218A19E,31071,11,12,1,109.58257,18.28458,1815
148207,410DD8A32244BC0C8E0A44B87218A19E,30854,13,23,10,109.56889,18.27076,1763
148244,10EBF762D28520B09848288F7052CFDE,30854,0,6,6,109.56889,18.27076,1763
148245,10EBF762D28520B09848288F7052CFDE,39101,8,16,8,109.50132,18.24931,1509
148246,10EBF762D28520B09848288F7052CFDE,31561,19,23,4,109.56792,18.28479,1765
148247,3E01B14B28C0FDBF8BB343D61C8AA7D8,60241,0,1,1,109.53319,18.28667,1616
148248,3E01B14B28C0FDBF8BB343D61C8AA7D8,31931,1,16,15,109.54771,18.29403,1667
148249,3E01B14B28C0FDBF8BB343D61C8AA7D8,60241,18,20,2,109.53319,18.28667,1616
148250,3E01B14B28C0FDBF8BB343D61C8AA7D8,60331,21,23,2,109.505,18.26507,1512
148279,E0686F37399D74676DEB0528C7B9FCF9,38903,0,7,7,109.39229,18.29243,1117
148280,E0686F37399D74676DEB0528C7B9FCF9,38325,8,11,3,109.39792,18.2909,1116
148281,E0686F37399D74676DEB0528C7B9FCF9,31781,12,14,2,109.19847,18.2975,367
148282,E0686F37399D74676DEB0528C7B9FCF9,38141,16,19,3,109.39479,18.2916,1116
148283,E0686F37399D74676DEB0528C7B9FCF9,30711,19,21,2,109.50271,18.25347,1510
148284,E0686F37399D74676DEB0528C7B9FCF9,38141,22,23,1,109.39479,18.2916,1116
148312,5E6F81A7DA23F57413C15AC7514275E5,31945,2,15,13,109.58021,18.29403,1817
148313,5E6F81A7DA23F57413C15AC7514275E5,31561,19,21,2,109.56792,18.28479,1765
148364,3066D3BA0EF6F55E10FAD924A6ADDDEF,30771,0,1,1,109.49938,18.26042,1511
148365,3066D3BA0EF6F55E10FAD924A6ADDDEF,30381,4,10,6,109.52521,18.24507,1609
148366,3066D3BA0EF6F55E10FAD924A6ADDDEF,30861,12,13,1,109.52722,18.22743,1606
148367,3066D3BA0EF6F55E10FAD924A6ADDDEF,31031,14,16,2,109.49979,18.25382,1510
148368,3066D3BA0EF6F55E10FAD924A6ADDDEF,30381,17,22,5,109.52521,18.24507,1609
148418,6DF7485545B790F22810B0EDD8F1B356,31945,12,13,1,109.58021,18.29403,1817
148419,6DF7485545B790F22810B0EDD8F1B356,30854,15,16,1,109.56889,18.27076,1763
148420,B621E9075674E792CCB217233825F9D1,30851,3,7,4,109.5616,18.27396,1713
148421,B621E9075674E792CCB217233825F9D1,31101,9,14,5,109.65389,18.23403,2057
148422,B621E9075674E792CCB217233825F9D1,30854,16,17,1,109.56889,18.27076,1763
148423,9837FB962D7F62E426A73EBD66CBBE03,30271,1,17,16,109.49132,18.23153,1456
148424,9837FB962D7F62E426A73EBD66CBBE03,60131,18,19,1,109.49819,18.24778,1509
148425,9837FB962D7F62E426A73EBD66CBBE03,30271,22,23,1,109.49132,18.23153,1456
148429,DF410547949833E8F7EB071905643771,38871,0,3,3,109.44681,18.28625,1316
148430,DF410547949833E8F7EB071905643771,31861,4,5,1,109.49042,18.27549,1464
148431,DF410547949833E8F7EB071905643771,31021,8,9,1,109.49021,18.27,1463
148432,DF410547949833E8F7EB071905643771,31861,10,11,1,109.49042,18.27549,1464
148433,DF410547949833E8F7EB071905643771,30361,12,13,1,109.50347,18.24,1508
148434,DF410547949833E8F7EB071905643771,31021,20,21,1,109.49021,18.27,1463
148435,DF410547949833E8F7EB071905643771,31861,21,23,2,109.49042,18.27549,1464
148490,15A2A8790389D1537721C21B141A7A31,61011,2,3,1,109.60653,18.19076,1900
148492,15A2A8790389D1537721C21B141A7A31,61011,5,10,5,109.60653,18.19076,1900
148494,15A2A8790389D1537721C21B141A7A31,61011,17,21,4,109.60653,18.19076,1900
148510,19E8353A2DD0F178EBFC3FFA3E623B24,31945,0,17,17,109.58021,18.29403,1817
148511,19E8353A2DD0F178EBFC3FFA3E623B24,30854,18,21,3,109.56889,18.27076,1763
148533,76F07B8DC17758A94772CF5ACE457FAC,30171,0,8,8,109.48458,18.27139,1463
148534,76F07B8DC17758A94772CF5ACE457FAC,31531,12,15,3,109.49583,18.25972,1461
148535,76F07B8DC17758A94772CF5ACE457FAC,60381,17,18,1,109.5241,18.22458,1605
148536,76F07B8DC17758A94772CF5ACE457FAC,31031,18,19,1,109.49979,18.25382,1510
148537,76F07B8DC17758A94772CF5ACE457FAC,31531,20,23,3,109.49583,18.25972,1461
148602,7421066246AAD1C230E7E2A7ADF06E9D,60631,0,7,7,109.57778,18.27583,1814
148603,7421066246AAD1C230E7E2A7ADF06E9D,30854,7,9,2,109.56889,18.27076,1763
148604,7421066246AAD1C230E7E2A7ADF06E9D,60631,12,13,1,109.57778,18.27583,1814
148605,7421066246AAD1C230E7E2A7ADF06E9D,30854,17,18,1,109.56889,18.27076,1763
148606,7421066246AAD1C230E7E2A7ADF06E9D,60631,21,23,2,109.57778,18.27583,1814
148632,A01B4012B619D942E7CC3AC9B78722B4,31561,0,6,6,109.56792,18.28479,1765
148633,A01B4012B619D942E7CC3AC9B78722B4,39183,9,10,1,109.55542,18.28208,1715
148634,A01B4012B619D942E7CC3AC9B78722B4,31561,11,23,12,109.56792,18.28479,1765
148638,E2A4A2ABBE2AAFDE32C6FA06BCCC268D,31071,11,14,3,109.58257,18.28458,1815
148639,E2A4A2ABBE2AAFDE32C6FA06BCCC268D,30581,15,17,2,109.62257,18.24951,1959
148640,E2A4A2ABBE2AAFDE32C6FA06BCCC268D,31261,19,21,2,109.51174,18.2466,1559
148660,417408FFDA93B177641D270D3A5C4B2D,30854,12,13,1,109.56889,18.27076,1763
148661,417408FFDA93B177641D270D3A5C4B2D,31071,15,16,1,109.58257,18.28458,1815
148662,417408FFDA93B177641D270D3A5C4B2D,30854,17,18,1,109.56889,18.27076,1763
148663,417408FFDA93B177641D270D3A5C4B2D,31071,19,23,4,109.58257,18.28458,1815
148696,770D2E9A8A9D56CFD9834A323B86C483,30854,12,13,1,109.56889,18.27076,1763
148697,770D2E9A8A9D56CFD9834A323B86C483,31071,13,14,1,109.58257,18.28458,1815
148698,770D2E9A8A9D56CFD9834A323B86C483,30854,14,17,3,109.56889,18.27076,1763
148699,770D2E9A8A9D56CFD9834A323B86C483,31071,18,19,1,109.58257,18.28458,1815
148713,C1788356D6298A19C2039F0E2F1C2CF1,30371,19,20,1,109.51,18.24771,1559
148714,C1788356D6298A19C2039F0E2F1C2CF1,60381,21,23,2,109.5241,18.22458,1605
148749,AD6CE74FEECB42F7806A62DA7A4CECCA,30854,0,2,2,109.56889,18.27076,1763
148750,AD6CE74FEECB42F7806A62DA7A4CECCA,30851,2,5,3,109.5616,18.27396,1713
148751,AD6CE74FEECB42F7806A62DA7A4CECCA,30854,6,9,3,109.56889,18.27076,1763
148805,EFFEF00C078D502D6D0D1D469ACBA466,38325,0,8,8,109.39792,18.2909,1116
148806,EFFEF00C078D502D6D0D1D469ACBA466,31471,9,11,2,109.34583,18.29563,917
148807,EFFEF00C078D502D6D0D1D469ACBA466,38325,12,15,3,109.39792,18.2909,1116
148827,DA5E6B13E9B86E6A18C6646FBB376A74,31251,6,9,3,109.18528,18.2975,317
148830,DA5E6B13E9B86E6A18C6646FBB376A74,31251,13,15,2,109.18528,18.2975,317
148856,DF49F834C08C7E8FA6D78272EE1FB651,60361,0,6,6,109.51938,18.29681,1567
148857,DF49F834C08C7E8FA6D78272EE1FB651,30951,8,17,9,109.56208,18.25667,1761
148858,DF49F834C08C7E8FA6D78272EE1FB651,60361,18,23,5,109.51938,18.29681,1567
148882,8DD23AA43C0F7967C45F7488D66F9159,30854,1,7,6,109.56889,18.27076,1763
148883,8DD23AA43C0F7967C45F7488D66F9159,31945,11,12,1,109.58021,18.29403,1817
148884,8DD23AA43C0F7967C45F7488D66F9159,30854,15,21,6,109.56889,18.27076,1763
148895,BD4652414D5C17466BA36FD4BD943A94,30721,1,5,4,109.51597,18.28257,1565
148896,BD4652414D5C17466BA36FD4BD943A94,39183,8,18,10,109.55542,18.28208,1715
148897,147470AD3D3B8724582C30D5F244A8B6,60421,0,12,12,109.46333,18.31743,1371
148898,147470AD3D3B8724582C30D5F244A8B6,30111,12,14,2,109.47583,18.30542,1419
148899,147470AD3D3B8724582C30D5F244A8B6,60421,16,17,1,109.46333,18.31743,1371
148900,147470AD3D3B8724582C30D5F244A8B6,30111,17,22,5,109.47583,18.30542,1419
148981,83930DA23863D53A36D25B51299F2054,61011,0,2,2,109.60653,18.19076,1900
148983,83930DA23863D53A36D25B51299F2054,61011,9,11,2,109.60653,18.19076,1900
149015,6D2D20F4D67580FE7309C23DCCA820C3,30951,16,17,1,109.56208,18.25667,1761
149016,6D2D20F4D67580FE7309C23DCCA820C3,31071,18,23,5,109.58257,18.28458,1815
149041,22EBBC51F7D1EF3A417D690DEC68B2D9,30171,3,10,7,109.48458,18.27139,1463
149044,C85D0B931BEF54F05B9ABBBB03212DB7,30854,0,3,3,109.56889,18.27076,1763
149045,C85D0B931BEF54F05B9ABBBB03212DB7,31421,4,8,4,109.55382,18.22347,1705
149046,C85D0B931BEF54F05B9ABBBB03212DB7,30854,13,20,7,109.56889,18.27076,1763
149074,0E1DB444F47235AEDAD0A0404A7B75B4,31561,0,1,1,109.56792,18.28479,1765
149075,0E1DB444F47235AEDAD0A0404A7B75B4,39183,1,6,5,109.55542,18.28208,1715
149076,0E1DB444F47235AEDAD0A0404A7B75B4,31561,11,12,1,109.56792,18.28479,1765
149077,0E1DB444F47235AEDAD0A0404A7B75B4,30251,15,16,1,109.50611,18.26653,1512
149078,0E1DB444F47235AEDAD0A0404A7B75B4,30251,17,23,6,109.50611,18.26653,1512
149144,D758DCB0CB2E5EA2CADCED24F521A533,30854,1,2,1,109.56889,18.27076,1763
149145,D758DCB0CB2E5EA2CADCED24F521A533,31945,2,5,3,109.58021,18.29403,1817
149146,D758DCB0CB2E5EA2CADCED24F521A533,30221,8,13,5,109.57833,18.20222,1802
149147,D758DCB0CB2E5EA2CADCED24F521A533,31945,20,21,1,109.58021,18.29403,1817
149148,D758DCB0CB2E5EA2CADCED24F521A533,31071,21,23,2,109.58257,18.28458,1815
149213,2A6BA0678DDF16AF08BAC9E3FA3C9391,31561,0,5,5,109.56792,18.28479,1765
149214,2A6BA0678DDF16AF08BAC9E3FA3C9391,30854,8,17,9,109.56889,18.27076,1763
149267,9E2C88D4E95B05198C1730806E1D4F8F,31071,0,4,4,109.58257,18.28458,1815
149268,9E2C88D4E95B05198C1730806E1D4F8F,39183,5,10,5,109.55542,18.28208,1715
149269,9E2C88D4E95B05198C1730806E1D4F8F,31071,11,12,1,109.58257,18.28458,1815
149270,9E2C88D4E95B05198C1730806E1D4F8F,39183,13,15,2,109.55542,18.28208,1715
149274,75817DB682187A07461734D66E1E6492,60631,0,4,4,109.57778,18.27583,1814
149275,75817DB682187A07461734D66E1E6492,30854,4,16,12,109.56889,18.27076,1763
149276,75817DB682187A07461734D66E1E6492,60631,19,23,4,109.57778,18.27583,1814
149350,21C679D1B9FF307EA1AC2A89744209FE,38291,0,8,8,109.51618,18.24313,1558
149351,21C679D1B9FF307EA1AC2A89744209FE,60281,8,12,4,109.51743,18.25924,1561
149352,21C679D1B9FF307EA1AC2A89744209FE,38291,13,23,10,109.51618,18.24313,1558
149356,ECCCA5770AD6AA7162B63EC395B55856,30951,13,17,4,109.56208,18.25667,1761
149357,ECCCA5770AD6AA7162B63EC395B55856,60631,19,23,4,109.57778,18.27583,1814
149358,A249BB92E18839D454C438B797D69714,38291,0,9,9,109.51618,18.24313,1558
149359,A249BB92E18839D454C438B797D69714,38017,12,18,6,109.49729,18.21424,1504
149394,34F3D64B41C252481F72E5CF931AC833,30851,16,19,3,109.5616,18.27396,1713
149395,34F3D64B41C252481F72E5CF931AC833,30854,20,22,2,109.56889,18.27076,1763
149410,3A352532FC7E82C19FB49B77C773900E,31864,14,18,4,109.49014,18.28333,1465
149411,3A352532FC7E82C19FB49B77C773900E,60281,20,22,2,109.51743,18.25924,1561
149416,95E09A72760B2799C2CC9BD7AF527107,31071,6,19,13,109.58257,18.28458,1815
149417,95E09A72760B2799C2CC9BD7AF527107,30854,20,22,2,109.56889,18.27076,1763
149418,95E09A72760B2799C2CC9BD7AF527107,31071,22,23,1,109.58257,18.28458,1815
149447,4DA47CA7E0DF1887A4FCFA8DEF75F8FC,31761,0,7,7,109.60521,18.27965,1914
149448,4DA47CA7E0DF1887A4FCFA8DEF75F8FC,30951,12,16,4,109.56208,18.25667,1761
149449,4DA47CA7E0DF1887A4FCFA8DEF75F8FC,31761,18,23,5,109.60521,18.27965,1914
149463,06FCF67485A2B44C8ABC96FDB92547C5,61011,2,17,15,109.60653,18.19076,1900
149467,5E97A4561E11AAC4FBC53FD068EAA52B,30854,0,8,8,109.56889,18.27076,1763
149468,5E97A4561E11AAC4FBC53FD068EAA52B,30531,8,18,10,109.53271,18.21472,1604
149469,5E97A4561E11AAC4FBC53FD068EAA52B,30854,20,22,2,109.56889,18.27076,1763
149503,E6541B4F346982101D887BAAF0315541,30854,0,2,2,109.56889,18.27076,1763
149504,E6541B4F346982101D887BAAF0315541,31931,3,5,2,109.54771,18.29403,1667
149505,E6541B4F346982101D887BAAF0315541,30854,5,23,18,109.56889,18.27076,1763
149515,9EB99F27F9127F01C16DB7BA7D10B6E0,30854,13,17,4,109.56889,18.27076,1763
149516,9EB99F27F9127F01C16DB7BA7D10B6E0,31071,18,20,2,109.58257,18.28458,1815
149517,9EB99F27F9127F01C16DB7BA7D10B6E0,31561,22,23,1,109.56792,18.28479,1765
149523,EF45C1C5A7F95D1E71D98768E1D22F90,31561,17,18,1,109.56792,18.28479,1765
149524,EF45C1C5A7F95D1E71D98768E1D22F90,30854,20,22,2,109.56889,18.27076,1763
149554,D9D6266510871BA9EBCA49EA785B4F2F,38331,0,11,11,109.62465,18.22736,1956
149555,D9D6266510871BA9EBCA49EA785B4F2F,31571,11,15,4,109.61563,18.23326,1957
149556,D9D6266510871BA9EBCA49EA785B4F2F,30361,19,20,1,109.50347,18.24,1508
149557,D9D6266510871BA9EBCA49EA785B4F2F,31571,21,23,2,109.61563,18.23326,1957
149570,B643AC77F8D8498A9694D45BA8B0F75F,31561,0,2,2,109.56792,18.28479,1765
149571,B643AC77F8D8498A9694D45BA8B0F75F,60631,5,16,11,109.57778,18.27583,1814
149572,B643AC77F8D8498A9694D45BA8B0F75F,31561,17,19,2,109.56792,18.28479,1765
149599,98EB1CF842CD30ED85E927AB3226642D,30854,13,15,2,109.56889,18.27076,1763
149600,98EB1CF842CD30ED85E927AB3226642D,31071,19,20,1,109.58257,18.28458,1815
149601,98EB1CF842CD30ED85E927AB3226642D,30891,21,22,1,109.59431,18.28389,1865
149668,E960A9C960574B6ECAA9E8161ED40783,30181,0,10,10,109.51597,18.23313,1557
149669,E960A9C960574B6ECAA9E8161ED40783,31521,10,11,1,109.51458,18.22542,1555
149670,E960A9C960574B6ECAA9E8161ED40783,38054,13,14,1,109.63479,18.23097,2006
149671,E960A9C960574B6ECAA9E8161ED40783,30181,16,18,2,109.51597,18.23313,1557
149672,E960A9C960574B6ECAA9E8161ED40783,31521,19,21,2,109.51458,18.22542,1555
149673,27BCEF3137923B84211F08830816C810,31561,15,16,1,109.56792,18.28479,1765
149674,27BCEF3137923B84211F08830816C810,30851,17,18,1,109.5616,18.27396,1713
149675,27BCEF3137923B84211F08830816C810,31561,21,22,1,109.56792,18.28479,1765
149708,5426296000364EE32711CD0E73D782C8,31071,4,5,1,109.58257,18.28458,1815
149709,5426296000364EE32711CD0E73D782C8,30854,7,8,1,109.56889,18.27076,1763
149710,5426296000364EE32711CD0E73D782C8,31561,10,15,5,109.56792,18.28479,1765
149754,4995463B780282C9C030A19D9F49AEAC,31071,2,5,3,109.58257,18.28458,1815
149755,4995463B780282C9C030A19D9F49AEAC,30854,8,14,6,109.56889,18.27076,1763
149780,283C1DB08EC53022FE9E85C662A0B611,38951,0,16,16,109.48097,18.28868,1416
149781,283C1DB08EC53022FE9E85C662A0B611,38951,17,18,1,109.48097,18.28868,1416
149782,283C1DB08EC53022FE9E85C662A0B611,38951,20,23,3,109.48097,18.28868,1416
149786,937F0B31443CC6355891AA9D2DB0C670,30854,14,19,5,109.56889,18.27076,1763
149787,937F0B31443CC6355891AA9D2DB0C670,31561,21,22,1,109.56792,18.28479,1765
149820,2506E93F1473AB5227728C7B0A12E7AF,38911,0,7,7,109.51674,18.24965,1559
149821,2506E93F1473AB5227728C7B0A12E7AF,31261,10,15,5,109.51174,18.2466,1559
149860,B87EA32D7A8C628CB2B89E95996DDE3E,31931,13,15,2,109.54771,18.29403,1667
149861,B95D5FCFC7327770C14B6F9FFDB772BC,30854,12,13,1,109.56889,18.27076,1763
149862,B95D5FCFC7327770C14B6F9FFDB772BC,31945,14,15,1,109.58021,18.29403,1817
149893,996C0D9500BF90CC0E7F5A04C49A464B,31931,9,17,8,109.54771,18.29403,1667
149894,996C0D9500BF90CC0E7F5A04C49A464B,39183,21,22,1,109.55542,18.28208,1715
149897,B340EDEF4A878E8DF5CBEC25E465EACE,30854,1,2,1,109.56889,18.27076,1763
149898,B340EDEF4A878E8DF5CBEC25E465EACE,31071,4,5,1,109.58257,18.28458,1815
149899,B340EDEF4A878E8DF5CBEC25E465EACE,30854,6,15,9,109.56889,18.27076,1763
149900,B340EDEF4A878E8DF5CBEC25E465EACE,60631,15,17,2,109.57778,18.27583,1814
149901,B340EDEF4A878E8DF5CBEC25E465EACE,30854,20,21,1,109.56889,18.27076,1763
149944,CD6FBEA58741CB482F98EE3EFC4C981F,38094,0,7,7,109.45403,18.28778,1316
149945,CD6FBEA58741CB482F98EE3EFC4C981F,30241,9,10,1,109.26174,18.3275,622
149946,CD6FBEA58741CB482F98EE3EFC4C981F,31781,12,13,1,109.19847,18.2975,367
149947,CD6FBEA58741CB482F98EE3EFC4C981F,60221,16,18,2,109.52569,18.29188,1616
149948,CD6FBEA58741CB482F98EE3EFC4C981F,38094,21,22,1,109.45403,18.28778,1316
149957,2EBBAC66DDB6248DEB5E1D635794A55A,61011,0,10,10,109.60653,18.19076,1900
149959,2EBBAC66DDB6248DEB5E1D635794A55A,61011,18,23,5,109.60653,18.19076,1900
150005,B32E0C141A5BC7BD81AEFEA867DBF2BA,39371,0,6,6,109.56627,18.2646,1762
150006,B32E0C141A5BC7BD81AEFEA867DBF2BA,30854,9,11,2,109.56889,18.27076,1763
150007,B32E0C141A5BC7BD81AEFEA867DBF2BA,31531,11,12,1,109.49583,18.25972,1461
150008,B32E0C141A5BC7BD81AEFEA867DBF2BA,30854,15,23,8,109.56889,18.27076,1763
150023,E064E516ED48D19AB171E43D87D419CE,30211,15,17,2,109.49882,18.23931,1508
150024,E064E516ED48D19AB171E43D87D419CE,60201,22,23,1,109.5041,18.2509,1510
150027,8C5A16299A6D294198C90C34C25C5949,30854,2,3,1,109.56889,18.27076,1763
150028,8C5A16299A6D294198C90C34C25C5949,39183,4,12,8,109.55542,18.28208,1715
150090,B43DB539B5964E15F0064080164C40C1,30854,2,6,4,109.56889,18.27076,1763
150091,B43DB539B5964E15F0064080164C40C1,60631,6,8,2,109.57778,18.27583,1814
150092,B43DB539B5964E15F0064080164C40C1,38085,8,9,1,109.6291,18.23625,2007
150093,B43DB539B5964E15F0064080164C40C1,38052,11,16,5,109.62618,18.23042,1956
150094,B43DB539B5964E15F0064080164C40C1,30854,17,19,2,109.56889,18.27076,1763
150104,B89747DA8FD8C271771A8056C80A48B6,60221,16,18,2,109.52569,18.29188,1616
150105,B89747DA8FD8C271771A8056C80A48B6,30711,19,20,1,109.50271,18.25347,1510
150106,B89747DA8FD8C271771A8056C80A48B6,30421,20,22,2,109.50021,18.25861,1511
150113,AFCE3351168C576BE2AA828A190DD579,31231,1,9,8,109.42597,18.29292,1217
150114,AFCE3351168C576BE2AA828A190DD579,30271,12,13,1,109.49132,18.23153,1456
150115,AFCE3351168C576BE2AA828A190DD579,38754,15,16,1,109.74667,18.37382,2430
150116,AFCE3351168C576BE2AA828A190DD579,31031,18,20,2,109.49979,18.25382,1510
150117,AFCE3351168C576BE2AA828A190DD579,30051,22,23,1,109.48917,18.21215,1453
150154,EB92ED6162DE5D09C3C6A535524882F3,31091,18,20,2,109.41201,18.31222,1170
150155,EB92ED6162DE5D09C3C6A535524882F3,31431,20,21,1,109.44639,18.29042,1316
150197,2D39AE6120F2674000C6DBB8A6E572A0,30854,17,18,1,109.56889,18.27076,1763
150198,2D39AE6120F2674000C6DBB8A6E572A0,31945,20,23,3,109.58021,18.29403,1817
150224,2D683B3AD358B28A27E068E80E3AA9C8,30854,0,4,4,109.56889,18.27076,1763
150225,2D683B3AD358B28A27E068E80E3AA9C8,31071,5,6,1,109.58257,18.28458,1815
150226,2D683B3AD358B28A27E068E80E3AA9C8,30854,6,17,11,109.56889,18.27076,1763
150227,2D683B3AD358B28A27E068E80E3AA9C8,31945,18,21,3,109.58021,18.29403,1817
150228,2D683B3AD358B28A27E068E80E3AA9C8,30854,21,23,2,109.56889,18.27076,1763
150238,C1F9914EF577AE2A8300B1A3945A50FF,31561,1,10,9,109.56792,18.28479,1765
150239,C1F9914EF577AE2A8300B1A3945A50FF,30851,12,18,6,109.5616,18.27396,1713
150263,369F61D9EC42E510E242E24266B2C23F,30921,0,11,11,109.53903,18.29451,1667
150264,369F61D9EC42E510E242E24266B2C23F,31931,11,13,2,109.54771,18.29403,1667
150265,369F61D9EC42E510E242E24266B2C23F,30921,13,14,1,109.53903,18.29451,1667
150266,369F61D9EC42E510E242E24266B2C23F,31931,14,21,7,109.54771,18.29403,1667
150365,DC0EB400EA24BEE9EB39D315B0E6AEF0,60041,0,6,6,109.39889,18.31944,1121
150366,DC0EB400EA24BEE9EB39D315B0E6AEF0,38871,10,12,2,109.44681,18.28625,1316
150367,DC0EB400EA24BEE9EB39D315B0E6AEF0,31431,13,20,7,109.44639,18.29042,1316
150383,58E91236A2413C70EF9B297260454A51,33051,11,15,4,109.6475,18.46618,2096
150384,58E91236A2413C70EF9B297260454A51,38105,17,19,2,109.40299,18.29229,1117
150385,58E91236A2413C70EF9B297260454A51,38251,20,21,1,109.49618,18.25493,1510
150389,7763FA5342AFBCA436FF4D695F9B9CB2,30711,1,7,6,109.50271,18.25347,1510
150390,7763FA5342AFBCA436FF4D695F9B9CB2,31781,12,15,3,109.19847,18.2975,367
150391,7763FA5342AFBCA436FF4D695F9B9CB2,30711,17,19,2,109.50271,18.25347,1510
150392,7763FA5342AFBCA436FF4D695F9B9CB2,30711,20,23,3,109.50271,18.25347,1510
150419,F605546ADA1ADB3E2AF3E74D19682812,60311,0,1,1,109.52097,18.24319,1558
150420,F605546ADA1ADB3E2AF3E74D19682812,60221,4,10,6,109.52569,18.29188,1616
150421,F605546ADA1ADB3E2AF3E74D19682812,30854,14,15,1,109.56889,18.27076,1763
150422,F605546ADA1ADB3E2AF3E74D19682812,31931,17,20,3,109.54771,18.29403,1667
150423,F605546ADA1ADB3E2AF3E74D19682812,60221,22,23,1,109.52569,18.29188,1616
150492,BE8220A49F1231C0A022F4AA2075503E,31945,0,6,6,109.58021,18.29403,1817
150493,BE8220A49F1231C0A022F4AA2075503E,30854,9,10,1,109.56889,18.27076,1763
150494,BE8220A49F1231C0A022F4AA2075503E,31945,11,13,2,109.58021,18.29403,1817
150495,BE8220A49F1231C0A022F4AA2075503E,30854,15,20,5,109.56889,18.27076,1763
150505,C3EF49B0098C6C3C4B26CC8869DE86AF,38271,13,17,4,109.62632,18.23049,1956
150506,C3EF49B0098C6C3C4B26CC8869DE86AF,30854,18,23,5,109.56889,18.27076,1763
150511,94C4D5691F7DFC1AB38806AFFAC1389E,30921,0,5,5,109.53903,18.29451,1667
150512,94C4D5691F7DFC1AB38806AFFAC1389E,39101,10,12,2,109.50132,18.24931,1509
150513,94C4D5691F7DFC1AB38806AFFAC1389E,31931,15,23,8,109.54771,18.29403,1667
150594,293757429670FEF848C950D685169FCC,31071,0,14,14,109.58257,18.28458,1815
150595,293757429670FEF848C950D685169FCC,30854,19,20,1,109.56889,18.27076,1763
150599,B616D64706FE00CB4CDA3E3D124853B8,31671,0,8,8,109.38965,18.29813,1068
150600,B616D64706FE00CB4CDA3E3D124853B8,38751,10,14,4,109.74903,18.37639,2481
150601,B616D64706FE00CB4CDA3E3D124853B8,31671,18,23,5,109.38965,18.29813,1068
150608,07F004282B66F8FFF4893B155B27BCEE,30351,18,19,1,109.41701,18.29292,1217
150609,07F004282B66F8FFF4893B155B27BCEE,60552,22,23,1,109.41729,18.30014,1218
150614,A68637AA89BD62624E677D9E66C32FAD,39101,0,5,5,109.50132,18.24931,1509
150615,A68637AA89BD62624E677D9E66C32FAD,30161,5,16,11,109.50042,18.24389,1508
150616,A68637AA89BD62624E677D9E66C32FAD,30361,17,22,5,109.50347,18.24,1508
150622,E70F59D4F47F86725E25CD6D6D80730B,60054,13,14,1,109.3016,18.31229,770
150623,E70F59D4F47F86725E25CD6D6D80730B,38251,16,21,5,109.49618,18.25493,1510
150624,E70F59D4F47F86725E25CD6D6D80730B,31181,22,23,1,109.50382,18.24813,1509
150666,37064F9BC763FD0F497B111F9661D621,39091,11,13,2,109.50097,18.25222,1510
150667,37064F9BC763FD0F497B111F9661D621,30711,15,19,4,109.50271,18.25347,1510
150668,37064F9BC763FD0F497B111F9661D621,39091,22,23,1,109.50097,18.25222,1510
150671,CFCFA94681CDD57855D6405C244168DD,30371,2,5,3,109.51,18.24771,1559
150672,CFCFA94681CDD57855D6405C244168DD,38891,5,12,7,109.51486,18.24118,1558
150673,CFCFA94681CDD57855D6405C244168DD,30371,13,16,3,109.51,18.24771,1559
150674,CFCFA94681CDD57855D6405C244168DD,38891,20,23,3,109.51486,18.24118,1558
150684,28BD8349014AF7ACA687EB9A336CEC23,60054,12,23,11,109.3016,18.31229,770
150690,A8CC84F6441C04DAF82A74609E587ED2,30561,1,5,4,109.52778,18.31938,1621
150691,A8CC84F6441C04DAF82A74609E587ED2,30561,10,12,2,109.52778,18.31938,1621
150692,A8CC84F6441C04DAF82A74609E587ED2,31931,14,15,1,109.54771,18.29403,1667
150723,B17D654C0C5F0BF2FDFE2DB8B9C0B83F,30421,4,16,12,109.50021,18.25861,1511
150724,B17D654C0C5F0BF2FDFE2DB8B9C0B83F,60381,18,19,1,109.5241,18.22458,1605
150725,B17D654C0C5F0BF2FDFE2DB8B9C0B83F,30711,21,23,2,109.50271,18.25347,1510
150777,41BFDF202AA15C7D0EC7487840A4D094,30851,3,4,1,109.5616,18.27396,1713
150778,41BFDF202AA15C7D0EC7487840A4D094,39183,5,6,1,109.55542,18.28208,1715
150779,41BFDF202AA15C7D0EC7487840A4D094,30854,6,7,1,109.56889,18.27076,1763
150788,FD33950BA7DBDA4F7AA88F8E119D9C66,38094,6,10,4,109.45403,18.28778,1316
150789,FD33950BA7DBDA4F7AA88F8E119D9C66,38094,14,17,3,109.45403,18.28778,1316
150790,FD33950BA7DBDA4F7AA88F8E119D9C66,60381,17,20,3,109.5241,18.22458,1605
150791,61845632D07FAD90D178155204748FBA,60631,0,1,1,109.57778,18.27583,1814
150792,61845632D07FAD90D178155204748FBA,30854,1,3,2,109.56889,18.27076,1763
150793,61845632D07FAD90D178155204748FBA,30851,6,15,9,109.5616,18.27396,1713
150794,61845632D07FAD90D178155204748FBA,30854,17,20,3,109.56889,18.27076,1763
150809,DF34F38BEE4872598B76E0C6734B5964,38157,0,13,13,109.51483,18.26958,1563
150810,DF34F38BEE4872598B76E0C6734B5964,31931,15,16,1,109.54771,18.29403,1667
150811,DF34F38BEE4872598B76E0C6734B5964,31821,18,19,1,109.51181,18.24924,1559
150812,DF34F38BEE4872598B76E0C6734B5964,31931,22,23,1,109.54771,18.29403,1667
150862,A65416E0023DB5B05C85EFD796D8188E,31521,2,10,8,109.51458,18.22542,1555
150863,A65416E0023DB5B05C85EFD796D8188E,31261,12,14,2,109.51174,18.2466,1559
150864,A65416E0023DB5B05C85EFD796D8188E,38291,14,17,3,109.51618,18.24313,1558
150865,A65416E0023DB5B05C85EFD796D8188E,31261,17,18,1,109.51174,18.2466,1559
150866,A65416E0023DB5B05C85EFD796D8188E,31261,19,21,2,109.51174,18.2466,1559
150913,47A18820FDA9856131F74091D44B6BCB,31071,0,6,6,109.58257,18.28458,1815
150914,47A18820FDA9856131F74091D44B6BCB,30851,8,9,1,109.5616,18.27396,1713
150915,47A18820FDA9856131F74091D44B6BCB,31561,10,12,2,109.56792,18.28479,1765
150957,A519BA026730D6143CD46B3D7E63697F,30511,10,12,2,109.51069,18.24208,1558
150958,A519BA026730D6143CD46B3D7E63697F,31181,13,14,1,109.50382,18.24813,1509
150959,A519BA026730D6143CD46B3D7E63697F,38911,15,16,1,109.51674,18.24965,1559
150983,74AD1AF2EA5153BD40BCF9A3F3F2C4E3,30854,11,19,8,109.56889,18.27076,1763
150984,74AD1AF2EA5153BD40BCF9A3F3F2C4E3,31071,19,20,1,109.58257,18.28458,1815
150985,74AD1AF2EA5153BD40BCF9A3F3F2C4E3,30854,21,23,2,109.56889,18.27076,1763
151011,A9FCE0049DB44FE004EAFBF5B783F4A5,31071,1,4,3,109.58257,18.28458,1815
151012,A9FCE0049DB44FE004EAFBF5B783F4A5,31945,4,6,2,109.58021,18.29403,1817
151013,A9FCE0049DB44FE004EAFBF5B783F4A5,30854,8,19,11,109.56889,18.27076,1763
151023,2D913891935203F66178BF4BFC3F9DA5,30461,0,14,14,109.5116,18.26313,1562
151024,2D913891935203F66178BF4BFC3F9DA5,30854,14,16,2,109.56889,18.27076,1763
151025,2D913891935203F66178BF4BFC3F9DA5,30461,17,23,6,109.5116,18.26313,1562
151060,9F78F38D6383CA869F6B266FFD637AAB,31471,13,15,2,109.34583,18.29563,917
151061,9F78F38D6383CA869F6B266FFD637AAB,38094,16,18,2,109.45403,18.28778,1316
151062,9F78F38D6383CA869F6B266FFD637AAB,60551,18,20,2,109.42722,18.30111,1218
151063,9F78F38D6383CA869F6B266FFD637AAB,31061,22,23,1,109.53333,18.23257,1607
151070,8E06EAC16B0EF776FA1BAAC5B9747325,30511,0,9,9,109.51069,18.24208,1558
151071,8E06EAC16B0EF776FA1BAAC5B9747325,60071,11,16,5,109.75674,18.31583,2470
151072,8E06EAC16B0EF776FA1BAAC5B9747325,30891,19,21,2,109.59431,18.28389,1865
151087,84DF4A7C208235D171EF56473BCCF210,31561,4,7,3,109.56792,18.28479,1765
151088,84DF4A7C208235D171EF56473BCCF210,60631,8,18,10,109.57778,18.27583,1814
151107,95009B06B81B68C6E9DA0D3D0B4DC185,31931,9,15,6,109.54771,18.29403,1667
151108,95009B06B81B68C6E9DA0D3D0B4DC185,30921,15,18,3,109.53903,18.29451,1667
151123,C3071072DB6684DC75BE160268E6323C,30854,1,18,17,109.56889,18.27076,1763
151124,C3071072DB6684DC75BE160268E6323C,31461,19,21,2,109.5091,18.25389,1510
151125,A94F66C88B84FF0658441320CD9F667C,30854,0,4,4,109.56889,18.27076,1763
151126,A94F66C88B84FF0658441320CD9F667C,31945,4,5,1,109.58021,18.29403,1817
151127,A94F66C88B84FF0658441320CD9F667C,31071,6,18,12,109.58257,18.28458,1815
151128,A94F66C88B84FF0658441320CD9F667C,30854,19,20,1,109.56889,18.27076,1763
151165,17E33F98086F9D71B1BE47BE6FC58756,30232,10,15,5,109.6191,18.31701,1971
151166,17E33F98086F9D71B1BE47BE6FC58756,31091,18,21,3,109.41201,18.31222,1170
151185,C316CE65034FB3C77BE459147CBF943A,60291,0,6,6,109.50826,18.24639,1509
151186,C316CE65034FB3C77BE459147CBF943A,30161,7,9,2,109.50042,18.24389,1508
151187,C316CE65034FB3C77BE459147CBF943A,30161,10,17,7,109.50042,18.24389,1508
151188,C316CE65034FB3C77BE459147CBF943A,60291,20,23,3,109.50826,18.24639,1509
151243,12F418F6C44355E3BA708D12ADBC4871,38336,9,10,1,109.61111,18.21806,1904
151264,6831AD010DA6E3DA47BF53D43652AAC5,30731,2,3,1,109.50944,18.22306,1555
151265,6831AD010DA6E3DA47BF53D43652AAC5,30191,3,4,1,109.50361,18.22701,1506
151266,6831AD010DA6E3DA47BF53D43652AAC5,30731,5,7,2,109.50944,18.22306,1555
151267,6831AD010DA6E3DA47BF53D43652AAC5,60054,11,12,1,109.3016,18.31229,770
151268,6831AD010DA6E3DA47BF53D43652AAC5,30191,19,21,2,109.50361,18.22701,1506
151269,6831AD010DA6E3DA47BF53D43652AAC5,30731,21,22,1,109.50944,18.22306,1555
151273,90316F668419B151242AF04D86EAF2CC,31761,0,2,2,109.60521,18.27965,1914
151274,90316F668419B151242AF04D86EAF2CC,31071,4,21,17,109.58257,18.28458,1815
151275,90316F668419B151242AF04D86EAF2CC,30854,22,23,1,109.56889,18.27076,1763
151307,46EF230EB6A4B6FDC207E16C624EC19C,38134,3,8,5,109.63931,18.23451,2007
151308,46EF230EB6A4B6FDC207E16C624EC19C,38271,9,12,3,109.62632,18.23049,1956
151309,4DE3E9C2C0E7F48C3178063DD53BC336,31041,0,2,2,109.50278,18.23701,1507
151310,4DE3E9C2C0E7F48C3178063DD53BC336,30771,3,7,4,109.49938,18.26042,1511
151311,4DE3E9C2C0E7F48C3178063DD53BC336,31941,8,16,8,109.62451,18.31222,1970
151312,F00821368F615DCDAF214035D8EC4A44,31071,0,6,6,109.58257,18.28458,1815
151313,F00821368F615DCDAF214035D8EC4A44,30854,9,16,7,109.56889,18.27076,1763
151314,F00821368F615DCDAF214035D8EC4A44,60463,18,21,3,109.52507,18.22438,1605
151315,F00821368F615DCDAF214035D8EC4A44,30854,22,23,1,109.56889,18.27076,1763
151355,934029FB5F97BCE114EDCE88F0393A63,30854,15,17,2,109.56889,18.27076,1763
151356,934029FB5F97BCE114EDCE88F0393A63,31945,19,20,1,109.58021,18.29403,1817
151357,934029FB5F97BCE114EDCE88F0393A63,30854,21,23,2,109.56889,18.27076,1763
151361,C2CC718D695CB45C49C10B739F52F650,31181,9,11,2,109.50382,18.24813,1509
151362,C2CC718D695CB45C49C10B739F52F650,60131,11,15,4,109.49819,18.24778,1509
151363,C2CC718D695CB45C49C10B739F52F650,31031,15,21,6,109.49979,18.25382,1510
151377,96F98526707B06BE1263CCD4F72E07A1,31071,1,7,6,109.58257,18.28458,1815
151378,96F98526707B06BE1263CCD4F72E07A1,30854,9,16,7,109.56889,18.27076,1763
151379,96F98526707B06BE1263CCD4F72E07A1,31945,17,18,1,109.58021,18.29403,1817
151380,96F98526707B06BE1263CCD4F72E07A1,30854,19,23,4,109.56889,18.27076,1763
151391,48E412C068F936A4922628B0DC57FE76,30111,12,14,2,109.47583,18.30542,1419
151411,24B9CD23EC5587BA3102D06F602ACE38,60361,2,7,5,109.51938,18.29681,1567
151412,24B9CD23EC5587BA3102D06F602ACE38,60171,10,11,1,109.51292,18.30694,1569
151413,24B9CD23EC5587BA3102D06F602ACE38,39183,12,13,1,109.55542,18.28208,1715
151414,A4FEA494C186F671057B754D5D75BB49,31431,0,8,8,109.44639,18.29042,1316
151415,A4FEA494C186F671057B754D5D75BB49,31145,9,11,2,109.20431,18.30479,369
151416,A4FEA494C186F671057B754D5D75BB49,31781,11,13,2,109.19847,18.2975,367
151417,A4FEA494C186F671057B754D5D75BB49,60054,14,15,1,109.3016,18.31229,770
151418,A4FEA494C186F671057B754D5D75BB49,31431,17,20,3,109.44639,18.29042,1316
151419,A4FEA494C186F671057B754D5D75BB49,30161,20,22,2,109.50042,18.24389,1508
151425,97F87E25D267410278E74FDFD0CF66D1,31071,0,10,10,109.58257,18.28458,1815
151426,97F87E25D267410278E74FDFD0CF66D1,30161,11,14,3,109.50042,18.24389,1508
151427,97F87E25D267410278E74FDFD0CF66D1,30071,16,17,1,109.52819,18.30472,1619
151429,AA17C9279A63248D7DCDF49F93EB8817,38275,9,17,8,109.62875,18.22938,2006
151430,AA17C9279A63248D7DCDF49F93EB8817,30854,20,21,1,109.56889,18.27076,1763
151431,AA17C9279A63248D7DCDF49F93EB8817,31071,22,23,1,109.58257,18.28458,1815
151456,ECE5F9061BD873B365108DCE1A2E8E9E,38271,0,13,13,109.62632,18.23049,1956
151457,ECE5F9061BD873B365108DCE1A2E8E9E,31321,13,16,3,109.63799,18.23201,2007
151458,ECE5F9061BD873B365108DCE1A2E8E9E,38271,19,21,2,109.62632,18.23049,1956
151459,ECE5F9061BD873B365108DCE1A2E8E9E,31321,21,22,1,109.63799,18.23201,2007
151464,D73D0E1690714CD7F442C709F67E4771,60361,0,6,6,109.51938,18.29681,1567
151465,D73D0E1690714CD7F442C709F67E4771,30851,8,9,1,109.5616,18.27396,1713
151466,D73D0E1690714CD7F442C709F67E4771,31421,11,16,5,109.55382,18.22347,1705
151467,D73D0E1690714CD7F442C709F67E4771,60361,18,23,5,109.51938,18.29681,1567
151511,F84D949DDCBF25D5530F771BC55E0B9D,61011,0,4,4,109.60653,18.19076,1900
151521,409F5E8F01172D32BBE91132149C037E,31201,0,7,7,109.51042,18.23819,1558
151522,409F5E8F01172D32BBE91132149C037E,31931,8,10,2,109.54771,18.29403,1667
151523,409F5E8F01172D32BBE91132149C037E,30511,11,13,2,109.51069,18.24208,1558
151524,409F5E8F01172D32BBE91132149C037E,31931,14,16,2,109.54771,18.29403,1667
151525,409F5E8F01172D32BBE91132149C037E,30511,17,20,3,109.51069,18.24208,1558
151526,409F5E8F01172D32BBE91132149C037E,31261,20,21,1,109.51174,18.2466,1559
151527,409F5E8F01172D32BBE91132149C037E,38376,22,23,1,109.50924,18.24,1558
151534,07169E7114E4F14C073261BAAC0D4491,61011,1,5,4,109.60653,18.19076,1900
151536,07169E7114E4F14C073261BAAC0D4491,61011,13,16,3,109.60653,18.19076,1900
151537,53490AD77ACCA93C3ED0F3DE79CA488B,31071,9,10,1,109.58257,18.28458,1815
151538,53490AD77ACCA93C3ED0F3DE79CA488B,30854,12,18,6,109.56889,18.27076,1763
151580,0958879F2092FEC51B8948C9F5C46956,31231,0,7,7,109.42597,18.29292,1217
151581,0958879F2092FEC51B8948C9F5C46956,60552,8,9,1,109.41729,18.30014,1218
151583,0958879F2092FEC51B8948C9F5C46956,31231,16,23,7,109.42597,18.29292,1217
151630,30EB9FD1E5C3A2F993BE211A12B3D4BF,38951,0,8,8,109.48097,18.28868,1416
151631,30EB9FD1E5C3A2F993BE211A12B3D4BF,33521,12,15,3,109.66313,18.45174,2143
151632,30EB9FD1E5C3A2F993BE211A12B3D4BF,38951,17,22,5,109.48097,18.28868,1416
151636,9C1407835BC54BEBDB541F52E1DA1820,61011,4,6,2,109.60653,18.19076,1900
151664,3520FED22A4D572CBFE1B08BD2743E22,60291,6,9,3,109.50826,18.24639,1509
151665,3520FED22A4D572CBFE1B08BD2743E22,30211,11,18,7,109.49882,18.23931,1508
151666,3520FED22A4D572CBFE1B08BD2743E22,38291,18,20,2,109.51618,18.24313,1558
151667,3520FED22A4D572CBFE1B08BD2743E22,31391,21,22,1,109.50382,18.24285,1508
151668,A3495AE12DCA51791665FEB15CF0D86C,31561,1,10,9,109.56792,18.28479,1765
151669,A3495AE12DCA51791665FEB15CF0D86C,30071,11,12,1,109.52819,18.30472,1619
151670,A3495AE12DCA51791665FEB15CF0D86C,31561,14,15,1,109.56792,18.28479,1765
151671,A3495AE12DCA51791665FEB15CF0D86C,30071,16,18,2,109.52819,18.30472,1619
151672,A3495AE12DCA51791665FEB15CF0D86C,39183,21,23,2,109.55542,18.28208,1715
151755,10BB72F4E7990A3695C663829F0D188E,30081,0,13,13,109.50243,18.26632,1512
151756,10BB72F4E7990A3695C663829F0D188E,60331,16,17,1,109.505,18.26507,1512
151757,10BB72F4E7990A3695C663829F0D188E,38157,17,19,2,109.51483,18.26958,1563
151758,10BB72F4E7990A3695C663829F0D188E,30081,21,23,2,109.50243,18.26632,1512
151795,DBB710D279E76C79F1E4B0766F579F8A,31071,0,14,14,109.58257,18.28458,1815
151796,DBB710D279E76C79F1E4B0766F579F8A,30854,14,20,6,109.56889,18.27076,1763
151797,DBB710D279E76C79F1E4B0766F579F8A,31071,21,23,2,109.58257,18.28458,1815
151814,CCCD2290FB632A48009771412BE68ADD,31561,0,9,9,109.56792,18.28479,1765
151815,CCCD2290FB632A48009771412BE68ADD,39183,9,10,1,109.55542,18.28208,1715
151816,CCCD2290FB632A48009771412BE68ADD,31561,12,14,2,109.56792,18.28479,1765
151817,CCCD2290FB632A48009771412BE68ADD,39183,16,17,1,109.55542,18.28208,1715
151847,73EAC1341C5005A58B26B1A52457F38B,31181,0,19,19,109.50382,18.24813,1509
151848,73EAC1341C5005A58B26B1A52457F38B,38891,22,23,1,109.51486,18.24118,1558
151853,39FA7A486F1856D43C300CE94E4DB233,30391,0,7,7,109.4975,18.27118,1513
151854,39FA7A486F1856D43C300CE94E4DB233,38127,8,10,2,109.50833,18.27222,1513
151855,39FA7A486F1856D43C300CE94E4DB233,30084,12,23,11,109.50118,18.26972,1513
151877,99CBAA6A65A50998F0A10B72B36210E4,38251,2,3,1,109.49618,18.25493,1510
151878,99CBAA6A65A50998F0A10B72B36210E4,30051,4,16,12,109.48917,18.21215,1453
151886,A2DBFF4E352E7B7C1EE25431C02FC741,31931,0,16,16,109.54771,18.29403,1667
151887,A2DBFF4E352E7B7C1EE25431C02FC741,39183,16,17,1,109.55542,18.28208,1715
151888,A2DBFF4E352E7B7C1EE25431C02FC741,31931,21,22,1,109.54771,18.29403,1667
151894,43922725F0A46A5D2B5FC870E087F339,30854,14,16,2,109.56889,18.27076,1763
151895,43922725F0A46A5D2B5FC870E087F339,31071,17,18,1,109.58257,18.28458,1815
151896,43922725F0A46A5D2B5FC870E087F339,30854,20,21,1,109.56889,18.27076,1763
151901,0BABF9C6516F437130A3DD3C99553A57,31206,0,13,13,109.50819,18.23549,1507
151902,0BABF9C6516F437130A3DD3C99553A57,60381,13,16,3,109.5241,18.22458,1605
151903,0BABF9C6516F437130A3DD3C99553A57,31206,17,18,1,109.50819,18.23549,1507
151913,6300414882932A98E73E91790947DC62,60281,0,11,11,109.51743,18.25924,1561
151914,6300414882932A98E73E91790947DC62,60311,11,13,2,109.52097,18.24319,1558
151915,6300414882932A98E73E91790947DC62,60281,13,23,10,109.51743,18.25924,1561
151935,37D38EF0062E64D55C94EB554B76F9EE,31071,6,7,1,109.58257,18.28458,1815
151936,37D38EF0062E64D55C94EB554B76F9EE,30221,9,11,2,109.57833,18.20222,1802
151958,E00EF22F493557E868E52C93194870CF,31071,10,11,1,109.58257,18.28458,1815
151959,E00EF22F493557E868E52C93194870CF,30234,12,14,2,109.60681,18.29979,1918
151960,E00EF22F493557E868E52C93194870CF,30854,16,17,1,109.56889,18.27076,1763
151961,E00EF22F493557E868E52C93194870CF,31071,20,23,3,109.58257,18.28458,1815
151980,3F0525247EE9DA06541A62C07CFE6D4C,31531,20,23,3,109.49583,18.25972,1461
151983,DF1914B7230B32BA806E8A8749CAD846,60491,1,2,1,109.43354,18.30847,1269
151984,DF1914B7230B32BA806E8A8749CAD846,60261,2,4,2,109.44326,18.3075,1319
151985,DF1914B7230B32BA806E8A8749CAD846,60421,5,6,1,109.46333,18.31743,1371
151986,DF1914B7230B32BA806E8A8749CAD846,60491,6,12,6,109.43354,18.30847,1269
151987,DF1914B7230B32BA806E8A8749CAD846,60281,19,20,1,109.51743,18.25924,1561
151988,DF1914B7230B32BA806E8A8749CAD846,31031,21,22,1,109.49979,18.25382,1510
152003,EF24901D99384F703B20FE07F2784FA0,31631,0,1,1,109.59542,18.36826,1879
152004,EF24901D99384F703B20FE07F2784FA0,30101,4,6,2,109.57299,18.33333,1773
152005,EF24901D99384F703B20FE07F2784FA0,31631,7,19,12,109.59542,18.36826,1879
152071,4A5724424F2C122BD123A5CE62CED1C7,60641,9,11,2,109.53854,18.2359,1657
152097,1122041491C04B199A15F6E1E401D68F,30251,2,5,3,109.50611,18.26653,1512
152098,1122041491C04B199A15F6E1E401D68F,30461,6,11,5,109.5116,18.26313,1562
152099,1122041491C04B199A15F6E1E401D68F,60281,13,16,3,109.51743,18.25924,1561
152100,1122041491C04B199A15F6E1E401D68F,30461,16,23,7,109.5116,18.26313,1562
152106,7FD31F65A9E7574FDAD4A110ACBA289D,31931,5,10,5,109.54771,18.29403,1667
152107,7FD31F65A9E7574FDAD4A110ACBA289D,60091,14,17,3,109.59729,18.30431,1869
152108,7FD31F65A9E7574FDAD4A110ACBA289D,31561,18,19,1,109.56792,18.28479,1765
152109,7FD31F65A9E7574FDAD4A110ACBA289D,31931,20,23,3,109.54771,18.29403,1667
152127,EB0139E0BBB300F5407E4F7BCDA3B148,30511,2,4,2,109.51069,18.24208,1558
152128,EB0139E0BBB300F5407E4F7BCDA3B148,38291,5,8,3,109.51618,18.24313,1558
152129,EB0139E0BBB300F5407E4F7BCDA3B148,31521,12,15,3,109.51458,18.22542,1555
152130,EB0139E0BBB300F5407E4F7BCDA3B148,38291,16,21,5,109.51618,18.24313,1558
152131,EB0139E0BBB300F5407E4F7BCDA3B148,38891,22,23,1,109.51486,18.24118,1558
152176,4A5667D82CB3C711D86862CBE82C4E19,38027,0,14,14,109.38833,18.2909,1066
152177,4A5667D82CB3C711D86862CBE82C4E19,38315,15,16,1,109.48979,18.29764,1467
152202,46FB195BB21573CE6CD85D42D7B06C1A,30854,6,9,3,109.56889,18.27076,1763
152203,46FB195BB21573CE6CD85D42D7B06C1A,31071,11,13,2,109.58257,18.28458,1815
152204,46FB195BB21573CE6CD85D42D7B06C1A,30854,15,19,4,109.56889,18.27076,1763
152248,56F818D0924E7BDB02CCC04065747626,31421,0,6,6,109.55382,18.22347,1705
152249,56F818D0924E7BDB02CCC04065747626,30711,7,8,1,109.50271,18.25347,1510
152250,56F818D0924E7BDB02CCC04065747626,38205,9,14,5,109.62743,18.23139,1956
152253,51061B3DE820AF1C1C713EF684728003,30854,1,14,13,109.56889,18.27076,1763
152254,51061B3DE820AF1C1C713EF684728003,31071,18,20,2,109.58257,18.28458,1815
152263,A8E9C7BB918ADAD29A3EA7ACDDCD32D7,38951,0,2,2,109.48097,18.28868,1416
152264,A8E9C7BB918ADAD29A3EA7ACDDCD32D7,38951,2,14,12,109.48097,18.28868,1416
152265,A8E9C7BB918ADAD29A3EA7ACDDCD32D7,60381,14,19,5,109.5241,18.22458,1605
152266,A8E9C7BB918ADAD29A3EA7ACDDCD32D7,38951,20,23,3,109.48097,18.28868,1416
152275,012ABD06F231728C214A4BA917E75B1C,31561,0,15,15,109.56792,18.28479,1765
152276,012ABD06F231728C214A4BA917E75B1C,30851,18,20,2,109.5616,18.27396,1713
152347,D9AE11CD16B231308C3F0FB3F53BC3E9,31071,0,7,7,109.58257,18.28458,1815
152348,D9AE11CD16B231308C3F0FB3F53BC3E9,30854,8,10,2,109.56889,18.27076,1763
152349,D9AE11CD16B231308C3F0FB3F53BC3E9,31071,13,14,1,109.58257,18.28458,1815
152350,D9AE11CD16B231308C3F0FB3F53BC3E9,30854,14,20,6,109.56889,18.27076,1763
152416,8B9A9BFD1ACAD480EB101A91DBF2024D,30191,0,1,1,109.50361,18.22701,1506
152417,8B9A9BFD1ACAD480EB101A91DBF2024D,38291,4,20,16,109.51618,18.24313,1558
152418,8B9A9BFD1ACAD480EB101A91DBF2024D,30371,21,22,1,109.51,18.24771,1559
152419,E840D759B1893A7E5B17DAF4E91C42F9,38027,1,7,6,109.38833,18.2909,1066
152420,E840D759B1893A7E5B17DAF4E91C42F9,38027,10,11,1,109.38833,18.2909,1066
152421,E840D759B1893A7E5B17DAF4E91C42F9,38027,13,23,10,109.38833,18.2909,1066
152422,D61883A9E0C7F2103C981F95E51C66DA,31931,0,12,12,109.54771,18.29403,1667
152423,D61883A9E0C7F2103C981F95E51C66DA,31206,17,18,1,109.50819,18.23549,1507
152443,43E035AE85036EBD9891453E9567CB81,30151,0,6,6,109.50986,18.25083,1560
152444,43E035AE85036EBD9891453E9567CB81,31531,11,13,2,109.49583,18.25972,1461
152445,43E035AE85036EBD9891453E9567CB81,30421,13,15,2,109.50021,18.25861,1511
152446,43E035AE85036EBD9891453E9567CB81,30151,19,23,4,109.50986,18.25083,1560
152447,1B56AAF9660B4689609A2EAC980068F2,31861,0,8,8,109.49042,18.27549,1464
152448,1B56AAF9660B4689609A2EAC980068F2,38754,11,14,3,109.74667,18.37382,2430
152449,1B56AAF9660B4689609A2EAC980068F2,30361,17,18,1,109.50347,18.24,1508
152450,1B56AAF9660B4689609A2EAC980068F2,31861,19,21,2,109.49042,18.27549,1464
152478,2A1AB09F11CECAAFA5576058E9461FEA,31231,4,21,17,109.42597,18.29292,1217
152479,2A1AB09F11CECAAFA5576058E9461FEA,31091,22,23,1,109.41201,18.31222,1170
152480,2371AF49C13083A9B56BAFD9F258B46A,30721,0,6,6,109.51597,18.28257,1565
152481,2371AF49C13083A9B56BAFD9F258B46A,30861,8,11,3,109.52722,18.22743,1606
152482,2371AF49C13083A9B56BAFD9F258B46A,30721,12,14,2,109.51597,18.28257,1565
152483,2371AF49C13083A9B56BAFD9F258B46A,30861,15,18,3,109.52722,18.22743,1606
152484,2371AF49C13083A9B56BAFD9F258B46A,30121,19,21,2,109.52861,18.27222,1613
152495,48E7CF9BD7466E8BC3AC99D05DB84CA5,31471,1,6,5,109.34583,18.29563,917
152496,48E7CF9BD7466E8BC3AC99D05DB84CA5,30241,7,8,1,109.26174,18.3275,622
152502,8752BC71725B50257436D50C6598F252,31071,0,7,7,109.58257,18.28458,1815
152503,8752BC71725B50257436D50C6598F252,30854,7,22,15,109.56889,18.27076,1763
152525,01E4EDC1E5574D5D38AD2CBB1DBED767,60351,10,13,3,109.58403,18.28958,1816
152526,01E4EDC1E5574D5D38AD2CBB1DBED767,30851,15,19,4,109.5616,18.27396,1713
152559,1A3FFDC65E8E8B2347B759A77F2F6BEE,30191,2,6,4,109.50361,18.22701,1506
152560,1A3FFDC65E8E8B2347B759A77F2F6BEE,31521,8,21,13,109.51458,18.22542,1555
152561,1A3FFDC65E8E8B2347B759A77F2F6BEE,30191,22,23,1,109.50361,18.22701,1506
152564,FFDAF8A9D2C792AE2603FAF38162851E,60491,16,19,3,109.43354,18.30847,1269
152565,FFDAF8A9D2C792AE2603FAF38162851E,30084,21,23,2,109.50118,18.26972,1513
152584,08077B5D5F0A9938A81D328635D03C8B,30854,2,13,11,109.56889,18.27076,1763
152585,08077B5D5F0A9938A81D328635D03C8B,31071,14,15,1,109.58257,18.28458,1815
152586,08077B5D5F0A9938A81D328635D03C8B,30854,15,19,4,109.56889,18.27076,1763
152587,08077B5D5F0A9938A81D328635D03C8B,31561,22,23,1,109.56792,18.28479,1765
152642,832E158759EFB7090F6865072A9601D8,38971,0,7,7,109.50743,18.25125,1510
152643,832E158759EFB7090F6865072A9601D8,33481,9,12,3,109.67278,18.41278,2187
152644,832E158759EFB7090F6865072A9601D8,33051,14,16,2,109.6475,18.46618,2096
152645,832E158759EFB7090F6865072A9601D8,30711,18,20,2,109.50271,18.25347,1510
152646,832E158759EFB7090F6865072A9601D8,31181,21,23,2,109.50382,18.24813,1509
152647,CCBE9BD27BE45DF1D524AAA2624A3639,38121,0,8,8,109.51361,18.27813,1564
152648,CCBE9BD27BE45DF1D524AAA2624A3639,30051,8,13,5,109.48917,18.21215,1453
152649,CCBE9BD27BE45DF1D524AAA2624A3639,31951,16,22,6,109.52174,18.30299,1568
152671,33A62A8066AF8B1342859DF4B906FBD2,38991,18,20,2,109.52681,18.30368,1618
152672,33A62A8066AF8B1342859DF4B906FBD2,31181,21,22,1,109.50382,18.24813,1509
152718,789033FF9671BBE480F6F60FF87489C2,31031,12,13,1,109.49979,18.25382,1510
152719,789033FF9671BBE480F6F60FF87489C2,30431,18,23,5,109.16931,18.37486,280
152792,117CDF2D41FFFF099F62724091D8605A,60631,17,18,1,109.57778,18.27583,1814
152793,117CDF2D41FFFF099F62724091D8605A,30891,19,20,1,109.59431,18.28389,1865
152799,9AA959ED87D1ECC3053DED17290EFCBD,31561,0,8,8,109.56792,18.28479,1765
152800,9AA959ED87D1ECC3053DED17290EFCBD,31071,12,13,1,109.58257,18.28458,1815
152801,9AA959ED87D1ECC3053DED17290EFCBD,39183,15,16,1,109.55542,18.28208,1715
152802,9AA959ED87D1ECC3053DED17290EFCBD,31561,19,22,3,109.56792,18.28479,1765
152828,9EBFE19AEC38C3A6F47AE2D903294BAE,30854,0,15,15,109.56889,18.27076,1763
152829,9EBFE19AEC38C3A6F47AE2D903294BAE,30791,20,21,1,109.72333,18.40889,2386
152830,7890099D98AA300C5BF12527E7372DB0,60631,0,8,8,109.57778,18.27583,1814
152831,7890099D98AA300C5BF12527E7372DB0,31071,12,15,3,109.58257,18.28458,1815
152832,7890099D98AA300C5BF12527E7372DB0,30854,18,20,2,109.56889,18.27076,1763
152833,7890099D98AA300C5BF12527E7372DB0,60631,21,23,2,109.57778,18.27583,1814
152912,BA3D3DE13D22E6DD1BA5A0B2CACB0B94,30441,0,8,8,109.64021,18.25424,2010
152913,BA3D3DE13D22E6DD1BA5A0B2CACB0B94,38052,8,10,2,109.62618,18.23042,1956
152914,BA3D3DE13D22E6DD1BA5A0B2CACB0B94,30441,12,16,4,109.64021,18.25424,2010
152915,BA3D3DE13D22E6DD1BA5A0B2CACB0B94,60594,18,19,1,109.62694,18.22799,1956
152916,BA3D3DE13D22E6DD1BA5A0B2CACB0B94,30441,22,23,1,109.64021,18.25424,2010
152919,C37DBDD12F85B1DFB17F9185AF0E7708,39371,0,6,6,109.56627,18.2646,1762
152920,C37DBDD12F85B1DFB17F9185AF0E7708,30851,7,10,3,109.5616,18.27396,1713
152921,C37DBDD12F85B1DFB17F9185AF0E7708,30951,11,22,11,109.56208,18.25667,1761
152931,AECCCA10F076AF0904633347B64B94DB,30191,0,2,2,109.50361,18.22701,1506
152932,AECCCA10F076AF0904633347B64B94DB,39111,3,4,1,109.5191,18.22597,1555
152933,AECCCA10F076AF0904633347B64B94DB,30191,5,6,1,109.50361,18.22701,1506
152934,AECCCA10F076AF0904633347B64B94DB,31521,7,13,6,109.51458,18.22542,1555
152955,46F524E2239F39277AC568014393DFDF,60594,1,15,14,109.62694,18.22799,1956
152956,46F524E2239F39277AC568014393DFDF,38052,17,19,2,109.62618,18.23042,1956
152957,46F524E2239F39277AC568014393DFDF,60594,20,23,3,109.62694,18.22799,1956
152958,C1DFDFC110B50DFE0D66E47848759FB2,30851,2,4,2,109.5616,18.27396,1713
152959,C1DFDFC110B50DFE0D66E47848759FB2,39183,8,9,1,109.55542,18.28208,1715
152960,C1DFDFC110B50DFE0D66E47848759FB2,31071,14,15,1,109.58257,18.28458,1815
152961,C1DFDFC110B50DFE0D66E47848759FB2,38251,19,20,1,109.49618,18.25493,1510
152962,C1DFDFC110B50DFE0D66E47848759FB2,38275,21,22,1,109.62875,18.22938,2006
152972,0ED0AC9F879ECB02034F61F5961F8D91,39063,0,3,3,109.386,18.2919,1066
152973,0ED0AC9F879ECB02034F61F5961F8D91,38027,4,6,2,109.38833,18.2909,1066
152974,0ED0AC9F879ECB02034F61F5961F8D91,38027,7,8,1,109.38833,18.2909,1066
152975,0ED0AC9F879ECB02034F61F5961F8D91,38027,10,12,2,109.38833,18.2909,1066
152976,0ED0AC9F879ECB02034F61F5961F8D91,60561,14,16,2,109.38229,18.29785,1067
152977,0ED0AC9F879ECB02034F61F5961F8D91,31671,18,20,2,109.38965,18.29813,1068
152978,0ED0AC9F879ECB02034F61F5961F8D91,38027,21,23,2,109.38833,18.2909,1066
152987,BBE4D8242EE46AE73AD69A56A00F4408,30201,0,9,9,109.4909,18.26465,1462
152988,BBE4D8242EE46AE73AD69A56A00F4408,31271,9,11,2,109.48958,18.26257,1462
152989,BBE4D8242EE46AE73AD69A56A00F4408,31021,11,13,2,109.49021,18.27,1463
152990,BBE4D8242EE46AE73AD69A56A00F4408,30201,13,23,10,109.4909,18.26465,1462
153008,40285EE8CCE25C38988EC087545664EC,31071,1,9,8,109.58257,18.28458,1815
153009,40285EE8CCE25C38988EC087545664EC,30854,9,10,1,109.56889,18.27076,1763
153010,40285EE8CCE25C38988EC087545664EC,31071,10,11,1,109.58257,18.28458,1815
153011,40285EE8CCE25C38988EC087545664EC,30854,14,16,2,109.56889,18.27076,1763
153012,40285EE8CCE25C38988EC087545664EC,31071,18,21,3,109.58257,18.28458,1815
153024,468231DFF07583BA8A222D360B2FDB3A,31864,1,6,5,109.49014,18.28333,1465
153025,468231DFF07583BA8A222D360B2FDB3A,30741,9,13,4,109.49833,18.28681,1516
153122,7D1ED6067ECBD941EFC43CE0A6ADAE71,30854,0,7,7,109.56889,18.27076,1763
153123,7D1ED6067ECBD941EFC43CE0A6ADAE71,31945,9,11,2,109.58021,18.29403,1817
153124,7D1ED6067ECBD941EFC43CE0A6ADAE71,30854,14,18,4,109.56889,18.27076,1763
153150,9E8746086915F9D4A063A74CF0B5B7AB,39183,10,11,1,109.55542,18.28208,1715
153151,9E8746086915F9D4A063A74CF0B5B7AB,31561,14,23,9,109.56792,18.28479,1765
153157,E74DD709C18EF8EBD8453383A814635F,60501,11,12,1,109.48701,18.29021,1466
153158,E74DD709C18EF8EBD8453383A814635F,38951,12,23,11,109.48097,18.28868,1416
153159,A503639E15A0B5D04B0130D882921438,30711,0,9,9,109.50271,18.25347,1510
153160,A503639E15A0B5D04B0130D882921438,30421,9,11,2,109.50021,18.25861,1511
153161,A503639E15A0B5D04B0130D882921438,31031,11,22,11,109.49979,18.25382,1510
153233,5CFFF8D919E96524101209E188C669B3,31951,0,10,10,109.52174,18.30299,1568
153308,00FC332040A284DA251A8D0705989FE9,31071,1,12,11,109.58257,18.28458,1815
153309,00FC332040A284DA251A8D0705989FE9,30854,14,16,2,109.56889,18.27076,1763
153310,00FC332040A284DA251A8D0705989FE9,30151,19,20,1,109.50986,18.25083,1560
153311,00FC332040A284DA251A8D0705989FE9,30854,22,23,1,109.56889,18.27076,1763
153410,2AE38FAF341950B0B91404FFCE5A0F3E,30921,7,17,10,109.53903,18.29451,1667
153411,2AE38FAF341950B0B91404FFCE5A0F3E,31931,18,23,5,109.54771,18.29403,1667
153412,8DA877D3A30401F86E81FB7BC1CA2A00,30854,0,19,19,109.56889,18.27076,1763
153413,8DA877D3A30401F86E81FB7BC1CA2A00,31071,20,21,1,109.58257,18.28458,1815
153417,39F25FE146A03325C93C111F2A943B6C,30854,1,2,1,109.56889,18.27076,1763
153418,39F25FE146A03325C93C111F2A943B6C,31945,2,6,4,109.58021,18.29403,1817
153419,39F25FE146A03325C93C111F2A943B6C,30854,7,23,16,109.56889,18.27076,1763
153449,D8917A2A43EA8070EEC2FA46A7C72FE1,38251,12,13,1,109.49618,18.25493,1510
153450,D8917A2A43EA8070EEC2FA46A7C72FE1,30504,16,23,7,109.705,18.35368,2277
153491,1E36640BE395A4EE8CCB2697222419A5,60631,0,6,6,109.57778,18.27583,1814
153492,1E36640BE395A4EE8CCB2697222419A5,30854,8,12,4,109.56889,18.27076,1763
153493,1E36640BE395A4EE8CCB2697222419A5,60631,14,16,2,109.57778,18.27583,1814
153494,1E36640BE395A4EE8CCB2697222419A5,30854,19,21,2,109.56889,18.27076,1763
153497,92B04F1171F7627BEF2FDBB24EA4D3B4,31471,9,12,3,109.34583,18.29563,917
153498,92B04F1171F7627BEF2FDBB24EA4D3B4,31145,13,14,1,109.20431,18.30479,369
153499,92B04F1171F7627BEF2FDBB24EA4D3B4,30351,17,19,2,109.41701,18.29292,1217
153503,CFA6DB42B4EA79576A8AEA8F93765E81,30721,3,7,4,109.51597,18.28257,1565
153504,CFA6DB42B4EA79576A8AEA8F93765E81,30271,10,11,1,109.49132,18.23153,1456
153505,CFA6DB42B4EA79576A8AEA8F93765E81,30291,15,18,3,109.50403,18.27028,1513
153506,CFA6DB42B4EA79576A8AEA8F93765E81,31864,19,20,1,109.49014,18.28333,1465
153507,DFFF17B7FE30E79B8AABBB5CE171272F,31561,0,10,10,109.56792,18.28479,1765
153508,DFFF17B7FE30E79B8AABBB5CE171272F,39183,10,16,6,109.55542,18.28208,1715
153509,DFFF17B7FE30E79B8AABBB5CE171272F,31561,17,22,5,109.56792,18.28479,1765
153531,B34415F599F0ED7D1A073EE314A60B9B,60041,2,9,7,109.39889,18.31944,1121
153532,B34415F599F0ED7D1A073EE314A60B9B,31671,9,20,11,109.38965,18.29813,1068
153590,EC4B90EDBF35256FDB4D4F8B87DB8A04,31071,1,7,6,109.58257,18.28458,1815
153591,EC4B90EDBF35256FDB4D4F8B87DB8A04,30854,7,18,11,109.56889,18.27076,1763
153622,BD5DE467370306D034C70B320455BE36,39091,0,11,11,109.50097,18.25222,1510
153623,BD5DE467370306D034C70B320455BE36,30421,16,17,1,109.50021,18.25861,1511
153624,BD5DE467370306D034C70B320455BE36,39151,17,23,6,109.49875,18.25097,1510
153667,0D69669D4DBC1CEB06269A084D86E853,30851,1,2,1,109.5616,18.27396,1713
153668,0D69669D4DBC1CEB06269A084D86E853,30854,2,6,4,109.56889,18.27076,1763
153768,979ABBB43C3434EE96D76E04CFC66E55,30201,20,21,1,109.4909,18.26465,1462
153769,979ABBB43C3434EE96D76E04CFC66E55,60201,22,23,1,109.5041,18.2509,1510
153775,853957914DEF6F72A1C4EECCFE47E293,30854,2,7,5,109.56889,18.27076,1763
153776,853957914DEF6F72A1C4EECCFE47E293,38706,8,18,10,109.74625,18.37097,2430
153788,18B397C6C5E352538250AEDC640C72E3,31941,0,6,6,109.62451,18.31222,1970
153789,18B397C6C5E352538250AEDC640C72E3,38205,7,12,5,109.62743,18.23139,1956
153790,18B397C6C5E352538250AEDC640C72E3,31221,13,14,1,109.61333,18.26833,1913
153839,622234A65D292D040A9E438A2770674C,30851,0,7,7,109.5616,18.27396,1713
153840,622234A65D292D040A9E438A2770674C,31561,8,9,1,109.56792,18.28479,1765
153841,622234A65D292D040A9E438A2770674C,30851,12,21,9,109.5616,18.27396,1713
153845,03CEC0FDDD5484124514C6D24A63D4DD,31561,0,7,7,109.56792,18.28479,1765
153846,03CEC0FDDD5484124514C6D24A63D4DD,39183,8,10,2,109.55542,18.28208,1715
153847,03CEC0FDDD5484124514C6D24A63D4DD,31561,11,12,1,109.56792,18.28479,1765
153848,03CEC0FDDD5484124514C6D24A63D4DD,39183,13,17,4,109.55542,18.28208,1715
153849,03CEC0FDDD5484124514C6D24A63D4DD,31561,17,19,2,109.56792,18.28479,1765
153850,03CEC0FDDD5484124514C6D24A63D4DD,30854,22,23,1,109.56889,18.27076,1763
153872,87ACF3C6ADE430D2B9DFB3C954E0C031,39183,1,4,3,109.55542,18.28208,1715
153873,87ACF3C6ADE430D2B9DFB3C954E0C031,31071,6,10,4,109.58257,18.28458,1815
153874,87ACF3C6ADE430D2B9DFB3C954E0C031,39181,10,12,2,109.55153,18.28035,1715
153875,87ACF3C6ADE430D2B9DFB3C954E0C031,31071,12,16,4,109.58257,18.28458,1815
153876,87ACF3C6ADE430D2B9DFB3C954E0C031,39183,16,19,3,109.55542,18.28208,1715
153877,87ACF3C6ADE430D2B9DFB3C954E0C031,31071,20,21,1,109.58257,18.28458,1815
153944,1E93239453A807F80FEB34C902C59FA1,48601,0,7,7,109.51694,18.22514,1555
153945,1E93239453A807F80FEB34C902C59FA1,31521,11,14,3,109.51458,18.22542,1555
153946,1E93239453A807F80FEB34C902C59FA1,48601,14,17,3,109.51694,18.22514,1555
153947,1E93239453A807F80FEB34C902C59FA1,31521,18,20,2,109.51458,18.22542,1555
153948,1E93239453A807F80FEB34C902C59FA1,31521,20,21,1,109.51458,18.22542,1555
153949,1E93239453A807F80FEB34C902C59FA1,30731,21,23,2,109.50944,18.22306,1555
153992,A4D22152627C5C24F4D207D0FDD787D4,60311,0,1,1,109.52097,18.24319,1558
153993,A4D22152627C5C24F4D207D0FDD787D4,60221,5,10,5,109.52569,18.29188,1616
153994,A4D22152627C5C24F4D207D0FDD787D4,30854,14,15,1,109.56889,18.27076,1763
153995,A4D22152627C5C24F4D207D0FDD787D4,60221,20,22,2,109.52569,18.29188,1616
154003,27229B6D41BD7CDDDAA38911093865DB,30854,0,3,3,109.56889,18.27076,1763
154004,27229B6D41BD7CDDDAA38911093865DB,38085,5,13,8,109.6291,18.23625,2007
154025,F941F01D0E9ADF1E538631C17665F2E0,38336,0,10,10,109.61111,18.21806,1904
154026,F941F01D0E9ADF1E538631C17665F2E0,30361,12,13,1,109.50347,18.24,1508
154027,F941F01D0E9ADF1E538631C17665F2E0,30854,17,19,2,109.56889,18.27076,1763
154028,F941F01D0E9ADF1E538631C17665F2E0,31071,19,21,2,109.58257,18.28458,1815
154029,F941F01D0E9ADF1E538631C17665F2E0,60591,22,23,1,109.61118,18.21715,1904
154046,E218C587552A5DADC05C4E69685FE374,30854,8,18,10,109.56889,18.27076,1763
154047,E218C587552A5DADC05C4E69685FE374,39183,21,23,2,109.55542,18.28208,1715
154048,B9C328A62B9F9830C9EA98AE81376626,30771,0,7,7,109.49938,18.26042,1511
154049,B9C328A62B9F9830C9EA98AE81376626,30251,9,10,1,109.50611,18.26653,1512
154050,B9C328A62B9F9830C9EA98AE81376626,30771,12,17,5,109.49938,18.26042,1511
154051,B9C328A62B9F9830C9EA98AE81376626,30571,18,19,1,109.50243,18.21861,1504
154052,B9C328A62B9F9830C9EA98AE81376626,30771,20,23,3,109.49938,18.26042,1511
154165,F8340F8DE3FC6E4B51712C02CF964A60,38117,0,5,5,109.51611,18.22354,1555
154166,F8340F8DE3FC6E4B51712C02CF964A60,31521,6,8,2,109.51458,18.22542,1555
154167,F8340F8DE3FC6E4B51712C02CF964A60,31521,11,14,3,109.51458,18.22542,1555
154168,F8340F8DE3FC6E4B51712C02CF964A60,39321,14,15,1,109.529,18.2167,1604
154169,F8340F8DE3FC6E4B51712C02CF964A60,60381,19,21,2,109.5241,18.22458,1605
154178,8880BF3B03853247B5235ADF19775070,31781,10,12,2,109.19847,18.2975,367
154179,8880BF3B03853247B5235ADF19775070,31471,14,16,2,109.34583,18.29563,917
154180,8880BF3B03853247B5235ADF19775070,60381,17,23,6,109.5241,18.22458,1605
154184,AB8B051428E5E5EDACDABEECED7F5A35,31421,0,1,1,109.55382,18.22347,1705
154185,AB8B051428E5E5EDACDABEECED7F5A35,30851,1,3,2,109.5616,18.27396,1713
154186,AB8B051428E5E5EDACDABEECED7F5A35,31421,4,14,10,109.55382,18.22347,1705
154187,AB8B051428E5E5EDACDABEECED7F5A35,30851,15,17,2,109.5616,18.27396,1713
154188,AB8B051428E5E5EDACDABEECED7F5A35,31421,18,23,5,109.55382,18.22347,1705
154229,4B8D9F3A9653A6483169F67E5D72F0C2,31945,16,17,1,109.58021,18.29403,1817
154230,4B8D9F3A9653A6483169F67E5D72F0C2,30791,19,23,4,109.72333,18.40889,2386
154277,7C4B45B599684104AFE3AA992CD3924A,31521,0,2,2,109.51458,18.22542,1555
154278,7C4B45B599684104AFE3AA992CD3924A,60211,2,8,6,109.63549,18.26049,2011
154279,7C4B45B599684104AFE3AA992CD3924A,30711,9,13,4,109.50271,18.25347,1510
154280,7C4B45B599684104AFE3AA992CD3924A,30421,14,16,2,109.50021,18.25861,1511
154281,7C4B45B599684104AFE3AA992CD3924A,30811,18,21,3,109.65188,18.26257,2062
154282,7C4B45B599684104AFE3AA992CD3924A,60211,21,23,2,109.63549,18.26049,2011
154283,EEC6B662D07BE95423A2DC77D2E69188,31071,0,8,8,109.58257,18.28458,1815
154284,EEC6B662D07BE95423A2DC77D2E69188,30854,11,18,7,109.56889,18.27076,1763
154285,EEC6B662D07BE95423A2DC77D2E69188,31071,20,21,1,109.58257,18.28458,1815
154286,EEC6B662D07BE95423A2DC77D2E69188,30854,21,22,1,109.56889,18.27076,1763
154363,752B4C65CCCA1EA27D3C6EA24E289B9C,60631,12,14,2,109.57778,18.27583,1814
154364,752B4C65CCCA1EA27D3C6EA24E289B9C,30854,14,20,6,109.56889,18.27076,1763
154405,452F0FF6BC36839041DCBEF2292D6E55,60661,2,9,7,109.548,18.2377,1657
154406,452F0FF6BC36839041DCBEF2292D6E55,31521,10,14,4,109.51458,18.22542,1555
154407,452F0FF6BC36839041DCBEF2292D6E55,30861,15,17,2,109.52722,18.22743,1606
154408,452F0FF6BC36839041DCBEF2292D6E55,60661,21,23,2,109.548,18.2377,1657
154414,2F64FEF19C86AA0A8AA3E3FA37CC4F2D,30854,0,1,1,109.56889,18.27076,1763
154415,2F64FEF19C86AA0A8AA3E3FA37CC4F2D,60631,1,9,8,109.57778,18.27583,1814
154416,2F64FEF19C86AA0A8AA3E3FA37CC4F2D,30891,10,11,1,109.59431,18.28389,1865
154417,2F64FEF19C86AA0A8AA3E3FA37CC4F2D,30854,13,19,6,109.56889,18.27076,1763
154418,2F64FEF19C86AA0A8AA3E3FA37CC4F2D,60631,20,22,2,109.57778,18.27583,1814
154422,0E54E51B728435921FF462A3D9A68B3D,30854,0,14,14,109.56889,18.27076,1763
154423,0E54E51B728435921FF462A3D9A68B3D,31231,18,23,5,109.42597,18.29292,1217
154434,AB43182259122294244C13D6FC66D4A1,30851,16,18,2,109.5616,18.27396,1713
154435,AB43182259122294244C13D6FC66D4A1,60631,18,23,5,109.57778,18.27583,1814
154440,C462628FF36F8FF2D0B7493E6DDA38BB,30661,1,7,6,109.37028,18.24361,1008
154441,C462628FF36F8FF2D0B7493E6DDA38BB,60411,8,12,4,109.32514,18.30854,869
154442,C462628FF36F8FF2D0B7493E6DDA38BB,30661,13,14,1,109.37028,18.24361,1008
154443,C462628FF36F8FF2D0B7493E6DDA38BB,60411,14,23,9,109.32514,18.30854,869
154468,036DFEF8CA623F9034F928149FE2468D,30821,14,20,6,109.43681,18.33639,1274
154469,036DFEF8CA623F9034F928149FE2468D,30651,21,22,1,109.42611,18.385,1232
154484,E1BB7B2CDA075A402737990C0757A672,39091,0,9,9,109.50097,18.25222,1510
154485,E1BB7B2CDA075A402737990C0757A672,30361,10,11,1,109.50347,18.24,1508
154494,F8D799D9161B0143E0D71C40472A357E,38991,1,7,6,109.52681,18.30368,1618
154495,F8D799D9161B0143E0D71C40472A357E,31951,7,8,1,109.52174,18.30299,1568
154496,F8D799D9161B0143E0D71C40472A357E,30071,10,14,4,109.52819,18.30472,1619
154497,F8D799D9161B0143E0D71C40472A357E,31951,15,18,3,109.52174,18.30299,1568
154498,F8D799D9161B0143E0D71C40472A357E,30071,18,20,2,109.52819,18.30472,1619
154499,F8D799D9161B0143E0D71C40472A357E,30071,21,23,2,109.52819,18.30472,1619
154512,5EE25A6E7DD554FFDA0C9C1A504114B7,30221,0,16,16,109.57833,18.20222,1802
154513,5EE25A6E7DD554FFDA0C9C1A504114B7,30281,18,19,1,109.50597,18.27583,1514
154545,E7DB0F55EDE33BB4C08C98B80B7173BF,31841,15,16,1,109.73201,18.33382,2373
154546,E7DB0F55EDE33BB4C08C98B80B7173BF,60111,17,18,1,109.72556,18.31924,2371
154547,E7DB0F55EDE33BB4C08C98B80B7173BF,60371,20,23,3,109.53063,18.30056,1618
154550,7BF65E5054DA81A230AB5423620158E1,60631,0,7,7,109.57778,18.27583,1814
154551,7BF65E5054DA81A230AB5423620158E1,30854,7,19,12,109.56889,18.27076,1763
154552,ADC7B707FBBD7BF3F9ACE0C092DAADE5,30921,0,2,2,109.53903,18.29451,1667
154553,ADC7B707FBBD7BF3F9ACE0C092DAADE5,60371,3,6,3,109.53063,18.30056,1618
154557,F5EB56BD5801B85A9E4703584DF6DFA6,60661,0,6,6,109.548,18.2377,1657
154558,F5EB56BD5801B85A9E4703584DF6DFA6,60431,10,11,1,109.46139,18.32861,1373
154559,F5EB56BD5801B85A9E4703584DF6DFA6,31534,11,13,2,109.49368,18.25806,1461
154695,A46BA306DAEA889FAC7ACE9E5FD6A1FF,30081,0,6,6,109.50243,18.26632,1512
154696,A46BA306DAEA889FAC7ACE9E5FD6A1FF,30911,7,9,2,109.50493,18.26181,1511
154697,A46BA306DAEA889FAC7ACE9E5FD6A1FF,30711,10,14,4,109.50271,18.25347,1510
154698,A46BA306DAEA889FAC7ACE9E5FD6A1FF,31171,14,16,2,109.50938,18.24917,1559
154699,A46BA306DAEA889FAC7ACE9E5FD6A1FF,30511,20,21,1,109.51069,18.24208,1558
154702,E649CF84A26278291AA1A5B5C5D01FCA,31561,1,5,4,109.56792,18.28479,1765
154703,E649CF84A26278291AA1A5B5C5D01FCA,30854,5,15,10,109.56889,18.27076,1763
154721,B84B247FA61A8C12DFCCCF3C2D72006D,31071,0,7,7,109.58257,18.28458,1815
154722,B84B247FA61A8C12DFCCCF3C2D72006D,30854,9,17,8,109.56889,18.27076,1763
154723,B84B247FA61A8C12DFCCCF3C2D72006D,31071,17,19,2,109.58257,18.28458,1815
154724,B84B247FA61A8C12DFCCCF3C2D72006D,30854,19,21,2,109.56889,18.27076,1763
154746,3871846CD20CC7E3D76BFB165D15B326,60631,13,14,1,109.57778,18.27583,1814
154747,3871846CD20CC7E3D76BFB165D15B326,30854,17,23,6,109.56889,18.27076,1763
154748,FE3B5F01A6626B19D8324F79E0BF8F47,60031,13,14,1,109.49694,18.31632,1521
154749,FE3B5F01A6626B19D8324F79E0BF8F47,31461,18,20,2,109.5091,18.25389,1510
154750,FE3B5F01A6626B19D8324F79E0BF8F47,30371,21,23,2,109.51,18.24771,1559
154766,6C0260646767B781577B5B8CE2471E51,38484,1,9,8,109.53028,18.31528,1620
154767,6C0260646767B781577B5B8CE2471E51,38484,12,17,5,109.53028,18.31528,1620
154768,6C0260646767B781577B5B8CE2471E51,38484,20,22,2,109.53028,18.31528,1620
154774,20C15B76A1E0DF79D86EDEAC7BC3D7B7,31071,0,4,4,109.58257,18.28458,1815
154775,20C15B76A1E0DF79D86EDEAC7BC3D7B7,31945,6,8,2,109.58021,18.29403,1817
154891,FAC035CAF00431CACD74AF53D18C4996,60011,0,6,6,109.48965,18.30222,1468
154892,FAC035CAF00431CACD74AF53D18C4996,30764,7,10,3,109.45806,18.29486,1367
154893,FAC035CAF00431CACD74AF53D18C4996,30761,10,11,1,109.45201,18.3,1318
154894,FAC035CAF00431CACD74AF53D18C4996,30764,14,17,3,109.45806,18.29486,1367
154895,FAC035CAF00431CACD74AF53D18C4996,60011,19,20,1,109.48965,18.30222,1468
154898,1E5258D0CC7C3DBB97888929EF64B7AF,30361,0,10,10,109.50347,18.24,1508
154899,1E5258D0CC7C3DBB97888929EF64B7AF,31041,11,12,1,109.50278,18.23701,1507
154900,1E5258D0CC7C3DBB97888929EF64B7AF,30361,13,16,3,109.50347,18.24,1508
154901,1E5258D0CC7C3DBB97888929EF64B7AF,30161,17,19,2,109.50042,18.24389,1508
154902,1E5258D0CC7C3DBB97888929EF64B7AF,30361,21,23,2,109.50347,18.24,1508
154937,CFFDD1BF3134B9FDD71614F40E1DE0FD,31561,0,2,2,109.56792,18.28479,1765
154938,CFFDD1BF3134B9FDD71614F40E1DE0FD,31071,5,22,17,109.58257,18.28458,1815
154965,075F360F88180B9A93BF11A5704B49F3,31621,0,8,8,109.51035,18.29826,1568
154966,075F360F88180B9A93BF11A5704B49F3,60121,12,14,2,109.74507,18.37472,2430
154967,075F360F88180B9A93BF11A5704B49F3,30741,18,21,3,109.49833,18.28681,1516
154968,8AABF5FDF2B06EB445749240A3894969,31071,1,8,7,109.58257,18.28458,1815
154969,8AABF5FDF2B06EB445749240A3894969,30854,8,12,4,109.56889,18.27076,1763
154970,8AABF5FDF2B06EB445749240A3894969,31071,12,13,1,109.58257,18.28458,1815
155025,9EF6440DA421994ED152A57FAE59B45B,30151,0,9,9,109.50986,18.25083,1560
155026,9EF6440DA421994ED152A57FAE59B45B,30711,9,11,2,109.50271,18.25347,1510
155027,9EF6440DA421994ED152A57FAE59B45B,39091,12,14,2,109.50097,18.25222,1510
155028,9EF6440DA421994ED152A57FAE59B45B,30371,14,16,2,109.51,18.24771,1559
155029,9EF6440DA421994ED152A57FAE59B45B,30371,18,23,5,109.51,18.24771,1559
155096,E8BAAF476E8FE57075BAB1A8D4FF1780,30232,18,20,2,109.6191,18.31701,1971
155097,E8BAAF476E8FE57075BAB1A8D4FF1780,39371,20,21,1,109.56627,18.2646,1762
155115,30CE72A519D49881F23B8123486E3A02,60054,2,8,6,109.3016,18.31229,770
155116,30CE72A519D49881F23B8123486E3A02,60411,9,11,2,109.32514,18.30854,869
155117,30CE72A519D49881F23B8123486E3A02,31471,16,17,1,109.34583,18.29563,917
155118,30CE72A519D49881F23B8123486E3A02,60411,18,20,2,109.32514,18.30854,869
155143,B40042BCF38D15C3E5C90930640CEE46,38071,20,22,2,109.40722,18.30938,1169
155162,9A1D1AA5EE2CD156CC396C667ED8C5B9,31071,1,9,8,109.58257,18.28458,1815
155163,9A1D1AA5EE2CD156CC396C667ED8C5B9,31164,10,15,5,109.69993,18.27215,2263
155164,9A1D1AA5EE2CD156CC396C667ED8C5B9,30854,16,21,5,109.56889,18.27076,1763
155214,798BF3B08F72A16A6DEAAA235F1899BB,61011,2,5,3,109.60653,18.19076,1900
155216,798BF3B08F72A16A6DEAAA235F1899BB,61011,20,22,2,109.60653,18.19076,1900
155346,9B979E9430BCD0DDB6C78BBE525EBD2D,60631,3,6,3,109.57778,18.27583,1814
155347,9B979E9430BCD0DDB6C78BBE525EBD2D,30854,7,20,13,109.56889,18.27076,1763
155348,9B979E9430BCD0DDB6C78BBE525EBD2D,39371,20,22,2,109.56627,18.2646,1762
155349,16C55088B9FD926AE4D7B338D0769967,30854,5,10,5,109.56889,18.27076,1763
155350,16C55088B9FD926AE4D7B338D0769967,31531,11,13,2,109.49583,18.25972,1461
155351,16C55088B9FD926AE4D7B338D0769967,30854,15,17,2,109.56889,18.27076,1763
155352,E4C7AB656E412C7E33554D18277C9478,60291,10,14,4,109.50826,18.24639,1509
155353,E4C7AB656E412C7E33554D18277C9478,38127,17,19,2,109.50833,18.27222,1513
155443,6751CEC3CF9B2AE78246C7287443D2B4,31945,0,2,2,109.58021,18.29403,1817
155444,6751CEC3CF9B2AE78246C7287443D2B4,30854,7,23,16,109.56889,18.27076,1763
155463,0D1B933C65704EEE0CFA016AED0F8FDF,31071,0,9,9,109.58257,18.28458,1815
155464,0D1B933C65704EEE0CFA016AED0F8FDF,30854,9,13,4,109.56889,18.27076,1763
155465,0D1B933C65704EEE0CFA016AED0F8FDF,31071,15,18,3,109.58257,18.28458,1815
155479,7FA173D0839B9BE60B23B32DD3C2AC47,31071,15,17,2,109.58257,18.28458,1815
155480,7FA173D0839B9BE60B23B32DD3C2AC47,30071,18,19,1,109.52819,18.30472,1619
155481,7FA173D0839B9BE60B23B32DD3C2AC47,60084,20,21,1,109.4984,18.2334,1507
155482,7FA173D0839B9BE60B23B32DD3C2AC47,30511,22,23,1,109.51069,18.24208,1558
155502,68DBE0B52FD0AB95F1DD47068FD7847F,60311,2,11,9,109.52097,18.24319,1558
155503,68DBE0B52FD0AB95F1DD47068FD7847F,30181,15,23,8,109.51597,18.23313,1557
155513,860C13CBFA013D0236AC6B4CB1CB4DEE,30721,1,8,7,109.51597,18.28257,1565
155514,860C13CBFA013D0236AC6B4CB1CB4DEE,30324,10,12,2,109.50326,18.29257,1517
155515,860C13CBFA013D0236AC6B4CB1CB4DEE,30711,13,16,3,109.50271,18.25347,1510
155516,860C13CBFA013D0236AC6B4CB1CB4DEE,30721,17,19,2,109.51597,18.28257,1565
155578,DECB7B3FC95BFA8620EFD8D9DE328252,30854,4,10,6,109.56889,18.27076,1763
155579,DECB7B3FC95BFA8620EFD8D9DE328252,31945,14,15,1,109.58021,18.29403,1817
155580,DECB7B3FC95BFA8620EFD8D9DE328252,30854,15,20,5,109.56889,18.27076,1763
155602,172CB232BBE684655CFBDFD055BB1CB5,30771,0,7,7,109.49938,18.26042,1511
155603,172CB232BBE684655CFBDFD055BB1CB5,60551,12,15,3,109.42722,18.30111,1218
155604,172CB232BBE684655CFBDFD055BB1CB5,60524,18,19,1,109.42951,18.28993,1216
155614,B7EEF2B178640D89D1EA0EECF6DA162E,30711,0,8,8,109.50271,18.25347,1510
155615,B7EEF2B178640D89D1EA0EECF6DA162E,31181,8,10,2,109.50382,18.24813,1509
155616,B7EEF2B178640D89D1EA0EECF6DA162E,31181,11,12,1,109.50382,18.24813,1509
155617,B7EEF2B178640D89D1EA0EECF6DA162E,31031,12,14,2,109.49979,18.25382,1510
155655,5D5B29A994BBA3635D38463A75BE58F6,30201,0,5,5,109.4909,18.26465,1462
155656,5D5B29A994BBA3635D38463A75BE58F6,31531,5,6,1,109.49583,18.25972,1461
155657,5D5B29A994BBA3635D38463A75BE58F6,30201,7,8,1,109.4909,18.26465,1462
155658,5D5B29A994BBA3635D38463A75BE58F6,31473,12,13,1,109.34792,18.29465,917
155659,5D5B29A994BBA3635D38463A75BE58F6,31021,14,21,7,109.49021,18.27,1463
155662,4E9C73925B67466BCE6AE7E22B99BF20,30891,0,3,3,109.59431,18.28389,1865
155663,4E9C73925B67466BCE6AE7E22B99BF20,39183,3,6,3,109.55542,18.28208,1715
155664,4E9C73925B67466BCE6AE7E22B99BF20,31071,6,23,17,109.58257,18.28458,1815
155674,FE5C9666AF69804A342901D01418FCD8,30181,0,1,1,109.51597,18.23313,1557
155675,FE5C9666AF69804A342901D01418FCD8,30191,2,4,2,109.50361,18.22701,1506
155676,FE5C9666AF69804A342901D01418FCD8,30181,5,8,3,109.51597,18.23313,1557
155695,222E0B6922623CE9FBB280F81068D40E,30731,12,17,5,109.50944,18.22306,1555
155696,222E0B6922623CE9FBB280F81068D40E,31561,21,23,2,109.56792,18.28479,1765
155739,90D91A493F9482486DCC3B27CF3F61EE,31071,0,7,7,109.58257,18.28458,1815
155740,90D91A493F9482486DCC3B27CF3F61EE,30854,8,9,1,109.56889,18.27076,1763
155741,90D91A493F9482486DCC3B27CF3F61EE,31071,11,13,2,109.58257,18.28458,1815
155742,90D91A493F9482486DCC3B27CF3F61EE,30854,14,16,2,109.56889,18.27076,1763
155743,90D91A493F9482486DCC3B27CF3F61EE,31071,16,17,1,109.58257,18.28458,1815
155755,7C68E1F4B8B2F3CBBD5427BF66BF9C2E,31571,14,15,1,109.61563,18.23326,1957
155756,7C68E1F4B8B2F3CBBD5427BF66BF9C2E,30854,20,22,2,109.56889,18.27076,1763
155760,5403ECE41AD9921A5DEF63FF6DE6A9D1,31071,2,9,7,109.58257,18.28458,1815
155761,5403ECE41AD9921A5DEF63FF6DE6A9D1,30854,11,17,6,109.56889,18.27076,1763
155765,15195C578D4A8081B069C4B518039EFC,60161,15,20,5,109.49174,18.26181,1461
155766,15195C578D4A8081B069C4B518039EFC,30051,22,23,1,109.48917,18.21215,1453
155786,B02D7A3F297B377D646E0F85B7C19006,61011,0,2,2,109.60653,18.19076,1900
155788,B02D7A3F297B377D646E0F85B7C19006,61011,22,23,1,109.60653,18.19076,1900
155794,246EF4D95FA494895EFB2D649512DAE7,60081,0,6,6,109.51097,18.22639,1556
155796,246EF4D95FA494895EFB2D649512DAE7,61011,13,17,4,109.60653,18.19076,1900
155803,C97A61E87ADF22CB0CED7FFED3A35BC3,30951,3,4,1,109.56208,18.25667,1761
155804,C97A61E87ADF22CB0CED7FFED3A35BC3,39371,8,9,1,109.56627,18.2646,1762
155805,C97A61E87ADF22CB0CED7FFED3A35BC3,30851,14,19,5,109.5616,18.27396,1713
155820,DD8DCE806AFFEAC5D779812E5F8F2B3D,31561,0,2,2,109.56792,18.28479,1765
155821,DD8DCE806AFFEAC5D779812E5F8F2B3D,31071,3,5,2,109.58257,18.28458,1815
155822,DD8DCE806AFFEAC5D779812E5F8F2B3D,31561,5,8,3,109.56792,18.28479,1765
155823,DD8DCE806AFFEAC5D779812E5F8F2B3D,30854,9,11,2,109.56889,18.27076,1763
155824,DD8DCE806AFFEAC5D779812E5F8F2B3D,31561,15,16,1,109.56792,18.28479,1765
155829,372A5433078073EAD18922D679CE0A73,60054,0,13,13,109.3016,18.31229,770
155830,372A5433078073EAD18922D679CE0A73,60411,14,22,8,109.32514,18.30854,869
155831,372A5433078073EAD18922D679CE0A73,60054,22,23,1,109.3016,18.31229,770
155863,0354DA7FCEC6CBE8F4AF79CA9C56607E,30854,8,9,1,109.56889,18.27076,1763
155864,0354DA7FCEC6CBE8F4AF79CA9C56607E,31561,9,14,5,109.56792,18.28479,1765
155865,0354DA7FCEC6CBE8F4AF79CA9C56607E,30854,16,17,1,109.56889,18.27076,1763
155866,0354DA7FCEC6CBE8F4AF79CA9C56607E,38484,18,20,2,109.53028,18.31528,1620
155867,0354DA7FCEC6CBE8F4AF79CA9C56607E,30854,20,21,1,109.56889,18.27076,1763
155868,0354DA7FCEC6CBE8F4AF79CA9C56607E,31071,21,23,2,109.58257,18.28458,1815
155896,98874DCD35D34E4D34E0BC9C49822D59,31521,0,14,14,109.51458,18.22542,1555
155897,98874DCD35D34E4D34E0BC9C49822D59,60381,15,16,1,109.5241,18.22458,1605
155898,98874DCD35D34E4D34E0BC9C49822D59,31521,16,17,1,109.51458,18.22542,1555
155899,98874DCD35D34E4D34E0BC9C49822D59,31521,19,21,2,109.51458,18.22542,1555
155900,98874DCD35D34E4D34E0BC9C49822D59,60381,22,23,1,109.5241,18.22458,1605
155903,A969AA4D78FD71B9F4E643F763F4C75F,30221,3,6,3,109.57833,18.20222,1802
155904,A969AA4D78FD71B9F4E643F763F4C75F,31521,7,8,1,109.51458,18.22542,1555
155905,A969AA4D78FD71B9F4E643F763F4C75F,60381,8,9,1,109.5241,18.22458,1605
155906,A969AA4D78FD71B9F4E643F763F4C75F,31521,10,21,11,109.51458,18.22542,1555
155907,A969AA4D78FD71B9F4E643F763F4C75F,60381,21,23,2,109.5241,18.22458,1605
155923,B023927CBEC0A8053CBDF64A5B76E367,30571,0,7,7,109.50243,18.21861,1504
155924,B023927CBEC0A8053CBDF64A5B76E367,31931,8,15,7,109.54771,18.29403,1667
155925,B023927CBEC0A8053CBDF64A5B76E367,30571,19,23,4,109.50243,18.21861,1504
155980,B172E1B17A92EA23226EC822FB6F7B82,30161,18,20,2,109.50042,18.24389,1508
155981,B172E1B17A92EA23226EC822FB6F7B82,31201,21,23,2,109.51042,18.23819,1558
155995,FF8CB3D02361FAEBFE418108180099D8,39154,0,1,1,109.50201,18.25681,1511
155996,FF8CB3D02361FAEBFE418108180099D8,60201,1,13,12,109.5041,18.2509,1510
155997,FF8CB3D02361FAEBFE418108180099D8,30711,14,22,8,109.50271,18.25347,1510
156011,D4EE8E1A4C04A1FF0596E4221D0B8B42,30854,0,4,4,109.56889,18.27076,1763
156012,D4EE8E1A4C04A1FF0596E4221D0B8B42,31071,7,14,7,109.58257,18.28458,1815
156013,D4EE8E1A4C04A1FF0596E4221D0B8B42,30854,18,19,1,109.56889,18.27076,1763
156014,D4EE8E1A4C04A1FF0596E4221D0B8B42,39091,20,22,2,109.50097,18.25222,1510
156021,5A888DC7A3AA300CC584D9862C5384A1,30421,0,7,7,109.50021,18.25861,1511
156022,5A888DC7A3AA300CC584D9862C5384A1,39181,8,11,3,109.55153,18.28035,1715
156023,5A888DC7A3AA300CC584D9862C5384A1,39183,11,18,7,109.55542,18.28208,1715
156034,875F4B80762D0E664890361D764F907D,60081,0,7,7,109.51097,18.22639,1556
156035,875F4B80762D0E664890361D764F907D,30571,7,18,11,109.50243,18.21861,1504
156036,875F4B80762D0E664890361D764F907D,60081,19,23,4,109.51097,18.22639,1556
156039,45FC4D7B7AEB1BB8222449DDC064C06B,31945,11,16,5,109.58021,18.29403,1817
156040,45FC4D7B7AEB1BB8222449DDC064C06B,30854,17,20,3,109.56889,18.27076,1763
156041,45FC4D7B7AEB1BB8222449DDC064C06B,31071,21,23,2,109.58257,18.28458,1815
156106,1B378B100EB2E1F18A0E8906C6FD4DA1,61011,1,2,1,109.60653,18.19076,1900
156108,1B378B100EB2E1F18A0E8906C6FD4DA1,61011,11,13,2,109.60653,18.19076,1900
156113,6F55ACFC3A2BD8567407A1426439CC11,38991,1,6,5,109.52681,18.30368,1618
156114,6F55ACFC3A2BD8567407A1426439CC11,60171,6,8,2,109.51292,18.30694,1569
156115,6F55ACFC3A2BD8567407A1426439CC11,30071,8,12,4,109.52819,18.30472,1619
156116,6F55ACFC3A2BD8567407A1426439CC11,60171,12,14,2,109.51292,18.30694,1569
156117,6F55ACFC3A2BD8567407A1426439CC11,30071,15,17,2,109.52819,18.30472,1619
156124,B330AB454B331A0CFDC38B66AEDE5BA8,60131,17,19,2,109.49819,18.24778,1509
156125,B330AB454B331A0CFDC38B66AEDE5BA8,60621,20,23,3,109.48354,18.27451,1464
156135,302C193EE9901423C2412C2BB087FCC7,60524,0,6,6,109.42951,18.28993,1216
156136,302C193EE9901423C2412C2BB087FCC7,30351,7,9,2,109.41701,18.29292,1217
156137,302C193EE9901423C2412C2BB087FCC7,31091,13,14,1,109.41201,18.31222,1170
156138,302C193EE9901423C2412C2BB087FCC7,30351,15,19,4,109.41701,18.29292,1217
156139,302C193EE9901423C2412C2BB087FCC7,31091,22,23,1,109.41201,18.31222,1170
156140,A9F97D2464709590426A157138F3C687,31931,0,6,6,109.54771,18.29403,1667
156141,A9F97D2464709590426A157138F3C687,39181,11,17,6,109.55153,18.28035,1715
156142,A9F97D2464709590426A157138F3C687,31931,19,23,4,109.54771,18.29403,1667
156166,A8E229AD359BAFAD8DE94B2EA508C4AD,38891,0,5,5,109.51486,18.24118,1558
156167,A8E229AD359BAFAD8DE94B2EA508C4AD,31261,5,7,2,109.51174,18.2466,1559
156168,A8E229AD359BAFAD8DE94B2EA508C4AD,31206,8,10,2,109.50819,18.23549,1507
156169,A8E229AD359BAFAD8DE94B2EA508C4AD,31181,12,13,1,109.50382,18.24813,1509
156170,A8E229AD359BAFAD8DE94B2EA508C4AD,31206,16,18,2,109.50819,18.23549,1507
156171,A8E229AD359BAFAD8DE94B2EA508C4AD,30731,19,20,1,109.50944,18.22306,1555
156172,A8E229AD359BAFAD8DE94B2EA508C4AD,31441,20,22,2,109.51181,18.24424,1559
156200,C17F2EF1DEA79C8C951E3013EE071B2C,31071,0,7,7,109.58257,18.28458,1815
156201,C17F2EF1DEA79C8C951E3013EE071B2C,30854,11,17,6,109.56889,18.27076,1763
156202,C17F2EF1DEA79C8C951E3013EE071B2C,31561,20,23,3,109.56792,18.28479,1765
156217,8E244E94833DBF281BCBFE2F4A36E102,30151,0,6,6,109.50986,18.25083,1560
156219,8E244E94833DBF281BCBFE2F4A36E102,60391,17,18,1,109.47667,18.28757,1416
156220,8E244E94833DBF281BCBFE2F4A36E102,60641,20,23,3,109.53854,18.2359,1657
156230,B80D6AB96D3D5CEE71A70ED25275F830,38951,0,1,1,109.48097,18.28868,1416
156231,B80D6AB96D3D5CEE71A70ED25275F830,38951,1,11,10,109.48097,18.28868,1416
156232,B80D6AB96D3D5CEE71A70ED25275F830,31531,15,17,2,109.49583,18.25972,1461
156233,B80D6AB96D3D5CEE71A70ED25275F830,38951,19,23,4,109.48097,18.28868,1416
156292,6256EC46A5EE081F3E479741B6BEAFA5,60501,0,7,7,109.48701,18.29021,1466
156293,6256EC46A5EE081F3E479741B6BEAFA5,30731,8,23,15,109.50944,18.22306,1555
156297,58E7368992E69F6E05A047BE8D6587D0,38251,0,9,9,109.49618,18.25493,1510
156298,58E7368992E69F6E05A047BE8D6587D0,31471,13,14,1,109.34583,18.29563,917
156299,58E7368992E69F6E05A047BE8D6587D0,38251,17,23,6,109.49618,18.25493,1510
156321,855D815DC19AA779325469411A9E7B8A,30251,3,8,5,109.50611,18.26653,1512
156322,855D815DC19AA779325469411A9E7B8A,38157,10,15,5,109.51483,18.26958,1563
156323,855D815DC19AA779325469411A9E7B8A,30251,16,17,1,109.50611,18.26653,1512
156333,D53608326657C140C9801171477BB48D,38171,18,20,2,109.50799,18.28139,1515
156334,D53608326657C140C9801171477BB48D,30771,20,23,3,109.49938,18.26042,1511
156356,E43761FEBE209371C105554567258124,31321,0,5,5,109.63799,18.23201,2007
156357,E43761FEBE209371C105554567258124,31931,6,9,3,109.54771,18.29403,1667
156358,E43761FEBE209371C105554567258124,30921,11,13,2,109.53903,18.29451,1667
156359,E43761FEBE209371C105554567258124,31931,13,14,1,109.54771,18.29403,1667
156360,E43761FEBE209371C105554567258124,31321,18,23,5,109.63799,18.23201,2007
156375,8621CFDF1B89A83351494618C53D033F,39181,1,3,2,109.55153,18.28035,1715
156376,8621CFDF1B89A83351494618C53D033F,31071,3,7,4,109.58257,18.28458,1815
156377,8621CFDF1B89A83351494618C53D033F,30854,9,10,1,109.56889,18.27076,1763
156378,8621CFDF1B89A83351494618C53D033F,39181,10,22,12,109.55153,18.28035,1715
156390,5D7EC4507F4E76B3D5B0735531A150FF,30731,2,14,12,109.50944,18.22306,1555
156391,5D7EC4507F4E76B3D5B0735531A150FF,30511,18,21,3,109.51069,18.24208,1558
156392,5D7EC4507F4E76B3D5B0735531A150FF,30731,22,23,1,109.50944,18.22306,1555
156436,22B987DE38F8C4435934FE5E6190C4A2,30441,12,14,2,109.64021,18.25424,2010
156437,22B987DE38F8C4435934FE5E6190C4A2,31571,16,19,3,109.61563,18.23326,1957
156442,EB291EA7E3235FF23960DA865075F183,39091,0,16,16,109.50097,18.25222,1510
156443,EB291EA7E3235FF23960DA865075F183,39151,18,19,1,109.49875,18.25097,1510
156444,EB291EA7E3235FF23960DA865075F183,60281,21,23,2,109.51743,18.25924,1561
156491,23DF3A4510347EF32640F77C0A9AA1C8,30371,1,12,11,109.51,18.24771,1559
156492,23DF3A4510347EF32640F77C0A9AA1C8,31821,16,19,3,109.51181,18.24924,1559
156493,23DF3A4510347EF32640F77C0A9AA1C8,60281,20,23,3,109.51743,18.25924,1561
156510,E9F64FD67E39C3E2C15C20715338A941,31931,0,12,12,109.54771,18.29403,1667
156511,E9F64FD67E39C3E2C15C20715338A941,30921,14,22,8,109.53903,18.29451,1667
156535,2E29BE7E21F829BB8E4505964B146371,30324,7,14,7,109.50326,18.29257,1517
156536,2E29BE7E21F829BB8E4505964B146371,30321,15,17,2,109.49563,18.29611,1467
156553,B39D2F94395224891CE3AFBCC24B5EAD,30661,7,12,5,109.37028,18.24361,1008
156554,B39D2F94395224891CE3AFBCC24B5EAD,60411,12,20,8,109.32514,18.30854,869
156557,13C882817D5EF3329D8612AEE7E0F34D,31864,0,17,17,109.49014,18.28333,1465
156558,13C882817D5EF3329D8612AEE7E0F34D,60381,20,21,1,109.5241,18.22458,1605
156561,8F3DE08315D720DC64DC898C5903196E,31071,5,6,1,109.58257,18.28458,1815
156562,8F3DE08315D720DC64DC898C5903196E,30854,6,17,11,109.56889,18.27076,1763
156563,8F3DE08315D720DC64DC898C5903196E,31071,19,21,2,109.58257,18.28458,1815
156592,878FC5EBB1B28FAABA6E6BFD01664318,30251,0,16,16,109.50611,18.26653,1512
156593,878FC5EBB1B28FAABA6E6BFD01664318,30711,20,21,1,109.50271,18.25347,1510
156637,BDDA3D7B24B34BCCEA8CD647D80A3FAF,30191,2,3,1,109.50361,18.22701,1506
156638,BDDA3D7B24B34BCCEA8CD647D80A3FAF,30181,5,8,3,109.51597,18.23313,1557
156639,BDDA3D7B24B34BCCEA8CD647D80A3FAF,31201,8,9,1,109.51042,18.23819,1558
156640,BDDA3D7B24B34BCCEA8CD647D80A3FAF,30181,10,11,1,109.51597,18.23313,1557
156641,BDDA3D7B24B34BCCEA8CD647D80A3FAF,30711,19,20,1,109.50271,18.25347,1510
156642,BDDA3D7B24B34BCCEA8CD647D80A3FAF,38105,22,23,1,109.40299,18.29229,1117
156654,FA6D7510012E571D09E23E75BE9DD4E6,60441,1,6,5,109.46792,18.28604,1366
156655,FA6D7510012E571D09E23E75BE9DD4E6,38094,8,9,1,109.45403,18.28778,1316
156656,FA6D7510012E571D09E23E75BE9DD4E6,33481,10,16,6,109.67278,18.41278,2187
156717,706B8E0F0F5D1C9FC2F8EBB2574EE89F,39154,8,21,13,109.50201,18.25681,1511
156718,706B8E0F0F5D1C9FC2F8EBB2574EE89F,30911,21,22,1,109.50493,18.26181,1511
156719,706B8E0F0F5D1C9FC2F8EBB2574EE89F,60201,22,23,1,109.5041,18.2509,1510
156727,EBD16061EA20EE33D9344D33735E5205,38891,0,5,5,109.51486,18.24118,1558
156728,EBD16061EA20EE33D9344D33735E5205,31201,5,6,1,109.51042,18.23819,1558
156729,EBD16061EA20EE33D9344D33735E5205,38291,10,12,2,109.51618,18.24313,1558
156730,EBD16061EA20EE33D9344D33735E5205,31201,13,14,1,109.51042,18.23819,1558
156731,EBD16061EA20EE33D9344D33735E5205,31821,14,15,1,109.51181,18.24924,1559
156732,EBD16061EA20EE33D9344D33735E5205,31201,17,19,2,109.51042,18.23819,1558
156733,EBD16061EA20EE33D9344D33735E5205,38891,21,23,2,109.51486,18.24118,1558
156743,35EDAC48C13C8606D4CE310CA7143DD0,31381,11,16,5,109.1375,18.36833,129
156744,35EDAC48C13C8606D4CE310CA7143DD0,31251,17,20,3,109.18528,18.2975,317
156767,909FBB0C84910641E7440FBAD40E8C52,39183,0,14,14,109.55542,18.28208,1715
156768,909FBB0C84910641E7440FBAD40E8C52,31561,16,17,1,109.56792,18.28479,1765
156769,909FBB0C84910641E7440FBAD40E8C52,39183,18,23,5,109.55542,18.28208,1715
156779,20CCCB6B429AF607F53CD26A27B9CFC5,60291,0,5,5,109.50826,18.24639,1509
156780,20CCCB6B429AF607F53CD26A27B9CFC5,30084,9,10,1,109.50118,18.26972,1513
156781,20CCCB6B429AF607F53CD26A27B9CFC5,31931,12,13,1,109.54771,18.29403,1667
156782,20CCCB6B429AF607F53CD26A27B9CFC5,60241,13,14,1,109.53319,18.28667,1616
156788,4879DE9CACF93CF08E9DC08004A43027,30741,14,15,1,109.49833,18.28681,1516
156789,4879DE9CACF93CF08E9DC08004A43027,60472,16,18,2,109.46625,18.29542,1367
156790,4879DE9CACF93CF08E9DC08004A43027,30721,19,23,4,109.51597,18.28257,1565
156797,5C8B80BEC63DDEFB9892A030CF73AEB3,31071,2,3,1,109.58257,18.28458,1815
156798,5C8B80BEC63DDEFB9892A030CF73AEB3,30854,5,8,3,109.56889,18.27076,1763
156839,50942B7AD3E1DC9B7C014E537BF17F88,39111,0,1,1,109.5191,18.22597,1555
156840,50942B7AD3E1DC9B7C014E537BF17F88,31391,3,4,1,109.50382,18.24285,1508
156841,50942B7AD3E1DC9B7C014E537BF17F88,31521,6,7,1,109.51458,18.22542,1555
156842,50942B7AD3E1DC9B7C014E537BF17F88,31781,10,11,1,109.19847,18.2975,367
156843,50942B7AD3E1DC9B7C014E537BF17F88,31471,14,15,1,109.34583,18.29563,917
156853,ACDEAAF45B65DE48CF80A48DBD3C775E,30854,0,10,10,109.56889,18.27076,1763
156854,ACDEAAF45B65DE48CF80A48DBD3C775E,31071,11,13,2,109.58257,18.28458,1815
156855,ACDEAAF45B65DE48CF80A48DBD3C775E,30854,14,16,2,109.56889,18.27076,1763
156856,ACDEAAF45B65DE48CF80A48DBD3C775E,31071,17,18,1,109.58257,18.28458,1815
156857,ACDEAAF45B65DE48CF80A48DBD3C775E,30854,19,20,1,109.56889,18.27076,1763
156868,5EBEA276FCB4A19AC5C987F5C7CC8908,60401,0,7,7,109.47444,18.27583,1414
156869,5EBEA276FCB4A19AC5C987F5C7CC8908,38361,10,11,1,109.43667,18.29201,1267
156905,CB44FE843228066922623C4A2B161A4C,60504,0,13,13,109.47917,18.28903,1416
156906,CB44FE843228066922623C4A2B161A4C,30081,13,17,4,109.50243,18.26632,1512
156907,CB44FE843228066922623C4A2B161A4C,30251,21,22,1,109.50611,18.26653,1512
156915,0312B43ACF9ED1D8304E325E851AEE29,31561,7,10,3,109.56792,18.28479,1765
156916,0312B43ACF9ED1D8304E325E851AEE29,30851,10,11,1,109.5616,18.27396,1713
156917,0312B43ACF9ED1D8304E325E851AEE29,31561,11,15,4,109.56792,18.28479,1765
156918,0312B43ACF9ED1D8304E325E851AEE29,30851,15,17,2,109.5616,18.27396,1713
156919,0312B43ACF9ED1D8304E325E851AEE29,31561,17,19,2,109.56792,18.28479,1765
156920,0312B43ACF9ED1D8304E325E851AEE29,30851,20,21,1,109.5616,18.27396,1713
156952,383D937DE514A0EC375F222FA3476E15,31031,0,10,10,109.49979,18.25382,1510
157061,0B1CC3266C9F341870D0B135F2AF352E,60472,2,3,1,109.46625,18.29542,1367
157062,0B1CC3266C9F341870D0B135F2AF352E,30111,4,6,2,109.47583,18.30542,1419
157063,0B1CC3266C9F341870D0B135F2AF352E,60441,7,8,1,109.46792,18.28604,1366
157064,0B1CC3266C9F341870D0B135F2AF352E,31471,12,13,1,109.34583,18.29563,917
157090,0C8D15C0488D521680F0DE3A28CFE111,30701,0,1,1,109.59313,18.32007,1871
157091,0C8D15C0488D521680F0DE3A28CFE111,31811,4,6,2,109.54201,18.31806,1671
157092,0C8D15C0488D521680F0DE3A28CFE111,30701,7,14,7,109.59313,18.32007,1871
157093,0C8D15C0488D521680F0DE3A28CFE111,31091,16,17,1,109.41201,18.31222,1170
157094,0C8D15C0488D521680F0DE3A28CFE111,30701,20,23,3,109.59313,18.32007,1871
157104,CA3896FB33E9BC68E91955EDFF5D709B,30854,14,15,1,109.56889,18.27076,1763
157105,CA3896FB33E9BC68E91955EDFF5D709B,31821,19,21,2,109.51181,18.24924,1559
157120,45CCFCD3EBDF941E1C92B70ED06E8B5E,30854,0,12,12,109.56889,18.27076,1763
157121,45CCFCD3EBDF941E1C92B70ED06E8B5E,31071,12,13,1,109.58257,18.28458,1815
157122,45CCFCD3EBDF941E1C92B70ED06E8B5E,30854,15,16,1,109.56889,18.27076,1763
157123,45CCFCD3EBDF941E1C92B70ED06E8B5E,31521,19,21,2,109.51458,18.22542,1555
157124,45CCFCD3EBDF941E1C92B70ED06E8B5E,30854,22,23,1,109.56889,18.27076,1763
157154,998A01460E3F739CE0004E00240DDFFF,31521,0,9,9,109.51458,18.22542,1555
157155,998A01460E3F739CE0004E00240DDFFF,38361,14,18,4,109.43667,18.29201,1267
157156,998A01460E3F739CE0004E00240DDFFF,31701,19,23,4,109.44132,18.28833,1266
157157,F8B0DC789B112F08EAF5FF1027906309,39183,11,13,2,109.55542,18.28208,1715
157158,F8B0DC789B112F08EAF5FF1027906309,30854,14,16,2,109.56889,18.27076,1763
157159,F8B0DC789B112F08EAF5FF1027906309,38071,17,19,2,109.40722,18.30938,1169
157165,6B806948BC9187A91D033B4096721B00,30854,1,5,4,109.56889,18.27076,1763
157166,6B806948BC9187A91D033B4096721B00,30851,10,11,1,109.5616,18.27396,1713
157167,6B806948BC9187A91D033B4096721B00,31071,11,19,8,109.58257,18.28458,1815
157168,DE5024DB59D5BF6AE5857A85EB7680EA,30854,0,13,13,109.56889,18.27076,1763
157169,DE5024DB59D5BF6AE5857A85EB7680EA,31221,16,17,1,109.61333,18.26833,1913
157170,DE5024DB59D5BF6AE5857A85EB7680EA,30854,18,23,5,109.56889,18.27076,1763
157181,933C30058B1CA246EC59609197D7CAAB,31071,12,23,11,109.58257,18.28458,1815
157238,25419DDF60017295279E872003D6F9C0,60501,0,12,12,109.48701,18.29021,1466
157259,E292D83051830D054E89D209EEABA4B9,39183,1,6,5,109.55542,18.28208,1715
157260,E292D83051830D054E89D209EEABA4B9,31561,8,9,1,109.56792,18.28479,1765
157261,E292D83051830D054E89D209EEABA4B9,39183,9,16,7,109.55542,18.28208,1715
157262,E292D83051830D054E89D209EEABA4B9,31071,20,22,2,109.58257,18.28458,1815
157274,886165CD4CCF3674607C202B8ADD28B5,31781,13,15,2,109.19847,18.2975,367
157275,886165CD4CCF3674607C202B8ADD28B5,31031,17,18,1,109.49979,18.25382,1510
157347,2B8C748A18FA7D08D4335AD7C9DEF01B,31761,0,6,6,109.60521,18.27965,1914
157348,2B8C748A18FA7D08D4335AD7C9DEF01B,30851,10,14,4,109.5616,18.27396,1713
157349,2B8C748A18FA7D08D4335AD7C9DEF01B,31761,18,23,5,109.60521,18.27965,1914
157356,5BAA9C7C807C2E83985768BCEFDEE04A,31231,4,9,5,109.42597,18.29292,1217
157357,5BAA9C7C807C2E83985768BCEFDEE04A,39091,13,14,1,109.50097,18.25222,1510
157358,5BAA9C7C807C2E83985768BCEFDEE04A,30661,19,23,4,109.37028,18.24361,1008
157359,BAFDD3A022A674BA6CCC93E365FAFC36,30201,0,6,6,109.4909,18.26465,1462
157399,DA10676C4DA702E02A2C3FFFAC40ABA2,39183,16,17,1,109.55542,18.28208,1715
157400,DA10676C4DA702E02A2C3FFFAC40ABA2,31561,17,23,6,109.56792,18.28479,1765
157457,AD608A919061B1C684914F8654FB2493,30651,5,6,1,109.42611,18.385,1232
157458,AD608A919061B1C684914F8654FB2493,60041,8,9,1,109.39889,18.31944,1121
157459,AD608A919061B1C684914F8654FB2493,31231,9,15,6,109.42597,18.29292,1217
157460,AD608A919061B1C684914F8654FB2493,30651,17,23,6,109.42611,18.385,1232
157465,0133DDFFB5CECBB261CEDEF10A82D50B,30854,1,11,10,109.56889,18.27076,1763
157466,0133DDFFB5CECBB261CEDEF10A82D50B,31071,11,14,3,109.58257,18.28458,1815
157467,0133DDFFB5CECBB261CEDEF10A82D50B,31561,14,15,1,109.56792,18.28479,1765
157468,0133DDFFB5CECBB261CEDEF10A82D50B,30854,19,21,2,109.56889,18.27076,1763
157500,28B366167501D3E270BF1F5EDB4474EC,30854,10,13,3,109.56889,18.27076,1763
157501,28B366167501D3E270BF1F5EDB4474EC,31561,16,19,3,109.56792,18.28479,1765
157529,56C8C781972E8BFAF8A768A19AD7F590,38127,0,7,7,109.50833,18.27222,1513
157533,56C8C781972E8BFAF8A768A19AD7F590,38127,18,23,5,109.50833,18.27222,1513
157550,C709D01469E0800AF998DFAF42105CDC,60631,0,3,3,109.57778,18.27583,1814
157551,C709D01469E0800AF998DFAF42105CDC,30854,4,5,1,109.56889,18.27076,1763
157552,C709D01469E0800AF998DFAF42105CDC,31561,5,6,1,109.56792,18.28479,1765
157553,C709D01469E0800AF998DFAF42105CDC,30854,8,10,2,109.56889,18.27076,1763
157554,C709D01469E0800AF998DFAF42105CDC,31561,13,16,3,109.56792,18.28479,1765
157555,C709D01469E0800AF998DFAF42105CDC,30854,17,19,2,109.56889,18.27076,1763
157556,C709D01469E0800AF998DFAF42105CDC,60631,20,23,3,109.57778,18.27583,1814
157569,173CD7A2B7B334BC53A50A1D248FBCFE,30854,7,17,10,109.56889,18.27076,1763
157570,173CD7A2B7B334BC53A50A1D248FBCFE,31071,19,20,1,109.58257,18.28458,1815
157571,173CD7A2B7B334BC53A50A1D248FBCFE,30854,20,22,2,109.56889,18.27076,1763
157572,451E2BF48CD7B253EB0892324E679BCC,60281,7,17,10,109.51743,18.25924,1561
157573,451E2BF48CD7B253EB0892324E679BCC,38297,19,21,2,109.52576,18.24965,1609
157574,451E2BF48CD7B253EB0892324E679BCC,31461,22,23,1,109.5091,18.25389,1510
157607,8883DF5E66B5FC284A8EF97DE8EAAAB3,60214,13,14,1,109.63104,18.24493,2009
157608,8883DF5E66B5FC284A8EF97DE8EAAAB3,30581,15,16,1,109.62257,18.24951,1959
157630,0E5593A90D661690BE3DAAA17AD936E2,38157,0,1,1,109.51483,18.26958,1563
157631,0E5593A90D661690BE3DAAA17AD936E2,38127,3,6,3,109.50833,18.27222,1513
157632,0E5593A90D661690BE3DAAA17AD936E2,38157,7,9,2,109.51483,18.26958,1563
157633,0E5593A90D661690BE3DAAA17AD936E2,30291,13,18,5,109.50403,18.27028,1513
157637,DDE77D3A656666992FC3458B84010D43,39183,1,4,3,109.55542,18.28208,1715
157638,DDE77D3A656666992FC3458B84010D43,31561,6,20,14,109.56792,18.28479,1765
157675,EDAE3160B50CE140907F5C4DAEEDDA8F,30201,11,17,6,109.4909,18.26465,1462
157676,EDAE3160B50CE140907F5C4DAEEDDA8F,31081,18,19,1,109.44639,18.30181,1318
157677,EDAE3160B50CE140907F5C4DAEEDDA8F,31091,20,21,1,109.41201,18.31222,1170
157678,C8B662CAEBDC359FAD2D68CB046F51F0,30681,0,7,7,109.48493,18.26917,1463
157679,C8B662CAEBDC359FAD2D68CB046F51F0,60401,7,9,2,109.47444,18.27583,1414
157680,C8B662CAEBDC359FAD2D68CB046F51F0,31781,12,15,3,109.19847,18.2975,367
157681,C8B662CAEBDC359FAD2D68CB046F51F0,30681,19,23,4,109.48493,18.26917,1463
157688,8FAAC7EA21AE7BB6F52A4D0F285944CD,38721,0,8,8,109.50368,18.27542,1514
157689,8FAAC7EA21AE7BB6F52A4D0F285944CD,30281,11,16,5,109.50597,18.27583,1514
157690,8FAAC7EA21AE7BB6F52A4D0F285944CD,39091,18,20,2,109.50097,18.25222,1510
157691,8FAAC7EA21AE7BB6F52A4D0F285944CD,30281,21,23,2,109.50597,18.27583,1514
157715,F6A1EBB84FE583E84185C423218578F5,31561,0,6,6,109.56792,18.28479,1765
157716,F6A1EBB84FE583E84185C423218578F5,39091,11,12,1,109.50097,18.25222,1510
157717,F6A1EBB84FE583E84185C423218578F5,31561,14,23,9,109.56792,18.28479,1765
157758,0E1B3CFC64EBB658DA96D0DCA834701E,61011,0,14,14,109.60653,18.19076,1900
157760,0E1B3CFC64EBB658DA96D0DCA834701E,61011,18,23,5,109.60653,18.19076,1900
157775,CB1C8502149DACE0B32B2F7416279EF2,30854,10,11,1,109.56889,18.27076,1763
157793,8C7667B6277A3C193B50CC18C706780E,30951,10,13,3,109.56208,18.25667,1761
157794,8C7667B6277A3C193B50CC18C706780E,31421,16,17,1,109.55382,18.22347,1705
157795,8C7667B6277A3C193B50CC18C706780E,60581,18,23,5,109.59785,18.29931,1868
157820,D39D64452E6BBEF7B3056CA239E1B86E,30854,0,1,1,109.56889,18.27076,1763
157821,D39D64452E6BBEF7B3056CA239E1B86E,30851,1,5,4,109.5616,18.27396,1713
157822,D39D64452E6BBEF7B3056CA239E1B86E,30854,7,14,7,109.56889,18.27076,1763
157823,D39D64452E6BBEF7B3056CA239E1B86E,31561,14,15,1,109.56792,18.28479,1765
157824,D39D64452E6BBEF7B3056CA239E1B86E,30854,16,23,7,109.56889,18.27076,1763
157837,40C57F24FE0409ABB752B2031C349577,38951,0,8,8,109.48097,18.28868,1416
157838,40C57F24FE0409ABB752B2031C349577,39041,8,10,2,109.40021,18.29278,1117
157839,40C57F24FE0409ABB752B2031C349577,38951,11,23,12,109.48097,18.28868,1416
157871,D6B54C643B88B86782DC30A38AD291FD,31561,0,9,9,109.56792,18.28479,1765
157872,D6B54C643B88B86782DC30A38AD291FD,30854,12,17,5,109.56889,18.27076,1763
157873,D6B54C643B88B86782DC30A38AD291FD,60221,18,21,3,109.52569,18.29188,1616
157930,5EB757C8918F704B5295B0BDE01D6841,38754,11,13,2,109.74667,18.37382,2430
157945,CD576F1C1CDFB89E6A99A20E65927346,31561,3,4,1,109.56792,18.28479,1765
157946,CD576F1C1CDFB89E6A99A20E65927346,30854,9,22,13,109.56889,18.27076,1763
157968,FB0C3DBC0AB121F552294646CC7B81E6,60087,0,7,7,109.50688,18.22299,1505
157969,FB0C3DBC0AB121F552294646CC7B81E6,30961,10,17,7,109.74042,18.37903,2431
157970,FB0C3DBC0AB121F552294646CC7B81E6,30371,18,20,2,109.51,18.24771,1559
157971,FB0C3DBC0AB121F552294646CC7B81E6,60121,22,23,1,109.74507,18.37472,2430
157983,15B71EBD44CAF1ECFDFB1D93C0E3A395,31161,0,15,15,109.70229,18.31361,2270
157984,15B71EBD44CAF1ECFDFB1D93C0E3A395,31861,18,19,1,109.49042,18.27549,1464
157987,B0D7DAF8D84656FF4C7229ABB8EA1350,31561,2,7,5,109.56792,18.28479,1765
157988,B0D7DAF8D84656FF4C7229ABB8EA1350,30854,9,13,4,109.56889,18.27076,1763
158000,B712327B6033C61F37801CFD6DAC08AD,31951,3,5,2,109.52174,18.30299,1568
158001,B712327B6033C61F37801CFD6DAC08AD,38484,7,14,7,109.53028,18.31528,1620
158002,B712327B6033C61F37801CFD6DAC08AD,38484,15,18,3,109.53028,18.31528,1620
158003,B712327B6033C61F37801CFD6DAC08AD,38484,20,22,2,109.53028,18.31528,1620
158004,B712327B6033C61F37801CFD6DAC08AD,31951,22,23,1,109.52174,18.30299,1568
158016,A7B3BDD8DC79485BA41EC7F220A41345,30854,0,1,1,109.56889,18.27076,1763
158017,A7B3BDD8DC79485BA41EC7F220A41345,60631,3,10,7,109.57778,18.27583,1814
158018,A7B3BDD8DC79485BA41EC7F220A41345,30854,12,18,6,109.56889,18.27076,1763
158019,A7B3BDD8DC79485BA41EC7F220A41345,30421,21,23,2,109.50021,18.25861,1511
158020,63FBAC0202144B00077561285E6A7F87,30821,0,5,5,109.43681,18.33639,1274
158021,63FBAC0202144B00077561285E6A7F87,30651,8,9,1,109.42611,18.385,1232
158022,63FBAC0202144B00077561285E6A7F87,30821,10,23,13,109.43681,18.33639,1274
158031,B81C37BC332023335C0BA8EE3FC6F3B6,31031,17,18,1,109.49979,18.25382,1510
158032,B81C37BC332023335C0BA8EE3FC6F3B6,30361,18,20,2,109.50347,18.24,1508
158033,B81C37BC332023335C0BA8EE3FC6F3B6,31231,21,23,2,109.42597,18.29292,1217
158049,EB51257A99E5D8C5B96E616F99FA4BE1,31061,0,8,8,109.53333,18.23257,1607
158050,EB51257A99E5D8C5B96E616F99FA4BE1,38325,13,14,1,109.39792,18.2909,1116
158051,EB51257A99E5D8C5B96E616F99FA4BE1,30571,15,16,1,109.50243,18.21861,1504
158052,EB51257A99E5D8C5B96E616F99FA4BE1,30361,20,21,1,109.50347,18.24,1508
158102,225EDE82328108AFB3E7EE610CA3F074,31931,0,18,18,109.54771,18.29403,1667
158103,225EDE82328108AFB3E7EE610CA3F074,60371,18,21,3,109.53063,18.30056,1618
158141,5533066D8871087CCD481B88DD73EF7D,31361,0,6,6,109.47417,18.28292,1415
158142,5533066D8871087CCD481B88DD73EF7D,60441,7,13,6,109.46792,18.28604,1366
158143,5533066D8871087CCD481B88DD73EF7D,60401,13,14,1,109.47444,18.27583,1414
158144,5533066D8871087CCD481B88DD73EF7D,31361,17,21,4,109.47417,18.28292,1415
158182,7FF3C6569A3990C03CAF6C52D3C8BC6C,60241,11,13,2,109.53319,18.28667,1616
158183,7FF3C6569A3990C03CAF6C52D3C8BC6C,30921,15,23,8,109.53903,18.29451,1667
158242,192815485DBBC485508837480A81E25C,30151,0,7,7,109.50986,18.25083,1560
158243,192815485DBBC485508837480A81E25C,30711,7,9,2,109.50271,18.25347,1510
158244,192815485DBBC485508837480A81E25C,60381,9,10,1,109.5241,18.22458,1605
158245,192815485DBBC485508837480A81E25C,31461,11,15,4,109.5091,18.25389,1510
158246,192815485DBBC485508837480A81E25C,30051,18,22,4,109.48917,18.21215,1453
158247,9D08F64A3A6AF6A3D8E4936FA0DD307A,31471,17,19,2,109.34583,18.29563,917
158248,9D08F64A3A6AF6A3D8E4936FA0DD307A,38903,21,23,2,109.39229,18.29243,1117
158279,B45693D5B184478846DA7E564CBD0CD0,38052,9,12,3,109.62618,18.23042,1956
158280,B45693D5B184478846DA7E564CBD0CD0,31071,14,15,1,109.58257,18.28458,1815
158314,D7B221E6999CDA2B49CD9F659205E39E,60661,0,8,8,109.548,18.2377,1657
158315,D7B221E6999CDA2B49CD9F659205E39E,31421,9,11,2,109.55382,18.22347,1705
158316,D7B221E6999CDA2B49CD9F659205E39E,60661,12,13,1,109.548,18.2377,1657
158317,D7B221E6999CDA2B49CD9F659205E39E,31201,19,20,1,109.51042,18.23819,1558
158318,D7B221E6999CDA2B49CD9F659205E39E,60661,22,23,1,109.548,18.2377,1657
158334,0F23B6E4E3B228AFE54C52B9B3D593D7,60551,0,6,6,109.42722,18.30111,1218
158335,0F23B6E4E3B228AFE54C52B9B3D593D7,60524,6,8,2,109.42951,18.28993,1216
158336,0F23B6E4E3B228AFE54C52B9B3D593D7,60551,9,22,13,109.42722,18.30111,1218
158346,A02F58F4D887D8C7AFCC5C3BF1733917,31461,15,16,1,109.5091,18.25389,1510
158347,A02F58F4D887D8C7AFCC5C3BF1733917,31261,19,21,2,109.51174,18.2466,1559
158348,A02F58F4D887D8C7AFCC5C3BF1733917,38291,21,22,1,109.51618,18.24313,1558
158367,A928E9F6C796FE1A60807BA003DE87BB,39183,12,14,2,109.55542,18.28208,1715
158368,A928E9F6C796FE1A60807BA003DE87BB,30854,16,18,2,109.56889,18.27076,1763
158369,A928E9F6C796FE1A60807BA003DE87BB,31071,18,19,1,109.58257,18.28458,1815
158370,A928E9F6C796FE1A60807BA003DE87BB,30854,19,23,4,109.56889,18.27076,1763
158376,975CB35586D2D95A387E2AA86A5AB719,31351,0,9,9,109.4959,18.28417,1465
158377,975CB35586D2D95A387E2AA86A5AB719,30391,10,11,1,109.4975,18.27118,1513
158378,975CB35586D2D95A387E2AA86A5AB719,30671,12,23,11,109.43611,18.30139,1268
158390,80B72DFF870E58099F17893CA96A269C,31071,0,16,16,109.58257,18.28458,1815
158391,80B72DFF870E58099F17893CA96A269C,31945,18,19,1,109.58021,18.29403,1817
158401,3F320FCC97654DBDACE66BB1BF09E301,30084,19,20,1,109.50118,18.26972,1513
158402,3F320FCC97654DBDACE66BB1BF09E301,38061,20,21,1,109.50597,18.23118,1506
158431,068048E7A110C24CC84B03CCF16511AC,31531,20,21,1,109.49583,18.25972,1461
158432,068048E7A110C24CC84B03CCF16511AC,38251,22,23,1,109.49618,18.25493,1510
158441,A549C024E6F63EDBD3DC866F10DB11CE,31071,0,5,5,109.58257,18.28458,1815
158442,A549C024E6F63EDBD3DC866F10DB11CE,30854,7,18,11,109.56889,18.27076,1763
158443,A549C024E6F63EDBD3DC866F10DB11CE,31071,20,22,2,109.58257,18.28458,1815
158452,33DACB62584DBB9731FA36EFE0B72692,31071,5,8,3,109.58257,18.28458,1815
158453,33DACB62584DBB9731FA36EFE0B72692,30854,10,20,10,109.56889,18.27076,1763
158454,70A62761FE79F922D082380DA7747243,30854,1,10,9,109.56889,18.27076,1763
158455,70A62761FE79F922D082380DA7747243,38754,14,16,2,109.74667,18.37382,2430
158475,A749E400BFD3B5908671E939EC104DEE,30854,1,2,1,109.56889,18.27076,1763
158476,A749E400BFD3B5908671E939EC104DEE,31071,4,7,3,109.58257,18.28458,1815
158477,A749E400BFD3B5908671E939EC104DEE,30854,10,22,12,109.56889,18.27076,1763
158485,E4B522EF4348156010E5C578EC13D60F,30854,0,8,8,109.56889,18.27076,1763
158486,E4B522EF4348156010E5C578EC13D60F,60361,11,13,2,109.51938,18.29681,1567
158487,E4B522EF4348156010E5C578EC13D60F,38991,18,19,1,109.52681,18.30368,1618
158488,E4B522EF4348156010E5C578EC13D60F,30191,20,22,2,109.50361,18.22701,1506
158489,F25102D4BE48A66B8AE50787215C5331,31181,0,13,13,109.50382,18.24813,1509
158490,F25102D4BE48A66B8AE50787215C5331,31181,14,23,9,109.50382,18.24813,1509
158495,9AF351B3CC27394DFED45513F0E32162,30951,8,10,2,109.56208,18.25667,1761
158496,9AF351B3CC27394DFED45513F0E32162,31551,11,13,2,109.55868,18.24222,1708
158497,9AF351B3CC27394DFED45513F0E32162,30851,13,14,1,109.5616,18.27396,1713
158498,9AF351B3CC27394DFED45513F0E32162,31551,15,16,1,109.55868,18.24222,1708
158499,560794A44CA17A43FA34D0FA6C339747,31071,0,2,2,109.58257,18.28458,1815
158500,560794A44CA17A43FA34D0FA6C339747,30854,3,10,7,109.56889,18.27076,1763
158501,560794A44CA17A43FA34D0FA6C339747,31071,11,12,1,109.58257,18.28458,1815
158510,D090D23BEAB243AAF74CB3648E81F65B,30851,3,6,3,109.5616,18.27396,1713
158511,D090D23BEAB243AAF74CB3648E81F65B,31561,8,21,13,109.56792,18.28479,1765
158512,DA759AC2EBBA8078FBC390D09D5C4EC7,31071,0,6,6,109.58257,18.28458,1815
158513,DA759AC2EBBA8078FBC390D09D5C4EC7,30854,9,16,7,109.56889,18.27076,1763
158514,DA759AC2EBBA8078FBC390D09D5C4EC7,31071,17,19,2,109.58257,18.28458,1815
158515,DA759AC2EBBA8078FBC390D09D5C4EC7,30854,20,21,1,109.56889,18.27076,1763
158516,608A55C14BAB2A5B627ACC1F39B89FB6,31945,3,7,4,109.58021,18.29403,1817
158517,608A55C14BAB2A5B627ACC1F39B89FB6,30854,7,18,11,109.56889,18.27076,1763
158518,608A55C14BAB2A5B627ACC1F39B89FB6,31945,20,22,2,109.58021,18.29403,1817
158526,7BF5A8A20737728F6EEBC1B96BC6C752,38094,13,17,4,109.45403,18.28778,1316
158527,7BF5A8A20737728F6EEBC1B96BC6C752,31021,20,23,3,109.49021,18.27,1463
158547,52820FDF38F5A08FADB7112AE77AAA8C,39151,0,16,16,109.49875,18.25097,1510
158548,52820FDF38F5A08FADB7112AE77AAA8C,31031,19,21,2,109.49979,18.25382,1510
158549,52820FDF38F5A08FADB7112AE77AAA8C,60201,21,22,1,109.5041,18.2509,1510
158550,4C0037DB2C07F7F329CC1D9E10D614E3,60311,1,2,1,109.52097,18.24319,1558
158551,4C0037DB2C07F7F329CC1D9E10D614E3,38297,6,7,1,109.52576,18.24965,1609
158552,4C0037DB2C07F7F329CC1D9E10D614E3,60281,11,15,4,109.51743,18.25924,1561
158553,4C0037DB2C07F7F329CC1D9E10D614E3,30771,18,19,1,109.49938,18.26042,1511
158565,28413CB0160B68347E92144BE214EF48,60381,17,18,1,109.5241,18.22458,1605
158566,28413CB0160B68347E92144BE214EF48,30181,19,20,1,109.51597,18.23313,1557
158578,D75F3D28EEDDC3AAB22F587F99A79102,30854,0,6,6,109.56889,18.27076,1763
158579,D75F3D28EEDDC3AAB22F587F99A79102,31071,7,10,3,109.58257,18.28458,1815
158580,D75F3D28EEDDC3AAB22F587F99A79102,30854,10,23,13,109.56889,18.27076,1763
158614,3E01B14B28C0FDBF8BB343D61C8AA7D8,60361,11,14,3,109.51938,18.29681,1567
158615,3E01B14B28C0FDBF8BB343D61C8AA7D8,31931,15,17,2,109.54771,18.29403,1667
158616,3E01B14B28C0FDBF8BB343D61C8AA7D8,60241,18,20,2,109.53319,18.28667,1616
158617,3E01B14B28C0FDBF8BB343D61C8AA7D8,60331,21,23,2,109.505,18.26507,1512
158627,6FC418E3C4CF83240DA2FD9B60CEEA6E,30151,0,1,1,109.50986,18.25083,1560
158628,6FC418E3C4CF83240DA2FD9B60CEEA6E,31821,2,3,1,109.51181,18.24924,1559
158629,6FC418E3C4CF83240DA2FD9B60CEEA6E,30151,4,6,2,109.50986,18.25083,1560
158630,6FC418E3C4CF83240DA2FD9B60CEEA6E,30151,6,14,8,109.50986,18.25083,1560
158631,6FC418E3C4CF83240DA2FD9B60CEEA6E,31521,18,21,3,109.51458,18.22542,1555
158632,6FC418E3C4CF83240DA2FD9B60CEEA6E,30151,21,23,2,109.50986,18.25083,1560
158633,8920C93432771D8645B969281AC5EB63,30661,13,15,2,109.37028,18.24361,1008
158634,8920C93432771D8645B969281AC5EB63,30361,16,23,7,109.50347,18.24,1508
158658,963B5F4C98446446023B8ED177B869B3,31561,14,15,1,109.56792,18.28479,1765
158659,963B5F4C98446446023B8ED177B869B3,60361,19,23,4,109.51938,18.29681,1567
158660,C61360C6C8202A54143E165C2C08120B,30951,1,2,1,109.56208,18.25667,1761
158661,C61360C6C8202A54143E165C2C08120B,30232,2,4,2,109.6191,18.31701,1971
158662,C61360C6C8202A54143E165C2C08120B,30951,4,10,6,109.56208,18.25667,1761
158692,66B36EAB2804138C84FF096B3B06E748,30421,6,7,1,109.50021,18.25861,1511
158693,66B36EAB2804138C84FF096B3B06E748,30711,7,23,16,109.50271,18.25347,1510
158709,065F1687C35F3C827A2EA4A378A0E2C6,30951,0,6,6,109.56208,18.25667,1761
158710,065F1687C35F3C827A2EA4A378A0E2C6,30851,9,12,3,109.5616,18.27396,1713
158733,BD24F3225C20924188793107A437125E,60524,0,3,3,109.42951,18.28993,1216
158734,BD24F3225C20924188793107A437125E,30351,3,8,5,109.41701,18.29292,1217
158735,BD24F3225C20924188793107A437125E,31145,9,11,2,109.20431,18.30479,369
158736,BD24F3225C20924188793107A437125E,31471,13,14,1,109.34583,18.29563,917
158737,BD24F3225C20924188793107A437125E,60524,19,20,1,109.42951,18.28993,1216
158744,31953E35176E90848BE35F2C91BAE76A,31521,0,14,14,109.51458,18.22542,1555
158745,31953E35176E90848BE35F2C91BAE76A,60381,14,17,3,109.5241,18.22458,1605
158746,31953E35176E90848BE35F2C91BAE76A,31421,18,20,2,109.55382,18.22347,1705
158747,31953E35176E90848BE35F2C91BAE76A,31521,21,23,2,109.51458,18.22542,1555
158750,B621E9075674E792CCB217233825F9D1,30854,0,3,3,109.56889,18.27076,1763
158751,B621E9075674E792CCB217233825F9D1,30851,4,13,9,109.5616,18.27396,1713
158780,15A2A8790389D1537721C21B141A7A31,61011,0,2,2,109.60653,18.19076,1900
158782,15A2A8790389D1537721C21B141A7A31,61011,8,11,3,109.60653,18.19076,1900
158784,15A2A8790389D1537721C21B141A7A31,61011,14,23,9,109.60653,18.19076,1900
158805,76F07B8DC17758A94772CF5ACE457FAC,31531,0,1,1,109.49583,18.25972,1461
158806,76F07B8DC17758A94772CF5ACE457FAC,31531,3,5,2,109.49583,18.25972,1461
158807,76F07B8DC17758A94772CF5ACE457FAC,31781,9,11,2,109.19847,18.2975,367
158808,76F07B8DC17758A94772CF5ACE457FAC,31145,12,13,1,109.20431,18.30479,369
158823,89A01963B06628A3D6B13DA41FA507D1,31561,0,18,18,109.56792,18.28479,1765
158824,89A01963B06628A3D6B13DA41FA507D1,30854,18,19,1,109.56889,18.27076,1763
158831,5513D4DF2C6575E373329D82A78CC8F3,31461,12,13,1,109.5091,18.25389,1510
158832,5513D4DF2C6575E373329D82A78CC8F3,60201,18,20,2,109.5041,18.2509,1510
158840,932D308A47BD924E11B570EA7CB7901D,31521,10,17,7,109.51458,18.22542,1555
158846,7421066246AAD1C230E7E2A7ADF06E9D,60631,0,6,6,109.57778,18.27583,1814
158847,7421066246AAD1C230E7E2A7ADF06E9D,30854,9,18,9,109.56889,18.27076,1763
158848,7421066246AAD1C230E7E2A7ADF06E9D,31071,19,20,1,109.58257,18.28458,1815
158849,7421066246AAD1C230E7E2A7ADF06E9D,60631,21,23,2,109.57778,18.27583,1814
158881,C153552CEA2677B0FF473AE565EA979E,30821,0,2,2,109.43681,18.33639,1274
158882,C153552CEA2677B0FF473AE565EA979E,30651,2,10,8,109.42611,18.385,1232
158883,C153552CEA2677B0FF473AE565EA979E,30821,11,15,4,109.43681,18.33639,1274
158886,417408FFDA93B177641D270D3A5C4B2D,31071,0,6,6,109.58257,18.28458,1815
158887,417408FFDA93B177641D270D3A5C4B2D,30854,7,19,12,109.56889,18.27076,1763
158888,417408FFDA93B177641D270D3A5C4B2D,31071,19,23,4,109.58257,18.28458,1815
158889,A5E738BCE3A14BFC61D30835FD8302F3,38321,0,9,9,109.39854,18.29132,1116
158890,A5E738BCE3A14BFC61D30835FD8302F3,31701,9,11,2,109.44132,18.28833,1266
158891,A5E738BCE3A14BFC61D30835FD8302F3,38321,12,19,7,109.39854,18.29132,1116
158914,C1788356D6298A19C2039F0E2F1C2CF1,60381,0,1,1,109.5241,18.22458,1605
158915,C1788356D6298A19C2039F0E2F1C2CF1,30891,4,10,6,109.59431,18.28389,1865
158916,C1788356D6298A19C2039F0E2F1C2CF1,60011,15,16,1,109.48965,18.30222,1468
158931,28F7DFD4A036DBA4E68AFC71762D44D7,30851,18,20,2,109.5616,18.27396,1713
158932,28F7DFD4A036DBA4E68AFC71762D44D7,31561,20,22,2,109.56792,18.28479,1765
158933,28F7DFD4A036DBA4E68AFC71762D44D7,30851,22,23,1,109.5616,18.27396,1713
158943,872709FDC860D320EC74676CCC63D436,60291,14,15,1,109.50826,18.24639,1509
158944,872709FDC860D320EC74676CCC63D436,30511,15,17,2,109.51069,18.24208,1558
158945,872709FDC860D320EC74676CCC63D436,39154,21,23,2,109.50201,18.25681,1511
158946,AD6CE74FEECB42F7806A62DA7A4CECCA,60631,9,10,1,109.57778,18.27583,1814
158947,AD6CE74FEECB42F7806A62DA7A4CECCA,30854,12,18,6,109.56889,18.27076,1763
158974,1BDE433888973A22F2D9A5CC8B5A34FF,31071,0,7,7,109.58257,18.28458,1815
158975,1BDE433888973A22F2D9A5CC8B5A34FF,30854,7,8,1,109.56889,18.27076,1763
158976,1BDE433888973A22F2D9A5CC8B5A34FF,30221,10,21,11,109.57833,18.20222,1802
159004,CB0DCEB8E5573AF0622B1E4D0B156499,38052,0,14,14,109.62618,18.23042,1956
159005,CB0DCEB8E5573AF0622B1E4D0B156499,30361,17,18,1,109.50347,18.24,1508
159006,CB0DCEB8E5573AF0622B1E4D0B156499,38052,20,22,2,109.62618,18.23042,1956
159036,D2A5F87218CF25385163A2F3C4229CB8,30851,7,15,8,109.5616,18.27396,1713
159037,D2A5F87218CF25385163A2F3C4229CB8,31561,19,23,4,109.56792,18.28479,1765
159041,DF49F834C08C7E8FA6D78272EE1FB651,60361,0,7,7,109.51938,18.29681,1567
159042,DF49F834C08C7E8FA6D78272EE1FB651,30851,7,10,3,109.5616,18.27396,1713
159043,DF49F834C08C7E8FA6D78272EE1FB651,30951,10,15,5,109.56208,18.25667,1761
159044,DF49F834C08C7E8FA6D78272EE1FB651,60361,18,23,5,109.51938,18.29681,1567
159067,8DD23AA43C0F7967C45F7488D66F9159,31945,0,7,7,109.58021,18.29403,1817
159068,8DD23AA43C0F7967C45F7488D66F9159,30854,8,20,12,109.56889,18.27076,1763
159071,BD4652414D5C17466BA36FD4BD943A94,60221,0,2,2,109.52569,18.29188,1616
159072,BD4652414D5C17466BA36FD4BD943A94,30721,2,4,2,109.51597,18.28257,1565
159073,BD4652414D5C17466BA36FD4BD943A94,31931,8,9,1,109.54771,18.29403,1667
159079,38D035140A3A408F4047FF243A2434AD,30921,0,9,9,109.53903,18.29451,1667
159080,38D035140A3A408F4047FF243A2434AD,30151,10,11,1,109.50986,18.25083,1560
159081,38D035140A3A408F4047FF243A2434AD,38251,11,12,1,109.49618,18.25493,1510
159082,38D035140A3A408F4047FF243A2434AD,30921,14,17,3,109.53903,18.29451,1667
159083,38D035140A3A408F4047FF243A2434AD,30421,19,20,1,109.50021,18.25861,1511
159084,38D035140A3A408F4047FF243A2434AD,30921,22,23,1,109.53903,18.29451,1667
159098,598A5BC9BEA86E74379689160E91B24E,31071,0,1,1,109.58257,18.28458,1815
159099,598A5BC9BEA86E74379689160E91B24E,30854,2,19,17,109.56889,18.27076,1763
159160,C85D0B931BEF54F05B9ABBBB03212DB7,30854,1,7,6,109.56889,18.27076,1763
159161,C85D0B931BEF54F05B9ABBBB03212DB7,31561,8,9,1,109.56792,18.28479,1765
159162,C85D0B931BEF54F05B9ABBBB03212DB7,30854,10,23,13,109.56889,18.27076,1763
159212,E744F6CA97803D8EE5E846E5B7FD2E92,31945,18,19,1,109.58021,18.29403,1817
159213,E744F6CA97803D8EE5E846E5B7FD2E92,60631,20,22,2,109.57778,18.27583,1814
159232,410D55EA73A3884577B7B9B7E86B067E,30084,0,6,6,109.50118,18.26972,1513
159233,410D55EA73A3884577B7B9B7E86B067E,30081,7,10,3,109.50243,18.26632,1512
159234,410D55EA73A3884577B7B9B7E86B067E,39371,13,14,1,109.56627,18.2646,1762
159237,C9FB9F2C2796B7DA9E44AABC0342CC7A,31081,0,7,7,109.44639,18.30181,1318
159238,C9FB9F2C2796B7DA9E44AABC0342CC7A,31301,9,11,2,109.14493,18.31222,170
159239,C9FB9F2C2796B7DA9E44AABC0342CC7A,31471,11,14,3,109.34583,18.29563,917
159240,C9FB9F2C2796B7DA9E44AABC0342CC7A,30371,16,18,2,109.51,18.24771,1559
159241,C9FB9F2C2796B7DA9E44AABC0342CC7A,60551,19,20,1,109.42722,18.30111,1218
159242,C9FB9F2C2796B7DA9E44AABC0342CC7A,31554,21,22,1,109.55521,18.2459,1709
159287,2A6BA0678DDF16AF08BAC9E3FA3C9391,31561,7,9,2,109.56792,18.28479,1765
159288,2A6BA0678DDF16AF08BAC9E3FA3C9391,30854,9,11,2,109.56889,18.27076,1763
159289,2A6BA0678DDF16AF08BAC9E3FA3C9391,31561,13,14,1,109.56792,18.28479,1765
159290,2A6BA0678DDF16AF08BAC9E3FA3C9391,30854,16,19,3,109.56889,18.27076,1763
159303,B2420C24A59D2C27A09046B2EE9F5AF9,31071,0,1,1,109.58257,18.28458,1815
159304,B2420C24A59D2C27A09046B2EE9F5AF9,30854,2,8,6,109.56889,18.27076,1763
159305,B2420C24A59D2C27A09046B2EE9F5AF9,31071,8,22,14,109.58257,18.28458,1815
159327,75817DB682187A07461734D66E1E6492,60631,0,4,4,109.57778,18.27583,1814
159328,75817DB682187A07461734D66E1E6492,30854,7,17,10,109.56889,18.27076,1763
159329,75817DB682187A07461734D66E1E6492,60631,20,23,3,109.57778,18.27583,1814
159344,C09F93BE0702CB5D61E87026FDAA8287,30854,1,8,7,109.56889,18.27076,1763
159345,C09F93BE0702CB5D61E87026FDAA8287,31561,10,14,4,109.56792,18.28479,1765
159346,C09F93BE0702CB5D61E87026FDAA8287,30854,16,23,7,109.56889,18.27076,1763
159352,005F3AEFE6DBF371ED1FD57736434098,31071,1,7,6,109.58257,18.28458,1815
159353,005F3AEFE6DBF371ED1FD57736434098,30854,8,19,11,109.56889,18.27076,1763
159354,005F3AEFE6DBF371ED1FD57736434098,31071,21,23,2,109.58257,18.28458,1815
159384,21C679D1B9FF307EA1AC2A89744209FE,38291,2,13,11,109.51618,18.24313,1558
159385,21C679D1B9FF307EA1AC2A89744209FE,60281,13,16,3,109.51743,18.25924,1561
159386,21C679D1B9FF307EA1AC2A89744209FE,38291,17,23,6,109.51618,18.24313,1558
159389,34F3D64B41C252481F72E5CF931AC833,30854,4,6,2,109.56889,18.27076,1763
159390,34F3D64B41C252481F72E5CF931AC833,31071,10,14,4,109.58257,18.28458,1815
159391,06FCF67485A2B44C8ABC96FDB92547C5,61011,0,6,6,109.60653,18.19076,1900
159393,06FCF67485A2B44C8ABC96FDB92547C5,61011,8,11,3,109.60653,18.19076,1900
159395,06FCF67485A2B44C8ABC96FDB92547C5,61011,21,23,2,109.60653,18.19076,1900
159438,320DCBE6D506CB46EF34B31CD4373E09,31031,11,13,2,109.49979,18.25382,1510
159439,320DCBE6D506CB46EF34B31CD4373E09,31521,13,15,2,109.51458,18.22542,1555
159440,320DCBE6D506CB46EF34B31CD4373E09,31521,17,19,2,109.51458,18.22542,1555
159441,320DCBE6D506CB46EF34B31CD4373E09,31521,19,22,3,109.51458,18.22542,1555
159462,ABCD0851CC1C78BCD7AF6DBDF2F5DE49,60524,2,3,1,109.42951,18.28993,1216
159463,ABCD0851CC1C78BCD7AF6DBDF2F5DE49,31031,8,9,1,109.49979,18.25382,1510
159464,ABCD0851CC1C78BCD7AF6DBDF2F5DE49,60552,10,19,9,109.41729,18.30014,1218
159473,B93D357AAB05700B15F775F104378052,31841,1,14,13,109.73201,18.33382,2373
159474,B93D357AAB05700B15F775F104378052,60114,15,17,2,109.73028,18.33847,2374
159475,5E97A4561E11AAC4FBC53FD068EAA52B,30854,0,7,7,109.56889,18.27076,1763
159476,5E97A4561E11AAC4FBC53FD068EAA52B,30531,8,18,10,109.53271,18.21472,1604
159477,5E97A4561E11AAC4FBC53FD068EAA52B,30854,20,22,2,109.56889,18.27076,1763
159534,B643AC77F8D8498A9694D45BA8B0F75F,31561,0,1,1,109.56792,18.28479,1765
159535,B643AC77F8D8498A9694D45BA8B0F75F,60631,4,16,12,109.57778,18.27583,1814
159536,B643AC77F8D8498A9694D45BA8B0F75F,31561,17,23,6,109.56792,18.28479,1765
159577,6593F76DF8B5BF518604AD69943FBD58,30854,0,6,6,109.56889,18.27076,1763
159578,6593F76DF8B5BF518604AD69943FBD58,31071,6,7,1,109.58257,18.28458,1815
159591,E5D9C2E63CCE9D1234DB3809C4F11F20,38291,0,10,10,109.51618,18.24313,1558
159592,E5D9C2E63CCE9D1234DB3809C4F11F20,30371,10,11,1,109.51,18.24771,1559
159593,E5D9C2E63CCE9D1234DB3809C4F11F20,30421,14,16,2,109.50021,18.25861,1511
159594,E5D9C2E63CCE9D1234DB3809C4F11F20,60671,20,22,2,109.52979,18.31757,1621
159599,814DB78AAB9C214E275D20A34DB679ED,30854,0,10,10,109.56889,18.27076,1763
159600,814DB78AAB9C214E275D20A34DB679ED,60201,11,12,1,109.5041,18.2509,1510
159601,814DB78AAB9C214E275D20A34DB679ED,30854,15,21,6,109.56889,18.27076,1763
159602,814DB78AAB9C214E275D20A34DB679ED,31071,22,23,1,109.58257,18.28458,1815
159659,DB7C0C5D10FF666BA5EE6412A44C4119,31271,0,3,3,109.48958,18.26257,1462
159660,DB7C0C5D10FF666BA5EE6412A44C4119,31531,3,4,1,109.49583,18.25972,1461
159661,DB7C0C5D10FF666BA5EE6412A44C4119,31271,5,6,1,109.48958,18.26257,1462
159662,27BCEF3137923B84211F08830816C810,30851,1,17,16,109.5616,18.27396,1713
159663,27BCEF3137923B84211F08830816C810,31561,17,20,3,109.56792,18.28479,1765
159664,27BCEF3137923B84211F08830816C810,30851,22,23,1,109.5616,18.27396,1713
159665,E960A9C960574B6ECAA9E8161ED40783,30181,0,1,1,109.51597,18.23313,1557
159666,E960A9C960574B6ECAA9E8161ED40783,31521,2,4,2,109.51458,18.22542,1555
159667,E960A9C960574B6ECAA9E8161ED40783,30181,5,10,5,109.51597,18.23313,1557
159668,E960A9C960574B6ECAA9E8161ED40783,60291,12,14,2,109.50826,18.24639,1509
159669,E960A9C960574B6ECAA9E8161ED40783,30361,19,21,2,109.50347,18.24,1508
159670,E960A9C960574B6ECAA9E8161ED40783,30181,22,23,1,109.51597,18.23313,1557
159677,BF601B271A76319695C5DD1D101B549E,60501,0,4,4,109.48701,18.29021,1466
159678,BF601B271A76319695C5DD1D101B549E,38951,4,23,19,109.48097,18.28868,1416
159692,D120910A908EA6AFCCC9BC3841E6089E,38891,0,5,5,109.51486,18.24118,1558
159693,D120910A908EA6AFCCC9BC3841E6089E,31261,5,6,1,109.51174,18.2466,1559
159694,D120910A908EA6AFCCC9BC3841E6089E,31821,6,8,2,109.51181,18.24924,1559
159695,D120910A908EA6AFCCC9BC3841E6089E,60311,14,18,4,109.52097,18.24319,1558
159696,D120910A908EA6AFCCC9BC3841E6089E,38891,19,23,4,109.51486,18.24118,1558
159707,5426296000364EE32711CD0E73D782C8,30854,2,8,6,109.56889,18.27076,1763
159708,5426296000364EE32711CD0E73D782C8,31031,10,11,1,109.49979,18.25382,1510
159709,5426296000364EE32711CD0E73D782C8,31561,13,14,1,109.56792,18.28479,1765
159731,4995463B780282C9C030A19D9F49AEAC,31071,3,7,4,109.58257,18.28458,1815
159732,4995463B780282C9C030A19D9F49AEAC,30854,9,17,8,109.56889,18.27076,1763
159733,4995463B780282C9C030A19D9F49AEAC,31071,18,22,4,109.58257,18.28458,1815
159748,4E94ADAE7ABEB20EEFAF67519DFCC1BE,31081,0,9,9,109.44639,18.30181,1318
159749,4E94ADAE7ABEB20EEFAF67519DFCC1BE,31031,9,12,3,109.49979,18.25382,1510
159750,4E94ADAE7ABEB20EEFAF67519DFCC1BE,31031,13,21,8,109.49979,18.25382,1510
159800,00FD2268DE6E83934D2916174E81532F,30111,6,7,1,109.47583,18.30542,1419
159801,00FD2268DE6E83934D2916174E81532F,60472,11,14,3,109.46625,18.29542,1367
159802,00FD2268DE6E83934D2916174E81532F,30111,14,18,4,109.47583,18.30542,1419
159803,00FD2268DE6E83934D2916174E81532F,60472,18,19,1,109.46625,18.29542,1367
159804,00FD2268DE6E83934D2916174E81532F,30111,20,21,1,109.47583,18.30542,1419
159817,B95D5FCFC7327770C14B6F9FFDB772BC,31945,19,20,1,109.58021,18.29403,1817
159818,B95D5FCFC7327770C14B6F9FFDB772BC,31071,22,23,1,109.58257,18.28458,1815
159827,996C0D9500BF90CC0E7F5A04C49A464B,31931,11,15,4,109.54771,18.29403,1667
159828,996C0D9500BF90CC0E7F5A04C49A464B,30921,15,22,7,109.53903,18.29451,1667
159838,B340EDEF4A878E8DF5CBEC25E465EACE,31071,0,4,4,109.58257,18.28458,1815
159839,B340EDEF4A878E8DF5CBEC25E465EACE,30854,8,20,12,109.56889,18.27076,1763
159845,91B57D3795DD45AFB8F2D4F7355B86E1,60441,16,18,2,109.46792,18.28604,1366
159846,91B57D3795DD45AFB8F2D4F7355B86E1,31531,21,23,2,109.49583,18.25972,1461
159860,55319B0406504211FF8992838E0FDE0A,31071,0,7,7,109.58257,18.28458,1815
159861,55319B0406504211FF8992838E0FDE0A,31091,8,10,2,109.41201,18.31222,1170
159863,F198CAA1F49ACA5D003FD8F8473B3798,31071,0,7,7,109.58257,18.28458,1815
159864,F198CAA1F49ACA5D003FD8F8473B3798,30854,11,21,10,109.56889,18.27076,1763
159884,2EBBAC66DDB6248DEB5E1D635794A55A,61011,0,4,4,109.60653,18.19076,1900
159886,2EBBAC66DDB6248DEB5E1D635794A55A,61011,11,15,4,109.60653,18.19076,1900
159895,B29FD39DCB3A3F5A51C3484B063DCAD3,38017,0,11,11,109.49729,18.21424,1504
159896,B29FD39DCB3A3F5A51C3484B063DCAD3,31521,12,13,1,109.51458,18.22542,1555
159899,C860767955774E3494068CF38C009FB6,31061,15,17,2,109.53333,18.23257,1607
159900,C860767955774E3494068CF38C009FB6,60131,20,21,1,109.49819,18.24778,1509
159901,C860767955774E3494068CF38C009FB6,60391,22,23,1,109.47667,18.28757,1416
159925,8C5A16299A6D294198C90C34C25C5949,30854,0,2,2,109.56889,18.27076,1763
159926,8C5A16299A6D294198C90C34C25C5949,30851,3,4,1,109.5616,18.27396,1713
159927,8C5A16299A6D294198C90C34C25C5949,31561,4,16,12,109.56792,18.28479,1765
159928,8C5A16299A6D294198C90C34C25C5949,39183,16,23,7,109.55542,18.28208,1715
159943,552B98A65A23DB4CD390E78F3246E9C5,60221,1,2,1,109.52569,18.29188,1616
159944,552B98A65A23DB4CD390E78F3246E9C5,31931,3,6,3,109.54771,18.29403,1667
159945,552B98A65A23DB4CD390E78F3246E9C5,30921,9,11,2,109.53903,18.29451,1667
159946,552B98A65A23DB4CD390E78F3246E9C5,31931,12,16,4,109.54771,18.29403,1667
159947,552B98A65A23DB4CD390E78F3246E9C5,60221,19,21,2,109.52569,18.29188,1616
159948,552B98A65A23DB4CD390E78F3246E9C5,30921,22,23,1,109.53903,18.29451,1667
159966,B89747DA8FD8C271771A8056C80A48B6,30421,0,8,8,109.50021,18.25861,1511
159967,B89747DA8FD8C271771A8056C80A48B6,30581,8,10,2,109.62257,18.24951,1959
159974,1C9FB52F3215AC60A67CACDC4AFA4355,30084,14,16,2,109.50118,18.26972,1513
159975,1C9FB52F3215AC60A67CACDC4AFA4355,60411,19,23,4,109.32514,18.30854,869
159982,AFCE3351168C576BE2AA828A190DD579,30051,0,3,3,109.48917,18.21215,1453
159983,AFCE3351168C576BE2AA828A190DD579,30271,3,4,1,109.49132,18.23153,1456
159984,AFCE3351168C576BE2AA828A190DD579,30051,5,7,2,109.48917,18.21215,1453
159985,AFCE3351168C576BE2AA828A190DD579,33051,12,13,1,109.6475,18.46618,2096
159986,AFCE3351168C576BE2AA828A190DD579,30051,16,18,2,109.48917,18.21215,1453
159987,AFCE3351168C576BE2AA828A190DD579,30161,18,20,2,109.50042,18.24389,1508
159988,AFCE3351168C576BE2AA828A190DD579,30051,21,22,1,109.48917,18.21215,1453
160002,AE9453D604AF88F4293DEF99463B2345,30861,14,16,2,109.52722,18.22743,1606
160035,FB69127E95B4D9EC5AF61282F8D7EEB7,30854,2,3,1,109.56889,18.27076,1763
160036,FB69127E95B4D9EC5AF61282F8D7EEB7,31071,4,7,3,109.58257,18.28458,1815
160037,FB69127E95B4D9EC5AF61282F8D7EEB7,31561,11,13,2,109.56792,18.28479,1765
160038,FB69127E95B4D9EC5AF61282F8D7EEB7,60121,14,16,2,109.74507,18.37472,2430
160039,FB69127E95B4D9EC5AF61282F8D7EEB7,30854,18,23,5,109.56889,18.27076,1763
160040,0E0D6E55BB1995EBF85F6B7AA8765E55,30854,0,1,1,109.56889,18.27076,1763
160041,0E0D6E55BB1995EBF85F6B7AA8765E55,60631,2,3,1,109.57778,18.27583,1814
160042,0E0D6E55BB1995EBF85F6B7AA8765E55,30854,3,5,2,109.56889,18.27076,1763
160043,0E0D6E55BB1995EBF85F6B7AA8765E55,60631,5,6,1,109.57778,18.27583,1814
160044,0E0D6E55BB1995EBF85F6B7AA8765E55,30854,9,23,14,109.56889,18.27076,1763
160070,770A00BDAFE9BCA8C9E9FA68066EED7D,31071,0,6,6,109.58257,18.28458,1815
160071,770A00BDAFE9BCA8C9E9FA68066EED7D,31561,9,10,1,109.56792,18.28479,1765
160072,770A00BDAFE9BCA8C9E9FA68066EED7D,30851,11,12,1,109.5616,18.27396,1713
160073,770A00BDAFE9BCA8C9E9FA68066EED7D,31561,16,18,2,109.56792,18.28479,1765
160074,770A00BDAFE9BCA8C9E9FA68066EED7D,31071,21,23,2,109.58257,18.28458,1815
160095,F418DE163D69F8F4F422D7CC67E3A86A,60661,0,7,7,109.548,18.2377,1657
160096,F418DE163D69F8F4F422D7CC67E3A86A,30084,8,11,3,109.50118,18.26972,1513
160097,F418DE163D69F8F4F422D7CC67E3A86A,60381,11,15,4,109.5241,18.22458,1605
160098,F418DE163D69F8F4F422D7CC67E3A86A,30711,18,20,2,109.50271,18.25347,1510
160099,F418DE163D69F8F4F422D7CC67E3A86A,60661,22,23,1,109.548,18.2377,1657
160100,369F61D9EC42E510E242E24266B2C23F,30921,9,11,2,109.53903,18.29451,1667
160101,369F61D9EC42E510E242E24266B2C23F,31931,11,23,12,109.54771,18.29403,1667
160110,3BB007FDF28DB0E7E883BA594F721FFE,31181,0,1,1,109.50382,18.24813,1509
160111,3BB007FDF28DB0E7E883BA594F721FFE,39151,2,5,3,109.49875,18.25097,1510
160112,3BB007FDF28DB0E7E883BA594F721FFE,31181,7,23,16,109.50382,18.24813,1509
160140,9D1EC22DFBB32C15D7FEE58EF69EC51E,30361,16,23,7,109.50347,18.24,1508
160175,1E96C566C30C0324136B787B7442349D,39091,0,7,7,109.50097,18.25222,1510
160186,4673FB95D801F5BA8AF86C05F77CD0AA,60161,0,11,11,109.49174,18.26181,1461
160187,4673FB95D801F5BA8AF86C05F77CD0AA,30711,12,13,1,109.50271,18.25347,1510
160188,4673FB95D801F5BA8AF86C05F77CD0AA,31471,15,16,1,109.34583,18.29563,917
160189,4673FB95D801F5BA8AF86C05F77CD0AA,30361,18,21,3,109.50347,18.24,1508
160192,3968C9A12C216FF93EDF454D44490440,39371,0,10,10,109.56627,18.2646,1762
160193,3968C9A12C216FF93EDF454D44490440,30951,15,16,1,109.56208,18.25667,1761
160194,3968C9A12C216FF93EDF454D44490440,30851,19,22,3,109.5616,18.27396,1713
160195,7763FA5342AFBCA436FF4D695F9B9CB2,30711,0,9,9,109.50271,18.25347,1510
160196,7763FA5342AFBCA436FF4D695F9B9CB2,60381,11,12,1,109.5241,18.22458,1605
160197,7763FA5342AFBCA436FF4D695F9B9CB2,30711,13,15,2,109.50271,18.25347,1510
160198,7763FA5342AFBCA436FF4D695F9B9CB2,30711,16,18,2,109.50271,18.25347,1510
160199,7763FA5342AFBCA436FF4D695F9B9CB2,30421,18,23,5,109.50021,18.25861,1511
160235,2A177ADF4F6516EDDF22425D74B17CFB,31931,0,5,5,109.54771,18.29403,1667
160298,8AD9F37216B2D3FCE05CA77434307672,30741,1,8,7,109.49833,18.28681,1516
160299,8AD9F37216B2D3FCE05CA77434307672,30361,11,12,1,109.50347,18.24,1508
160300,8AD9F37216B2D3FCE05CA77434307672,31161,15,16,1,109.70229,18.31361,2270
160301,8AD9F37216B2D3FCE05CA77434307672,60621,20,21,1,109.48354,18.27451,1464
160302,8AD9F37216B2D3FCE05CA77434307672,60281,22,23,1,109.51743,18.25924,1561
160309,E191BF114A3C2277CB7C3323BAA13F43,30854,0,10,10,109.56889,18.27076,1763
160310,E191BF114A3C2277CB7C3323BAA13F43,31301,13,15,2,109.14493,18.31222,170
160311,E191BF114A3C2277CB7C3323BAA13F43,30854,16,17,1,109.56889,18.27076,1763
160312,7BB21D6130AE75AA410ED280998BF572,31236,10,13,3,109.42965,18.29111,1216
160313,7BB21D6130AE75AA410ED280998BF572,31231,15,18,3,109.42597,18.29292,1217
160314,7BB21D6130AE75AA410ED280998BF572,60524,20,21,1,109.42951,18.28993,1216
160334,A68637AA89BD62624E677D9E66C32FAD,30361,2,10,8,109.50347,18.24,1508
160335,A68637AA89BD62624E677D9E66C32FAD,30161,11,17,6,109.50042,18.24389,1508
160336,A68637AA89BD62624E677D9E66C32FAD,30361,17,20,3,109.50347,18.24,1508
160401,B17D654C0C5F0BF2FDFE2DB8B9C0B83F,31031,0,1,1,109.49979,18.25382,1510
160402,B17D654C0C5F0BF2FDFE2DB8B9C0B83F,31041,2,3,1,109.50278,18.23701,1507
160403,B17D654C0C5F0BF2FDFE2DB8B9C0B83F,30771,4,22,18,109.49938,18.26042,1511
160495,122D07F80E4FAC68FAE7EDBB2DF1AFA3,30854,9,15,6,109.56889,18.27076,1763
160496,122D07F80E4FAC68FAE7EDBB2DF1AFA3,31071,16,18,2,109.58257,18.28458,1815
160497,122D07F80E4FAC68FAE7EDBB2DF1AFA3,39091,21,22,1,109.50097,18.25222,1510
160498,4020F45A25B90FB7F045FA0843BE28FF,31471,15,17,2,109.34583,18.29563,917
160499,4020F45A25B90FB7F045FA0843BE28FF,30821,18,19,1,109.43681,18.33639,1274
160507,A65416E0023DB5B05C85EFD796D8188E,31261,0,2,2,109.51174,18.2466,1559
160508,A65416E0023DB5B05C85EFD796D8188E,38911,3,7,4,109.51674,18.24965,1559
160509,A65416E0023DB5B05C85EFD796D8188E,31261,9,12,3,109.51174,18.2466,1559
160510,A65416E0023DB5B05C85EFD796D8188E,30351,16,18,2,109.41701,18.29292,1217
160511,A65416E0023DB5B05C85EFD796D8188E,30711,19,20,1,109.50271,18.25347,1510
160512,A65416E0023DB5B05C85EFD796D8188E,31261,21,23,2,109.51174,18.2466,1559
160517,D75B532BF6F643579E3E2D7CFBC9B3F9,31071,0,7,7,109.58257,18.28458,1815
160518,D75B532BF6F643579E3E2D7CFBC9B3F9,31561,7,9,2,109.56792,18.28479,1765
160519,D75B532BF6F643579E3E2D7CFBC9B3F9,31071,9,23,14,109.58257,18.28458,1815
160537,415924917BD1FA059141A38CE1BD297D,38157,0,1,1,109.51483,18.26958,1563
160538,415924917BD1FA059141A38CE1BD297D,30391,5,15,10,109.4975,18.27118,1513
160539,415924917BD1FA059141A38CE1BD297D,30911,16,19,3,109.50493,18.26181,1511
160540,415924917BD1FA059141A38CE1BD297D,30161,19,20,1,109.50042,18.24389,1508
160541,415924917BD1FA059141A38CE1BD297D,31554,21,22,1,109.55521,18.2459,1709
160558,47A18820FDA9856131F74091D44B6BCB,30851,7,11,4,109.5616,18.27396,1713
160559,47A18820FDA9856131F74091D44B6BCB,31561,13,15,2,109.56792,18.28479,1765
160560,47A18820FDA9856131F74091D44B6BCB,39183,15,17,2,109.55542,18.28208,1715
160570,46B472A67DC212EE4047EBC9FB351124,31071,0,5,5,109.58257,18.28458,1815
160571,46B472A67DC212EE4047EBC9FB351124,30854,7,8,1,109.56889,18.27076,1763
160572,46B472A67DC212EE4047EBC9FB351124,31071,10,23,13,109.58257,18.28458,1815
160576,74AD1AF2EA5153BD40BCF9A3F3F2C4E3,31071,12,13,1,109.58257,18.28458,1815
160577,74AD1AF2EA5153BD40BCF9A3F3F2C4E3,30854,14,19,5,109.56889,18.27076,1763
160578,74AD1AF2EA5153BD40BCF9A3F3F2C4E3,31071,20,22,2,109.58257,18.28458,1815
160590,A9FCE0049DB44FE004EAFBF5B783F4A5,31945,1,3,2,109.58021,18.29403,1817
160591,A9FCE0049DB44FE004EAFBF5B783F4A5,31071,4,6,2,109.58257,18.28458,1815
160592,A9FCE0049DB44FE004EAFBF5B783F4A5,30854,8,10,2,109.56889,18.27076,1763
160593,A9FCE0049DB44FE004EAFBF5B783F4A5,31945,12,14,2,109.58021,18.29403,1817
160594,A9FCE0049DB44FE004EAFBF5B783F4A5,30854,15,23,8,109.56889,18.27076,1763
160595,CCBF1BE99DA9F84ADB162A21804AB04F,60361,6,7,1,109.51938,18.29681,1567
160596,CCBF1BE99DA9F84ADB162A21804AB04F,31561,8,10,2,109.56792,18.28479,1765
160597,CCBF1BE99DA9F84ADB162A21804AB04F,60361,12,13,1,109.51938,18.29681,1567
160598,CCBF1BE99DA9F84ADB162A21804AB04F,31561,14,16,2,109.56792,18.28479,1765
160599,CCBF1BE99DA9F84ADB162A21804AB04F,60361,20,21,1,109.51938,18.29681,1567
160613,E21BDA79D452CC6D5F26BA60A43939EC,31261,4,5,1,109.51174,18.2466,1559
160614,E21BDA79D452CC6D5F26BA60A43939EC,30371,8,14,6,109.51,18.24771,1559
160615,E21BDA79D452CC6D5F26BA60A43939EC,31261,14,15,1,109.51174,18.2466,1559
160616,E21BDA79D452CC6D5F26BA60A43939EC,38911,17,20,3,109.51674,18.24965,1559
160617,43DCA4A54D551EB9E56C0160DC714BC6,30854,2,3,1,109.56889,18.27076,1763
160618,43DCA4A54D551EB9E56C0160DC714BC6,31561,3,9,6,109.56792,18.28479,1765
160619,43DCA4A54D551EB9E56C0160DC714BC6,31861,10,11,1,109.49042,18.27549,1464
160620,43DCA4A54D551EB9E56C0160DC714BC6,31561,13,19,6,109.56792,18.28479,1765
160621,43DCA4A54D551EB9E56C0160DC714BC6,38891,20,23,3,109.51486,18.24118,1558
160653,2CE19795F2549AFE8556FD3526787FA2,31071,0,7,7,109.58257,18.28458,1815
160654,2CE19795F2549AFE8556FD3526787FA2,30851,9,17,8,109.5616,18.27396,1713
160655,2CE19795F2549AFE8556FD3526787FA2,31071,20,23,3,109.58257,18.28458,1815
160664,84DF4A7C208235D171EF56473BCCF210,31561,5,7,2,109.56792,18.28479,1765
160665,84DF4A7C208235D171EF56473BCCF210,60631,9,18,9,109.57778,18.27583,1814
160666,84DF4A7C208235D171EF56473BCCF210,31071,19,21,2,109.58257,18.28458,1815
160672,C0D9A8D1FC57A96EA766A127A0E8EAAC,30854,0,6,6,109.56889,18.27076,1763
160673,C0D9A8D1FC57A96EA766A127A0E8EAAC,31571,7,9,2,109.61563,18.23326,1957
160674,C0D9A8D1FC57A96EA766A127A0E8EAAC,60591,12,13,1,109.61118,18.21715,1904
160675,C0D9A8D1FC57A96EA766A127A0E8EAAC,38054,17,19,2,109.63479,18.23097,2006
160682,015CDEB9169BCE5537ABAE49B6A63F2B,31071,0,7,7,109.58257,18.28458,1815
160683,015CDEB9169BCE5537ABAE49B6A63F2B,30854,8,20,12,109.56889,18.27076,1763
160684,015CDEB9169BCE5537ABAE49B6A63F2B,31071,22,23,1,109.58257,18.28458,1815
160689,EAACD4FD1FD759C1481EE68BDD81E5E7,60201,0,1,1,109.5041,18.2509,1510
160690,EAACD4FD1FD759C1481EE68BDD81E5E7,38251,2,9,7,109.49618,18.25493,1510
160691,EAACD4FD1FD759C1481EE68BDD81E5E7,31471,12,14,2,109.34583,18.29563,917
160692,EAACD4FD1FD759C1481EE68BDD81E5E7,31781,15,16,1,109.19847,18.2975,367
160693,EAACD4FD1FD759C1481EE68BDD81E5E7,30271,18,19,1,109.49132,18.23153,1456
160697,A94F66C88B84FF0658441320CD9F667C,60631,0,2,2,109.57778,18.27583,1814
160698,A94F66C88B84FF0658441320CD9F667C,31071,5,6,1,109.58257,18.28458,1815
160708,E8E05D2BF37E5522AAFF8446679CEF53,31931,8,9,1,109.54771,18.29403,1667
160709,E8E05D2BF37E5522AAFF8446679CEF53,30921,9,10,1,109.53903,18.29451,1667
160710,E8E05D2BF37E5522AAFF8446679CEF53,31931,11,13,2,109.54771,18.29403,1667
160711,E8E05D2BF37E5522AAFF8446679CEF53,60671,14,23,9,109.52979,18.31757,1621
160715,7024F3A14F6F554DC6E80063E30315F0,30854,0,2,2,109.56889,18.27076,1763
160716,7024F3A14F6F554DC6E80063E30315F0,31561,3,8,5,109.56792,18.28479,1765
160717,7024F3A14F6F554DC6E80063E30315F0,39183,8,18,10,109.55542,18.28208,1715
160718,7024F3A14F6F554DC6E80063E30315F0,30854,22,23,1,109.56889,18.27076,1763
160755,E1FCF6F0DAD733D65B4B7CF374C299B4,30661,0,4,4,109.37028,18.24361,1008
160756,E1FCF6F0DAD733D65B4B7CF374C299B4,60054,5,6,1,109.3016,18.31229,770
160757,E1FCF6F0DAD733D65B4B7CF374C299B4,30661,6,9,3,109.37028,18.24361,1008
160758,E1FCF6F0DAD733D65B4B7CF374C299B4,60054,9,10,1,109.3016,18.31229,770
160759,E1FCF6F0DAD733D65B4B7CF374C299B4,30661,10,23,13,109.37028,18.24361,1008
160764,068F8725B235C28EDCF1ACB518984443,30071,0,7,7,109.52819,18.30472,1619
160765,068F8725B235C28EDCF1ACB518984443,30071,9,10,1,109.52819,18.30472,1619
160766,068F8725B235C28EDCF1ACB518984443,38991,12,13,1,109.52681,18.30368,1618
160777,90316F668419B151242AF04D86EAF2CC,31761,1,6,5,109.60521,18.27965,1914
160778,90316F668419B151242AF04D86EAF2CC,30854,9,10,1,109.56889,18.27076,1763
160779,90316F668419B151242AF04D86EAF2CC,31071,11,12,1,109.58257,18.28458,1815
160780,90316F668419B151242AF04D86EAF2CC,30854,12,17,5,109.56889,18.27076,1763
160781,90316F668419B151242AF04D86EAF2CC,38154,18,20,2,109.5266,18.28278,1615
160782,90316F668419B151242AF04D86EAF2CC,30281,21,23,2,109.50597,18.27583,1514
160808,F00821368F615DCDAF214035D8EC4A44,31071,0,1,1,109.58257,18.28458,1815
160809,F00821368F615DCDAF214035D8EC4A44,30854,4,12,8,109.56889,18.27076,1763
160810,F00821368F615DCDAF214035D8EC4A44,31071,12,13,1,109.58257,18.28458,1815
160811,F00821368F615DCDAF214035D8EC4A44,30854,14,15,1,109.56889,18.27076,1763
160816,8C0E6B51FAFE21C31FB9AE08C36DF0A2,30921,0,16,16,109.53903,18.29451,1667
160817,8C0E6B51FAFE21C31FB9AE08C36DF0A2,31931,18,20,2,109.54771,18.29403,1667
160818,8C0E6B51FAFE21C31FB9AE08C36DF0A2,60241,20,22,2,109.53319,18.28667,1616
160824,28A89A8FEC174286EFBBD2F96B7BCF44,60201,17,19,2,109.5041,18.2509,1510
160825,28A89A8FEC174286EFBBD2F96B7BCF44,60281,20,22,2,109.51743,18.25924,1561
160830,96F98526707B06BE1263CCD4F72E07A1,30854,0,4,4,109.56889,18.27076,1763
160831,96F98526707B06BE1263CCD4F72E07A1,31071,5,10,5,109.58257,18.28458,1815
160832,96F98526707B06BE1263CCD4F72E07A1,30854,10,17,7,109.56889,18.27076,1763
160833,96F98526707B06BE1263CCD4F72E07A1,31071,18,23,5,109.58257,18.28458,1815
160854,24B9CD23EC5587BA3102D06F602ACE38,60171,0,17,17,109.51292,18.30694,1569
160855,24B9CD23EC5587BA3102D06F602ACE38,31181,19,21,2,109.50382,18.24813,1509
160877,AA17C9279A63248D7DCDF49F93EB8817,39183,4,5,1,109.55542,18.28208,1715
160878,AA17C9279A63248D7DCDF49F93EB8817,38275,8,17,9,109.62875,18.22938,2006
160879,AA17C9279A63248D7DCDF49F93EB8817,30854,19,20,1,109.56889,18.27076,1763
160890,36566106CC9CFD386F41AE364EF63663,38751,18,20,2,109.74903,18.37639,2481
160891,36566106CC9CFD386F41AE364EF63663,60114,21,23,2,109.73028,18.33847,2374
160906,3FBDC8D8C17B76F60ECEEB6B68F9AA0F,38361,0,7,7,109.43667,18.29201,1267
160907,3FBDC8D8C17B76F60ECEEB6B68F9AA0F,31391,9,10,1,109.50382,18.24285,1508
160908,3FBDC8D8C17B76F60ECEEB6B68F9AA0F,38291,12,16,4,109.51618,18.24313,1558
160909,3FBDC8D8C17B76F60ECEEB6B68F9AA0F,38361,19,23,4,109.43667,18.29201,1267
160910,5DFB96E5E8A111915E2B8AFE3C420F16,30531,0,1,1,109.53271,18.21472,1604
160911,5DFB96E5E8A111915E2B8AFE3C420F16,31421,4,6,2,109.55382,18.22347,1705
160912,5DFB96E5E8A111915E2B8AFE3C420F16,31061,7,17,10,109.53333,18.23257,1607
160913,5DFB96E5E8A111915E2B8AFE3C420F16,30531,19,23,4,109.53271,18.21472,1604
160943,F84D949DDCBF25D5530F771BC55E0B9D,61011,0,2,2,109.60653,18.19076,1900
160949,07169E7114E4F14C073261BAAC0D4491,31071,0,7,7,109.58257,18.28458,1815
160950,07169E7114E4F14C073261BAAC0D4491,61011,9,11,2,109.60653,18.19076,1900
160963,53490AD77ACCA93C3ED0F3DE79CA488B,31071,5,13,8,109.58257,18.28458,1815
160964,53490AD77ACCA93C3ED0F3DE79CA488B,30854,16,17,1,109.56889,18.27076,1763
161026,121138E269BBF0B506FA8CE6CEB3BF52,39181,10,11,1,109.55153,18.28035,1715
161027,121138E269BBF0B506FA8CE6CEB3BF52,31931,12,23,11,109.54771,18.29403,1667
161031,8AE1DEDFE1A65A29B5153547EEA03A21,30851,15,17,2,109.5616,18.27396,1713
161032,8AE1DEDFE1A65A29B5153547EEA03A21,31071,18,22,4,109.58257,18.28458,1815
161036,9C1407835BC54BEBDB541F52E1DA1820,61011,0,5,5,109.60653,18.19076,1900
161123,8C3D244B6DAAE8C73F174808255E03C6,60011,0,3,3,109.48965,18.30222,1468
161124,8C3D244B6DAAE8C73F174808255E03C6,30111,3,11,8,109.47583,18.30542,1419
161125,8C3D244B6DAAE8C73F174808255E03C6,60011,12,13,1,109.48965,18.30222,1468
161126,8C3D244B6DAAE8C73F174808255E03C6,30761,14,16,2,109.45201,18.3,1318
161127,8C3D244B6DAAE8C73F174808255E03C6,31031,20,23,3,109.49979,18.25382,1510
161154,CCCD2290FB632A48009771412BE68ADD,31561,0,14,14,109.56792,18.28479,1765
161155,CCCD2290FB632A48009771412BE68ADD,39183,15,16,1,109.55542,18.28208,1715
161156,CCCD2290FB632A48009771412BE68ADD,31561,18,22,4,109.56792,18.28479,1765
161161,8799356B7181F28146A203E5F86C52F0,30571,16,19,3,109.50243,18.21861,1504
161162,8799356B7181F28146A203E5F86C52F0,31621,20,21,1,109.51035,18.29826,1568
161163,8799356B7181F28146A203E5F86C52F0,31351,22,23,1,109.4959,18.28417,1465
161166,2091DB2ACA69B10ADE950A23CC278A98,30151,1,3,2,109.50986,18.25083,1560
161167,2091DB2ACA69B10ADE950A23CC278A98,60361,4,12,8,109.51938,18.29681,1567
161168,2091DB2ACA69B10ADE950A23CC278A98,60274,12,15,3,109.514,18.2933,1567
161169,2091DB2ACA69B10ADE950A23CC278A98,31021,15,18,3,109.49021,18.27,1463
161200,99CBAA6A65A50998F0A10B72B36210E4,30271,0,18,18,109.49132,18.23153,1456
161201,99CBAA6A65A50998F0A10B72B36210E4,60084,18,23,5,109.4984,18.2334,1507
161205,E7E2A00FD533B194627A6A403AE528B1,30721,0,13,13,109.51597,18.28257,1565
161207,E7E2A00FD533B194627A6A403AE528B1,38171,20,23,3,109.50799,18.28139,1515
161263,E00EF22F493557E868E52C93194870CF,30234,0,3,3,109.60681,18.29979,1918
161264,E00EF22F493557E868E52C93194870CF,31071,4,14,10,109.58257,18.28458,1815
161265,3C5AEA306E8A69C707195C4150E77D90,31931,2,7,5,109.54771,18.29403,1667
161266,3C5AEA306E8A69C707195C4150E77D90,39181,7,17,10,109.55153,18.28035,1715
161293,EF24901D99384F703B20FE07F2784FA0,31631,16,17,1,109.59542,18.36826,1879
161294,EF24901D99384F703B20FE07F2784FA0,30101,20,21,1,109.57299,18.33333,1773
161360,1122041491C04B199A15F6E1E401D68F,31461,8,9,1,109.5091,18.25389,1510
161361,1122041491C04B199A15F6E1E401D68F,30461,12,13,1,109.5116,18.26313,1562
161362,1122041491C04B199A15F6E1E401D68F,31261,15,16,1,109.51174,18.2466,1559
161363,1122041491C04B199A15F6E1E401D68F,30461,20,22,2,109.5116,18.26313,1562
161411,A55D4129A4D1B105629D337545083A9E,31561,0,7,7,109.56792,18.28479,1765
161412,A55D4129A4D1B105629D337545083A9E,30854,11,12,1,109.56889,18.27076,1763
161413,A55D4129A4D1B105629D337545083A9E,31561,13,14,1,109.56792,18.28479,1765
161450,56F818D0924E7BDB02CCC04065747626,31421,0,6,6,109.55382,18.22347,1705
161451,56F818D0924E7BDB02CCC04065747626,30711,7,10,3,109.50271,18.25347,1510
161452,56F818D0924E7BDB02CCC04065747626,30861,10,11,1,109.52722,18.22743,1606
161453,56F818D0924E7BDB02CCC04065747626,31421,12,13,1,109.55382,18.22347,1705
161454,56F818D0924E7BDB02CCC04065747626,38205,15,17,2,109.62743,18.23139,1956
161455,56F818D0924E7BDB02CCC04065747626,31421,20,22,2,109.55382,18.22347,1705
161458,51061B3DE820AF1C1C713EF684728003,30854,18,20,2,109.56889,18.27076,1763
161459,51061B3DE820AF1C1C713EF684728003,31071,21,23,2,109.58257,18.28458,1815
161467,213AF2099653A4ADAEF799CCC144B279,30021,0,10,10,109.12014,18.40986,86
161469,213AF2099653A4ADAEF799CCC144B279,30021,19,23,4,109.12014,18.40986,86
161470,A8E9C7BB918ADAD29A3EA7ACDDCD32D7,38951,0,15,15,109.48097,18.28868,1416
161471,A8E9C7BB918ADAD29A3EA7ACDDCD32D7,30151,16,17,1,109.50986,18.25083,1560
161472,A8E9C7BB918ADAD29A3EA7ACDDCD32D7,38951,18,23,5,109.48097,18.28868,1416
161473,012ABD06F231728C214A4BA917E75B1C,31561,20,21,1,109.56792,18.28479,1765
161474,012ABD06F231728C214A4BA917E75B1C,30851,22,23,1,109.5616,18.27396,1713
161483,F3652FF504BC297E68234A33C1877043,31945,0,6,6,109.58021,18.29403,1817
161484,F3652FF504BC297E68234A33C1877043,30854,6,22,16,109.56889,18.27076,1763
161509,1980C8D409DE9551539224B3D393CDAA,30071,1,2,1,109.52819,18.30472,1619
161510,1980C8D409DE9551539224B3D393CDAA,30071,4,7,3,109.52819,18.30472,1619
161511,1980C8D409DE9551539224B3D393CDAA,31951,7,17,10,109.52174,18.30299,1568
161512,1980C8D409DE9551539224B3D393CDAA,30071,17,21,4,109.52819,18.30472,1619
161535,D9AE11CD16B231308C3F0FB3F53BC3E9,30854,0,6,6,109.56889,18.27076,1763
161536,D9AE11CD16B231308C3F0FB3F53BC3E9,31071,9,10,1,109.58257,18.28458,1815
161537,D9AE11CD16B231308C3F0FB3F53BC3E9,30854,12,14,2,109.56889,18.27076,1763
161551,174B81E807CFD6D72A51A63141915219,30764,0,2,2,109.45806,18.29486,1367
161552,174B81E807CFD6D72A51A63141915219,30111,2,5,3,109.47583,18.30542,1419
161553,174B81E807CFD6D72A51A63141915219,60391,6,7,1,109.47667,18.28757,1416
161602,8B9A9BFD1ACAD480EB101A91DBF2024D,30371,1,2,1,109.51,18.24771,1559
161603,8B9A9BFD1ACAD480EB101A91DBF2024D,38291,3,19,16,109.51618,18.24313,1558
161604,8B9A9BFD1ACAD480EB101A91DBF2024D,30371,19,22,3,109.51,18.24771,1559
161615,43E035AE85036EBD9891453E9567CB81,60621,12,13,1,109.48354,18.27451,1464
161616,43E035AE85036EBD9891453E9567CB81,38154,15,16,1,109.5266,18.28278,1615
161617,43E035AE85036EBD9891453E9567CB81,30151,20,23,3,109.50986,18.25083,1560
161649,81596C8771F0BD5C8688C47E383316FD,31041,14,16,2,109.50278,18.23701,1507
161650,81596C8771F0BD5C8688C47E383316FD,30191,18,22,4,109.50361,18.22701,1506
161651,2A1AB09F11CECAAFA5576058E9461FEA,31231,1,12,11,109.42597,18.29292,1217
161652,2A1AB09F11CECAAFA5576058E9461FEA,30111,15,17,2,109.47583,18.30542,1419
161653,2A1AB09F11CECAAFA5576058E9461FEA,31231,19,20,1,109.42597,18.29292,1217
161664,6ADBEFDC21CA46F051933BF984A8E255,30681,13,14,1,109.48493,18.26917,1463
161665,6ADBEFDC21CA46F051933BF984A8E255,30201,15,19,4,109.4909,18.26465,1462
161681,9671B6E053D263F77ADF522BC499DA98,30351,18,20,2,109.41701,18.29292,1217
161682,9671B6E053D263F77ADF522BC499DA98,60524,21,22,1,109.42951,18.28993,1216
161716,08077B5D5F0A9938A81D328635D03C8B,31071,1,6,5,109.58257,18.28458,1815
161717,08077B5D5F0A9938A81D328635D03C8B,30854,8,9,1,109.56889,18.27076,1763
161718,08077B5D5F0A9938A81D328635D03C8B,31071,11,12,1,109.58257,18.28458,1815
161719,08077B5D5F0A9938A81D328635D03C8B,30854,12,13,1,109.56889,18.27076,1763
161720,189633BA4D39EBA8A203BC9E364D4B1F,30381,1,8,7,109.52521,18.24507,1609
161721,189633BA4D39EBA8A203BC9E364D4B1F,30571,8,10,2,109.50243,18.21861,1504
161722,189633BA4D39EBA8A203BC9E364D4B1F,30051,11,12,1,109.48917,18.21215,1453
161723,189633BA4D39EBA8A203BC9E364D4B1F,30571,13,14,1,109.50243,18.21861,1504
161724,189633BA4D39EBA8A203BC9E364D4B1F,30051,15,17,2,109.48917,18.21215,1453
161725,189633BA4D39EBA8A203BC9E364D4B1F,38291,20,23,3,109.51618,18.24313,1558
161742,C983E73D646629A775690ECA8920EB29,31631,15,16,1,109.59542,18.36826,1879
161743,C983E73D646629A775690ECA8920EB29,30101,19,21,2,109.57299,18.33333,1773
161751,8C8F8FC2780D9BDAFAB332E6525E36FA,30084,14,16,2,109.50118,18.26972,1513
161752,8C8F8FC2780D9BDAFAB332E6525E36FA,31351,16,18,2,109.4959,18.28417,1465
161753,8C8F8FC2780D9BDAFAB332E6525E36FA,30084,20,22,2,109.50118,18.26972,1513
161778,33A62A8066AF8B1342859DF4B906FBD2,30741,17,19,2,109.49833,18.28681,1516
161779,33A62A8066AF8B1342859DF4B906FBD2,30351,20,23,3,109.41701,18.29292,1217
161795,4639E7F597994307D62A7FF9CC65CC1D,31071,0,6,6,109.58257,18.28458,1815
161796,4639E7F597994307D62A7FF9CC65CC1D,30854,7,15,8,109.56889,18.27076,1763
161797,4639E7F597994307D62A7FF9CC65CC1D,31071,18,20,2,109.58257,18.28458,1815
161801,37657A593A7A700C5ECCE5BB0AAAABA7,31931,0,7,7,109.54771,18.29403,1667
161802,37657A593A7A700C5ECCE5BB0AAAABA7,39183,8,10,2,109.55542,18.28208,1715
161803,37657A593A7A700C5ECCE5BB0AAAABA7,31931,11,12,1,109.54771,18.29403,1667
161804,37657A593A7A700C5ECCE5BB0AAAABA7,39183,15,16,1,109.55542,18.28208,1715
161805,37657A593A7A700C5ECCE5BB0AAAABA7,31931,19,22,3,109.54771,18.29403,1667
161847,6422CB87ACC55DDEF6EBE8946593C808,38171,0,5,5,109.50799,18.28139,1515
161848,6422CB87ACC55DDEF6EBE8946593C808,60281,5,6,1,109.51743,18.25924,1561
161849,6422CB87ACC55DDEF6EBE8946593C808,30571,8,15,7,109.50243,18.21861,1504
161850,6422CB87ACC55DDEF6EBE8946593C808,30741,18,23,5,109.49833,18.28681,1516
161886,53453D8B736810206EC5A6632D159BE6,30921,16,17,1,109.53903,18.29451,1667
161887,53453D8B736810206EC5A6632D159BE6,31931,19,22,3,109.54771,18.29403,1667
161892,D1700FD0B8D8B8304DC420C1C5EAA5DF,31521,0,6,6,109.51458,18.22542,1555
161893,D1700FD0B8D8B8304DC420C1C5EAA5DF,31521,10,17,7,109.51458,18.22542,1555
161894,D1700FD0B8D8B8304DC420C1C5EAA5DF,31091,19,22,3,109.41201,18.31222,1170
161900,9AA959ED87D1ECC3053DED17290EFCBD,39183,1,2,1,109.55542,18.28208,1715
161901,9AA959ED87D1ECC3053DED17290EFCBD,31561,3,8,5,109.56792,18.28479,1765
161902,9AA959ED87D1ECC3053DED17290EFCBD,39183,9,10,1,109.55542,18.28208,1715
161912,7890099D98AA300C5BF12527E7372DB0,60631,0,7,7,109.57778,18.27583,1814
161913,7890099D98AA300C5BF12527E7372DB0,30854,7,10,3,109.56889,18.27076,1763
161914,7890099D98AA300C5BF12527E7372DB0,31071,10,15,5,109.58257,18.28458,1815
161915,7890099D98AA300C5BF12527E7372DB0,30854,16,18,2,109.56889,18.27076,1763
161916,7890099D98AA300C5BF12527E7372DB0,60631,19,23,4,109.57778,18.27583,1814
161917,C1F80FD61770F46AF18F3BEF2B67E7ED,31551,2,5,3,109.55868,18.24222,1708
161918,C1F80FD61770F46AF18F3BEF2B67E7ED,31554,5,7,2,109.55521,18.2459,1709
161919,C1F80FD61770F46AF18F3BEF2B67E7ED,60291,10,13,3,109.50826,18.24639,1509
161920,C1F80FD61770F46AF18F3BEF2B67E7ED,31781,14,17,3,109.19847,18.2975,367
161921,C1F80FD61770F46AF18F3BEF2B67E7ED,31551,19,22,3,109.55868,18.24222,1708
161942,D96E01B8E0F0DE9C160C9FEAFDCFDB6D,30854,8,18,10,109.56889,18.27076,1763
161943,D96E01B8E0F0DE9C160C9FEAFDCFDB6D,31071,20,21,1,109.58257,18.28458,1815
161981,C37DBDD12F85B1DFB17F9185AF0E7708,30951,1,8,7,109.56208,18.25667,1761
161982,C37DBDD12F85B1DFB17F9185AF0E7708,30851,8,11,3,109.5616,18.27396,1713
161983,C37DBDD12F85B1DFB17F9185AF0E7708,30951,11,14,3,109.56208,18.25667,1761
161984,C37DBDD12F85B1DFB17F9185AF0E7708,30851,14,15,1,109.5616,18.27396,1713
161985,C37DBDD12F85B1DFB17F9185AF0E7708,30951,16,21,5,109.56208,18.25667,1761
162031,5525BF918B1E57DF5793EBC4D3539159,30381,0,13,13,109.52521,18.24507,1609
162032,5525BF918B1E57DF5793EBC4D3539159,30711,14,15,1,109.50271,18.25347,1510
162033,5525BF918B1E57DF5793EBC4D3539159,30381,18,22,4,109.52521,18.24507,1609
162049,40285EE8CCE25C38988EC087545664EC,31071,0,7,7,109.58257,18.28458,1815
162050,40285EE8CCE25C38988EC087545664EC,30854,10,11,1,109.56889,18.27076,1763
162051,40285EE8CCE25C38988EC087545664EC,31071,14,17,3,109.58257,18.28458,1815
162052,40285EE8CCE25C38988EC087545664EC,30854,20,22,2,109.56889,18.27076,1763
162078,3B46764DEE9C1A14D1C3F1D56B4284FD,30921,0,1,1,109.53903,18.29451,1667
162079,3B46764DEE9C1A14D1C3F1D56B4284FD,60361,2,10,8,109.51938,18.29681,1567
162080,3B46764DEE9C1A14D1C3F1D56B4284FD,60171,11,12,1,109.51292,18.30694,1569
162104,D66DDB1AF696D6DDB044E124EA6B793E,60501,15,17,2,109.48701,18.29021,1466
162105,D66DDB1AF696D6DDB044E124EA6B793E,38241,19,21,2,109.54111,18.30542,1669
162119,C8922FAF66F21ECAECB6B717FCD5A53B,60391,0,1,1,109.47667,18.28757,1416
162120,C8922FAF66F21ECAECB6B717FCD5A53B,60614,2,3,1,109.48799,18.29521,1467
162121,C8922FAF66F21ECAECB6B717FCD5A53B,60391,4,6,2,109.47667,18.28757,1416
162122,C8922FAF66F21ECAECB6B717FCD5A53B,60614,6,8,2,109.48799,18.29521,1467
162123,C8922FAF66F21ECAECB6B717FCD5A53B,60391,8,17,9,109.47667,18.28757,1416
162124,C8922FAF66F21ECAECB6B717FCD5A53B,60614,17,22,5,109.48799,18.29521,1467
162128,7108DC6F5FE31ADF679880B9ADB266C0,38291,14,16,2,109.51618,18.24313,1558
162129,7108DC6F5FE31ADF679880B9ADB266C0,30681,19,21,2,109.48493,18.26917,1463
162139,9E8746086915F9D4A063A74CF0B5B7AB,31561,0,2,2,109.56792,18.28479,1765
162140,9E8746086915F9D4A063A74CF0B5B7AB,30851,2,6,4,109.5616,18.27396,1713
162157,219D03D2345568C24C18853ACF5CAE7D,38754,11,13,2,109.74667,18.37382,2430
162158,219D03D2345568C24C18853ACF5CAE7D,30421,15,17,2,109.50021,18.25861,1511
162159,219D03D2345568C24C18853ACF5CAE7D,60084,19,22,3,109.4984,18.2334,1507
162170,A503639E15A0B5D04B0130D882921438,30711,0,19,19,109.50271,18.25347,1510
162171,A503639E15A0B5D04B0130D882921438,31031,20,23,3,109.49979,18.25382,1510
162199,FD5B9AB034F15F72E8BEF02193669238,60241,11,13,2,109.53319,18.28667,1616
162200,FD5B9AB034F15F72E8BEF02193669238,31931,15,18,3,109.54771,18.29403,1667
162201,FD5B9AB034F15F72E8BEF02193669238,60241,19,21,2,109.53319,18.28667,1616
162216,04ABA8BFD5D63DDF1B83BA0577C9019C,39371,2,4,2,109.56627,18.2646,1762
162217,04ABA8BFD5D63DDF1B83BA0577C9019C,30232,4,6,2,109.6191,18.31701,1971
162218,04ABA8BFD5D63DDF1B83BA0577C9019C,39183,6,8,2,109.55542,18.28208,1715
162219,04ABA8BFD5D63DDF1B83BA0577C9019C,39371,12,13,1,109.56627,18.2646,1762
162241,C16911B04E69B2086DAE9402EB30D376,39111,0,14,14,109.5191,18.22597,1555
162250,E9E473F09C342630187345312F4A31D8,39181,0,14,14,109.55153,18.28035,1715
162251,E9E473F09C342630187345312F4A31D8,39181,16,23,7,109.55153,18.28035,1715
162293,E75CF54BA14775FEDD26504F9F6B7365,31945,0,6,6,109.58021,18.29403,1817
162294,E75CF54BA14775FEDD26504F9F6B7365,31561,7,16,9,109.56792,18.28479,1765
162295,E75CF54BA14775FEDD26504F9F6B7365,31945,20,23,3,109.58021,18.29403,1817
162296,00FC332040A284DA251A8D0705989FE9,31071,0,13,13,109.58257,18.28458,1815
162297,00FC332040A284DA251A8D0705989FE9,30854,13,16,3,109.56889,18.27076,1763
162315,EF4AD841380B82F3DA5A0CBE5A6DFAF4,38052,0,10,10,109.62618,18.23042,1956
162316,EF4AD841380B82F3DA5A0CBE5A6DFAF4,38052,12,14,2,109.62618,18.23042,1956
162317,EF4AD841380B82F3DA5A0CBE5A6DFAF4,30361,17,18,1,109.50347,18.24,1508
162318,EF4AD841380B82F3DA5A0CBE5A6DFAF4,38052,20,23,3,109.62618,18.23042,1956
162353,FA53F02C9576867AA821D2C957A0BDBE,30581,0,8,8,109.62257,18.24951,1959
162354,FA53F02C9576867AA821D2C957A0BDBE,31321,9,17,8,109.63799,18.23201,2007
162355,FA53F02C9576867AA821D2C957A0BDBE,30851,19,21,2,109.5616,18.27396,1713
162362,2AE38FAF341950B0B91404FFCE5A0F3E,31931,0,6,6,109.54771,18.29403,1667
162363,2AE38FAF341950B0B91404FFCE5A0F3E,30921,6,17,11,109.53903,18.29451,1667
162364,2AE38FAF341950B0B91404FFCE5A0F3E,31931,18,20,2,109.54771,18.29403,1667
162365,8DA877D3A30401F86E81FB7BC1CA2A00,30854,8,16,8,109.56889,18.27076,1763
162366,8DA877D3A30401F86E81FB7BC1CA2A00,31071,17,19,2,109.58257,18.28458,1815
162367,39F25FE146A03325C93C111F2A943B6C,31945,1,7,6,109.58021,18.29403,1817
162368,39F25FE146A03325C93C111F2A943B6C,31071,8,12,4,109.58257,18.28458,1815
162369,39F25FE146A03325C93C111F2A943B6C,31945,12,13,1,109.58021,18.29403,1817
162382,BDC0B96180E8B3E332A3ED9C8BE261B2,30671,0,1,1,109.43611,18.30139,1268
162383,BDC0B96180E8B3E332A3ED9C8BE261B2,31231,4,6,2,109.42597,18.29292,1217
162384,BDC0B96180E8B3E332A3ED9C8BE261B2,30671,7,14,7,109.43611,18.30139,1268
162426,1E36640BE395A4EE8CCB2697222419A5,60631,0,1,1,109.57778,18.27583,1814
162427,1E36640BE395A4EE8CCB2697222419A5,31071,2,7,5,109.58257,18.28458,1815
162428,1E36640BE395A4EE8CCB2697222419A5,31164,9,12,3,109.69993,18.27215,2263
162429,1E36640BE395A4EE8CCB2697222419A5,31391,15,16,1,109.50382,18.24285,1508
162430,14AE6C820CE45F96077630992CABD33D,30951,0,15,15,109.56208,18.25667,1761
162431,14AE6C820CE45F96077630992CABD33D,39371,16,17,1,109.56627,18.2646,1762
162436,CFA6DB42B4EA79576A8AEA8F93765E81,30721,0,7,7,109.51597,18.28257,1565
162437,CFA6DB42B4EA79576A8AEA8F93765E81,30084,9,17,8,109.50118,18.26972,1513
162438,CFA6DB42B4EA79576A8AEA8F93765E81,31206,19,20,1,109.50819,18.23549,1507
162439,DFFF17B7FE30E79B8AABBB5CE171272F,30854,0,6,6,109.56889,18.27076,1763
162440,DFFF17B7FE30E79B8AABBB5CE171272F,31561,8,13,5,109.56792,18.28479,1765
162441,DFFF17B7FE30E79B8AABBB5CE171272F,39183,17,19,2,109.55542,18.28208,1715
162442,DFFF17B7FE30E79B8AABBB5CE171272F,31561,20,22,2,109.56792,18.28479,1765
162451,B34415F599F0ED7D1A073EE314A60B9B,31671,0,11,11,109.38965,18.29813,1068
162452,B34415F599F0ED7D1A073EE314A60B9B,60041,14,15,1,109.39889,18.31944,1121
162453,B34415F599F0ED7D1A073EE314A60B9B,31671,20,22,2,109.38965,18.29813,1068
162468,EDE389AFA39F6BCEE22D12194DD10361,30671,0,8,8,109.43611,18.30139,1268
162469,EDE389AFA39F6BCEE22D12194DD10361,30371,9,10,1,109.51,18.24771,1559
162470,EDE389AFA39F6BCEE22D12194DD10361,30421,12,14,2,109.50021,18.25861,1511
162471,EDE389AFA39F6BCEE22D12194DD10361,30671,14,23,9,109.43611,18.30139,1268
162510,EC4B90EDBF35256FDB4D4F8B87DB8A04,31071,8,13,5,109.58257,18.28458,1815
162511,EC4B90EDBF35256FDB4D4F8B87DB8A04,30854,15,23,8,109.56889,18.27076,1763
162526,E0A24740E2C54F3B77DB561A91D2BED7,30151,0,7,7,109.50986,18.25083,1560
162527,E0A24740E2C54F3B77DB561A91D2BED7,30251,8,12,4,109.50611,18.26653,1512
162528,E0A24740E2C54F3B77DB561A91D2BED7,30251,12,18,6,109.50611,18.26653,1512
162529,E0A24740E2C54F3B77DB561A91D2BED7,31821,18,23,5,109.51181,18.24924,1559
162594,8AFD8FEB1A2AFA5CA33EEEE08ED05D66,60501,0,1,1,109.48701,18.29021,1466
162595,8AFD8FEB1A2AFA5CA33EEEE08ED05D66,60504,4,5,1,109.47917,18.28903,1416
162596,8AFD8FEB1A2AFA5CA33EEEE08ED05D66,30111,6,7,1,109.47583,18.30542,1419
162635,979ABBB43C3434EE96D76E04CFC66E55,39151,0,4,4,109.49875,18.25097,1510
162636,979ABBB43C3434EE96D76E04CFC66E55,60131,4,7,3,109.49819,18.24778,1509
162637,979ABBB43C3434EE96D76E04CFC66E55,60201,7,23,16,109.5041,18.2509,1510
162672,867B597177C033B93C7398A70CF92274,31041,0,1,1,109.50278,18.23701,1507
162673,867B597177C033B93C7398A70CF92274,30151,1,9,8,109.50986,18.25083,1560
162674,867B597177C033B93C7398A70CF92274,30711,12,13,1,109.50271,18.25347,1510
162675,867B597177C033B93C7398A70CF92274,39154,16,17,1,109.50201,18.25681,1511
162676,867B597177C033B93C7398A70CF92274,30151,18,23,5,109.50986,18.25083,1560
162677,738D4FA982656893A7BF5113ADD931D7,30854,13,15,2,109.56889,18.27076,1763
162678,738D4FA982656893A7BF5113ADD931D7,31071,18,21,3,109.58257,18.28458,1815
162686,F209A1377D570F6F7DFE6504E3D5965F,31521,12,19,7,109.51458,18.22542,1555
162687,F209A1377D570F6F7DFE6504E3D5965F,31521,21,22,1,109.51458,18.22542,1555
162702,03CEC0FDDD5484124514C6D24A63D4DD,30854,0,4,4,109.56889,18.27076,1763
162703,03CEC0FDDD5484124514C6D24A63D4DD,31561,4,6,2,109.56792,18.28479,1765
162706,982A3533FF2DE923A7996414ED8DF792,31945,1,2,1,109.58021,18.29403,1817
162707,982A3533FF2DE923A7996414ED8DF792,60631,4,5,1,109.57778,18.27583,1814
162708,982A3533FF2DE923A7996414ED8DF792,31071,7,8,1,109.58257,18.28458,1815
162715,87ACF3C6ADE430D2B9DFB3C954E0C031,31071,4,9,5,109.58257,18.28458,1815
162716,87ACF3C6ADE430D2B9DFB3C954E0C031,39183,10,21,11,109.55542,18.28208,1715
162717,87ACF3C6ADE430D2B9DFB3C954E0C031,31071,21,23,2,109.58257,18.28458,1815
162732,EA446444DFE25212830F95291C13D19D,31931,1,13,12,109.54771,18.29403,1667
162733,EA446444DFE25212830F95291C13D19D,39181,13,15,2,109.55153,18.28035,1715
162734,EA446444DFE25212830F95291C13D19D,31931,16,17,1,109.54771,18.29403,1667
162735,EA446444DFE25212830F95291C13D19D,39181,19,20,1,109.55153,18.28035,1715
162760,1E93239453A807F80FEB34C902C59FA1,48601,0,4,4,109.51694,18.22514,1555
162761,1E93239453A807F80FEB34C902C59FA1,60291,5,7,2,109.50826,18.24639,1509
162762,1E93239453A807F80FEB34C902C59FA1,31521,7,12,5,109.51458,18.22542,1555
162773,967E548F53382C36FB0D7FF12F6A99E7,31531,0,5,5,109.49583,18.25972,1461
162774,967E548F53382C36FB0D7FF12F6A99E7,60331,7,10,3,109.505,18.26507,1512
162775,967E548F53382C36FB0D7FF12F6A99E7,31531,11,13,2,109.49583,18.25972,1461
162776,967E548F53382C36FB0D7FF12F6A99E7,60161,16,20,4,109.49174,18.26181,1461
162821,D0B7F52F6637F62713846394EF54526E,31781,13,16,3,109.19847,18.2975,367
162822,D0B7F52F6637F62713846394EF54526E,31701,20,22,2,109.44132,18.28833,1266
162840,E218C587552A5DADC05C4E69685FE374,30854,10,17,7,109.56889,18.27076,1763
162841,E218C587552A5DADC05C4E69685FE374,39183,21,22,1,109.55542,18.28208,1715
162890,1D8B814EC83D52D7C5F3FED99C129EE0,30854,2,8,6,109.56889,18.27076,1763
162891,1D8B814EC83D52D7C5F3FED99C129EE0,38271,10,19,9,109.62632,18.23049,1956
162892,1D8B814EC83D52D7C5F3FED99C129EE0,30854,19,21,2,109.56889,18.27076,1763
162929,F8340F8DE3FC6E4B51712C02CF964A60,60381,19,20,1,109.5241,18.22458,1605
162930,F8340F8DE3FC6E4B51712C02CF964A60,39321,20,22,2,109.529,18.2167,1604
162977,45D28ABCF21CFC012A68F14A68C61EFC,31521,0,7,7,109.51458,18.22542,1555
162978,45D28ABCF21CFC012A68F14A68C61EFC,31145,10,13,3,109.20431,18.30479,369
162979,45D28ABCF21CFC012A68F14A68C61EFC,60381,14,16,2,109.5241,18.22458,1605
162980,45D28ABCF21CFC012A68F14A68C61EFC,31521,16,17,1,109.51458,18.22542,1555
162981,45D28ABCF21CFC012A68F14A68C61EFC,31521,18,23,5,109.51458,18.22542,1555
163063,752B4C65CCCA1EA27D3C6EA24E289B9C,30854,0,17,17,109.56889,18.27076,1763
163064,752B4C65CCCA1EA27D3C6EA24E289B9C,39371,20,21,1,109.56627,18.2646,1762
163090,452F0FF6BC36839041DCBEF2292D6E55,60661,0,8,8,109.548,18.2377,1657
163091,452F0FF6BC36839041DCBEF2292D6E55,30861,10,12,2,109.52722,18.22743,1606
163093,452F0FF6BC36839041DCBEF2292D6E55,60381,22,23,1,109.5241,18.22458,1605
163105,2F64FEF19C86AA0A8AA3E3FA37CC4F2D,30854,0,2,2,109.56889,18.27076,1763
163106,2F64FEF19C86AA0A8AA3E3FA37CC4F2D,30851,4,5,1,109.5616,18.27396,1713
163107,2F64FEF19C86AA0A8AA3E3FA37CC4F2D,30854,6,18,12,109.56889,18.27076,1763
163108,2F64FEF19C86AA0A8AA3E3FA37CC4F2D,39183,18,19,1,109.55542,18.28208,1715
163109,2F64FEF19C86AA0A8AA3E3FA37CC4F2D,30854,20,23,3,109.56889,18.27076,1763
163113,5C4B759B8D2905A494B81A3EB710A8F3,30891,0,8,8,109.59431,18.28389,1865
163114,5C4B759B8D2905A494B81A3EB710A8F3,60631,13,14,1,109.57778,18.27583,1814
163115,5C4B759B8D2905A494B81A3EB710A8F3,31271,18,19,1,109.48958,18.26257,1462
163116,5C4B759B8D2905A494B81A3EB710A8F3,30854,22,23,1,109.56889,18.27076,1763
163120,AB43182259122294244C13D6FC66D4A1,30851,9,17,8,109.5616,18.27396,1713
163121,AB43182259122294244C13D6FC66D4A1,60631,19,22,3,109.57778,18.27583,1814
163128,036DFEF8CA623F9034F928149FE2468D,30821,1,2,1,109.43681,18.33639,1274
163129,036DFEF8CA623F9034F928149FE2468D,30651,3,5,2,109.42611,18.385,1232
163130,036DFEF8CA623F9034F928149FE2468D,30821,5,9,4,109.43681,18.33639,1274
163131,036DFEF8CA623F9034F928149FE2468D,60011,11,23,12,109.48965,18.30222,1468
163161,F8D799D9161B0143E0D71C40472A357E,38991,0,4,4,109.52681,18.30368,1618
163162,F8D799D9161B0143E0D71C40472A357E,30071,6,8,2,109.52819,18.30472,1619
163163,F8D799D9161B0143E0D71C40472A357E,30071,10,12,2,109.52819,18.30472,1619
163164,F8D799D9161B0143E0D71C40472A357E,30071,13,21,8,109.52819,18.30472,1619
163165,F8D799D9161B0143E0D71C40472A357E,31951,21,22,1,109.52174,18.30299,1568
163177,5EE25A6E7DD554FFDA0C9C1A504114B7,60291,0,2,2,109.50826,18.24639,1509
163178,5EE25A6E7DD554FFDA0C9C1A504114B7,60291,2,6,4,109.50826,18.24639,1509
163179,5EE25A6E7DD554FFDA0C9C1A504114B7,30221,8,14,6,109.57833,18.20222,1802
163180,5EE25A6E7DD554FFDA0C9C1A504114B7,30071,18,19,1,109.52819,18.30472,1619
163181,5EE25A6E7DD554FFDA0C9C1A504114B7,30221,21,23,2,109.57833,18.20222,1802
163213,7BF65E5054DA81A230AB5423620158E1,30854,0,1,1,109.56889,18.27076,1763
163214,7BF65E5054DA81A230AB5423620158E1,31071,3,5,2,109.58257,18.28458,1815
163215,7BF65E5054DA81A230AB5423620158E1,30854,8,11,3,109.56889,18.27076,1763
163216,7BF65E5054DA81A230AB5423620158E1,60631,12,13,1,109.57778,18.27583,1814
163217,7BF65E5054DA81A230AB5423620158E1,30854,13,15,2,109.56889,18.27076,1763
163218,7BF65E5054DA81A230AB5423620158E1,31071,15,17,2,109.58257,18.28458,1815
163219,7BF65E5054DA81A230AB5423620158E1,30854,19,21,2,109.56889,18.27076,1763
163220,410ABF8C14ACED0B5467A09396FAD1E3,31071,1,5,4,109.58257,18.28458,1815
163221,410ABF8C14ACED0B5467A09396FAD1E3,31945,8,9,1,109.58021,18.29403,1817
163222,410ABF8C14ACED0B5467A09396FAD1E3,30854,12,20,8,109.56889,18.27076,1763
163225,D12046233C14C8451AD4125CF88323E3,31021,0,12,12,109.49021,18.27,1463
163251,C58D0182BFC61ED113EE3B09763C30B2,38185,0,6,6,109.51333,18.27347,1563
163252,C58D0182BFC61ED113EE3B09763C30B2,30281,7,8,1,109.50597,18.27583,1514
163253,C58D0182BFC61ED113EE3B09763C30B2,31931,8,11,3,109.54771,18.29403,1667
163254,C58D0182BFC61ED113EE3B09763C30B2,38721,13,14,1,109.50368,18.27542,1514
163255,C58D0182BFC61ED113EE3B09763C30B2,38185,18,23,5,109.51333,18.27347,1563
163335,9BF33DB1F7AC1D27E06AF501C14CCF2C,39181,15,17,2,109.55153,18.28035,1715
163336,9BF33DB1F7AC1D27E06AF501C14CCF2C,31931,18,23,5,109.54771,18.29403,1667
163345,A46BA306DAEA889FAC7ACE9E5FD6A1FF,30911,0,20,20,109.50493,18.26181,1511
163346,A46BA306DAEA889FAC7ACE9E5FD6A1FF,30421,20,22,2,109.50021,18.25861,1511
163359,B84B247FA61A8C12DFCCCF3C2D72006D,31071,3,9,6,109.58257,18.28458,1815
163360,B84B247FA61A8C12DFCCCF3C2D72006D,30854,9,10,1,109.56889,18.27076,1763
163361,B84B247FA61A8C12DFCCCF3C2D72006D,31071,11,19,8,109.58257,18.28458,1815
163362,B84B247FA61A8C12DFCCCF3C2D72006D,30854,20,21,1,109.56889,18.27076,1763
163368,27CFDDBDBE225F8224792B641031B794,33051,13,14,1,109.6475,18.46618,2096
163369,27CFDDBDBE225F8224792B641031B794,60381,16,19,3,109.5241,18.22458,1605
163370,27CFDDBDBE225F8224792B641031B794,31236,21,23,2,109.42965,18.29111,1216
163389,14F21534C21254001A38352AD4BB0EF6,30854,0,1,1,109.56889,18.27076,1763
163390,14F21534C21254001A38352AD4BB0EF6,31071,2,6,4,109.58257,18.28458,1815
163391,14F21534C21254001A38352AD4BB0EF6,30854,8,15,7,109.56889,18.27076,1763
163392,14F21534C21254001A38352AD4BB0EF6,31071,16,17,1,109.58257,18.28458,1815
163393,14F21534C21254001A38352AD4BB0EF6,30854,18,20,2,109.56889,18.27076,1763
163396,7F3DDE6B55C3459C61E435131FEEF622,30191,1,7,6,109.50361,18.22701,1506
163397,7F3DDE6B55C3459C61E435131FEEF622,30741,8,10,2,109.49833,18.28681,1516
163398,7F3DDE6B55C3459C61E435131FEEF622,60463,12,14,2,109.52507,18.22438,1605
163399,7F3DDE6B55C3459C61E435131FEEF622,30611,18,23,5,109.74958,18.40188,2485
163409,6C0260646767B781577B5B8CE2471E51,30071,21,22,1,109.52819,18.30472,1619
163410,6C0260646767B781577B5B8CE2471E51,38484,22,23,1,109.53028,18.31528,1620
163457,C1C69C0EAD4ABEFD1467543102429D9B,30854,1,2,1,109.56889,18.27076,1763
163458,C1C69C0EAD4ABEFD1467543102429D9B,39183,4,5,1,109.55542,18.28208,1715
163459,C1C69C0EAD4ABEFD1467543102429D9B,31561,5,14,9,109.56792,18.28479,1765
163460,C1C69C0EAD4ABEFD1467543102429D9B,30281,18,23,5,109.50597,18.27583,1514
163473,63B5E489F3503F8EC6E40A38F9D2117C,60171,0,19,19,109.51292,18.30694,1569
163474,63B5E489F3503F8EC6E40A38F9D2117C,60361,19,21,2,109.51938,18.29681,1567
163478,41C41C21BD6663648BFE9928451490DC,39111,0,8,8,109.5191,18.22597,1555
163479,41C41C21BD6663648BFE9928451490DC,31471,12,14,2,109.34583,18.29563,917
163480,41C41C21BD6663648BFE9928451490DC,31521,18,23,5,109.51458,18.22542,1555
163493,FAC035CAF00431CACD74AF53D18C4996,30111,0,1,1,109.47583,18.30542,1419
163494,FAC035CAF00431CACD74AF53D18C4996,60011,5,6,1,109.48965,18.30222,1468
163495,FAC035CAF00431CACD74AF53D18C4996,30764,9,11,2,109.45806,18.29486,1367
163496,FAC035CAF00431CACD74AF53D18C4996,30761,14,15,1,109.45201,18.3,1318
163497,FAC035CAF00431CACD74AF53D18C4996,30111,16,18,2,109.47583,18.30542,1419
163507,1254ED270726E34A8E3E0767CE400812,31071,3,5,2,109.58257,18.28458,1815
163508,1254ED270726E34A8E3E0767CE400812,31945,8,10,2,109.58021,18.29403,1817
163509,1254ED270726E34A8E3E0767CE400812,31071,12,17,5,109.58257,18.28458,1815
163517,CFFDD1BF3134B9FDD71614F40E1DE0FD,30854,2,4,2,109.56889,18.27076,1763
163518,CFFDD1BF3134B9FDD71614F40E1DE0FD,31071,4,6,2,109.58257,18.28458,1815
163519,CFFDD1BF3134B9FDD71614F40E1DE0FD,31945,10,11,1,109.58021,18.29403,1817
163520,CFFDD1BF3134B9FDD71614F40E1DE0FD,31071,14,21,7,109.58257,18.28458,1815
163543,BB6A9729DE557ADD6D3E7E09F28116DB,30731,0,1,1,109.50944,18.22306,1555
163544,BB6A9729DE557ADD6D3E7E09F28116DB,30511,2,6,4,109.51069,18.24208,1558
163545,BB6A9729DE557ADD6D3E7E09F28116DB,30191,6,7,1,109.50361,18.22701,1506
163546,BB6A9729DE557ADD6D3E7E09F28116DB,31145,9,10,1,109.20431,18.30479,369
163547,BB6A9729DE557ADD6D3E7E09F28116DB,31471,13,15,2,109.34583,18.29563,917
163548,8AABF5FDF2B06EB445749240A3894969,31071,4,6,2,109.58257,18.28458,1815
163549,8AABF5FDF2B06EB445749240A3894969,31561,6,8,2,109.56792,18.28479,1765
163550,8AABF5FDF2B06EB445749240A3894969,30854,9,11,2,109.56889,18.27076,1763
163551,8AABF5FDF2B06EB445749240A3894969,31851,11,12,1,109.71736,18.29007,2316
163552,8AABF5FDF2B06EB445749240A3894969,31161,13,15,2,109.70229,18.31361,2270
163553,8AABF5FDF2B06EB445749240A3894969,30854,20,21,1,109.56889,18.27076,1763
163554,8AABF5FDF2B06EB445749240A3894969,31071,22,23,1,109.58257,18.28458,1815
163555,075F360F88180B9A93BF11A5704B49F3,30961,12,14,2,109.74042,18.37903,2431
163556,075F360F88180B9A93BF11A5704B49F3,60121,17,20,3,109.74507,18.37472,2430
163597,FD9120CA3F85D3F015CEFB66B9BF2F3D,30721,0,7,7,109.51597,18.28257,1565
163598,FD9120CA3F85D3F015CEFB66B9BF2F3D,60301,8,11,3,109.60715,18.30993,1919
163599,FD9120CA3F85D3F015CEFB66B9BF2F3D,30721,13,16,3,109.51597,18.28257,1565
163600,FD9120CA3F85D3F015CEFB66B9BF2F3D,60301,18,20,2,109.60715,18.30993,1919
163601,FD9120CA3F85D3F015CEFB66B9BF2F3D,30721,21,22,1,109.51597,18.28257,1565
163610,1644C78B6566683D75956618DC25318D,31061,0,8,8,109.53333,18.23257,1607
163611,1644C78B6566683D75956618DC25318D,30161,9,13,4,109.50042,18.24389,1508
163612,1644C78B6566683D75956618DC25318D,31061,13,23,10,109.53333,18.23257,1607
163642,E8BAAF476E8FE57075BAB1A8D4FF1780,30232,0,4,4,109.6191,18.31701,1971
163643,E8BAAF476E8FE57075BAB1A8D4FF1780,39371,6,8,2,109.56627,18.2646,1762
163644,E8BAAF476E8FE57075BAB1A8D4FF1780,30181,11,12,1,109.51597,18.23313,1557
163645,E8BAAF476E8FE57075BAB1A8D4FF1780,39371,13,14,1,109.56627,18.2646,1762
163687,9A1D1AA5EE2CD156CC396C667ED8C5B9,31071,0,6,6,109.58257,18.28458,1815
163688,9A1D1AA5EE2CD156CC396C667ED8C5B9,31164,9,16,7,109.69993,18.27215,2263
163689,9A1D1AA5EE2CD156CC396C667ED8C5B9,30854,17,18,1,109.56889,18.27076,1763
163711,BAF784C90E903A1C0CEDF594F05C3F50,60221,1,3,2,109.52569,18.29188,1616
163712,BAF784C90E903A1C0CEDF594F05C3F50,30121,3,8,5,109.52861,18.27222,1613
163713,BAF784C90E903A1C0CEDF594F05C3F50,30181,9,15,6,109.51597,18.23313,1557
163734,798BF3B08F72A16A6DEAAA235F1899BB,61011,5,19,14,109.60653,18.19076,1900
163746,0D48FD835B207ED202CAB110B7436DC2,31071,0,14,14,109.58257,18.28458,1815
163747,0D48FD835B207ED202CAB110B7436DC2,30854,16,17,1,109.56889,18.27076,1763
163748,0D48FD835B207ED202CAB110B7436DC2,31821,20,21,1,109.51181,18.24924,1559
163753,BBEE5F721A31A0C7CA0CDB43309D2457,38754,12,13,1,109.74667,18.37382,2430
163754,BBEE5F721A31A0C7CA0CDB43309D2457,38951,18,20,2,109.48097,18.28868,1416
163755,BBEE5F721A31A0C7CA0CDB43309D2457,60401,20,23,3,109.47444,18.27583,1414
163768,77F4AC7CCE20E40974362ED501828AE5,60621,2,7,5,109.48354,18.27451,1464
163769,77F4AC7CCE20E40974362ED501828AE5,60161,9,14,5,109.49174,18.26181,1461
163770,77F4AC7CCE20E40974362ED501828AE5,31411,18,19,1,109.5016,18.23576,1507
163771,209DF6A91F218920F5741E5EF3086DD3,31071,0,8,8,109.58257,18.28458,1815
163772,209DF6A91F218920F5741E5EF3086DD3,30421,12,14,2,109.50021,18.25861,1511
163773,209DF6A91F218920F5741E5EF3086DD3,30854,14,15,1,109.56889,18.27076,1763
163774,209DF6A91F218920F5741E5EF3086DD3,31071,19,23,4,109.58257,18.28458,1815
163806,AD6E05A888C5166E4DCB46810FF747A8,31701,2,3,1,109.44132,18.28833,1266
163807,AD6E05A888C5166E4DCB46810FF747A8,31701,3,10,7,109.44132,18.28833,1266
163808,AD6E05A888C5166E4DCB46810FF747A8,38111,13,16,3,109.52007,18.22403,1555
163813,91F59FD84A5A011AF1877621EDB85B69,38706,0,16,16,109.74625,18.37097,2430
163814,91F59FD84A5A011AF1877621EDB85B69,38706,17,23,6,109.74625,18.37097,2430
163818,4E9C3D8DBD7B4A03D77C4314ACCD7B6D,38951,1,2,1,109.48097,18.28868,1416
163819,4E9C3D8DBD7B4A03D77C4314ACCD7B6D,38951,3,4,1,109.48097,18.28868,1416
163820,4E9C3D8DBD7B4A03D77C4314ACCD7B6D,38951,5,6,1,109.48097,18.28868,1416
163821,4E9C3D8DBD7B4A03D77C4314ACCD7B6D,38951,6,9,3,109.48097,18.28868,1416
163822,4E9C3D8DBD7B4A03D77C4314ACCD7B6D,38315,14,15,1,109.48979,18.29764,1467
163911,6751CEC3CF9B2AE78246C7287443D2B4,31945,0,3,3,109.58021,18.29403,1817
163912,6751CEC3CF9B2AE78246C7287443D2B4,30854,7,19,12,109.56889,18.27076,1763
163921,0FFE97B54C688D2EEA9662A15AA9CB9D,30281,0,3,3,109.50597,18.27583,1514
163922,0FFE97B54C688D2EEA9662A15AA9CB9D,30291,5,7,2,109.50403,18.27028,1513
163923,0FFE97B54C688D2EEA9662A15AA9CB9D,38157,7,8,1,109.51483,18.26958,1563
163924,0FFE97B54C688D2EEA9662A15AA9CB9D,33481,11,16,5,109.67278,18.41278,2187
163925,0FFE97B54C688D2EEA9662A15AA9CB9D,30291,20,23,3,109.50403,18.27028,1513
163926,0D1B933C65704EEE0CFA016AED0F8FDF,31071,1,2,1,109.58257,18.28458,1815
163927,0D1B933C65704EEE0CFA016AED0F8FDF,30854,3,10,7,109.56889,18.27076,1763
163928,0D1B933C65704EEE0CFA016AED0F8FDF,31071,14,23,9,109.58257,18.28458,1815
163978,4D4289AE0DFBF4B5C79A47559DC2EBDD,31071,1,6,5,109.58257,18.28458,1815
163979,4D4289AE0DFBF4B5C79A47559DC2EBDD,30854,6,7,1,109.56889,18.27076,1763
163980,4D4289AE0DFBF4B5C79A47559DC2EBDD,39371,8,10,2,109.56627,18.2646,1762
163991,68DBE0B52FD0AB95F1DD47068FD7847F,30181,0,1,1,109.51597,18.23313,1557
163992,68DBE0B52FD0AB95F1DD47068FD7847F,31521,2,5,3,109.51458,18.22542,1555
163993,68DBE0B52FD0AB95F1DD47068FD7847F,30181,5,7,2,109.51597,18.23313,1557
163994,68DBE0B52FD0AB95F1DD47068FD7847F,31521,9,11,2,109.51458,18.22542,1555
163995,68DBE0B52FD0AB95F1DD47068FD7847F,30361,13,16,3,109.50347,18.24,1508
163996,68DBE0B52FD0AB95F1DD47068FD7847F,31201,18,19,1,109.51042,18.23819,1558
163997,68DBE0B52FD0AB95F1DD47068FD7847F,30181,20,22,2,109.51597,18.23313,1557
164039,BA03E00C1E8A034E0F06517E78EC4066,31691,11,17,6,109.36604,18.3075,1019
164040,BA03E00C1E8A034E0F06517E78EC4066,31121,21,23,2,109.16292,18.37063,230
164060,D16C062350492867096E1F38A610E35D,30151,0,19,19,109.50986,18.25083,1560
164061,D16C062350492867096E1F38A610E35D,31821,21,23,2,109.51181,18.24924,1559
164066,2FAD245BB53FEB8086E954B3DFCAA678,60671,0,9,9,109.52979,18.31757,1621
164067,2FAD245BB53FEB8086E954B3DFCAA678,30031,11,14,3,109.53681,18.33313,1673
164068,2FAD245BB53FEB8086E954B3DFCAA678,60661,16,18,2,109.548,18.2377,1657
164069,2FAD245BB53FEB8086E954B3DFCAA678,30361,19,20,1,109.50347,18.24,1508
164070,2FAD245BB53FEB8086E954B3DFCAA678,30031,21,23,2,109.53681,18.33313,1673
164082,E58E5EFF0A1D7ADABE8F5BBEE665ED0D,39321,2,7,5,109.529,18.2167,1604
164083,E58E5EFF0A1D7ADABE8F5BBEE665ED0D,30861,8,13,5,109.52722,18.22743,1606
164084,E58E5EFF0A1D7ADABE8F5BBEE665ED0D,31061,15,16,1,109.53333,18.23257,1607
164085,E58E5EFF0A1D7ADABE8F5BBEE665ED0D,30861,17,22,5,109.52722,18.22743,1606
164098,DECB7B3FC95BFA8620EFD8D9DE328252,31945,14,15,1,109.58021,18.29403,1817
164099,DECB7B3FC95BFA8620EFD8D9DE328252,30854,16,18,2,109.56889,18.27076,1763
164113,7E95AEA91A37473FF71C625BDD54FD92,60361,0,1,1,109.51938,18.29681,1567
164114,7E95AEA91A37473FF71C625BDD54FD92,60226,3,4,1,109.5175,18.28778,1566
164115,7E95AEA91A37473FF71C625BDD54FD92,60361,4,21,17,109.51938,18.29681,1567
164132,172CB232BBE684655CFBDFD055BB1CB5,60291,13,14,1,109.50826,18.24639,1509
164133,172CB232BBE684655CFBDFD055BB1CB5,38127,15,16,1,109.50833,18.27222,1513
164134,172CB232BBE684655CFBDFD055BB1CB5,30291,19,21,2,109.50403,18.27028,1513
164201,4E9C73925B67466BCE6AE7E22B99BF20,31561,4,8,4,109.56792,18.28479,1765
164202,4E9C73925B67466BCE6AE7E22B99BF20,30854,10,21,11,109.56889,18.27076,1763
164211,A7FDF665A78FC5E85D90E0F0BDBE51A2,30191,2,8,6,109.50361,18.22701,1506
164212,A7FDF665A78FC5E85D90E0F0BDBE51A2,31145,11,13,2,109.20431,18.30479,369
164213,A7FDF665A78FC5E85D90E0F0BDBE51A2,60054,16,17,1,109.3016,18.31229,770
164244,2D8DD824BBF69AD8F67DA5D5B6F17323,31261,0,2,2,109.51174,18.2466,1559
164245,2D8DD824BBF69AD8F67DA5D5B6F17323,31461,3,5,2,109.5091,18.25389,1510
164246,2D8DD824BBF69AD8F67DA5D5B6F17323,60201,6,10,4,109.5041,18.2509,1510
164247,2D8DD824BBF69AD8F67DA5D5B6F17323,30991,13,16,3,109.30847,18.44139,791
164248,2D8DD824BBF69AD8F67DA5D5B6F17323,38891,18,20,2,109.51486,18.24118,1558
164249,2D8DD824BBF69AD8F67DA5D5B6F17323,60201,21,23,2,109.5041,18.2509,1510
164271,B175A0347ABEEA30E818C5CCD25E280F,30651,0,1,1,109.42611,18.385,1232
164272,B175A0347ABEEA30E818C5CCD25E280F,30821,1,20,19,109.43681,18.33639,1274
164291,8B69C410684F618B4BB94E686E30E787,31531,7,9,2,109.49583,18.25972,1461
164292,8B69C410684F618B4BB94E686E30E787,31471,12,14,2,109.34583,18.29563,917
164293,8B69C410684F618B4BB94E686E30E787,30421,16,18,2,109.50021,18.25861,1511
164294,8B69C410684F618B4BB94E686E30E787,31531,19,21,2,109.49583,18.25972,1461
164302,C9A281EF0BD980779EA579DF3160E0C7,30211,11,13,2,109.49882,18.23931,1508
164303,C9A281EF0BD980779EA579DF3160E0C7,30161,18,19,1,109.50042,18.24389,1508
164304,C9A281EF0BD980779EA579DF3160E0C7,30211,19,20,1,109.49882,18.23931,1508
164305,C9A281EF0BD980779EA579DF3160E0C7,60614,21,23,2,109.48799,18.29521,1467
164316,90D91A493F9482486DCC3B27CF3F61EE,30854,0,7,7,109.56889,18.27076,1763
164317,90D91A493F9482486DCC3B27CF3F61EE,31071,10,12,2,109.58257,18.28458,1815
164318,90D91A493F9482486DCC3B27CF3F61EE,30854,15,16,1,109.56889,18.27076,1763
164324,7C68E1F4B8B2F3CBBD5427BF66BF9C2E,31321,16,18,2,109.63799,18.23201,2007
164325,7C68E1F4B8B2F3CBBD5427BF66BF9C2E,30581,18,20,2,109.62257,18.24951,1959
164342,15195C578D4A8081B069C4B518039EFC,60231,1,6,5,109.49903,18.21972,1504
164343,15195C578D4A8081B069C4B518039EFC,60161,9,10,1,109.49174,18.26181,1461
164344,15195C578D4A8081B069C4B518039EFC,30051,11,14,3,109.48917,18.21215,1453
164345,15195C578D4A8081B069C4B518039EFC,60161,16,22,6,109.49174,18.26181,1461
164358,B02D7A3F297B377D646E0F85B7C19006,61011,0,10,10,109.60653,18.19076,1900
164360,B02D7A3F297B377D646E0F85B7C19006,61011,12,23,11,109.60653,18.19076,1900
164372,7F6E66BC10419161F6457A6D79258EDB,38094,10,11,1,109.45403,18.28778,1316
164373,7F6E66BC10419161F6457A6D79258EDB,38251,11,13,2,109.49618,18.25493,1510
164374,7F6E66BC10419161F6457A6D79258EDB,38094,14,15,1,109.45403,18.28778,1316
164375,7F6E66BC10419161F6457A6D79258EDB,30341,16,17,1,109.3625,18.29167,966
164376,7F6E66BC10419161F6457A6D79258EDB,60621,20,22,2,109.48354,18.27451,1464
164383,BD5D5103B08534F20AF53FB58E9A43CA,38241,1,5,4,109.54111,18.30542,1669
164384,BD5D5103B08534F20AF53FB58E9A43CA,31931,5,6,1,109.54771,18.29403,1667
164385,BD5D5103B08534F20AF53FB58E9A43CA,38241,7,9,2,109.54111,18.30542,1669
164386,BD5D5103B08534F20AF53FB58E9A43CA,31931,11,13,2,109.54771,18.29403,1667
164387,246EF4D95FA494895EFB2D649512DAE7,31521,0,5,5,109.51458,18.22542,1555
164389,246EF4D95FA494895EFB2D649512DAE7,61011,17,18,1,109.60653,18.19076,1900
164399,080247CC19405F981D4BEFE1A1E9D339,31931,1,4,3,109.54771,18.29403,1667
164400,080247CC19405F981D4BEFE1A1E9D339,39181,8,23,15,109.55153,18.28035,1715
164406,DD8DCE806AFFEAC5D779812E5F8F2B3D,30281,1,4,3,109.50597,18.27583,1514
164407,DD8DCE806AFFEAC5D779812E5F8F2B3D,31071,6,9,3,109.58257,18.28458,1815
164408,DD8DCE806AFFEAC5D779812E5F8F2B3D,30854,10,11,1,109.56889,18.27076,1763
164409,DD8DCE806AFFEAC5D779812E5F8F2B3D,31071,13,14,1,109.58257,18.28458,1815
164421,372A5433078073EAD18922D679CE0A73,60054,0,8,8,109.3016,18.31229,770
164422,372A5433078073EAD18922D679CE0A73,60411,12,13,1,109.32514,18.30854,869
164423,372A5433078073EAD18922D679CE0A73,60054,14,15,1,109.3016,18.31229,770
164424,372A5433078073EAD18922D679CE0A73,60411,15,17,2,109.32514,18.30854,869
164425,372A5433078073EAD18922D679CE0A73,60054,20,21,1,109.3016,18.31229,770
164426,372A5433078073EAD18922D679CE0A73,30661,22,23,1,109.37028,18.24361,1008
164436,BCE751A95FD4E47157356B205E676C81,30351,0,16,16,109.41701,18.29292,1217
164437,BCE751A95FD4E47157356B205E676C81,30361,16,19,3,109.50347,18.24,1508
164441,24A5718F38ADE9789750DBD9F143F189,31031,19,21,2,109.49979,18.25382,1510
164442,24A5718F38ADE9789750DBD9F143F189,38951,21,23,2,109.48097,18.28868,1416
164455,A969AA4D78FD71B9F4E643F763F4C75F,30221,0,7,7,109.57833,18.20222,1802
164456,A969AA4D78FD71B9F4E643F763F4C75F,31521,7,9,2,109.51458,18.22542,1555
164457,A969AA4D78FD71B9F4E643F763F4C75F,31521,11,21,10,109.51458,18.22542,1555
164458,A969AA4D78FD71B9F4E643F763F4C75F,60381,21,23,2,109.5241,18.22458,1605
164526,BA987FAAC62A550769ECB5E13AC256A5,38171,0,9,9,109.50799,18.28139,1515
164527,BA987FAAC62A550769ECB5E13AC256A5,31864,12,13,1,109.49014,18.28333,1465
164528,BA987FAAC62A550769ECB5E13AC256A5,31931,15,17,2,109.54771,18.29403,1667
164529,BA987FAAC62A550769ECB5E13AC256A5,39151,18,20,2,109.49875,18.25097,1510
164530,BA987FAAC62A550769ECB5E13AC256A5,60281,22,23,1,109.51743,18.25924,1561
164535,C925EDC1C2C39BAEC75090090BF059D6,30721,16,18,2,109.51597,18.28257,1565
164536,C925EDC1C2C39BAEC75090090BF059D6,30741,19,23,4,109.49833,18.28681,1516
164556,FF8CB3D02361FAEBFE418108180099D8,39154,0,6,6,109.50201,18.25681,1511
164557,FF8CB3D02361FAEBFE418108180099D8,60201,6,15,9,109.5041,18.2509,1510
164558,FF8CB3D02361FAEBFE418108180099D8,30711,15,22,7,109.50271,18.25347,1510
164578,D4EE8E1A4C04A1FF0596E4221D0B8B42,31071,1,5,4,109.58257,18.28458,1815
164579,D4EE8E1A4C04A1FF0596E4221D0B8B42,30854,7,8,1,109.56889,18.27076,1763
164580,D4EE8E1A4C04A1FF0596E4221D0B8B42,31221,8,10,2,109.61333,18.26833,1913
164581,D4EE8E1A4C04A1FF0596E4221D0B8B42,30854,12,13,1,109.56889,18.27076,1763
164603,5A888DC7A3AA300CC584D9862C5384A1,30421,4,6,2,109.50021,18.25861,1511
164604,5A888DC7A3AA300CC584D9862C5384A1,30771,7,9,2,109.49938,18.26042,1511
164605,5A888DC7A3AA300CC584D9862C5384A1,39183,12,18,6,109.55542,18.28208,1715
164627,45FC4D7B7AEB1BB8222449DDC064C06B,31945,0,6,6,109.58021,18.29403,1817
164628,45FC4D7B7AEB1BB8222449DDC064C06B,30854,8,9,1,109.56889,18.27076,1763
164629,45FC4D7B7AEB1BB8222449DDC064C06B,31945,9,22,13,109.58021,18.29403,1817
164663,8CF08DEE8EF83AC7333B837D79034776,38121,0,8,8,109.51361,18.27813,1564
164665,8CF08DEE8EF83AC7333B837D79034776,31531,17,23,6,109.49583,18.25972,1461
164687,FBDD80570A641C18D89F4987D07601F8,31561,2,5,3,109.56792,18.28479,1765
164688,FBDD80570A641C18D89F4987D07601F8,30854,7,22,15,109.56889,18.27076,1763
164710,7BB0E357F79DCC3BC5358A41DFC62FBE,30854,13,20,7,109.56889,18.27076,1763
164711,7BB0E357F79DCC3BC5358A41DFC62FBE,31561,21,23,2,109.56792,18.28479,1765
164741,302C193EE9901423C2412C2BB087FCC7,30351,8,10,2,109.41701,18.29292,1217
164742,302C193EE9901423C2412C2BB087FCC7,31091,11,13,2,109.41201,18.31222,1170
164743,302C193EE9901423C2412C2BB087FCC7,38706,14,22,8,109.74625,18.37097,2430
164751,A9F97D2464709590426A157138F3C687,31931,0,10,10,109.54771,18.29403,1667
164752,A9F97D2464709590426A157138F3C687,39181,10,11,1,109.55153,18.28035,1715
164753,A9F97D2464709590426A157138F3C687,31931,12,14,2,109.54771,18.29403,1667
164754,A9F97D2464709590426A157138F3C687,39181,18,19,1,109.55153,18.28035,1715
164755,A9F97D2464709590426A157138F3C687,31931,19,20,1,109.54771,18.29403,1667
164826,775EB6812979C1B34766B2D30E0D2441,31701,0,5,5,109.44132,18.28833,1266
164827,775EB6812979C1B34766B2D30E0D2441,38871,7,9,2,109.44681,18.28625,1316
164859,17D13F6A66037B54FAB5668CDC734401,30721,0,7,7,109.51597,18.28257,1565
164860,17D13F6A66037B54FAB5668CDC734401,31931,9,17,8,109.54771,18.29403,1667
164861,17D13F6A66037B54FAB5668CDC734401,30721,19,23,4,109.51597,18.28257,1565
164909,430614CCBE3C6FA65CA55D075D8A9EA2,31071,0,6,6,109.58257,18.28458,1815
164910,430614CCBE3C6FA65CA55D075D8A9EA2,31945,8,9,1,109.58021,18.29403,1817
164911,430614CCBE3C6FA65CA55D075D8A9EA2,30854,12,17,5,109.56889,18.27076,1763
164912,430614CCBE3C6FA65CA55D075D8A9EA2,31071,19,23,4,109.58257,18.28458,1815
164921,07656689F72FAC39425758CA91F1B696,31781,16,17,1,109.19847,18.2975,367
164922,07656689F72FAC39425758CA91F1B696,60221,19,20,1,109.52569,18.29188,1616
164923,07656689F72FAC39425758CA91F1B696,30181,22,23,1,109.51597,18.23313,1557
164924,81D70A3ED522BA9C5A3A11D0C612F029,30191,0,6,6,109.50361,18.22701,1506
164925,81D70A3ED522BA9C5A3A11D0C612F029,30661,8,17,9,109.37028,18.24361,1008
164926,81D70A3ED522BA9C5A3A11D0C612F029,31521,20,22,2,109.51458,18.22542,1555
164927,36BCA39777B9D1E703C1404CDA6A45E7,30511,0,8,8,109.51069,18.24208,1558
164928,36BCA39777B9D1E703C1404CDA6A45E7,30511,9,11,2,109.51069,18.24208,1558
164929,36BCA39777B9D1E703C1404CDA6A45E7,31521,13,14,1,109.51458,18.22542,1555
164930,36BCA39777B9D1E703C1404CDA6A45E7,30511,15,17,2,109.51069,18.24208,1558
164931,36BCA39777B9D1E703C1404CDA6A45E7,30511,20,23,3,109.51069,18.24208,1558
164939,8D3B10FD4DBC46DB93DA60040668F697,30854,0,13,13,109.56889,18.27076,1763
164940,8D3B10FD4DBC46DB93DA60040668F697,39183,15,16,1,109.55542,18.28208,1715
164941,8D3B10FD4DBC46DB93DA60040668F697,30854,19,23,4,109.56889,18.27076,1763
164953,855D815DC19AA779325469411A9E7B8A,38157,12,15,3,109.51483,18.26958,1563
164954,855D815DC19AA779325469411A9E7B8A,30251,17,23,6,109.50611,18.26653,1512
164999,8621CFDF1B89A83351494618C53D033F,31071,0,5,5,109.58257,18.28458,1815
165000,8621CFDF1B89A83351494618C53D033F,39181,8,19,11,109.55153,18.28035,1715
165061,B125AF31137882D184643AC445C2034E,31521,20,21,1,109.51458,18.22542,1555
165062,B125AF31137882D184643AC445C2034E,60381,22,23,1,109.5241,18.22458,1605
165074,BC78511C0B1B49984ADDBA304773FFF3,31521,14,17,3,109.51458,18.22542,1555
165075,BC78511C0B1B49984ADDBA304773FFF3,38111,17,22,5,109.52007,18.22403,1555
165084,EB291EA7E3235FF23960DA865075F183,60281,0,7,7,109.51743,18.25924,1561
165085,EB291EA7E3235FF23960DA865075F183,39101,8,12,4,109.50132,18.24931,1509
165086,EB291EA7E3235FF23960DA865075F183,60281,13,14,1,109.51743,18.25924,1561
165087,EB291EA7E3235FF23960DA865075F183,39091,14,15,1,109.50097,18.25222,1510
165099,BBE4FEE5DC356F34A55E0F5D610B7841,38961,0,5,5,109.50847,18.23514,1507
165100,BBE4FEE5DC356F34A55E0F5D610B7841,31201,6,7,1,109.51042,18.23819,1558
165101,BBE4FEE5DC356F34A55E0F5D610B7841,31201,10,19,9,109.51042,18.23819,1558
165102,BBE4FEE5DC356F34A55E0F5D610B7841,38961,21,22,1,109.50847,18.23514,1507
165126,3456EF45A9AD00721451876A26BECEFE,39321,3,5,2,109.529,18.2167,1604
165127,3456EF45A9AD00721451876A26BECEFE,60381,7,23,16,109.5241,18.22458,1605
165156,8B3125BACE32612AE7F9DC5599DC75E6,30731,0,7,7,109.50944,18.22306,1555
165157,8B3125BACE32612AE7F9DC5599DC75E6,30661,8,9,1,109.37028,18.24361,1008
165158,8B3125BACE32612AE7F9DC5599DC75E6,39061,11,12,1,109.38222,18.28958,1066
165159,8B3125BACE32612AE7F9DC5599DC75E6,30661,12,18,6,109.37028,18.24361,1008
165160,8B3125BACE32612AE7F9DC5599DC75E6,60081,20,23,3,109.51097,18.22639,1556
165167,E9F64FD67E39C3E2C15C20715338A941,30921,0,9,9,109.53903,18.29451,1667
165168,E9F64FD67E39C3E2C15C20715338A941,31931,11,13,2,109.54771,18.29403,1667
165169,E9F64FD67E39C3E2C15C20715338A941,30921,15,18,3,109.53903,18.29451,1667
165170,E9F64FD67E39C3E2C15C20715338A941,31931,18,19,1,109.54771,18.29403,1667
165237,13C882817D5EF3329D8612AEE7E0F34D,31864,0,15,15,109.49014,18.28333,1465
165238,13C882817D5EF3329D8612AEE7E0F34D,30711,15,16,1,109.50271,18.25347,1510
165239,13C882817D5EF3329D8612AEE7E0F34D,31864,17,18,1,109.49014,18.28333,1465
165240,13C882817D5EF3329D8612AEE7E0F34D,30084,19,22,3,109.50118,18.26972,1513
165251,8F3DE08315D720DC64DC898C5903196E,60631,0,4,4,109.57778,18.27583,1814
165252,8F3DE08315D720DC64DC898C5903196E,30854,7,23,16,109.56889,18.27076,1763
165255,EB316856896788EC8FD871E122E95728,60361,0,7,7,109.51938,18.29681,1567
165256,EB316856896788EC8FD871E122E95728,31811,8,11,3,109.54201,18.31806,1671
165257,EB316856896788EC8FD871E122E95728,30101,12,14,2,109.57299,18.33333,1773
165258,EB316856896788EC8FD871E122E95728,30701,16,21,5,109.59313,18.32007,1871
165270,CBA29FB366E4111071C95C99C696D0E6,31561,0,8,8,109.56792,18.28479,1765
165271,CBA29FB366E4111071C95C99C696D0E6,30854,8,11,3,109.56889,18.27076,1763
165272,CBA29FB366E4111071C95C99C696D0E6,31561,11,20,9,109.56792,18.28479,1765
165273,CBA29FB366E4111071C95C99C696D0E6,30854,20,21,1,109.56889,18.27076,1763
165280,10549B1717E5239D7AEBFC330945270F,30661,1,2,1,109.37028,18.24361,1008
165281,10549B1717E5239D7AEBFC330945270F,60411,3,7,4,109.32514,18.30854,869
165288,878FC5EBB1B28FAABA6E6BFD01664318,30251,12,16,4,109.50611,18.26653,1512
165289,878FC5EBB1B28FAABA6E6BFD01664318,30711,17,18,1,109.50271,18.25347,1510
165290,878FC5EBB1B28FAABA6E6BFD01664318,30251,19,23,4,109.50611,18.26653,1512
165360,4B004637D3CFBCA65EA00FFD3F1EF7A6,30854,0,3,3,109.56889,18.27076,1763
165361,4B004637D3CFBCA65EA00FFD3F1EF7A6,39183,3,11,8,109.55542,18.28208,1715
165362,4B004637D3CFBCA65EA00FFD3F1EF7A6,31561,11,13,2,109.56792,18.28479,1765
165363,FA6D7510012E571D09E23E75BE9DD4E6,60441,2,6,4,109.46792,18.28604,1366
165364,FA6D7510012E571D09E23E75BE9DD4E6,38251,9,10,1,109.49618,18.25493,1510
165365,FA6D7510012E571D09E23E75BE9DD4E6,31031,14,22,8,109.49979,18.25382,1510
165419,706B8E0F0F5D1C9FC2F8EBB2574EE89F,60201,0,2,2,109.5041,18.2509,1510
165420,706B8E0F0F5D1C9FC2F8EBB2574EE89F,31461,2,7,5,109.5091,18.25389,1510
165421,706B8E0F0F5D1C9FC2F8EBB2574EE89F,30711,8,10,2,109.50271,18.25347,1510
165422,706B8E0F0F5D1C9FC2F8EBB2574EE89F,30911,10,21,11,109.50493,18.26181,1511
165423,706B8E0F0F5D1C9FC2F8EBB2574EE89F,30711,22,23,1,109.50271,18.25347,1510
165433,44B54E64DFC324A23E66F52E98A481FB,30211,0,9,9,109.49882,18.23931,1508
165434,44B54E64DFC324A23E66F52E98A481FB,31145,11,13,2,109.20431,18.30479,369
165435,44B54E64DFC324A23E66F52E98A481FB,31781,13,14,1,109.19847,18.2975,367
165436,44B54E64DFC324A23E66F52E98A481FB,30211,17,21,4,109.49882,18.23931,1508
165439,EBD16061EA20EE33D9344D33735E5205,38891,0,6,6,109.51486,18.24118,1558
165440,EBD16061EA20EE33D9344D33735E5205,31261,8,10,2,109.51174,18.2466,1559
165441,EBD16061EA20EE33D9344D33735E5205,31201,10,19,9,109.51042,18.23819,1558
165442,EBD16061EA20EE33D9344D33735E5205,38891,20,21,1,109.51486,18.24118,1558
165473,9B43F93397D8AD2193F77AAD4D6186E5,30721,0,8,8,109.51597,18.28257,1565
165476,9B43F93397D8AD2193F77AAD4D6186E5,30721,18,23,5,109.51597,18.28257,1565
165490,019EB913544B8855829875D27D9C85B6,60361,0,1,1,109.51938,18.29681,1567
165491,019EB913544B8855829875D27D9C85B6,31201,2,9,7,109.51042,18.23819,1558
165492,019EB913544B8855829875D27D9C85B6,30511,12,14,2,109.51069,18.24208,1558
165493,019EB913544B8855829875D27D9C85B6,30181,16,18,2,109.51597,18.23313,1557
165520,2FD3D62C2F03A29CB2B8169833F320AE,31521,15,18,3,109.51458,18.22542,1555
165521,2FD3D62C2F03A29CB2B8169833F320AE,31421,18,20,2,109.55382,18.22347,1705
165522,2FD3D62C2F03A29CB2B8169833F320AE,60381,20,22,2,109.5241,18.22458,1605
165546,DE85A2F9432633114A7B9A1B323B8AE9,30051,0,8,8,109.48917,18.21215,1453
165547,DE85A2F9432633114A7B9A1B323B8AE9,60231,8,10,2,109.49903,18.21972,1504
165548,DE85A2F9432633114A7B9A1B323B8AE9,30051,10,23,13,109.48917,18.21215,1453
165584,1D613D61EB380544A693E6450D8A9DB4,31345,0,8,8,109.39,18.29,1066
165585,1D613D61EB380544A693E6450D8A9DB4,31145,10,12,2,109.20431,18.30479,369
165586,1D613D61EB380544A693E6450D8A9DB4,31471,13,15,2,109.34583,18.29563,917
165587,1D613D61EB380544A693E6450D8A9DB4,60551,18,20,2,109.42722,18.30111,1218
165588,1D613D61EB380544A693E6450D8A9DB4,31345,21,23,2,109.39,18.29,1066
165589,53BCE5F560CEFC5FCB7183DCF1733E93,30511,1,9,8,109.51069,18.24208,1558
165590,53BCE5F560CEFC5FCB7183DCF1733E93,30511,13,23,10,109.51069,18.24208,1558
165597,8873690CCFD5F63D42F0A4C5C2610D9F,31471,15,16,1,109.34583,18.29563,917
165598,8873690CCFD5F63D42F0A4C5C2610D9F,38754,18,20,2,109.74667,18.37382,2430
165601,5EBEA276FCB4A19AC5C987F5C7CC8908,60524,0,6,6,109.42951,18.28993,1216
165602,5EBEA276FCB4A19AC5C987F5C7CC8908,60401,7,18,11,109.47444,18.27583,1414
165603,5EBEA276FCB4A19AC5C987F5C7CC8908,60552,18,20,2,109.41729,18.30014,1218
165604,5EBEA276FCB4A19AC5C987F5C7CC8908,38361,20,21,1,109.43667,18.29201,1267
165605,3B6FF1F8D896A0A62DC7E65967011999,31561,0,3,3,109.56792,18.28479,1765
165606,3B6FF1F8D896A0A62DC7E65967011999,39183,5,23,18,109.55542,18.28208,1715
165609,54036114D002A873652B2123255670F7,38754,0,13,13,109.74667,18.37382,2430
165610,54036114D002A873652B2123255670F7,30361,17,19,2,109.50347,18.24,1508
165611,54036114D002A873652B2123255670F7,38336,20,22,2,109.61111,18.21806,1904
165632,45086BC0869D90A8E8F669EDA6561CFA,31071,0,1,1,109.58257,18.28458,1815
165633,45086BC0869D90A8E8F669EDA6561CFA,31945,1,14,13,109.58021,18.29403,1817
165634,45086BC0869D90A8E8F669EDA6561CFA,31071,17,23,6,109.58257,18.28458,1815
165639,DB4DF566D4757FF3BB488F82DE126248,31561,7,9,2,109.56792,18.28479,1765
165640,DB4DF566D4757FF3BB488F82DE126248,30854,9,10,1,109.56889,18.27076,1763
165663,0312B43ACF9ED1D8304E325E851AEE29,30851,6,14,8,109.5616,18.27396,1713
165664,0312B43ACF9ED1D8304E325E851AEE29,31561,14,16,2,109.56792,18.28479,1765
165665,0312B43ACF9ED1D8304E325E851AEE29,30851,16,21,5,109.5616,18.27396,1713
165666,0312B43ACF9ED1D8304E325E851AEE29,31561,21,22,1,109.56792,18.28479,1765
165672,24F13A92B374E6D95DDAA2ABBEAFF9C1,31345,0,8,8,109.39,18.29,1066
165673,24F13A92B374E6D95DDAA2ABBEAFF9C1,31781,10,12,2,109.19847,18.2975,367
165674,24F13A92B374E6D95DDAA2ABBEAFF9C1,31471,13,14,1,109.34583,18.29563,917
165675,24F13A92B374E6D95DDAA2ABBEAFF9C1,60551,18,19,1,109.42722,18.30111,1218
165676,24F13A92B374E6D95DDAA2ABBEAFF9C1,31345,22,23,1,109.39,18.29,1066
165687,59B48C7DD533E36B4AA6ADABEB53F8C6,60631,0,6,6,109.57778,18.27583,1814
165688,59B48C7DD533E36B4AA6ADABEB53F8C6,31571,7,12,5,109.61563,18.23326,1957
165689,59B48C7DD533E36B4AA6ADABEB53F8C6,60631,14,15,1,109.57778,18.27583,1814
165690,59B48C7DD533E36B4AA6ADABEB53F8C6,31571,16,17,1,109.61563,18.23326,1957
165691,59B48C7DD533E36B4AA6ADABEB53F8C6,30854,18,20,2,109.56889,18.27076,1763
165692,59B48C7DD533E36B4AA6ADABEB53F8C6,60631,21,23,2,109.57778,18.27583,1814
165693,1FC5887E4053936D3ED4D738338DC172,30121,0,7,7,109.52861,18.27222,1613
165694,1FC5887E4053936D3ED4D738338DC172,30851,8,9,1,109.5616,18.27396,1713
165695,1FC5887E4053936D3ED4D738338DC172,30951,9,17,8,109.56208,18.25667,1761
165696,B55959B64746A18ECF5077B5F7359221,31561,1,8,7,109.56792,18.28479,1765
165697,B55959B64746A18ECF5077B5F7359221,39183,9,10,1,109.55542,18.28208,1715
165698,B55959B64746A18ECF5077B5F7359221,31561,11,12,1,109.56792,18.28479,1765
165699,B55959B64746A18ECF5077B5F7359221,30854,17,18,1,109.56889,18.27076,1763
165768,D1E9F173C78819C710E28E8ACB6462D5,31391,0,9,9,109.50382,18.24285,1508
165769,D1E9F173C78819C710E28E8ACB6462D5,30181,10,12,2,109.51597,18.23313,1557
165770,D1E9F173C78819C710E28E8ACB6462D5,31201,13,18,5,109.51042,18.23819,1558
165781,5CC1762A5E087A77C8027D2CC6A16A88,30741,12,14,2,109.49833,18.28681,1516
165782,5CC1762A5E087A77C8027D2CC6A16A88,38127,16,23,7,109.50833,18.27222,1513
165789,8088BB824557EB3DC3C65BFEE10DC938,31031,12,13,1,109.49979,18.25382,1510
165790,8088BB824557EB3DC3C65BFEE10DC938,38251,18,20,2,109.49618,18.25493,1510
165791,8088BB824557EB3DC3C65BFEE10DC938,30271,21,23,2,109.49132,18.23153,1456
165832,B0D2E3C407097FA6EE45A73276479899,60331,18,20,2,109.505,18.26507,1512
165833,B0D2E3C407097FA6EE45A73276479899,30421,20,21,1,109.50021,18.25861,1511
165834,B0D2E3C407097FA6EE45A73276479899,60331,21,22,1,109.505,18.26507,1512
165886,0B1CC3266C9F341870D0B135F2AF352E,60472,0,6,6,109.46625,18.29542,1367
165887,0B1CC3266C9F341870D0B135F2AF352E,30111,7,8,1,109.47583,18.30542,1419
165888,0B1CC3266C9F341870D0B135F2AF352E,30711,11,14,3,109.50271,18.25347,1510
165889,0B1CC3266C9F341870D0B135F2AF352E,60441,14,21,7,109.46792,18.28604,1366
165903,E43F5A263B0294AA2C456223D73198EC,31521,5,16,11,109.51458,18.22542,1555
165904,E43F5A263B0294AA2C456223D73198EC,30861,17,19,2,109.52722,18.22743,1606
165910,0C8D15C0488D521680F0DE3A28CFE111,30701,7,9,2,109.59313,18.32007,1871
165911,0C8D15C0488D521680F0DE3A28CFE111,31811,9,11,2,109.54201,18.31806,1671
165912,0C8D15C0488D521680F0DE3A28CFE111,30701,11,23,12,109.59313,18.32007,1871
165944,45CCFCD3EBDF941E1C92B70ED06E8B5E,30854,0,5,5,109.56889,18.27076,1763
165945,45CCFCD3EBDF941E1C92B70ED06E8B5E,31945,10,11,1,109.58021,18.29403,1817
165946,45CCFCD3EBDF941E1C92B70ED06E8B5E,30854,11,14,3,109.56889,18.27076,1763
165947,45CCFCD3EBDF941E1C92B70ED06E8B5E,31221,17,19,2,109.61333,18.26833,1913
165948,45CCFCD3EBDF941E1C92B70ED06E8B5E,30441,21,22,1,109.64021,18.25424,2010
165962,C5B1410BD3333D6A3B1B68633B51E495,38325,0,6,6,109.39792,18.2909,1116
165978,6B806948BC9187A91D033B4096721B00,30854,0,8,8,109.56889,18.27076,1763
165979,6B806948BC9187A91D033B4096721B00,31071,8,19,11,109.58257,18.28458,1815
165983,DE5024DB59D5BF6AE5857A85EB7680EA,31071,0,4,4,109.58257,18.28458,1815
165984,DE5024DB59D5BF6AE5857A85EB7680EA,30854,8,18,10,109.56889,18.27076,1763
166028,BF47FA4C2D8294F1660DC2EB7200128F,31345,0,10,10,109.39,18.29,1066
166029,BF47FA4C2D8294F1660DC2EB7200128F,31781,11,12,1,109.19847,18.2975,367
166030,BF47FA4C2D8294F1660DC2EB7200128F,31345,15,17,2,109.39,18.29,1066
166031,BF47FA4C2D8294F1660DC2EB7200128F,30201,18,19,1,109.4909,18.26465,1462
166032,BF47FA4C2D8294F1660DC2EB7200128F,38291,20,23,3,109.51618,18.24313,1558
166059,1CB7DA025FB95AE18ED5AC1449EEA03C,31081,1,13,12,109.44639,18.30181,1318
166107,E65658506C2BF9C993BA69EE6D38B3C6,31951,0,1,1,109.52174,18.30299,1568
166108,E65658506C2BF9C993BA69EE6D38B3C6,60361,2,5,3,109.51938,18.29681,1567
166109,E65658506C2BF9C993BA69EE6D38B3C6,31951,6,8,2,109.52174,18.30299,1568
166110,E65658506C2BF9C993BA69EE6D38B3C6,60361,10,14,4,109.51938,18.29681,1567
166118,996308BA516E2A4FD895EB11278D247D,30201,0,19,19,109.4909,18.26465,1462
166119,996308BA516E2A4FD895EB11278D247D,31031,19,23,4,109.49979,18.25382,1510
166141,E292D83051830D054E89D209EEABA4B9,31561,1,2,1,109.56792,18.28479,1765
166142,E292D83051830D054E89D209EEABA4B9,30851,4,6,2,109.5616,18.27396,1713
166143,E292D83051830D054E89D209EEABA4B9,39183,8,10,2,109.55542,18.28208,1715
166144,E292D83051830D054E89D209EEABA4B9,31561,14,16,2,109.56792,18.28479,1765
166145,E292D83051830D054E89D209EEABA4B9,31031,21,22,1,109.49979,18.25382,1510
166188,2C3459DAFE695C300A661A98CBD396AB,31231,9,10,1,109.42597,18.29292,1217
166189,2C3459DAFE695C300A661A98CBD396AB,30101,15,16,1,109.57299,18.33333,1773
166190,2C3459DAFE695C300A661A98CBD396AB,30651,17,21,4,109.42611,18.385,1232
166206,30DA8BEF22769330A5D581D4E40911DE,60281,18,21,3,109.51743,18.25924,1561
166207,30DA8BEF22769330A5D581D4E40911DE,31031,21,23,2,109.49979,18.25382,1510
166209,A5C73F1C88306EFCBB8393D7978016B5,60381,18,19,1,109.5241,18.22458,1605
166214,C93386A9D86FE22A1FD4E5116045DD8D,31561,0,6,6,109.56792,18.28479,1765
166215,C93386A9D86FE22A1FD4E5116045DD8D,39183,10,18,8,109.55542,18.28208,1715
166216,C93386A9D86FE22A1FD4E5116045DD8D,30854,19,21,2,109.56889,18.27076,1763
166217,C93386A9D86FE22A1FD4E5116045DD8D,31561,21,23,2,109.56792,18.28479,1765
166265,48EC852B1939DE9DE8D67EA49BF6D736,60361,12,14,2,109.51938,18.29681,1567
166266,48EC852B1939DE9DE8D67EA49BF6D736,30251,16,18,2,109.50611,18.26653,1512
166267,48EC852B1939DE9DE8D67EA49BF6D736,30721,21,23,2,109.51597,18.28257,1565
166324,DA10676C4DA702E02A2C3FFFAC40ABA2,39183,1,12,11,109.55542,18.28208,1715
166325,DA10676C4DA702E02A2C3FFFAC40ABA2,31561,13,23,10,109.56792,18.28479,1765
166331,3977578BE56276DA0700B04B81DC1356,31561,4,5,1,109.56792,18.28479,1765
166332,3977578BE56276DA0700B04B81DC1356,30851,5,7,2,109.5616,18.27396,1713
166333,3977578BE56276DA0700B04B81DC1356,31561,8,9,1,109.56792,18.28479,1765
166334,3977578BE56276DA0700B04B81DC1356,30851,10,11,1,109.5616,18.27396,1713
166335,3977578BE56276DA0700B04B81DC1356,31561,12,14,2,109.56792,18.28479,1765
166341,6EB870A8DE5FEF4CB01EB6410E49EA6C,30854,9,11,2,109.56889,18.27076,1763
166342,6EB870A8DE5FEF4CB01EB6410E49EA6C,31561,11,15,4,109.56792,18.28479,1765
166343,6EB870A8DE5FEF4CB01EB6410E49EA6C,30711,17,20,3,109.50271,18.25347,1510
166344,6EB870A8DE5FEF4CB01EB6410E49EA6C,31561,21,23,2,109.56792,18.28479,1765
166417,AD608A919061B1C684914F8654FB2493,60041,0,2,2,109.39889,18.31944,1121
166418,AD608A919061B1C684914F8654FB2493,30651,2,4,2,109.42611,18.385,1232
166419,AD608A919061B1C684914F8654FB2493,38145,5,7,2,109.378,18.2912,1066
166420,AD608A919061B1C684914F8654FB2493,30651,9,14,5,109.42611,18.385,1232
166425,0133DDFFB5CECBB261CEDEF10A82D50B,30854,0,5,5,109.56889,18.27076,1763
166426,0133DDFFB5CECBB261CEDEF10A82D50B,31561,8,10,2,109.56792,18.28479,1765
166427,0133DDFFB5CECBB261CEDEF10A82D50B,31071,12,14,2,109.58257,18.28458,1815
166428,0133DDFFB5CECBB261CEDEF10A82D50B,30854,15,17,2,109.56889,18.27076,1763
166450,0841B38EFEEE80E4084E126D1C4D1973,31561,0,16,16,109.56792,18.28479,1765
166451,0841B38EFEEE80E4084E126D1C4D1973,30854,16,19,3,109.56889,18.27076,1763
166452,0841B38EFEEE80E4084E126D1C4D1973,31561,20,23,3,109.56792,18.28479,1765
166477,0E129C09250C0D46273B4BD7E5225556,30151,0,6,6,109.50986,18.25083,1560
166478,0E129C09250C0D46273B4BD7E5225556,30421,7,12,5,109.50021,18.25861,1511
166479,0E129C09250C0D46273B4BD7E5225556,30151,16,18,2,109.50986,18.25083,1560
166480,0E129C09250C0D46273B4BD7E5225556,60463,19,21,2,109.52507,18.22438,1605
166504,28B366167501D3E270BF1F5EDB4474EC,30854,13,14,1,109.56889,18.27076,1763
166505,28B366167501D3E270BF1F5EDB4474EC,30234,15,17,2,109.60681,18.29979,1918
166517,537CA9C3FED012868AB5E4DF92AD232C,30861,0,10,10,109.52722,18.22743,1606
166518,537CA9C3FED012868AB5E4DF92AD232C,60641,12,13,1,109.53854,18.2359,1657
166519,537CA9C3FED012868AB5E4DF92AD232C,31461,14,15,1,109.5091,18.25389,1510
166520,537CA9C3FED012868AB5E4DF92AD232C,31031,16,17,1,109.49979,18.25382,1510
166521,537CA9C3FED012868AB5E4DF92AD232C,30861,19,23,4,109.52722,18.22743,1606
166525,1D4558B4C0B5F77B61048106C84086AA,60551,2,7,5,109.42722,18.30111,1218
166526,1D4558B4C0B5F77B61048106C84086AA,31231,7,8,1,109.42597,18.29292,1217
166527,1D4558B4C0B5F77B61048106C84086AA,31231,8,23,15,109.42597,18.29292,1217
166573,C709D01469E0800AF998DFAF42105CDC,60631,0,6,6,109.57778,18.27583,1814
166574,C709D01469E0800AF998DFAF42105CDC,31561,8,17,9,109.56792,18.28479,1765
166575,C709D01469E0800AF998DFAF42105CDC,30854,18,23,5,109.56889,18.27076,1763
166593,173CD7A2B7B334BC53A50A1D248FBCFE,31071,3,10,7,109.58257,18.28458,1815
166594,173CD7A2B7B334BC53A50A1D248FBCFE,30854,10,14,4,109.56889,18.27076,1763
166595,173CD7A2B7B334BC53A50A1D248FBCFE,31091,15,19,4,109.41201,18.31222,1170
166602,451E2BF48CD7B253EB0892324E679BCC,38297,0,7,7,109.52576,18.24965,1609
166603,451E2BF48CD7B253EB0892324E679BCC,60281,7,18,11,109.51743,18.25924,1561
166604,451E2BF48CD7B253EB0892324E679BCC,38297,18,19,1,109.52576,18.24965,1609
166605,451E2BF48CD7B253EB0892324E679BCC,30711,20,21,1,109.50271,18.25347,1510
166606,451E2BF48CD7B253EB0892324E679BCC,38297,21,23,2,109.52576,18.24965,1609
166618,3160CBE2F0CDCB610575CDC881D9968C,38127,17,18,1,109.50833,18.27222,1513
166619,3160CBE2F0CDCB610575CDC881D9968C,31861,20,21,1,109.49042,18.27549,1464
166620,3160CBE2F0CDCB610575CDC881D9968C,38297,22,23,1,109.52576,18.24965,1609
166644,94ACF7A1508842D400E0E081D99A3FBE,31521,19,23,4,109.51458,18.22542,1555
166676,5E08AB7C372A394BECF04F7C241613A4,60524,0,6,6,109.42951,18.28993,1216
166677,5E08AB7C372A394BECF04F7C241613A4,60551,6,8,2,109.42722,18.30111,1218
166678,5E08AB7C372A394BECF04F7C241613A4,31145,10,12,2,109.20431,18.30479,369
166679,5E08AB7C372A394BECF04F7C241613A4,31781,12,13,1,109.19847,18.2975,367
166680,5E08AB7C372A394BECF04F7C241613A4,31471,14,16,2,109.34583,18.29563,917
166721,A76FBC2A19FBBE53E6CFE5E27050EE06,60081,0,5,5,109.51097,18.22639,1556
166722,A76FBC2A19FBBE53E6CFE5E27050EE06,30191,6,8,2,109.50361,18.22701,1506
166723,A76FBC2A19FBBE53E6CFE5E27050EE06,31781,11,13,2,109.19847,18.2975,367
166724,A76FBC2A19FBBE53E6CFE5E27050EE06,31471,15,17,2,109.34583,18.29563,917
166725,A76FBC2A19FBBE53E6CFE5E27050EE06,60381,20,22,2,109.5241,18.22458,1605
166745,F6A1EBB84FE583E84185C423218578F5,30854,17,19,2,109.56889,18.27076,1763
166746,F6A1EBB84FE583E84185C423218578F5,31561,19,20,1,109.56792,18.28479,1765
166802,5202825DF51CA068C8B204422480230F,31071,2,9,7,109.58257,18.28458,1815
166803,5202825DF51CA068C8B204422480230F,31945,13,14,1,109.58021,18.29403,1817
166831,0E1B3CFC64EBB658DA96D0DCA834701E,61011,7,21,14,109.60653,18.19076,1900
166832,4E9347808E8F02AFB816F8344D637F34,38961,0,1,1,109.50847,18.23514,1507
166833,4E9347808E8F02AFB816F8344D637F34,30741,2,18,16,109.49833,18.28681,1516
166834,4E9347808E8F02AFB816F8344D637F34,30421,19,20,1,109.50021,18.25861,1511
166841,76A2DDC275135F20E5541A96E91E072B,31031,15,18,3,109.49979,18.25382,1510
166842,76A2DDC275135F20E5541A96E91E072B,31031,19,23,4,109.49979,18.25382,1510
166877,D39D64452E6BBEF7B3056CA239E1B86E,30854,0,6,6,109.56889,18.27076,1763
166878,D39D64452E6BBEF7B3056CA239E1B86E,31561,6,10,4,109.56792,18.28479,1765
166879,D39D64452E6BBEF7B3056CA239E1B86E,30854,10,13,3,109.56889,18.27076,1763
166880,D39D64452E6BBEF7B3056CA239E1B86E,31561,14,15,1,109.56792,18.28479,1765
166881,D39D64452E6BBEF7B3056CA239E1B86E,30854,15,23,8,109.56889,18.27076,1763
166942,1FE2866848043A2C10AD87212485FE15,31071,3,4,1,109.58257,18.28458,1815
166943,1FE2866848043A2C10AD87212485FE15,30854,4,5,1,109.56889,18.27076,1763
166944,1FE2866848043A2C10AD87212485FE15,31071,6,7,1,109.58257,18.28458,1815
166970,B0C6DED232762D9BAF78468BD2731104,60041,14,15,1,109.39889,18.31944,1121
166971,B0C6DED232762D9BAF78468BD2731104,30581,20,23,3,109.62257,18.24951,1959
166972,1A1B5C664F8D6460240C73AB76187420,30854,3,8,5,109.56889,18.27076,1763
166973,1A1B5C664F8D6460240C73AB76187420,31071,12,13,1,109.58257,18.28458,1815
166974,1A1B5C664F8D6460240C73AB76187420,30854,15,16,1,109.56889,18.27076,1763
166975,1A1B5C664F8D6460240C73AB76187420,31071,17,19,2,109.58257,18.28458,1815
166976,1A1B5C664F8D6460240C73AB76187420,30854,20,22,2,109.56889,18.27076,1763
166990,7E7742F5B0156B5C74FAAA9FE22D94C7,31071,0,13,13,109.58257,18.28458,1815
166991,7E7742F5B0156B5C74FAAA9FE22D94C7,30854,16,23,7,109.56889,18.27076,1763
167066,B712327B6033C61F37801CFD6DAC08AD,38484,13,15,2,109.53028,18.31528,1620
167067,B712327B6033C61F37801CFD6DAC08AD,30561,19,22,3,109.52778,18.31938,1621
167095,A7B3BDD8DC79485BA41EC7F220A41345,60631,1,8,7,109.57778,18.27583,1814
167096,A7B3BDD8DC79485BA41EC7F220A41345,30854,12,15,3,109.56889,18.27076,1763
167097,A7B3BDD8DC79485BA41EC7F220A41345,60631,15,17,2,109.57778,18.27583,1814
167107,5C18A2E44B35E6C3C2823CC3AAFB80BA,60201,0,9,9,109.5041,18.2509,1510
167108,5C18A2E44B35E6C3C2823CC3AAFB80BA,31931,9,11,2,109.54771,18.29403,1667
167109,5C18A2E44B35E6C3C2823CC3AAFB80BA,60201,12,14,2,109.5041,18.2509,1510
167110,5C18A2E44B35E6C3C2823CC3AAFB80BA,60201,15,23,8,109.5041,18.2509,1510
167116,B0D7DAF8D84656FF4C7229ABB8EA1350,31561,0,17,17,109.56792,18.28479,1765
167117,B0D7DAF8D84656FF4C7229ABB8EA1350,30854,18,20,2,109.56889,18.27076,1763
167118,B0D7DAF8D84656FF4C7229ABB8EA1350,31561,20,21,1,109.56792,18.28479,1765
167163,89362A3CA3AE6F5B75871F2110924F99,30851,0,11,11,109.5616,18.27396,1713
167164,89362A3CA3AE6F5B75871F2110924F99,30951,11,14,3,109.56208,18.25667,1761
167165,89362A3CA3AE6F5B75871F2110924F99,39371,14,16,2,109.56627,18.2646,1762
167166,89362A3CA3AE6F5B75871F2110924F99,30951,16,17,1,109.56208,18.25667,1761
167167,89362A3CA3AE6F5B75871F2110924F99,30851,18,23,5,109.5616,18.27396,1713
167225,8DA7661E8E46B66EF011FB9B9FA15609,38061,0,9,9,109.50597,18.23118,1506
167226,8DA7661E8E46B66EF011FB9B9FA15609,39111,11,12,1,109.5191,18.22597,1555
167227,8DA7661E8E46B66EF011FB9B9FA15609,60381,15,17,2,109.5241,18.22458,1605
167228,8DA7661E8E46B66EF011FB9B9FA15609,39111,20,22,2,109.5191,18.22597,1555
167250,7FF3C6569A3990C03CAF6C52D3C8BC6C,30921,1,4,3,109.53903,18.29451,1667
167251,7FF3C6569A3990C03CAF6C52D3C8BC6C,31931,5,7,2,109.54771,18.29403,1667
167252,7FF3C6569A3990C03CAF6C52D3C8BC6C,30921,7,8,1,109.53903,18.29451,1667
167253,7FF3C6569A3990C03CAF6C52D3C8BC6C,60241,11,12,1,109.53319,18.28667,1616
167254,7FF3C6569A3990C03CAF6C52D3C8BC6C,31931,14,15,1,109.54771,18.29403,1667
167255,7FF3C6569A3990C03CAF6C52D3C8BC6C,30921,16,17,1,109.53903,18.29451,1667
167261,B78E7295CB13532B4E2C30EF158E297F,39183,0,10,10,109.55542,18.28208,1715
167262,B78E7295CB13532B4E2C30EF158E297F,30851,12,14,2,109.5616,18.27396,1713
167263,B78E7295CB13532B4E2C30EF158E297F,31931,15,16,1,109.54771,18.29403,1667
167266,63C17AFD80869AD1D0375390D26A4ACA,38127,0,17,17,109.50833,18.27222,1513
167267,63C17AFD80869AD1D0375390D26A4ACA,38157,20,22,2,109.51483,18.26958,1563
167276,D6E72F3649E9FA4F285A8682EF1A1E3A,39101,0,9,9,109.50132,18.24931,1509
167277,D6E72F3649E9FA4F285A8682EF1A1E3A,31521,11,20,9,109.51458,18.22542,1555
167297,F47C4E1E39056C43B0AD32AC994AB7C0,31931,12,13,1,109.54771,18.29403,1667
167298,F47C4E1E39056C43B0AD32AC994AB7C0,60361,14,19,5,109.51938,18.29681,1567
167299,F47C4E1E39056C43B0AD32AC994AB7C0,31931,21,23,2,109.54771,18.29403,1667
167311,2D72FF66CB71FCFECF5E9D92443E43AB,38291,14,16,2,109.51618,18.24313,1558
167312,2D72FF66CB71FCFECF5E9D92443E43AB,60311,17,19,2,109.52097,18.24319,1558
167315,8BE73BF558E3512B54F879E678FCD6C7,31201,3,10,7,109.51042,18.23819,1558
167316,8BE73BF558E3512B54F879E678FCD6C7,31521,12,14,2,109.51458,18.22542,1555
167317,8BE73BF558E3512B54F879E678FCD6C7,31521,15,16,1,109.51458,18.22542,1555
167331,64EA917EAAD3EB55DA2ABB227203C131,60631,0,7,7,109.57778,18.27583,1814
167332,64EA917EAAD3EB55DA2ABB227203C131,30854,12,15,3,109.56889,18.27076,1763
167333,64EA917EAAD3EB55DA2ABB227203C131,60631,19,20,1,109.57778,18.27583,1814
167334,64EA917EAAD3EB55DA2ABB227203C131,30851,21,22,1,109.5616,18.27396,1713
167362,C84F6E3CAF0EAE725088ED441618D6C7,30181,0,1,1,109.51597,18.23313,1557
167363,C84F6E3CAF0EAE725088ED441618D6C7,31206,2,5,3,109.50819,18.23549,1507
167364,C84F6E3CAF0EAE725088ED441618D6C7,30181,5,7,2,109.51597,18.23313,1557
167365,C84F6E3CAF0EAE725088ED441618D6C7,30851,16,17,1,109.5616,18.27396,1713
167366,C84F6E3CAF0EAE725088ED441618D6C7,30181,18,23,5,109.51597,18.23313,1557
167367,3738BCD5F22BB841A8E524306ADFE0A0,38261,0,7,7,109.50361,18.28153,1515
167368,3738BCD5F22BB841A8E524306ADFE0A0,38751,8,19,11,109.74903,18.37639,2481
167369,3738BCD5F22BB841A8E524306ADFE0A0,60231,21,22,1,109.49903,18.21972,1504
167427,A928E9F6C796FE1A60807BA003DE87BB,30854,3,5,2,109.56889,18.27076,1763
167428,A928E9F6C796FE1A60807BA003DE87BB,39181,9,17,8,109.55153,18.28035,1715
167429,A928E9F6C796FE1A60807BA003DE87BB,30854,22,23,1,109.56889,18.27076,1763
167465,491A112CD81B9085F752897809919691,31201,0,7,7,109.51042,18.23819,1558
167466,491A112CD81B9085F752897809919691,30511,8,9,1,109.51069,18.24208,1558
167467,491A112CD81B9085F752897809919691,60291,14,15,1,109.50826,18.24639,1509
167468,491A112CD81B9085F752897809919691,31521,17,18,1,109.51458,18.22542,1555
167469,491A112CD81B9085F752897809919691,31201,22,23,1,109.51042,18.23819,1558
167475,68D4FD9FDF41B7C090858F716B8364B9,31521,0,6,6,109.51458,18.22542,1555
167476,68D4FD9FDF41B7C090858F716B8364B9,38185,6,8,2,109.51333,18.27347,1563
167477,68D4FD9FDF41B7C090858F716B8364B9,30854,10,11,1,109.56889,18.27076,1763
167511,807332CEC38772FA8DF98C48FBD8DD1E,31561,11,12,1,109.56792,18.28479,1765
167512,807332CEC38772FA8DF98C48FBD8DD1E,31931,15,17,2,109.54771,18.29403,1667
167513,807332CEC38772FA8DF98C48FBD8DD1E,31561,20,22,2,109.56792,18.28479,1765
167514,97C31877CA4226D0F1BA1C0E12066B56,30081,0,7,7,109.50243,18.26632,1512
167515,97C31877CA4226D0F1BA1C0E12066B56,31071,9,10,1,109.58257,18.28458,1815
167516,97C31877CA4226D0F1BA1C0E12066B56,30854,15,18,3,109.56889,18.27076,1763
167517,97C31877CA4226D0F1BA1C0E12066B56,30081,19,20,1,109.50243,18.26632,1512
167518,97C31877CA4226D0F1BA1C0E12066B56,60331,22,23,1,109.505,18.26507,1512
167534,A549C024E6F63EDBD3DC866F10DB11CE,30234,1,4,3,109.60681,18.29979,1918
167535,A549C024E6F63EDBD3DC866F10DB11CE,31071,5,6,1,109.58257,18.28458,1815
167536,A549C024E6F63EDBD3DC866F10DB11CE,30854,7,10,3,109.56889,18.27076,1763
167537,A549C024E6F63EDBD3DC866F10DB11CE,31071,12,13,1,109.58257,18.28458,1815
167538,A549C024E6F63EDBD3DC866F10DB11CE,30854,15,17,2,109.56889,18.27076,1763
167562,56D57BE12476A3A09FC512AA68EE1DCB,60084,0,6,6,109.4984,18.2334,1507
167563,56D57BE12476A3A09FC512AA68EE1DCB,60231,7,14,7,109.49903,18.21972,1504
167564,56D57BE12476A3A09FC512AA68EE1DCB,31251,16,21,5,109.18528,18.2975,317
167574,A749E400BFD3B5908671E939EC104DEE,31071,2,7,5,109.58257,18.28458,1815
167575,A749E400BFD3B5908671E939EC104DEE,30854,7,21,14,109.56889,18.27076,1763
167576,E4B522EF4348156010E5C578EC13D60F,30234,0,9,9,109.60681,18.29979,1918
167577,E4B522EF4348156010E5C578EC13D60F,30854,10,14,4,109.56889,18.27076,1763
167578,E4B522EF4348156010E5C578EC13D60F,31164,18,20,2,109.69993,18.27215,2263
167579,E4B522EF4348156010E5C578EC13D60F,30854,22,23,1,109.56889,18.27076,1763
167589,560794A44CA17A43FA34D0FA6C339747,30181,18,21,3,109.51597,18.23313,1557
167590,560794A44CA17A43FA34D0FA6C339747,30854,22,23,1,109.56889,18.27076,1763
167596,DCD137352B900F9F43521E37884B7F13,60054,0,8,8,109.3016,18.31229,770
167597,DCD137352B900F9F43521E37884B7F13,30661,9,11,2,109.37028,18.24361,1008
167598,DCD137352B900F9F43521E37884B7F13,60054,12,23,11,109.3016,18.31229,770
167604,D090D23BEAB243AAF74CB3648E81F65B,30851,4,7,3,109.5616,18.27396,1713
167605,D090D23BEAB243AAF74CB3648E81F65B,31561,7,19,12,109.56792,18.28479,1765
167606,D090D23BEAB243AAF74CB3648E81F65B,30851,19,20,1,109.5616,18.27396,1713
167650,608A55C14BAB2A5B627ACC1F39B89FB6,31945,0,7,7,109.58021,18.29403,1817
167651,608A55C14BAB2A5B627ACC1F39B89FB6,31071,8,10,2,109.58257,18.28458,1815
167652,608A55C14BAB2A5B627ACC1F39B89FB6,31945,12,13,1,109.58021,18.29403,1817
167653,608A55C14BAB2A5B627ACC1F39B89FB6,30854,13,15,2,109.56889,18.27076,1763
167673,362A5B9B34971851814BD592D30A5666,39191,0,2,2,109.51493,18.23472,1557
167674,362A5B9B34971851814BD592D30A5666,38891,2,5,3,109.51486,18.24118,1558
167675,362A5B9B34971851814BD592D30A5666,39191,5,8,3,109.51493,18.23472,1557
167676,362A5B9B34971851814BD592D30A5666,31561,13,15,2,109.56792,18.28479,1765
167677,362A5B9B34971851814BD592D30A5666,38891,20,23,3,109.51486,18.24118,1558
167680,28413CB0160B68347E92144BE214EF48,31411,18,19,1,109.5016,18.23576,1507
167681,28413CB0160B68347E92144BE214EF48,60084,21,23,2,109.4984,18.2334,1507
167684,410DD8A32244BC0C8E0A44B87218A19E,30181,18,21,3,109.51597,18.23313,1557
167685,410DD8A32244BC0C8E0A44B87218A19E,30854,21,23,2,109.56889,18.27076,1763
167732,10EBF762D28520B09848288F7052CFDE,30854,0,7,7,109.56889,18.27076,1763
167733,10EBF762D28520B09848288F7052CFDE,31561,8,17,9,109.56792,18.28479,1765
167734,10EBF762D28520B09848288F7052CFDE,30854,20,23,3,109.56889,18.27076,1763
167741,8920C93432771D8645B969281AC5EB63,60614,13,17,4,109.48799,18.29521,1467
167748,66DAA2740440F603A26B0FC0D4309DF2,30921,0,5,5,109.53903,18.29451,1667
167749,66DAA2740440F603A26B0FC0D4309DF2,31931,7,8,1,109.54771,18.29403,1667
167750,66DAA2740440F603A26B0FC0D4309DF2,30921,11,12,1,109.53903,18.29451,1667
167817,065F1687C35F3C827A2EA4A378A0E2C6,39371,12,13,1,109.56627,18.2646,1762
167818,065F1687C35F3C827A2EA4A378A0E2C6,30851,14,21,7,109.5616,18.27396,1713
167845,13166628932DF36C0AD7B1DB5811240A,60631,12,13,1,109.57778,18.27583,1814
167846,13166628932DF36C0AD7B1DB5811240A,30854,15,17,2,109.56889,18.27076,1763
167847,13166628932DF36C0AD7B1DB5811240A,60591,19,23,4,109.61118,18.21715,1904
167868,9837FB962D7F62E426A73EBD66CBBE03,30711,12,14,2,109.50271,18.25347,1510
167869,9837FB962D7F62E426A73EBD66CBBE03,30711,15,17,2,109.50271,18.25347,1510
167894,15A2A8790389D1537721C21B141A7A31,61011,1,9,8,109.60653,18.19076,1900
167896,15A2A8790389D1537721C21B141A7A31,61011,13,16,3,109.60653,18.19076,1900
167945,B47CB2A2315F987CAA4AD3E9353D33AE,38251,14,15,1,109.49618,18.25493,1510
167946,B47CB2A2315F987CAA4AD3E9353D33AE,31231,16,17,1,109.42597,18.29292,1217
167947,B47CB2A2315F987CAA4AD3E9353D33AE,60524,19,20,1,109.42951,18.28993,1216
167948,B47CB2A2315F987CAA4AD3E9353D33AE,31031,20,22,2,109.49979,18.25382,1510
167956,D0016644D08E46EAD736BEE805BD7ECD,30421,18,20,2,109.50021,18.25861,1511
167957,D0016644D08E46EAD736BEE805BD7ECD,31864,21,23,2,109.49014,18.28333,1465
167958,7AF4921BC4D1712A961904D0ECC91550,30071,16,18,2,109.52819,18.30472,1619
167959,7AF4921BC4D1712A961904D0ECC91550,38251,20,21,1,109.49618,18.25493,1510
167965,89A01963B06628A3D6B13DA41FA507D1,31561,0,6,6,109.56792,18.28479,1765
167966,89A01963B06628A3D6B13DA41FA507D1,30854,7,9,2,109.56889,18.27076,1763
167967,89A01963B06628A3D6B13DA41FA507D1,31561,10,11,1,109.56792,18.28479,1765
167968,89A01963B06628A3D6B13DA41FA507D1,30854,15,16,1,109.56889,18.27076,1763
167969,76DC937B0560E4BA6ECE26A57F4E541A,60491,0,20,20,109.43354,18.30847,1269
167970,76DC937B0560E4BA6ECE26A57F4E541A,38951,21,23,2,109.48097,18.28868,1416
167971,1026894DC5FF9A7FAF3A2EE28B95E239,30854,0,11,11,109.56889,18.27076,1763
167972,1026894DC5FF9A7FAF3A2EE28B95E239,30232,14,16,2,109.6191,18.31701,1971
167973,1026894DC5FF9A7FAF3A2EE28B95E239,30854,18,23,5,109.56889,18.27076,1763
167989,7421066246AAD1C230E7E2A7ADF06E9D,60631,0,6,6,109.57778,18.27583,1814
167990,7421066246AAD1C230E7E2A7ADF06E9D,30854,7,17,10,109.56889,18.27076,1763
167991,7421066246AAD1C230E7E2A7ADF06E9D,60631,22,23,1,109.57778,18.27583,1814
168012,BA14D3A3DF052B077104F1218BF7563E,31261,1,7,6,109.51174,18.2466,1559
168013,BA14D3A3DF052B077104F1218BF7563E,31181,10,12,2,109.50382,18.24813,1509
168014,BA14D3A3DF052B077104F1218BF7563E,31261,13,14,1,109.51174,18.2466,1559
168015,A01B4012B619D942E7CC3AC9B78722B4,39183,2,5,3,109.55542,18.28208,1715
168016,A01B4012B619D942E7CC3AC9B78722B4,31561,9,13,4,109.56792,18.28479,1765
168017,A01B4012B619D942E7CC3AC9B78722B4,31931,13,15,2,109.54771,18.29403,1667
168028,C153552CEA2677B0FF473AE565EA979E,30821,0,12,12,109.43681,18.33639,1274
168029,C153552CEA2677B0FF473AE565EA979E,60424,15,17,2,109.44611,18.31736,1321
168030,C153552CEA2677B0FF473AE565EA979E,30821,19,23,4,109.43681,18.33639,1274
168036,417408FFDA93B177641D270D3A5C4B2D,31071,0,7,7,109.58257,18.28458,1815
168037,417408FFDA93B177641D270D3A5C4B2D,30854,7,19,12,109.56889,18.27076,1763
168038,417408FFDA93B177641D270D3A5C4B2D,31071,21,23,2,109.58257,18.28458,1815
168081,28F7DFD4A036DBA4E68AFC71762D44D7,39371,1,2,1,109.56627,18.2646,1762
168082,28F7DFD4A036DBA4E68AFC71762D44D7,30851,4,5,1,109.5616,18.27396,1713
168083,28F7DFD4A036DBA4E68AFC71762D44D7,30951,8,15,7,109.56208,18.25667,1761
168084,28F7DFD4A036DBA4E68AFC71762D44D7,31561,19,23,4,109.56792,18.28479,1765
168100,872709FDC860D320EC74676CCC63D436,39154,0,10,10,109.50201,18.25681,1511
168102,294D9A63045D1EB69E8575E3D91BD865,31421,18,19,1,109.55382,18.22347,1705
168103,294D9A63045D1EB69E8575E3D91BD865,39321,21,23,2,109.529,18.2167,1604
168104,AD6CE74FEECB42F7806A62DA7A4CECCA,39183,1,6,5,109.55542,18.28208,1715
168105,AD6CE74FEECB42F7806A62DA7A4CECCA,31071,10,11,1,109.58257,18.28458,1815
168106,AD6CE74FEECB42F7806A62DA7A4CECCA,30854,11,13,2,109.56889,18.27076,1763
168107,E2847DA629B89621A8D8F84E79614739,38903,0,4,4,109.39229,18.29243,1117
168133,AAD294F97E8F953422B544ED61B36D13,30851,16,17,1,109.5616,18.27396,1713
168134,AAD294F97E8F953422B544ED61B36D13,31071,18,22,4,109.58257,18.28458,1815
168152,CB0DCEB8E5573AF0622B1E4D0B156499,38052,0,9,9,109.62618,18.23042,1956
168153,CB0DCEB8E5573AF0622B1E4D0B156499,38052,12,13,1,109.62618,18.23042,1956
168154,CB0DCEB8E5573AF0622B1E4D0B156499,38754,14,17,3,109.74667,18.37382,2430
168155,CB0DCEB8E5573AF0622B1E4D0B156499,38052,19,23,4,109.62618,18.23042,1956
168156,EFFEF00C078D502D6D0D1D469ACBA466,31231,12,14,2,109.42597,18.29292,1217
168157,EFFEF00C078D502D6D0D1D469ACBA466,31471,16,17,1,109.34583,18.29563,917
168158,EFFEF00C078D502D6D0D1D469ACBA466,39154,19,23,4,109.50201,18.25681,1511
168200,DF49F834C08C7E8FA6D78272EE1FB651,60361,0,6,6,109.51938,18.29681,1567
168201,DF49F834C08C7E8FA6D78272EE1FB651,30951,9,17,8,109.56208,18.25667,1761
168202,DF49F834C08C7E8FA6D78272EE1FB651,60361,18,23,5,109.51938,18.29681,1567
168225,8DD23AA43C0F7967C45F7488D66F9159,31071,1,8,7,109.58257,18.28458,1815
168226,8DD23AA43C0F7967C45F7488D66F9159,31945,10,11,1,109.58021,18.29403,1817
168227,8DD23AA43C0F7967C45F7488D66F9159,30854,15,21,6,109.56889,18.27076,1763
168243,B800F38F59ABC7037D5C269643629D72,30084,11,13,2,109.50118,18.26972,1513
168246,147470AD3D3B8724582C30D5F244A8B6,60421,0,7,7,109.46333,18.31743,1371
168247,147470AD3D3B8724582C30D5F244A8B6,30111,7,8,1,109.47583,18.30542,1419
168248,147470AD3D3B8724582C30D5F244A8B6,60421,8,16,8,109.46333,18.31743,1371
168249,147470AD3D3B8724582C30D5F244A8B6,30111,16,18,2,109.47583,18.30542,1419
168250,147470AD3D3B8724582C30D5F244A8B6,60421,19,22,3,109.46333,18.31743,1371
168254,BD4652414D5C17466BA36FD4BD943A94,31931,12,14,2,109.54771,18.29403,1667
168255,BD4652414D5C17466BA36FD4BD943A94,39183,16,17,1,109.55542,18.28208,1715
168256,BD4652414D5C17466BA36FD4BD943A94,30321,20,21,1,109.49563,18.29611,1467
168257,BD4652414D5C17466BA36FD4BD943A94,60221,22,23,1,109.52569,18.29188,1616
168335,83930DA23863D53A36D25B51299F2054,61011,5,8,3,109.60653,18.19076,1900
168337,83930DA23863D53A36D25B51299F2054,61011,19,23,4,109.60653,18.19076,1900
168340,267F571F2E3CF014CFEEB29B9E88DA7A,30721,0,6,6,109.51597,18.28257,1565
168341,267F571F2E3CF014CFEEB29B9E88DA7A,39154,8,9,1,109.50201,18.25681,1511
168342,267F571F2E3CF014CFEEB29B9E88DA7A,31251,14,15,1,109.18528,18.2975,317
168343,267F571F2E3CF014CFEEB29B9E88DA7A,30721,20,23,3,109.51597,18.28257,1565
168377,1582BEC240072EC51899932D6A0A257A,30232,3,4,1,109.6191,18.31701,1971
168378,1582BEC240072EC51899932D6A0A257A,30891,4,19,15,109.59431,18.28389,1865
168379,1582BEC240072EC51899932D6A0A257A,31561,22,23,1,109.56792,18.28479,1765
168388,0E1DB444F47235AEDAD0A0404A7B75B4,39183,15,17,2,109.55542,18.28208,1715
168389,0E1DB444F47235AEDAD0A0404A7B75B4,38071,21,22,1,109.40722,18.30938,1169
168430,410D55EA73A3884577B7B9B7E86B067E,30084,1,7,6,109.50118,18.26972,1513
168431,410D55EA73A3884577B7B9B7E86B067E,30084,8,14,6,109.50118,18.26972,1513
168432,410D55EA73A3884577B7B9B7E86B067E,30084,17,22,5,109.50118,18.26972,1513
168438,D758DCB0CB2E5EA2CADCED24F521A533,31071,0,19,19,109.58257,18.28458,1815
168439,D758DCB0CB2E5EA2CADCED24F521A533,30741,21,22,1,109.49833,18.28681,1516
168452,EBF906C5498076BCFA3E97DF6001B4F3,60631,1,8,7,109.57778,18.27583,1814
168453,EBF906C5498076BCFA3E97DF6001B4F3,30854,12,21,9,109.56889,18.27076,1763
168475,2A6BA0678DDF16AF08BAC9E3FA3C9391,31561,0,2,2,109.56792,18.28479,1765
168476,2A6BA0678DDF16AF08BAC9E3FA3C9391,30854,2,3,1,109.56889,18.27076,1763
168477,2A6BA0678DDF16AF08BAC9E3FA3C9391,31561,3,6,3,109.56792,18.28479,1765
168478,2A6BA0678DDF16AF08BAC9E3FA3C9391,30854,9,19,10,109.56889,18.27076,1763
168499,B2420C24A59D2C27A09046B2EE9F5AF9,30854,0,8,8,109.56889,18.27076,1763
168500,B2420C24A59D2C27A09046B2EE9F5AF9,31071,8,10,2,109.58257,18.28458,1815
168501,B2420C24A59D2C27A09046B2EE9F5AF9,30854,10,15,5,109.56889,18.27076,1763
168502,B2420C24A59D2C27A09046B2EE9F5AF9,31071,15,17,2,109.58257,18.28458,1815
168503,B2420C24A59D2C27A09046B2EE9F5AF9,30854,18,23,5,109.56889,18.27076,1763
168508,EA4D123112CD0AE32B6D1280D2074CF8,30921,0,18,18,109.53903,18.29451,1667
168509,EA4D123112CD0AE32B6D1280D2074CF8,30911,19,20,1,109.50493,18.26181,1511
168510,EA4D123112CD0AE32B6D1280D2074CF8,60621,21,22,1,109.48354,18.27451,1464
168524,75817DB682187A07461734D66E1E6492,60631,0,4,4,109.57778,18.27583,1814
168525,75817DB682187A07461734D66E1E6492,30854,4,10,6,109.56889,18.27076,1763
168526,75817DB682187A07461734D66E1E6492,31071,14,15,1,109.58257,18.28458,1815
168527,75817DB682187A07461734D66E1E6492,60631,18,23,5,109.57778,18.27583,1814
168543,5A944CB174BBBA51B8B9B04F6940A655,39061,14,16,2,109.38222,18.28958,1066
168544,5A944CB174BBBA51B8B9B04F6940A655,30821,18,19,1,109.43681,18.33639,1274
168545,5A944CB174BBBA51B8B9B04F6940A655,60084,21,23,2,109.4984,18.2334,1507
168558,005F3AEFE6DBF371ED1FD57736434098,31071,0,7,7,109.58257,18.28458,1815
168559,005F3AEFE6DBF371ED1FD57736434098,30854,8,10,2,109.56889,18.27076,1763
168560,005F3AEFE6DBF371ED1FD57736434098,31071,10,11,1,109.58257,18.28458,1815
168585,06FCF67485A2B44C8ABC96FDB92547C5,61011,0,12,12,109.60653,18.19076,1900
168591,F57902A58026464B5BDED6D5CB0C8C35,31041,13,14,1,109.50278,18.23701,1507
168592,F57902A58026464B5BDED6D5CB0C8C35,30081,14,18,4,109.50243,18.26632,1512
168593,F57902A58026464B5BDED6D5CB0C8C35,30721,18,20,2,109.51597,18.28257,1565
168594,F57902A58026464B5BDED6D5CB0C8C35,30201,20,22,2,109.4909,18.26465,1462
168600,34F3D64B41C252481F72E5CF931AC833,39181,0,1,1,109.55153,18.28035,1715
168601,34F3D64B41C252481F72E5CF931AC833,30851,2,14,12,109.5616,18.27396,1713
168602,34F3D64B41C252481F72E5CF931AC833,31071,14,16,2,109.58257,18.28458,1815
168610,1EC233846FD142FF96E668743DBF5A72,60161,0,2,2,109.49174,18.26181,1461
168611,1EC233846FD142FF96E668743DBF5A72,31231,6,7,1,109.42597,18.29292,1217
168612,1EC233846FD142FF96E668743DBF5A72,30211,10,13,3,109.49882,18.23931,1508
168613,1EC233846FD142FF96E668743DBF5A72,31471,16,17,1,109.34583,18.29563,917
168614,1EC233846FD142FF96E668743DBF5A72,31571,20,22,2,109.61563,18.23326,1957
168620,6DA2EC279010D0E9F544FC8AE2AE810A,39331,0,5,5,109.62125,18.22708,1956
168621,6DA2EC279010D0E9F544FC8AE2AE810A,31571,6,10,4,109.61563,18.23326,1957
168622,6DA2EC279010D0E9F544FC8AE2AE810A,33051,11,13,2,109.6475,18.46618,2096
168623,6DA2EC279010D0E9F544FC8AE2AE810A,33481,15,17,2,109.67278,18.41278,2187
168624,6DA2EC279010D0E9F544FC8AE2AE810A,31571,18,23,5,109.61563,18.23326,1957
168646,95E09A72760B2799C2CC9BD7AF527107,31071,0,4,4,109.58257,18.28458,1815
168647,95E09A72760B2799C2CC9BD7AF527107,30854,9,10,1,109.56889,18.27076,1763
168648,95E09A72760B2799C2CC9BD7AF527107,31071,13,14,1,109.58257,18.28458,1815
168649,95E09A72760B2799C2CC9BD7AF527107,30854,14,23,9,109.56889,18.27076,1763
168666,EC70F9D6B8EC4124E51EFCFD87BAFA84,60504,0,8,8,109.47917,18.28903,1416
168667,EC70F9D6B8EC4124E51EFCFD87BAFA84,38903,11,16,5,109.39229,18.29243,1117
168668,EC70F9D6B8EC4124E51EFCFD87BAFA84,30324,18,20,2,109.50326,18.29257,1517
168669,EC70F9D6B8EC4124E51EFCFD87BAFA84,60504,21,23,2,109.47917,18.28903,1416
168673,8D8AA41210FC9E2D5DD4D81CF4DB18D7,60371,1,11,10,109.53063,18.30056,1618
168674,8D8AA41210FC9E2D5DD4D81CF4DB18D7,30391,13,15,2,109.4975,18.27118,1513
168675,8D8AA41210FC9E2D5DD4D81CF4DB18D7,30711,18,19,1,109.50271,18.25347,1510
168693,BD1C8CAB0CA377D9350002A865081450,31021,17,18,1,109.49021,18.27,1463
168694,BD1C8CAB0CA377D9350002A865081450,30251,20,23,3,109.50611,18.26653,1512
168702,5E97A4561E11AAC4FBC53FD068EAA52B,30854,0,6,6,109.56889,18.27076,1763
168703,5E97A4561E11AAC4FBC53FD068EAA52B,30531,8,18,10,109.53271,18.21472,1604
168704,5E97A4561E11AAC4FBC53FD068EAA52B,30854,22,23,1,109.56889,18.27076,1763
168724,C19430CE8DF26BDEF43903E57E682236,31561,0,14,14,109.56792,18.28479,1765
168725,C19430CE8DF26BDEF43903E57E682236,30854,15,17,2,109.56889,18.27076,1763
168726,C19430CE8DF26BDEF43903E57E682236,31561,19,23,4,109.56792,18.28479,1765
168778,B643AC77F8D8498A9694D45BA8B0F75F,31561,0,1,1,109.56792,18.28479,1765
168779,B643AC77F8D8498A9694D45BA8B0F75F,60631,5,16,11,109.57778,18.27583,1814
168780,B643AC77F8D8498A9694D45BA8B0F75F,30854,18,19,1,109.56889,18.27076,1763
168781,B643AC77F8D8498A9694D45BA8B0F75F,60631,21,23,2,109.57778,18.27583,1814
168870,E960A9C960574B6ECAA9E8161ED40783,30181,0,1,1,109.51597,18.23313,1557
168871,E960A9C960574B6ECAA9E8161ED40783,39111,2,4,2,109.5191,18.22597,1555
168872,E960A9C960574B6ECAA9E8161ED40783,30181,5,8,3,109.51597,18.23313,1557
168873,E960A9C960574B6ECAA9E8161ED40783,30661,11,16,5,109.37028,18.24361,1008
168874,E960A9C960574B6ECAA9E8161ED40783,30861,20,23,3,109.52722,18.22743,1606
168911,5426296000364EE32711CD0E73D782C8,30854,0,8,8,109.56889,18.27076,1763
168912,5426296000364EE32711CD0E73D782C8,31561,13,20,7,109.56792,18.28479,1765
168913,5426296000364EE32711CD0E73D782C8,30854,22,23,1,109.56889,18.27076,1763
168940,B2C1D7D797194AB8141D50C733D584D6,30271,1,5,4,109.49132,18.23153,1456
168941,B2C1D7D797194AB8141D50C733D584D6,30711,6,8,2,109.50271,18.25347,1510
168942,B2C1D7D797194AB8141D50C733D584D6,30441,12,13,1,109.64021,18.25424,2010
168953,4995463B780282C9C030A19D9F49AEAC,31071,0,7,7,109.58257,18.28458,1815
168954,4995463B780282C9C030A19D9F49AEAC,30854,7,9,2,109.56889,18.27076,1763
168955,4995463B780282C9C030A19D9F49AEAC,31071,9,11,2,109.58257,18.28458,1815
168956,4995463B780282C9C030A19D9F49AEAC,30854,11,15,4,109.56889,18.27076,1763
168957,4995463B780282C9C030A19D9F49AEAC,31071,16,18,2,109.58257,18.28458,1815
168958,4995463B780282C9C030A19D9F49AEAC,30854,22,23,1,109.56889,18.27076,1763
169034,00FD2268DE6E83934D2916174E81532F,60472,0,6,6,109.46625,18.29542,1367
169035,00FD2268DE6E83934D2916174E81532F,30761,9,10,1,109.45201,18.3,1318
169036,00FD2268DE6E83934D2916174E81532F,30111,10,23,13,109.47583,18.30542,1419
169064,9DF600F9262EC0A308B6F0B7D23C17B4,31071,18,20,2,109.58257,18.28458,1815
169065,9DF600F9262EC0A308B6F0B7D23C17B4,30854,20,23,3,109.56889,18.27076,1763
169070,6DD2992D9A732B2B8C9D2BEBFF495B9E,30854,12,17,5,109.56889,18.27076,1763
169071,6DD2992D9A732B2B8C9D2BEBFF495B9E,31561,19,23,4,109.56792,18.28479,1765
169082,92C902C260BAB0E059978AFA43029807,30211,0,7,7,109.49882,18.23931,1508
169083,92C902C260BAB0E059978AFA43029807,31391,8,9,1,109.50382,18.24285,1508
169084,92C902C260BAB0E059978AFA43029807,31781,12,13,1,109.19847,18.2975,367
169085,92C902C260BAB0E059978AFA43029807,30361,17,20,3,109.50347,18.24,1508
169086,92C902C260BAB0E059978AFA43029807,30271,20,22,2,109.49132,18.23153,1456
169094,B340EDEF4A878E8DF5CBEC25E465EACE,30854,0,1,1,109.56889,18.27076,1763
169095,B340EDEF4A878E8DF5CBEC25E465EACE,31071,1,2,1,109.58257,18.28458,1815
169096,B340EDEF4A878E8DF5CBEC25E465EACE,30854,4,6,2,109.56889,18.27076,1763
169097,B340EDEF4A878E8DF5CBEC25E465EACE,60631,9,10,1,109.57778,18.27583,1814
169098,B340EDEF4A878E8DF5CBEC25E465EACE,30854,14,17,3,109.56889,18.27076,1763
169099,B340EDEF4A878E8DF5CBEC25E465EACE,38127,19,20,1,109.50833,18.27222,1513
169100,B340EDEF4A878E8DF5CBEC25E465EACE,31206,21,23,2,109.50819,18.23549,1507
169116,F198CAA1F49ACA5D003FD8F8473B3798,31071,1,11,10,109.58257,18.28458,1815
169117,F198CAA1F49ACA5D003FD8F8473B3798,30854,11,13,2,109.56889,18.27076,1763
169118,F198CAA1F49ACA5D003FD8F8473B3798,31071,13,21,8,109.58257,18.28458,1815
169119,F198CAA1F49ACA5D003FD8F8473B3798,30854,21,23,2,109.56889,18.27076,1763
169179,8C5A16299A6D294198C90C34C25C5949,39183,12,15,3,109.55542,18.28208,1715
169180,8C5A16299A6D294198C90C34C25C5949,31561,16,23,7,109.56792,18.28479,1765
169213,FEBC61D07262A46BE9A7FF14D2806B38,30854,0,11,11,109.56889,18.27076,1763
169214,FEBC61D07262A46BE9A7FF14D2806B38,38251,15,16,1,109.49618,18.25493,1510
169215,FEBC61D07262A46BE9A7FF14D2806B38,30854,17,23,6,109.56889,18.27076,1763
169243,D1EBD1A5A8A922DEF994C933F10DD8DB,60381,0,6,6,109.5241,18.22458,1605
169244,D1EBD1A5A8A922DEF994C933F10DD8DB,31021,7,8,1,109.49021,18.27,1463
169245,D1EBD1A5A8A922DEF994C933F10DD8DB,60381,9,12,3,109.5241,18.22458,1605
169246,D1EBD1A5A8A922DEF994C933F10DD8DB,30161,13,23,10,109.50042,18.24389,1508
169247,AB23564C2A438938AB9FCEB6A1EF8561,30121,0,7,7,109.52861,18.27222,1613
169248,AB23564C2A438938AB9FCEB6A1EF8561,31061,8,9,1,109.53333,18.23257,1607
169249,AB23564C2A438938AB9FCEB6A1EF8561,60381,11,13,2,109.5241,18.22458,1605
169250,AB23564C2A438938AB9FCEB6A1EF8561,30121,14,15,1,109.52861,18.27222,1613
169251,AB23564C2A438938AB9FCEB6A1EF8561,30861,15,17,2,109.52722,18.22743,1606
169252,AB23564C2A438938AB9FCEB6A1EF8561,30121,21,23,2,109.52861,18.27222,1613
169330,44F505B3929E26B4B29F00CC284F3084,60631,0,6,6,109.57778,18.27583,1814
169331,44F505B3929E26B4B29F00CC284F3084,30681,9,10,1,109.48493,18.26917,1463
169332,44F505B3929E26B4B29F00CC284F3084,30854,12,14,2,109.56889,18.27076,1763
169333,44F505B3929E26B4B29F00CC284F3084,60381,16,18,2,109.5241,18.22458,1605
169337,770A00BDAFE9BCA8C9E9FA68066EED7D,31561,14,16,2,109.56792,18.28479,1765
169338,770A00BDAFE9BCA8C9E9FA68066EED7D,31071,20,23,3,109.58257,18.28458,1815
169339,2218DE2B527AD8BF235B73A4AAB31E7E,31031,10,14,4,109.49979,18.25382,1510
169340,2218DE2B527AD8BF235B73A4AAB31E7E,60161,14,16,2,109.49174,18.26181,1461
169341,2218DE2B527AD8BF235B73A4AAB31E7E,30201,19,20,1,109.4909,18.26465,1462
169342,2218DE2B527AD8BF235B73A4AAB31E7E,60161,20,23,3,109.49174,18.26181,1461
169351,C1F9914EF577AE2A8300B1A3945A50FF,31561,1,3,2,109.56792,18.28479,1765
169352,C1F9914EF577AE2A8300B1A3945A50FF,30851,4,15,11,109.5616,18.27396,1713
169353,C1F9914EF577AE2A8300B1A3945A50FF,31561,20,21,1,109.56792,18.28479,1765
169354,369F61D9EC42E510E242E24266B2C23F,31931,0,18,18,109.54771,18.29403,1667
169355,369F61D9EC42E510E242E24266B2C23F,30921,19,23,4,109.53903,18.29451,1667
169379,3BB007FDF28DB0E7E883BA594F721FFE,31181,0,1,1,109.50382,18.24813,1509
169380,3BB007FDF28DB0E7E883BA594F721FFE,39151,3,6,3,109.49875,18.25097,1510
169381,3BB007FDF28DB0E7E883BA594F721FFE,31181,8,23,15,109.50382,18.24813,1509
169415,1D95C9F25428D40F06E5BFA001370E3C,31071,1,16,15,109.58257,18.28458,1815
169416,1D95C9F25428D40F06E5BFA001370E3C,30854,18,19,1,109.56889,18.27076,1763
169417,1D95C9F25428D40F06E5BFA001370E3C,31071,20,21,1,109.58257,18.28458,1815
169421,F02E76D8008BA6DC4D6244598B7BBC70,60311,17,19,2,109.52097,18.24319,1558
169422,F02E76D8008BA6DC4D6244598B7BBC70,31071,22,23,1,109.58257,18.28458,1815
169474,9FEA4B85EAE4FAEE1CAF0EABFF2FAEA1,31561,0,12,12,109.56792,18.28479,1765
169475,9FEA4B85EAE4FAEE1CAF0EABFF2FAEA1,39183,14,15,1,109.55542,18.28208,1715
169476,7763FA5342AFBCA436FF4D695F9B9CB2,30711,0,7,7,109.50271,18.25347,1510
169477,7763FA5342AFBCA436FF4D695F9B9CB2,60291,7,8,1,109.50826,18.24639,1509
169478,7763FA5342AFBCA436FF4D695F9B9CB2,60211,13,15,2,109.63549,18.26049,2011
169479,7763FA5342AFBCA436FF4D695F9B9CB2,30711,18,23,5,109.50271,18.25347,1510
169492,301B337150415B5DF427DDCD9632DE5F,60631,0,7,7,109.57778,18.27583,1814
169493,301B337150415B5DF427DDCD9632DE5F,30851,11,17,6,109.5616,18.27396,1713
169494,301B337150415B5DF427DDCD9632DE5F,60631,20,23,3,109.57778,18.27583,1814
169515,C01D7F4C525517694A04D5EAA5AD2420,31931,14,17,3,109.54771,18.29403,1667
169516,C01D7F4C525517694A04D5EAA5AD2420,31945,18,19,1,109.58021,18.29403,1817
169517,C01D7F4C525517694A04D5EAA5AD2420,31071,21,23,2,109.58257,18.28458,1815
169540,A27FD6E116842BE4E0FAFD34416290B6,30771,20,21,1,109.49938,18.26042,1511
169541,A27FD6E116842BE4E0FAFD34416290B6,31271,22,23,1,109.48958,18.26257,1462
169551,317A2326A5D15E475076F1921264E5AD,38117,0,8,8,109.51611,18.22354,1555
169552,317A2326A5D15E475076F1921264E5AD,39321,8,10,2,109.529,18.2167,1604
169553,317A2326A5D15E475076F1921264E5AD,31521,10,11,1,109.51458,18.22542,1555
169554,317A2326A5D15E475076F1921264E5AD,39321,13,15,2,109.529,18.2167,1604
169555,317A2326A5D15E475076F1921264E5AD,30731,16,17,1,109.50944,18.22306,1555
169556,317A2326A5D15E475076F1921264E5AD,31521,21,23,2,109.51458,18.22542,1555
169561,B0034CBA41049BC4020FA7373D060140,31071,1,4,3,109.58257,18.28458,1815
169562,B0034CBA41049BC4020FA7373D060140,30854,5,13,8,109.56889,18.27076,1763
169587,7BB21D6130AE75AA410ED280998BF572,31236,0,8,8,109.42965,18.29111,1216
169588,7BB21D6130AE75AA410ED280998BF572,31145,9,10,1,109.20431,18.30479,369
169589,7BB21D6130AE75AA410ED280998BF572,30771,15,16,1,109.49938,18.26042,1511
169590,7BB21D6130AE75AA410ED280998BF572,60221,18,21,3,109.52569,18.29188,1616
169591,7BB21D6130AE75AA410ED280998BF572,30771,21,23,2,109.49938,18.26042,1511
169592,9FC721E86703223349C05C95FE4BBB6F,31521,0,11,11,109.51458,18.22542,1555
169593,9FC721E86703223349C05C95FE4BBB6F,60381,11,19,8,109.5241,18.22458,1605
169594,9FC721E86703223349C05C95FE4BBB6F,31521,19,21,2,109.51458,18.22542,1555
169595,9FC721E86703223349C05C95FE4BBB6F,60087,22,23,1,109.50688,18.22299,1505
169596,99DAF94CE6124D8A914C4452ADC2394D,30671,1,9,8,109.43611,18.30139,1268
169597,99DAF94CE6124D8A914C4452ADC2394D,38251,10,11,1,109.49618,18.25493,1510
169598,99DAF94CE6124D8A914C4452ADC2394D,60131,12,13,1,109.49819,18.24778,1509
169622,A68637AA89BD62624E677D9E66C32FAD,30361,0,8,8,109.50347,18.24,1508
169623,A68637AA89BD62624E677D9E66C32FAD,30161,10,12,2,109.50042,18.24389,1508
169624,A68637AA89BD62624E677D9E66C32FAD,30361,12,16,4,109.50347,18.24,1508
169625,A68637AA89BD62624E677D9E66C32FAD,30161,17,23,6,109.50042,18.24389,1508
169677,A8CC84F6441C04DAF82A74609E587ED2,38484,0,1,1,109.53028,18.31528,1620
169678,A8CC84F6441C04DAF82A74609E587ED2,30561,2,3,1,109.52778,18.31938,1621
169679,A8CC84F6441C04DAF82A74609E587ED2,31931,7,9,2,109.54771,18.29403,1667
169680,A8CC84F6441C04DAF82A74609E587ED2,30561,12,13,1,109.52778,18.31938,1621
169704,B17D654C0C5F0BF2FDFE2DB8B9C0B83F,60084,1,2,1,109.4984,18.2334,1507
169705,B17D654C0C5F0BF2FDFE2DB8B9C0B83F,30421,3,19,16,109.50021,18.25861,1511
169706,B17D654C0C5F0BF2FDFE2DB8B9C0B83F,30191,19,20,1,109.50361,18.22701,1506
169752,90B0A60855A43B2DB99A0964CE51D3AF,31071,1,7,6,109.58257,18.28458,1815
169753,90B0A60855A43B2DB99A0964CE51D3AF,30854,12,18,6,109.56889,18.27076,1763
169754,90B0A60855A43B2DB99A0964CE51D3AF,31071,21,22,1,109.58257,18.28458,1815
169760,B40C23F05DF669D1A7928A9352D650F2,30161,1,8,7,109.50042,18.24389,1508
169761,B40C23F05DF669D1A7928A9352D650F2,31181,12,13,1,109.50382,18.24813,1509
169805,2EB843F78CEA3889458F6783F8AADAE0,30854,1,2,1,109.56889,18.27076,1763
169806,2EB843F78CEA3889458F6783F8AADAE0,31071,2,3,1,109.58257,18.28458,1815
169807,2EB843F78CEA3889458F6783F8AADAE0,30854,3,5,2,109.56889,18.27076,1763
169808,2EB843F78CEA3889458F6783F8AADAE0,31071,19,20,1,109.58257,18.28458,1815
169809,2EB843F78CEA3889458F6783F8AADAE0,30854,22,23,1,109.56889,18.27076,1763
169813,F9610B40FA7FDAD4A84DD7EF570B95F9,31841,0,8,8,109.73201,18.33382,2373
169814,F9610B40FA7FDAD4A84DD7EF570B95F9,60211,12,13,1,109.63549,18.26049,2011
169815,F9610B40FA7FDAD4A84DD7EF570B95F9,60231,14,16,2,109.49903,18.21972,1504
169816,F9610B40FA7FDAD4A84DD7EF570B95F9,31841,20,23,3,109.73201,18.33382,2373
169832,4118232D9131A3783CE684A84D794F5E,30854,0,15,15,109.56889,18.27076,1763
169833,4118232D9131A3783CE684A84D794F5E,31561,18,19,1,109.56792,18.28479,1765
169834,DF5BF21EA71E8781CC37C7BE0B10CC24,30661,12,14,2,109.37028,18.24361,1008
169835,DF5BF21EA71E8781CC37C7BE0B10CC24,30581,16,17,1,109.62257,18.24951,1959
169836,4020F45A25B90FB7F045FA0843BE28FF,30241,8,9,1,109.26174,18.3275,622
169837,4020F45A25B90FB7F045FA0843BE28FF,30651,12,13,1,109.42611,18.385,1232
169838,4020F45A25B90FB7F045FA0843BE28FF,30821,15,16,1,109.43681,18.33639,1274
169839,4020F45A25B90FB7F045FA0843BE28FF,30651,20,22,2,109.42611,18.385,1232
169864,A65416E0023DB5B05C85EFD796D8188E,31441,0,7,7,109.51181,18.24424,1559
169865,A65416E0023DB5B05C85EFD796D8188E,30661,11,12,1,109.37028,18.24361,1008
169866,A65416E0023DB5B05C85EFD796D8188E,31261,15,20,5,109.51174,18.2466,1559
169910,47A18820FDA9856131F74091D44B6BCB,31561,0,14,14,109.56792,18.28479,1765
169911,47A18820FDA9856131F74091D44B6BCB,30851,16,17,1,109.5616,18.27396,1713
169912,47A18820FDA9856131F74091D44B6BCB,31561,20,21,1,109.56792,18.28479,1765
169947,79B3E6103791BA4C5123FE39F25946F0,30081,0,5,5,109.50243,18.26632,1512
169948,79B3E6103791BA4C5123FE39F25946F0,30661,6,10,4,109.37028,18.24361,1008
169949,79B3E6103791BA4C5123FE39F25946F0,60411,10,14,4,109.32514,18.30854,869
169950,A9FCE0049DB44FE004EAFBF5B783F4A5,30854,1,16,15,109.56889,18.27076,1763
169951,A9FCE0049DB44FE004EAFBF5B783F4A5,31071,16,17,1,109.58257,18.28458,1815
169952,A9FCE0049DB44FE004EAFBF5B783F4A5,38154,21,22,1,109.5266,18.28278,1615
169957,CCBF1BE99DA9F84ADB162A21804AB04F,39183,14,15,1,109.55542,18.28208,1715
169958,CCBF1BE99DA9F84ADB162A21804AB04F,31561,15,16,1,109.56792,18.28479,1765
169959,CCBF1BE99DA9F84ADB162A21804AB04F,60361,19,22,3,109.51938,18.29681,1567
169962,03B0ABE70E1304E959E1A0EDA3550F7F,60661,0,6,6,109.548,18.2377,1657
169963,03B0ABE70E1304E959E1A0EDA3550F7F,31091,8,10,2,109.41201,18.31222,1170
169964,03B0ABE70E1304E959E1A0EDA3550F7F,30661,13,14,1,109.37028,18.24361,1008
169965,03B0ABE70E1304E959E1A0EDA3550F7F,31421,16,17,1,109.55382,18.22347,1705
169966,03B0ABE70E1304E959E1A0EDA3550F7F,60661,21,22,1,109.548,18.2377,1657
170012,E4A6ADA106DC95FCBCCB308A3007E3C3,31471,15,17,2,109.34583,18.29563,917
170013,E4A6ADA106DC95FCBCCB308A3007E3C3,60281,19,21,2,109.51743,18.25924,1561
170014,E4A6ADA106DC95FCBCCB308A3007E3C3,30711,21,23,2,109.50271,18.25347,1510
170018,0467E7A2F341B63F33E9945177D53E54,31521,1,7,6,109.51458,18.22542,1555
170019,0467E7A2F341B63F33E9945177D53E54,31521,7,9,2,109.51458,18.22542,1555
170020,0467E7A2F341B63F33E9945177D53E54,31781,10,12,2,109.19847,18.2975,367
170021,0467E7A2F341B63F33E9945177D53E54,31521,13,16,3,109.51458,18.22542,1555
170022,0467E7A2F341B63F33E9945177D53E54,60221,16,18,2,109.52569,18.29188,1616
170023,0467E7A2F341B63F33E9945177D53E54,31521,19,23,4,109.51458,18.22542,1555
170039,84DF4A7C208235D171EF56473BCCF210,30851,1,2,1,109.5616,18.27396,1713
170040,84DF4A7C208235D171EF56473BCCF210,31561,5,7,2,109.56792,18.28479,1765
170041,84DF4A7C208235D171EF56473BCCF210,60631,7,18,11,109.57778,18.27583,1814
170122,BE586ACB441383CC10D7CF3923850B73,39181,14,18,4,109.55153,18.28035,1715
170123,BE586ACB441383CC10D7CF3923850B73,31931,19,23,4,109.54771,18.29403,1667
170154,D8E932F61067935AEFB49165DCDE5286,31251,0,7,7,109.18528,18.2975,317
170155,D8E932F61067935AEFB49165DCDE5286,31145,9,10,1,109.20431,18.30479,369
170156,D8E932F61067935AEFB49165DCDE5286,31471,14,16,2,109.34583,18.29563,917
170157,D8E932F61067935AEFB49165DCDE5286,60251,19,22,3,109.51229,18.325,1572
170178,40D62DAB923B148A7A4FFB3BCA6C7343,60501,1,7,6,109.48701,18.29021,1466
170179,40D62DAB923B148A7A4FFB3BCA6C7343,38951,10,11,1,109.48097,18.28868,1416
170180,40D62DAB923B148A7A4FFB3BCA6C7343,38153,15,17,2,109.51819,18.25736,1561
170181,40D62DAB923B148A7A4FFB3BCA6C7343,38951,18,20,2,109.48097,18.28868,1416
170182,40D62DAB923B148A7A4FFB3BCA6C7343,30201,21,22,1,109.4909,18.26465,1462
170201,2AB980E3003284F0269A1377C53CC1EB,30581,16,17,1,109.62257,18.24951,1959
170202,2AB980E3003284F0269A1377C53CC1EB,38325,21,23,2,109.39792,18.2909,1116
170210,FF90B6855593CFEA9A07FE008E94551D,31931,15,16,1,109.54771,18.29403,1667
170211,FF90B6855593CFEA9A07FE008E94551D,30071,21,22,1,109.52819,18.30472,1619
170220,8C0E6B51FAFE21C31FB9AE08C36DF0A2,30921,1,16,15,109.53903,18.29451,1667
170221,8C0E6B51FAFE21C31FB9AE08C36DF0A2,60241,19,22,3,109.53319,18.28667,1616
170228,28A89A8FEC174286EFBBD2F96B7BCF44,60281,1,2,1,109.51743,18.25924,1561
170229,28A89A8FEC174286EFBBD2F96B7BCF44,38291,2,4,2,109.51618,18.24313,1558
170230,28A89A8FEC174286EFBBD2F96B7BCF44,60281,5,7,2,109.51743,18.25924,1561
170231,28A89A8FEC174286EFBBD2F96B7BCF44,30181,10,12,2,109.51597,18.23313,1557
170232,28A89A8FEC174286EFBBD2F96B7BCF44,30171,13,14,1,109.48458,18.27139,1463
170247,D947D8D9432E18EA6A214259B6E2987E,60411,0,14,14,109.32514,18.30854,869
170248,D947D8D9432E18EA6A214259B6E2987E,30661,14,18,4,109.37028,18.24361,1008
170249,D947D8D9432E18EA6A214259B6E2987E,60054,20,23,3,109.3016,18.31229,770
170250,335A7B1DE8538918FDA774EE3E402A76,30191,0,7,7,109.50361,18.22701,1506
170251,335A7B1DE8538918FDA774EE3E402A76,31521,7,8,1,109.51458,18.22542,1555
170252,335A7B1DE8538918FDA774EE3E402A76,60381,9,11,2,109.5241,18.22458,1605
170253,335A7B1DE8538918FDA774EE3E402A76,30191,12,23,11,109.50361,18.22701,1506
170260,E082FB5BD091C5B334EC1176FF352EE0,30071,0,8,8,109.52819,18.30472,1619
170261,E082FB5BD091C5B334EC1176FF352EE0,31931,10,12,2,109.54771,18.29403,1667
170262,E082FB5BD091C5B334EC1176FF352EE0,30071,12,22,10,109.52819,18.30472,1619
170284,AA17C9279A63248D7DCDF49F93EB8817,38275,10,18,8,109.62875,18.22938,2006
170285,AA17C9279A63248D7DCDF49F93EB8817,30854,22,23,1,109.56889,18.27076,1763
170300,ECE5F9061BD873B365108DCE1A2E8E9E,31321,13,15,2,109.63799,18.23201,2007
170301,ECE5F9061BD873B365108DCE1A2E8E9E,38271,17,22,5,109.62632,18.23049,1956
170310,D73D0E1690714CD7F442C709F67E4771,60361,0,7,7,109.51938,18.29681,1567
170311,D73D0E1690714CD7F442C709F67E4771,30951,8,11,3,109.56208,18.25667,1761
170312,D73D0E1690714CD7F442C709F67E4771,30851,12,14,2,109.5616,18.27396,1713
170313,D73D0E1690714CD7F442C709F67E4771,60361,19,23,4,109.51938,18.29681,1567
170323,B16225DD3371073720184BB0D089E6D6,31561,2,6,4,109.56792,18.28479,1765
170324,B16225DD3371073720184BB0D089E6D6,30854,7,16,9,109.56889,18.27076,1763
170330,5DFB96E5E8A111915E2B8AFE3C420F16,30531,0,7,7,109.53271,18.21472,1604
170331,5DFB96E5E8A111915E2B8AFE3C420F16,31061,8,18,10,109.53333,18.23257,1607
170332,5DFB96E5E8A111915E2B8AFE3C420F16,60661,18,19,1,109.548,18.2377,1657
170333,5DFB96E5E8A111915E2B8AFE3C420F16,30531,20,22,2,109.53271,18.21472,1604
170348,F84D949DDCBF25D5530F771BC55E0B9D,61011,5,23,18,109.60653,18.19076,1900
170367,07169E7114E4F14C073261BAAC0D4491,61011,1,7,6,109.60653,18.19076,1900
170369,07169E7114E4F14C073261BAAC0D4491,61011,18,23,5,109.60653,18.19076,1900
170401,DDA0EB7263815D997F150C58431C5F5D,30351,0,8,8,109.41701,18.29292,1217
170402,DDA0EB7263815D997F150C58431C5F5D,31471,10,12,2,109.34583,18.29563,917
170403,DDA0EB7263815D997F150C58431C5F5D,31781,14,15,1,109.19847,18.2975,367
170404,DDA0EB7263815D997F150C58431C5F5D,60281,19,20,1,109.51743,18.25924,1561
170405,DDA0EB7263815D997F150C58431C5F5D,30351,22,23,1,109.41701,18.29292,1217
170409,8F41B5A5D3BA7B315EA1C41B064BC5DA,60524,0,6,6,109.42951,18.28993,1216
170410,8F41B5A5D3BA7B315EA1C41B064BC5DA,60552,6,7,1,109.41729,18.30014,1218
170411,8F41B5A5D3BA7B315EA1C41B064BC5DA,31781,12,13,1,109.19847,18.2975,367
170412,8F41B5A5D3BA7B315EA1C41B064BC5DA,31471,15,16,1,109.34583,18.29563,917
170413,8F41B5A5D3BA7B315EA1C41B064BC5DA,38071,20,23,3,109.40722,18.30938,1169
170447,8941A851436D0D911B70B8FD5F8E2C31,31161,15,23,8,109.70229,18.31361,2270
170448,9C1407835BC54BEBDB541F52E1DA1820,61011,0,9,9,109.60653,18.19076,1900
170500,52C15F07544D9CC60D46BD6BA2551891,31071,10,11,1,109.58257,18.28458,1815
170501,52C15F07544D9CC60D46BD6BA2551891,60631,13,19,6,109.57778,18.27583,1814
170502,52C15F07544D9CC60D46BD6BA2551891,30854,19,22,3,109.56889,18.27076,1763
170503,52C15F07544D9CC60D46BD6BA2551891,60631,22,23,1,109.57778,18.27583,1814
170533,1D815BFAE7906FCEB1C73FB23323FFF3,31345,0,10,10,109.39,18.29,1066
170534,1D815BFAE7906FCEB1C73FB23323FFF3,31143,11,13,2,109.19986,18.29875,368
170535,1D815BFAE7906FCEB1C73FB23323FFF3,31345,14,17,3,109.39,18.29,1066
170536,1D815BFAE7906FCEB1C73FB23323FFF3,30201,17,19,2,109.4909,18.26465,1462
170537,1D815BFAE7906FCEB1C73FB23323FFF3,31261,20,22,2,109.51174,18.2466,1559
170538,1D815BFAE7906FCEB1C73FB23323FFF3,38291,22,23,1,109.51618,18.24313,1558
170559,C23F82F14EE8213E43F931E428019A69,30321,21,23,2,109.49563,18.29611,1467
170562,2A699167E9D3E245FFAC98B0B1AFC37B,31181,0,7,7,109.50382,18.24813,1509
170563,2A699167E9D3E245FFAC98B0B1AFC37B,60291,9,13,4,109.50826,18.24639,1509
170564,2A699167E9D3E245FFAC98B0B1AFC37B,31181,15,17,2,109.50382,18.24813,1509
170565,2A699167E9D3E245FFAC98B0B1AFC37B,60291,17,23,6,109.50826,18.24639,1509
170577,59BC82AA673F3B026E4585AB957F187F,30211,4,7,3,109.49882,18.23931,1508
170578,59BC82AA673F3B026E4585AB957F187F,60401,9,10,1,109.47444,18.27583,1414
170579,59BC82AA673F3B026E4585AB957F187F,31021,12,14,2,109.49021,18.27,1463
170580,59BC82AA673F3B026E4585AB957F187F,31521,14,23,9,109.51458,18.22542,1555
170627,CCCD2290FB632A48009771412BE68ADD,31561,0,13,13,109.56792,18.28479,1765
170628,CCCD2290FB632A48009771412BE68ADD,39183,15,16,1,109.55542,18.28208,1715
170653,73EAC1341C5005A58B26B1A52457F38B,39151,0,5,5,109.49875,18.25097,1510
170654,73EAC1341C5005A58B26B1A52457F38B,31181,6,20,14,109.50382,18.24813,1509
170655,73EAC1341C5005A58B26B1A52457F38B,39091,22,23,1,109.50097,18.25222,1510
170659,DC29C676832347947F366933ECB88090,31561,0,1,1,109.56792,18.28479,1765
170660,DC29C676832347947F366933ECB88090,30854,2,4,2,109.56889,18.27076,1763
170661,DC29C676832347947F366933ECB88090,31561,4,6,2,109.56792,18.28479,1765
170662,DC29C676832347947F366933ECB88090,39183,10,11,1,109.55542,18.28208,1715
170663,DC29C676832347947F366933ECB88090,31561,12,15,3,109.56792,18.28479,1765
170664,DC29C676832347947F366933ECB88090,39183,15,17,2,109.55542,18.28208,1715
170676,99CBAA6A65A50998F0A10B72B36210E4,60084,6,11,5,109.4984,18.2334,1507
170677,99CBAA6A65A50998F0A10B72B36210E4,60201,12,13,1,109.5041,18.2509,1510
170678,99CBAA6A65A50998F0A10B72B36210E4,60084,14,19,5,109.4984,18.2334,1507
170679,99CBAA6A65A50998F0A10B72B36210E4,30271,21,22,1,109.49132,18.23153,1456
170725,37D38EF0062E64D55C94EB554B76F9EE,31945,0,8,8,109.58021,18.29403,1817
170726,37D38EF0062E64D55C94EB554B76F9EE,30854,13,14,1,109.56889,18.27076,1763
170727,37D38EF0062E64D55C94EB554B76F9EE,31164,18,20,2,109.69993,18.27215,2263
170728,37D38EF0062E64D55C94EB554B76F9EE,30854,21,22,1,109.56889,18.27076,1763
170739,3C5AEA306E8A69C707195C4150E77D90,39183,7,9,2,109.55542,18.28208,1715
170740,3C5AEA306E8A69C707195C4150E77D90,31931,10,13,3,109.54771,18.29403,1667
170741,3C5AEA306E8A69C707195C4150E77D90,39181,13,16,3,109.55153,18.28035,1715
170755,E34FF61340C5B86CF9FD0AD454D26266,60331,0,8,8,109.505,18.26507,1512
170756,E34FF61340C5B86CF9FD0AD454D26266,60281,8,9,1,109.51743,18.25924,1561
170757,E34FF61340C5B86CF9FD0AD454D26266,38251,10,11,1,109.49618,18.25493,1510
170758,E34FF61340C5B86CF9FD0AD454D26266,31521,15,17,2,109.51458,18.22542,1555
170759,E34FF61340C5B86CF9FD0AD454D26266,30251,18,22,4,109.50611,18.26653,1512
170769,EF24901D99384F703B20FE07F2784FA0,31631,9,11,2,109.59542,18.36826,1879
170770,EF24901D99384F703B20FE07F2784FA0,30101,13,18,5,109.57299,18.33333,1773
170771,EF24901D99384F703B20FE07F2784FA0,31631,20,22,2,109.59542,18.36826,1879
170786,5E0DF04AE6922A733420CB1D87AC36E1,30511,17,18,1,109.51069,18.24208,1558
170787,5E0DF04AE6922A733420CB1D87AC36E1,39091,18,20,2,109.50097,18.25222,1510
170790,E5E2DA460104E389257158E8D8C9FBDA,60281,0,7,7,109.51743,18.25924,1561
170791,E5E2DA460104E389257158E8D8C9FBDA,60311,8,10,2,109.52097,18.24319,1558
170792,E5E2DA460104E389257158E8D8C9FBDA,60281,13,23,10,109.51743,18.25924,1561
170793,7784022BDEFABB0258B32ABBB5E13027,39154,0,6,6,109.50201,18.25681,1511
170794,7784022BDEFABB0258B32ABBB5E13027,38157,7,10,3,109.51483,18.26958,1563
170795,7784022BDEFABB0258B32ABBB5E13027,30711,12,15,3,109.50271,18.25347,1510
170796,7784022BDEFABB0258B32ABBB5E13027,31491,17,18,1,109.73042,18.38771,2382
170797,7784022BDEFABB0258B32ABBB5E13027,60121,19,21,2,109.74507,18.37472,2430
170814,8D496C0E2DB1FF881021B05CE10C0242,31071,0,7,7,109.58257,18.28458,1815
170815,8D496C0E2DB1FF881021B05CE10C0242,30854,7,8,1,109.56889,18.27076,1763
170816,8D496C0E2DB1FF881021B05CE10C0242,31071,11,12,1,109.58257,18.28458,1815
170817,8D496C0E2DB1FF881021B05CE10C0242,30854,16,17,1,109.56889,18.27076,1763
170818,8D496C0E2DB1FF881021B05CE10C0242,31071,22,23,1,109.58257,18.28458,1815
170845,1122041491C04B199A15F6E1E401D68F,30151,14,17,3,109.50986,18.25083,1560
170846,1122041491C04B199A15F6E1E401D68F,30461,18,19,1,109.5116,18.26313,1562
170847,1122041491C04B199A15F6E1E401D68F,31821,21,22,1,109.51181,18.24924,1559
170869,76F6A54588C8DF7DDADFC50CAA11D44C,38085,0,8,8,109.6291,18.23625,2007
170870,76F6A54588C8DF7DDADFC50CAA11D44C,31561,12,15,3,109.56792,18.28479,1765
170871,76F6A54588C8DF7DDADFC50CAA11D44C,30854,17,23,6,109.56889,18.27076,1763
170952,012ABD06F231728C214A4BA917E75B1C,31561,0,2,2,109.56792,18.28479,1765
170953,012ABD06F231728C214A4BA917E75B1C,30851,4,12,8,109.5616,18.27396,1713
170954,012ABD06F231728C214A4BA917E75B1C,31561,15,16,1,109.56792,18.28479,1765
170955,012ABD06F231728C214A4BA917E75B1C,30851,16,23,7,109.5616,18.27396,1713
170958,51061B3DE820AF1C1C713EF684728003,31071,5,7,2,109.58257,18.28458,1815
170959,51061B3DE820AF1C1C713EF684728003,30854,8,17,9,109.56889,18.27076,1763
170960,51061B3DE820AF1C1C713EF684728003,30891,19,20,1,109.59431,18.28389,1865
170961,51061B3DE820AF1C1C713EF684728003,31071,21,23,2,109.58257,18.28458,1815
170962,A8E9C7BB918ADAD29A3EA7ACDDCD32D7,38951,0,7,7,109.48097,18.28868,1416
170963,A8E9C7BB918ADAD29A3EA7ACDDCD32D7,38951,8,10,2,109.48097,18.28868,1416
170964,A8E9C7BB918ADAD29A3EA7ACDDCD32D7,38951,12,23,11,109.48097,18.28868,1416
170972,844EDA750B421C0DF1043A6AC4E51E70,60041,1,10,9,109.39889,18.31944,1121
170973,844EDA750B421C0DF1043A6AC4E51E70,30651,14,22,8,109.42611,18.385,1232
170993,1980C8D409DE9551539224B3D393CDAA,30071,3,9,6,109.52819,18.30472,1619
170994,1980C8D409DE9551539224B3D393CDAA,30071,9,12,3,109.52819,18.30472,1619
170995,1980C8D409DE9551539224B3D393CDAA,30071,12,14,2,109.52819,18.30472,1619
170996,1980C8D409DE9551539224B3D393CDAA,31951,14,19,5,109.52174,18.30299,1568
170997,1980C8D409DE9551539224B3D393CDAA,30071,20,23,3,109.52819,18.30472,1619
171029,C1287E1F5E9B82EE35A85BDD5D31ACF1,30421,1,4,3,109.50021,18.25861,1511
171030,C1287E1F5E9B82EE35A85BDD5D31ACF1,30381,8,10,2,109.52521,18.24507,1609
171031,C1287E1F5E9B82EE35A85BDD5D31ACF1,31261,12,15,3,109.51174,18.2466,1559
171032,D9AE11CD16B231308C3F0FB3F53BC3E9,30854,0,6,6,109.56889,18.27076,1763
171033,D9AE11CD16B231308C3F0FB3F53BC3E9,31071,8,17,9,109.58257,18.28458,1815
171071,8B9A9BFD1ACAD480EB101A91DBF2024D,38291,0,1,1,109.51618,18.24313,1558
171072,8B9A9BFD1ACAD480EB101A91DBF2024D,30371,2,18,16,109.51,18.24771,1559
171073,8B9A9BFD1ACAD480EB101A91DBF2024D,30421,20,23,3,109.50021,18.25861,1511
171074,E9A67CAEAD4E146EE721320A56F893AA,31071,1,5,4,109.58257,18.28458,1815
171075,E9A67CAEAD4E146EE721320A56F893AA,30854,7,8,1,109.56889,18.27076,1763
171076,E9A67CAEAD4E146EE721320A56F893AA,31945,8,9,1,109.58021,18.29403,1817
171077,E9A67CAEAD4E146EE721320A56F893AA,31071,12,13,1,109.58257,18.28458,1815
171090,43E035AE85036EBD9891453E9567CB81,30151,1,8,7,109.50986,18.25083,1560
171091,43E035AE85036EBD9891453E9567CB81,30151,10,14,4,109.50986,18.25083,1560
171092,43E035AE85036EBD9891453E9567CB81,30151,19,23,4,109.50986,18.25083,1560
171109,81596C8771F0BD5C8688C47E383316FD,39191,0,1,1,109.51493,18.23472,1557
171110,81596C8771F0BD5C8688C47E383316FD,31201,2,5,3,109.51042,18.23819,1558
171111,81596C8771F0BD5C8688C47E383316FD,30181,5,10,5,109.51597,18.23313,1557
171114,2A1AB09F11CECAAFA5576058E9461FEA,31431,0,1,1,109.44639,18.29042,1316
171115,2A1AB09F11CECAAFA5576058E9461FEA,31231,3,5,2,109.42597,18.29292,1217
171116,2A1AB09F11CECAAFA5576058E9461FEA,30661,6,7,1,109.37028,18.24361,1008
171117,2A1AB09F11CECAAFA5576058E9461FEA,30111,8,10,2,109.47583,18.30542,1419
171118,594298D66BAD5405EE1904C905FA9B12,31071,13,19,6,109.58257,18.28458,1815
171119,594298D66BAD5405EE1904C905FA9B12,30711,21,22,1,109.50271,18.25347,1510
171150,8752BC71725B50257436D50C6598F252,31071,1,7,6,109.58257,18.28458,1815
171151,8752BC71725B50257436D50C6598F252,30854,8,18,10,109.56889,18.27076,1763
171152,8752BC71725B50257436D50C6598F252,31071,21,23,2,109.58257,18.28458,1815
171194,189633BA4D39EBA8A203BC9E364D4B1F,30051,12,14,2,109.48917,18.21215,1453
171195,189633BA4D39EBA8A203BC9E364D4B1F,38291,19,23,4,109.51618,18.24313,1558
171206,C983E73D646629A775690ECA8920EB29,30101,2,5,3,109.57299,18.33333,1773
171207,C983E73D646629A775690ECA8920EB29,31631,8,9,1,109.59542,18.36826,1879
171208,C983E73D646629A775690ECA8920EB29,30101,11,17,6,109.57299,18.33333,1773
171209,C983E73D646629A775690ECA8920EB29,31631,20,21,1,109.59542,18.36826,1879
171217,6C7CFF92341DACF5390B37394F2B073B,60381,1,3,2,109.5241,18.22458,1605
171218,6C7CFF92341DACF5390B37394F2B073B,39321,7,8,1,109.529,18.2167,1604
171219,6C7CFF92341DACF5390B37394F2B073B,30731,12,13,1,109.50944,18.22306,1555
171220,6C7CFF92341DACF5390B37394F2B073B,60381,15,17,2,109.5241,18.22458,1605
171226,EF9F15FAFA5926C5B853D240732ABDEA,30661,17,19,2,109.37028,18.24361,1008
171227,EF9F15FAFA5926C5B853D240732ABDEA,60201,20,22,2,109.5041,18.2509,1510
171261,F1FA54BCDE7297F39D6C0507CA898D49,38361,0,17,17,109.43667,18.29201,1267
171262,F1FA54BCDE7297F39D6C0507CA898D49,60551,17,19,2,109.42722,18.30111,1218
171278,D4AA3869830031578B573FD0033C24A8,60371,5,9,4,109.53063,18.30056,1618
171279,D4AA3869830031578B573FD0033C24A8,31931,13,23,10,109.54771,18.29403,1667
171298,377A324496E54511961704972731A3D5,31821,0,8,8,109.51181,18.24924,1559
171299,377A324496E54511961704972731A3D5,39111,12,14,2,109.5191,18.22597,1555
171300,377A324496E54511961704972731A3D5,31521,17,21,4,109.51458,18.22542,1555
171315,4639E7F597994307D62A7FF9CC65CC1D,31071,0,18,18,109.58257,18.28458,1815
171316,4639E7F597994307D62A7FF9CC65CC1D,30854,18,19,1,109.56889,18.27076,1763
171403,9AA959ED87D1ECC3053DED17290EFCBD,30851,1,2,1,109.5616,18.27396,1713
171404,9AA959ED87D1ECC3053DED17290EFCBD,31561,3,4,1,109.56792,18.28479,1765
171456,D96E01B8E0F0DE9C160C9FEAFDCFDB6D,31021,15,16,1,109.49021,18.27,1463
171457,D96E01B8E0F0DE9C160C9FEAFDCFDB6D,31071,19,21,2,109.58257,18.28458,1815
171458,D96E01B8E0F0DE9C160C9FEAFDCFDB6D,30854,22,23,1,109.56889,18.27076,1763
171497,C37DBDD12F85B1DFB17F9185AF0E7708,30951,1,8,7,109.56208,18.25667,1761
171498,C37DBDD12F85B1DFB17F9185AF0E7708,30851,8,11,3,109.5616,18.27396,1713
171499,C37DBDD12F85B1DFB17F9185AF0E7708,30951,12,23,11,109.56208,18.25667,1761
171508,7084657DF30063A945AAA5EF4742695F,39183,0,6,6,109.55542,18.28208,1715
171509,7084657DF30063A945AAA5EF4742695F,31931,6,8,2,109.54771,18.29403,1667
171510,7084657DF30063A945AAA5EF4742695F,39183,11,23,12,109.55542,18.28208,1715
171555,651A229E7C61DF6BD0C5C3DE95C555BD,30854,10,18,8,109.56889,18.27076,1763
171556,651A229E7C61DF6BD0C5C3DE95C555BD,30711,21,22,1,109.50271,18.25347,1510
171580,C09C0EAB86082A4D7E18052318E53A38,38291,0,8,8,109.51618,18.24313,1558
171581,C09C0EAB86082A4D7E18052318E53A38,38017,10,14,4,109.49729,18.21424,1504
171582,C09C0EAB86082A4D7E18052318E53A38,31471,14,16,2,109.34583,18.29563,917
171583,C09C0EAB86082A4D7E18052318E53A38,38017,19,23,4,109.49729,18.21424,1504
171589,7426A8B55792A8B93D9B7B93370F4B93,60524,0,7,7,109.42951,18.28993,1216
171590,7426A8B55792A8B93D9B7B93370F4B93,30351,7,8,1,109.41701,18.29292,1217
171591,7426A8B55792A8B93D9B7B93370F4B93,30581,9,10,1,109.62257,18.24951,1959
171631,1730F16E414BB3DC3E44A9424DB9DBC0,38484,0,1,1,109.53028,18.31528,1620
171632,1730F16E414BB3DC3E44A9424DB9DBC0,60371,1,5,4,109.53063,18.30056,1618
171634,1730F16E414BB3DC3E44A9424DB9DBC0,60371,13,14,1,109.53063,18.30056,1618
171635,1730F16E414BB3DC3E44A9424DB9DBC0,31391,15,16,1,109.50382,18.24285,1508
171636,1730F16E414BB3DC3E44A9424DB9DBC0,60371,19,23,4,109.53063,18.30056,1618
171659,C8922FAF66F21ECAECB6B717FCD5A53B,60614,0,13,13,109.48799,18.29521,1467
171660,C8922FAF66F21ECAECB6B717FCD5A53B,60391,14,17,3,109.47667,18.28757,1416
171661,C8922FAF66F21ECAECB6B717FCD5A53B,60614,17,23,6,109.48799,18.29521,1467
171687,C69D9D9A56587BE98796607AF04788C3,60551,19,20,1,109.42722,18.30111,1218
171688,C69D9D9A56587BE98796607AF04788C3,30421,21,23,2,109.50021,18.25861,1511
171718,E1B69B9C5AD47FF9C02A38B65955BC56,31945,0,11,11,109.58021,18.29403,1817
171719,E1B69B9C5AD47FF9C02A38B65955BC56,30854,13,23,10,109.56889,18.27076,1763
171749,FD5B9AB034F15F72E8BEF02193669238,30921,9,11,2,109.53903,18.29451,1667
171750,FD5B9AB034F15F72E8BEF02193669238,60241,12,22,10,109.53319,18.28667,1616
171769,04ABA8BFD5D63DDF1B83BA0577C9019C,30232,2,4,2,109.6191,18.31701,1971
171770,04ABA8BFD5D63DDF1B83BA0577C9019C,31421,4,5,1,109.55382,18.22347,1705
171774,8B67CA01C44A0A9FF0492771727FF584,60381,18,19,1,109.5241,18.22458,1605
171775,8B67CA01C44A0A9FF0492771727FF584,38891,20,23,3,109.51486,18.24118,1558
171808,5CFFF8D919E96524101209E188C669B3,31951,22,23,1,109.52174,18.30299,1568
171819,08A066736557478B1013C0CF834491DF,31931,18,20,2,109.54771,18.29403,1667
171820,08A066736557478B1013C0CF834491DF,30921,20,21,1,109.53903,18.29451,1667
171839,8EC6BA9FA8E683D0E20F5950ED4FE9BA,30851,0,2,2,109.5616,18.27396,1713
171840,8EC6BA9FA8E683D0E20F5950ED4FE9BA,30854,3,4,1,109.56889,18.27076,1763
171841,8EC6BA9FA8E683D0E20F5950ED4FE9BA,31561,5,6,1,109.56792,18.28479,1765
171842,8EC6BA9FA8E683D0E20F5950ED4FE9BA,38891,19,20,1,109.51486,18.24118,1558
171843,8EC6BA9FA8E683D0E20F5950ED4FE9BA,38154,22,23,1,109.5266,18.28278,1615
171862,232722015844736ABCA5CD9BDD75C9C8,60614,0,6,6,109.48799,18.29521,1467
171863,232722015844736ABCA5CD9BDD75C9C8,31221,11,12,1,109.61333,18.26833,1913
171864,232722015844736ABCA5CD9BDD75C9C8,30441,13,16,3,109.64021,18.25424,2010
171865,232722015844736ABCA5CD9BDD75C9C8,60501,20,23,3,109.48701,18.29021,1466
171867,36BDBC763CA4EEA7EA86EDFAC07B856F,30581,8,10,2,109.62257,18.24951,1959
171868,36BDBC763CA4EEA7EA86EDFAC07B856F,31781,12,13,1,109.19847,18.2975,367
171889,00FC332040A284DA251A8D0705989FE9,31071,0,7,7,109.58257,18.28458,1815
171890,00FC332040A284DA251A8D0705989FE9,30854,7,12,5,109.56889,18.27076,1763
171955,2AE38FAF341950B0B91404FFCE5A0F3E,31931,4,6,2,109.54771,18.29403,1667
171956,2AE38FAF341950B0B91404FFCE5A0F3E,30921,11,18,7,109.53903,18.29451,1667
171957,75616D7735994EB9CD2FE56D29700535,30854,9,12,3,109.56889,18.27076,1763
171958,75616D7735994EB9CD2FE56D29700535,31561,12,13,1,109.56792,18.28479,1765
171959,75616D7735994EB9CD2FE56D29700535,30854,14,16,2,109.56889,18.27076,1763
171960,75616D7735994EB9CD2FE56D29700535,30711,17,19,2,109.50271,18.25347,1510
171961,75616D7735994EB9CD2FE56D29700535,31561,20,23,3,109.56792,18.28479,1765
171962,39F25FE146A03325C93C111F2A943B6C,30854,13,15,2,109.56889,18.27076,1763
171963,39F25FE146A03325C93C111F2A943B6C,31071,17,19,2,109.58257,18.28458,1815
171990,B3777343168B11ED0B6DA62191147797,31071,0,8,8,109.58257,18.28458,1815
171991,B3777343168B11ED0B6DA62191147797,30854,9,17,8,109.56889,18.27076,1763
172007,1E36640BE395A4EE8CCB2697222419A5,30854,1,3,2,109.56889,18.27076,1763
172008,1E36640BE395A4EE8CCB2697222419A5,60631,5,9,4,109.57778,18.27583,1814
172009,1E36640BE395A4EE8CCB2697222419A5,30854,9,18,9,109.56889,18.27076,1763
172012,CFA6DB42B4EA79576A8AEA8F93765E81,30721,0,7,7,109.51597,18.28257,1565
172013,CFA6DB42B4EA79576A8AEA8F93765E81,30291,10,12,2,109.50403,18.27028,1513
172014,CFA6DB42B4EA79576A8AEA8F93765E81,30084,16,20,4,109.50118,18.26972,1513
172015,CFA6DB42B4EA79576A8AEA8F93765E81,30721,21,23,2,109.51597,18.28257,1565
172016,DFFF17B7FE30E79B8AABBB5CE171272F,30851,0,4,4,109.5616,18.27396,1713
172017,DFFF17B7FE30E79B8AABBB5CE171272F,31561,4,7,3,109.56792,18.28479,1765
172018,DFFF17B7FE30E79B8AABBB5CE171272F,39183,11,13,2,109.55542,18.28208,1715
172019,DFFF17B7FE30E79B8AABBB5CE171272F,31561,13,21,8,109.56792,18.28479,1765
172050,B34415F599F0ED7D1A073EE314A60B9B,31671,0,6,6,109.38965,18.29813,1068
172051,B34415F599F0ED7D1A073EE314A60B9B,60041,6,8,2,109.39889,18.31944,1121
172052,B34415F599F0ED7D1A073EE314A60B9B,31671,8,23,15,109.38965,18.29813,1068
172119,EC4B90EDBF35256FDB4D4F8B87DB8A04,30854,0,1,1,109.56889,18.27076,1763
172120,EC4B90EDBF35256FDB4D4F8B87DB8A04,31071,2,5,3,109.58257,18.28458,1815
172121,EC4B90EDBF35256FDB4D4F8B87DB8A04,30854,8,9,1,109.56889,18.27076,1763
172122,EC4B90EDBF35256FDB4D4F8B87DB8A04,31071,17,18,1,109.58257,18.28458,1815
172123,EC4B90EDBF35256FDB4D4F8B87DB8A04,30854,21,23,2,109.56889,18.27076,1763
172132,8CD15CF6B5FB4821940FF9AFE6D6CB84,39181,0,1,1,109.55153,18.28035,1715
172133,8CD15CF6B5FB4821940FF9AFE6D6CB84,39181,2,3,1,109.55153,18.28035,1715
172134,8CD15CF6B5FB4821940FF9AFE6D6CB84,39181,4,5,1,109.55153,18.28035,1715
172135,8CD15CF6B5FB4821940FF9AFE6D6CB84,31931,6,16,10,109.54771,18.29403,1667
172140,339B8E03A8626DDBBF8D74D2D918714D,60201,0,1,1,109.5041,18.2509,1510
172141,339B8E03A8626DDBBF8D74D2D918714D,31461,3,6,3,109.5091,18.25389,1510
172142,339B8E03A8626DDBBF8D74D2D918714D,30151,7,8,1,109.50986,18.25083,1560
172143,339B8E03A8626DDBBF8D74D2D918714D,30661,12,13,1,109.37028,18.24361,1008
172144,339B8E03A8626DDBBF8D74D2D918714D,60331,18,19,1,109.505,18.26507,1512
172145,339B8E03A8626DDBBF8D74D2D918714D,60371,19,22,3,109.53063,18.30056,1618
172146,339B8E03A8626DDBBF8D74D2D918714D,60331,22,23,1,109.505,18.26507,1512
172149,E0A24740E2C54F3B77DB561A91D2BED7,30151,0,6,6,109.50986,18.25083,1560
172150,E0A24740E2C54F3B77DB561A91D2BED7,30251,8,18,10,109.50611,18.26653,1512
172151,E0A24740E2C54F3B77DB561A91D2BED7,30151,18,20,2,109.50986,18.25083,1560
172152,E0A24740E2C54F3B77DB561A91D2BED7,31821,21,23,2,109.51181,18.24924,1559
172165,10E6DCB22C04D9E1B01193CDA87B3193,30721,0,6,6,109.51597,18.28257,1565
172166,10E6DCB22C04D9E1B01193CDA87B3193,31931,9,10,1,109.54771,18.29403,1667
172167,10E6DCB22C04D9E1B01193CDA87B3193,39183,11,13,2,109.55542,18.28208,1715
172250,979ABBB43C3434EE96D76E04CFC66E55,60201,0,9,9,109.5041,18.2509,1510
172251,979ABBB43C3434EE96D76E04CFC66E55,31781,12,15,3,109.19847,18.2975,367
172252,979ABBB43C3434EE96D76E04CFC66E55,31164,18,20,2,109.69993,18.27215,2263
172298,03CEC0FDDD5484124514C6D24A63D4DD,39183,13,18,5,109.55542,18.28208,1715
172299,03CEC0FDDD5484124514C6D24A63D4DD,30854,20,22,2,109.56889,18.27076,1763
172303,87ACF3C6ADE430D2B9DFB3C954E0C031,31071,0,8,8,109.58257,18.28458,1815
172304,87ACF3C6ADE430D2B9DFB3C954E0C031,30854,8,15,7,109.56889,18.27076,1763
172305,87ACF3C6ADE430D2B9DFB3C954E0C031,31071,16,17,1,109.58257,18.28458,1815
172306,87ACF3C6ADE430D2B9DFB3C954E0C031,30854,21,22,1,109.56889,18.27076,1763
172307,ABE4E7AE3E68F27E859AAF9E649218E0,30121,0,7,7,109.52861,18.27222,1613
172308,ABE4E7AE3E68F27E859AAF9E649218E0,30771,8,11,3,109.49938,18.26042,1511
172309,ABE4E7AE3E68F27E859AAF9E649218E0,60281,14,17,3,109.51743,18.25924,1561
172310,ABE4E7AE3E68F27E859AAF9E649218E0,30121,18,23,5,109.52861,18.27222,1613
172320,9A1FB52F8D7F45B27EB2059FE8339DC0,38141,0,1,1,109.39479,18.2916,1116
172321,9A1FB52F8D7F45B27EB2059FE8339DC0,38903,2,8,6,109.39229,18.29243,1117
172322,9A1FB52F8D7F45B27EB2059FE8339DC0,38141,9,11,2,109.39479,18.2916,1116
172323,9A1FB52F8D7F45B27EB2059FE8339DC0,38903,11,13,2,109.39229,18.29243,1117
172324,9A1FB52F8D7F45B27EB2059FE8339DC0,31951,16,17,1,109.52174,18.30299,1568
172325,9A1FB52F8D7F45B27EB2059FE8339DC0,38141,19,23,4,109.39479,18.2916,1116
172339,38CF8AD578A393476F29705A4599B8B1,30511,0,9,9,109.51069,18.24208,1558
172340,38CF8AD578A393476F29705A4599B8B1,60291,9,10,1,109.50826,18.24639,1509
172341,38CF8AD578A393476F29705A4599B8B1,38271,12,14,2,109.62632,18.23049,1956
172342,38CF8AD578A393476F29705A4599B8B1,38171,16,17,1,109.50799,18.28139,1515
172343,38CF8AD578A393476F29705A4599B8B1,38271,19,23,4,109.62632,18.23049,1956
172379,2F3BB5BE10811E7F8F8565DAA2126DE6,39181,0,4,4,109.55153,18.28035,1715
172380,2F3BB5BE10811E7F8F8565DAA2126DE6,31931,4,6,2,109.54771,18.29403,1667
172381,2F3BB5BE10811E7F8F8565DAA2126DE6,39181,9,23,14,109.55153,18.28035,1715
172392,55D9F9C0249C92714E75EA2BD9E88590,39091,4,7,3,109.50097,18.25222,1510
172422,14F1CC63CDA098F9694EAC8584B9C7A5,30854,14,15,1,109.56889,18.27076,1763
172423,14F1CC63CDA098F9694EAC8584B9C7A5,31561,15,19,4,109.56792,18.28479,1765
172437,93C8A9BFC982F63705EDC3214DA05AC8,30901,14,23,9,109.27597,18.3134,670
172454,E218C587552A5DADC05C4E69685FE374,39183,0,7,7,109.55542,18.28208,1715
172455,E218C587552A5DADC05C4E69685FE374,30854,10,16,6,109.56889,18.27076,1763
172527,1D8B814EC83D52D7C5F3FED99C129EE0,38271,10,18,8,109.62632,18.23049,1956
172528,1D8B814EC83D52D7C5F3FED99C129EE0,30854,19,20,1,109.56889,18.27076,1763
172529,E455476985FDFEBBD2CF96D40884A00A,38721,0,4,4,109.50368,18.27542,1514
172530,E455476985FDFEBBD2CF96D40884A00A,30291,6,9,3,109.50403,18.27028,1513
172531,E455476985FDFEBBD2CF96D40884A00A,60161,10,11,1,109.49174,18.26181,1461
172532,E455476985FDFEBBD2CF96D40884A00A,30161,12,14,2,109.50042,18.24389,1508
172538,8AD957ABE98C62A8B6F06AA624D5CB23,30854,11,12,1,109.56889,18.27076,1763
172539,8AD957ABE98C62A8B6F06AA624D5CB23,31071,12,13,1,109.58257,18.28458,1815
172540,8AD957ABE98C62A8B6F06AA624D5CB23,31561,15,16,1,109.56792,18.28479,1765
172541,8AD957ABE98C62A8B6F06AA624D5CB23,31071,18,19,1,109.58257,18.28458,1815
172663,EEC6B662D07BE95423A2DC77D2E69188,30891,0,8,8,109.59431,18.28389,1865
172664,EEC6B662D07BE95423A2DC77D2E69188,31071,9,17,8,109.58257,18.28458,1815
172694,628B56F9AD0921837C78826286456231,31236,17,20,3,109.42965,18.29111,1216
172695,628B56F9AD0921837C78826286456231,60552,21,23,2,109.41729,18.30014,1218
172708,752B4C65CCCA1EA27D3C6EA24E289B9C,30854,0,2,2,109.56889,18.27076,1763
172709,752B4C65CCCA1EA27D3C6EA24E289B9C,60631,4,5,1,109.57778,18.27583,1814
172710,752B4C65CCCA1EA27D3C6EA24E289B9C,30854,10,15,5,109.56889,18.27076,1763
172711,752B4C65CCCA1EA27D3C6EA24E289B9C,39371,16,18,2,109.56627,18.2646,1762
172712,752B4C65CCCA1EA27D3C6EA24E289B9C,30854,20,21,1,109.56889,18.27076,1763
172713,752B4C65CCCA1EA27D3C6EA24E289B9C,31071,21,23,2,109.58257,18.28458,1815
172732,C7A4B55787295F6419B55AB029D11243,38251,0,2,2,109.49618,18.25493,1510
172733,C7A4B55787295F6419B55AB029D11243,31031,3,7,4,109.49979,18.25382,1510
172734,C7A4B55787295F6419B55AB029D11243,30421,8,10,2,109.50021,18.25861,1511
172735,C7A4B55787295F6419B55AB029D11243,38251,11,15,4,109.49618,18.25493,1510
172736,C7A4B55787295F6419B55AB029D11243,30421,15,17,2,109.50021,18.25861,1511
172737,C7A4B55787295F6419B55AB029D11243,31031,17,21,4,109.49979,18.25382,1510
172767,AB43182259122294244C13D6FC66D4A1,30891,0,5,5,109.59431,18.28389,1865
172768,AB43182259122294244C13D6FC66D4A1,60631,5,6,1,109.57778,18.27583,1814
172769,AB43182259122294244C13D6FC66D4A1,31561,9,13,4,109.56792,18.28479,1765
172770,23019CE071DC0B0CEC6E78ADA422CE57,31091,1,2,1,109.41201,18.31222,1170
172771,23019CE071DC0B0CEC6E78ADA422CE57,31461,3,16,13,109.5091,18.25389,1510
172772,23019CE071DC0B0CEC6E78ADA422CE57,60361,17,19,2,109.51938,18.29681,1567
172773,036DFEF8CA623F9034F928149FE2468D,30821,0,2,2,109.43681,18.33639,1274
172774,036DFEF8CA623F9034F928149FE2468D,30651,2,4,2,109.42611,18.385,1232
172775,036DFEF8CA623F9034F928149FE2468D,30821,7,23,16,109.43681,18.33639,1274
172828,FCFB14BA36BDB7CD6A39612B9AE933B2,38127,2,5,3,109.50833,18.27222,1513
172829,FCFB14BA36BDB7CD6A39612B9AE933B2,31931,7,16,9,109.54771,18.29403,1667
172830,FCFB14BA36BDB7CD6A39612B9AE933B2,38127,18,23,5,109.50833,18.27222,1513
172831,F8D799D9161B0143E0D71C40472A357E,30071,0,8,8,109.52819,18.30472,1619
172832,F8D799D9161B0143E0D71C40472A357E,60371,8,10,2,109.53063,18.30056,1618
172833,F8D799D9161B0143E0D71C40472A357E,30071,10,11,1,109.52819,18.30472,1619
172834,F8D799D9161B0143E0D71C40472A357E,30071,12,18,6,109.52819,18.30472,1619
172835,F8D799D9161B0143E0D71C40472A357E,31951,19,23,4,109.52174,18.30299,1568
172840,6CFAF1B7B16CCEAB1A9CAE288B372D6F,60411,1,3,2,109.32514,18.30854,869
172841,6CFAF1B7B16CCEAB1A9CAE288B372D6F,30661,3,9,6,109.37028,18.24361,1008
172842,6CFAF1B7B16CCEAB1A9CAE288B372D6F,31471,13,15,2,109.34583,18.29563,917
172843,6CFAF1B7B16CCEAB1A9CAE288B372D6F,60411,19,21,2,109.32514,18.30854,869
172844,1C4D9C3B4ACCE12D2B04BB20561492BF,31461,14,17,3,109.5091,18.25389,1510
172874,410ABF8C14ACED0B5467A09396FAD1E3,31071,4,5,1,109.58257,18.28458,1815
172875,410ABF8C14ACED0B5467A09396FAD1E3,30854,8,22,14,109.56889,18.27076,1763
172889,7BF65E5054DA81A230AB5423620158E1,60631,1,4,3,109.57778,18.27583,1814
172890,7BF65E5054DA81A230AB5423620158E1,31071,6,7,1,109.58257,18.28458,1815
172891,7BF65E5054DA81A230AB5423620158E1,30854,9,23,14,109.56889,18.27076,1763
173009,4053323049FA57896819CD5356E38746,31071,1,6,5,109.58257,18.28458,1815
173010,4053323049FA57896819CD5356E38746,30681,10,12,2,109.48493,18.26917,1463
173011,4053323049FA57896819CD5356E38746,30854,13,22,9,109.56889,18.27076,1763
173021,9BF33DB1F7AC1D27E06AF501C14CCF2C,31931,0,8,8,109.54771,18.29403,1667
173022,9BF33DB1F7AC1D27E06AF501C14CCF2C,39181,8,9,1,109.55153,18.28035,1715
173023,9BF33DB1F7AC1D27E06AF501C14CCF2C,31931,12,23,11,109.54771,18.29403,1667
173040,A46BA306DAEA889FAC7ACE9E5FD6A1FF,30911,0,1,1,109.50493,18.26181,1511
173041,A46BA306DAEA889FAC7ACE9E5FD6A1FF,60331,5,9,4,109.505,18.26507,1512
173042,A46BA306DAEA889FAC7ACE9E5FD6A1FF,30911,12,15,3,109.50493,18.26181,1511
173043,A46BA306DAEA889FAC7ACE9E5FD6A1FF,30711,19,21,2,109.50271,18.25347,1510
173044,A46BA306DAEA889FAC7ACE9E5FD6A1FF,30511,21,23,2,109.51069,18.24208,1558
173064,C6C3BC01E542B810EF853FEEB6C81198,60361,0,19,19,109.51938,18.29681,1567
173065,C6C3BC01E542B810EF853FEEB6C81198,31561,19,21,2,109.56792,18.28479,1765
173068,DAE4AED2552702E7E5B51363230E28AA,30171,0,7,7,109.48458,18.27139,1463
173069,DAE4AED2552702E7E5B51363230E28AA,31231,8,9,1,109.42597,18.29292,1217
173070,DAE4AED2552702E7E5B51363230E28AA,30171,13,15,2,109.48458,18.27139,1463
173071,DAE4AED2552702E7E5B51363230E28AA,30171,20,21,1,109.48458,18.27139,1463
173082,14F21534C21254001A38352AD4BB0EF6,31071,0,15,15,109.58257,18.28458,1815
173083,14F21534C21254001A38352AD4BB0EF6,30854,17,20,3,109.56889,18.27076,1763
173095,7F3DDE6B55C3459C61E435131FEEF622,31151,0,10,10,109.75549,18.4191,2488
173096,7F3DDE6B55C3459C61E435131FEEF622,30861,12,13,1,109.52722,18.22743,1606
173097,7F3DDE6B55C3459C61E435131FEEF622,60381,18,21,3,109.5241,18.22458,1605
173105,7045DBCCD7547EA005B802778717D4DC,30271,0,8,8,109.49132,18.23153,1456
173106,7045DBCCD7547EA005B802778717D4DC,31471,11,12,1,109.34583,18.29563,917
173107,7045DBCCD7547EA005B802778717D4DC,60054,12,13,1,109.3016,18.31229,770
173108,7045DBCCD7547EA005B802778717D4DC,31471,14,15,1,109.34583,18.29563,917
173109,7045DBCCD7547EA005B802778717D4DC,31021,17,19,2,109.49021,18.27,1463
173110,7045DBCCD7547EA005B802778717D4DC,30271,20,23,3,109.49132,18.23153,1456
173111,6C0260646767B781577B5B8CE2471E51,38484,0,17,17,109.53028,18.31528,1620
173112,6C0260646767B781577B5B8CE2471E51,30071,21,22,1,109.52819,18.30472,1619
173113,20C15B76A1E0DF79D86EDEAC7BC3D7B7,31071,0,8,8,109.58257,18.28458,1815
173114,20C15B76A1E0DF79D86EDEAC7BC3D7B7,30854,12,14,2,109.56889,18.27076,1763
173115,20C15B76A1E0DF79D86EDEAC7BC3D7B7,31071,19,23,4,109.58257,18.28458,1815
173150,C1C69C0EAD4ABEFD1467543102429D9B,30281,0,1,1,109.50597,18.27583,1514
173151,C1C69C0EAD4ABEFD1467543102429D9B,31561,2,7,5,109.56792,18.28479,1765
173152,C1C69C0EAD4ABEFD1467543102429D9B,39183,11,21,10,109.55542,18.28208,1715
173273,B8A8F8A9546487F572B7D006432745F0,39091,0,8,8,109.50097,18.25222,1510
173274,B8A8F8A9546487F572B7D006432745F0,60411,11,23,12,109.32514,18.30854,869
173277,B2035C0684FF9CA861B7EB217CE5A160,60524,0,7,7,109.42951,18.28993,1216
173278,B2035C0684FF9CA861B7EB217CE5A160,31471,10,17,7,109.34583,18.29563,917
173279,B2035C0684FF9CA861B7EB217CE5A160,60041,18,19,1,109.39889,18.31944,1121
173297,FE95B3A32EFBC2838F293DF38F55FDD1,31561,16,17,1,109.56792,18.28479,1765
173298,FE95B3A32EFBC2838F293DF38F55FDD1,39183,18,19,1,109.55542,18.28208,1715
173361,E8BAAF476E8FE57075BAB1A8D4FF1780,30232,6,12,6,109.6191,18.31701,1971
173362,E8BAAF476E8FE57075BAB1A8D4FF1780,39371,15,17,2,109.56627,18.2646,1762
173363,E8BAAF476E8FE57075BAB1A8D4FF1780,31041,19,20,1,109.50278,18.23701,1507
173380,30CE72A519D49881F23B8123486E3A02,60411,0,10,10,109.32514,18.30854,869
173381,30CE72A519D49881F23B8123486E3A02,31471,11,18,7,109.34583,18.29563,917
173382,30CE72A519D49881F23B8123486E3A02,60411,18,23,5,109.32514,18.30854,869
173423,0E92CE103B7D015A3121B51920E312F8,31021,0,7,7,109.49021,18.27,1463
173424,0E92CE103B7D015A3121B51920E312F8,30281,10,11,1,109.50597,18.27583,1514
173425,0E92CE103B7D015A3121B51920E312F8,31031,11,13,2,109.49979,18.25382,1510
173426,0E92CE103B7D015A3121B51920E312F8,38171,15,18,3,109.50799,18.28139,1515
173427,0E92CE103B7D015A3121B51920E312F8,60463,18,20,2,109.52507,18.22438,1605
173428,0E92CE103B7D015A3121B51920E312F8,30281,21,22,1,109.50597,18.27583,1514
173434,9A1D1AA5EE2CD156CC396C667ED8C5B9,30854,0,11,11,109.56889,18.27076,1763
173435,9A1D1AA5EE2CD156CC396C667ED8C5B9,60631,15,16,1,109.57778,18.27583,1814
173455,62373512AC63EC7FF3AD17244A4ECC6D,31531,17,20,3,109.49583,18.25972,1461
173456,62373512AC63EC7FF3AD17244A4ECC6D,31534,21,23,2,109.49368,18.25806,1461
173464,798BF3B08F72A16A6DEAAA235F1899BB,61011,0,5,5,109.60653,18.19076,1900
173466,798BF3B08F72A16A6DEAAA235F1899BB,61011,10,23,13,109.60653,18.19076,1900
173487,0D48FD835B207ED202CAB110B7436DC2,31821,14,18,4,109.51181,18.24924,1559
173488,0D48FD835B207ED202CAB110B7436DC2,31071,21,22,1,109.58257,18.28458,1815
173489,0D48FD835B207ED202CAB110B7436DC2,30854,22,23,1,109.56889,18.27076,1763
173563,8FEFA204EA7EEB362556D906D163980A,31071,19,20,1,109.58257,18.28458,1815
173564,8FEFA204EA7EEB362556D906D163980A,30854,22,23,1,109.56889,18.27076,1763
173565,8DA90B6D40958D7E810FB66B32BF98D6,30361,16,17,1,109.50347,18.24,1508
173566,8DA90B6D40958D7E810FB66B32BF98D6,31311,20,23,3,109.72299,18.27438,2364
173573,CDBCEFE36800F86949E9657EF4E117F8,38541,0,13,13,109.73715,18.34875,2426
173574,CDBCEFE36800F86949E9657EF4E117F8,30361,17,19,2,109.50347,18.24,1508
173575,CDBCEFE36800F86949E9657EF4E117F8,30271,19,23,4,109.49132,18.23153,1456
173600,995FEDA35E19404F9E3BD941B6B09B64,30191,0,7,7,109.50361,18.22701,1506
173601,995FEDA35E19404F9E3BD941B6B09B64,31781,11,13,2,109.19847,18.2975,367
173602,995FEDA35E19404F9E3BD941B6B09B64,31471,15,16,1,109.34583,18.29563,917
173603,995FEDA35E19404F9E3BD941B6B09B64,30201,19,21,2,109.4909,18.26465,1462
173604,995FEDA35E19404F9E3BD941B6B09B64,38961,22,23,1,109.50847,18.23514,1507
173616,E4C7AB656E412C7E33554D18277C9478,60291,2,11,9,109.50826,18.24639,1509
173617,E4C7AB656E412C7E33554D18277C9478,38911,13,15,2,109.51674,18.24965,1559
173618,E4C7AB656E412C7E33554D18277C9478,60331,17,19,2,109.505,18.26507,1512
173619,E4C7AB656E412C7E33554D18277C9478,31461,22,23,1,109.5091,18.25389,1510
173649,C91F430AC30B55A21F7C58F74A11754B,31071,1,6,5,109.58257,18.28458,1815
173650,C91F430AC30B55A21F7C58F74A11754B,30854,7,8,1,109.56889,18.27076,1763
173651,C91F430AC30B55A21F7C58F74A11754B,31071,12,23,11,109.58257,18.28458,1815
173691,6751CEC3CF9B2AE78246C7287443D2B4,31761,15,16,1,109.60521,18.27965,1914
173692,6751CEC3CF9B2AE78246C7287443D2B4,31945,21,23,2,109.58021,18.29403,1817
173693,7F632B4875B2736225CD6D350CD25670,31071,0,7,7,109.58257,18.28458,1815
173694,7F632B4875B2736225CD6D350CD25670,30854,8,22,14,109.56889,18.27076,1763
173701,4552AE0C0FB78BA3063EBA5C903C87F0,31945,18,20,2,109.58021,18.29403,1817
173702,4552AE0C0FB78BA3063EBA5C903C87F0,31421,21,23,2,109.55382,18.22347,1705
173737,7FA173D0839B9BE60B23B32DD3C2AC47,30854,7,9,2,109.56889,18.27076,1763
173738,7FA173D0839B9BE60B23B32DD3C2AC47,31071,9,10,1,109.58257,18.28458,1815
173739,7FA173D0839B9BE60B23B32DD3C2AC47,31945,12,14,2,109.58021,18.29403,1817
173740,7FA173D0839B9BE60B23B32DD3C2AC47,38241,18,19,1,109.54111,18.30542,1669
173741,7FA173D0839B9BE60B23B32DD3C2AC47,30854,20,21,1,109.56889,18.27076,1763
173769,01137538B50607C6E164E173798CDC4B,39131,0,5,5,109.2066,18.29639,417
173770,01137538B50607C6E164E173798CDC4B,39131,8,11,3,109.2066,18.29639,417
173771,01137538B50607C6E164E173798CDC4B,60571,14,15,1,109.50722,18.25056,1510
173772,01137538B50607C6E164E173798CDC4B,60201,16,17,1,109.5041,18.2509,1510
173773,01137538B50607C6E164E173798CDC4B,31171,18,20,2,109.50938,18.24917,1559
173774,01137538B50607C6E164E173798CDC4B,30151,21,23,2,109.50986,18.25083,1560
173781,4D4289AE0DFBF4B5C79A47559DC2EBDD,30854,2,17,15,109.56889,18.27076,1763
173782,4D4289AE0DFBF4B5C79A47559DC2EBDD,60381,20,22,2,109.5241,18.22458,1605
173794,59F29435D748531F416A4F1636997ECF,60361,0,1,1,109.51938,18.29681,1567
173795,59F29435D748531F416A4F1636997ECF,60631,4,5,1,109.57778,18.27583,1814
173796,59F29435D748531F416A4F1636997ECF,31071,5,9,4,109.58257,18.28458,1815
173812,68DBE0B52FD0AB95F1DD47068FD7847F,60311,0,7,7,109.52097,18.24319,1558
173813,68DBE0B52FD0AB95F1DD47068FD7847F,30181,7,21,14,109.51597,18.23313,1557
173887,905DE0D7E71B1111A514D0B230AE04DE,31251,0,7,7,109.18528,18.2975,317
173889,905DE0D7E71B1111A514D0B230AE04DE,31251,11,16,5,109.18528,18.2975,317
173929,DECB7B3FC95BFA8620EFD8D9DE328252,31381,8,9,1,109.1375,18.36833,129
173930,DECB7B3FC95BFA8620EFD8D9DE328252,30854,12,14,2,109.56889,18.27076,1763
173931,DECB7B3FC95BFA8620EFD8D9DE328252,60411,16,18,2,109.32514,18.30854,869
173932,DECB7B3FC95BFA8620EFD8D9DE328252,30854,19,20,1,109.56889,18.27076,1763
174041,019CCF25DBCE9B21B5D2698F82FCE788,30854,2,7,5,109.56889,18.27076,1763
174042,019CCF25DBCE9B21B5D2698F82FCE788,31851,11,12,1,109.71736,18.29007,2316
174043,019CCF25DBCE9B21B5D2698F82FCE788,31161,13,15,2,109.70229,18.31361,2270
174044,019CCF25DBCE9B21B5D2698F82FCE788,31851,16,17,1,109.71736,18.29007,2316
174045,019CCF25DBCE9B21B5D2698F82FCE788,31041,21,22,1,109.50278,18.23701,1507
174061,4E9C73925B67466BCE6AE7E22B99BF20,31561,2,4,2,109.56792,18.28479,1765
174062,4E9C73925B67466BCE6AE7E22B99BF20,31071,4,7,3,109.58257,18.28458,1815
174063,4E9C73925B67466BCE6AE7E22B99BF20,30854,10,12,2,109.56889,18.27076,1763
174064,4E9C73925B67466BCE6AE7E22B99BF20,39183,14,17,3,109.55542,18.28208,1715
174065,4E9C73925B67466BCE6AE7E22B99BF20,30854,19,20,1,109.56889,18.27076,1763
174066,4E9C73925B67466BCE6AE7E22B99BF20,31071,21,22,1,109.58257,18.28458,1815
174080,FE6376AB53578CB7B343C13E491275A1,60121,15,16,1,109.74507,18.37472,2430
174136,B175A0347ABEEA30E818C5CCD25E280F,30821,5,21,16,109.43681,18.33639,1274
174137,B175A0347ABEEA30E818C5CCD25E280F,60011,22,23,1,109.48965,18.30222,1468
174157,E7EF2FD0C20FE9F43ACE7950E88D1DFE,60561,0,4,4,109.38229,18.29785,1067
174158,E7EF2FD0C20FE9F43ACE7950E88D1DFE,31671,5,18,13,109.38965,18.29813,1068
174159,8B69C410684F618B4BB94E686E30E787,30361,15,17,2,109.50347,18.24,1508
174160,8B69C410684F618B4BB94E686E30E787,31531,18,21,3,109.49583,18.25972,1461
174166,C9A281EF0BD980779EA579DF3160E0C7,60614,0,8,8,109.48799,18.29521,1467
174167,C9A281EF0BD980779EA579DF3160E0C7,31181,12,14,2,109.50382,18.24813,1509
174174,90D91A493F9482486DCC3B27CF3F61EE,31071,0,6,6,109.58257,18.28458,1815
174175,90D91A493F9482486DCC3B27CF3F61EE,30854,11,22,11,109.56889,18.27076,1763
174180,AAB2387B734435D3D9CD946A8ED73005,31351,21,23,2,109.4959,18.28417,1465
174190,9BD095517798346F169AD6D898CA1A42,60361,0,7,7,109.51938,18.29681,1567
174191,9BD095517798346F169AD6D898CA1A42,60221,7,9,2,109.52569,18.29188,1616
174192,9BD095517798346F169AD6D898CA1A42,60274,13,14,1,109.514,18.2933,1567
174193,5403ECE41AD9921A5DEF63FF6DE6A9D1,30854,0,3,3,109.56889,18.27076,1763
174194,5403ECE41AD9921A5DEF63FF6DE6A9D1,31071,4,11,7,109.58257,18.28458,1815
174195,5403ECE41AD9921A5DEF63FF6DE6A9D1,30854,16,20,4,109.56889,18.27076,1763
174214,15195C578D4A8081B069C4B518039EFC,60161,0,7,7,109.49174,18.26181,1461
174215,15195C578D4A8081B069C4B518039EFC,60231,7,8,1,109.49903,18.21972,1504
174216,15195C578D4A8081B069C4B518039EFC,60084,11,15,4,109.4984,18.2334,1507
174217,15195C578D4A8081B069C4B518039EFC,60231,18,22,4,109.49903,18.21972,1504
174218,0B5DA2373AB43B25667FC2040F3AB05D,31321,0,7,7,109.63799,18.23201,2007
174219,0B5DA2373AB43B25667FC2040F3AB05D,31781,11,12,1,109.19847,18.2975,367
174220,0B5DA2373AB43B25667FC2040F3AB05D,30354,17,18,1,109.42813,18.29076,1216
174221,0B5DA2373AB43B25667FC2040F3AB05D,60524,20,23,3,109.42951,18.28993,1216
174242,B02D7A3F297B377D646E0F85B7C19006,61011,1,3,2,109.60653,18.19076,1900
174255,BD5D5103B08534F20AF53FB58E9A43CA,31931,14,16,2,109.54771,18.29403,1667
174256,BD5D5103B08534F20AF53FB58E9A43CA,39101,18,19,1,109.50132,18.24931,1509
174257,BD5D5103B08534F20AF53FB58E9A43CA,39053,19,21,2,109.511,18.2771,1564
174258,246EF4D95FA494895EFB2D649512DAE7,60081,1,7,6,109.51097,18.22639,1556
174260,246EF4D95FA494895EFB2D649512DAE7,31521,19,22,3,109.51458,18.22542,1555
174276,372A5433078073EAD18922D679CE0A73,60054,2,3,1,109.3016,18.31229,770
174277,372A5433078073EAD18922D679CE0A73,30661,4,6,2,109.37028,18.24361,1008
174278,372A5433078073EAD18922D679CE0A73,60054,6,17,11,109.3016,18.31229,770
174279,372A5433078073EAD18922D679CE0A73,31471,19,20,1,109.34583,18.29563,917
174280,372A5433078073EAD18922D679CE0A73,60054,20,23,3,109.3016,18.31229,770
174345,24A5718F38ADE9789750DBD9F143F189,60401,1,5,4,109.47444,18.27583,1414
174346,24A5718F38ADE9789750DBD9F143F189,38951,5,6,1,109.48097,18.28868,1416
174347,24A5718F38ADE9789750DBD9F143F189,60401,7,8,1,109.47444,18.27583,1414
174348,24A5718F38ADE9789750DBD9F143F189,38951,8,10,2,109.48097,18.28868,1416
174349,24A5718F38ADE9789750DBD9F143F189,38951,10,14,4,109.48097,18.28868,1416
174350,24A5718F38ADE9789750DBD9F143F189,30361,18,20,2,109.50347,18.24,1508
174351,24A5718F38ADE9789750DBD9F143F189,38951,20,23,3,109.48097,18.28868,1416
174416,E2EDBB70F04FBEB0911E18FB05861B67,38141,0,8,8,109.39479,18.2916,1116
174417,E2EDBB70F04FBEB0911E18FB05861B67,60231,10,13,3,109.49903,18.21972,1504
174418,E2EDBB70F04FBEB0911E18FB05861B67,30201,18,19,1,109.4909,18.26465,1462
174419,E2EDBB70F04FBEB0911E18FB05861B67,38141,21,23,2,109.39479,18.2916,1116
174438,4A6E6277F47F7550E2618B9C1ADC3166,30361,0,17,17,109.50347,18.24,1508
174439,4A6E6277F47F7550E2618B9C1ADC3166,30161,20,23,3,109.50042,18.24389,1508
174440,BB31DF7CD95EBDC65D12089CF34DDE37,31521,0,9,9,109.51458,18.22542,1555
174441,BB31DF7CD95EBDC65D12089CF34DDE37,60621,13,14,1,109.48354,18.27451,1464
174442,BB31DF7CD95EBDC65D12089CF34DDE37,31521,18,23,5,109.51458,18.22542,1555
174479,D4EE8E1A4C04A1FF0596E4221D0B8B42,31071,0,6,6,109.58257,18.28458,1815
174480,D4EE8E1A4C04A1FF0596E4221D0B8B42,30854,7,21,14,109.56889,18.27076,1763
174540,D2B92BDCA81782196C97ED9FBD07A486,39154,0,6,6,109.50201,18.25681,1511
174541,D2B92BDCA81782196C97ED9FBD07A486,31145,9,12,3,109.20431,18.30479,369
174563,8CF08DEE8EF83AC7333B837D79034776,31531,0,8,8,109.49583,18.25972,1461
174565,8CF08DEE8EF83AC7333B837D79034776,30281,14,16,2,109.50597,18.27583,1514
174566,8CF08DEE8EF83AC7333B837D79034776,31531,18,23,5,109.49583,18.25972,1461
174589,FBDD80570A641C18D89F4987D07601F8,31561,0,3,3,109.56792,18.28479,1765
174590,FBDD80570A641C18D89F4987D07601F8,30854,8,13,5,109.56889,18.27076,1763
174591,FBDD80570A641C18D89F4987D07601F8,31561,15,23,8,109.56792,18.28479,1765
174627,A9F97D2464709590426A157138F3C687,39181,12,13,1,109.55153,18.28035,1715
174628,A9F97D2464709590426A157138F3C687,31931,14,23,9,109.54771,18.29403,1667
174678,283E90F84EEBCE43BF6B6D42BDFBC3E7,31261,0,7,7,109.51174,18.2466,1559
174679,283E90F84EEBCE43BF6B6D42BDFBC3E7,31261,8,13,5,109.51174,18.2466,1559
174680,283E90F84EEBCE43BF6B6D42BDFBC3E7,31521,15,18,3,109.51458,18.22542,1555
174681,283E90F84EEBCE43BF6B6D42BDFBC3E7,31261,18,23,5,109.51174,18.2466,1559
174687,C80B17780A5E1C3296CC2BACA948899A,30854,2,11,9,109.56889,18.27076,1763
174689,C80B17780A5E1C3296CC2BACA948899A,30854,18,23,5,109.56889,18.27076,1763
174703,C17F2EF1DEA79C8C951E3013EE071B2C,31071,0,13,13,109.58257,18.28458,1815
174704,C17F2EF1DEA79C8C951E3013EE071B2C,30854,16,23,7,109.56889,18.27076,1763
174721,B80D6AB96D3D5CEE71A70ED25275F830,60501,0,1,1,109.48701,18.29021,1466
174722,B80D6AB96D3D5CEE71A70ED25275F830,38951,2,10,8,109.48097,18.28868,1416
174725,8C50A9A3D5A31C1286D1433D74FA3A6F,31071,0,1,1,109.58257,18.28458,1815
174726,8C50A9A3D5A31C1286D1433D74FA3A6F,30854,1,8,7,109.56889,18.27076,1763
174727,8C50A9A3D5A31C1286D1433D74FA3A6F,31071,9,10,1,109.58257,18.28458,1815
174728,8C50A9A3D5A31C1286D1433D74FA3A6F,30854,13,15,2,109.56889,18.27076,1763
174738,08D5EFAE8388B70BF24B8C765A0BDF86,31561,0,7,7,109.56792,18.28479,1765
174739,08D5EFAE8388B70BF24B8C765A0BDF86,30854,10,12,2,109.56889,18.27076,1763
174740,08D5EFAE8388B70BF24B8C765A0BDF86,31071,12,13,1,109.58257,18.28458,1815
174744,17D13F6A66037B54FAB5668CDC734401,30721,0,7,7,109.51597,18.28257,1565
174745,17D13F6A66037B54FAB5668CDC734401,31931,7,9,2,109.54771,18.29403,1667
174746,17D13F6A66037B54FAB5668CDC734401,39183,12,14,2,109.55542,18.28208,1715
174747,17D13F6A66037B54FAB5668CDC734401,30721,17,21,4,109.51597,18.28257,1565
174751,6A26FED9158987DCFB21331785DB2E9C,39371,0,2,2,109.56627,18.2646,1762
174752,6A26FED9158987DCFB21331785DB2E9C,30851,2,8,6,109.5616,18.27396,1713
174753,6A26FED9158987DCFB21331785DB2E9C,39371,12,23,11,109.56627,18.2646,1762
174785,06639AF8E634A2EA412E3ADD181BCABE,31071,0,1,1,109.58257,18.28458,1815
174786,06639AF8E634A2EA412E3ADD181BCABE,31561,4,8,4,109.56792,18.28479,1765
174787,06639AF8E634A2EA412E3ADD181BCABE,30854,12,13,1,109.56889,18.27076,1763
174788,06639AF8E634A2EA412E3ADD181BCABE,31561,13,15,2,109.56792,18.28479,1765
174789,06639AF8E634A2EA412E3ADD181BCABE,30854,18,19,1,109.56889,18.27076,1763
174790,06639AF8E634A2EA412E3ADD181BCABE,31071,20,22,2,109.58257,18.28458,1815
174835,36BCA39777B9D1E703C1404CDA6A45E7,30511,0,8,8,109.51069,18.24208,1558
174836,36BCA39777B9D1E703C1404CDA6A45E7,31351,11,14,3,109.4959,18.28417,1465
174837,36BCA39777B9D1E703C1404CDA6A45E7,31864,18,19,1,109.49014,18.28333,1465
174838,36BCA39777B9D1E703C1404CDA6A45E7,30511,22,23,1,109.51069,18.24208,1558
174860,855D815DC19AA779325469411A9E7B8A,30251,0,5,5,109.50611,18.26653,1512
174861,855D815DC19AA779325469411A9E7B8A,38157,6,18,12,109.51483,18.26958,1563
174862,DE841C2C767041F00D7DAF75FFC633F6,30771,2,4,2,109.49938,18.26042,1511
174863,DE841C2C767041F00D7DAF75FFC633F6,30421,5,22,17,109.50021,18.25861,1511
174864,DE841C2C767041F00D7DAF75FFC633F6,31561,22,23,1,109.56792,18.28479,1765
174880,EAED40469566BEC9779C5FE2ED8401DA,31311,15,17,2,109.72299,18.27438,2364
174881,EAED40469566BEC9779C5FE2ED8401DA,30861,21,23,2,109.52722,18.22743,1606
174915,8621CFDF1B89A83351494618C53D033F,31071,0,7,7,109.58257,18.28458,1815
174916,8621CFDF1B89A83351494618C53D033F,39181,8,21,13,109.55153,18.28035,1715
174927,5D7EC4507F4E76B3D5B0735531A150FF,30731,0,8,8,109.50944,18.22306,1555
174928,5D7EC4507F4E76B3D5B0735531A150FF,30771,9,12,3,109.49938,18.26042,1511
174929,5D7EC4507F4E76B3D5B0735531A150FF,31864,16,17,1,109.49014,18.28333,1465
174969,9F3E5E88FFF135A7A6F9D8C4CA8C3CCE,48574,0,8,8,109.48931,18.28458,1465
174970,9F3E5E88FFF135A7A6F9D8C4CA8C3CCE,30071,11,12,1,109.52819,18.30472,1619
174971,9F3E5E88FFF135A7A6F9D8C4CA8C3CCE,31861,13,14,1,109.49042,18.27549,1464
175005,BE7763F8096EB5A037146E1CC4190538,30854,0,5,5,109.56889,18.27076,1763
175006,BE7763F8096EB5A037146E1CC4190538,30324,7,17,10,109.50326,18.29257,1517
175007,BE7763F8096EB5A037146E1CC4190538,30854,20,22,2,109.56889,18.27076,1763
175010,63CB222117AB8A54673799718246EF46,30084,0,8,8,109.50118,18.26972,1513
175011,63CB222117AB8A54673799718246EF46,31031,10,12,2,109.49979,18.25382,1510
175012,63CB222117AB8A54673799718246EF46,60131,12,13,1,109.49819,18.24778,1509
175013,63CB222117AB8A54673799718246EF46,30084,13,15,2,109.50118,18.26972,1513
175014,63CB222117AB8A54673799718246EF46,30291,16,17,1,109.50403,18.27028,1513
175015,63CB222117AB8A54673799718246EF46,30764,19,20,1,109.45806,18.29486,1367
175018,EB291EA7E3235FF23960DA865075F183,38911,0,8,8,109.51674,18.24965,1559
175019,EB291EA7E3235FF23960DA865075F183,39091,9,11,2,109.50097,18.25222,1510
175020,EB291EA7E3235FF23960DA865075F183,31031,12,18,6,109.49979,18.25382,1510
175027,4AA92C2276692190731459431C798101,31945,0,8,8,109.58021,18.29403,1817
175029,4AA92C2276692190731459431C798101,31945,17,23,6,109.58021,18.29403,1817
175030,F4D73E54C3F1B86838B3542D305E78B2,30851,15,17,2,109.5616,18.27396,1713
175031,F4D73E54C3F1B86838B3542D305E78B2,60631,18,23,5,109.57778,18.27583,1814
175069,23DF3A4510347EF32640F77C0A9AA1C8,60281,10,11,1,109.51743,18.25924,1561
175070,23DF3A4510347EF32640F77C0A9AA1C8,39321,12,14,2,109.529,18.2167,1604
175071,23DF3A4510347EF32640F77C0A9AA1C8,60381,15,17,2,109.5241,18.22458,1605
175072,23DF3A4510347EF32640F77C0A9AA1C8,31821,17,21,4,109.51181,18.24924,1559
175073,23DF3A4510347EF32640F77C0A9AA1C8,60281,22,23,1,109.51743,18.25924,1561
175095,E9F64FD67E39C3E2C15C20715338A941,31931,7,9,2,109.54771,18.29403,1667
175096,E9F64FD67E39C3E2C15C20715338A941,30921,9,17,8,109.53903,18.29451,1667
175097,E9F64FD67E39C3E2C15C20715338A941,31931,22,23,1,109.54771,18.29403,1667
175157,EB316856896788EC8FD871E122E95728,30701,0,6,6,109.59313,18.32007,1871
175158,EB316856896788EC8FD871E122E95728,31811,8,9,1,109.54201,18.31806,1671
175159,EB316856896788EC8FD871E122E95728,30931,12,13,1,109.55653,18.32722,1722
175160,EB316856896788EC8FD871E122E95728,30701,15,17,2,109.59313,18.32007,1871
175161,EB316856896788EC8FD871E122E95728,31811,20,21,1,109.54201,18.31806,1671
175162,EB316856896788EC8FD871E122E95728,30701,21,23,2,109.59313,18.32007,1871
175168,13C882817D5EF3329D8612AEE7E0F34D,60371,0,7,7,109.53063,18.30056,1618
175169,13C882817D5EF3329D8612AEE7E0F34D,31145,10,11,1,109.20431,18.30479,369
175195,5F05A258CA919BA01045F79DD70FBCC9,31561,11,13,2,109.56792,18.28479,1765
175196,5F05A258CA919BA01045F79DD70FBCC9,30854,14,16,2,109.56889,18.27076,1763
175197,5F05A258CA919BA01045F79DD70FBCC9,31561,17,21,4,109.56792,18.28479,1765
175198,5F05A258CA919BA01045F79DD70FBCC9,30854,22,23,1,109.56889,18.27076,1763
175236,3C6C31F30579C628F9EDFADEE409AE9F,60241,0,7,7,109.53319,18.28667,1616
175237,3C6C31F30579C628F9EDFADEE409AE9F,30711,8,9,1,109.50271,18.25347,1510
175238,3C6C31F30579C628F9EDFADEE409AE9F,31181,10,14,4,109.50382,18.24813,1509
175239,3C6C31F30579C628F9EDFADEE409AE9F,30661,16,17,1,109.37028,18.24361,1008
175240,3C6C31F30579C628F9EDFADEE409AE9F,60241,21,22,1,109.53319,18.28667,1616
175247,CBA29FB366E4111071C95C99C696D0E6,31561,0,5,5,109.56792,18.28479,1765
175248,CBA29FB366E4111071C95C99C696D0E6,31321,7,17,10,109.63799,18.23201,2007
175249,CBA29FB366E4111071C95C99C696D0E6,30854,18,23,5,109.56889,18.27076,1763
175280,4B004637D3CFBCA65EA00FFD3F1EF7A6,31561,0,2,2,109.56792,18.28479,1765
175281,4B004637D3CFBCA65EA00FFD3F1EF7A6,30854,3,4,1,109.56889,18.27076,1763
175282,4B004637D3CFBCA65EA00FFD3F1EF7A6,39183,8,10,2,109.55542,18.28208,1715
175283,4B004637D3CFBCA65EA00FFD3F1EF7A6,31561,10,13,3,109.56792,18.28479,1765
175284,4B004637D3CFBCA65EA00FFD3F1EF7A6,39183,16,22,6,109.55542,18.28208,1715
175285,FA6D7510012E571D09E23E75BE9DD4E6,60081,17,19,2,109.51097,18.22639,1556
175286,FA6D7510012E571D09E23E75BE9DD4E6,60441,20,21,1,109.46792,18.28604,1366
175304,58DE8A719D3ADBEDAE163213845B460A,31071,0,7,7,109.58257,18.28458,1815
175305,58DE8A719D3ADBEDAE163213845B460A,30854,8,12,4,109.56889,18.27076,1763
175306,58DE8A719D3ADBEDAE163213845B460A,31071,12,13,1,109.58257,18.28458,1815
175307,58DE8A719D3ADBEDAE163213845B460A,30854,15,19,4,109.56889,18.27076,1763
175308,58DE8A719D3ADBEDAE163213845B460A,31071,20,23,3,109.58257,18.28458,1815
175351,706B8E0F0F5D1C9FC2F8EBB2574EE89F,30711,0,1,1,109.50271,18.25347,1510
175352,706B8E0F0F5D1C9FC2F8EBB2574EE89F,38185,1,2,1,109.51333,18.27347,1563
175353,706B8E0F0F5D1C9FC2F8EBB2574EE89F,30711,2,10,8,109.50271,18.25347,1510
175354,706B8E0F0F5D1C9FC2F8EBB2574EE89F,31461,10,20,10,109.5091,18.25389,1510
175355,706B8E0F0F5D1C9FC2F8EBB2574EE89F,30711,21,23,2,109.50271,18.25347,1510
175356,E79FCCBA9F6300DF5C81A804945B477E,31071,0,6,6,109.58257,18.28458,1815
175357,E79FCCBA9F6300DF5C81A804945B477E,30854,8,11,3,109.56889,18.27076,1763
175358,E52B1449B3E12C656C55695335C2EE0A,30071,0,14,14,109.52819,18.30472,1619
175359,E52B1449B3E12C656C55695335C2EE0A,38251,14,15,1,109.49618,18.25493,1510
175360,E52B1449B3E12C656C55695335C2EE0A,60201,16,19,3,109.5041,18.2509,1510
175361,E52B1449B3E12C656C55695335C2EE0A,31411,20,21,1,109.5016,18.23576,1507
175400,019EB913544B8855829875D27D9C85B6,31201,0,9,9,109.51042,18.23819,1558
175401,019EB913544B8855829875D27D9C85B6,30181,11,16,5,109.51597,18.23313,1557
175402,019EB913544B8855829875D27D9C85B6,31201,20,22,2,109.51042,18.23819,1558
175414,C7D2CD8303C3ACD5723978EF4C4C760B,38951,0,7,7,109.48097,18.28868,1416
175415,C7D2CD8303C3ACD5723978EF4C4C760B,31145,9,10,1,109.20431,18.30479,369
175416,C7D2CD8303C3ACD5723978EF4C4C760B,31471,15,16,1,109.34583,18.29563,917
175417,C7D2CD8303C3ACD5723978EF4C4C760B,30821,18,19,1,109.43681,18.33639,1274
175418,C7D2CD8303C3ACD5723978EF4C4C760B,38951,19,23,4,109.48097,18.28868,1416
175437,2BFDDEF2CA95240C316B75CE066959B5,30111,20,21,1,109.47583,18.30542,1419
175443,2FD3D62C2F03A29CB2B8169833F320AE,60054,14,15,1,109.3016,18.31229,770
175444,2FD3D62C2F03A29CB2B8169833F320AE,38111,18,23,5,109.52007,18.22403,1555
175447,5264833F0013AE6B294396000613EF89,60201,0,14,14,109.5041,18.2509,1510
175449,5264833F0013AE6B294396000613EF89,60201,21,23,2,109.5041,18.2509,1510
175456,AE6DC7ACB81DB5F351E45AC25E5F5A3B,38297,5,7,2,109.52576,18.24965,1609
175457,AE6DC7ACB81DB5F351E45AC25E5F5A3B,39091,8,12,4,109.50097,18.25222,1510
175458,AE6DC7ACB81DB5F351E45AC25E5F5A3B,38297,12,19,7,109.52576,18.24965,1609
175459,AE6DC7ACB81DB5F351E45AC25E5F5A3B,39191,21,22,1,109.51493,18.23472,1557
175462,756F7869BDD7D5958992D7847F42858F,60041,1,3,2,109.39889,18.31944,1121
175463,756F7869BDD7D5958992D7847F42858F,30351,6,23,17,109.41701,18.29292,1217
175487,2F440A235E684ECEDD042B3100A4AE95,31071,0,7,7,109.58257,18.28458,1815
175488,2F440A235E684ECEDD042B3100A4AE95,30854,8,18,10,109.56889,18.27076,1763
175535,5EBEA276FCB4A19AC5C987F5C7CC8908,60621,0,6,6,109.48354,18.27451,1464
175536,5EBEA276FCB4A19AC5C987F5C7CC8908,60401,6,9,3,109.47444,18.27583,1414
175537,5EBEA276FCB4A19AC5C987F5C7CC8908,60552,10,12,2,109.41729,18.30014,1218
175538,5EBEA276FCB4A19AC5C987F5C7CC8908,60621,12,16,4,109.48354,18.27451,1464
175539,5EBEA276FCB4A19AC5C987F5C7CC8908,60401,16,18,2,109.47444,18.27583,1414
175540,5EBEA276FCB4A19AC5C987F5C7CC8908,38361,18,19,1,109.43667,18.29201,1267
175541,5EBEA276FCB4A19AC5C987F5C7CC8908,60552,19,21,2,109.41729,18.30014,1218
175542,5EBEA276FCB4A19AC5C987F5C7CC8908,60401,21,22,1,109.47444,18.27583,1414
175543,3B6FF1F8D896A0A62DC7E65967011999,39183,0,4,4,109.55542,18.28208,1715
175544,3B6FF1F8D896A0A62DC7E65967011999,31561,5,7,2,109.56792,18.28479,1765
175545,3B6FF1F8D896A0A62DC7E65967011999,39183,7,20,13,109.55542,18.28208,1715
175588,45086BC0869D90A8E8F669EDA6561CFA,31071,0,14,14,109.58257,18.28458,1815
175589,45086BC0869D90A8E8F669EDA6561CFA,30911,18,20,2,109.50493,18.26181,1511
175590,45086BC0869D90A8E8F669EDA6561CFA,38127,20,21,1,109.50833,18.27222,1513
175591,DB4DF566D4757FF3BB488F82DE126248,31561,14,15,1,109.56792,18.28479,1765
175592,DB4DF566D4757FF3BB488F82DE126248,30851,16,17,1,109.5616,18.27396,1713
175593,DB4DF566D4757FF3BB488F82DE126248,31561,21,22,1,109.56792,18.28479,1765
175611,FBC323A047041F71D8997C22FDE88F17,31321,1,13,12,109.63799,18.23201,2007
175612,FBC323A047041F71D8997C22FDE88F17,30181,13,15,2,109.51597,18.23313,1557
175613,FBC323A047041F71D8997C22FDE88F17,31321,20,22,2,109.63799,18.23201,2007
175616,0312B43ACF9ED1D8304E325E851AEE29,30851,5,6,1,109.5616,18.27396,1713
175617,0312B43ACF9ED1D8304E325E851AEE29,31561,7,17,10,109.56792,18.28479,1765
175648,B55959B64746A18ECF5077B5F7359221,31561,0,16,16,109.56792,18.28479,1765
175649,B55959B64746A18ECF5077B5F7359221,39183,17,18,1,109.55542,18.28208,1715
175664,4BA143AD44480D9BEACA2836C34FF531,60231,3,8,5,109.49903,18.21972,1504
175665,4BA143AD44480D9BEACA2836C34FF531,60084,9,11,2,109.4984,18.2334,1507
175666,4BA143AD44480D9BEACA2836C34FF531,60231,11,13,2,109.49903,18.21972,1504
175667,4BA143AD44480D9BEACA2836C34FF531,60084,15,16,1,109.4984,18.2334,1507
175668,4BA143AD44480D9BEACA2836C34FF531,60231,17,19,2,109.49903,18.21972,1504
175669,4BA143AD44480D9BEACA2836C34FF531,31411,21,22,1,109.5016,18.23576,1507
175678,85CBCBBFD7989A93B3D9A05B97F2C0BC,31521,0,6,6,109.51458,18.22542,1555
175679,85CBCBBFD7989A93B3D9A05B97F2C0BC,31145,8,9,1,109.20431,18.30479,369
175680,85CBCBBFD7989A93B3D9A05B97F2C0BC,31781,9,11,2,109.19847,18.2975,367
175681,85CBCBBFD7989A93B3D9A05B97F2C0BC,31145,11,12,1,109.20431,18.30479,369
175682,85CBCBBFD7989A93B3D9A05B97F2C0BC,60054,14,15,1,109.3016,18.31229,770
175683,85CBCBBFD7989A93B3D9A05B97F2C0BC,31521,19,22,3,109.51458,18.22542,1555
175691,67D30B307FD4639F5D7DA8C23EB3E033,31461,8,9,1,109.5091,18.25389,1510
175692,67D30B307FD4639F5D7DA8C23EB3E033,60641,10,12,2,109.53854,18.2359,1657
175693,67D30B307FD4639F5D7DA8C23EB3E033,30711,12,15,3,109.50271,18.25347,1510
175729,01F0083CC81D0009F9AAB8F7CAA0C106,30854,0,6,6,109.56889,18.27076,1763
175730,01F0083CC81D0009F9AAB8F7CAA0C106,30851,7,9,2,109.5616,18.27396,1713
175731,01F0083CC81D0009F9AAB8F7CAA0C106,30854,11,20,9,109.56889,18.27076,1763
175742,00AEAAE0DD4398BA164B5D4BA6DC0137,31071,0,7,7,109.58257,18.28458,1815
175743,00AEAAE0DD4398BA164B5D4BA6DC0137,30861,11,13,2,109.52722,18.22743,1606
175800,4EEB87EFD2F33BBAF42BE530271C40CA,31161,0,13,13,109.70229,18.31361,2270
175801,4EEB87EFD2F33BBAF42BE530271C40CA,31841,14,17,3,109.73201,18.33382,2373
175802,4EEB87EFD2F33BBAF42BE530271C40CA,39101,18,21,3,109.50132,18.24931,1509
175810,13664B2E5419DDA8E26BAB65AA04153C,39191,0,12,12,109.51493,18.23472,1557
175811,13664B2E5419DDA8E26BAB65AA04153C,30181,12,17,5,109.51597,18.23313,1557
175812,13664B2E5419DDA8E26BAB65AA04153C,31421,19,20,1,109.55382,18.22347,1705
175813,13664B2E5419DDA8E26BAB65AA04153C,39101,22,23,1,109.50132,18.24931,1509
175848,30D9F47EE01436A9014A347A7F5878BC,38141,0,8,8,109.39479,18.2916,1116
175849,30D9F47EE01436A9014A347A7F5878BC,31145,9,11,2,109.20431,18.30479,369
175850,30D9F47EE01436A9014A347A7F5878BC,31781,11,12,1,109.19847,18.2975,367
175851,B7A2800FDF738E1064EAD2A5E58F7A3C,61011,0,1,1,109.60653,18.19076,1900
175853,B7A2800FDF738E1064EAD2A5E58F7A3C,61011,10,19,9,109.60653,18.19076,1900
175869,0B1CC3266C9F341870D0B135F2AF352E,60441,16,17,1,109.46792,18.28604,1366
175870,0B1CC3266C9F341870D0B135F2AF352E,30201,18,19,1,109.4909,18.26465,1462
175871,0B1CC3266C9F341870D0B135F2AF352E,60441,21,22,1,109.46792,18.28604,1366
175886,0C8D15C0488D521680F0DE3A28CFE111,31811,0,7,7,109.54201,18.31806,1671
175887,0C8D15C0488D521680F0DE3A28CFE111,30701,7,21,14,109.59313,18.32007,1871
175900,0410C9BFB4956092D2C91E696A83188B,31945,0,3,3,109.58021,18.29403,1817
175901,0410C9BFB4956092D2C91E696A83188B,30854,7,8,1,109.56889,18.27076,1763
175902,0410C9BFB4956092D2C91E696A83188B,31071,11,12,1,109.58257,18.28458,1815
175903,0410C9BFB4956092D2C91E696A83188B,30854,15,16,1,109.56889,18.27076,1763
175904,0410C9BFB4956092D2C91E696A83188B,31945,19,20,1,109.58021,18.29403,1817
175912,64F4CDF664AA04E7B79DE93C57128CF6,31931,0,7,7,109.54771,18.29403,1667
175913,64F4CDF664AA04E7B79DE93C57128CF6,39181,7,18,11,109.55153,18.28035,1715
175917,45CCFCD3EBDF941E1C92B70ED06E8B5E,31561,2,3,1,109.56792,18.28479,1765
175918,45CCFCD3EBDF941E1C92B70ED06E8B5E,30854,7,17,10,109.56889,18.27076,1763
175919,45CCFCD3EBDF941E1C92B70ED06E8B5E,31421,18,19,1,109.55382,18.22347,1705
175930,E885B3923220582401E6F1A363A3329C,31071,13,14,1,109.58257,18.28458,1815
175931,E885B3923220582401E6F1A363A3329C,30854,15,23,8,109.56889,18.27076,1763
175960,6B806948BC9187A91D033B4096721B00,31561,0,1,1,109.56792,18.28479,1765
175961,6B806948BC9187A91D033B4096721B00,30854,1,7,6,109.56889,18.27076,1763
175962,6B806948BC9187A91D033B4096721B00,31071,9,19,10,109.58257,18.28458,1815
175963,6B806948BC9187A91D033B4096721B00,31561,21,22,1,109.56792,18.28479,1765
175964,6B806948BC9187A91D033B4096721B00,30854,22,23,1,109.56889,18.27076,1763
176015,76A2064D4E26CC1DFB7C0689BEBF7D5B,31061,0,7,7,109.53333,18.23257,1607
176027,895CD60412795FD53135C10CDBA0A9C7,38154,1,7,6,109.5266,18.28278,1615
176028,895CD60412795FD53135C10CDBA0A9C7,30281,12,13,1,109.50597,18.27583,1514
176029,895CD60412795FD53135C10CDBA0A9C7,31471,15,17,2,109.34583,18.29563,917
176030,895CD60412795FD53135C10CDBA0A9C7,38127,18,23,5,109.50833,18.27222,1513
176062,7D30E1AF6572DC63597A758CCA3A5243,31251,1,7,6,109.18528,18.2975,317
176063,7D30E1AF6572DC63597A758CCA3A5243,31145,7,8,1,109.20431,18.30479,369
176064,7D30E1AF6572DC63597A758CCA3A5243,31781,10,12,2,109.19847,18.2975,367
176065,7D30E1AF6572DC63597A758CCA3A5243,31145,13,15,2,109.20431,18.30479,369
176096,996308BA516E2A4FD895EB11278D247D,30711,0,4,4,109.50271,18.25347,1510
176097,996308BA516E2A4FD895EB11278D247D,30201,4,9,5,109.4909,18.26465,1462
176098,996308BA516E2A4FD895EB11278D247D,30711,9,13,4,109.50271,18.25347,1510
176099,996308BA516E2A4FD895EB11278D247D,30081,16,19,3,109.50243,18.26632,1512
176100,996308BA516E2A4FD895EB11278D247D,30201,19,22,3,109.4909,18.26465,1462
176145,5AE5291D69C9CAB9DE596EEA8E795748,31521,0,1,1,109.51458,18.22542,1555
176146,5AE5291D69C9CAB9DE596EEA8E795748,31521,5,10,5,109.51458,18.22542,1555
176147,5AE5291D69C9CAB9DE596EEA8E795748,60221,14,18,4,109.52569,18.29188,1616
176160,76B21384CC3EFE3F43353B93FDFE32EE,30821,2,6,4,109.43681,18.33639,1274
176161,76B21384CC3EFE3F43353B93FDFE32EE,30651,7,8,1,109.42611,18.385,1232
176162,76B21384CC3EFE3F43353B93FDFE32EE,30821,8,14,6,109.43681,18.33639,1274
176163,76B21384CC3EFE3F43353B93FDFE32EE,30651,14,17,3,109.42611,18.385,1232
176164,76B21384CC3EFE3F43353B93FDFE32EE,30821,17,19,2,109.43681,18.33639,1274
176196,EF0AF6DFF11E792E87881ED5E6F91398,30721,0,6,6,109.51597,18.28257,1565
176197,EF0AF6DFF11E792E87881ED5E6F91398,39183,7,17,10,109.55542,18.28208,1715
176198,EF0AF6DFF11E792E87881ED5E6F91398,38154,20,21,1,109.5266,18.28278,1615
176205,C93386A9D86FE22A1FD4E5116045DD8D,31561,1,7,6,109.56792,18.28479,1765
176206,C93386A9D86FE22A1FD4E5116045DD8D,39183,9,16,7,109.55542,18.28208,1715
176207,C93386A9D86FE22A1FD4E5116045DD8D,30854,20,22,2,109.56889,18.27076,1763
176238,2B8C748A18FA7D08D4335AD7C9DEF01B,31551,11,14,3,109.55868,18.24222,1708
176239,2B8C748A18FA7D08D4335AD7C9DEF01B,31761,18,23,5,109.60521,18.27965,1914
176254,7BD1580BA480E545686438B39D58DB57,31124,14,15,1,109.17069,18.35,276
176255,7BD1580BA480E545686438B39D58DB57,38157,17,19,2,109.51483,18.26958,1563
176289,01C3A40E8C2D18FB80BE4CD2C78B4B61,30711,0,12,12,109.50271,18.25347,1510
176290,01C3A40E8C2D18FB80BE4CD2C78B4B61,60201,13,14,1,109.5041,18.2509,1510
176291,01C3A40E8C2D18FB80BE4CD2C78B4B61,39091,14,17,3,109.50097,18.25222,1510
176292,01C3A40E8C2D18FB80BE4CD2C78B4B61,30051,18,20,2,109.48917,18.21215,1453
176299,EFDE35289FEC1E13D6F34EFEE66A8AD2,30854,15,16,1,109.56889,18.27076,1763
176300,EFDE35289FEC1E13D6F34EFEE66A8AD2,60631,18,23,5,109.57778,18.27583,1814
176311,5581E816D65ABEC11ABF61B39B1CF7D8,31781,12,14,2,109.19847,18.2975,367
176312,5581E816D65ABEC11ABF61B39B1CF7D8,60571,16,18,2,109.50722,18.25056,1510
176313,5581E816D65ABEC11ABF61B39B1CF7D8,31031,18,20,2,109.49979,18.25382,1510
176316,DA10676C4DA702E02A2C3FFFAC40ABA2,31561,0,2,2,109.56792,18.28479,1765
176317,DA10676C4DA702E02A2C3FFFAC40ABA2,39183,2,4,2,109.55542,18.28208,1715
176318,DA10676C4DA702E02A2C3FFFAC40ABA2,31561,4,11,7,109.56792,18.28479,1765
176319,DA10676C4DA702E02A2C3FFFAC40ABA2,39183,12,13,1,109.55542,18.28208,1715
176320,DA10676C4DA702E02A2C3FFFAC40ABA2,31561,14,19,5,109.56792,18.28479,1765
176321,DA10676C4DA702E02A2C3FFFAC40ABA2,39183,20,22,2,109.55542,18.28208,1715
176326,3977578BE56276DA0700B04B81DC1356,31561,0,1,1,109.56792,18.28479,1765
176327,3977578BE56276DA0700B04B81DC1356,30851,2,6,4,109.5616,18.27396,1713
176328,3977578BE56276DA0700B04B81DC1356,31561,7,17,10,109.56792,18.28479,1765
176329,3977578BE56276DA0700B04B81DC1356,30851,19,21,2,109.5616,18.27396,1713
176372,AF8242E3517F84A72E26C512CF4FFF97,31471,14,16,2,109.34583,18.29563,917
176373,AF8242E3517F84A72E26C512CF4FFF97,30821,17,18,1,109.43681,18.33639,1274
176374,AF8242E3517F84A72E26C512CF4FFF97,38951,19,21,2,109.48097,18.28868,1416
176375,AF8242E3517F84A72E26C512CF4FFF97,38951,21,23,2,109.48097,18.28868,1416
176424,0133DDFFB5CECBB261CEDEF10A82D50B,31561,5,6,1,109.56792,18.28479,1765
176425,0133DDFFB5CECBB261CEDEF10A82D50B,30854,6,8,2,109.56889,18.27076,1763
176426,0133DDFFB5CECBB261CEDEF10A82D50B,31561,9,11,2,109.56792,18.28479,1765
176427,0133DDFFB5CECBB261CEDEF10A82D50B,31071,13,14,1,109.58257,18.28458,1815
176428,0133DDFFB5CECBB261CEDEF10A82D50B,31561,15,16,1,109.56792,18.28479,1765
176464,0E129C09250C0D46273B4BD7E5225556,30151,0,6,6,109.50986,18.25083,1560
176465,0E129C09250C0D46273B4BD7E5225556,60201,6,9,3,109.5041,18.2509,1510
176466,0E129C09250C0D46273B4BD7E5225556,60441,12,16,4,109.46792,18.28604,1366
176467,0E129C09250C0D46273B4BD7E5225556,30151,19,21,2,109.50986,18.25083,1560
176468,0E129C09250C0D46273B4BD7E5225556,30151,22,23,1,109.50986,18.25083,1560
176498,42815E00E74F2DEE06DE8ADA6B858662,31561,0,14,14,109.56792,18.28479,1765
176499,42815E00E74F2DEE06DE8ADA6B858662,30854,18,20,2,109.56889,18.27076,1763
176500,42815E00E74F2DEE06DE8ADA6B858662,31071,21,22,1,109.58257,18.28458,1815
176524,56C8C781972E8BFAF8A768A19AD7F590,30281,0,7,7,109.50597,18.27583,1514
176527,56C8C781972E8BFAF8A768A19AD7F590,30281,19,20,1,109.50597,18.27583,1514
176528,56C8C781972E8BFAF8A768A19AD7F590,38127,21,23,2,109.50833,18.27222,1513
176534,7D3715670DBD868CBE84944A90E4C6E8,38027,0,2,2,109.38833,18.2909,1066
176535,7D3715670DBD868CBE84944A90E4C6E8,60561,3,4,1,109.38229,18.29785,1067
176536,7D3715670DBD868CBE84944A90E4C6E8,38027,4,5,1,109.38833,18.2909,1066
176537,7D3715670DBD868CBE84944A90E4C6E8,60561,7,9,2,109.38229,18.29785,1067
176538,7D3715670DBD868CBE84944A90E4C6E8,38027,10,23,13,109.38833,18.2909,1066
176552,C709D01469E0800AF998DFAF42105CDC,30854,0,2,2,109.56889,18.27076,1763
176553,C709D01469E0800AF998DFAF42105CDC,31561,6,19,13,109.56792,18.28479,1765
176570,451E2BF48CD7B253EB0892324E679BCC,38297,0,1,1,109.52576,18.24965,1609
176571,451E2BF48CD7B253EB0892324E679BCC,38291,1,3,2,109.51618,18.24313,1558
176572,451E2BF48CD7B253EB0892324E679BCC,38297,3,4,1,109.52576,18.24965,1609
176573,451E2BF48CD7B253EB0892324E679BCC,60281,6,10,4,109.51743,18.25924,1561
176574,451E2BF48CD7B253EB0892324E679BCC,38297,10,14,4,109.52576,18.24965,1609
176575,451E2BF48CD7B253EB0892324E679BCC,60281,14,17,3,109.51743,18.25924,1561
176576,451E2BF48CD7B253EB0892324E679BCC,38291,18,23,5,109.51618,18.24313,1558
176593,8A0382A2385C362EFE2664E8795F133E,31561,0,8,8,109.56792,18.28479,1765
176594,8A0382A2385C362EFE2664E8795F133E,39183,8,18,10,109.55542,18.28208,1715
176616,5ABFF3E8EB470884C270C0C936A89A00,38754,17,21,4,109.74667,18.37382,2430
176620,8883DF5E66B5FC284A8EF97DE8EAAAB3,31571,9,10,1,109.61563,18.23326,1957
176621,8883DF5E66B5FC284A8EF97DE8EAAAB3,60214,13,14,1,109.63104,18.24493,2009
176624,8345A9276E866C21971E3C408D4E0341,30854,4,9,5,109.56889,18.27076,1763
176625,8345A9276E866C21971E3C408D4E0341,31071,10,11,1,109.58257,18.28458,1815
176626,8345A9276E866C21971E3C408D4E0341,30854,12,23,11,109.56889,18.27076,1763
176648,0E5593A90D661690BE3DAAA17AD936E2,30281,18,19,1,109.50597,18.27583,1514
176649,0E5593A90D661690BE3DAAA17AD936E2,30084,19,22,3,109.50118,18.26972,1513
176682,529A14F498129B0238F7B12A9FC7F6F7,31205,0,2,2,109.51111,18.23736,1557
176683,529A14F498129B0238F7B12A9FC7F6F7,31671,2,14,12,109.38965,18.29813,1068
176684,529A14F498129B0238F7B12A9FC7F6F7,38361,14,15,1,109.43667,18.29201,1267
176685,529A14F498129B0238F7B12A9FC7F6F7,31091,17,18,1,109.41201,18.31222,1170
176686,529A14F498129B0238F7B12A9FC7F6F7,31231,19,20,1,109.42597,18.29292,1217
176739,F6A1EBB84FE583E84185C423218578F5,31561,0,6,6,109.56792,18.28479,1765
176740,F6A1EBB84FE583E84185C423218578F5,39183,8,9,1,109.55542,18.28208,1715
176741,F6A1EBB84FE583E84185C423218578F5,30854,9,10,1,109.56889,18.27076,1763
176788,28549A30BFBE28E97BEE5CE42AFF819B,30281,0,19,19,109.50597,18.27583,1514
176789,28549A30BFBE28E97BEE5CE42AFF819B,38891,19,20,1,109.51486,18.24118,1558
176800,12E2C9356A230BE21C77839B0896D677,30854,15,16,1,109.56889,18.27076,1763
176801,12E2C9356A230BE21C77839B0896D677,31561,20,23,3,109.56792,18.28479,1765
176814,0E1B3CFC64EBB658DA96D0DCA834701E,61011,0,2,2,109.60653,18.19076,1900
176816,0E1B3CFC64EBB658DA96D0DCA834701E,61011,4,5,1,109.60653,18.19076,1900
176843,D42D82F7F77C55013F0EAB7E35E2211F,31071,3,11,8,109.58257,18.28458,1815
176844,D42D82F7F77C55013F0EAB7E35E2211F,30531,14,22,8,109.53271,18.21472,1604
176845,0C2EC2AEEF4BBDE5715612F8F83C00CC,60274,13,14,1,109.514,18.2933,1567
176852,8C7667B6277A3C193B50CC18C706780E,31421,3,9,6,109.55382,18.22347,1705
176853,8C7667B6277A3C193B50CC18C706780E,30951,9,10,1,109.56208,18.25667,1761
176854,8C7667B6277A3C193B50CC18C706780E,39371,12,15,3,109.56627,18.2646,1762
176877,D39D64452E6BBEF7B3056CA239E1B86E,30854,0,7,7,109.56889,18.27076,1763
176878,D39D64452E6BBEF7B3056CA239E1B86E,31561,7,10,3,109.56792,18.28479,1765
176879,D39D64452E6BBEF7B3056CA239E1B86E,30854,12,13,1,109.56889,18.27076,1763
176880,D39D64452E6BBEF7B3056CA239E1B86E,31561,14,15,1,109.56792,18.28479,1765
176881,D39D64452E6BBEF7B3056CA239E1B86E,30854,18,23,5,109.56889,18.27076,1763
176891,40C57F24FE0409ABB752B2031C349577,38951,0,13,13,109.48097,18.28868,1416
176892,40C57F24FE0409ABB752B2031C349577,38951,13,15,2,109.48097,18.28868,1416
176893,40C57F24FE0409ABB752B2031C349577,30711,15,20,5,109.50271,18.25347,1510
176894,40C57F24FE0409ABB752B2031C349577,38951,22,23,1,109.48097,18.28868,1416
176913,ADDDEBD546B43FF699A163EB1EA5FE50,30151,12,14,2,109.50986,18.25083,1560
176914,ADDDEBD546B43FF699A163EB1EA5FE50,38251,18,20,2,109.49618,18.25493,1510
176915,ADDDEBD546B43FF699A163EB1EA5FE50,30201,21,23,2,109.4909,18.26465,1462
176933,50C497E938D256053EDA53A1DE0E2147,31304,0,12,12,109.15903,18.32854,223
176934,50C497E938D256053EDA53A1DE0E2147,38205,14,15,1,109.62743,18.23139,1956
176935,50C497E938D256053EDA53A1DE0E2147,31304,17,19,2,109.15903,18.32854,223
176936,50C497E938D256053EDA53A1DE0E2147,31124,21,22,1,109.17069,18.35,276
176951,E1B4EE5B2DAE31219B37A92CAB40AC2A,60161,17,18,1,109.49174,18.26181,1461
176952,E1B4EE5B2DAE31219B37A92CAB40AC2A,31531,20,21,1,109.49583,18.25972,1461
176976,1A1B5C664F8D6460240C73AB76187420,30854,0,9,9,109.56889,18.27076,1763
176977,1A1B5C664F8D6460240C73AB76187420,31071,9,10,1,109.58257,18.28458,1815
176978,1A1B5C664F8D6460240C73AB76187420,30854,13,20,7,109.56889,18.27076,1763
176982,82591CF1D9AFC5ADCA95A1BAF87D07E3,60361,0,3,3,109.51938,18.29681,1567
177008,7E7742F5B0156B5C74FAAA9FE22D94C7,31071,2,5,3,109.58257,18.28458,1815
177009,7E7742F5B0156B5C74FAAA9FE22D94C7,30854,8,10,2,109.56889,18.27076,1763
177010,7E7742F5B0156B5C74FAAA9FE22D94C7,31071,10,13,3,109.58257,18.28458,1815
177011,7E7742F5B0156B5C74FAAA9FE22D94C7,30854,16,18,2,109.56889,18.27076,1763
177012,7E7742F5B0156B5C74FAAA9FE22D94C7,31071,19,23,4,109.58257,18.28458,1815
177025,CD576F1C1CDFB89E6A99A20E65927346,31561,4,5,1,109.56792,18.28479,1765
177026,CD576F1C1CDFB89E6A99A20E65927346,30854,5,22,17,109.56889,18.27076,1763
177034,FB0C3DBC0AB121F552294646CC7B81E6,60087,0,15,15,109.50688,18.22299,1505
177035,FB0C3DBC0AB121F552294646CC7B81E6,60121,16,23,7,109.74507,18.37472,2430
177055,B0D7DAF8D84656FF4C7229ABB8EA1350,31561,1,7,6,109.56792,18.28479,1765
177056,B0D7DAF8D84656FF4C7229ABB8EA1350,30854,11,15,4,109.56889,18.27076,1763
177057,B0D7DAF8D84656FF4C7229ABB8EA1350,31561,17,19,2,109.56792,18.28479,1765
177061,B712327B6033C61F37801CFD6DAC08AD,38484,0,3,3,109.53028,18.31528,1620
177062,B712327B6033C61F37801CFD6DAC08AD,31951,4,5,1,109.52174,18.30299,1568
177063,B712327B6033C61F37801CFD6DAC08AD,38484,6,11,5,109.53028,18.31528,1620
177064,B712327B6033C61F37801CFD6DAC08AD,30561,11,12,1,109.52778,18.31938,1621
177065,B712327B6033C61F37801CFD6DAC08AD,38484,13,18,5,109.53028,18.31528,1620
177066,B712327B6033C61F37801CFD6DAC08AD,38484,22,23,1,109.53028,18.31528,1620
177094,63FBAC0202144B00077561285E6A7F87,30821,5,10,5,109.43681,18.33639,1274
177095,63FBAC0202144B00077561285E6A7F87,30651,14,16,2,109.42611,18.385,1232
177096,63FBAC0202144B00077561285E6A7F87,30821,17,23,6,109.43681,18.33639,1274
177105,5C18A2E44B35E6C3C2823CC3AAFB80BA,60201,0,10,10,109.5041,18.2509,1510
177106,5C18A2E44B35E6C3C2823CC3AAFB80BA,31931,13,14,1,109.54771,18.29403,1667
177107,5C18A2E44B35E6C3C2823CC3AAFB80BA,31821,14,16,2,109.51181,18.24924,1559
177108,5C18A2E44B35E6C3C2823CC3AAFB80BA,30711,16,19,3,109.50271,18.25347,1510
177109,5C18A2E44B35E6C3C2823CC3AAFB80BA,60201,20,21,1,109.5041,18.2509,1510
177110,5C18A2E44B35E6C3C2823CC3AAFB80BA,60201,22,23,1,109.5041,18.2509,1510
177111,DF296B63A64E364FCDA4C38B0935EEEE,30511,0,21,21,109.51069,18.24208,1558
177112,DF296B63A64E364FCDA4C38B0935EEEE,30151,21,23,2,109.50986,18.25083,1560
177188,89362A3CA3AE6F5B75871F2110924F99,30851,0,7,7,109.5616,18.27396,1713
177189,89362A3CA3AE6F5B75871F2110924F99,30951,7,9,2,109.56208,18.25667,1761
177190,89362A3CA3AE6F5B75871F2110924F99,39371,9,22,13,109.56627,18.2646,1762
177206,7D632B68A96EBB9D6582527232D6634C,30151,12,18,6,109.50986,18.25083,1560
177207,7D632B68A96EBB9D6582527232D6634C,39154,19,22,3,109.50201,18.25681,1511
177232,43FEE4745615D8F20734EFB07A58D0A4,31421,1,2,1,109.55382,18.22347,1705
177233,43FEE4745615D8F20734EFB07A58D0A4,31521,2,13,11,109.51458,18.22542,1555
177234,43FEE4745615D8F20734EFB07A58D0A4,38251,14,22,8,109.49618,18.25493,1510
177239,8DA7661E8E46B66EF011FB9B9FA15609,38061,0,6,6,109.50597,18.23118,1506
177240,8DA7661E8E46B66EF011FB9B9FA15609,30731,7,10,3,109.50944,18.22306,1555
177241,8DA7661E8E46B66EF011FB9B9FA15609,30181,12,13,1,109.51597,18.23313,1557
177260,ED7E4BD9A3B03A25328617DB4B500130,30111,0,8,8,109.47583,18.30542,1419
177261,ED7E4BD9A3B03A25328617DB4B500130,60171,11,12,1,109.51292,18.30694,1569
177262,ED7E4BD9A3B03A25328617DB4B500130,30111,13,15,2,109.47583,18.30542,1419
177263,ED7E4BD9A3B03A25328617DB4B500130,31071,18,21,3,109.58257,18.28458,1815
177276,7FF3C6569A3990C03CAF6C52D3C8BC6C,60241,3,5,2,109.53319,18.28667,1616
177277,7FF3C6569A3990C03CAF6C52D3C8BC6C,31931,6,16,10,109.54771,18.29403,1667
177278,7FF3C6569A3990C03CAF6C52D3C8BC6C,60241,21,23,2,109.53319,18.28667,1616
177311,AA2A5396AD753E9245AC53C94BAEDECD,61011,3,5,2,109.60653,18.19076,1900
177313,AA2A5396AD753E9245AC53C94BAEDECD,61011,8,13,5,109.60653,18.19076,1900
177315,AA2A5396AD753E9245AC53C94BAEDECD,61011,21,22,1,109.60653,18.19076,1900
177323,F47C4E1E39056C43B0AD32AC994AB7C0,31931,2,15,13,109.54771,18.29403,1667
177324,F47C4E1E39056C43B0AD32AC994AB7C0,60361,15,18,3,109.51938,18.29681,1567
177325,F47C4E1E39056C43B0AD32AC994AB7C0,31931,18,23,5,109.54771,18.29403,1667
177330,96F82DE3A1872ACA5447FE8341C04D65,39091,16,17,1,109.50097,18.25222,1510
177331,96F82DE3A1872ACA5447FE8341C04D65,31041,18,19,1,109.50278,18.23701,1507
177332,96F82DE3A1872ACA5447FE8341C04D65,60471,21,23,2,109.44653,18.30646,1319
177348,48C2384D12D5B16772007E35CE360CBB,30721,0,8,8,109.51597,18.28257,1565
177349,48C2384D12D5B16772007E35CE360CBB,38105,9,17,8,109.40299,18.29229,1117
177350,48C2384D12D5B16772007E35CE360CBB,39041,18,22,4,109.40021,18.29278,1117
177461,A928E9F6C796FE1A60807BA003DE87BB,39181,8,10,2,109.55153,18.28035,1715
177462,A928E9F6C796FE1A60807BA003DE87BB,30854,11,12,1,109.56889,18.27076,1763
177463,A928E9F6C796FE1A60807BA003DE87BB,39181,13,16,3,109.55153,18.28035,1715
177464,A928E9F6C796FE1A60807BA003DE87BB,30854,16,21,5,109.56889,18.27076,1763
177474,975CB35586D2D95A387E2AA86A5AB719,31351,0,8,8,109.4959,18.28417,1465
177475,975CB35586D2D95A387E2AA86A5AB719,30671,9,23,14,109.43611,18.30139,1268
177485,491A112CD81B9085F752897809919691,31201,8,9,1,109.51042,18.23819,1558
177486,491A112CD81B9085F752897809919691,38251,12,14,2,109.49618,18.25493,1510
177508,D8B19999D42CFF7EB03B9BAFA13044AB,60011,0,6,6,109.48965,18.30222,1468
177509,D8B19999D42CFF7EB03B9BAFA13044AB,30111,6,17,11,109.47583,18.30542,1419
177510,D8B19999D42CFF7EB03B9BAFA13044AB,31031,19,21,2,109.49979,18.25382,1510
177524,97C31877CA4226D0F1BA1C0E12066B56,60331,0,6,6,109.505,18.26507,1512
177525,97C31877CA4226D0F1BA1C0E12066B56,30854,7,9,2,109.56889,18.27076,1763
177526,97C31877CA4226D0F1BA1C0E12066B56,31071,10,11,1,109.58257,18.28458,1815
177527,97C31877CA4226D0F1BA1C0E12066B56,30854,14,17,3,109.56889,18.27076,1763
177528,97C31877CA4226D0F1BA1C0E12066B56,60331,18,20,2,109.505,18.26507,1512
177534,A549C024E6F63EDBD3DC866F10DB11CE,31071,2,6,4,109.58257,18.28458,1815
177535,A549C024E6F63EDBD3DC866F10DB11CE,30854,6,14,8,109.56889,18.27076,1763
177536,A549C024E6F63EDBD3DC866F10DB11CE,31071,18,19,1,109.58257,18.28458,1815
177537,A549C024E6F63EDBD3DC866F10DB11CE,30854,20,23,3,109.56889,18.27076,1763
177560,E1108DE9382EA6DD2052A0875C7E83C6,31161,0,12,12,109.70229,18.31361,2270
177561,E1108DE9382EA6DD2052A0875C7E83C6,60111,14,15,1,109.72556,18.31924,2371
177562,E1108DE9382EA6DD2052A0875C7E83C6,31161,18,21,3,109.70229,18.31361,2270
177573,21FBB6F0F825A6B1E89545963BB6C9D3,30854,1,3,2,109.56889,18.27076,1763
177574,21FBB6F0F825A6B1E89545963BB6C9D3,60631,3,4,1,109.57778,18.27583,1814
177575,21FBB6F0F825A6B1E89545963BB6C9D3,30854,5,6,1,109.56889,18.27076,1763
177576,21FBB6F0F825A6B1E89545963BB6C9D3,60631,7,8,1,109.57778,18.27583,1814
177590,E4B522EF4348156010E5C578EC13D60F,30854,5,6,1,109.56889,18.27076,1763
177591,E4B522EF4348156010E5C578EC13D60F,31071,6,7,1,109.58257,18.28458,1815
177592,E4B522EF4348156010E5C578EC13D60F,30854,8,14,6,109.56889,18.27076,1763
177593,E4B522EF4348156010E5C578EC13D60F,30291,18,20,2,109.50403,18.27028,1513
177606,9AF351B3CC27394DFED45513F0E32162,60351,0,1,1,109.58403,18.28958,1816
177607,9AF351B3CC27394DFED45513F0E32162,31071,1,3,2,109.58257,18.28458,1815
177608,9AF351B3CC27394DFED45513F0E32162,60351,5,7,2,109.58403,18.28958,1816
177609,9AF351B3CC27394DFED45513F0E32162,30851,10,11,1,109.5616,18.27396,1713
177610,9AF351B3CC27394DFED45513F0E32162,30951,11,13,2,109.56208,18.25667,1761
177611,9AF351B3CC27394DFED45513F0E32162,30851,13,16,3,109.5616,18.27396,1713
177612,560794A44CA17A43FA34D0FA6C339747,31071,4,6,2,109.58257,18.28458,1815
177613,560794A44CA17A43FA34D0FA6C339747,30854,8,18,10,109.56889,18.27076,1763
177614,560794A44CA17A43FA34D0FA6C339747,31071,19,20,1,109.58257,18.28458,1815
177629,DCD137352B900F9F43521E37884B7F13,60054,0,15,15,109.3016,18.31229,770
177630,DCD137352B900F9F43521E37884B7F13,30661,18,23,5,109.37028,18.24361,1008
177638,DA759AC2EBBA8078FBC390D09D5C4EC7,30854,12,20,8,109.56889,18.27076,1763
177639,DA759AC2EBBA8078FBC390D09D5C4EC7,31071,22,23,1,109.58257,18.28458,1815
177640,608A55C14BAB2A5B627ACC1F39B89FB6,31945,0,13,13,109.58021,18.29403,1817
177641,608A55C14BAB2A5B627ACC1F39B89FB6,30854,13,17,4,109.56889,18.27076,1763
177642,608A55C14BAB2A5B627ACC1F39B89FB6,31071,19,20,1,109.58257,18.28458,1815
177643,608A55C14BAB2A5B627ACC1F39B89FB6,31945,22,23,1,109.58021,18.29403,1817
177659,5F6720997470E5A2E722B130218E5FC9,60594,13,22,9,109.62694,18.22799,1956
177698,410DD8A32244BC0C8E0A44B87218A19E,30854,4,18,14,109.56889,18.27076,1763
177699,410DD8A32244BC0C8E0A44B87218A19E,31461,21,22,1,109.5091,18.25389,1510
177715,CFAA4900917F16A6BB33BA227F202636,30221,16,17,1,109.57833,18.20222,1802
177716,CFAA4900917F16A6BB33BA227F202636,38241,19,20,1,109.54111,18.30542,1669
177741,10EBF762D28520B09848288F7052CFDE,30854,2,7,5,109.56889,18.27076,1763
177742,10EBF762D28520B09848288F7052CFDE,31561,7,19,12,109.56792,18.28479,1765
177743,10EBF762D28520B09848288F7052CFDE,30854,19,23,4,109.56889,18.27076,1763
177768,029EE78335AC14EA912876F28FB86277,30681,0,10,10,109.48493,18.26917,1463
177769,029EE78335AC14EA912876F28FB86277,60381,12,14,2,109.5241,18.22458,1605
177770,029EE78335AC14EA912876F28FB86277,31031,14,15,1,109.49979,18.25382,1510
177771,029EE78335AC14EA912876F28FB86277,30681,16,21,5,109.48493,18.26917,1463
177772,E0686F37399D74676DEB0528C7B9FCF9,30511,0,9,9,109.51069,18.24208,1558
177773,E0686F37399D74676DEB0528C7B9FCF9,60381,9,11,2,109.5241,18.22458,1605
177782,963B5F4C98446446023B8ED177B869B3,39183,14,16,2,109.55542,18.28208,1715
177783,963B5F4C98446446023B8ED177B869B3,60361,18,22,4,109.51938,18.29681,1567
177799,C61360C6C8202A54143E165C2C08120B,30951,0,1,1,109.56208,18.25667,1761
177800,C61360C6C8202A54143E165C2C08120B,30854,1,3,2,109.56889,18.27076,1763
177801,C61360C6C8202A54143E165C2C08120B,30951,5,8,3,109.56208,18.25667,1761
177802,C61360C6C8202A54143E165C2C08120B,39371,10,20,10,109.56627,18.2646,1762
177815,BE84D9BAD945F657EF3BFD7A07C2842B,38105,1,9,8,109.40299,18.29229,1117
177816,BE84D9BAD945F657EF3BFD7A07C2842B,60541,13,19,6,109.4084,18.29208,1167
177817,BE84D9BAD945F657EF3BFD7A07C2842B,60041,21,23,2,109.39889,18.31944,1121
177823,AAB3DCB18BAF89954DC0C8A658A6D766,31951,0,2,2,109.52174,18.30299,1568
177824,AAB3DCB18BAF89954DC0C8A658A6D766,30071,2,5,3,109.52819,18.30472,1619
177825,AAB3DCB18BAF89954DC0C8A658A6D766,30071,7,9,2,109.52819,18.30472,1619
177826,AAB3DCB18BAF89954DC0C8A658A6D766,38881,14,17,3,109.51618,18.26431,1562
177827,AAB3DCB18BAF89954DC0C8A658A6D766,31951,19,22,3,109.52174,18.30299,1568
177836,19A7A932E03C63EDA78541C31E010D15,30201,14,15,1,109.4909,18.26465,1462
177837,19A7A932E03C63EDA78541C31E010D15,60541,18,22,4,109.4084,18.29208,1167
177899,DF5348A8E25901EBB63BBF3F6126BB02,31071,0,6,6,109.58257,18.28458,1815
177900,DF5348A8E25901EBB63BBF3F6126BB02,30854,6,7,1,109.56889,18.27076,1763
177901,DF5348A8E25901EBB63BBF3F6126BB02,31071,9,11,2,109.58257,18.28458,1815
177902,DF5348A8E25901EBB63BBF3F6126BB02,60361,13,17,4,109.51938,18.29681,1567
177903,DF5348A8E25901EBB63BBF3F6126BB02,31071,19,20,1,109.58257,18.28458,1815
177904,DF5348A8E25901EBB63BBF3F6126BB02,30854,20,22,2,109.56889,18.27076,1763
177916,6DF7485545B790F22810B0EDD8F1B356,30234,1,7,6,109.60681,18.29979,1918
177917,6DF7485545B790F22810B0EDD8F1B356,30854,7,10,3,109.56889,18.27076,1763
177918,6DF7485545B790F22810B0EDD8F1B356,31071,14,16,2,109.58257,18.28458,1815
177919,6DF7485545B790F22810B0EDD8F1B356,30854,20,21,1,109.56889,18.27076,1763
177979,3F91EE227475391A33DA85DF3C955C00,60054,13,14,1,109.3016,18.31229,770
177980,3F91EE227475391A33DA85DF3C955C00,60401,17,18,1,109.47444,18.27583,1414
177985,15A2A8790389D1537721C21B141A7A31,61011,2,5,3,109.60653,18.19076,1900
177987,15A2A8790389D1537721C21B141A7A31,61011,13,15,2,109.60653,18.19076,1900
177989,15A2A8790389D1537721C21B141A7A31,61011,17,18,1,109.60653,18.19076,1900
178019,9700F013445EE92B5BC547553474ABFD,38105,0,10,10,109.40299,18.29229,1117
178020,9700F013445EE92B5BC547553474ABFD,31031,13,15,2,109.49979,18.25382,1510
178021,9700F013445EE92B5BC547553474ABFD,38105,17,20,3,109.40299,18.29229,1117
178022,990177E7F6C01BC630E60891F7DC3E29,60401,0,2,2,109.47444,18.27583,1414
178023,990177E7F6C01BC630E60891F7DC3E29,30111,2,5,3,109.47583,18.30542,1419
178026,990177E7F6C01BC630E60891F7DC3E29,60504,21,22,1,109.47917,18.28903,1416
178059,B47CB2A2315F987CAA4AD3E9353D33AE,31231,0,7,7,109.42597,18.29292,1217
178060,B47CB2A2315F987CAA4AD3E9353D33AE,31781,9,12,3,109.19847,18.2975,367
178061,B47CB2A2315F987CAA4AD3E9353D33AE,31521,13,15,2,109.51458,18.22542,1555
178073,D0016644D08E46EAD736BEE805BD7ECD,31864,0,8,8,109.49014,18.28333,1465
178074,D0016644D08E46EAD736BEE805BD7ECD,30391,10,11,1,109.4975,18.27118,1513
178075,D0016644D08E46EAD736BEE805BD7ECD,60221,13,14,1,109.52569,18.29188,1616
178078,7AF4921BC4D1712A961904D0ECC91550,38991,0,7,7,109.52681,18.30368,1618
178079,7AF4921BC4D1712A961904D0ECC91550,30421,9,10,1,109.50021,18.25861,1511
178080,7AF4921BC4D1712A961904D0ECC91550,30071,12,14,2,109.52819,18.30472,1619
178081,7AF4921BC4D1712A961904D0ECC91550,60571,14,15,1,109.50722,18.25056,1510
178082,7AF4921BC4D1712A961904D0ECC91550,30071,17,19,2,109.52819,18.30472,1619
178083,0F558B6653C655C7F0BAEA9D66B33F57,31071,0,6,6,109.58257,18.28458,1815
178084,0F558B6653C655C7F0BAEA9D66B33F57,30854,7,18,11,109.56889,18.27076,1763
178085,0F558B6653C655C7F0BAEA9D66B33F57,31071,20,21,1,109.58257,18.28458,1815
178091,5513D4DF2C6575E373329D82A78CC8F3,60221,19,21,2,109.52569,18.29188,1616
178092,5513D4DF2C6575E373329D82A78CC8F3,60281,21,23,2,109.51743,18.25924,1561
178095,1026894DC5FF9A7FAF3A2EE28B95E239,30854,0,1,1,109.56889,18.27076,1763
178096,1026894DC5FF9A7FAF3A2EE28B95E239,30232,2,3,1,109.6191,18.31701,1971
178097,1026894DC5FF9A7FAF3A2EE28B95E239,30891,4,6,2,109.59431,18.28389,1865
178098,1026894DC5FF9A7FAF3A2EE28B95E239,30232,6,7,1,109.6191,18.31701,1971
178099,1026894DC5FF9A7FAF3A2EE28B95E239,30854,11,23,12,109.56889,18.27076,1763
178111,BC0EA07162A3720F3AF08008AC1D0A3A,31411,0,1,1,109.5016,18.23576,1507
178112,BC0EA07162A3720F3AF08008AC1D0A3A,38971,1,7,6,109.50743,18.25125,1510
178113,BC0EA07162A3720F3AF08008AC1D0A3A,31461,8,9,1,109.5091,18.25389,1510
178114,BC0EA07162A3720F3AF08008AC1D0A3A,31461,11,13,2,109.5091,18.25389,1510
178133,7421066246AAD1C230E7E2A7ADF06E9D,60631,0,6,6,109.57778,18.27583,1814
178134,7421066246AAD1C230E7E2A7ADF06E9D,30854,7,11,4,109.56889,18.27076,1763
178135,7421066246AAD1C230E7E2A7ADF06E9D,60631,12,13,1,109.57778,18.27583,1814
178136,7421066246AAD1C230E7E2A7ADF06E9D,30854,15,16,1,109.56889,18.27076,1763
178137,7421066246AAD1C230E7E2A7ADF06E9D,31071,16,18,2,109.58257,18.28458,1815
178191,A01B4012B619D942E7CC3AC9B78722B4,31561,1,8,7,109.56792,18.28479,1765
178192,A01B4012B619D942E7CC3AC9B78722B4,30854,10,11,1,109.56889,18.27076,1763
178193,A01B4012B619D942E7CC3AC9B78722B4,31561,12,13,1,109.56792,18.28479,1765
178194,A01B4012B619D942E7CC3AC9B78722B4,31931,13,14,1,109.54771,18.29403,1667
178195,A01B4012B619D942E7CC3AC9B78722B4,39183,15,16,1,109.55542,18.28208,1715
178196,A01B4012B619D942E7CC3AC9B78722B4,31561,19,21,2,109.56792,18.28479,1765
178209,C153552CEA2677B0FF473AE565EA979E,30821,0,13,13,109.43681,18.33639,1274
178210,C153552CEA2677B0FF473AE565EA979E,60424,15,16,1,109.44611,18.31736,1321
178211,C153552CEA2677B0FF473AE565EA979E,30821,17,23,6,109.43681,18.33639,1274
178214,417408FFDA93B177641D270D3A5C4B2D,31071,0,6,6,109.58257,18.28458,1815
178215,417408FFDA93B177641D270D3A5C4B2D,30854,8,10,2,109.56889,18.27076,1763
178216,417408FFDA93B177641D270D3A5C4B2D,31071,11,23,12,109.58257,18.28458,1815
178293,28F7DFD4A036DBA4E68AFC71762D44D7,31561,0,6,6,109.56792,18.28479,1765
178294,28F7DFD4A036DBA4E68AFC71762D44D7,30951,8,17,9,109.56208,18.25667,1761
178295,28F7DFD4A036DBA4E68AFC71762D44D7,39371,17,23,6,109.56627,18.2646,1762
178309,06D4B9E449A0048FBF2732A634B857D8,30111,21,23,2,109.47583,18.30542,1419
178310,F2B9C7568D81626E82B4BCA4DDFDDC53,30191,20,21,1,109.50361,18.22701,1506
178311,F2B9C7568D81626E82B4BCA4DDFDDC53,60281,21,23,2,109.51743,18.25924,1561
178312,AD6CE74FEECB42F7806A62DA7A4CECCA,30851,0,6,6,109.5616,18.27396,1713
178313,AD6CE74FEECB42F7806A62DA7A4CECCA,30854,9,15,6,109.56889,18.27076,1763
178314,AD6CE74FEECB42F7806A62DA7A4CECCA,39183,19,23,4,109.55542,18.28208,1715
178423,D2A5F87218CF25385163A2F3C4229CB8,30851,0,1,1,109.5616,18.27396,1713
178424,D2A5F87218CF25385163A2F3C4229CB8,31561,1,12,11,109.56792,18.28479,1765
178425,D2A5F87218CF25385163A2F3C4229CB8,30851,12,13,1,109.5616,18.27396,1713
178426,D2A5F87218CF25385163A2F3C4229CB8,31561,14,23,9,109.56792,18.28479,1765
178429,DF49F834C08C7E8FA6D78272EE1FB651,60361,0,7,7,109.51938,18.29681,1567
178430,DF49F834C08C7E8FA6D78272EE1FB651,39371,10,12,2,109.56627,18.2646,1762
178431,DF49F834C08C7E8FA6D78272EE1FB651,30851,12,14,2,109.5616,18.27396,1713
178432,DF49F834C08C7E8FA6D78272EE1FB651,60361,18,23,5,109.51938,18.29681,1567
178449,4CE4A31810F905218B2DE448B8558D56,30341,14,17,3,109.3625,18.29167,966
178450,4CE4A31810F905218B2DE448B8558D56,38071,19,20,1,109.40722,18.30938,1169
178451,147470AD3D3B8724582C30D5F244A8B6,30111,6,12,6,109.47583,18.30542,1419
178452,147470AD3D3B8724582C30D5F244A8B6,60421,13,23,10,109.46333,18.31743,1371
178466,9E4B050A632405BF0E0F227A4DA9A53D,30854,0,10,10,109.56889,18.27076,1763
178467,9E4B050A632405BF0E0F227A4DA9A53D,30441,11,12,1,109.64021,18.25424,2010
178468,9E4B050A632405BF0E0F227A4DA9A53D,30731,15,18,3,109.50944,18.22306,1555
178469,9E4B050A632405BF0E0F227A4DA9A53D,30191,20,23,3,109.50361,18.22701,1506
178505,DE2E7FD3F70D02EF01FD3D7518139D80,38951,0,7,7,109.48097,18.28868,1416
178506,DE2E7FD3F70D02EF01FD3D7518139D80,31781,9,12,3,109.19847,18.2975,367
178507,DE2E7FD3F70D02EF01FD3D7518139D80,31471,14,15,1,109.34583,18.29563,917
178508,DE2E7FD3F70D02EF01FD3D7518139D80,38951,19,21,2,109.48097,18.28868,1416
178532,19AF14C42256ABB10CC41D7FEC42A786,31071,1,7,6,109.58257,18.28458,1815
178533,19AF14C42256ABB10CC41D7FEC42A786,30851,8,9,1,109.5616,18.27396,1713
178534,19AF14C42256ABB10CC41D7FEC42A786,33481,11,16,5,109.67278,18.41278,2187
178544,83930DA23863D53A36D25B51299F2054,61011,4,6,2,109.60653,18.19076,1900
178546,83930DA23863D53A36D25B51299F2054,61011,12,14,2,109.60653,18.19076,1900
178560,01CB2F51227D8C2BB2D3000C42EE0DA2,31521,10,17,7,109.51458,18.22542,1555
178561,01CB2F51227D8C2BB2D3000C42EE0DA2,31171,17,19,2,109.50938,18.24917,1559
178562,01CB2F51227D8C2BB2D3000C42EE0DA2,60274,19,22,3,109.514,18.2933,1567
178566,3261CBB7DE1D0E7EBB73DA5908B3B2A9,31521,0,10,10,109.51458,18.22542,1555
178567,3261CBB7DE1D0E7EBB73DA5908B3B2A9,31031,14,17,3,109.49979,18.25382,1510
178587,C85D0B931BEF54F05B9ABBBB03212DB7,31421,0,7,7,109.55382,18.22347,1705
178588,C85D0B931BEF54F05B9ABBBB03212DB7,30854,9,20,11,109.56889,18.27076,1763
178589,C85D0B931BEF54F05B9ABBBB03212DB7,31561,22,23,1,109.56792,18.28479,1765
178610,1582BEC240072EC51899932D6A0A257A,60631,3,4,1,109.57778,18.27583,1814
178611,1582BEC240072EC51899932D6A0A257A,30891,4,17,13,109.59431,18.28389,1865
178661,C9FB9F2C2796B7DA9E44AABC0342CC7A,60381,14,15,1,109.5241,18.22458,1605
178662,C9FB9F2C2796B7DA9E44AABC0342CC7A,31521,16,18,2,109.51458,18.22542,1555
178667,032BA6C7F044E8806CEB432AECA246EE,48621,0,6,6,109.52882,18.31743,1621
178668,032BA6C7F044E8806CEB432AECA246EE,38484,7,17,10,109.53028,18.31528,1620
178669,032BA6C7F044E8806CEB432AECA246EE,38484,18,23,5,109.53028,18.31528,1620
178698,EBF906C5498076BCFA3E97DF6001B4F3,60631,6,7,1,109.57778,18.27583,1814
178699,EBF906C5498076BCFA3E97DF6001B4F3,30854,9,21,12,109.56889,18.27076,1763
178754,B2420C24A59D2C27A09046B2EE9F5AF9,30854,0,6,6,109.56889,18.27076,1763
178755,B2420C24A59D2C27A09046B2EE9F5AF9,31071,8,15,7,109.58257,18.28458,1815
178756,B2420C24A59D2C27A09046B2EE9F5AF9,31071,17,20,3,109.58257,18.28458,1815
178757,B2420C24A59D2C27A09046B2EE9F5AF9,31071,21,23,2,109.58257,18.28458,1815
178770,F8028D3CB53BF090C5567009A22F9DE3,60131,0,9,9,109.49819,18.24778,1509
178771,F8028D3CB53BF090C5567009A22F9DE3,31471,11,14,3,109.34583,18.29563,917
178772,F8028D3CB53BF090C5567009A22F9DE3,39091,18,23,5,109.50097,18.25222,1510
178775,8E3A30A4D1E8F550E98C2EF7500D367D,30084,0,14,14,109.50118,18.26972,1513
178776,8E3A30A4D1E8F550E98C2EF7500D367D,60381,17,19,2,109.5241,18.22458,1605
178777,8E3A30A4D1E8F550E98C2EF7500D367D,30421,20,21,1,109.50021,18.25861,1511
178788,75817DB682187A07461734D66E1E6492,60631,0,4,4,109.57778,18.27583,1814
178789,75817DB682187A07461734D66E1E6492,30854,6,15,9,109.56889,18.27076,1763
178790,75817DB682187A07461734D66E1E6492,31061,19,21,2,109.53333,18.23257,1607
178791,75817DB682187A07461734D66E1E6492,60631,22,23,1,109.57778,18.27583,1814
178840,6DB79FADDF50EB053ABAC0F23B07A706,38721,12,16,4,109.50368,18.27542,1514
178841,6DB79FADDF50EB053ABAC0F23B07A706,60381,19,22,3,109.5241,18.22458,1605
178855,21C679D1B9FF307EA1AC2A89744209FE,38291,0,8,8,109.51618,18.24313,1558
178856,21C679D1B9FF307EA1AC2A89744209FE,60281,8,10,2,109.51743,18.25924,1561
178857,21C679D1B9FF307EA1AC2A89744209FE,38291,12,18,6,109.51618,18.24313,1558
178858,21C679D1B9FF307EA1AC2A89744209FE,60281,18,20,2,109.51743,18.25924,1561
178859,21C679D1B9FF307EA1AC2A89744209FE,38291,20,23,3,109.51618,18.24313,1558
178870,34F3D64B41C252481F72E5CF931AC833,30854,1,5,4,109.56889,18.27076,1763
178871,34F3D64B41C252481F72E5CF931AC833,30851,7,10,3,109.5616,18.27396,1713
178872,34F3D64B41C252481F72E5CF931AC833,30854,13,22,9,109.56889,18.27076,1763
178887,06FCF67485A2B44C8ABC96FDB92547C5,61011,13,15,2,109.60653,18.19076,1900
178889,06FCF67485A2B44C8ABC96FDB92547C5,61011,18,23,5,109.60653,18.19076,1900
178900,6DA2EC279010D0E9F544FC8AE2AE810A,39331,0,1,1,109.62125,18.22708,1956
178901,6DA2EC279010D0E9F544FC8AE2AE810A,38283,1,4,3,109.62229,18.22618,1956
178902,6DA2EC279010D0E9F544FC8AE2AE810A,31571,5,8,3,109.61563,18.23326,1957
178904,6DA2EC279010D0E9F544FC8AE2AE810A,30361,19,23,4,109.50347,18.24,1508
178923,95E09A72760B2799C2CC9BD7AF527107,31071,1,6,5,109.58257,18.28458,1815
178924,95E09A72760B2799C2CC9BD7AF527107,30854,6,7,1,109.56889,18.27076,1763
178925,95E09A72760B2799C2CC9BD7AF527107,31071,8,10,2,109.58257,18.28458,1815
178926,95E09A72760B2799C2CC9BD7AF527107,30854,13,18,5,109.56889,18.27076,1763
178927,95E09A72760B2799C2CC9BD7AF527107,31071,22,23,1,109.58257,18.28458,1815
178928,B9443F64442A80E319EB0A8B9F1B13FA,31721,3,13,10,109.67938,18.24014,2158
178929,B9443F64442A80E319EB0A8B9F1B13FA,39183,18,19,1,109.55542,18.28208,1715
178930,B9443F64442A80E319EB0A8B9F1B13FA,30891,20,22,2,109.59431,18.28389,1865
178944,8D8AA41210FC9E2D5DD4D81CF4DB18D7,60361,0,7,7,109.51938,18.29681,1567
178945,8D8AA41210FC9E2D5DD4D81CF4DB18D7,38991,7,17,10,109.52681,18.30368,1618
178946,8D8AA41210FC9E2D5DD4D81CF4DB18D7,39191,18,20,2,109.51493,18.23472,1557
178968,BD1C8CAB0CA377D9350002A865081450,30081,0,7,7,109.50243,18.26632,1512
178969,BD1C8CAB0CA377D9350002A865081450,30251,12,16,4,109.50611,18.26653,1512
178970,BD1C8CAB0CA377D9350002A865081450,31021,17,18,1,109.49021,18.27,1463
178971,BD1C8CAB0CA377D9350002A865081450,30251,19,23,4,109.50611,18.26653,1512
178972,ABCD0851CC1C78BCD7AF6DBDF2F5DE49,60041,0,5,5,109.39889,18.31944,1121
178973,ABCD0851CC1C78BCD7AF6DBDF2F5DE49,60552,7,17,10,109.41729,18.30014,1218
178974,ABCD0851CC1C78BCD7AF6DBDF2F5DE49,30731,18,19,1,109.50944,18.22306,1555
178977,5E97A4561E11AAC4FBC53FD068EAA52B,30531,8,18,10,109.53271,18.21472,1604
178978,5E97A4561E11AAC4FBC53FD068EAA52B,30854,20,22,2,109.56889,18.27076,1763
178996,C19430CE8DF26BDEF43903E57E682236,31561,0,7,7,109.56792,18.28479,1765
178997,C19430CE8DF26BDEF43903E57E682236,30854,10,12,2,109.56889,18.27076,1763
178998,C19430CE8DF26BDEF43903E57E682236,31561,14,16,2,109.56792,18.28479,1765
178999,C19430CE8DF26BDEF43903E57E682236,30854,19,21,2,109.56889,18.27076,1763
179000,C19430CE8DF26BDEF43903E57E682236,31561,21,23,2,109.56792,18.28479,1765
179008,E6541B4F346982101D887BAAF0315541,30854,0,1,1,109.56889,18.27076,1763
179009,E6541B4F346982101D887BAAF0315541,31931,1,4,3,109.54771,18.29403,1667
179010,E6541B4F346982101D887BAAF0315541,30854,4,5,1,109.56889,18.27076,1763
179011,E6541B4F346982101D887BAAF0315541,31561,7,9,2,109.56792,18.28479,1765
179012,E6541B4F346982101D887BAAF0315541,30854,12,14,2,109.56889,18.27076,1763
179013,E6541B4F346982101D887BAAF0315541,31561,16,17,1,109.56792,18.28479,1765
179014,E6541B4F346982101D887BAAF0315541,30854,18,20,2,109.56889,18.27076,1763
179056,238A28D828ECC4FDAC2CC9F666ABE21D,31864,0,11,11,109.49014,18.28333,1465
179057,238A28D828ECC4FDAC2CC9F666ABE21D,30161,11,15,4,109.50042,18.24389,1508
179062,5DB17B652EFBF6CFE54CE332D8232D6E,31351,0,9,9,109.4959,18.28417,1465
179068,7252A0F90E29EC78621699C082578EF7,31361,0,6,6,109.47417,18.28292,1415
179069,7252A0F90E29EC78621699C082578EF7,60504,8,9,1,109.47917,18.28903,1416
179070,7252A0F90E29EC78621699C082578EF7,31521,11,12,1,109.51458,18.22542,1555
179071,7252A0F90E29EC78621699C082578EF7,31091,17,18,1,109.41201,18.31222,1170
179072,7252A0F90E29EC78621699C082578EF7,30111,19,20,1,109.47583,18.30542,1419
179073,7252A0F90E29EC78621699C082578EF7,31361,22,23,1,109.47417,18.28292,1415
179100,6593F76DF8B5BF518604AD69943FBD58,31071,0,9,9,109.58257,18.28458,1815
179101,6593F76DF8B5BF518604AD69943FBD58,30854,9,20,11,109.56889,18.27076,1763
179118,E5D9C2E63CCE9D1234DB3809C4F11F20,30721,0,1,1,109.51597,18.28257,1565
179119,E5D9C2E63CCE9D1234DB3809C4F11F20,60421,5,9,4,109.46333,18.31743,1371
179120,E5D9C2E63CCE9D1234DB3809C4F11F20,60171,12,20,8,109.51292,18.30694,1569
179153,4AE7355880AC4A67834E5F08397D8D3C,60524,0,2,2,109.42951,18.28993,1216
179154,4AE7355880AC4A67834E5F08397D8D3C,30351,6,20,14,109.41701,18.29292,1217
179155,4AE7355880AC4A67834E5F08397D8D3C,30771,21,22,1,109.49938,18.26042,1511
179189,E960A9C960574B6ECAA9E8161ED40783,30861,0,12,12,109.52722,18.22743,1606
179190,E960A9C960574B6ECAA9E8161ED40783,31031,14,16,2,109.49979,18.25382,1510
179191,E960A9C960574B6ECAA9E8161ED40783,60221,17,21,4,109.52569,18.29188,1616
179192,27BCEF3137923B84211F08830816C810,31561,0,1,1,109.56792,18.28479,1765
179193,27BCEF3137923B84211F08830816C810,30851,2,5,3,109.5616,18.27396,1713
179194,27BCEF3137923B84211F08830816C810,31561,8,9,1,109.56792,18.28479,1765
179202,EA46ADF9F976BE5C491F6E059468AAEA,31521,0,5,5,109.51458,18.22542,1555
179203,EA46ADF9F976BE5C491F6E059468AAEA,31521,6,8,2,109.51458,18.22542,1555
179204,EA46ADF9F976BE5C491F6E059468AAEA,38754,11,13,2,109.74667,18.37382,2430
179205,EA46ADF9F976BE5C491F6E059468AAEA,31521,15,22,7,109.51458,18.22542,1555
179223,CBFB6695A565EE8288E80536B0FF653C,39321,16,17,1,109.529,18.2167,1604
179224,CBFB6695A565EE8288E80536B0FF653C,30854,19,20,1,109.56889,18.27076,1763
179225,5426296000364EE32711CD0E73D782C8,31071,2,9,7,109.58257,18.28458,1815
179226,5426296000364EE32711CD0E73D782C8,31561,13,14,1,109.56792,18.28479,1765
179227,5426296000364EE32711CD0E73D782C8,30854,17,18,1,109.56889,18.27076,1763
179228,5426296000364EE32711CD0E73D782C8,38251,19,20,1,109.49618,18.25493,1510
179257,4995463B780282C9C030A19D9F49AEAC,30721,0,2,2,109.51597,18.28257,1565
179258,4995463B780282C9C030A19D9F49AEAC,31071,3,6,3,109.58257,18.28458,1815
179259,4995463B780282C9C030A19D9F49AEAC,30854,7,17,10,109.56889,18.27076,1763
179260,4995463B780282C9C030A19D9F49AEAC,31071,19,22,3,109.58257,18.28458,1815
179275,4E94ADAE7ABEB20EEFAF67519DFCC1BE,31081,0,8,8,109.44639,18.30181,1318
179276,4E94ADAE7ABEB20EEFAF67519DFCC1BE,31031,9,15,6,109.49979,18.25382,1510
179277,4E94ADAE7ABEB20EEFAF67519DFCC1BE,31031,15,21,6,109.49979,18.25382,1510
179339,00FD2268DE6E83934D2916174E81532F,60472,0,4,4,109.46625,18.29542,1367
179340,00FD2268DE6E83934D2916174E81532F,30111,7,19,12,109.47583,18.30542,1419
179367,6F0540B756080DEA0630ADD22B34EFCA,30371,0,7,7,109.51,18.24771,1559
179368,6F0540B756080DEA0630ADD22B34EFCA,30151,8,10,2,109.50986,18.25083,1560
179369,6F0540B756080DEA0630ADD22B34EFCA,38801,11,18,7,109.51472,18.2584,1561
179370,6F0540B756080DEA0630ADD22B34EFCA,30151,18,23,5,109.50986,18.25083,1560
179387,8C8DB7A18864109B823771C405E00B29,60351,0,6,6,109.58403,18.28958,1816
179388,8C8DB7A18864109B823771C405E00B29,31421,7,8,1,109.55382,18.22347,1705
179389,8C8DB7A18864109B823771C405E00B29,30951,11,14,3,109.56208,18.25667,1761
179390,8C8DB7A18864109B823771C405E00B29,31071,18,19,1,109.58257,18.28458,1815
179391,8C8DB7A18864109B823771C405E00B29,60351,20,22,2,109.58403,18.28958,1816
179392,C3AB0123E8B0A1F17841EC5DAE5B6707,31521,15,16,1,109.51458,18.22542,1555
179393,C3AB0123E8B0A1F17841EC5DAE5B6707,30764,18,21,3,109.45806,18.29486,1367
179396,996C0D9500BF90CC0E7F5A04C49A464B,31931,4,6,2,109.54771,18.29403,1667
179398,B340EDEF4A878E8DF5CBEC25E465EACE,30854,7,11,4,109.56889,18.27076,1763
179399,B340EDEF4A878E8DF5CBEC25E465EACE,31071,11,13,2,109.58257,18.28458,1815
179400,B340EDEF4A878E8DF5CBEC25E465EACE,30854,14,15,1,109.56889,18.27076,1763
179401,B340EDEF4A878E8DF5CBEC25E465EACE,60631,16,17,1,109.57778,18.27583,1814
179402,B340EDEF4A878E8DF5CBEC25E465EACE,30721,17,20,3,109.51597,18.28257,1565
179403,B340EDEF4A878E8DF5CBEC25E465EACE,31071,22,23,1,109.58257,18.28458,1815
179420,F198CAA1F49ACA5D003FD8F8473B3798,30854,0,15,15,109.56889,18.27076,1763
179421,F198CAA1F49ACA5D003FD8F8473B3798,30731,15,18,3,109.50944,18.22306,1555
179441,6DD2992D9A732B2B8C9D2BEBFF495B9E,31561,0,8,8,109.56792,18.28479,1765
179442,6DD2992D9A732B2B8C9D2BEBFF495B9E,30854,9,12,3,109.56889,18.27076,1763
179443,6DD2992D9A732B2B8C9D2BEBFF495B9E,31561,13,18,5,109.56792,18.28479,1765
179444,6DD2992D9A732B2B8C9D2BEBFF495B9E,30854,18,20,2,109.56889,18.27076,1763
179445,6DD2992D9A732B2B8C9D2BEBFF495B9E,31561,21,22,1,109.56792,18.28479,1765
179447,2EBBAC66DDB6248DEB5E1D635794A55A,61011,1,10,9,109.60653,18.19076,1900
179449,2EBBAC66DDB6248DEB5E1D635794A55A,61011,15,17,2,109.60653,18.19076,1900
179453,EEBA7563A33B93144B19AD633FDB9890,31561,0,6,6,109.56792,18.28479,1765
179454,EEBA7563A33B93144B19AD633FDB9890,30854,8,9,1,109.56889,18.27076,1763
179455,EEBA7563A33B93144B19AD633FDB9890,31561,11,23,12,109.56792,18.28479,1765
179502,35C6EDC8AAC6B5ABA770190223528BA2,31061,0,5,5,109.53333,18.23257,1607
179503,35C6EDC8AAC6B5ABA770190223528BA2,60381,6,8,2,109.5241,18.22458,1605
179504,35C6EDC8AAC6B5ABA770190223528BA2,60121,10,11,1,109.74507,18.37472,2430
179505,35C6EDC8AAC6B5ABA770190223528BA2,60381,14,16,2,109.5241,18.22458,1605
179511,A50A9C6740FDA7E08A9D2C9FE22F2DDD,31531,13,14,1,109.49583,18.25972,1461
179512,A50A9C6740FDA7E08A9D2C9FE22F2DDD,60221,15,17,2,109.52569,18.29188,1616
179513,A50A9C6740FDA7E08A9D2C9FE22F2DDD,31271,20,21,1,109.48958,18.26257,1462
179520,552B98A65A23DB4CD390E78F3246E9C5,60241,2,6,4,109.53319,18.28667,1616
179521,552B98A65A23DB4CD390E78F3246E9C5,30921,8,10,2,109.53903,18.29451,1667
179522,552B98A65A23DB4CD390E78F3246E9C5,60241,12,13,1,109.53319,18.28667,1616
179523,552B98A65A23DB4CD390E78F3246E9C5,30921,16,22,6,109.53903,18.29451,1667
179559,FEBC61D07262A46BE9A7FF14D2806B38,30854,0,8,8,109.56889,18.27076,1763
179560,FEBC61D07262A46BE9A7FF14D2806B38,31031,12,14,2,109.49979,18.25382,1510
179561,FEBC61D07262A46BE9A7FF14D2806B38,30854,14,16,2,109.56889,18.27076,1763
179562,FEBC61D07262A46BE9A7FF14D2806B38,30161,17,22,5,109.50042,18.24389,1508
179599,9D1215DD6B7CC5D7B77DB28818401AF1,31071,0,7,7,109.58257,18.28458,1815
179600,9D1215DD6B7CC5D7B77DB28818401AF1,31761,9,10,1,109.60521,18.27965,1914
179601,9D1215DD6B7CC5D7B77DB28818401AF1,30232,14,16,2,109.6191,18.31701,1971
179602,9D1215DD6B7CC5D7B77DB28818401AF1,31071,17,19,2,109.58257,18.28458,1815
179603,9D1215DD6B7CC5D7B77DB28818401AF1,31561,20,21,1,109.56792,18.28479,1765
179611,D1EBD1A5A8A922DEF994C933F10DD8DB,60131,0,6,6,109.49819,18.24778,1509
179612,D1EBD1A5A8A922DEF994C933F10DD8DB,30161,7,8,1,109.50042,18.24389,1508
179613,D1EBD1A5A8A922DEF994C933F10DD8DB,60381,8,14,6,109.5241,18.22458,1605
179614,D1EBD1A5A8A922DEF994C933F10DD8DB,60131,15,17,2,109.49819,18.24778,1509
179615,D1EBD1A5A8A922DEF994C933F10DD8DB,30161,19,23,4,109.50042,18.24389,1508
179644,665F7D27C5B6FBE7E46677D117D817C4,60381,19,21,2,109.5241,18.22458,1605
179645,665F7D27C5B6FBE7E46677D117D817C4,30721,21,22,1,109.51597,18.28257,1565
179646,F71405344B971967BDA24B8D31704EA3,39331,11,16,5,109.62125,18.22708,1956
179647,F71405344B971967BDA24B8D31704EA3,30854,18,21,3,109.56889,18.27076,1763
179708,44F505B3929E26B4B29F00CC284F3084,31071,3,4,1,109.58257,18.28458,1815
179709,44F505B3929E26B4B29F00CC284F3084,60631,6,7,1,109.57778,18.27583,1814
179710,44F505B3929E26B4B29F00CC284F3084,30854,10,21,11,109.56889,18.27076,1763
179713,770A00BDAFE9BCA8C9E9FA68066EED7D,31071,0,6,6,109.58257,18.28458,1815
179714,770A00BDAFE9BCA8C9E9FA68066EED7D,30851,6,10,4,109.5616,18.27396,1713
179715,770A00BDAFE9BCA8C9E9FA68066EED7D,30854,10,11,1,109.56889,18.27076,1763
179716,770A00BDAFE9BCA8C9E9FA68066EED7D,31561,12,15,3,109.56792,18.28479,1765
179717,770A00BDAFE9BCA8C9E9FA68066EED7D,30854,17,19,2,109.56889,18.27076,1763
179718,770A00BDAFE9BCA8C9E9FA68066EED7D,31071,21,23,2,109.58257,18.28458,1815
179746,FDC2B4BB960ACDA9822626D3DCBE25AF,31071,5,7,2,109.58257,18.28458,1815
179747,FDC2B4BB960ACDA9822626D3DCBE25AF,30941,9,20,11,109.5559,18.33938,1724
179748,FDC2B4BB960ACDA9822626D3DCBE25AF,31071,21,23,2,109.58257,18.28458,1815
179749,F95A4851DA9E4577D24C7EFA15F54F09,39321,0,17,17,109.529,18.2167,1604
179750,F95A4851DA9E4577D24C7EFA15F54F09,60381,18,19,1,109.5241,18.22458,1605
179751,F95A4851DA9E4577D24C7EFA15F54F09,39321,21,23,2,109.529,18.2167,1604
179752,369F61D9EC42E510E242E24266B2C23F,30921,0,7,7,109.53903,18.29451,1667
179753,369F61D9EC42E510E242E24266B2C23F,31931,9,10,1,109.54771,18.29403,1667
179754,369F61D9EC42E510E242E24266B2C23F,30921,10,11,1,109.53903,18.29451,1667
179755,369F61D9EC42E510E242E24266B2C23F,31931,11,21,10,109.54771,18.29403,1667
179756,369F61D9EC42E510E242E24266B2C23F,30071,22,23,1,109.52819,18.30472,1619
179780,3BB007FDF28DB0E7E883BA594F721FFE,31181,0,15,15,109.50382,18.24813,1509
179781,3BB007FDF28DB0E7E883BA594F721FFE,30711,16,23,7,109.50271,18.25347,1510
179790,22328E79B5A8943E5A27CE35499D706B,60171,18,20,2,109.51292,18.30694,1569
179791,22328E79B5A8943E5A27CE35499D706B,38251,21,23,2,109.49618,18.25493,1510
179797,386F7C3EECFB31191CAF7B5A56666704,30854,18,19,1,109.56889,18.27076,1763
179798,386F7C3EECFB31191CAF7B5A56666704,31071,21,22,1,109.58257,18.28458,1815
179803,F5FE23BF42FC224C310CD42E08B0B950,31431,0,8,8,109.44639,18.29042,1316
179804,F5FE23BF42FC224C310CD42E08B0B950,30764,9,10,1,109.45806,18.29486,1367
179805,F5FE23BF42FC224C310CD42E08B0B950,38094,10,16,6,109.45403,18.28778,1316
179806,F5FE23BF42FC224C310CD42E08B0B950,31701,18,22,4,109.44132,18.28833,1266
179813,533C598FBE9A80A69F24B4E517B0CF08,30101,14,16,2,109.57299,18.33333,1773
179814,533C598FBE9A80A69F24B4E517B0CF08,31351,17,19,2,109.4959,18.28417,1465
179815,533C598FBE9A80A69F24B4E517B0CF08,30741,21,23,2,109.49833,18.28681,1516
179837,DC0EB400EA24BEE9EB39D315B0E6AEF0,38871,0,3,3,109.44681,18.28625,1316
179838,DC0EB400EA24BEE9EB39D315B0E6AEF0,31701,3,4,1,109.44132,18.28833,1266
179839,DC0EB400EA24BEE9EB39D315B0E6AEF0,38871,5,7,2,109.44681,18.28625,1316
179840,DC0EB400EA24BEE9EB39D315B0E6AEF0,31431,8,14,6,109.44639,18.29042,1316
179842,DC0EB400EA24BEE9EB39D315B0E6AEF0,60274,20,23,3,109.514,18.2933,1567
179858,9FEA4B85EAE4FAEE1CAF0EABFF2FAEA1,31931,13,16,3,109.54771,18.29403,1667
179859,9FEA4B85EAE4FAEE1CAF0EABFF2FAEA1,39183,16,18,2,109.55542,18.28208,1715
179867,7763FA5342AFBCA436FF4D695F9B9CB2,30711,0,6,6,109.50271,18.25347,1510
179868,7763FA5342AFBCA436FF4D695F9B9CB2,60071,10,12,2,109.75674,18.31583,2470
179869,7763FA5342AFBCA436FF4D695F9B9CB2,30711,16,17,1,109.50271,18.25347,1510
179870,7763FA5342AFBCA436FF4D695F9B9CB2,30711,17,21,4,109.50271,18.25347,1510
179874,32A3CE1C280040E7ED0898AB2CE878E8,60401,0,1,1,109.47444,18.27583,1414
179875,32A3CE1C280040E7ED0898AB2CE878E8,30171,1,4,3,109.48458,18.27139,1463
179876,32A3CE1C280040E7ED0898AB2CE878E8,60401,5,8,3,109.47444,18.27583,1414
179877,32A3CE1C280040E7ED0898AB2CE878E8,31471,12,14,2,109.34583,18.29563,917
179878,32A3CE1C280040E7ED0898AB2CE878E8,60401,16,22,6,109.47444,18.27583,1414
179891,0A1CB07AD09D756A92F5040351DE4A0A,38336,0,11,11,109.61111,18.21806,1904
179892,0A1CB07AD09D756A92F5040351DE4A0A,31321,12,13,1,109.63799,18.23201,2007
179926,088829826E35A8DF49EB0AEC08CE7FE7,60054,15,16,1,109.3016,18.31229,770
179927,088829826E35A8DF49EB0AEC08CE7FE7,30661,19,22,3,109.37028,18.24361,1008
179928,088829826E35A8DF49EB0AEC08CE7FE7,60054,22,23,1,109.3016,18.31229,770
179938,B2ECB16DAB1B797D0F4EE32090B0A991,60011,0,7,7,109.48965,18.30222,1468
179939,B2ECB16DAB1B797D0F4EE32090B0A991,30111,8,10,2,109.47583,18.30542,1419
179940,B2ECB16DAB1B797D0F4EE32090B0A991,60011,11,19,8,109.48965,18.30222,1468
179941,B2ECB16DAB1B797D0F4EE32090B0A991,30111,20,21,1,109.47583,18.30542,1419
179942,B2ECB16DAB1B797D0F4EE32090B0A991,60011,21,23,2,109.48965,18.30222,1468
179951,94C4D5691F7DFC1AB38806AFFAC1389E,30921,12,16,4,109.53903,18.29451,1667
179952,94C4D5691F7DFC1AB38806AFFAC1389E,31931,20,21,1,109.54771,18.29403,1667
179957,317A2326A5D15E475076F1921264E5AD,39321,0,5,5,109.529,18.2167,1604
179958,317A2326A5D15E475076F1921264E5AD,31521,7,8,1,109.51458,18.22542,1555
179959,317A2326A5D15E475076F1921264E5AD,38071,12,13,1,109.40722,18.30938,1169
179999,E191BF114A3C2277CB7C3323BAA13F43,31301,14,15,1,109.14493,18.31222,170
180000,E191BF114A3C2277CB7C3323BAA13F43,30854,18,23,5,109.56889,18.27076,1763
180001,9FC721E86703223349C05C95FE4BBB6F,60081,1,10,9,109.51097,18.22639,1556
180002,9FC721E86703223349C05C95FE4BBB6F,60381,11,14,3,109.5241,18.22458,1605
180003,9FC721E86703223349C05C95FE4BBB6F,31521,15,23,8,109.51458,18.22542,1555
180030,293757429670FEF848C950D685169FCC,31071,0,4,4,109.58257,18.28458,1815
180031,293757429670FEF848C950D685169FCC,30854,5,16,11,109.56889,18.27076,1763
180039,A68637AA89BD62624E677D9E66C32FAD,30161,0,9,9,109.50042,18.24389,1508
180040,A68637AA89BD62624E677D9E66C32FAD,30151,12,14,2,109.50986,18.25083,1560
180041,A68637AA89BD62624E677D9E66C32FAD,30161,14,16,2,109.50042,18.24389,1508
180042,A68637AA89BD62624E677D9E66C32FAD,30361,17,22,5,109.50347,18.24,1508
180046,E4199729A84482014747EE1ECF3FF7D9,30101,13,19,6,109.57299,18.33333,1773
180047,E4199729A84482014747EE1ECF3FF7D9,30931,21,23,2,109.55653,18.32722,1722
180078,E8D51F8B53F290BFD73338AD2AD8C728,31271,9,10,1,109.48958,18.26257,1462
180079,E8D51F8B53F290BFD73338AD2AD8C728,31561,15,16,1,109.56792,18.28479,1765
180088,7B8A7DE9549FE5EAAECC590C9484FFF7,38361,0,8,8,109.43667,18.29201,1267
180089,7B8A7DE9549FE5EAAECC590C9484FFF7,31471,12,14,2,109.34583,18.29563,917
180090,7B8A7DE9549FE5EAAECC590C9484FFF7,38361,16,23,7,109.43667,18.29201,1267
180115,5C958E9FBADCA0FB00CA547ED9076A9C,38121,3,7,4,109.51361,18.27813,1564
180123,A8CC84F6441C04DAF82A74609E587ED2,39181,15,16,1,109.55153,18.28035,1715
180124,A8CC84F6441C04DAF82A74609E587ED2,30561,19,20,1,109.52778,18.31938,1621
180209,B40C23F05DF669D1A7928A9352D650F2,31391,0,1,1,109.50382,18.24285,1508
180210,B40C23F05DF669D1A7928A9352D650F2,31181,1,2,1,109.50382,18.24813,1509
180211,B40C23F05DF669D1A7928A9352D650F2,31391,2,8,6,109.50382,18.24285,1508
180212,B40C23F05DF669D1A7928A9352D650F2,30361,9,11,2,109.50347,18.24,1508
180213,B40C23F05DF669D1A7928A9352D650F2,31181,11,12,1,109.50382,18.24813,1509
180214,B40C23F05DF669D1A7928A9352D650F2,31181,13,15,2,109.50382,18.24813,1509
180215,B40C23F05DF669D1A7928A9352D650F2,30161,17,19,2,109.50042,18.24389,1508
180216,B40C23F05DF669D1A7928A9352D650F2,60291,20,23,3,109.50826,18.24639,1509
180227,61845632D07FAD90D178155204748FBA,30851,0,5,5,109.5616,18.27396,1713
180228,61845632D07FAD90D178155204748FBA,60631,10,20,10,109.57778,18.27583,1814
180229,61845632D07FAD90D178155204748FBA,30851,20,21,1,109.5616,18.27396,1713
180232,DFE6C61D63344C2B343C27596421479D,30071,19,20,1,109.52819,18.30472,1619
180233,DFE6C61D63344C2B343C27596421479D,30921,21,23,2,109.53903,18.29451,1667
180234,E62AF2241FB9B5D16FE7C239F98C4F87,60331,0,6,6,109.505,18.26507,1512
180277,16DAC975E7E40EFDE62B9A017D79E7C1,31761,3,6,3,109.60521,18.27965,1914
180278,16DAC975E7E40EFDE62B9A017D79E7C1,30854,8,10,2,109.56889,18.27076,1763
180279,16DAC975E7E40EFDE62B9A017D79E7C1,60354,13,23,10,109.58701,18.28521,1815
180280,2EB843F78CEA3889458F6783F8AADAE0,31071,14,17,3,109.58257,18.28458,1815
180281,2EB843F78CEA3889458F6783F8AADAE0,30854,18,22,4,109.56889,18.27076,1763
180288,4118232D9131A3783CE684A84D794F5E,31561,2,4,2,109.56792,18.28479,1765
180289,4118232D9131A3783CE684A84D794F5E,30854,5,22,17,109.56889,18.27076,1763
180290,4020F45A25B90FB7F045FA0843BE28FF,38871,13,16,3,109.44681,18.28625,1316
180291,4020F45A25B90FB7F045FA0843BE28FF,31431,17,23,6,109.44639,18.29042,1316
180310,A65416E0023DB5B05C85EFD796D8188E,31261,0,6,6,109.51174,18.2466,1559
180311,A65416E0023DB5B05C85EFD796D8188E,38291,6,9,3,109.51618,18.24313,1558
180312,A65416E0023DB5B05C85EFD796D8188E,60441,12,17,5,109.46792,18.28604,1366
180313,A65416E0023DB5B05C85EFD796D8188E,30711,18,23,5,109.50271,18.25347,1510
180323,D334753E33AD01D79142036B3D85543F,39183,5,6,1,109.55542,18.28208,1715
180324,D334753E33AD01D79142036B3D85543F,31561,6,7,1,109.56792,18.28479,1765
180342,10526BE112ADB237730F205D73F11651,38903,1,8,7,109.39229,18.29243,1117
180343,10526BE112ADB237730F205D73F11651,31681,9,11,2,109.40396,18.29979,1168
180344,10526BE112ADB237730F205D73F11651,38141,11,13,2,109.39479,18.2916,1116
180345,10526BE112ADB237730F205D73F11651,31031,16,18,2,109.49979,18.25382,1510
180346,10526BE112ADB237730F205D73F11651,38141,19,22,3,109.39479,18.2916,1116
180379,47A18820FDA9856131F74091D44B6BCB,30851,11,17,6,109.5616,18.27396,1713
180380,47A18820FDA9856131F74091D44B6BCB,31561,21,22,1,109.56792,18.28479,1765
180381,5274FB91D917823AD6AE120EE7F21099,31931,0,7,7,109.54771,18.29403,1667
180382,5274FB91D917823AD6AE120EE7F21099,60591,8,16,8,109.61118,18.21715,1904
180383,5274FB91D917823AD6AE120EE7F21099,31931,19,23,4,109.54771,18.29403,1667
180384,2E836A972A0232332CDA39E73CDA9E49,60331,0,15,15,109.505,18.26507,1512
180385,2E836A972A0232332CDA39E73CDA9E49,30421,16,19,3,109.50021,18.25861,1511
180394,46B472A67DC212EE4047EBC9FB351124,31071,0,10,10,109.58257,18.28458,1815
180395,46B472A67DC212EE4047EBC9FB351124,31071,14,16,2,109.58257,18.28458,1815
180396,46B472A67DC212EE4047EBC9FB351124,31071,17,23,6,109.58257,18.28458,1815
180419,74AD1AF2EA5153BD40BCF9A3F3F2C4E3,30854,7,18,11,109.56889,18.27076,1763
180420,74AD1AF2EA5153BD40BCF9A3F3F2C4E3,60463,18,20,2,109.52507,18.22438,1605
180421,74AD1AF2EA5153BD40BCF9A3F3F2C4E3,30854,21,23,2,109.56889,18.27076,1763
180429,A9FCE0049DB44FE004EAFBF5B783F4A5,31071,9,10,1,109.58257,18.28458,1815
180430,A9FCE0049DB44FE004EAFBF5B783F4A5,31945,11,13,2,109.58021,18.29403,1817
180431,A9FCE0049DB44FE004EAFBF5B783F4A5,31071,15,16,1,109.58257,18.28458,1815
180432,A9FCE0049DB44FE004EAFBF5B783F4A5,30854,16,23,7,109.56889,18.27076,1763
180503,0467E7A2F341B63F33E9945177D53E54,31521,0,9,9,109.51458,18.22542,1555
180505,0467E7A2F341B63F33E9945177D53E54,31521,18,20,2,109.51458,18.22542,1555
180512,2CE19795F2549AFE8556FD3526787FA2,30851,12,18,6,109.5616,18.27396,1713
180513,2CE19795F2549AFE8556FD3526787FA2,31071,20,23,3,109.58257,18.28458,1815
180514,8E06EAC16B0EF776FA1BAAC5B9747325,31541,12,13,1,109.1809,18.36722,329
180515,8E06EAC16B0EF776FA1BAAC5B9747325,30511,16,23,7,109.51069,18.24208,1558
180529,984F2D9D2B3B2392734A65DD4D02EF52,60291,0,8,8,109.50826,18.24639,1509
180534,CE0C6679CFD46FBB91046534419A41BB,31321,8,12,4,109.63799,18.23201,2007
180535,CE0C6679CFD46FBB91046534419A41BB,30361,15,17,2,109.50347,18.24,1508
180536,CE0C6679CFD46FBB91046534419A41BB,38071,18,19,1,109.40722,18.30938,1169
180537,2BC350354AEE5008A4B7C604A26746F0,31431,18,19,1,109.44639,18.29042,1316
180538,2BC350354AEE5008A4B7C604A26746F0,60401,20,22,2,109.47444,18.27583,1414
180542,E9DD0C3BA6B2B97161600872C6799D2F,60552,9,10,1,109.41729,18.30014,1218
180543,E9DD0C3BA6B2B97161600872C6799D2F,30581,12,13,1,109.62257,18.24951,1959
180544,E9DD0C3BA6B2B97161600872C6799D2F,31061,17,19,2,109.53333,18.23257,1607
180550,015CDEB9169BCE5537ABAE49B6A63F2B,30854,14,17,3,109.56889,18.27076,1763
180551,015CDEB9169BCE5537ABAE49B6A63F2B,31031,19,22,3,109.49979,18.25382,1510
180569,8AC12540A314B0C19F9DBE13856CB9EC,38094,0,8,8,109.45403,18.28778,1316
180576,BCE29A3A46F5A479B3F0FA50B11216DE,31071,4,7,3,109.58257,18.28458,1815
180577,BCE29A3A46F5A479B3F0FA50B11216DE,30854,10,11,1,109.56889,18.27076,1763
180578,C3071072DB6684DC75BE160268E6323C,30854,14,16,2,109.56889,18.27076,1763
180579,C3071072DB6684DC75BE160268E6323C,31071,18,21,3,109.58257,18.28458,1815
180580,83F8DEFB45E9970F803B6E01CF53475C,60361,0,3,3,109.51938,18.29681,1567
180581,83F8DEFB45E9970F803B6E01CF53475C,31021,4,13,9,109.49021,18.27,1463
180582,83F8DEFB45E9970F803B6E01CF53475C,60261,13,15,2,109.44326,18.3075,1319
180583,83F8DEFB45E9970F803B6E01CF53475C,31021,17,21,4,109.49021,18.27,1463
180584,83F8DEFB45E9970F803B6E01CF53475C,60221,21,23,2,109.52569,18.29188,1616
180592,2648BE3E594A9E0A865450E6976107E9,38094,0,13,13,109.45403,18.28778,1316
180595,7024F3A14F6F554DC6E80063E30315F0,31561,4,5,1,109.56792,18.28479,1765
180596,7024F3A14F6F554DC6E80063E30315F0,39183,7,9,2,109.55542,18.28208,1715
180597,7024F3A14F6F554DC6E80063E30315F0,31561,13,15,2,109.56792,18.28479,1765
180625,17E33F98086F9D71B1BE47BE6FC58756,30232,0,9,9,109.6191,18.31701,1971
180626,17E33F98086F9D71B1BE47BE6FC58756,30861,10,12,2,109.52722,18.22743,1606
180627,17E33F98086F9D71B1BE47BE6FC58756,39101,13,16,3,109.50132,18.24931,1509
180628,17E33F98086F9D71B1BE47BE6FC58756,60381,19,20,1,109.5241,18.22458,1605
180629,17E33F98086F9D71B1BE47BE6FC58756,30854,21,23,2,109.56889,18.27076,1763
180632,8EB27D2E0095A9FF48E016863044B329,30854,18,19,1,109.56889,18.27076,1763
180633,8EB27D2E0095A9FF48E016863044B329,31945,21,22,1,109.58021,18.29403,1817
180639,C316CE65034FB3C77BE459147CBF943A,60291,0,8,8,109.50826,18.24639,1509
180640,C316CE65034FB3C77BE459147CBF943A,30161,10,12,2,109.50042,18.24389,1508
180641,C316CE65034FB3C77BE459147CBF943A,31181,12,15,3,109.50382,18.24813,1509
180642,C316CE65034FB3C77BE459147CBF943A,30161,16,19,3,109.50042,18.24389,1508
180643,C316CE65034FB3C77BE459147CBF943A,31181,19,23,4,109.50382,18.24813,1509
180649,BE586ACB441383CC10D7CF3923850B73,31931,5,6,1,109.54771,18.29403,1667
180650,BE586ACB441383CC10D7CF3923850B73,39181,8,15,7,109.55153,18.28035,1715
180651,BE586ACB441383CC10D7CF3923850B73,31931,20,23,3,109.54771,18.29403,1667
180659,66C8ABAC706935076EC04B86FC9279C1,60411,0,1,1,109.32514,18.30854,869
180660,66C8ABAC706935076EC04B86FC9279C1,31471,1,5,4,109.34583,18.29563,917
180661,66C8ABAC706935076EC04B86FC9279C1,60411,6,8,2,109.32514,18.30854,869
180662,E1FCF6F0DAD733D65B4B7CF374C299B4,60054,0,5,5,109.3016,18.31229,770
180663,E1FCF6F0DAD733D65B4B7CF374C299B4,30661,5,18,13,109.37028,18.24361,1008
180697,F6B0C4B9BFBC5C0F5D704098C64B8B01,30861,19,21,2,109.52722,18.22743,1606
180698,F6B0C4B9BFBC5C0F5D704098C64B8B01,30741,21,23,2,109.49833,18.28681,1516
180699,C50EC98EBB3AD6F34D76F87C749DAC01,39181,0,13,13,109.55153,18.28035,1715
180700,C50EC98EBB3AD6F34D76F87C749DAC01,39181,14,17,3,109.55153,18.28035,1715
180701,C50EC98EBB3AD6F34D76F87C749DAC01,39181,18,23,5,109.55153,18.28035,1715
180729,2AB980E3003284F0269A1377C53CC1EB,38325,0,1,1,109.39792,18.2909,1116
180730,2AB980E3003284F0269A1377C53CC1EB,60541,3,5,2,109.4084,18.29208,1167
180731,2AB980E3003284F0269A1377C53CC1EB,38325,6,7,1,109.39792,18.2909,1116
180736,776EC15CC06379D52F8D7E811FFEB172,30711,16,21,5,109.50271,18.25347,1510
180743,F00821368F615DCDAF214035D8EC4A44,31071,0,6,6,109.58257,18.28458,1815
180744,F00821368F615DCDAF214035D8EC4A44,30854,8,23,15,109.56889,18.27076,1763
180749,FF90B6855593CFEA9A07FE008E94551D,30071,0,7,7,109.52819,18.30472,1619
180750,FF90B6855593CFEA9A07FE008E94551D,31931,8,18,10,109.54771,18.29403,1667
180751,FF90B6855593CFEA9A07FE008E94551D,30071,21,22,1,109.52819,18.30472,1619
180776,934029FB5F97BCE114EDCE88F0393A63,30854,5,13,8,109.56889,18.27076,1763
180777,934029FB5F97BCE114EDCE88F0393A63,30234,13,14,1,109.60681,18.29979,1918
180778,28A89A8FEC174286EFBBD2F96B7BCF44,60241,18,21,3,109.53319,18.28667,1616
180779,28A89A8FEC174286EFBBD2F96B7BCF44,60281,21,23,2,109.51743,18.25924,1561
180793,96F98526707B06BE1263CCD4F72E07A1,31945,0,8,8,109.58021,18.29403,1817
180794,96F98526707B06BE1263CCD4F72E07A1,30854,12,14,2,109.56889,18.27076,1763
180795,96F98526707B06BE1263CCD4F72E07A1,31945,14,17,3,109.58021,18.29403,1817
180796,96F98526707B06BE1263CCD4F72E07A1,31071,20,23,3,109.58257,18.28458,1815
180797,335A7B1DE8538918FDA774EE3E402A76,30191,0,7,7,109.50361,18.22701,1506
180798,335A7B1DE8538918FDA774EE3E402A76,31521,8,13,5,109.51458,18.22542,1555
180799,335A7B1DE8538918FDA774EE3E402A76,30191,15,23,8,109.50361,18.22701,1506
180804,E082FB5BD091C5B334EC1176FF352EE0,30071,0,7,7,109.52819,18.30472,1619
180805,E082FB5BD091C5B334EC1176FF352EE0,31931,8,11,3,109.54771,18.29403,1667
180806,E082FB5BD091C5B334EC1176FF352EE0,30071,12,22,10,109.52819,18.30472,1619
180816,AA17C9279A63248D7DCDF49F93EB8817,38275,9,17,8,109.62875,18.22938,2006
180817,AA17C9279A63248D7DCDF49F93EB8817,30854,20,22,2,109.56889,18.27076,1763
180838,B16225DD3371073720184BB0D089E6D6,31561,0,6,6,109.56792,18.28479,1765
180839,B16225DD3371073720184BB0D089E6D6,30854,7,8,1,109.56889,18.27076,1763
180840,B16225DD3371073720184BB0D089E6D6,31561,10,11,1,109.56792,18.28479,1765
180841,B16225DD3371073720184BB0D089E6D6,30854,13,14,1,109.56889,18.27076,1763
180842,A10AD66CE81CDFBC974C36FAC5FE4CAA,31071,5,8,3,109.58257,18.28458,1815
180843,A10AD66CE81CDFBC974C36FAC5FE4CAA,30854,10,18,8,109.56889,18.27076,1763
180844,6ED697962F10CC0C2236463F9FC9376B,30761,6,8,2,109.45201,18.3,1318
180845,6ED697962F10CC0C2236463F9FC9376B,30821,9,18,9,109.43681,18.33639,1274
180846,6ED697962F10CC0C2236463F9FC9376B,30761,19,22,3,109.45201,18.3,1318
180847,B93185B4820D7E0DEE74EBEA00941D15,31261,2,3,1,109.51174,18.2466,1559
180848,B93185B4820D7E0DEE74EBEA00941D15,30251,4,5,1,109.50611,18.26653,1512
180849,B93185B4820D7E0DEE74EBEA00941D15,30911,9,20,11,109.50493,18.26181,1511
180850,B93185B4820D7E0DEE74EBEA00941D15,31261,22,23,1,109.51174,18.2466,1559
180857,26C399C5B5691882722617888E25101D,38154,0,19,19,109.5266,18.28278,1615
180858,26C399C5B5691882722617888E25101D,31031,20,23,3,109.49979,18.25382,1510
180870,54A6757CA4BF8A47C41CF1DDCA6EA505,30854,1,6,5,109.56889,18.27076,1763
180871,54A6757CA4BF8A47C41CF1DDCA6EA505,60661,8,10,2,109.548,18.2377,1657
180872,54A6757CA4BF8A47C41CF1DDCA6EA505,30361,13,16,3,109.50347,18.24,1508
180893,F84D949DDCBF25D5530F771BC55E0B9D,61011,17,23,6,109.60653,18.19076,1900
180903,07169E7114E4F14C073261BAAC0D4491,61011,4,6,2,109.60653,18.19076,1900
180905,53490AD77ACCA93C3ED0F3DE79CA488B,31071,9,10,1,109.58257,18.28458,1815
180906,53490AD77ACCA93C3ED0F3DE79CA488B,30854,10,21,11,109.56889,18.27076,1763
180939,6EF68F35CE79552C1164E70C67C72C02,30121,0,9,9,109.52861,18.27222,1613
180940,6EF68F35CE79552C1164E70C67C72C02,30854,10,19,9,109.56889,18.27076,1763
180941,6EF68F35CE79552C1164E70C67C72C02,31041,20,21,1,109.50278,18.23701,1507
180942,6EF68F35CE79552C1164E70C67C72C02,30121,22,23,1,109.52861,18.27222,1613
180956,DF5038986CF763F139ACC3021B3CE64A,60594,0,8,8,109.62694,18.22799,1956
180957,DF5038986CF763F139ACC3021B3CE64A,38052,8,10,2,109.62618,18.23042,1956
180958,DF5038986CF763F139ACC3021B3CE64A,60594,14,17,3,109.62694,18.22799,1956
180986,121138E269BBF0B506FA8CE6CEB3BF52,30711,19,20,1,109.50271,18.25347,1510
180987,121138E269BBF0B506FA8CE6CEB3BF52,31931,21,22,1,109.54771,18.29403,1667
180997,9C1407835BC54BEBDB541F52E1DA1820,61011,3,23,20,109.60653,18.19076,1900
181017,C14397FECB4CD60D23F08FD75F05B3B4,30581,0,10,10,109.62257,18.24951,1959
181018,C14397FECB4CD60D23F08FD75F05B3B4,31701,14,19,5,109.44132,18.28833,1266
181019,C14397FECB4CD60D23F08FD75F05B3B4,60441,19,21,2,109.46792,18.28604,1366
181020,C14397FECB4CD60D23F08FD75F05B3B4,38094,22,23,1,109.45403,18.28778,1316
181027,116A680F1141CB1D640294F052372134,60671,0,7,7,109.52979,18.31757,1621
181028,116A680F1141CB1D640294F052372134,38241,7,8,1,109.54111,18.30542,1669
181029,116A680F1141CB1D640294F052372134,30071,12,14,2,109.52819,18.30472,1619
181089,59BC82AA673F3B026E4585AB957F187F,31521,0,10,10,109.51458,18.22542,1555
181090,59BC82AA673F3B026E4585AB957F187F,60054,13,15,2,109.3016,18.31229,770
181091,59BC82AA673F3B026E4585AB957F187F,31471,15,16,1,109.34583,18.29563,917
181092,59BC82AA673F3B026E4585AB957F187F,31521,18,23,5,109.51458,18.22542,1555
181126,B80D4B4CDBD08237A9C4254F8883AEF4,39151,0,7,7,109.49875,18.25097,1510
181127,B80D4B4CDBD08237A9C4254F8883AEF4,60201,9,12,3,109.5041,18.2509,1510
181128,B80D4B4CDBD08237A9C4254F8883AEF4,30711,12,14,2,109.50271,18.25347,1510
181129,B80D4B4CDBD08237A9C4254F8883AEF4,31171,15,17,2,109.50938,18.24917,1559
181130,B80D4B4CDBD08237A9C4254F8883AEF4,30171,20,21,1,109.48458,18.27139,1463
181149,CCCD2290FB632A48009771412BE68ADD,31561,0,13,13,109.56792,18.28479,1765
181150,CCCD2290FB632A48009771412BE68ADD,39183,17,18,1,109.55542,18.28208,1715
181151,CCCD2290FB632A48009771412BE68ADD,31561,22,23,1,109.56792,18.28479,1765
181160,796A71B0D026A7B5CB7E27471C925E8B,30911,17,18,1,109.50493,18.26181,1511
181174,DC29C676832347947F366933ECB88090,31561,3,9,6,109.56792,18.28479,1765
181175,DC29C676832347947F366933ECB88090,39183,9,11,2,109.55542,18.28208,1715
181176,DC29C676832347947F366933ECB88090,31561,13,22,9,109.56792,18.28479,1765
181229,8068F1EF55119CC805C3493D560CAAB3,30854,12,14,2,109.56889,18.27076,1763
181230,8068F1EF55119CC805C3493D560CAAB3,31071,14,16,2,109.58257,18.28458,1815
181231,8068F1EF55119CC805C3493D560CAAB3,30854,18,20,2,109.56889,18.27076,1763
181232,99CBAA6A65A50998F0A10B72B36210E4,30271,0,4,4,109.49132,18.23153,1456
181233,99CBAA6A65A50998F0A10B72B36210E4,60201,7,8,1,109.5041,18.2509,1510
181234,99CBAA6A65A50998F0A10B72B36210E4,60084,10,11,1,109.4984,18.2334,1507
181235,99CBAA6A65A50998F0A10B72B36210E4,60201,13,14,1,109.5041,18.2509,1510
181236,99CBAA6A65A50998F0A10B72B36210E4,30051,14,18,4,109.48917,18.21215,1453
181237,99CBAA6A65A50998F0A10B72B36210E4,60084,20,21,1,109.4984,18.2334,1507
181246,43922725F0A46A5D2B5FC870E087F339,30854,5,18,13,109.56889,18.27076,1763
181247,43922725F0A46A5D2B5FC870E087F339,60361,19,20,1,109.51938,18.29681,1567
181248,43922725F0A46A5D2B5FC870E087F339,30854,20,22,2,109.56889,18.27076,1763
181256,0B625DE57093602A177FF6EF2935F6D3,31081,0,10,10,109.44639,18.30181,1318
181257,0B625DE57093602A177FF6EF2935F6D3,31521,12,18,6,109.51458,18.22542,1555
181258,0B625DE57093602A177FF6EF2935F6D3,60401,20,21,1,109.47444,18.27583,1414
181259,0B625DE57093602A177FF6EF2935F6D3,31521,21,23,2,109.51458,18.22542,1555
181275,84D09807769454188E86D49181B1B5D0,30421,0,13,13,109.50021,18.25861,1511
181276,84D09807769454188E86D49181B1B5D0,31091,15,16,1,109.41201,18.31222,1170
181277,84D09807769454188E86D49181B1B5D0,30421,17,19,2,109.50021,18.25861,1511
181309,37D38EF0062E64D55C94EB554B76F9EE,30854,11,16,5,109.56889,18.27076,1763
181310,37D38EF0062E64D55C94EB554B76F9EE,30291,20,21,1,109.50403,18.27028,1513
181315,3C5AEA306E8A69C707195C4150E77D90,31931,2,6,4,109.54771,18.29403,1667
181316,3C5AEA306E8A69C707195C4150E77D90,39181,6,10,4,109.55153,18.28035,1715
181317,3C5AEA306E8A69C707195C4150E77D90,31931,11,12,1,109.54771,18.29403,1667
181318,3C5AEA306E8A69C707195C4150E77D90,39183,14,17,3,109.55542,18.28208,1715
181365,B89DA24132F66CAA79D695B4CC5F2909,60121,0,13,13,109.74507,18.37472,2430
181367,B89DA24132F66CAA79D695B4CC5F2909,60121,19,23,4,109.74507,18.37472,2430
181385,E5E2DA460104E389257158E8D8C9FBDA,60281,0,6,6,109.51743,18.25924,1561
181386,E5E2DA460104E389257158E8D8C9FBDA,60311,6,11,5,109.52097,18.24319,1558
181387,E5E2DA460104E389257158E8D8C9FBDA,60281,13,23,10,109.51743,18.25924,1561
181397,98C149D55643675CD88F276A1BCEA6F3,60321,0,1,1,109.63611,18.24306,2008
181398,98C149D55643675CD88F276A1BCEA6F3,38134,5,8,3,109.63931,18.23451,2007
181399,98C149D55643675CD88F276A1BCEA6F3,60321,8,10,2,109.63611,18.24306,2008
181400,98C149D55643675CD88F276A1BCEA6F3,30854,10,15,5,109.56889,18.27076,1763
181426,020753EF78F0A0C39658113A3377EA1E,30854,4,6,2,109.56889,18.27076,1763
181427,020753EF78F0A0C39658113A3377EA1E,39183,8,9,1,109.55542,18.28208,1715
181428,020753EF78F0A0C39658113A3377EA1E,31931,9,10,1,109.54771,18.29403,1667
181429,020753EF78F0A0C39658113A3377EA1E,31561,11,14,3,109.56792,18.28479,1765
181430,020753EF78F0A0C39658113A3377EA1E,39183,14,17,3,109.55542,18.28208,1715
181431,020753EF78F0A0C39658113A3377EA1E,31561,18,22,4,109.56792,18.28479,1765
181447,1122041491C04B199A15F6E1E401D68F,60281,0,1,1,109.51743,18.25924,1561
181448,1122041491C04B199A15F6E1E401D68F,38881,1,7,6,109.51618,18.26431,1562
181449,1122041491C04B199A15F6E1E401D68F,30711,10,11,1,109.50271,18.25347,1510
181450,1122041491C04B199A15F6E1E401D68F,30461,12,13,1,109.5116,18.26313,1562
181451,1122041491C04B199A15F6E1E401D68F,60281,15,18,3,109.51743,18.25924,1561
181452,1122041491C04B199A15F6E1E401D68F,31031,19,20,1,109.49979,18.25382,1510
181453,1122041491C04B199A15F6E1E401D68F,30461,21,23,2,109.5116,18.26313,1562
181457,7FD31F65A9E7574FDAD4A110ACBA289D,31931,1,2,1,109.54771,18.29403,1667
181458,7FD31F65A9E7574FDAD4A110ACBA289D,60371,6,7,1,109.53063,18.30056,1618
181459,7FD31F65A9E7574FDAD4A110ACBA289D,60171,9,10,1,109.51292,18.30694,1569
181528,46FB195BB21573CE6CD85D42D7B06C1A,30854,7,10,3,109.56889,18.27076,1763
181529,46FB195BB21573CE6CD85D42D7B06C1A,31164,12,15,3,109.69993,18.27215,2263
181597,213AF2099653A4ADAEF799CCC144B279,30021,0,11,11,109.12014,18.40986,86
181599,A8E9C7BB918ADAD29A3EA7ACDDCD32D7,38951,0,8,8,109.48097,18.28868,1416
181600,A8E9C7BB918ADAD29A3EA7ACDDCD32D7,38951,8,15,7,109.48097,18.28868,1416
181601,A8E9C7BB918ADAD29A3EA7ACDDCD32D7,30711,15,20,5,109.50271,18.25347,1510
181602,A8E9C7BB918ADAD29A3EA7ACDDCD32D7,38951,21,22,1,109.48097,18.28868,1416
181603,012ABD06F231728C214A4BA917E75B1C,30851,0,17,17,109.5616,18.27396,1713
181604,012ABD06F231728C214A4BA917E75B1C,31561,19,23,4,109.56792,18.28479,1765
181611,844EDA750B421C0DF1043A6AC4E51E70,30651,8,15,7,109.42611,18.385,1232
181612,844EDA750B421C0DF1043A6AC4E51E70,38871,19,21,2,109.44681,18.28625,1316
181613,844EDA750B421C0DF1043A6AC4E51E70,30651,21,23,2,109.42611,18.385,1232
181623,23C072325D16F69046C57FE53EA6F9E0,31071,1,8,7,109.58257,18.28458,1815
181624,23C072325D16F69046C57FE53EA6F9E0,30854,12,13,1,109.56889,18.27076,1763
181625,23C072325D16F69046C57FE53EA6F9E0,31071,13,23,10,109.58257,18.28458,1815
181638,1980C8D409DE9551539224B3D393CDAA,30071,1,3,2,109.52819,18.30472,1619
181639,1980C8D409DE9551539224B3D393CDAA,31951,6,8,2,109.52174,18.30299,1568
181640,1980C8D409DE9551539224B3D393CDAA,30071,8,18,10,109.52819,18.30472,1619
181641,1980C8D409DE9551539224B3D393CDAA,30071,20,22,2,109.52819,18.30472,1619
181663,FB20E84A4A99DC452BCC9B5660C3080F,39111,0,7,7,109.5191,18.22597,1555
181664,FB20E84A4A99DC452BCC9B5660C3080F,60011,10,12,2,109.48965,18.30222,1468
181665,FB20E84A4A99DC452BCC9B5660C3080F,30791,15,17,2,109.72333,18.40889,2386
181666,FB20E84A4A99DC452BCC9B5660C3080F,31521,19,20,1,109.51458,18.22542,1555
181667,FB20E84A4A99DC452BCC9B5660C3080F,31521,20,22,2,109.51458,18.22542,1555
181677,CA63110F88D6457AD774A164FA870244,30271,6,8,2,109.49132,18.23153,1456
181678,CA63110F88D6457AD774A164FA870244,60231,8,17,9,109.49903,18.21972,1504
181679,CA63110F88D6457AD774A164FA870244,60084,21,23,2,109.4984,18.2334,1507
181700,D9AE11CD16B231308C3F0FB3F53BC3E9,30854,0,1,1,109.56889,18.27076,1763
181701,D9AE11CD16B231308C3F0FB3F53BC3E9,31071,2,7,5,109.58257,18.28458,1815
181702,D9AE11CD16B231308C3F0FB3F53BC3E9,30854,9,11,2,109.56889,18.27076,1763
181703,D9AE11CD16B231308C3F0FB3F53BC3E9,31071,12,13,1,109.58257,18.28458,1815
181704,D9AE11CD16B231308C3F0FB3F53BC3E9,30854,14,15,1,109.56889,18.27076,1763
181705,D9AE11CD16B231308C3F0FB3F53BC3E9,31071,16,17,1,109.58257,18.28458,1815
181706,D9AE11CD16B231308C3F0FB3F53BC3E9,60641,18,19,1,109.53854,18.2359,1657
181707,D9AE11CD16B231308C3F0FB3F53BC3E9,38241,20,23,3,109.54111,18.30542,1669
181714,7BE3F2187062B105A4F6714C58D08E1A,31071,0,7,7,109.58257,18.28458,1815
181715,7BE3F2187062B105A4F6714C58D08E1A,30951,7,13,6,109.56208,18.25667,1761
181716,7BE3F2187062B105A4F6714C58D08E1A,31421,14,16,2,109.55382,18.22347,1705
181717,7BE3F2187062B105A4F6714C58D08E1A,31071,17,23,6,109.58257,18.28458,1815
181769,FA0EB766C44C307B69FC2247C53C674E,31031,0,7,7,109.49979,18.25382,1510
181770,FA0EB766C44C307B69FC2247C53C674E,30421,7,9,2,109.50021,18.25861,1511
181771,FA0EB766C44C307B69FC2247C53C674E,60131,12,15,3,109.49819,18.24778,1509
181772,FA0EB766C44C307B69FC2247C53C674E,30151,18,22,4,109.50986,18.25083,1560
181782,8B9A9BFD1ACAD480EB101A91DBF2024D,30421,0,2,2,109.50021,18.25861,1511
181783,8B9A9BFD1ACAD480EB101A91DBF2024D,38291,2,18,16,109.51618,18.24313,1558
181784,8B9A9BFD1ACAD480EB101A91DBF2024D,30421,18,22,4,109.50021,18.25861,1511
181785,316CEA89BB7331FA8EA1A0930D8BA877,60491,2,10,8,109.43354,18.30847,1269
181786,316CEA89BB7331FA8EA1A0930D8BA877,31031,11,13,2,109.49979,18.25382,1510
181787,316CEA89BB7331FA8EA1A0930D8BA877,30711,16,23,7,109.50271,18.25347,1510
181795,E9A67CAEAD4E146EE721320A56F893AA,31071,0,7,7,109.58257,18.28458,1815
181796,E9A67CAEAD4E146EE721320A56F893AA,30854,11,12,1,109.56889,18.27076,1763
181797,E9A67CAEAD4E146EE721320A56F893AA,31071,17,22,5,109.58257,18.28458,1815
181827,F3EA4B3DF8A619A30272A53ECD9E968F,38185,2,8,6,109.51333,18.27347,1563
181828,F3EA4B3DF8A619A30272A53ECD9E968F,38291,12,14,2,109.51618,18.24313,1558
181829,F3EA4B3DF8A619A30272A53ECD9E968F,38185,19,23,4,109.51333,18.27347,1563
181851,594298D66BAD5405EE1904C905FA9B12,30854,3,14,11,109.56889,18.27076,1763
181852,594298D66BAD5405EE1904C905FA9B12,31071,14,15,1,109.58257,18.28458,1815
181874,8752BC71725B50257436D50C6598F252,31071,0,13,13,109.58257,18.28458,1815
181875,8752BC71725B50257436D50C6598F252,30854,14,16,2,109.56889,18.27076,1763
181876,8752BC71725B50257436D50C6598F252,30234,18,20,2,109.60681,18.29979,1918
181930,189633BA4D39EBA8A203BC9E364D4B1F,30381,0,7,7,109.52521,18.24507,1609
181931,189633BA4D39EBA8A203BC9E364D4B1F,30051,12,18,6,109.48917,18.21215,1453
181932,189633BA4D39EBA8A203BC9E364D4B1F,30721,19,20,1,109.51597,18.28257,1565
181936,DC9973204E62AA99FA79F0696CF6C0F6,31945,0,7,7,109.58021,18.29403,1817
181937,DC9973204E62AA99FA79F0696CF6C0F6,30854,8,12,4,109.56889,18.27076,1763
181941,C983E73D646629A775690ECA8920EB29,31631,0,17,17,109.59542,18.36826,1879
181942,C983E73D646629A775690ECA8920EB29,31031,19,20,1,109.49979,18.25382,1510
181995,F1FA54BCDE7297F39D6C0507CA898D49,38361,1,2,1,109.43667,18.29201,1267
181996,F1FA54BCDE7297F39D6C0507CA898D49,30731,3,6,3,109.50944,18.22306,1555
181997,F1FA54BCDE7297F39D6C0507CA898D49,60551,8,13,5,109.42722,18.30111,1218
181998,F1FA54BCDE7297F39D6C0507CA898D49,38361,14,16,2,109.43667,18.29201,1267
181999,F1FA54BCDE7297F39D6C0507CA898D49,60551,17,18,1,109.42722,18.30111,1218
182000,F1FA54BCDE7297F39D6C0507CA898D49,38361,19,23,4,109.43667,18.29201,1267
182010,D4AA3869830031578B573FD0033C24A8,31931,0,9,9,109.54771,18.29403,1667
182011,D4AA3869830031578B573FD0033C24A8,60371,9,19,10,109.53063,18.30056,1618
182049,4639E7F597994307D62A7FF9CC65CC1D,30854,1,2,1,109.56889,18.27076,1763
182050,4639E7F597994307D62A7FF9CC65CC1D,31071,2,6,4,109.58257,18.28458,1815
182051,4639E7F597994307D62A7FF9CC65CC1D,30854,6,8,2,109.56889,18.27076,1763
182098,6422CB87ACC55DDEF6EBE8946593C808,31351,0,7,7,109.4959,18.28417,1465
182099,6422CB87ACC55DDEF6EBE8946593C808,31851,7,10,3,109.71736,18.29007,2316
182100,6422CB87ACC55DDEF6EBE8946593C808,60231,12,13,1,109.49903,18.21972,1504
182101,6422CB87ACC55DDEF6EBE8946593C808,31351,17,23,6,109.4959,18.28417,1465
182158,53453D8B736810206EC5A6632D159BE6,31931,0,15,15,109.54771,18.29403,1667
182159,53453D8B736810206EC5A6632D159BE6,60371,15,17,2,109.53063,18.30056,1618
182160,53453D8B736810206EC5A6632D159BE6,31931,20,23,3,109.54771,18.29403,1667
182166,73E41EC2402BE125BFADB41C15633348,39191,0,8,8,109.51493,18.23472,1557
182167,73E41EC2402BE125BFADB41C15633348,60463,10,13,3,109.52507,18.22438,1605
182169,9AA959ED87D1ECC3053DED17290EFCBD,31561,10,20,10,109.56792,18.28479,1765
182170,9AA959ED87D1ECC3053DED17290EFCBD,39183,21,23,2,109.55542,18.28208,1715
182206,ACEF2E5153AE9E10B2F445536315664A,31031,19,21,2,109.49979,18.25382,1510
182207,ACEF2E5153AE9E10B2F445536315664A,39151,21,23,2,109.49875,18.25097,1510
182227,D96E01B8E0F0DE9C160C9FEAFDCFDB6D,31021,9,10,1,109.49021,18.27,1463
182228,D96E01B8E0F0DE9C160C9FEAFDCFDB6D,31071,12,13,1,109.58257,18.28458,1815
182229,D96E01B8E0F0DE9C160C9FEAFDCFDB6D,30854,14,23,9,109.56889,18.27076,1763
182240,C6812E7C0E8E7B7313DC722FACB50779,30854,0,12,12,109.56889,18.27076,1763
182241,C6812E7C0E8E7B7313DC722FACB50779,31945,13,15,2,109.58021,18.29403,1817
182262,AA12884D86AA6006A6349FC5858AD75E,38325,16,18,2,109.39792,18.2909,1116
182263,AA12884D86AA6006A6349FC5858AD75E,31201,19,20,1,109.51042,18.23819,1558
182264,AA12884D86AA6006A6349FC5858AD75E,38903,20,23,3,109.39229,18.29243,1117
182265,C6FE4CF0CD47303AD7F7EC5A71315B10,30851,3,9,6,109.5616,18.27396,1713
182266,C6FE4CF0CD47303AD7F7EC5A71315B10,38275,10,21,11,109.62875,18.22938,2006
182272,7084657DF30063A945AAA5EF4742695F,39183,0,2,2,109.55542,18.28208,1715
182273,7084657DF30063A945AAA5EF4742695F,31561,2,6,4,109.56792,18.28479,1765
182274,7084657DF30063A945AAA5EF4742695F,31931,8,11,3,109.54771,18.29403,1667
182275,7084657DF30063A945AAA5EF4742695F,39183,11,13,2,109.55542,18.28208,1715
182276,7084657DF30063A945AAA5EF4742695F,31931,14,16,2,109.54771,18.29403,1667
182277,7084657DF30063A945AAA5EF4742695F,31071,19,20,1,109.58257,18.28458,1815
182278,7084657DF30063A945AAA5EF4742695F,39183,21,23,2,109.55542,18.28208,1715
182306,5B5FB16F9BE2A1826D497C2695908410,30854,14,15,1,109.56889,18.27076,1763
182307,5B5FB16F9BE2A1826D497C2695908410,31561,18,19,1,109.56792,18.28479,1765
182308,5B5FB16F9BE2A1826D497C2695908410,60371,20,21,1,109.53063,18.30056,1618
182345,7426A8B55792A8B93D9B7B93370F4B93,60524,0,6,6,109.42951,18.28993,1216
182346,7426A8B55792A8B93D9B7B93370F4B93,60071,10,12,2,109.75674,18.31583,2470
182347,7426A8B55792A8B93D9B7B93370F4B93,30351,16,17,1,109.41701,18.29292,1217
182348,7426A8B55792A8B93D9B7B93370F4B93,60552,18,19,1,109.41729,18.30014,1218
182349,7426A8B55792A8B93D9B7B93370F4B93,60524,20,22,2,109.42951,18.28993,1216
182350,7426A8B55792A8B93D9B7B93370F4B93,30351,22,23,1,109.41701,18.29292,1217
182378,9ADBCE363F6C95D971E05A07ACCD27F2,31945,1,2,1,109.58021,18.29403,1817
182379,9ADBCE363F6C95D971E05A07ACCD27F2,30854,4,18,14,109.56889,18.27076,1763
182380,9ADBCE363F6C95D971E05A07ACCD27F2,31071,21,23,2,109.58257,18.28458,1815
182434,7D1ED6067ECBD941EFC43CE0A6ADAE71,31071,2,3,1,109.58257,18.28458,1815
182435,7D1ED6067ECBD941EFC43CE0A6ADAE71,30854,6,16,10,109.56889,18.27076,1763
182436,7D1ED6067ECBD941EFC43CE0A6ADAE71,60463,18,21,3,109.52507,18.22438,1605
182437,84599FEEE94509A3E8D44F4C45C7CC01,31671,0,7,7,109.38965,18.29813,1068
182438,84599FEEE94509A3E8D44F4C45C7CC01,31681,8,10,2,109.40396,18.29979,1168
182439,84599FEEE94509A3E8D44F4C45C7CC01,60041,11,15,4,109.39889,18.31944,1121
182440,84599FEEE94509A3E8D44F4C45C7CC01,31681,15,17,2,109.40396,18.29979,1168
182441,84599FEEE94509A3E8D44F4C45C7CC01,31091,17,19,2,109.41201,18.31222,1170
182442,84599FEEE94509A3E8D44F4C45C7CC01,31671,20,23,3,109.38965,18.29813,1068
182443,C8922FAF66F21ECAECB6B717FCD5A53B,60614,0,13,13,109.48799,18.29521,1467
182444,C8922FAF66F21ECAECB6B717FCD5A53B,60391,14,16,2,109.47667,18.28757,1416
182445,C8922FAF66F21ECAECB6B717FCD5A53B,60614,16,22,6,109.48799,18.29521,1467
182448,9E8746086915F9D4A063A74CF0B5B7AB,30851,0,3,3,109.5616,18.27396,1713
182449,9E8746086915F9D4A063A74CF0B5B7AB,31561,3,6,3,109.56792,18.28479,1765
182450,9E8746086915F9D4A063A74CF0B5B7AB,39183,9,14,5,109.55542,18.28208,1715
182465,C69D9D9A56587BE98796607AF04788C3,31521,0,7,7,109.51458,18.22542,1555
182466,C69D9D9A56587BE98796607AF04788C3,60552,8,9,1,109.41729,18.30014,1218
182484,83F5F6CBF2A63352524671B510BBFB08,30191,0,7,7,109.50361,18.22701,1506
182485,83F5F6CBF2A63352524671B510BBFB08,31145,10,13,3,109.20431,18.30479,369
182486,83F5F6CBF2A63352524671B510BBFB08,30191,15,23,8,109.50361,18.22701,1506
182496,A503639E15A0B5D04B0130D882921438,31031,0,18,18,109.49979,18.25382,1510
182497,A503639E15A0B5D04B0130D882921438,31031,19,23,4,109.49979,18.25382,1510
182512,8255A2F4BC245ABC1F6126838351DBA2,39183,18,19,1,109.55542,18.28208,1715
182513,8255A2F4BC245ABC1F6126838351DBA2,30854,21,23,2,109.56889,18.27076,1763
182516,FD5B9AB034F15F72E8BEF02193669238,31931,8,11,3,109.54771,18.29403,1667
182517,FD5B9AB034F15F72E8BEF02193669238,60241,11,13,2,109.53319,18.28667,1616
182518,FD5B9AB034F15F72E8BEF02193669238,30921,16,17,1,109.53903,18.29451,1667
182519,FD5B9AB034F15F72E8BEF02193669238,60241,19,23,4,109.53319,18.28667,1616
182520,A83BD14E399B6923A1B4678B4F192AC2,60221,0,10,10,109.52569,18.29188,1616
182521,A83BD14E399B6923A1B4678B4F192AC2,60241,11,13,2,109.53319,18.28667,1616
182522,A83BD14E399B6923A1B4678B4F192AC2,31351,13,14,1,109.4959,18.28417,1465
182523,A83BD14E399B6923A1B4678B4F192AC2,39091,17,19,2,109.50097,18.25222,1510
182524,A83BD14E399B6923A1B4678B4F192AC2,30741,20,22,2,109.49833,18.28681,1516
182537,51DF765CB634D9549D20AD1F2C37BA18,31561,9,10,1,109.56792,18.28479,1765
182538,51DF765CB634D9549D20AD1F2C37BA18,30854,11,12,1,109.56889,18.27076,1763
182539,51DF765CB634D9549D20AD1F2C37BA18,31561,15,19,4,109.56792,18.28479,1765
182546,04ABA8BFD5D63DDF1B83BA0577C9019C,31071,9,10,1,109.58257,18.28458,1815
182547,04ABA8BFD5D63DDF1B83BA0577C9019C,39371,12,18,6,109.56627,18.2646,1762
182563,00678D3F0FE479614070948AEC721AF0,31561,0,10,10,109.56792,18.28479,1765
182564,00678D3F0FE479614070948AEC721AF0,30854,12,20,8,109.56889,18.27076,1763
182588,F7305868296354D8CCFF78E71B73969B,60391,1,6,5,109.47667,18.28757,1416
182608,E9E473F09C342630187345312F4A31D8,39181,0,8,8,109.55153,18.28035,1715
182609,E9E473F09C342630187345312F4A31D8,31931,9,10,1,109.54771,18.29403,1667
182610,E9E473F09C342630187345312F4A31D8,39181,11,14,3,109.55153,18.28035,1715
182611,E9E473F09C342630187345312F4A31D8,31931,14,15,1,109.54771,18.29403,1667
182612,E9E473F09C342630187345312F4A31D8,39181,17,23,6,109.55153,18.28035,1715
182624,08A066736557478B1013C0CF834491DF,30921,0,7,7,109.53903,18.29451,1667
182625,08A066736557478B1013C0CF834491DF,31931,10,11,1,109.54771,18.29403,1667
182626,08A066736557478B1013C0CF834491DF,30921,14,18,4,109.53903,18.29451,1667
182646,A5A15F9723FE4E2C95CB1DC28822F214,31071,0,7,7,109.58257,18.28458,1815
182647,A5A15F9723FE4E2C95CB1DC28822F214,30854,10,21,11,109.56889,18.27076,1763
182660,65E68B83464639D712CFAC5226A0F5CB,39321,0,12,12,109.529,18.2167,1604
182661,65E68B83464639D712CFAC5226A0F5CB,60131,13,14,1,109.49819,18.24778,1509
182662,65E68B83464639D712CFAC5226A0F5CB,38754,16,18,2,109.74667,18.37382,2430
182663,65E68B83464639D712CFAC5226A0F5CB,60541,21,23,2,109.4084,18.29208,1167
182683,E75CF54BA14775FEDD26504F9F6B7365,31945,0,6,6,109.58021,18.29403,1817
182684,E75CF54BA14775FEDD26504F9F6B7365,31561,8,16,8,109.56792,18.28479,1765
182685,E75CF54BA14775FEDD26504F9F6B7365,31945,19,21,2,109.58021,18.29403,1817
182716,470B644FF80F707DCE59E28652EFEBA3,31361,0,2,2,109.47417,18.28292,1415
182717,470B644FF80F707DCE59E28652EFEBA3,60391,3,5,2,109.47667,18.28757,1416
182718,470B644FF80F707DCE59E28652EFEBA3,31361,5,6,1,109.47417,18.28292,1415
182723,60C76AD19DF8888A84F620E94C92FF2B,60084,0,14,14,109.4984,18.2334,1507
182724,60C76AD19DF8888A84F620E94C92FF2B,30271,15,17,2,109.49132,18.23153,1456
182725,60C76AD19DF8888A84F620E94C92FF2B,60084,17,18,1,109.4984,18.2334,1507
182726,60C76AD19DF8888A84F620E94C92FF2B,60231,18,20,2,109.49903,18.21972,1504
182727,60C76AD19DF8888A84F620E94C92FF2B,60084,20,21,1,109.4984,18.2334,1507
182728,60C76AD19DF8888A84F620E94C92FF2B,60231,21,23,2,109.49903,18.21972,1504
182795,2AE38FAF341950B0B91404FFCE5A0F3E,30921,7,16,9,109.53903,18.29451,1667
182796,2AE38FAF341950B0B91404FFCE5A0F3E,31931,20,23,3,109.54771,18.29403,1667
182797,75616D7735994EB9CD2FE56D29700535,31561,1,9,8,109.56792,18.28479,1765
182798,75616D7735994EB9CD2FE56D29700535,30854,11,13,2,109.56889,18.27076,1763
182799,75616D7735994EB9CD2FE56D29700535,31561,14,17,3,109.56792,18.28479,1765
182800,8DA877D3A30401F86E81FB7BC1CA2A00,31071,5,7,2,109.58257,18.28458,1815
182801,8DA877D3A30401F86E81FB7BC1CA2A00,30854,10,16,6,109.56889,18.27076,1763
182802,39F25FE146A03325C93C111F2A943B6C,31945,0,7,7,109.58021,18.29403,1817
182803,39F25FE146A03325C93C111F2A943B6C,30854,7,8,1,109.56889,18.27076,1763
182804,39F25FE146A03325C93C111F2A943B6C,31071,10,16,6,109.58257,18.28458,1815
182805,39F25FE146A03325C93C111F2A943B6C,30854,16,22,6,109.56889,18.27076,1763
182808,859E4192F6E8E2E3F5C7174B3CFA1BB4,30351,0,7,7,109.41701,18.29292,1217
182809,859E4192F6E8E2E3F5C7174B3CFA1BB4,33481,9,13,4,109.67278,18.41278,2187
182810,859E4192F6E8E2E3F5C7174B3CFA1BB4,33051,14,15,1,109.6475,18.46618,2096
182811,859E4192F6E8E2E3F5C7174B3CFA1BB4,30351,17,22,5,109.41701,18.29292,1217
182830,765716C073B71E5A4C89E173E62DD881,60311,0,7,7,109.52097,18.24319,1558
182831,765716C073B71E5A4C89E173E62DD881,31931,10,15,5,109.54771,18.29403,1667
182832,765716C073B71E5A4C89E173E62DD881,60671,16,17,1,109.52979,18.31757,1621
182833,765716C073B71E5A4C89E173E62DD881,60311,19,23,4,109.52097,18.24319,1558
182869,9ECDB9C3F97E311C1827C02496967431,60371,0,7,7,109.53063,18.30056,1618
182870,9ECDB9C3F97E311C1827C02496967431,30101,8,9,1,109.57299,18.33333,1773
182871,9ECDB9C3F97E311C1827C02496967431,60371,10,13,3,109.53063,18.30056,1618
182872,9ECDB9C3F97E311C1827C02496967431,30701,14,16,2,109.59313,18.32007,1871
182873,9ECDB9C3F97E311C1827C02496967431,30101,16,17,1,109.57299,18.33333,1773
182874,9ECDB9C3F97E311C1827C02496967431,60371,18,20,2,109.53063,18.30056,1618
182902,14AE6C820CE45F96077630992CABD33D,31551,8,11,3,109.55868,18.24222,1708
182903,14AE6C820CE45F96077630992CABD33D,39371,11,13,2,109.56627,18.2646,1762
182904,14AE6C820CE45F96077630992CABD33D,30951,15,22,7,109.56208,18.25667,1761
182907,DFFF17B7FE30E79B8AABBB5CE171272F,39183,2,6,4,109.55542,18.28208,1715
182908,DFFF17B7FE30E79B8AABBB5CE171272F,31561,6,7,1,109.56792,18.28479,1765
182909,DFFF17B7FE30E79B8AABBB5CE171272F,39183,8,10,2,109.55542,18.28208,1715
182910,DFFF17B7FE30E79B8AABBB5CE171272F,31561,11,13,2,109.56792,18.28479,1765
182911,DFFF17B7FE30E79B8AABBB5CE171272F,39183,16,18,2,109.55542,18.28208,1715
182912,DFFF17B7FE30E79B8AABBB5CE171272F,31561,20,22,2,109.56792,18.28479,1765
182945,B34415F599F0ED7D1A073EE314A60B9B,31671,1,19,18,109.38965,18.29813,1068
182946,B34415F599F0ED7D1A073EE314A60B9B,60041,22,23,1,109.39889,18.31944,1121
182968,A312E6CD7504A7FEBB46DDC68FE4A7A1,39091,0,10,10,109.50097,18.25222,1510
182969,A312E6CD7504A7FEBB46DDC68FE4A7A1,31471,12,14,2,109.34583,18.29563,917
182970,A312E6CD7504A7FEBB46DDC68FE4A7A1,30711,18,23,5,109.50271,18.25347,1510
182997,DCFC026A83B81F5FB8797C8205011404,31031,20,21,1,109.49979,18.25382,1510
182998,DCFC026A83B81F5FB8797C8205011404,60084,22,23,1,109.4984,18.2334,1507
183011,E0A24740E2C54F3B77DB561A91D2BED7,30371,0,7,7,109.51,18.24771,1559
183012,E0A24740E2C54F3B77DB561A91D2BED7,30251,7,12,5,109.50611,18.26653,1512
183013,E0A24740E2C54F3B77DB561A91D2BED7,30151,13,17,4,109.50986,18.25083,1560
183014,8CD15CF6B5FB4821940FF9AFE6D6CB84,39181,0,10,10,109.55153,18.28035,1715
183015,8CD15CF6B5FB4821940FF9AFE6D6CB84,31931,12,16,4,109.54771,18.29403,1667
183016,8CD15CF6B5FB4821940FF9AFE6D6CB84,39181,19,23,4,109.55153,18.28035,1715
183025,13BA422D9C6FCE9CD249F0603D3E98AC,30421,18,20,2,109.50021,18.25861,1511
183026,13BA422D9C6FCE9CD249F0603D3E98AC,31701,20,21,1,109.44132,18.28833,1266
183027,13BA422D9C6FCE9CD249F0603D3E98AC,31431,21,23,2,109.44639,18.29042,1316
183028,29A22EA607E99C159FB2EC8DBCE0862B,30381,1,6,5,109.52521,18.24507,1609
183029,29A22EA607E99C159FB2EC8DBCE0862B,38297,7,10,3,109.52576,18.24965,1609
183030,29A22EA607E99C159FB2EC8DBCE0862B,30381,10,13,3,109.52521,18.24507,1609
183031,29A22EA607E99C159FB2EC8DBCE0862B,38911,13,14,1,109.51674,18.24965,1559
183032,29A22EA607E99C159FB2EC8DBCE0862B,30381,16,21,5,109.52521,18.24507,1609
183039,B6B3717614F59DDB2BC10343DA931DEF,30854,0,7,7,109.56889,18.27076,1763
183040,B6B3717614F59DDB2BC10343DA931DEF,31101,9,19,10,109.65389,18.23403,2057
183041,B6B3717614F59DDB2BC10343DA931DEF,39183,19,21,2,109.55542,18.28208,1715
183044,10E6DCB22C04D9E1B01193CDA87B3193,30721,20,21,1,109.51597,18.28257,1565
183045,10E6DCB22C04D9E1B01193CDA87B3193,38154,22,23,1,109.5266,18.28278,1615
183145,59FB777BFFD6221B504D668D06677EAC,38017,0,6,6,109.49729,18.21424,1504
183146,59FB777BFFD6221B504D668D06677EAC,38017,7,9,2,109.49729,18.21424,1504
183147,59FB777BFFD6221B504D668D06677EAC,31781,13,14,1,109.19847,18.2975,367
183148,59FB777BFFD6221B504D668D06677EAC,38017,16,18,2,109.49729,18.21424,1504
183149,59FB777BFFD6221B504D668D06677EAC,30711,19,21,2,109.50271,18.25347,1510
183150,59FB777BFFD6221B504D668D06677EAC,38017,22,23,1,109.49729,18.21424,1504
183168,5232A1F9DD43FADD1ACE9CE9BD82FED1,33521,10,12,2,109.66313,18.45174,2143
183169,5232A1F9DD43FADD1ACE9CE9BD82FED1,39131,14,23,9,109.2066,18.29639,417
183176,E1474E300BEF909C99028517459A2449,30854,0,10,10,109.56889,18.27076,1763
183177,E1474E300BEF909C99028517459A2449,60501,14,16,2,109.48701,18.29021,1466
183178,E1474E300BEF909C99028517459A2449,60614,20,23,3,109.48799,18.29521,1467
183187,18B397C6C5E352538250AEDC640C72E3,30581,7,18,11,109.62257,18.24951,1959
183188,18B397C6C5E352538250AEDC640C72E3,30232,20,23,3,109.6191,18.31701,1971
183189,CE100D093BF3BFDD6A311D9723805BCC,30651,4,5,1,109.42611,18.385,1232
183190,CE100D093BF3BFDD6A311D9723805BCC,38871,6,7,1,109.44681,18.28625,1316
183232,F6355456D841CBD98F176AAD0DC166BC,30151,0,8,8,109.50986,18.25083,1560
183233,F6355456D841CBD98F176AAD0DC166BC,60411,12,14,2,109.32514,18.30854,869
183234,F6355456D841CBD98F176AAD0DC166BC,31031,16,17,1,109.49979,18.25382,1510
183235,F6355456D841CBD98F176AAD0DC166BC,30151,20,23,3,109.50986,18.25083,1560
183238,03CEC0FDDD5484124514C6D24A63D4DD,31561,0,4,4,109.56792,18.28479,1765
183239,03CEC0FDDD5484124514C6D24A63D4DD,30854,4,6,2,109.56889,18.27076,1763
183240,03CEC0FDDD5484124514C6D24A63D4DD,31561,7,19,12,109.56792,18.28479,1765
183241,03CEC0FDDD5484124514C6D24A63D4DD,30854,19,23,4,109.56889,18.27076,1763
183242,CD6BC9843B399CA50E6DC7ED58C0E9DC,60631,0,1,1,109.57778,18.27583,1814
183243,CD6BC9843B399CA50E6DC7ED58C0E9DC,31071,2,20,18,109.58257,18.28458,1815
183253,87ACF3C6ADE430D2B9DFB3C954E0C031,31071,5,13,8,109.58257,18.28458,1815
183254,87ACF3C6ADE430D2B9DFB3C954E0C031,30854,14,16,2,109.56889,18.27076,1763
183255,87ACF3C6ADE430D2B9DFB3C954E0C031,39183,17,19,2,109.55542,18.28208,1715
183256,87ACF3C6ADE430D2B9DFB3C954E0C031,30854,21,23,2,109.56889,18.27076,1763
183257,5106C265E7997749AD66854B6E7AAB9E,38754,11,13,2,109.74667,18.37382,2430
183258,5106C265E7997749AD66854B6E7AAB9E,30361,17,18,1,109.50347,18.24,1508
183283,102A3C1C3179D6FF6A52B59C3B4087A1,39091,0,8,8,109.50097,18.25222,1510
183284,102A3C1C3179D6FF6A52B59C3B4087A1,30711,10,12,2,109.50271,18.25347,1510
183285,38CF8AD578A393476F29705A4599B8B1,38271,0,2,2,109.62632,18.23049,1956
183286,38CF8AD578A393476F29705A4599B8B1,31201,4,7,3,109.51042,18.23819,1558
183287,38CF8AD578A393476F29705A4599B8B1,38271,11,22,11,109.62632,18.23049,1956
183337,2F3BB5BE10811E7F8F8565DAA2126DE6,39181,0,4,4,109.55153,18.28035,1715
183338,2F3BB5BE10811E7F8F8565DAA2126DE6,39181,7,8,1,109.55153,18.28035,1715
183339,2F3BB5BE10811E7F8F8565DAA2126DE6,39181,9,23,14,109.55153,18.28035,1715
183371,27229B6D41BD7CDDDAA38911093865DB,38085,5,13,8,109.6291,18.23625,2007
183372,27229B6D41BD7CDDDAA38911093865DB,30854,16,23,7,109.56889,18.27076,1763
183411,E218C587552A5DADC05C4E69685FE374,30854,16,21,5,109.56889,18.27076,1763
183412,E218C587552A5DADC05C4E69685FE374,39371,22,23,1,109.56627,18.2646,1762
183489,1D8B814EC83D52D7C5F3FED99C129EE0,60631,0,2,2,109.57778,18.27583,1814
183490,1D8B814EC83D52D7C5F3FED99C129EE0,30854,4,9,5,109.56889,18.27076,1763
183491,1D8B814EC83D52D7C5F3FED99C129EE0,38271,11,20,9,109.62632,18.23049,1956
183492,1D8B814EC83D52D7C5F3FED99C129EE0,30851,22,23,1,109.5616,18.27396,1713
183531,960E6AF880A0B0147E779761A652C7F1,30511,18,19,1,109.51069,18.24208,1558
183532,960E6AF880A0B0147E779761A652C7F1,31391,20,23,3,109.50382,18.24285,1508
183557,F04654AC056A2E82B670DFA8C627A5F2,30071,13,15,2,109.52819,18.30472,1619
183558,F04654AC056A2E82B670DFA8C627A5F2,30081,18,23,5,109.50243,18.26632,1512
183577,C6BDCA078DA12C36FBCA53FDC4E2A328,38275,4,9,5,109.62875,18.22938,2006
183578,C6BDCA078DA12C36FBCA53FDC4E2A328,38754,11,14,3,109.74667,18.37382,2430
183592,D11BB8B2E4EFB2DA119C7E6F9B91E70A,30421,11,13,2,109.50021,18.25861,1511
183593,D11BB8B2E4EFB2DA119C7E6F9B91E70A,31201,13,15,2,109.51042,18.23819,1558
183594,D11BB8B2E4EFB2DA119C7E6F9B91E70A,39321,18,20,2,109.529,18.2167,1604
183595,D11BB8B2E4EFB2DA119C7E6F9B91E70A,31521,21,23,2,109.51458,18.22542,1555
183605,4F1F2C63B1D8098AD9ABA50013979078,30151,0,11,11,109.50986,18.25083,1560
183606,4F1F2C63B1D8098AD9ABA50013979078,30711,12,13,1,109.50271,18.25347,1510
183607,4F1F2C63B1D8098AD9ABA50013979078,60201,15,16,1,109.5041,18.2509,1510
183608,4F1F2C63B1D8098AD9ABA50013979078,30421,18,19,1,109.50021,18.25861,1511
183609,4F1F2C63B1D8098AD9ABA50013979078,30321,20,22,2,109.49563,18.29611,1467
183645,EEC6B662D07BE95423A2DC77D2E69188,31071,0,11,11,109.58257,18.28458,1815
183646,EEC6B662D07BE95423A2DC77D2E69188,30854,13,16,3,109.56889,18.27076,1763
183647,EEC6B662D07BE95423A2DC77D2E69188,31071,16,17,1,109.58257,18.28458,1815
183648,EEC6B662D07BE95423A2DC77D2E69188,30854,19,21,2,109.56889,18.27076,1763
183649,EEC6B662D07BE95423A2DC77D2E69188,31071,21,22,1,109.58257,18.28458,1815
183672,FA5380545CCB9B0D320F8A515A2E8C57,60391,8,14,6,109.47667,18.28757,1416
183673,FA5380545CCB9B0D320F8A515A2E8C57,60391,18,21,3,109.47667,18.28757,1416
183691,628B56F9AD0921837C78826286456231,60552,0,4,4,109.41729,18.30014,1218
183692,628B56F9AD0921837C78826286456231,31236,6,8,2,109.42965,18.29111,1216
183693,628B56F9AD0921837C78826286456231,31781,10,11,1,109.19847,18.2975,367
183694,628B56F9AD0921837C78826286456231,60054,14,15,1,109.3016,18.31229,770
183695,628B56F9AD0921837C78826286456231,31091,20,23,3,109.41201,18.31222,1170
183703,6BF671BC76B2463D72102139E4EB1018,60371,15,16,1,109.53063,18.30056,1618
183718,752B4C65CCCA1EA27D3C6EA24E289B9C,31071,0,7,7,109.58257,18.28458,1815
183719,752B4C65CCCA1EA27D3C6EA24E289B9C,30854,8,10,2,109.56889,18.27076,1763
183720,752B4C65CCCA1EA27D3C6EA24E289B9C,60301,13,14,1,109.60715,18.30993,1919
183721,752B4C65CCCA1EA27D3C6EA24E289B9C,30854,17,21,4,109.56889,18.27076,1763
183728,34F2C4C2BDA247D8772C3C689C546CCB,31021,18,20,2,109.49021,18.27,1463
183729,34F2C4C2BDA247D8772C3C689C546CCB,30171,21,23,2,109.48458,18.27139,1463
183733,C7A4B55787295F6419B55AB029D11243,38251,0,2,2,109.49618,18.25493,1510
183734,C7A4B55787295F6419B55AB029D11243,31531,3,5,2,109.49583,18.25972,1461
183735,C7A4B55787295F6419B55AB029D11243,38251,5,13,8,109.49618,18.25493,1510
183736,C7A4B55787295F6419B55AB029D11243,30421,13,17,4,109.50021,18.25861,1511
183737,C7A4B55787295F6419B55AB029D11243,38251,17,22,5,109.49618,18.25493,1510
183764,947F03940C60BAB03B48F948CC8A55AE,30851,0,10,10,109.5616,18.27396,1713
183765,947F03940C60BAB03B48F948CC8A55AE,39154,12,13,1,109.50201,18.25681,1511
183766,947F03940C60BAB03B48F948CC8A55AE,30854,18,23,5,109.56889,18.27076,1763
183792,C462628FF36F8FF2D0B7493E6DDA38BB,60411,0,1,1,109.32514,18.30854,869
183793,C462628FF36F8FF2D0B7493E6DDA38BB,30661,2,13,11,109.37028,18.24361,1008
183794,C462628FF36F8FF2D0B7493E6DDA38BB,60411,14,17,3,109.32514,18.30854,869
183795,5B058EBBD270D4814B560F0B36F48A4A,30351,0,8,8,109.41701,18.29292,1217
183831,036DFEF8CA623F9034F928149FE2468D,30651,0,2,2,109.42611,18.385,1232
183832,036DFEF8CA623F9034F928149FE2468D,30821,3,22,19,109.43681,18.33639,1274
183833,FCFB14BA36BDB7CD6A39612B9AE933B2,39181,14,17,3,109.55153,18.28035,1715
183834,FCFB14BA36BDB7CD6A39612B9AE933B2,38127,18,23,5,109.50833,18.27222,1513
183835,F8D799D9161B0143E0D71C40472A357E,30071,0,18,18,109.52819,18.30472,1619
183836,F8D799D9161B0143E0D71C40472A357E,30071,19,23,4,109.52819,18.30472,1619
183874,7BF65E5054DA81A230AB5423620158E1,60631,0,7,7,109.57778,18.27583,1814
183875,7BF65E5054DA81A230AB5423620158E1,30854,7,18,11,109.56889,18.27076,1763
183876,7BF65E5054DA81A230AB5423620158E1,38171,21,22,1,109.50799,18.28139,1515
183884,F37B07A401D9C93406CC2037F09DFFEF,60161,10,11,1,109.49174,18.26181,1461
183885,F37B07A401D9C93406CC2037F09DFFEF,30051,12,16,4,109.48917,18.21215,1453
183886,F37B07A401D9C93406CC2037F09DFFEF,38105,19,20,1,109.40299,18.29229,1117
183894,D12046233C14C8451AD4125CF88323E3,30201,1,7,6,109.4909,18.26465,1462
183896,D12046233C14C8451AD4125CF88323E3,31021,15,23,8,109.49021,18.27,1463
183916,C58D0182BFC61ED113EE3B09763C30B2,38185,0,7,7,109.51333,18.27347,1563
183917,C58D0182BFC61ED113EE3B09763C30B2,30281,7,9,2,109.50597,18.27583,1514
183918,C58D0182BFC61ED113EE3B09763C30B2,38127,10,15,5,109.50833,18.27222,1513
183919,C58D0182BFC61ED113EE3B09763C30B2,30711,19,20,1,109.50271,18.25347,1510
183920,C58D0182BFC61ED113EE3B09763C30B2,38185,21,23,2,109.51333,18.27347,1563
183943,E6651E3C6D8FEA2077D9EFC6D097D06C,38251,0,10,10,109.49618,18.25493,1510
183944,E6651E3C6D8FEA2077D9EFC6D097D06C,38251,10,14,4,109.49618,18.25493,1510
183945,E6651E3C6D8FEA2077D9EFC6D097D06C,38251,16,23,7,109.49618,18.25493,1510
183952,26CF9A9D015D5F6BC87A922112E6EBE3,31351,0,6,6,109.4959,18.28417,1465
183953,26CF9A9D015D5F6BC87A922112E6EBE3,60552,8,9,1,109.41729,18.30014,1218
184030,4053323049FA57896819CD5356E38746,31071,0,1,1,109.58257,18.28458,1815
184031,4053323049FA57896819CD5356E38746,30854,2,21,19,109.56889,18.27076,1763
184034,9BF33DB1F7AC1D27E06AF501C14CCF2C,31931,0,16,16,109.54771,18.29403,1667
184035,9BF33DB1F7AC1D27E06AF501C14CCF2C,30711,19,20,1,109.50271,18.25347,1510
184036,9BF33DB1F7AC1D27E06AF501C14CCF2C,31931,21,23,2,109.54771,18.29403,1667
184052,A46BA306DAEA889FAC7ACE9E5FD6A1FF,30081,0,1,1,109.50243,18.26632,1512
184053,A46BA306DAEA889FAC7ACE9E5FD6A1FF,39154,2,8,6,109.50201,18.25681,1511
184054,A46BA306DAEA889FAC7ACE9E5FD6A1FF,30911,8,9,1,109.50493,18.26181,1511
184058,E649CF84A26278291AA1A5B5C5D01FCA,30854,0,2,2,109.56889,18.27076,1763
184059,E649CF84A26278291AA1A5B5C5D01FCA,31561,3,9,6,109.56792,18.28479,1765
184065,27CFDDBDBE225F8224792B641031B794,31531,16,20,4,109.49583,18.25972,1461
184066,27CFDDBDBE225F8224792B641031B794,30351,21,23,2,109.41701,18.29292,1217
184112,6C0260646767B781577B5B8CE2471E51,38484,7,17,10,109.53028,18.31528,1620
184113,6C0260646767B781577B5B8CE2471E51,30321,18,19,1,109.49563,18.29611,1467
184114,6C0260646767B781577B5B8CE2471E51,38484,19,21,2,109.53028,18.31528,1620
184115,6C0260646767B781577B5B8CE2471E51,38484,22,23,1,109.53028,18.31528,1620
184131,52626520133C58C019E9712FB19D3224,38754,15,17,2,109.74667,18.37382,2430
184132,52626520133C58C019E9712FB19D3224,31091,17,19,2,109.41201,18.31222,1170
184133,52626520133C58C019E9712FB19D3224,30351,19,21,2,109.41701,18.29292,1217
184165,C1C69C0EAD4ABEFD1467543102429D9B,31561,0,1,1,109.56792,18.28479,1765
184166,C1C69C0EAD4ABEFD1467543102429D9B,39183,3,5,2,109.55542,18.28208,1715
184167,C1C69C0EAD4ABEFD1467543102429D9B,31561,5,8,3,109.56792,18.28479,1765
184194,26B686A42B220020984171EC7BD6742F,30854,11,12,1,109.56889,18.27076,1763
184195,26B686A42B220020984171EC7BD6742F,31071,13,14,1,109.58257,18.28458,1815
184196,26B686A42B220020984171EC7BD6742F,39183,15,22,7,109.55542,18.28208,1715
184202,431D43589A63BFD6130F6E2FA2B0A71E,31471,13,15,2,109.34583,18.29563,917
184203,431D43589A63BFD6130F6E2FA2B0A71E,30821,16,17,1,109.43681,18.33639,1274
184204,431D43589A63BFD6130F6E2FA2B0A71E,31271,19,22,3,109.48958,18.26257,1462
184213,A59893CF63A9A48BE0D9E2ED611A9BB2,60201,12,14,2,109.5041,18.2509,1510
184214,A59893CF63A9A48BE0D9E2ED611A9BB2,30084,16,18,2,109.50118,18.26972,1513
184220,F102C83FDC4F60C20EE0AB8CFB5C476F,30661,19,20,1,109.37028,18.24361,1008
184221,F102C83FDC4F60C20EE0AB8CFB5C476F,60411,21,22,1,109.32514,18.30854,869
184229,FF811E88FEA9CBDF12E5CC54DEE7CCA1,39371,17,18,1,109.56627,18.2646,1762
184230,FF811E88FEA9CBDF12E5CC54DEE7CCA1,30232,19,21,2,109.6191,18.31701,1971
184231,FF811E88FEA9CBDF12E5CC54DEE7CCA1,39371,21,23,2,109.56627,18.2646,1762
184245,8AABF5FDF2B06EB445749240A3894969,31071,0,8,8,109.58257,18.28458,1815
184246,8AABF5FDF2B06EB445749240A3894969,30854,8,14,6,109.56889,18.27076,1763
184247,8AABF5FDF2B06EB445749240A3894969,31071,18,20,2,109.58257,18.28458,1815
184248,8AABF5FDF2B06EB445749240A3894969,31561,22,23,1,109.56792,18.28479,1765
184269,4B6FFEFB36770528DA20871CE9291F99,31521,2,14,12,109.51458,18.22542,1555
184270,4B6FFEFB36770528DA20871CE9291F99,31521,15,18,3,109.51458,18.22542,1555
184271,4B6FFEFB36770528DA20871CE9291F99,39321,18,20,2,109.529,18.2167,1604
184272,4B6FFEFB36770528DA20871CE9291F99,31521,20,21,1,109.51458,18.22542,1555
184283,B2035C0684FF9CA861B7EB217CE5A160,60524,1,5,4,109.42951,18.28993,1216
184284,B2035C0684FF9CA861B7EB217CE5A160,31091,6,8,2,109.41201,18.31222,1170
184285,B2035C0684FF9CA861B7EB217CE5A160,30351,8,17,9,109.41701,18.29292,1217
184286,B2035C0684FF9CA861B7EB217CE5A160,60041,18,20,2,109.39889,18.31944,1121
184287,B2035C0684FF9CA861B7EB217CE5A160,31236,20,22,2,109.42965,18.29111,1216
184288,B2035C0684FF9CA861B7EB217CE5A160,60041,22,23,1,109.39889,18.31944,1121
184304,507CF3D1EACF4732FFA920666B1242A1,31021,18,19,1,109.49021,18.27,1463
184305,507CF3D1EACF4732FFA920666B1242A1,30171,20,22,2,109.48458,18.27139,1463
184318,FE95B3A32EFBC2838F293DF38F55FDD1,39183,2,4,2,109.55542,18.28208,1715
184319,FE95B3A32EFBC2838F293DF38F55FDD1,31561,9,11,2,109.56792,18.28479,1765
184320,FE95B3A32EFBC2838F293DF38F55FDD1,39183,12,13,1,109.55542,18.28208,1715
184321,FE95B3A32EFBC2838F293DF38F55FDD1,31561,14,15,1,109.56792,18.28479,1765
184386,E8BAAF476E8FE57075BAB1A8D4FF1780,30232,9,10,1,109.6191,18.31701,1971
184387,E8BAAF476E8FE57075BAB1A8D4FF1780,39371,12,16,4,109.56627,18.2646,1762
184404,30CE72A519D49881F23B8123486E3A02,60411,1,13,12,109.32514,18.30854,869
184405,30CE72A519D49881F23B8123486E3A02,31471,13,21,8,109.34583,18.29563,917
184406,30CE72A519D49881F23B8123486E3A02,60411,21,22,1,109.32514,18.30854,869
184423,56262E863531B59958C9E3F1A20F4447,38094,0,18,18,109.45403,18.28778,1316
184424,56262E863531B59958C9E3F1A20F4447,30361,19,20,1,109.50347,18.24,1508
184425,56262E863531B59958C9E3F1A20F4447,38094,21,22,1,109.45403,18.28778,1316
184439,9A1D1AA5EE2CD156CC396C667ED8C5B9,31071,0,6,6,109.58257,18.28458,1815
184440,9A1D1AA5EE2CD156CC396C667ED8C5B9,30854,10,16,6,109.56889,18.27076,1763
184441,9A1D1AA5EE2CD156CC396C667ED8C5B9,60631,20,21,1,109.57778,18.27583,1814
184444,0E92CE103B7D015A3121B51920E312F8,31021,0,15,15,109.49021,18.27,1463
184445,0E92CE103B7D015A3121B51920E312F8,38261,15,17,2,109.50361,18.28153,1515
184446,0E92CE103B7D015A3121B51920E312F8,30421,19,21,2,109.50021,18.25861,1511
184447,0E92CE103B7D015A3121B51920E312F8,31021,22,23,1,109.49021,18.27,1463
184508,798BF3B08F72A16A6DEAAA235F1899BB,61011,2,17,15,109.60653,18.19076,1900
184561,158EE23AC5B5E1F3FF8412E7F820E901,31561,18,20,2,109.56792,18.28479,1765
184562,158EE23AC5B5E1F3FF8412E7F820E901,31071,21,22,1,109.58257,18.28458,1815
184580,B3F017F7A9A81643FF9F81D88A6BEE4A,30854,16,18,2,109.56889,18.27076,1763
184581,B3F017F7A9A81643FF9F81D88A6BEE4A,31071,19,20,1,109.58257,18.28458,1815
184587,8FEFA204EA7EEB362556D906D163980A,30854,0,10,10,109.56889,18.27076,1763
184588,8FEFA204EA7EEB362556D906D163980A,31071,12,13,1,109.58257,18.28458,1815
184589,8FEFA204EA7EEB362556D906D163980A,30854,18,19,1,109.56889,18.27076,1763
184590,F30BE9C9754710CDCA5A89A96F673E96,30351,15,17,2,109.41701,18.29292,1217
184591,F30BE9C9754710CDCA5A89A96F673E96,60524,22,23,1,109.42951,18.28993,1216
184628,0C70A52F592FCFAC1CDC42762C9A17A0,31571,0,1,1,109.61563,18.23326,1957
184629,0C70A52F592FCFAC1CDC42762C9A17A0,38085,4,7,3,109.6291,18.23625,2007
184630,0C70A52F592FCFAC1CDC42762C9A17A0,60381,12,13,1,109.5241,18.22458,1605
184631,0C70A52F592FCFAC1CDC42762C9A17A0,31473,16,17,1,109.34792,18.29465,917
184632,0C70A52F592FCFAC1CDC42762C9A17A0,31041,18,20,2,109.50278,18.23701,1507
184633,0C70A52F592FCFAC1CDC42762C9A17A0,38085,21,23,2,109.6291,18.23625,2007
184645,FC9B7FD2465F862BBF1D529A5948B21C,30201,0,8,8,109.4909,18.26465,1462
184646,FC9B7FD2465F862BBF1D529A5948B21C,38291,8,11,3,109.51618,18.24313,1558
184647,FC9B7FD2465F862BBF1D529A5948B21C,30201,12,15,3,109.4909,18.26465,1462
184648,FC9B7FD2465F862BBF1D529A5948B21C,38291,15,17,2,109.51618,18.24313,1558
184649,FC9B7FD2465F862BBF1D529A5948B21C,30421,18,20,2,109.50021,18.25861,1511
184686,3B8907096B5BACD5BD7132435146A19A,30661,1,6,5,109.37028,18.24361,1008
184687,3B8907096B5BACD5BD7132435146A19A,60161,10,11,1,109.49174,18.26181,1461
184688,3B8907096B5BACD5BD7132435146A19A,60231,12,17,5,109.49903,18.21972,1504
184689,3B8907096B5BACD5BD7132435146A19A,30661,19,20,1,109.37028,18.24361,1008
184690,3B8907096B5BACD5BD7132435146A19A,31681,21,23,2,109.40396,18.29979,1168
184693,965E8F38FE667573C28BEF2A4D9F60FE,30721,12,13,1,109.51597,18.28257,1565
184694,965E8F38FE667573C28BEF2A4D9F60FE,39053,16,21,5,109.511,18.2771,1564
184695,965E8F38FE667573C28BEF2A4D9F60FE,30281,21,23,2,109.50597,18.27583,1514
184696,C91F430AC30B55A21F7C58F74A11754B,30854,15,16,1,109.56889,18.27076,1763
184697,C91F430AC30B55A21F7C58F74A11754B,30151,19,22,3,109.50986,18.25083,1560
184745,05C1119F8C536EC2F1AEFFF96EE8A274,38677,0,8,8,109.41854,18.29701,1217
184746,05C1119F8C536EC2F1AEFFF96EE8A274,31781,13,14,1,109.19847,18.2975,367
184747,05C1119F8C536EC2F1AEFFF96EE8A274,31521,15,17,2,109.51458,18.22542,1555
184748,05C1119F8C536EC2F1AEFFF96EE8A274,38677,20,23,3,109.41854,18.29701,1217
184756,6D11A991B84CF2421C0052A4AC5AB4C3,38271,19,23,4,109.62632,18.23049,1956
184778,C1F100A79C441D3FFDBAE922D32DC8D2,30854,0,4,4,109.56889,18.27076,1763
184779,C1F100A79C441D3FFDBAE922D32DC8D2,31945,8,9,1,109.58021,18.29403,1817
184781,6751CEC3CF9B2AE78246C7287443D2B4,31945,5,6,1,109.58021,18.29403,1817
184782,6751CEC3CF9B2AE78246C7287443D2B4,30854,7,10,3,109.56889,18.27076,1763
184783,6751CEC3CF9B2AE78246C7287443D2B4,31945,12,13,1,109.58021,18.29403,1817
184784,6751CEC3CF9B2AE78246C7287443D2B4,31071,14,16,2,109.58257,18.28458,1815
184785,6751CEC3CF9B2AE78246C7287443D2B4,30854,16,18,2,109.56889,18.27076,1763
184794,6751CEC3CF9B2AE78246C7287443D2B4,31945,0,4,4,109.58021,18.29403,1817
184795,6751CEC3CF9B2AE78246C7287443D2B4,30854,7,8,1,109.56889,18.27076,1763
184796,6751CEC3CF9B2AE78246C7287443D2B4,31071,13,14,1,109.58257,18.28458,1815
184797,6751CEC3CF9B2AE78246C7287443D2B4,60661,19,21,2,109.548,18.2377,1657
184804,8CD2F16F090DFFBF34897CAC847CB1B1,38991,0,11,11,109.52681,18.30368,1618
184805,8CD2F16F090DFFBF34897CAC847CB1B1,38316,13,14,1,109.48542,18.27424,1464
184806,8CD2F16F090DFFBF34897CAC847CB1B1,38991,18,23,5,109.52681,18.30368,1618
184807,F73FA22BCE58EDAFF289460FA5CC21E5,31531,9,11,2,109.49583,18.25972,1461
184808,F73FA22BCE58EDAFF289460FA5CC21E5,31471,12,15,3,109.34583,18.29563,917
184809,F73FA22BCE58EDAFF289460FA5CC21E5,31531,18,23,5,109.49583,18.25972,1461
184815,02C53C5746E38501957FE72E2C83CCA4,38251,0,9,9,109.49618,18.25493,1510
184816,02C53C5746E38501957FE72E2C83CCA4,31431,12,13,1,109.44639,18.29042,1316
184817,02C53C5746E38501957FE72E2C83CCA4,30651,14,15,1,109.42611,18.385,1232
184818,02C53C5746E38501957FE72E2C83CCA4,38251,15,16,1,109.49618,18.25493,1510
184842,68DBE0B52FD0AB95F1DD47068FD7847F,30181,0,11,11,109.51597,18.23313,1557
184843,68DBE0B52FD0AB95F1DD47068FD7847F,31521,12,15,3,109.51458,18.22542,1555
184844,68DBE0B52FD0AB95F1DD47068FD7847F,30181,17,23,6,109.51597,18.23313,1557
184913,882ECAD9BB7A0DC66E689517602F98B0,30891,4,8,4,109.59431,18.28389,1865
184914,882ECAD9BB7A0DC66E689517602F98B0,30221,12,13,1,109.57833,18.20222,1802
184918,8FF88CE1C7893F7B14E397F30C6E014A,30211,10,11,1,109.49882,18.23931,1508
184920,E58E5EFF0A1D7ADABE8F5BBEE665ED0D,60641,0,7,7,109.53854,18.2359,1657
184921,E58E5EFF0A1D7ADABE8F5BBEE665ED0D,31021,8,13,5,109.49021,18.27,1463
184922,E58E5EFF0A1D7ADABE8F5BBEE665ED0D,30861,14,15,1,109.52722,18.22743,1606
184923,E58E5EFF0A1D7ADABE8F5BBEE665ED0D,30861,17,19,2,109.52722,18.22743,1606
184924,25816EE0A17BD271D78FE03A1826E784,60084,0,2,2,109.4984,18.2334,1507
184925,25816EE0A17BD271D78FE03A1826E784,30271,3,8,5,109.49132,18.23153,1456
184926,25816EE0A17BD271D78FE03A1826E784,60211,10,11,1,109.63549,18.26049,2011
184944,8A4CA94771FDC32ED298939D74FF667F,31061,0,5,5,109.53333,18.23257,1607
184945,8A4CA94771FDC32ED298939D74FF667F,38094,7,10,3,109.45403,18.28778,1316
184946,8A4CA94771FDC32ED298939D74FF667F,31061,12,17,5,109.53333,18.23257,1607
184980,0FFE1266CE318D6038E5B958E6916238,31671,0,2,2,109.38965,18.29813,1068
184981,0FFE1266CE318D6038E5B958E6916238,38141,2,9,7,109.39479,18.2916,1116
184982,0FFE1266CE318D6038E5B958E6916238,38141,10,14,4,109.39479,18.2916,1116
184983,0FFE1266CE318D6038E5B958E6916238,31781,15,17,2,109.19847,18.2975,367
184984,0FFE1266CE318D6038E5B958E6916238,31671,21,23,2,109.38965,18.29813,1068
185007,D658FAED197C23209E6C54260A1F1BDD,38127,0,8,8,109.50833,18.27222,1513
185010,A9634A2AD8447824C1C9412CBBCC32E0,31534,0,6,6,109.49368,18.25806,1461
185011,A9634A2AD8447824C1C9412CBBCC32E0,31031,9,10,1,109.49979,18.25382,1510
185012,A9634A2AD8447824C1C9412CBBCC32E0,31181,11,13,2,109.50382,18.24813,1509
185013,A9634A2AD8447824C1C9412CBBCC32E0,31851,14,15,1,109.71736,18.29007,2316
185014,A9634A2AD8447824C1C9412CBBCC32E0,31534,17,18,1,109.49368,18.25806,1461
185015,A9634A2AD8447824C1C9412CBBCC32E0,31181,18,23,5,109.50382,18.24813,1509
185034,14BFE46EEAB2E234698393270A62605D,60411,0,2,2,109.32514,18.30854,869
185035,14BFE46EEAB2E234698393270A62605D,30661,3,21,18,109.37028,18.24361,1008
185036,14BFE46EEAB2E234698393270A62605D,60411,21,22,1,109.32514,18.30854,869
185039,5D5B29A994BBA3635D38463A75BE58F6,30201,0,10,10,109.4909,18.26465,1462
185041,5D5B29A994BBA3635D38463A75BE58F6,30321,17,19,2,109.49563,18.29611,1467
185087,222E0B6922623CE9FBB280F81068D40E,30371,3,4,1,109.51,18.24771,1559
185088,222E0B6922623CE9FBB280F81068D40E,30731,6,14,8,109.50944,18.22306,1555
185089,222E0B6922623CE9FBB280F81068D40E,31521,15,16,1,109.51458,18.22542,1555
185090,222E0B6922623CE9FBB280F81068D40E,31421,18,20,2,109.55382,18.22347,1705
185135,7C68E1F4B8B2F3CBBD5427BF66BF9C2E,31571,8,19,11,109.61563,18.23326,1957
185136,7C68E1F4B8B2F3CBBD5427BF66BF9C2E,30854,20,22,2,109.56889,18.27076,1763
185137,9BD095517798346F169AD6D898CA1A42,60274,0,1,1,109.514,18.2933,1567
185138,9BD095517798346F169AD6D898CA1A42,60361,3,4,1,109.51938,18.29681,1567
185139,9BD095517798346F169AD6D898CA1A42,60221,6,8,2,109.52569,18.29188,1616
185158,5403ECE41AD9921A5DEF63FF6DE6A9D1,31945,4,10,6,109.58021,18.29403,1817
185159,5403ECE41AD9921A5DEF63FF6DE6A9D1,30854,12,13,1,109.56889,18.27076,1763
185160,5403ECE41AD9921A5DEF63FF6DE6A9D1,31271,14,16,2,109.48958,18.26257,1462
185161,5403ECE41AD9921A5DEF63FF6DE6A9D1,31071,18,19,1,109.58257,18.28458,1815
185168,15195C578D4A8081B069C4B518039EFC,60231,16,17,1,109.49903,18.21972,1504
185169,15195C578D4A8081B069C4B518039EFC,60401,17,19,2,109.47444,18.27583,1414
185201,BD5D5103B08534F20AF53FB58E9A43CA,38241,6,10,4,109.54111,18.30542,1669
185202,BD5D5103B08534F20AF53FB58E9A43CA,30421,12,13,1,109.50021,18.25861,1511
185203,BD5D5103B08534F20AF53FB58E9A43CA,60381,15,20,5,109.5241,18.22458,1605
185236,372A5433078073EAD18922D679CE0A73,60054,0,6,6,109.3016,18.31229,770
185237,372A5433078073EAD18922D679CE0A73,30901,7,8,1,109.27597,18.3134,670
185238,372A5433078073EAD18922D679CE0A73,60054,9,14,5,109.3016,18.31229,770
185239,372A5433078073EAD18922D679CE0A73,60411,14,17,3,109.32514,18.30854,869
185240,372A5433078073EAD18922D679CE0A73,60054,18,23,5,109.3016,18.31229,770
185248,ADF0A7CED2B8DFD757D8FCA8B507C37E,31561,13,15,2,109.56792,18.28479,1765
185249,ADF0A7CED2B8DFD757D8FCA8B507C37E,38283,17,20,3,109.62229,18.22618,1956
185320,B023927CBEC0A8053CBDF64A5B76E367,60231,1,6,5,109.49903,18.21972,1504
185321,B023927CBEC0A8053CBDF64A5B76E367,31931,7,17,10,109.54771,18.29403,1667
185378,FF8CB3D02361FAEBFE418108180099D8,39154,0,5,5,109.50201,18.25681,1511
185379,FF8CB3D02361FAEBFE418108180099D8,60201,6,8,2,109.5041,18.2509,1510
185380,FF8CB3D02361FAEBFE418108180099D8,31261,8,9,1,109.51174,18.2466,1559
185381,FF8CB3D02361FAEBFE418108180099D8,30711,10,23,13,109.50271,18.25347,1510
185396,D4EE8E1A4C04A1FF0596E4221D0B8B42,30854,16,17,1,109.56889,18.27076,1763
185397,D4EE8E1A4C04A1FF0596E4221D0B8B42,30324,19,22,3,109.50326,18.29257,1517
185414,5A888DC7A3AA300CC584D9862C5384A1,30771,4,5,1,109.49938,18.26042,1511
185415,5A888DC7A3AA300CC584D9862C5384A1,39183,8,18,10,109.55542,18.28208,1715
185416,5A888DC7A3AA300CC584D9862C5384A1,30421,20,23,3,109.50021,18.25861,1511
185484,FBDD80570A641C18D89F4987D07601F8,31561,1,10,9,109.56792,18.28479,1765
185485,FBDD80570A641C18D89F4987D07601F8,30854,11,16,5,109.56889,18.27076,1763
185486,FBDD80570A641C18D89F4987D07601F8,31071,20,23,3,109.58257,18.28458,1815
185518,9B389AE8E9B004176803CCEAFF69104A,39371,13,16,3,109.56627,18.2646,1762
185519,9B389AE8E9B004176803CCEAFF69104A,31071,19,21,2,109.58257,18.28458,1815
185525,A9F97D2464709590426A157138F3C687,31931,0,18,18,109.54771,18.29403,1667
185526,A9F97D2464709590426A157138F3C687,39183,19,20,1,109.55542,18.28208,1715
185527,A9F97D2464709590426A157138F3C687,31931,21,22,1,109.54771,18.29403,1667
185561,C17F2EF1DEA79C8C951E3013EE071B2C,31071,12,13,1,109.58257,18.28458,1815
185562,C17F2EF1DEA79C8C951E3013EE071B2C,30854,14,16,2,109.56889,18.27076,1763
185578,879D0582077AA8488C2D5C693D7F7760,38361,0,9,9,109.43667,18.29201,1267
185579,879D0582077AA8488C2D5C693D7F7760,60201,11,12,1,109.5041,18.2509,1510
185580,879D0582077AA8488C2D5C693D7F7760,31031,12,14,2,109.49979,18.25382,1510
185581,879D0582077AA8488C2D5C693D7F7760,38361,14,23,9,109.43667,18.29201,1267
185582,3D8ADE80304FD3207128013D43F1118A,60421,1,7,6,109.46333,18.31743,1371
185583,3D8ADE80304FD3207128013D43F1118A,31781,11,12,1,109.19847,18.2975,367
185584,3D8ADE80304FD3207128013D43F1118A,30111,16,18,2,109.47583,18.30542,1419
185585,3D8ADE80304FD3207128013D43F1118A,60472,19,20,1,109.46625,18.29542,1367
185601,0442B38E8824E569B00E80CCEFC70940,31561,11,13,2,109.56792,18.28479,1765
185602,0442B38E8824E569B00E80CCEFC70940,39183,14,16,2,109.55542,18.28208,1715
185603,0442B38E8824E569B00E80CCEFC70940,31561,19,23,4,109.56792,18.28479,1765
185604,17D13F6A66037B54FAB5668CDC734401,30721,0,6,6,109.51597,18.28257,1565
185605,17D13F6A66037B54FAB5668CDC734401,31931,7,11,4,109.54771,18.29403,1667
185606,17D13F6A66037B54FAB5668CDC734401,39181,13,15,2,109.55153,18.28035,1715
185607,17D13F6A66037B54FAB5668CDC734401,30721,19,23,4,109.51597,18.28257,1565
185681,8D3B10FD4DBC46DB93DA60040668F697,30854,0,6,6,109.56889,18.27076,1763
185682,8D3B10FD4DBC46DB93DA60040668F697,31561,8,9,1,109.56792,18.28479,1765
185683,8D3B10FD4DBC46DB93DA60040668F697,30854,12,13,1,109.56889,18.27076,1763
185684,8D3B10FD4DBC46DB93DA60040668F697,31561,15,16,1,109.56792,18.28479,1765
185685,8D3B10FD4DBC46DB93DA60040668F697,30854,18,23,5,109.56889,18.27076,1763
185694,855D815DC19AA779325469411A9E7B8A,38911,3,4,1,109.51674,18.24965,1559
185695,855D815DC19AA779325469411A9E7B8A,30251,5,7,2,109.50611,18.26653,1512
185696,855D815DC19AA779325469411A9E7B8A,38157,7,10,3,109.51483,18.26958,1563
185697,855D815DC19AA779325469411A9E7B8A,30251,11,12,1,109.50611,18.26653,1512
185698,855D815DC19AA779325469411A9E7B8A,38157,13,14,1,109.51483,18.26958,1563
185707,5A9102EC5E9F0DC40E1A3F8CEDE0001B,30854,16,17,1,109.56889,18.27076,1763
185708,5A9102EC5E9F0DC40E1A3F8CEDE0001B,30861,20,21,1,109.52722,18.22743,1606
185709,5A9102EC5E9F0DC40E1A3F8CEDE0001B,30121,22,23,1,109.52861,18.27222,1613
185729,8621CFDF1B89A83351494618C53D033F,31071,0,6,6,109.58257,18.28458,1815
185730,8621CFDF1B89A83351494618C53D033F,39181,8,9,1,109.55153,18.28035,1715
185731,8621CFDF1B89A83351494618C53D033F,39181,10,15,5,109.55153,18.28035,1715
185732,8621CFDF1B89A83351494618C53D033F,39181,18,21,3,109.55153,18.28035,1715
185733,8621CFDF1B89A83351494618C53D033F,31071,21,23,2,109.58257,18.28458,1815
185783,78ACFC8C61BE9AC648F94D8A9D03B0D0,38891,0,7,7,109.51486,18.24118,1558
185784,78ACFC8C61BE9AC648F94D8A9D03B0D0,31521,7,10,3,109.51458,18.22542,1555
185785,78ACFC8C61BE9AC648F94D8A9D03B0D0,38754,13,15,2,109.74667,18.37382,2430
185786,78ACFC8C61BE9AC648F94D8A9D03B0D0,31521,19,20,1,109.51458,18.22542,1555
185787,78ACFC8C61BE9AC648F94D8A9D03B0D0,30511,21,23,2,109.51069,18.24208,1558
185797,EB291EA7E3235FF23960DA865075F183,60281,1,8,7,109.51743,18.25924,1561
185798,EB291EA7E3235FF23960DA865075F183,31145,11,12,1,109.20431,18.30479,369
185799,EB291EA7E3235FF23960DA865075F183,60161,16,17,1,109.49174,18.26181,1461
185800,EB291EA7E3235FF23960DA865075F183,60281,21,23,2,109.51743,18.25924,1561
185842,2191B2AD5C915B8862D4C345F0A13CFB,31071,6,12,6,109.58257,18.28458,1815
185843,2191B2AD5C915B8862D4C345F0A13CFB,30851,15,16,1,109.5616,18.27396,1713
185855,E9F64FD67E39C3E2C15C20715338A941,30921,0,2,2,109.53903,18.29451,1667
185856,E9F64FD67E39C3E2C15C20715338A941,60371,3,6,3,109.53063,18.30056,1618
185857,E9F64FD67E39C3E2C15C20715338A941,30921,7,11,4,109.53903,18.29451,1667
185858,E9F64FD67E39C3E2C15C20715338A941,31931,13,14,1,109.54771,18.29403,1667
185859,E9F64FD67E39C3E2C15C20715338A941,30921,14,22,8,109.53903,18.29451,1667
185923,CBA29FB366E4111071C95C99C696D0E6,30854,1,4,3,109.56889,18.27076,1763
185924,CBA29FB366E4111071C95C99C696D0E6,31561,4,5,1,109.56792,18.28479,1765
185925,CBA29FB366E4111071C95C99C696D0E6,31321,7,16,9,109.63799,18.23201,2007
185926,CBA29FB366E4111071C95C99C696D0E6,30854,19,20,1,109.56889,18.27076,1763
185927,58979C567AA82D4656FBA764FCCBAA6B,39063,15,16,1,109.386,18.2919,1066
185928,58979C567AA82D4656FBA764FCCBAA6B,31671,20,23,3,109.38965,18.29813,1068
185954,6B6C009D25FF3E364187E5021A2E374B,30791,0,8,8,109.72333,18.40889,2386
185955,6B6C009D25FF3E364187E5021A2E374B,31781,11,12,1,109.19847,18.2975,367
185956,6B6C009D25FF3E364187E5021A2E374B,60161,16,18,2,109.49174,18.26181,1461
185980,876B18E154DD33AF86D598DC340CC1E5,60101,13,14,1,109.75465,18.40139,2485
185981,876B18E154DD33AF86D598DC340CC1E5,38185,15,23,8,109.51333,18.27347,1563
186017,9CCF240AA09CA64BC883A0FAC7F89243,31521,4,16,12,109.51458,18.22542,1555
186018,9CCF240AA09CA64BC883A0FAC7F89243,60381,18,20,2,109.5241,18.22458,1605
186019,9CCF240AA09CA64BC883A0FAC7F89243,60381,20,22,2,109.5241,18.22458,1605
186032,4B004637D3CFBCA65EA00FFD3F1EF7A6,39183,2,3,1,109.55542,18.28208,1715
186033,4B004637D3CFBCA65EA00FFD3F1EF7A6,31561,5,14,9,109.56792,18.28479,1765
186034,4B004637D3CFBCA65EA00FFD3F1EF7A6,39183,15,16,1,109.55542,18.28208,1715
186035,4B004637D3CFBCA65EA00FFD3F1EF7A6,31561,20,21,1,109.56792,18.28479,1765
186044,58DE8A719D3ADBEDAE163213845B460A,31071,0,7,7,109.58257,18.28458,1815
186045,58DE8A719D3ADBEDAE163213845B460A,30854,7,12,5,109.56889,18.27076,1763
186046,58DE8A719D3ADBEDAE163213845B460A,31071,12,14,2,109.58257,18.28458,1815
186047,58DE8A719D3ADBEDAE163213845B460A,30854,14,15,1,109.56889,18.27076,1763
186048,58DE8A719D3ADBEDAE163213845B460A,31071,17,23,6,109.58257,18.28458,1815
186095,706B8E0F0F5D1C9FC2F8EBB2574EE89F,30711,0,18,18,109.50271,18.25347,1510
186096,706B8E0F0F5D1C9FC2F8EBB2574EE89F,30711,18,21,3,109.50271,18.25347,1510
186097,706B8E0F0F5D1C9FC2F8EBB2574EE89F,30711,22,23,1,109.50271,18.25347,1510
186098,E52B1449B3E12C656C55695335C2EE0A,60201,0,7,7,109.5041,18.2509,1510
186099,E52B1449B3E12C656C55695335C2EE0A,60161,7,8,1,109.49174,18.26181,1461
186100,E52B1449B3E12C656C55695335C2EE0A,30071,12,13,1,109.52819,18.30472,1619
186101,E52B1449B3E12C656C55695335C2EE0A,38275,14,16,2,109.62875,18.22938,2006
186102,E52B1449B3E12C656C55695335C2EE0A,30071,19,20,1,109.52819,18.30472,1619
186117,EBD16061EA20EE33D9344D33735E5205,38291,0,12,12,109.51618,18.24313,1558
186118,EBD16061EA20EE33D9344D33735E5205,31261,13,23,10,109.51174,18.2466,1559
186140,909FBB0C84910641E7440FBAD40E8C52,39183,0,6,6,109.55542,18.28208,1715
186141,909FBB0C84910641E7440FBAD40E8C52,31931,8,10,2,109.54771,18.29403,1667
186142,909FBB0C84910641E7440FBAD40E8C52,39183,15,23,8,109.55542,18.28208,1715
186143,E52AB7AB71324275F6E7FD670EB569C3,48574,0,6,6,109.48931,18.28458,1465
186144,E52AB7AB71324275F6E7FD670EB569C3,60501,7,8,1,109.48701,18.29021,1466
186169,7F8080706CEE97D2E7730488F93BE8CE,31931,6,15,9,109.54771,18.29403,1667
186170,7F8080706CEE97D2E7730488F93BE8CE,30891,19,20,1,109.59431,18.28389,1865
186171,7F8080706CEE97D2E7730488F93BE8CE,31071,21,23,2,109.58257,18.28458,1815
186184,DE85A2F9432633114A7B9A1B323B8AE9,30051,0,15,15,109.48917,18.21215,1453
186185,DE85A2F9432633114A7B9A1B323B8AE9,38017,15,16,1,109.49729,18.21424,1504
186186,DE85A2F9432633114A7B9A1B323B8AE9,30051,17,23,6,109.48917,18.21215,1453
186195,2F440A235E684ECEDD042B3100A4AE95,31071,0,7,7,109.58257,18.28458,1815
186196,2F440A235E684ECEDD042B3100A4AE95,30101,9,11,2,109.57299,18.33333,1773
186197,2F440A235E684ECEDD042B3100A4AE95,30854,11,13,2,109.56889,18.27076,1763
186200,0402BD114B7D5E20705E302B756CD062,60631,1,6,5,109.57778,18.27583,1814
186201,0402BD114B7D5E20705E302B756CD062,30854,7,9,2,109.56889,18.27076,1763
186202,0402BD114B7D5E20705E302B756CD062,31071,10,12,2,109.58257,18.28458,1815
186215,ACDEAAF45B65DE48CF80A48DBD3C775E,30854,0,2,2,109.56889,18.27076,1763
186216,ACDEAAF45B65DE48CF80A48DBD3C775E,31071,3,4,1,109.58257,18.28458,1815
186217,ACDEAAF45B65DE48CF80A48DBD3C775E,30854,7,9,2,109.56889,18.27076,1763
186218,ACDEAAF45B65DE48CF80A48DBD3C775E,30731,11,13,2,109.50944,18.22306,1555
186219,ACDEAAF45B65DE48CF80A48DBD3C775E,30854,17,22,5,109.56889,18.27076,1763
186234,BF521586C88C40E33C810282BBCA205D,30251,2,9,7,109.50611,18.26653,1512
186235,BF521586C88C40E33C810282BBCA205D,31461,10,11,1,109.5091,18.25389,1510
186236,BF521586C88C40E33C810282BBCA205D,31864,13,15,2,109.49014,18.28333,1465
186237,BF521586C88C40E33C810282BBCA205D,31301,18,19,1,109.14493,18.31222,170
186238,5EBEA276FCB4A19AC5C987F5C7CC8908,60401,13,15,2,109.47444,18.27583,1414
186239,5EBEA276FCB4A19AC5C987F5C7CC8908,60621,15,17,2,109.48354,18.27451,1464
186240,5EBEA276FCB4A19AC5C987F5C7CC8908,38361,17,23,6,109.43667,18.29201,1267
186241,3B6FF1F8D896A0A62DC7E65967011999,39183,1,20,19,109.55542,18.28208,1715
186242,3B6FF1F8D896A0A62DC7E65967011999,31561,22,23,1,109.56792,18.28479,1765
186259,45CBD2C3BADB5D2EDB84D5554054690B,38871,1,3,2,109.44681,18.28625,1316
186260,45CBD2C3BADB5D2EDB84D5554054690B,38094,6,8,2,109.45403,18.28778,1316
186261,45CBD2C3BADB5D2EDB84D5554054690B,30661,12,14,2,109.37028,18.24361,1008
186262,45CBD2C3BADB5D2EDB84D5554054690B,30111,19,23,4,109.47583,18.30542,1419
186267,B032E534C72FB8134F1588648D944A44,30854,0,8,8,109.56889,18.27076,1763
186268,B032E534C72FB8134F1588648D944A44,31521,13,14,1,109.51458,18.22542,1555
186269,B032E534C72FB8134F1588648D944A44,30854,15,16,1,109.56889,18.27076,1763
186270,B032E534C72FB8134F1588648D944A44,60354,18,19,1,109.58701,18.28521,1815
186282,FBC323A047041F71D8997C22FDE88F17,31431,16,17,1,109.44639,18.29042,1316
186283,FBC323A047041F71D8997C22FDE88F17,31864,19,20,1,109.49014,18.28333,1465
186286,0312B43ACF9ED1D8304E325E851AEE29,30851,7,8,1,109.5616,18.27396,1713
186287,0312B43ACF9ED1D8304E325E851AEE29,31561,8,9,1,109.56792,18.28479,1765
186288,0312B43ACF9ED1D8304E325E851AEE29,30851,9,14,5,109.5616,18.27396,1713
186289,0312B43ACF9ED1D8304E325E851AEE29,31561,14,17,3,109.56792,18.28479,1765
186290,0312B43ACF9ED1D8304E325E851AEE29,30851,17,23,6,109.5616,18.27396,1713
186300,B55959B64746A18ECF5077B5F7359221,31561,0,4,4,109.56792,18.28479,1765
186301,B55959B64746A18ECF5077B5F7359221,39183,7,8,1,109.55542,18.28208,1715
186302,B55959B64746A18ECF5077B5F7359221,31561,8,15,7,109.56792,18.28479,1765
186303,FFD6F9EB143758832EB0BC3318A1D581,60401,0,7,7,109.47444,18.27583,1414
186304,FFD6F9EB143758832EB0BC3318A1D581,31781,9,10,1,109.19847,18.2975,367
186305,FFD6F9EB143758832EB0BC3318A1D581,31471,12,13,1,109.34583,18.29563,917
186319,4BA143AD44480D9BEACA2836C34FF531,30211,6,12,6,109.49882,18.23931,1508
186320,4BA143AD44480D9BEACA2836C34FF531,60231,14,16,2,109.49903,18.21972,1504
186335,7E8F7A106D56BA02167BE8BEC6D1DCB2,31071,0,8,8,109.58257,18.28458,1815
186336,7E8F7A106D56BA02167BE8BEC6D1DCB2,60354,8,10,2,109.58701,18.28521,1815
186337,7E8F7A106D56BA02167BE8BEC6D1DCB2,30854,13,15,2,109.56889,18.27076,1763
186338,7E8F7A106D56BA02167BE8BEC6D1DCB2,31071,16,21,5,109.58257,18.28458,1815
186349,9485D4C6CDE6DE6B84BBFF7C364B13A6,60054,3,7,4,109.3016,18.31229,770
186350,9485D4C6CDE6DE6B84BBFF7C364B13A6,30661,9,12,3,109.37028,18.24361,1008
186351,9485D4C6CDE6DE6B84BBFF7C364B13A6,39061,14,23,9,109.38222,18.28958,1066
186366,01F0083CC81D0009F9AAB8F7CAA0C106,30854,1,13,12,109.56889,18.27076,1763
186367,01F0083CC81D0009F9AAB8F7CAA0C106,31071,13,16,3,109.58257,18.28458,1815
186381,C8135D3E403B7CC96352A41CBCD291A7,38241,0,6,6,109.54111,18.30542,1669
186382,C8135D3E403B7CC96352A41CBCD291A7,31931,6,7,1,109.54771,18.29403,1667
186471,B7A2800FDF738E1064EAD2A5E58F7A3C,31071,19,20,1,109.58257,18.28458,1815
186473,0B1CC3266C9F341870D0B135F2AF352E,38094,0,6,6,109.45403,18.28778,1316
186474,0B1CC3266C9F341870D0B135F2AF352E,60441,8,14,6,109.46792,18.28604,1366
186496,64F4CDF664AA04E7B79DE93C57128CF6,31931,0,7,7,109.54771,18.29403,1667
186497,64F4CDF664AA04E7B79DE93C57128CF6,39181,8,16,8,109.55153,18.28035,1715
186503,2784AD65C6F3580D4FC580DB3654BC4C,31521,10,16,6,109.51458,18.22542,1555
186504,2784AD65C6F3580D4FC580DB3654BC4C,60381,20,21,1,109.5241,18.22458,1605
186507,45CCFCD3EBDF941E1C92B70ED06E8B5E,31561,2,3,1,109.56792,18.28479,1765
186508,45CCFCD3EBDF941E1C92B70ED06E8B5E,30854,4,8,4,109.56889,18.27076,1763
186509,45CCFCD3EBDF941E1C92B70ED06E8B5E,31945,8,9,1,109.58021,18.29403,1817
186510,E885B3923220582401E6F1A363A3329C,39183,1,2,1,109.55542,18.28208,1715
186511,E885B3923220582401E6F1A363A3329C,30854,2,5,3,109.56889,18.27076,1763
186512,E885B3923220582401E6F1A363A3329C,39183,6,8,2,109.55542,18.28208,1715
186513,E885B3923220582401E6F1A363A3329C,31071,8,10,2,109.58257,18.28458,1815
186514,E885B3923220582401E6F1A363A3329C,30221,12,13,1,109.57833,18.20222,1802
186515,E885B3923220582401E6F1A363A3329C,30731,15,16,1,109.50944,18.22306,1555
186542,6B806948BC9187A91D033B4096721B00,31561,0,5,5,109.56792,18.28479,1765
186543,6B806948BC9187A91D033B4096721B00,30851,8,9,1,109.5616,18.27396,1713
186544,6B806948BC9187A91D033B4096721B00,31071,12,20,8,109.58257,18.28458,1815
186549,354DC607408BB828F25BA014BE4B0A10,38111,11,16,5,109.52007,18.22403,1555
186550,354DC607408BB828F25BA014BE4B0A10,30731,17,20,3,109.50944,18.22306,1555
186551,354DC607408BB828F25BA014BE4B0A10,39111,22,23,1,109.5191,18.22597,1555
186552,F621296F333E8058687ACD884B135C6E,30504,0,5,5,109.705,18.35368,2277
186553,F621296F333E8058687ACD884B135C6E,30711,9,10,1,109.50271,18.25347,1510
186554,F621296F333E8058687ACD884B135C6E,31351,10,14,4,109.4959,18.28417,1465
186626,2183AF5A97756EB05E1459D1CE0BD7C7,31931,14,15,1,109.54771,18.29403,1667
186627,2183AF5A97756EB05E1459D1CE0BD7C7,60371,17,20,3,109.53063,18.30056,1618
186628,2183AF5A97756EB05E1459D1CE0BD7C7,31931,20,23,3,109.54771,18.29403,1667
186644,E65658506C2BF9C993BA69EE6D38B3C6,60361,0,2,2,109.51938,18.29681,1567
186645,E65658506C2BF9C993BA69EE6D38B3C6,31951,3,4,1,109.52174,18.30299,1568
186646,E65658506C2BF9C993BA69EE6D38B3C6,60361,4,6,2,109.51938,18.29681,1567
186647,E65658506C2BF9C993BA69EE6D38B3C6,31951,6,9,3,109.52174,18.30299,1568
186648,E65658506C2BF9C993BA69EE6D38B3C6,60361,9,12,3,109.51938,18.29681,1567
186690,1C25334EE7BA1B02FAAADA4861FD1792,39111,1,3,2,109.5191,18.22597,1555
186691,1C25334EE7BA1B02FAAADA4861FD1792,60381,5,8,3,109.5241,18.22458,1605
186692,1C25334EE7BA1B02FAAADA4861FD1792,31781,10,13,3,109.19847,18.2975,367
186693,1C25334EE7BA1B02FAAADA4861FD1792,60381,17,18,1,109.5241,18.22458,1605
186694,1C25334EE7BA1B02FAAADA4861FD1792,31521,20,23,3,109.51458,18.22542,1555
186707,5AE5291D69C9CAB9DE596EEA8E795748,31391,2,4,2,109.50382,18.24285,1508
186708,5AE5291D69C9CAB9DE596EEA8E795748,31521,4,5,1,109.51458,18.22542,1555
186709,5AE5291D69C9CAB9DE596EEA8E795748,60381,7,8,1,109.5241,18.22458,1605
186710,5AE5291D69C9CAB9DE596EEA8E795748,33051,12,15,3,109.6475,18.46618,2096
186711,5AE5291D69C9CAB9DE596EEA8E795748,31521,19,21,2,109.51458,18.22542,1555
186723,14DC9638CB494ECD60B58F300BAA61B6,39181,0,11,11,109.55153,18.28035,1715
186724,14DC9638CB494ECD60B58F300BAA61B6,39181,11,13,2,109.55153,18.28035,1715
186725,14DC9638CB494ECD60B58F300BAA61B6,39181,15,23,8,109.55153,18.28035,1715
186726,76B21384CC3EFE3F43353B93FDFE32EE,30821,2,7,5,109.43681,18.33639,1274
186727,76B21384CC3EFE3F43353B93FDFE32EE,30651,7,8,1,109.42611,18.385,1232
186728,76B21384CC3EFE3F43353B93FDFE32EE,30821,12,23,11,109.43681,18.33639,1274
186732,4EC716C6116001DCCA61DAB5E48F9371,60524,2,3,1,109.42951,18.28993,1216
186733,4EC716C6116001DCCA61DAB5E48F9371,60552,7,11,4,109.41729,18.30014,1218
186734,4EC716C6116001DCCA61DAB5E48F9371,60401,12,13,1,109.47444,18.27583,1414
186735,4EC716C6116001DCCA61DAB5E48F9371,31031,19,20,1,109.49979,18.25382,1510
186736,4EC716C6116001DCCA61DAB5E48F9371,39321,21,22,1,109.529,18.2167,1604
186768,9C068F0C3303F33ADE079F339455F990,30181,13,15,2,109.51597,18.23313,1557
186769,9C068F0C3303F33ADE079F339455F990,31521,16,18,2,109.51458,18.22542,1555
186770,9C068F0C3303F33ADE079F339455F990,30711,19,20,1,109.50271,18.25347,1510
186820,6587551DA47309E484D1302521C8D417,60631,1,6,5,109.57778,18.27583,1814
186821,6587551DA47309E484D1302521C8D417,38275,8,19,11,109.62875,18.22938,2006
186827,EFDE35289FEC1E13D6F34EFEE66A8AD2,60631,17,19,2,109.57778,18.27583,1814
186828,EFDE35289FEC1E13D6F34EFEE66A8AD2,60571,21,23,2,109.50722,18.25056,1510
186857,DA10676C4DA702E02A2C3FFFAC40ABA2,31561,9,13,4,109.56792,18.28479,1765
186858,DA10676C4DA702E02A2C3FFFAC40ABA2,39183,18,19,1,109.55542,18.28208,1715
186859,DA10676C4DA702E02A2C3FFFAC40ABA2,31561,19,21,2,109.56792,18.28479,1765
186866,3977578BE56276DA0700B04B81DC1356,31561,2,17,15,109.56792,18.28479,1765
186867,3977578BE56276DA0700B04B81DC1356,30851,17,20,3,109.5616,18.27396,1713
186868,3977578BE56276DA0700B04B81DC1356,31561,22,23,1,109.56792,18.28479,1765
186923,AD608A919061B1C684914F8654FB2493,31251,13,15,2,109.18528,18.2975,317
186924,AD608A919061B1C684914F8654FB2493,31231,18,19,1,109.42597,18.29292,1217
186925,D37BF241A4A35F0F341582CAF9EF0DD2,60221,1,5,4,109.52569,18.29188,1616
186926,D37BF241A4A35F0F341582CAF9EF0DD2,38251,10,13,3,109.49618,18.25493,1510
186927,D37BF241A4A35F0F341582CAF9EF0DD2,31205,15,17,2,109.51111,18.23736,1557
186928,D37BF241A4A35F0F341582CAF9EF0DD2,38291,18,19,1,109.51618,18.24313,1558
186929,D37BF241A4A35F0F341582CAF9EF0DD2,38251,19,23,4,109.49618,18.25493,1510
186938,0133DDFFB5CECBB261CEDEF10A82D50B,31561,0,4,4,109.56792,18.28479,1765
186939,0133DDFFB5CECBB261CEDEF10A82D50B,30854,6,8,2,109.56889,18.27076,1763
186940,0133DDFFB5CECBB261CEDEF10A82D50B,31561,8,11,3,109.56792,18.28479,1765
186941,0133DDFFB5CECBB261CEDEF10A82D50B,31071,12,13,1,109.58257,18.28458,1815
186942,0133DDFFB5CECBB261CEDEF10A82D50B,31561,14,15,1,109.56792,18.28479,1765
186943,0133DDFFB5CECBB261CEDEF10A82D50B,30854,20,22,2,109.56889,18.27076,1763
186948,638580236EF215868960D2AF9691D2BA,38052,0,8,8,109.62618,18.23042,1956
186949,638580236EF215868960D2AF9691D2BA,31781,10,13,3,109.19847,18.2975,367
186950,638580236EF215868960D2AF9691D2BA,30441,16,18,2,109.64021,18.25424,2010
186951,638580236EF215868960D2AF9691D2BA,30354,19,20,1,109.42813,18.29076,1216
186979,0E129C09250C0D46273B4BD7E5225556,30151,0,6,6,109.50986,18.25083,1560
186980,0E129C09250C0D46273B4BD7E5225556,60201,6,9,3,109.5041,18.2509,1510
186981,0E129C09250C0D46273B4BD7E5225556,60401,10,12,2,109.47444,18.27583,1414
186982,0E129C09250C0D46273B4BD7E5225556,60441,12,16,4,109.46792,18.28604,1366
186983,0E129C09250C0D46273B4BD7E5225556,60281,20,23,3,109.51743,18.25924,1561
187003,E8837AFD996CC82B70ED442FBB169EAD,38013,0,8,8,109.49514,18.21951,1454
187005,E8837AFD996CC82B70ED442FBB169EAD,30901,14,15,1,109.27597,18.3134,670
187014,23DF42FF4E6B61B09E6A4E456F67A952,38361,0,2,2,109.43667,18.29201,1267
187015,23DF42FF4E6B61B09E6A4E456F67A952,30051,2,5,3,109.48917,18.21215,1453
187016,23DF42FF4E6B61B09E6A4E456F67A952,38361,6,7,1,109.43667,18.29201,1267
187017,23DF42FF4E6B61B09E6A4E456F67A952,31781,8,10,2,109.19847,18.2975,367
187027,5D4E252AC551D7DB97A6F7C764F981F2,38127,13,16,3,109.50833,18.27222,1513
187028,5D4E252AC551D7DB97A6F7C764F981F2,31351,18,23,5,109.4959,18.28417,1465
187034,C709D01469E0800AF998DFAF42105CDC,30854,2,3,1,109.56889,18.27076,1763
187035,C709D01469E0800AF998DFAF42105CDC,31561,6,15,9,109.56792,18.28479,1765
187050,C957C5FFC60830A667C461DE5D4133C9,60381,20,23,3,109.5241,18.22458,1605
187056,FA14B010F60C7FB3B13194FAA13740E8,31561,1,3,2,109.56792,18.28479,1765
187057,FA14B010F60C7FB3B13194FAA13740E8,30851,4,5,1,109.5616,18.27396,1713
187058,FA14B010F60C7FB3B13194FAA13740E8,39183,10,11,1,109.55542,18.28208,1715
187059,FA14B010F60C7FB3B13194FAA13740E8,31561,13,21,8,109.56792,18.28479,1765
187063,451E2BF48CD7B253EB0892324E679BCC,38297,0,4,4,109.52576,18.24965,1609
187064,451E2BF48CD7B253EB0892324E679BCC,60281,5,11,6,109.51743,18.25924,1561
187065,451E2BF48CD7B253EB0892324E679BCC,38291,11,13,2,109.51618,18.24313,1558
187066,451E2BF48CD7B253EB0892324E679BCC,60281,14,18,4,109.51743,18.25924,1561
187067,451E2BF48CD7B253EB0892324E679BCC,38291,18,20,2,109.51618,18.24313,1558
187068,451E2BF48CD7B253EB0892324E679BCC,38297,20,22,2,109.52576,18.24965,1609
187069,A5351FE9BD2860440534F7277F893732,30111,0,7,7,109.47583,18.30542,1419
187070,A5351FE9BD2860440534F7277F893732,31471,9,10,1,109.34583,18.29563,917
187071,A5351FE9BD2860440534F7277F893732,39154,13,14,1,109.50201,18.25681,1511
187072,A5351FE9BD2860440534F7277F893732,38251,15,19,4,109.49618,18.25493,1510
187073,A5351FE9BD2860440534F7277F893732,30421,20,21,1,109.50021,18.25861,1511
187074,A5351FE9BD2860440534F7277F893732,30421,21,23,2,109.50021,18.25861,1511
187076,C7D574CBE15EDD2D6A977D5207AF0BA3,31471,9,11,2,109.34583,18.29563,917
187077,C7D574CBE15EDD2D6A977D5207AF0BA3,33051,14,15,1,109.6475,18.46618,2096
187131,93715618B304E009FF2F157425BB5843,30421,11,14,3,109.50021,18.25861,1511
187132,93715618B304E009FF2F157425BB5843,30181,18,20,2,109.51597,18.23313,1557
187133,93715618B304E009FF2F157425BB5843,60504,21,23,2,109.47917,18.28903,1416
187142,4F3A073B0E00F2C591EAC7CA3550DBAE,30851,3,4,1,109.5616,18.27396,1713
187143,4F3A073B0E00F2C591EAC7CA3550DBAE,39181,4,6,2,109.55153,18.28035,1715
187144,4F3A073B0E00F2C591EAC7CA3550DBAE,39181,8,9,1,109.55153,18.28035,1715
187145,4F3A073B0E00F2C591EAC7CA3550DBAE,31071,12,13,1,109.58257,18.28458,1815
187146,4F3A073B0E00F2C591EAC7CA3550DBAE,39181,13,16,3,109.55153,18.28035,1715
187147,4F3A073B0E00F2C591EAC7CA3550DBAE,31071,18,19,1,109.58257,18.28458,1815
187163,0E5593A90D661690BE3DAAA17AD936E2,38127,0,7,7,109.50833,18.27222,1513
187164,0E5593A90D661690BE3DAAA17AD936E2,38073,9,14,5,109.40813,18.30958,1169
187165,0E5593A90D661690BE3DAAA17AD936E2,30281,17,18,1,109.50597,18.27583,1514
187166,0E5593A90D661690BE3DAAA17AD936E2,31271,19,21,2,109.48958,18.26257,1462
187169,DDE77D3A656666992FC3458B84010D43,39183,0,3,3,109.55542,18.28208,1715
187170,DDE77D3A656666992FC3458B84010D43,31561,7,8,1,109.56792,18.28479,1765
187171,DDE77D3A656666992FC3458B84010D43,39183,12,14,2,109.55542,18.28208,1715
187198,C8B662CAEBDC359FAD2D68CB046F51F0,30681,10,11,1,109.48493,18.26917,1463
187199,C8B662CAEBDC359FAD2D68CB046F51F0,60401,13,14,1,109.47444,18.27583,1414
187200,C8B662CAEBDC359FAD2D68CB046F51F0,30681,15,16,1,109.48493,18.26917,1463
187201,C8B662CAEBDC359FAD2D68CB046F51F0,30171,16,21,5,109.48458,18.27139,1463
187202,2C3BD53A8702A47FB82F05FB4993B683,31561,2,3,1,109.56792,18.28479,1765
187203,2C3BD53A8702A47FB82F05FB4993B683,39181,7,9,2,109.55153,18.28035,1715
187204,2C3BD53A8702A47FB82F05FB4993B683,31561,11,22,11,109.56792,18.28479,1765
187210,8FAAC7EA21AE7BB6F52A4D0F285944CD,38721,0,8,8,109.50368,18.27542,1514
187211,8FAAC7EA21AE7BB6F52A4D0F285944CD,30281,9,10,1,109.50597,18.27583,1514
187212,8FAAC7EA21AE7BB6F52A4D0F285944CD,30281,11,13,2,109.50597,18.27583,1514
187213,8FAAC7EA21AE7BB6F52A4D0F285944CD,30281,18,20,2,109.50597,18.27583,1514
187214,8FAAC7EA21AE7BB6F52A4D0F285944CD,38151,21,23,2,109.51361,18.26542,1562
187225,F6A1EBB84FE583E84185C423218578F5,39183,13,15,2,109.55542,18.28208,1715
187226,F6A1EBB84FE583E84185C423218578F5,31561,18,19,1,109.56792,18.28479,1765
187263,8A0FB0898366225E4559ACD305792D50,30121,0,9,9,109.52861,18.27222,1613
187264,8A0FB0898366225E4559ACD305792D50,38347,9,16,7,109.4934,18.21444,1454
187265,8A0FB0898366225E4559ACD305792D50,30421,19,20,1,109.50021,18.25861,1511
187293,12E2C9356A230BE21C77839B0896D677,30854,12,13,1,109.56889,18.27076,1763
187294,12E2C9356A230BE21C77839B0896D677,31071,15,19,4,109.58257,18.28458,1815
187295,12E2C9356A230BE21C77839B0896D677,60631,20,21,1,109.57778,18.27583,1814
187296,12E2C9356A230BE21C77839B0896D677,31071,21,23,2,109.58257,18.28458,1815
187314,DD45307798B5E5E871398410DD7318C5,31145,13,14,1,109.20431,18.30479,369
187328,2951B609D4809F44409A5DD8DDED7FBC,60594,1,8,7,109.62694,18.22799,1956
187329,2951B609D4809F44409A5DD8DDED7FBC,38052,10,13,3,109.62618,18.23042,1956
187330,2951B609D4809F44409A5DD8DDED7FBC,60594,13,15,2,109.62694,18.22799,1956
187331,2951B609D4809F44409A5DD8DDED7FBC,38331,19,23,4,109.62465,18.22736,1956
187363,ADDDEBD546B43FF699A163EB1EA5FE50,38251,18,19,1,109.49618,18.25493,1510
187380,1758F7A03033DAF462A8174615B0DBCE,31321,18,19,1,109.63799,18.23201,2007
187381,1758F7A03033DAF462A8174615B0DBCE,38331,19,22,3,109.62465,18.22736,1956
187406,E1B4EE5B2DAE31219B37A92CAB40AC2A,60401,10,13,3,109.47444,18.27583,1414
187407,E1B4EE5B2DAE31219B37A92CAB40AC2A,31531,14,20,6,109.49583,18.25972,1461
187417,34AB502A442AA8EA4A7FB30471B204DB,38325,4,6,2,109.39792,18.2909,1116
187418,34AB502A442AA8EA4A7FB30471B204DB,31431,8,9,1,109.44639,18.29042,1316
187419,34AB502A442AA8EA4A7FB30471B204DB,38094,10,11,1,109.45403,18.28778,1316
187420,34AB502A442AA8EA4A7FB30471B204DB,30341,13,14,1,109.3625,18.29167,966
187428,1A1B5C664F8D6460240C73AB76187420,30854,0,1,1,109.56889,18.27076,1763
187429,1A1B5C664F8D6460240C73AB76187420,31071,1,7,6,109.58257,18.28458,1815
187430,1A1B5C664F8D6460240C73AB76187420,30854,7,9,2,109.56889,18.27076,1763
187457,CD576F1C1CDFB89E6A99A20E65927346,31561,2,12,10,109.56792,18.28479,1765
187458,CD576F1C1CDFB89E6A99A20E65927346,30854,13,21,8,109.56889,18.27076,1763
187471,0695D4E7B3E726CA09D841B87798B560,31561,0,2,2,109.56792,18.28479,1765
187472,0695D4E7B3E726CA09D841B87798B560,60354,5,6,1,109.58701,18.28521,1815
187473,0695D4E7B3E726CA09D841B87798B560,30854,8,14,6,109.56889,18.27076,1763
187485,B712327B6033C61F37801CFD6DAC08AD,38484,3,4,1,109.53028,18.31528,1620
187486,B712327B6033C61F37801CFD6DAC08AD,38484,7,10,3,109.53028,18.31528,1620
187487,B712327B6033C61F37801CFD6DAC08AD,38484,12,14,2,109.53028,18.31528,1620
187488,B712327B6033C61F37801CFD6DAC08AD,38484,14,18,4,109.53028,18.31528,1620
187489,B712327B6033C61F37801CFD6DAC08AD,38484,20,22,2,109.53028,18.31528,1620
187513,63FBAC0202144B00077561285E6A7F87,30821,4,13,9,109.43681,18.33639,1274
187514,63FBAC0202144B00077561285E6A7F87,30651,14,16,2,109.42611,18.385,1232
187515,63FBAC0202144B00077561285E6A7F87,30821,16,23,7,109.43681,18.33639,1274
187597,89362A3CA3AE6F5B75871F2110924F99,30851,0,6,6,109.5616,18.27396,1713
187598,89362A3CA3AE6F5B75871F2110924F99,39371,8,9,1,109.56627,18.2646,1762
187599,89362A3CA3AE6F5B75871F2110924F99,31551,12,16,4,109.55868,18.24222,1708
187600,89362A3CA3AE6F5B75871F2110924F99,30851,16,23,7,109.5616,18.27396,1713
187613,5533066D8871087CCD481B88DD73EF7D,31361,0,8,8,109.47417,18.28292,1415
187614,5533066D8871087CCD481B88DD73EF7D,60401,10,18,8,109.47444,18.27583,1414
187615,5533066D8871087CCD481B88DD73EF7D,31361,18,23,5,109.47417,18.28292,1415
187620,77D805C7CC3CDE277FD34ED04AB294D2,31521,0,2,2,109.51458,18.22542,1555
187621,77D805C7CC3CDE277FD34ED04AB294D2,39321,5,11,6,109.529,18.2167,1604
187622,77D805C7CC3CDE277FD34ED04AB294D2,31521,13,16,3,109.51458,18.22542,1555
187623,77D805C7CC3CDE277FD34ED04AB294D2,60381,19,21,2,109.5241,18.22458,1605
187654,7FF3C6569A3990C03CAF6C52D3C8BC6C,31931,7,16,9,109.54771,18.29403,1667
187655,7FF3C6569A3990C03CAF6C52D3C8BC6C,30921,18,23,5,109.53903,18.29451,1667
187663,B78E7295CB13532B4E2C30EF158E297F,30854,2,5,3,109.56889,18.27076,1763
187664,B78E7295CB13532B4E2C30EF158E297F,31931,5,10,5,109.54771,18.29403,1667
187665,B78E7295CB13532B4E2C30EF158E297F,30851,12,15,3,109.5616,18.27396,1713
187694,AA2A5396AD753E9245AC53C94BAEDECD,61011,2,5,3,109.60653,18.19076,1900
187696,AA2A5396AD753E9245AC53C94BAEDECD,61011,11,20,9,109.60653,18.19076,1900
187721,A9263BE9008920F9142A0014B55D5185,60401,0,7,7,109.47444,18.27583,1414
187722,A9263BE9008920F9142A0014B55D5185,31781,9,10,1,109.19847,18.2975,367
187723,A9263BE9008920F9142A0014B55D5185,31471,12,13,1,109.34583,18.29563,917
187730,182D5101D28D51096306D4EF5FDD4501,60084,2,6,4,109.4984,18.2334,1507
187731,182D5101D28D51096306D4EF5FDD4501,30361,9,11,2,109.50347,18.24,1508
187785,18073AD9E71B8DFC1E520C5E3653B1BD,31951,0,14,14,109.52174,18.30299,1568
187786,18073AD9E71B8DFC1E520C5E3653B1BD,30421,16,18,2,109.50021,18.25861,1511
187787,18073AD9E71B8DFC1E520C5E3653B1BD,30771,19,20,1,109.49938,18.26042,1511
187817,A6AC80D1B196B7846A22B3CFEA4051A4,60661,0,8,8,109.548,18.2377,1657
187819,A6AC80D1B196B7846A22B3CFEA4051A4,60661,18,22,4,109.548,18.2377,1657
187839,76DA946F4DC1318DD46A32E1D303D6B7,39181,16,17,1,109.55153,18.28035,1715
187840,76DA946F4DC1318DD46A32E1D303D6B7,31931,21,22,1,109.54771,18.29403,1667
187848,975CB35586D2D95A387E2AA86A5AB719,30671,0,8,8,109.43611,18.30139,1268
187849,975CB35586D2D95A387E2AA86A5AB719,31351,11,13,2,109.4959,18.28417,1465
187850,975CB35586D2D95A387E2AA86A5AB719,30271,14,15,1,109.49132,18.23153,1456
187869,491A112CD81B9085F752897809919691,31201,0,14,14,109.51042,18.23819,1558
187870,491A112CD81B9085F752897809919691,60201,14,15,1,109.5041,18.2509,1510
187871,491A112CD81B9085F752897809919691,31201,20,23,3,109.51042,18.23819,1558
187897,807332CEC38772FA8DF98C48FBD8DD1E,31561,16,17,1,109.56792,18.28479,1765
187898,807332CEC38772FA8DF98C48FBD8DD1E,30854,19,21,2,109.56889,18.27076,1763
187899,807332CEC38772FA8DF98C48FBD8DD1E,31561,21,22,1,109.56792,18.28479,1765
187900,97C31877CA4226D0F1BA1C0E12066B56,30854,7,16,9,109.56889,18.27076,1763
187901,97C31877CA4226D0F1BA1C0E12066B56,60331,19,23,4,109.505,18.26507,1512
187912,21FBB6F0F825A6B1E89545963BB6C9D3,30854,2,3,1,109.56889,18.27076,1763
187913,21FBB6F0F825A6B1E89545963BB6C9D3,30851,4,6,2,109.5616,18.27396,1713
187914,21FBB6F0F825A6B1E89545963BB6C9D3,30854,9,10,1,109.56889,18.27076,1763
187955,E4B522EF4348156010E5C578EC13D60F,30854,0,2,2,109.56889,18.27076,1763
187956,E4B522EF4348156010E5C578EC13D60F,31071,3,8,5,109.58257,18.28458,1815
187957,E4B522EF4348156010E5C578EC13D60F,30854,9,12,3,109.56889,18.27076,1763
187965,DA759AC2EBBA8078FBC390D09D5C4EC7,60354,0,2,2,109.58701,18.28521,1815
187966,DA759AC2EBBA8078FBC390D09D5C4EC7,30854,3,10,7,109.56889,18.27076,1763
187967,DA759AC2EBBA8078FBC390D09D5C4EC7,31071,10,11,1,109.58257,18.28458,1815
187968,DA759AC2EBBA8078FBC390D09D5C4EC7,30854,11,15,4,109.56889,18.27076,1763
187972,608A55C14BAB2A5B627ACC1F39B89FB6,31945,0,6,6,109.58021,18.29403,1817
187973,608A55C14BAB2A5B627ACC1F39B89FB6,30854,8,10,2,109.56889,18.27076,1763
187974,608A55C14BAB2A5B627ACC1F39B89FB6,31071,11,12,1,109.58257,18.28458,1815
187975,608A55C14BAB2A5B627ACC1F39B89FB6,30854,13,17,4,109.56889,18.27076,1763
187976,608A55C14BAB2A5B627ACC1F39B89FB6,31945,21,22,1,109.58021,18.29403,1817
188006,410DD8A32244BC0C8E0A44B87218A19E,39053,0,1,1,109.511,18.2771,1564
188007,410DD8A32244BC0C8E0A44B87218A19E,30854,2,9,7,109.56889,18.27076,1763
188030,D75F3D28EEDDC3AAB22F587F99A79102,30854,0,11,11,109.56889,18.27076,1763
188031,D75F3D28EEDDC3AAB22F587F99A79102,31071,11,12,1,109.58257,18.28458,1815
188032,D75F3D28EEDDC3AAB22F587F99A79102,30854,15,18,3,109.56889,18.27076,1763
188033,D75F3D28EEDDC3AAB22F587F99A79102,30851,18,19,1,109.5616,18.27396,1713
188034,D75F3D28EEDDC3AAB22F587F99A79102,30854,20,21,1,109.56889,18.27076,1763
188044,CFAA4900917F16A6BB33BA227F202636,31071,3,8,5,109.58257,18.28458,1815
188045,CFAA4900917F16A6BB33BA227F202636,30854,8,11,3,109.56889,18.27076,1763
188091,5E6F81A7DA23F57413C15AC7514275E5,31945,5,18,13,109.58021,18.29403,1817
188092,5E6F81A7DA23F57413C15AC7514275E5,30851,19,21,2,109.5616,18.27396,1713
188096,B09F6CB43F7BB3E6391589239BFB1120,38951,2,17,15,109.48097,18.28868,1416
188097,B09F6CB43F7BB3E6391589239BFB1120,30681,19,22,3,109.48493,18.26917,1463
188132,3066D3BA0EF6F55E10FAD924A6ADDDEF,39091,0,1,1,109.50097,18.25222,1510
188133,3066D3BA0EF6F55E10FAD924A6ADDDEF,30381,2,12,10,109.52521,18.24507,1609
188134,3066D3BA0EF6F55E10FAD924A6ADDDEF,31031,14,15,1,109.49979,18.25382,1510
188135,3066D3BA0EF6F55E10FAD924A6ADDDEF,30421,18,23,5,109.50021,18.25861,1511
188144,F463C6D05ADE42D98ADCBBE75434CCEF,30201,0,9,9,109.4909,18.26465,1462
188145,F463C6D05ADE42D98ADCBBE75434CCEF,60054,13,15,2,109.3016,18.31229,770
188146,F463C6D05ADE42D98ADCBBE75434CCEF,31021,19,23,4,109.49021,18.27,1463
188184,E605B26D53F08A0D3360A4541E09F4E2,38283,0,8,8,109.62229,18.22618,1956
188185,E605B26D53F08A0D3360A4541E09F4E2,38283,12,15,3,109.62229,18.22618,1956
188211,2C5F898948A2B7909519666936FBF333,38707,0,14,14,109.73778,18.35368,2427
188212,2C5F898948A2B7909519666936FBF333,38707,15,23,8,109.73778,18.35368,2427
188230,637A9DA12514DD49C1B8E5B00DF49C3A,31681,16,17,1,109.40396,18.29979,1168
188231,637A9DA12514DD49C1B8E5B00DF49C3A,30351,17,20,3,109.41701,18.29292,1217
188255,77F5A37783010C53E376197FE3F1043D,30071,4,16,12,109.52819,18.30472,1619
188256,77F5A37783010C53E376197FE3F1043D,60361,19,23,4,109.51938,18.29681,1567
188260,C48911F2501F3C5309DA39E0641B7D38,31071,0,15,15,109.58257,18.28458,1815
188261,C48911F2501F3C5309DA39E0641B7D38,30854,17,20,3,109.56889,18.27076,1763
188270,89A01963B06628A3D6B13DA41FA507D1,30854,0,6,6,109.56889,18.27076,1763
188271,89A01963B06628A3D6B13DA41FA507D1,31161,8,14,6,109.70229,18.31361,2270
188272,89A01963B06628A3D6B13DA41FA507D1,30854,18,20,2,109.56889,18.27076,1763
188273,0F558B6653C655C7F0BAEA9D66B33F57,31071,9,10,1,109.58257,18.28458,1815
188274,0F558B6653C655C7F0BAEA9D66B33F57,30854,11,22,11,109.56889,18.27076,1763
188275,1026894DC5FF9A7FAF3A2EE28B95E239,30232,9,12,3,109.6191,18.31701,1971
188276,1026894DC5FF9A7FAF3A2EE28B95E239,30854,13,15,2,109.56889,18.27076,1763
188277,1026894DC5FF9A7FAF3A2EE28B95E239,38085,16,17,1,109.6291,18.23625,2007
188296,D93AA4B2BEBDAF08795028EBAFF2CAE4,31701,0,8,8,109.44132,18.28833,1266
188297,D93AA4B2BEBDAF08795028EBAFF2CAE4,31561,13,14,1,109.56792,18.28479,1765
188298,D93AA4B2BEBDAF08795028EBAFF2CAE4,31701,18,23,5,109.44132,18.28833,1266
188299,A4823EEC9A8E697E80697432C029B488,30391,10,12,2,109.4975,18.27118,1513
188300,A4823EEC9A8E697E80697432C029B488,30421,13,15,2,109.50021,18.25861,1511
188301,A4823EEC9A8E697E80697432C029B488,30391,18,20,2,109.4975,18.27118,1513
188323,A01B4012B619D942E7CC3AC9B78722B4,31561,0,7,7,109.56792,18.28479,1765
188324,A01B4012B619D942E7CC3AC9B78722B4,31931,7,9,2,109.54771,18.29403,1667
188325,A01B4012B619D942E7CC3AC9B78722B4,31561,9,10,1,109.56792,18.28479,1765
188326,A01B4012B619D942E7CC3AC9B78722B4,39183,10,12,2,109.55542,18.28208,1715
188327,A01B4012B619D942E7CC3AC9B78722B4,31561,12,23,11,109.56792,18.28479,1765
188333,C153552CEA2677B0FF473AE565EA979E,30821,3,6,3,109.43681,18.33639,1274
188334,C153552CEA2677B0FF473AE565EA979E,30651,9,11,2,109.42611,18.385,1232
188335,C153552CEA2677B0FF473AE565EA979E,30821,11,23,12,109.43681,18.33639,1274
188343,417408FFDA93B177641D270D3A5C4B2D,31071,0,6,6,109.58257,18.28458,1815
188344,417408FFDA93B177641D270D3A5C4B2D,30854,10,11,1,109.56889,18.27076,1763
188345,03CF17D18D5ABB539B8A67460591BD40,60541,0,8,8,109.4084,18.29208,1167
188346,03CF17D18D5ABB539B8A67460591BD40,30211,10,20,10,109.49882,18.23931,1508
188347,03CF17D18D5ABB539B8A67460591BD40,60291,20,23,3,109.50826,18.24639,1509
188389,F0D8EB3805762325257E07582BA2416E,30861,13,16,3,109.52722,18.22743,1606
188390,F0D8EB3805762325257E07582BA2416E,60381,19,23,4,109.5241,18.22458,1605
188417,A4743972EC2FC58546DD11935BDC0E1A,30711,11,15,4,109.50271,18.25347,1510
188418,A4743972EC2FC58546DD11935BDC0E1A,30421,19,20,1,109.50021,18.25861,1511
188419,A4743972EC2FC58546DD11935BDC0E1A,39154,21,23,2,109.50201,18.25681,1511
188424,0A9117B90774715AACE2ED3045D6F579,60551,0,8,8,109.42722,18.30111,1218
188425,0A9117B90774715AACE2ED3045D6F579,31031,11,13,2,109.49979,18.25382,1510
188426,0A9117B90774715AACE2ED3045D6F579,31181,13,14,1,109.50382,18.24813,1509
188428,0A9117B90774715AACE2ED3045D6F579,60552,21,22,1,109.41729,18.30014,1218
188436,FDC054EE1F6297074BC908470125F9F1,48574,1,6,5,109.48931,18.28458,1465
188437,FDC054EE1F6297074BC908470125F9F1,31864,7,8,1,109.49014,18.28333,1465
188438,FDC054EE1F6297074BC908470125F9F1,31471,10,11,1,109.34583,18.29563,917
188439,FDC054EE1F6297074BC908470125F9F1,31031,18,21,3,109.49979,18.25382,1510
188440,FDC054EE1F6297074BC908470125F9F1,48574,22,23,1,109.48931,18.28458,1465
188461,F866B6E34CEF853A6497211DD74A607E,30201,15,17,2,109.4909,18.26465,1462
188462,F866B6E34CEF853A6497211DD74A607E,60117,20,23,3,109.73604,18.35681,2427
188532,BD4652414D5C17466BA36FD4BD943A94,60274,4,5,1,109.514,18.2933,1567
188533,BD4652414D5C17466BA36FD4BD943A94,39053,6,7,1,109.511,18.2771,1564
188534,BD4652414D5C17466BA36FD4BD943A94,39183,8,13,5,109.55542,18.28208,1715
188535,BD4652414D5C17466BA36FD4BD943A94,39181,18,20,2,109.55153,18.28035,1715
188536,BD4652414D5C17466BA36FD4BD943A94,31041,22,23,1,109.50278,18.23701,1507
188564,B421B0364BC07B443944D07A1DCB065A,31461,0,9,9,109.5091,18.25389,1510
188565,B421B0364BC07B443944D07A1DCB065A,39091,12,13,1,109.50097,18.25222,1510
188566,B421B0364BC07B443944D07A1DCB065A,31931,15,16,1,109.54771,18.29403,1667
188567,B421B0364BC07B443944D07A1DCB065A,60201,18,20,2,109.5041,18.2509,1510
188602,B3570D3DE8F1063CDA8C0E261A8F3734,30241,11,12,1,109.26174,18.3275,622
188603,B3570D3DE8F1063CDA8C0E261A8F3734,31471,13,16,3,109.34583,18.29563,917
188604,D517610C2076C41FED0ED80CB6FFB44C,30851,8,17,9,109.5616,18.27396,1713
188605,D517610C2076C41FED0ED80CB6FFB44C,30951,19,21,2,109.56208,18.25667,1761
188606,D517610C2076C41FED0ED80CB6FFB44C,31561,22,23,1,109.56792,18.28479,1765
188644,1D8B56371E487F3812C9965576175C8D,38361,0,10,10,109.43667,18.29201,1267
188645,1D8B56371E487F3812C9965576175C8D,30084,11,12,1,109.50118,18.26972,1513
188646,1D8B56371E487F3812C9965576175C8D,30171,12,13,1,109.48458,18.27139,1463
188647,1D8B56371E487F3812C9965576175C8D,38361,16,17,1,109.43667,18.29201,1267
188648,1D8B56371E487F3812C9965576175C8D,31861,18,20,2,109.49042,18.27549,1464
188649,1D8B56371E487F3812C9965576175C8D,38361,21,23,2,109.43667,18.29201,1267
188661,BC2EDF4DF9C7FAD55BDEABA03DFA7284,31561,0,11,11,109.56792,18.28479,1765
188662,BC2EDF4DF9C7FAD55BDEABA03DFA7284,30851,12,13,1,109.5616,18.27396,1713
188663,BC2EDF4DF9C7FAD55BDEABA03DFA7284,39183,15,16,1,109.55542,18.28208,1715
188664,BC2EDF4DF9C7FAD55BDEABA03DFA7284,31561,19,23,4,109.56792,18.28479,1765
188669,C85D0B931BEF54F05B9ABBBB03212DB7,31561,0,8,8,109.56792,18.28479,1765
188670,C85D0B931BEF54F05B9ABBBB03212DB7,30854,8,22,14,109.56889,18.27076,1763
188770,EBF906C5498076BCFA3E97DF6001B4F3,60631,0,7,7,109.57778,18.27583,1814
188771,EBF906C5498076BCFA3E97DF6001B4F3,30854,10,12,2,109.56889,18.27076,1763
188801,219721364FA6301D2F800ECE1EBFC972,30361,11,12,1,109.50347,18.24,1508
188802,219721364FA6301D2F800ECE1EBFC972,30211,13,17,4,109.49882,18.23931,1508
188803,219721364FA6301D2F800ECE1EBFC972,30211,18,23,5,109.49882,18.23931,1508
188820,044B260BB5F12A7C76BF06F0DD8F09A0,30181,7,8,1,109.51597,18.23313,1557
188821,044B260BB5F12A7C76BF06F0DD8F09A0,31521,9,10,1,109.51458,18.22542,1555
188822,044B260BB5F12A7C76BF06F0DD8F09A0,30181,13,17,4,109.51597,18.23313,1557
188823,044B260BB5F12A7C76BF06F0DD8F09A0,31521,19,20,1,109.51458,18.22542,1555
188826,75817DB682187A07461734D66E1E6492,30854,9,13,4,109.56889,18.27076,1763
188827,75817DB682187A07461734D66E1E6492,31071,13,14,1,109.58257,18.28458,1815
188828,75817DB682187A07461734D66E1E6492,31061,19,20,1,109.53333,18.23257,1607
188829,75817DB682187A07461734D66E1E6492,60631,22,23,1,109.57778,18.27583,1814
188899,53875E69050EC42E511A64D3211FA7B3,60631,3,5,2,109.57778,18.27583,1814
188900,53875E69050EC42E511A64D3211FA7B3,30854,9,15,6,109.56889,18.27076,1763
188901,53875E69050EC42E511A64D3211FA7B3,60101,20,22,2,109.75465,18.40139,2485
188926,B9443F64442A80E319EB0A8B9F1B13FA,30891,0,6,6,109.59431,18.28389,1865
188927,B9443F64442A80E319EB0A8B9F1B13FA,30851,6,7,1,109.5616,18.27396,1713
188928,B9443F64442A80E319EB0A8B9F1B13FA,31101,12,14,2,109.65389,18.23403,2057
188929,B9443F64442A80E319EB0A8B9F1B13FA,31721,14,15,1,109.67938,18.24014,2158
188965,79093FC5CD83BC87E594DF8DD17421B3,30351,19,21,2,109.41701,18.29292,1217
188968,5E97A4561E11AAC4FBC53FD068EAA52B,30891,0,6,6,109.59431,18.28389,1865
188969,5E97A4561E11AAC4FBC53FD068EAA52B,30854,7,8,1,109.56889,18.27076,1763
188970,5E97A4561E11AAC4FBC53FD068EAA52B,30531,10,20,10,109.53271,18.21472,1604
188971,5E97A4561E11AAC4FBC53FD068EAA52B,30854,21,22,1,109.56889,18.27076,1763
188991,C19430CE8DF26BDEF43903E57E682236,31561,0,13,13,109.56792,18.28479,1765
188992,C19430CE8DF26BDEF43903E57E682236,30854,14,16,2,109.56889,18.27076,1763
188993,C19430CE8DF26BDEF43903E57E682236,31561,20,23,3,109.56792,18.28479,1765
189116,9EDC789413D54BDC00C69BCE3615AF7F,31351,0,11,11,109.4959,18.28417,1465
189129,E960A9C960574B6ECAA9E8161ED40783,60084,1,7,6,109.4984,18.2334,1507
189130,E960A9C960574B6ECAA9E8161ED40783,31781,12,15,3,109.19847,18.2975,367
189133,5BD3BF1CB6F50721BC625B86AA70AC34,60524,1,9,8,109.42951,18.28993,1216
189134,5BD3BF1CB6F50721BC625B86AA70AC34,30661,11,13,2,109.37028,18.24361,1008
189150,4734AFF1B70F6E2220C283E468A26DA6,38356,20,23,3,109.50201,18.21486,1504
189154,2361E8D6BAB0231B2E8E3C0F34517282,30291,0,8,8,109.50403,18.27028,1513
189155,2361E8D6BAB0231B2E8E3C0F34517282,60331,10,13,3,109.505,18.26507,1512
189156,2361E8D6BAB0231B2E8E3C0F34517282,30081,13,19,6,109.50243,18.26632,1512
189157,2361E8D6BAB0231B2E8E3C0F34517282,30291,19,21,2,109.50403,18.27028,1513
189181,B2C1D7D797194AB8141D50C733D584D6,60524,0,7,7,109.42951,18.28993,1216
189182,B2C1D7D797194AB8141D50C733D584D6,31781,11,13,2,109.19847,18.2975,367
189183,B2C1D7D797194AB8141D50C733D584D6,30361,17,19,2,109.50347,18.24,1508
189184,B2C1D7D797194AB8141D50C733D584D6,60524,21,23,2,109.42951,18.28993,1216
189198,4995463B780282C9C030A19D9F49AEAC,30854,7,17,10,109.56889,18.27076,1763
189199,4995463B780282C9C030A19D9F49AEAC,31071,19,21,2,109.58257,18.28458,1815
189209,4E94ADAE7ABEB20EEFAF67519DFCC1BE,31081,0,9,9,109.44639,18.30181,1318
189210,4E94ADAE7ABEB20EEFAF67519DFCC1BE,31031,9,22,13,109.49979,18.25382,1510
189267,4D9A472B7DD43E0DD6EF3059F08EEEB1,30051,6,10,4,109.48917,18.21215,1453
189268,4D9A472B7DD43E0DD6EF3059F08EEEB1,31231,11,13,2,109.42597,18.29292,1217
189269,4D9A472B7DD43E0DD6EF3059F08EEEB1,30361,17,21,4,109.50347,18.24,1508
189279,8F1EF92DD1571C1CE1F083763A3D65D0,30891,0,6,6,109.59431,18.28389,1865
189280,8F1EF92DD1571C1CE1F083763A3D65D0,31071,9,11,2,109.58257,18.28458,1815
189281,8F1EF92DD1571C1CE1F083763A3D65D0,30221,11,13,2,109.57833,18.20222,1802
189307,996C0D9500BF90CC0E7F5A04C49A464B,31931,0,9,9,109.54771,18.29403,1667
189308,996C0D9500BF90CC0E7F5A04C49A464B,30921,11,12,1,109.53903,18.29451,1667
189309,996C0D9500BF90CC0E7F5A04C49A464B,31931,14,16,2,109.54771,18.29403,1667
189310,996C0D9500BF90CC0E7F5A04C49A464B,39181,19,21,2,109.55153,18.28035,1715
189330,B340EDEF4A878E8DF5CBEC25E465EACE,31071,0,1,1,109.58257,18.28458,1815
189331,B340EDEF4A878E8DF5CBEC25E465EACE,30854,3,18,15,109.56889,18.27076,1763
189332,B340EDEF4A878E8DF5CBEC25E465EACE,31071,21,23,2,109.58257,18.28458,1815
189408,8C5A16299A6D294198C90C34C25C5949,30851,0,3,3,109.5616,18.27396,1713
189409,8C5A16299A6D294198C90C34C25C5949,39183,4,6,2,109.55542,18.28208,1715
189410,8C5A16299A6D294198C90C34C25C5949,31561,11,12,1,109.56792,18.28479,1765
189411,8C5A16299A6D294198C90C34C25C5949,39183,12,13,1,109.55542,18.28208,1715
189412,8C5A16299A6D294198C90C34C25C5949,31561,16,17,1,109.56792,18.28479,1765
189413,8C5A16299A6D294198C90C34C25C5949,39183,21,23,2,109.55542,18.28208,1715
189416,35C6EDC8AAC6B5ABA770190223528BA2,30391,0,1,1,109.4975,18.27118,1513
189417,35C6EDC8AAC6B5ABA770190223528BA2,30861,2,8,6,109.52722,18.22743,1606
189418,35C6EDC8AAC6B5ABA770190223528BA2,33521,11,15,4,109.66313,18.45174,2143
189446,C2EDA129DED7B4E10FC6588761A88D65,39053,0,7,7,109.511,18.2771,1564
189447,C2EDA129DED7B4E10FC6588761A88D65,60291,9,10,1,109.50826,18.24639,1509
189514,0E0D6E55BB1995EBF85F6B7AA8765E55,30854,0,14,14,109.56889,18.27076,1763
189515,0E0D6E55BB1995EBF85F6B7AA8765E55,38271,15,23,8,109.62632,18.23049,1956
189541,44F505B3929E26B4B29F00CC284F3084,31071,1,13,12,109.58257,18.28458,1815
189542,44F505B3929E26B4B29F00CC284F3084,30854,16,23,7,109.56889,18.27076,1763
189547,C1F9914EF577AE2A8300B1A3945A50FF,31561,0,9,9,109.56792,18.28479,1765
189548,C1F9914EF577AE2A8300B1A3945A50FF,30851,11,13,2,109.5616,18.27396,1713
189549,C1F9914EF577AE2A8300B1A3945A50FF,31561,13,14,1,109.56792,18.28479,1765
189550,C1F9914EF577AE2A8300B1A3945A50FF,30854,15,16,1,109.56889,18.27076,1763
189551,C1F9914EF577AE2A8300B1A3945A50FF,31561,18,20,2,109.56792,18.28479,1765
189555,770A00BDAFE9BCA8C9E9FA68066EED7D,31071,0,5,5,109.58257,18.28458,1815
189556,770A00BDAFE9BCA8C9E9FA68066EED7D,31561,8,20,12,109.56792,18.28479,1765
189557,770A00BDAFE9BCA8C9E9FA68066EED7D,31071,20,22,2,109.58257,18.28458,1815
189565,21EA50B7F2072F2024B9F3B7B9174B94,38154,1,7,6,109.5266,18.28278,1615
189566,21EA50B7F2072F2024B9F3B7B9174B94,30232,9,18,9,109.6191,18.31701,1971
189567,21EA50B7F2072F2024B9F3B7B9174B94,60501,18,20,2,109.48701,18.29021,1466
189585,3BB007FDF28DB0E7E883BA594F721FFE,31181,0,11,11,109.50382,18.24813,1509
189586,3BB007FDF28DB0E7E883BA594F721FFE,31181,12,14,2,109.50382,18.24813,1509
189587,3BB007FDF28DB0E7E883BA594F721FFE,31181,16,23,7,109.50382,18.24813,1509
189615,1D95C9F25428D40F06E5BFA001370E3C,31071,0,11,11,109.58257,18.28458,1815
189616,1D95C9F25428D40F06E5BFA001370E3C,30854,11,16,5,109.56889,18.27076,1763
189617,1D95C9F25428D40F06E5BFA001370E3C,31071,17,23,6,109.58257,18.28458,1815
189647,DC0EB400EA24BEE9EB39D315B0E6AEF0,60041,0,7,7,109.39889,18.31944,1121
189648,DC0EB400EA24BEE9EB39D315B0E6AEF0,31701,12,13,1,109.44132,18.28833,1266
189649,DC0EB400EA24BEE9EB39D315B0E6AEF0,38871,18,23,5,109.44681,18.28625,1316
189654,9FEA4B85EAE4FAEE1CAF0EABFF2FAEA1,31561,0,3,3,109.56792,18.28479,1765
189655,9FEA4B85EAE4FAEE1CAF0EABFF2FAEA1,30854,4,5,1,109.56889,18.27076,1763
189656,9FEA4B85EAE4FAEE1CAF0EABFF2FAEA1,31561,8,9,1,109.56792,18.28479,1765
189657,9FEA4B85EAE4FAEE1CAF0EABFF2FAEA1,30854,11,23,12,109.56889,18.27076,1763
189709,3604A30B97765FCF194506153EE8C0D9,31945,0,6,6,109.58021,18.29403,1817
189710,3604A30B97765FCF194506153EE8C0D9,30854,10,23,13,109.56889,18.27076,1763
189726,088829826E35A8DF49EB0AEC08CE7FE7,30661,0,3,3,109.37028,18.24361,1008
189727,088829826E35A8DF49EB0AEC08CE7FE7,60054,5,7,2,109.3016,18.31229,770
189728,088829826E35A8DF49EB0AEC08CE7FE7,30661,7,9,2,109.37028,18.24361,1008
189729,088829826E35A8DF49EB0AEC08CE7FE7,60054,10,16,6,109.3016,18.31229,770
189734,3047F6D5E6312C5CD043B8770B1E8967,31391,10,11,1,109.50382,18.24285,1508
189735,3047F6D5E6312C5CD043B8770B1E8967,30161,12,15,3,109.50042,18.24389,1508
189736,94C4D5691F7DFC1AB38806AFFAC1389E,31931,9,16,7,109.54771,18.29403,1667
189737,94C4D5691F7DFC1AB38806AFFAC1389E,60241,17,18,1,109.53319,18.28667,1616
189738,94C4D5691F7DFC1AB38806AFFAC1389E,31931,20,23,3,109.54771,18.29403,1667
189770,E191BF114A3C2277CB7C3323BAA13F43,30854,0,15,15,109.56889,18.27076,1763
189771,E191BF114A3C2277CB7C3323BAA13F43,31301,19,20,1,109.14493,18.31222,170
189772,E191BF114A3C2277CB7C3323BAA13F43,30854,22,23,1,109.56889,18.27076,1763
189788,EB5C701CC758E473EF822E076B49A534,31311,9,10,1,109.72299,18.27438,2364
189789,EB5C701CC758E473EF822E076B49A534,31145,15,16,1,109.20431,18.30479,369
189790,EB5C701CC758E473EF822E076B49A534,30421,20,23,3,109.50021,18.25861,1511
189807,A68637AA89BD62624E677D9E66C32FAD,39101,0,4,4,109.50132,18.24931,1509
189808,A68637AA89BD62624E677D9E66C32FAD,30361,5,8,3,109.50347,18.24,1508
189809,A68637AA89BD62624E677D9E66C32FAD,30161,8,13,5,109.50042,18.24389,1508
189810,A68637AA89BD62624E677D9E66C32FAD,31391,14,16,2,109.50382,18.24285,1508
189811,A68637AA89BD62624E677D9E66C32FAD,30161,17,23,6,109.50042,18.24389,1508
189812,0989A1FA83098A129EC9A63DDE064266,31561,1,2,1,109.56792,18.28479,1765
189813,0989A1FA83098A129EC9A63DDE064266,30854,5,12,7,109.56889,18.27076,1763
189814,0989A1FA83098A129EC9A63DDE064266,31071,12,14,2,109.58257,18.28458,1815
189815,0989A1FA83098A129EC9A63DDE064266,30854,17,18,1,109.56889,18.27076,1763
189816,0989A1FA83098A129EC9A63DDE064266,31071,18,23,5,109.58257,18.28458,1815
189836,E8D51F8B53F290BFD73338AD2AD8C728,31561,3,5,2,109.56792,18.28479,1765
189837,E8D51F8B53F290BFD73338AD2AD8C728,31931,8,15,7,109.54771,18.29403,1667
189838,E8D51F8B53F290BFD73338AD2AD8C728,31561,19,22,3,109.56792,18.28479,1765
189879,3389A095460231D31BA622B7185D6321,31231,0,1,1,109.42597,18.29292,1217
189880,3389A095460231D31BA622B7185D6321,60552,2,4,2,109.41729,18.30014,1218
189881,3389A095460231D31BA622B7185D6321,31681,6,8,2,109.40396,18.29979,1168
189882,3389A095460231D31BA622B7185D6321,60541,8,11,3,109.4084,18.29208,1167
189883,3389A095460231D31BA622B7185D6321,31681,12,14,2,109.40396,18.29979,1168
189884,3389A095460231D31BA622B7185D6321,60541,17,19,2,109.4084,18.29208,1167
189885,3389A095460231D31BA622B7185D6321,60552,19,21,2,109.41729,18.30014,1218
189920,90B0A60855A43B2DB99A0964CE51D3AF,31071,0,7,7,109.58257,18.28458,1815
189921,90B0A60855A43B2DB99A0964CE51D3AF,30854,8,10,2,109.56889,18.27076,1763
189941,ABF738EC798E54DC6486A640123BFFD8,31071,2,7,5,109.58257,18.28458,1815
189942,ABF738EC798E54DC6486A640123BFFD8,60291,11,13,2,109.50826,18.24639,1509
189943,ABF738EC798E54DC6486A640123BFFD8,39091,13,22,9,109.50097,18.25222,1510
190005,A65416E0023DB5B05C85EFD796D8188E,38251,0,9,9,109.49618,18.25493,1510
190006,A65416E0023DB5B05C85EFD796D8188E,30361,11,13,2,109.50347,18.24,1508
190007,A65416E0023DB5B05C85EFD796D8188E,30711,13,16,3,109.50271,18.25347,1510
190008,A65416E0023DB5B05C85EFD796D8188E,38291,18,20,2,109.51618,18.24313,1558
190009,A65416E0023DB5B05C85EFD796D8188E,38251,20,23,3,109.49618,18.25493,1510
190016,D334753E33AD01D79142036B3D85543F,31561,0,5,5,109.56792,18.28479,1765
190017,D334753E33AD01D79142036B3D85543F,31931,9,10,1,109.54771,18.29403,1667
190018,D334753E33AD01D79142036B3D85543F,31561,11,13,2,109.56792,18.28479,1765
190019,D334753E33AD01D79142036B3D85543F,30851,20,21,1,109.5616,18.27396,1713
190020,D334753E33AD01D79142036B3D85543F,31561,22,23,1,109.56792,18.28479,1765
190135,A9FCE0049DB44FE004EAFBF5B783F4A5,30854,0,8,8,109.56889,18.27076,1763
190136,A9FCE0049DB44FE004EAFBF5B783F4A5,31071,8,10,2,109.58257,18.28458,1815
190137,A9FCE0049DB44FE004EAFBF5B783F4A5,30854,10,16,6,109.56889,18.27076,1763
190138,A9FCE0049DB44FE004EAFBF5B783F4A5,31071,16,18,2,109.58257,18.28458,1815
190139,A9FCE0049DB44FE004EAFBF5B783F4A5,39091,22,23,1,109.50097,18.25222,1510
190195,0467E7A2F341B63F33E9945177D53E54,31521,0,1,1,109.51458,18.22542,1555
190196,0467E7A2F341B63F33E9945177D53E54,31521,4,8,4,109.51458,18.22542,1555
190197,0467E7A2F341B63F33E9945177D53E54,31101,11,12,1,109.65389,18.23403,2057
190208,84DF4A7C208235D171EF56473BCCF210,30851,19,23,4,109.5616,18.27396,1713
190237,C3071072DB6684DC75BE160268E6323C,30854,16,18,2,109.56889,18.27076,1763
190238,C3071072DB6684DC75BE160268E6323C,30324,20,22,2,109.50326,18.29257,1517
190239,A94F66C88B84FF0658441320CD9F667C,60631,1,6,5,109.57778,18.27583,1814
190240,A94F66C88B84FF0658441320CD9F667C,30854,7,18,11,109.56889,18.27076,1763
190270,BE586ACB441383CC10D7CF3923850B73,31931,0,7,7,109.54771,18.29403,1667
190271,BE586ACB441383CC10D7CF3923850B73,39181,7,16,9,109.55153,18.28035,1715
190272,BE586ACB441383CC10D7CF3923850B73,31931,18,20,2,109.54771,18.29403,1667
190274,8CE55AC8BC984D52D16D6CE4872EB6FC,31391,4,15,11,109.50382,18.24285,1508
190280,B8587D3CED4B79DF3F07DD5419A719F9,38754,16,17,1,109.74667,18.37382,2430
190281,B8587D3CED4B79DF3F07DD5419A719F9,31031,19,21,2,109.49979,18.25382,1510
190282,B8587D3CED4B79DF3F07DD5419A719F9,31231,21,23,2,109.42597,18.29292,1217
190307,40D62DAB923B148A7A4FFB3BCA6C7343,31271,14,15,1,109.48958,18.26257,1462
190308,40D62DAB923B148A7A4FFB3BCA6C7343,38951,18,19,1,109.48097,18.28868,1416
190318,FEB5D5949975AC1B686ACF91B7A6C2AD,31271,0,8,8,109.48958,18.26257,1462
190319,FEB5D5949975AC1B686ACF91B7A6C2AD,30961,12,13,1,109.74042,18.37903,2431
190320,FEB5D5949975AC1B686ACF91B7A6C2AD,38251,16,17,1,109.49618,18.25493,1510
190321,FEB5D5949975AC1B686ACF91B7A6C2AD,30361,19,22,3,109.50347,18.24,1508
190347,F00821368F615DCDAF214035D8EC4A44,31071,0,4,4,109.58257,18.28458,1815
190348,F00821368F615DCDAF214035D8EC4A44,30854,5,22,17,109.56889,18.27076,1763
190349,FF90B6855593CFEA9A07FE008E94551D,60371,0,4,4,109.53063,18.30056,1618
190350,FF90B6855593CFEA9A07FE008E94551D,30071,5,7,2,109.52819,18.30472,1619
190351,FF90B6855593CFEA9A07FE008E94551D,31931,8,14,6,109.54771,18.29403,1667
190352,FF90B6855593CFEA9A07FE008E94551D,30071,19,21,2,109.52819,18.30472,1619
190370,934029FB5F97BCE114EDCE88F0393A63,31031,19,21,2,109.49979,18.25382,1510
190371,934029FB5F97BCE114EDCE88F0393A63,39371,21,22,1,109.56627,18.2646,1762
190377,96F98526707B06BE1263CCD4F72E07A1,31071,0,8,8,109.58257,18.28458,1815
190378,96F98526707B06BE1263CCD4F72E07A1,30854,9,11,2,109.56889,18.27076,1763
190379,96F98526707B06BE1263CCD4F72E07A1,31071,15,17,2,109.58257,18.28458,1815
190386,335A7B1DE8538918FDA774EE3E402A76,30191,0,7,7,109.50361,18.22701,1506
190387,335A7B1DE8538918FDA774EE3E402A76,31521,7,11,4,109.51458,18.22542,1555
190439,B16225DD3371073720184BB0D089E6D6,31561,0,11,11,109.56792,18.28479,1765
190440,B16225DD3371073720184BB0D089E6D6,30854,12,15,3,109.56889,18.27076,1763
190441,B16225DD3371073720184BB0D089E6D6,31071,17,18,1,109.58257,18.28458,1815
190442,B93185B4820D7E0DEE74EBEA00941D15,31261,0,1,1,109.51174,18.2466,1559
190443,B93185B4820D7E0DEE74EBEA00941D15,30911,1,17,16,109.50493,18.26181,1511
190444,B93185B4820D7E0DEE74EBEA00941D15,38291,21,23,2,109.51618,18.24313,1558
190460,54A6757CA4BF8A47C41CF1DDCA6EA505,30854,0,12,12,109.56889,18.27076,1763
190461,54A6757CA4BF8A47C41CF1DDCA6EA505,30891,17,18,1,109.59431,18.28389,1865
190498,07169E7114E4F14C073261BAAC0D4491,61011,5,12,7,109.60653,18.19076,1900
190514,DDA0EB7263815D997F150C58431C5F5D,30351,0,4,4,109.41701,18.29292,1217
190515,DDA0EB7263815D997F150C58431C5F5D,30351,5,8,3,109.41701,18.29292,1217
190516,DDA0EB7263815D997F150C58431C5F5D,30661,11,13,2,109.37028,18.24361,1008
190517,DDA0EB7263815D997F150C58431C5F5D,30351,15,17,2,109.41701,18.29292,1217
190522,9AE2F7694D67538FB73269B53D8C1BCE,38903,19,21,2,109.39229,18.29243,1117
190523,9AE2F7694D67538FB73269B53D8C1BCE,38325,21,23,2,109.39792,18.2909,1116
190540,25029E441FE00FCACF889ABEDF6D0DA6,38141,0,9,9,109.39479,18.2916,1116
190541,25029E441FE00FCACF889ABEDF6D0DA6,38141,12,21,9,109.39479,18.2916,1116
190559,121138E269BBF0B506FA8CE6CEB3BF52,31931,0,7,7,109.54771,18.29403,1667
190560,121138E269BBF0B506FA8CE6CEB3BF52,39181,8,10,2,109.55153,18.28035,1715
190561,121138E269BBF0B506FA8CE6CEB3BF52,39181,12,18,6,109.55153,18.28035,1715
190562,121138E269BBF0B506FA8CE6CEB3BF52,31931,20,23,3,109.54771,18.29403,1667
190563,9C1407835BC54BEBDB541F52E1DA1820,61011,0,2,2,109.60653,18.19076,1900
190565,9C1407835BC54BEBDB541F52E1DA1820,61011,5,9,4,109.60653,18.19076,1900
190577,3A4E228E5E71900953BAD30C430563D8,60371,0,7,7,109.53063,18.30056,1618
190578,3A4E228E5E71900953BAD30C430563D8,30851,8,10,2,109.5616,18.27396,1713
190579,3A4E228E5E71900953BAD30C430563D8,60371,13,15,2,109.53063,18.30056,1618
190580,3A4E228E5E71900953BAD30C430563D8,30921,15,16,1,109.53903,18.29451,1667
190581,3A4E228E5E71900953BAD30C430563D8,60371,18,22,4,109.53063,18.30056,1618
190660,7B9D64657CE26DF907B4C2AC87C9F431,60371,7,9,2,109.53063,18.30056,1618
190661,7B9D64657CE26DF907B4C2AC87C9F431,38241,9,10,1,109.54111,18.30542,1669
190662,7B9D64657CE26DF907B4C2AC87C9F431,60371,13,15,2,109.53063,18.30056,1618
190663,7B9D64657CE26DF907B4C2AC87C9F431,31931,19,20,1,109.54771,18.29403,1667
190691,DBB710D279E76C79F1E4B0766F579F8A,31071,0,7,7,109.58257,18.28458,1815
190692,DBB710D279E76C79F1E4B0766F579F8A,30854,8,16,8,109.56889,18.27076,1763
190693,DBB710D279E76C79F1E4B0766F579F8A,60631,16,17,1,109.57778,18.27583,1814
190700,B80D4B4CDBD08237A9C4254F8883AEF4,31534,18,20,2,109.49368,18.25806,1461
190701,B80D4B4CDBD08237A9C4254F8883AEF4,39151,20,23,3,109.49875,18.25097,1510
190716,CCCD2290FB632A48009771412BE68ADD,31561,0,14,14,109.56792,18.28479,1765
190717,CCCD2290FB632A48009771412BE68ADD,39183,16,18,2,109.55542,18.28208,1715
190718,CCCD2290FB632A48009771412BE68ADD,31561,20,21,1,109.56792,18.28479,1765
190738,DC29C676832347947F366933ECB88090,39183,0,2,2,109.55542,18.28208,1715
190739,DC29C676832347947F366933ECB88090,31561,3,23,20,109.56792,18.28479,1765
190760,8068F1EF55119CC805C3493D560CAAB3,31071,2,4,2,109.58257,18.28458,1815
190761,8068F1EF55119CC805C3493D560CAAB3,30854,5,8,3,109.56889,18.27076,1763
190762,8068F1EF55119CC805C3493D560CAAB3,30221,9,10,1,109.57833,18.20222,1802
190763,8068F1EF55119CC805C3493D560CAAB3,30731,12,15,3,109.50944,18.22306,1555
190764,8068F1EF55119CC805C3493D560CAAB3,31071,19,21,2,109.58257,18.28458,1815
190765,8068F1EF55119CC805C3493D560CAAB3,31945,22,23,1,109.58021,18.29403,1817
190766,99CBAA6A65A50998F0A10B72B36210E4,30051,3,14,11,109.48917,18.21215,1453
190767,99CBAA6A65A50998F0A10B72B36210E4,60231,18,22,4,109.49903,18.21972,1504
190781,0B625DE57093602A177FF6EF2935F6D3,60381,0,3,3,109.5241,18.22458,1605
190782,0B625DE57093602A177FF6EF2935F6D3,31521,4,7,3,109.51458,18.22542,1555
190783,0B625DE57093602A177FF6EF2935F6D3,60381,8,9,1,109.5241,18.22458,1605
190784,0B625DE57093602A177FF6EF2935F6D3,60054,13,15,2,109.3016,18.31229,770
190785,0B625DE57093602A177FF6EF2935F6D3,31521,18,22,4,109.51458,18.22542,1555
190789,000584B3023702F3E9DDF521B1C35B1A,30854,0,2,2,109.56889,18.27076,1763
190790,000584B3023702F3E9DDF521B1C35B1A,31071,3,6,3,109.58257,18.28458,1815
190791,000584B3023702F3E9DDF521B1C35B1A,30854,6,8,2,109.56889,18.27076,1763
190792,000584B3023702F3E9DDF521B1C35B1A,31071,11,12,1,109.58257,18.28458,1815
190793,000584B3023702F3E9DDF521B1C35B1A,31071,15,17,2,109.58257,18.28458,1815
190812,84D09807769454188E86D49181B1B5D0,39154,0,9,9,109.50201,18.25681,1511
190813,84D09807769454188E86D49181B1B5D0,31181,11,13,2,109.50382,18.24813,1509
190814,84D09807769454188E86D49181B1B5D0,60381,15,16,1,109.5241,18.22458,1605
190815,84D09807769454188E86D49181B1B5D0,39154,19,21,2,109.50201,18.25681,1511
190849,3C5AEA306E8A69C707195C4150E77D90,39183,7,17,10,109.55542,18.28208,1715
190850,3C5AEA306E8A69C707195C4150E77D90,31931,18,19,1,109.54771,18.29403,1667
190888,8D496C0E2DB1FF881021B05CE10C0242,31945,0,4,4,109.58021,18.29403,1817
190889,8D496C0E2DB1FF881021B05CE10C0242,30854,8,23,15,109.56889,18.27076,1763
190902,05A57DE8DC0D94268B97E02566D1A0C9,60351,0,5,5,109.58403,18.28958,1816
190905,05A57DE8DC0D94268B97E02566D1A0C9,30861,14,15,1,109.52722,18.22743,1606
190906,05A57DE8DC0D94268B97E02566D1A0C9,60351,18,23,5,109.58403,18.28958,1816
190917,020753EF78F0A0C39658113A3377EA1E,31561,5,14,9,109.56792,18.28479,1765
190918,020753EF78F0A0C39658113A3377EA1E,60381,14,15,1,109.5241,18.22458,1605
190934,7FD31F65A9E7574FDAD4A110ACBA289D,60171,13,16,3,109.51292,18.30694,1569
190935,7FD31F65A9E7574FDAD4A110ACBA289D,31931,19,23,4,109.54771,18.29403,1667
190957,76F6A54588C8DF7DDADFC50CAA11D44C,31071,9,11,2,109.58257,18.28458,1815
190958,76F6A54588C8DF7DDADFC50CAA11D44C,31561,13,15,2,109.56792,18.28479,1765
190999,5D67332784D543EA1329DDE1D672CE40,38017,1,2,1,109.49729,18.21424,1504
191000,5D67332784D543EA1329DDE1D672CE40,60234,4,7,3,109.49577,18.2096,1453
191001,5D67332784D543EA1329DDE1D672CE40,30051,7,9,2,109.48917,18.21215,1453
191002,5D67332784D543EA1329DDE1D672CE40,31781,12,14,2,109.19847,18.2975,367
191003,5D67332784D543EA1329DDE1D672CE40,38017,16,18,2,109.49729,18.21424,1504
191004,5D67332784D543EA1329DDE1D672CE40,38017,19,21,2,109.49729,18.21424,1504
191020,012ABD06F231728C214A4BA917E75B1C,31561,0,7,7,109.56792,18.28479,1765
191021,012ABD06F231728C214A4BA917E75B1C,30851,10,14,4,109.5616,18.27396,1713
191022,012ABD06F231728C214A4BA917E75B1C,31561,15,22,7,109.56792,18.28479,1765
191026,A8E9C7BB918ADAD29A3EA7ACDDCD32D7,38951,0,11,11,109.48097,18.28868,1416
191027,A8E9C7BB918ADAD29A3EA7ACDDCD32D7,38951,11,14,3,109.48097,18.28868,1416
191028,A8E9C7BB918ADAD29A3EA7ACDDCD32D7,38951,14,23,9,109.48097,18.28868,1416
191029,213AF2099653A4ADAEF799CCC144B279,30021,0,14,14,109.12014,18.40986,86
191031,51061B3DE820AF1C1C713EF684728003,31071,5,6,1,109.58257,18.28458,1815
191032,51061B3DE820AF1C1C713EF684728003,30854,7,22,15,109.56889,18.27076,1763
191051,23C072325D16F69046C57FE53EA6F9E0,31071,0,9,9,109.58257,18.28458,1815
191052,23C072325D16F69046C57FE53EA6F9E0,30854,11,12,1,109.56889,18.27076,1763
191053,23C072325D16F69046C57FE53EA6F9E0,31811,15,16,1,109.54201,18.31806,1671
191059,1980C8D409DE9551539224B3D393CDAA,38991,0,6,6,109.52681,18.30368,1618
191060,1980C8D409DE9551539224B3D393CDAA,31951,6,8,2,109.52174,18.30299,1568
191061,1980C8D409DE9551539224B3D393CDAA,30071,8,11,3,109.52819,18.30472,1619
191062,1980C8D409DE9551539224B3D393CDAA,31951,13,18,5,109.52174,18.30299,1568
191077,68BC4ECB523764DB770AFD5383D642C3,60201,0,7,7,109.5041,18.2509,1510
191078,68BC4ECB523764DB770AFD5383D642C3,60161,10,11,1,109.49174,18.26181,1461
191079,68BC4ECB523764DB770AFD5383D642C3,30071,12,13,1,109.52819,18.30472,1619
191080,68BC4ECB523764DB770AFD5383D642C3,38275,14,18,4,109.62875,18.22938,2006
191081,68BC4ECB523764DB770AFD5383D642C3,30071,18,20,2,109.52819,18.30472,1619
191089,1C9A566B8DA1C771B0866D2AEB70C2F0,31031,19,20,1,109.49979,18.25382,1510
191090,1C9A566B8DA1C771B0866D2AEB70C2F0,30671,21,23,2,109.43611,18.30139,1268
191098,CA63110F88D6457AD774A164FA870244,60231,0,13,13,109.49903,18.21972,1504
191099,CA63110F88D6457AD774A164FA870244,30531,16,21,5,109.53271,18.21472,1604
191112,D9AE11CD16B231308C3F0FB3F53BC3E9,30854,0,8,8,109.56889,18.27076,1763
191113,D9AE11CD16B231308C3F0FB3F53BC3E9,31071,9,10,1,109.58257,18.28458,1815
191114,D9AE11CD16B231308C3F0FB3F53BC3E9,31071,11,16,5,109.58257,18.28458,1815
191173,E9A67CAEAD4E146EE721320A56F893AA,31071,0,10,10,109.58257,18.28458,1815
191174,E9A67CAEAD4E146EE721320A56F893AA,30854,14,17,3,109.56889,18.27076,1763
191175,E9A67CAEAD4E146EE721320A56F893AA,31945,19,20,1,109.58021,18.29403,1817
191176,E9A67CAEAD4E146EE721320A56F893AA,31071,21,23,2,109.58257,18.28458,1815
191193,43E035AE85036EBD9891453E9567CB81,30151,0,14,14,109.50986,18.25083,1560
191194,43E035AE85036EBD9891453E9567CB81,30151,17,19,2,109.50986,18.25083,1560
191195,43E035AE85036EBD9891453E9567CB81,30151,21,23,2,109.50986,18.25083,1560
191204,6E54413485CBDE34C6A9D84D5B11990A,31781,12,14,2,109.19847,18.2975,367
191278,FB01CB4AAEF97941600363E726859DCF,31521,0,7,7,109.51458,18.22542,1555
191279,FB01CB4AAEF97941600363E726859DCF,60381,7,8,1,109.5241,18.22458,1605
191280,FB01CB4AAEF97941600363E726859DCF,31781,10,13,3,109.19847,18.2975,367
191281,FB01CB4AAEF97941600363E726859DCF,31521,16,23,7,109.51458,18.22542,1555
191308,D4AA3869830031578B573FD0033C24A8,31931,17,19,2,109.54771,18.29403,1667
191309,D4AA3869830031578B573FD0033C24A8,60371,19,22,3,109.53063,18.30056,1618
191323,377A324496E54511961704972731A3D5,39111,0,1,1,109.5191,18.22597,1555
191324,377A324496E54511961704972731A3D5,31821,1,8,7,109.51181,18.24924,1559
191325,377A324496E54511961704972731A3D5,31521,13,15,2,109.51458,18.22542,1555
191326,377A324496E54511961704972731A3D5,39111,17,21,4,109.5191,18.22597,1555
191372,D0644281647025A7A26484BC424A7256,31101,0,1,1,109.65389,18.23403,2057
191373,D0644281647025A7A26484BC424A7256,38052,3,13,10,109.62618,18.23042,1956
191374,D0644281647025A7A26484BC424A7256,38331,13,15,2,109.62465,18.22736,1956
191375,D0644281647025A7A26484BC424A7256,31321,18,19,1,109.63799,18.23201,2007
191376,D0644281647025A7A26484BC424A7256,38052,19,21,2,109.62618,18.23042,1956
191377,D0644281647025A7A26484BC424A7256,38331,21,23,2,109.62465,18.22736,1956
191424,9AA959ED87D1ECC3053DED17290EFCBD,39183,0,4,4,109.55542,18.28208,1715
191425,9AA959ED87D1ECC3053DED17290EFCBD,31561,5,7,2,109.56792,18.28479,1765
191426,9AA959ED87D1ECC3053DED17290EFCBD,39183,8,16,8,109.55542,18.28208,1715
191427,9AA959ED87D1ECC3053DED17290EFCBD,30851,19,20,1,109.5616,18.27396,1713
191491,C37DBDD12F85B1DFB17F9185AF0E7708,30951,1,15,14,109.56208,18.25667,1761
191492,C37DBDD12F85B1DFB17F9185AF0E7708,39371,19,20,1,109.56627,18.2646,1762
191508,7084657DF30063A945AAA5EF4742695F,39183,12,13,1,109.55542,18.28208,1715
191509,7084657DF30063A945AAA5EF4742695F,31931,15,16,1,109.54771,18.29403,1667
191510,7084657DF30063A945AAA5EF4742695F,39183,19,23,4,109.55542,18.28208,1715
191572,40285EE8CCE25C38988EC087545664EC,31071,4,7,3,109.58257,18.28458,1815
191573,40285EE8CCE25C38988EC087545664EC,30854,10,15,5,109.56889,18.27076,1763
191574,40285EE8CCE25C38988EC087545664EC,31071,18,19,1,109.58257,18.28458,1815
191575,40285EE8CCE25C38988EC087545664EC,30854,22,23,1,109.56889,18.27076,1763
191624,69F4307E378774E8E49F5A5A6F5C64A6,60281,0,4,4,109.51743,18.25924,1561
191625,69F4307E378774E8E49F5A5A6F5C64A6,30921,8,13,5,109.53903,18.29451,1667
191626,69F4307E378774E8E49F5A5A6F5C64A6,31931,15,16,1,109.54771,18.29403,1667
191627,69F4307E378774E8E49F5A5A6F5C64A6,30921,18,20,2,109.53903,18.29451,1667
191628,C49E05BA9578491269BA059D71D7A080,38027,19,20,1,109.38833,18.2909,1066
191629,C49E05BA9578491269BA059D71D7A080,30351,22,23,1,109.41701,18.29292,1217
191641,C8922FAF66F21ECAECB6B717FCD5A53B,60614,0,6,6,109.48799,18.29521,1467
191642,C8922FAF66F21ECAECB6B717FCD5A53B,60391,6,9,3,109.47667,18.28757,1416
191643,C8922FAF66F21ECAECB6B717FCD5A53B,60614,9,16,7,109.48799,18.29521,1467
191644,C8922FAF66F21ECAECB6B717FCD5A53B,60391,16,18,2,109.47667,18.28757,1416
191645,C8922FAF66F21ECAECB6B717FCD5A53B,60614,19,23,4,109.48799,18.29521,1467
191693,A503639E15A0B5D04B0130D882921438,30711,0,17,17,109.50271,18.25347,1510
191694,A503639E15A0B5D04B0130D882921438,31031,18,23,5,109.49979,18.25382,1510
191705,FD5B9AB034F15F72E8BEF02193669238,60241,0,13,13,109.53319,18.28667,1616
191706,FD5B9AB034F15F72E8BEF02193669238,30921,14,16,2,109.53903,18.29451,1667
191707,86602408BC637A2A44D2EC51BE779605,39041,13,14,1,109.40021,18.29278,1117
191708,86602408BC637A2A44D2EC51BE779605,31671,15,17,2,109.38965,18.29813,1068
191711,EABE9486B25B9331D9C92F2ACD69756F,38336,0,11,11,109.61111,18.21806,1904
191712,EABE9486B25B9331D9C92F2ACD69756F,60201,12,20,8,109.5041,18.2509,1510
191713,EABE9486B25B9331D9C92F2ACD69756F,60381,21,23,2,109.5241,18.22458,1605
191716,04ABA8BFD5D63DDF1B83BA0577C9019C,39371,2,8,6,109.56627,18.2646,1762
191717,04ABA8BFD5D63DDF1B83BA0577C9019C,30854,9,10,1,109.56889,18.27076,1763
191718,04ABA8BFD5D63DDF1B83BA0577C9019C,39371,12,13,1,109.56627,18.2646,1762
191719,04ABA8BFD5D63DDF1B83BA0577C9019C,30854,15,16,1,109.56889,18.27076,1763
191720,04ABA8BFD5D63DDF1B83BA0577C9019C,39371,19,20,1,109.56627,18.2646,1762
191729,00678D3F0FE479614070948AEC721AF0,30854,0,9,9,109.56889,18.27076,1763
191730,00678D3F0FE479614070948AEC721AF0,38754,11,13,2,109.74667,18.37382,2430
191731,00678D3F0FE479614070948AEC721AF0,30854,17,20,3,109.56889,18.27076,1763
191764,E9E473F09C342630187345312F4A31D8,39181,0,16,16,109.55153,18.28035,1715
191765,E9E473F09C342630187345312F4A31D8,39181,18,23,5,109.55153,18.28035,1715
191774,08A066736557478B1013C0CF834491DF,30921,1,6,5,109.53903,18.29451,1667
191775,08A066736557478B1013C0CF834491DF,31931,6,18,12,109.54771,18.29403,1667
191806,E75CF54BA14775FEDD26504F9F6B7365,31945,0,6,6,109.58021,18.29403,1817
191807,E75CF54BA14775FEDD26504F9F6B7365,31561,7,17,10,109.56792,18.28479,1765
191808,E75CF54BA14775FEDD26504F9F6B7365,31945,18,23,5,109.58021,18.29403,1817
191825,D8EBCB05DE029B0DEDBF9FBDF3DA3C2D,60084,3,4,1,109.4984,18.2334,1507
191826,D8EBCB05DE029B0DEDBF9FBDF3DA3C2D,30271,8,17,9,109.49132,18.23153,1456
191827,D8EBCB05DE029B0DEDBF9FBDF3DA3C2D,31031,18,19,1,109.49979,18.25382,1510
191828,D8EBCB05DE029B0DEDBF9FBDF3DA3C2D,30211,19,21,2,109.49882,18.23931,1508
191836,60C76AD19DF8888A84F620E94C92FF2B,60084,1,2,1,109.4984,18.2334,1507
191837,60C76AD19DF8888A84F620E94C92FF2B,39151,4,5,1,109.49875,18.25097,1510
191838,60C76AD19DF8888A84F620E94C92FF2B,60231,10,15,5,109.49903,18.21972,1504
191839,60C76AD19DF8888A84F620E94C92FF2B,60084,16,17,1,109.4984,18.2334,1507
191840,60C76AD19DF8888A84F620E94C92FF2B,30531,18,20,2,109.53271,18.21472,1604
191855,D46DE9169E4BACF1D272EA5E0FDEF68F,31561,2,5,3,109.56792,18.28479,1765
191856,D46DE9169E4BACF1D272EA5E0FDEF68F,39183,8,10,2,109.55542,18.28208,1715
191857,D46DE9169E4BACF1D272EA5E0FDEF68F,31561,11,12,1,109.56792,18.28479,1765
191859,19464A667335AE139DC940C83825CBD8,30161,10,15,5,109.50042,18.24389,1508
191877,2AE38FAF341950B0B91404FFCE5A0F3E,31931,0,6,6,109.54771,18.29403,1667
191878,2AE38FAF341950B0B91404FFCE5A0F3E,30921,6,17,11,109.53903,18.29451,1667
191879,2AE38FAF341950B0B91404FFCE5A0F3E,31931,18,22,4,109.54771,18.29403,1667
191884,75616D7735994EB9CD2FE56D29700535,30854,7,11,4,109.56889,18.27076,1763
191885,75616D7735994EB9CD2FE56D29700535,31421,14,16,2,109.55382,18.22347,1705
191886,39F25FE146A03325C93C111F2A943B6C,31945,0,7,7,109.58021,18.29403,1817
191887,39F25FE146A03325C93C111F2A943B6C,31071,8,9,1,109.58257,18.28458,1815
191888,39F25FE146A03325C93C111F2A943B6C,31945,12,13,1,109.58021,18.29403,1817
191889,39F25FE146A03325C93C111F2A943B6C,30854,15,16,1,109.56889,18.27076,1763
191890,39F25FE146A03325C93C111F2A943B6C,31071,19,20,1,109.58257,18.28458,1815
191891,39F25FE146A03325C93C111F2A943B6C,30854,20,22,2,109.56889,18.27076,1763
191907,5DD2873132009BD9D866BCA396BA3ECB,31431,0,8,8,109.44639,18.29042,1316
191908,5DD2873132009BD9D866BCA396BA3ECB,60231,12,13,1,109.49903,18.21972,1504
191909,5DD2873132009BD9D866BCA396BA3ECB,60441,14,23,9,109.46792,18.28604,1366
191921,67A3119E82936DF1B07EFCD41ABA5080,31271,0,8,8,109.48958,18.26257,1462
191922,67A3119E82936DF1B07EFCD41ABA5080,38094,9,10,1,109.45403,18.28778,1316
191923,67A3119E82936DF1B07EFCD41ABA5080,60054,13,14,1,109.3016,18.31229,770
191924,67A3119E82936DF1B07EFCD41ABA5080,31271,18,22,4,109.48958,18.26257,1462
191961,14AE6C820CE45F96077630992CABD33D,39371,2,13,11,109.56627,18.2646,1762
191962,14AE6C820CE45F96077630992CABD33D,30851,13,14,1,109.5616,18.27396,1713
191963,14AE6C820CE45F96077630992CABD33D,39371,14,16,2,109.56627,18.2646,1762
191964,14AE6C820CE45F96077630992CABD33D,30951,18,21,3,109.56208,18.25667,1761
191971,DFFF17B7FE30E79B8AABBB5CE171272F,31561,10,11,1,109.56792,18.28479,1765
191972,DFFF17B7FE30E79B8AABBB5CE171272F,30854,12,14,2,109.56889,18.27076,1763
191973,DFFF17B7FE30E79B8AABBB5CE171272F,31561,15,17,2,109.56792,18.28479,1765
191974,DFFF17B7FE30E79B8AABBB5CE171272F,39183,20,21,1,109.55542,18.28208,1715
192030,DCFC026A83B81F5FB8797C8205011404,31181,0,2,2,109.50382,18.24813,1509
192031,DCFC026A83B81F5FB8797C8205011404,39151,3,5,2,109.49875,18.25097,1510
192032,EC4B90EDBF35256FDB4D4F8B87DB8A04,31071,0,13,13,109.58257,18.28458,1815
192033,EC4B90EDBF35256FDB4D4F8B87DB8A04,30854,16,17,1,109.56889,18.27076,1763
192034,8CD15CF6B5FB4821940FF9AFE6D6CB84,39181,0,9,9,109.55153,18.28035,1715
192035,8CD15CF6B5FB4821940FF9AFE6D6CB84,31931,11,13,2,109.54771,18.29403,1667
192036,8CD15CF6B5FB4821940FF9AFE6D6CB84,30361,14,15,1,109.50347,18.24,1508
192037,8CD15CF6B5FB4821940FF9AFE6D6CB84,31931,19,21,2,109.54771,18.29403,1667
192153,3E06E0B107AE9E10530FC9DE60417A9C,30854,0,9,9,109.56889,18.27076,1763
192154,3E06E0B107AE9E10530FC9DE60417A9C,31071,9,19,10,109.58257,18.28458,1815
192169,03CEC0FDDD5484124514C6D24A63D4DD,30854,0,2,2,109.56889,18.27076,1763
192170,03CEC0FDDD5484124514C6D24A63D4DD,31561,4,13,9,109.56792,18.28479,1765
192171,03CEC0FDDD5484124514C6D24A63D4DD,39183,14,16,2,109.55542,18.28208,1715
192172,03CEC0FDDD5484124514C6D24A63D4DD,31561,16,20,4,109.56792,18.28479,1765
192189,38CF8AD578A393476F29705A4599B8B1,38891,0,8,8,109.51486,18.24118,1558
192190,38CF8AD578A393476F29705A4599B8B1,38271,12,13,1,109.62632,18.23049,1956
192191,38CF8AD578A393476F29705A4599B8B1,31041,17,18,1,109.50278,18.23701,1507
192192,38CF8AD578A393476F29705A4599B8B1,38891,20,23,3,109.51486,18.24118,1558
192199,9FEB0895D82B765FC0B1993DBDBFB56B,31071,1,2,1,109.58257,18.28458,1815
192200,9FEB0895D82B765FC0B1993DBDBFB56B,30854,3,16,13,109.56889,18.27076,1763
192201,9FEB0895D82B765FC0B1993DBDBFB56B,31071,16,23,7,109.58257,18.28458,1815
192204,15565874522715FB4EEB4DFBF24CA2B9,31491,0,6,6,109.73042,18.38771,2382
192205,15565874522715FB4EEB4DFBF24CA2B9,38754,8,9,1,109.74667,18.37382,2430
192206,15565874522715FB4EEB4DFBF24CA2B9,31951,10,11,1,109.52174,18.30299,1568
192207,15565874522715FB4EEB4DFBF24CA2B9,60171,12,13,1,109.51292,18.30694,1569
192208,15565874522715FB4EEB4DFBF24CA2B9,38754,13,19,6,109.74667,18.37382,2430
192221,E987E65408C33CB1112132CB6DDF2895,38391,0,6,6,109.44111,18.29083,1266
192222,E987E65408C33CB1112132CB6DDF2895,31431,9,23,14,109.44639,18.29042,1316
192230,2F3BB5BE10811E7F8F8565DAA2126DE6,39181,0,6,6,109.55153,18.28035,1715
192231,2F3BB5BE10811E7F8F8565DAA2126DE6,39181,9,13,4,109.55153,18.28035,1715
192232,2F3BB5BE10811E7F8F8565DAA2126DE6,39181,15,23,8,109.55153,18.28035,1715
192342,1D8B814EC83D52D7C5F3FED99C129EE0,60631,1,2,1,109.57778,18.27583,1814
192343,1D8B814EC83D52D7C5F3FED99C129EE0,30854,4,6,2,109.56889,18.27076,1763
192344,1D8B814EC83D52D7C5F3FED99C129EE0,38271,10,20,10,109.62632,18.23049,1956
192345,1D8B814EC83D52D7C5F3FED99C129EE0,31561,22,23,1,109.56792,18.28479,1765
192350,8AD957ABE98C62A8B6F06AA624D5CB23,30854,6,12,6,109.56889,18.27076,1763
192351,8AD957ABE98C62A8B6F06AA624D5CB23,31071,13,16,3,109.58257,18.28458,1815
192352,8AD957ABE98C62A8B6F06AA624D5CB23,31071,18,23,5,109.58257,18.28458,1815
192419,4F1F2C63B1D8098AD9ABA50013979078,30151,0,2,2,109.50986,18.25083,1560
192420,4F1F2C63B1D8098AD9ABA50013979078,30151,4,15,11,109.50986,18.25083,1560
192421,4F1F2C63B1D8098AD9ABA50013979078,30051,16,17,1,109.48917,18.21215,1453
192422,4F1F2C63B1D8098AD9ABA50013979078,60614,20,23,3,109.48799,18.29521,1467
192428,3336A16929AE164DE73ACCE3EDAB4195,31521,0,6,6,109.51458,18.22542,1555
192429,3336A16929AE164DE73ACCE3EDAB4195,31471,10,11,1,109.34583,18.29563,917
192430,3336A16929AE164DE73ACCE3EDAB4195,30661,11,14,3,109.37028,18.24361,1008
192431,3336A16929AE164DE73ACCE3EDAB4195,31521,16,18,2,109.51458,18.22542,1555
192432,3336A16929AE164DE73ACCE3EDAB4195,39111,18,23,5,109.5191,18.22597,1555
192472,71D35ED12FD809FD321ED1C8285B5582,31781,13,14,1,109.19847,18.2975,367
192473,71D35ED12FD809FD321ED1C8285B5582,31471,15,16,1,109.34583,18.29563,917
192474,71D35ED12FD809FD321ED1C8285B5582,38951,21,23,2,109.48097,18.28868,1416
192509,947F03940C60BAB03B48F948CC8A55AE,60121,14,15,1,109.74507,18.37472,2430
192510,947F03940C60BAB03B48F948CC8A55AE,30861,20,22,2,109.52722,18.22743,1606
192565,591FE6773219F44C74B8131639493332,31391,0,8,8,109.50382,18.24285,1508
192566,591FE6773219F44C74B8131639493332,30511,10,12,2,109.51069,18.24208,1558
192567,591FE6773219F44C74B8131639493332,30361,12,14,2,109.50347,18.24,1508
192568,591FE6773219F44C74B8131639493332,60594,15,17,2,109.62694,18.22799,1956
192569,591FE6773219F44C74B8131639493332,30441,19,21,2,109.64021,18.25424,2010
192578,5EE25A6E7DD554FFDA0C9C1A504114B7,60291,0,6,6,109.50826,18.24639,1509
192579,5EE25A6E7DD554FFDA0C9C1A504114B7,30221,8,18,10,109.57833,18.20222,1802
192580,5EE25A6E7DD554FFDA0C9C1A504114B7,31811,19,20,1,109.54201,18.31806,1671
192581,5EE25A6E7DD554FFDA0C9C1A504114B7,30221,21,22,1,109.57833,18.20222,1802
192608,E7DB0F55EDE33BB4C08C98B80B7173BF,30771,14,15,1,109.49938,18.26042,1511
192609,E7DB0F55EDE33BB4C08C98B80B7173BF,60371,18,23,5,109.53063,18.30056,1618
192610,410ABF8C14ACED0B5467A09396FAD1E3,31071,8,9,1,109.58257,18.28458,1815
192611,410ABF8C14ACED0B5467A09396FAD1E3,30854,12,16,4,109.56889,18.27076,1763
192612,410ABF8C14ACED0B5467A09396FAD1E3,31071,16,21,5,109.58257,18.28458,1815
192613,7BF65E5054DA81A230AB5423620158E1,30854,7,8,1,109.56889,18.27076,1763
192614,7BF65E5054DA81A230AB5423620158E1,31071,9,10,1,109.58257,18.28458,1815
192615,7BF65E5054DA81A230AB5423620158E1,30854,11,15,4,109.56889,18.27076,1763
192616,7BF65E5054DA81A230AB5423620158E1,31071,15,17,2,109.58257,18.28458,1815
192617,ADC7B707FBBD7BF3F9ACE0C092DAADE5,30921,0,6,6,109.53903,18.29451,1667
192618,ADC7B707FBBD7BF3F9ACE0C092DAADE5,31931,10,16,6,109.54771,18.29403,1667
192619,ADC7B707FBBD7BF3F9ACE0C092DAADE5,30921,17,18,1,109.53903,18.29451,1667
192634,D1A5E6081E70F748BFD3C6895B141C01,60411,0,2,2,109.32514,18.30854,869
192635,D1A5E6081E70F748BFD3C6895B141C01,30661,2,4,2,109.37028,18.24361,1008
192636,D1A5E6081E70F748BFD3C6895B141C01,60411,4,6,2,109.32514,18.30854,869
192637,D1A5E6081E70F748BFD3C6895B141C01,30661,7,19,12,109.37028,18.24361,1008
192638,D1A5E6081E70F748BFD3C6895B141C01,60411,21,23,2,109.32514,18.30854,869
192650,C58D0182BFC61ED113EE3B09763C30B2,38185,0,6,6,109.51333,18.27347,1563
192651,C58D0182BFC61ED113EE3B09763C30B2,31931,10,13,3,109.54771,18.29403,1667
192652,C58D0182BFC61ED113EE3B09763C30B2,38127,18,19,1,109.50833,18.27222,1513
192653,C58D0182BFC61ED113EE3B09763C30B2,38185,19,23,4,109.51333,18.27347,1563
192701,394D1710D25BBA6EE7532E3C0B5270CF,38111,13,14,1,109.52007,18.22403,1555
192702,394D1710D25BBA6EE7532E3C0B5270CF,39321,15,16,1,109.529,18.2167,1604
192703,394D1710D25BBA6EE7532E3C0B5270CF,31521,20,22,2,109.51458,18.22542,1555
192712,4053323049FA57896819CD5356E38746,30854,1,10,9,109.56889,18.27076,1763
192713,4053323049FA57896819CD5356E38746,31071,10,11,1,109.58257,18.28458,1815
192714,4053323049FA57896819CD5356E38746,30854,12,23,11,109.56889,18.27076,1763
192737,A46BA306DAEA889FAC7ACE9E5FD6A1FF,60331,1,6,5,109.505,18.26507,1512
192738,A46BA306DAEA889FAC7ACE9E5FD6A1FF,30911,6,10,4,109.50493,18.26181,1511
192739,A46BA306DAEA889FAC7ACE9E5FD6A1FF,30421,10,11,1,109.50021,18.25861,1511
192740,A46BA306DAEA889FAC7ACE9E5FD6A1FF,30371,13,15,2,109.51,18.24771,1559
192748,B84B247FA61A8C12DFCCCF3C2D72006D,30854,0,10,10,109.56889,18.27076,1763
192749,B84B247FA61A8C12DFCCCF3C2D72006D,31071,10,11,1,109.58257,18.28458,1815
192750,B84B247FA61A8C12DFCCCF3C2D72006D,30854,14,16,2,109.56889,18.27076,1763
192751,B84B247FA61A8C12DFCCCF3C2D72006D,31071,16,18,2,109.58257,18.28458,1815
192773,D17842D1E850E617B4B15889C460D1C5,31931,0,10,10,109.54771,18.29403,1667
192774,D17842D1E850E617B4B15889C460D1C5,30921,11,12,1,109.53903,18.29451,1667
192775,D17842D1E850E617B4B15889C460D1C5,31931,12,22,10,109.54771,18.29403,1667
192779,23348D27AE799B0D96AE7DABCCDD8B0C,31861,0,7,7,109.49042,18.27549,1464
192780,23348D27AE799B0D96AE7DABCCDD8B0C,31471,9,10,1,109.34583,18.29563,917
192781,23348D27AE799B0D96AE7DABCCDD8B0C,30661,11,12,1,109.37028,18.24361,1008
192787,7F3DDE6B55C3459C61E435131FEEF622,31351,0,10,10,109.4959,18.28417,1465
192788,7F3DDE6B55C3459C61E435131FEEF622,30581,13,14,1,109.62257,18.24951,1959
192789,7F3DDE6B55C3459C61E435131FEEF622,38171,19,21,2,109.50799,18.28139,1515
192799,6C0260646767B781577B5B8CE2471E51,31951,4,5,1,109.52174,18.30299,1568
192800,6C0260646767B781577B5B8CE2471E51,38484,7,11,4,109.53028,18.31528,1620
192801,6C0260646767B781577B5B8CE2471E51,60361,14,15,1,109.51938,18.29681,1567
192802,6C0260646767B781577B5B8CE2471E51,38484,15,17,2,109.53028,18.31528,1620
192803,6C0260646767B781577B5B8CE2471E51,30321,18,19,1,109.49563,18.29611,1467
192804,6C0260646767B781577B5B8CE2471E51,38484,20,21,1,109.53028,18.31528,1620
192805,20C15B76A1E0DF79D86EDEAC7BC3D7B7,30854,0,10,10,109.56889,18.27076,1763
192806,20C15B76A1E0DF79D86EDEAC7BC3D7B7,31071,12,13,1,109.58257,18.28458,1815
192807,20C15B76A1E0DF79D86EDEAC7BC3D7B7,31945,16,17,1,109.58021,18.29403,1817
192812,7CCF6D37DF7208BEF6187AE3AF915883,39111,0,4,4,109.5191,18.22597,1555
192813,7CCF6D37DF7208BEF6187AE3AF915883,30731,4,6,2,109.50944,18.22306,1555
192814,7CCF6D37DF7208BEF6187AE3AF915883,31781,8,12,4,109.19847,18.2975,367
192815,7CCF6D37DF7208BEF6187AE3AF915883,30731,17,23,6,109.50944,18.22306,1555
192842,63B5E489F3503F8EC6E40A38F9D2117C,31031,11,13,2,109.49979,18.25382,1510
192843,63B5E489F3503F8EC6E40A38F9D2117C,31951,14,17,3,109.52174,18.30299,1568
192844,63B5E489F3503F8EC6E40A38F9D2117C,60171,22,23,1,109.51292,18.30694,1569
192917,8AABF5FDF2B06EB445749240A3894969,31161,12,14,2,109.70229,18.31361,2270
192918,8AABF5FDF2B06EB445749240A3894969,31851,14,16,2,109.71736,18.29007,2316
192928,4B6FFEFB36770528DA20871CE9291F99,31391,0,6,6,109.50382,18.24285,1508
192929,4B6FFEFB36770528DA20871CE9291F99,60381,11,16,5,109.5241,18.22458,1605
192930,4B6FFEFB36770528DA20871CE9291F99,31521,18,23,5,109.51458,18.22542,1555
192933,FC4E540B07DB36C2A24C73051E1FA6C0,30171,0,8,8,109.48458,18.27139,1463
192934,FC4E540B07DB36C2A24C73051E1FA6C0,60401,9,18,9,109.47444,18.27583,1414
192935,FC4E540B07DB36C2A24C73051E1FA6C0,30171,20,23,3,109.48458,18.27139,1463
192948,B2035C0684FF9CA861B7EB217CE5A160,60524,0,5,5,109.42951,18.28993,1216
192949,B2035C0684FF9CA861B7EB217CE5A160,31236,6,8,2,109.42965,18.29111,1216
192950,B2035C0684FF9CA861B7EB217CE5A160,30351,10,14,4,109.41701,18.29292,1217
192951,B2035C0684FF9CA861B7EB217CE5A160,60041,16,19,3,109.39889,18.31944,1121
192952,B2035C0684FF9CA861B7EB217CE5A160,60552,20,22,2,109.41729,18.30014,1218
192953,FD8E83DD7FF39A687AC2462EEEA479A1,30171,0,7,7,109.48458,18.27139,1463
192954,FD8E83DD7FF39A687AC2462EEEA479A1,30051,9,15,6,109.48917,18.21215,1453
192961,FE95B3A32EFBC2838F293DF38F55FDD1,30851,2,3,1,109.5616,18.27396,1713
192962,FE95B3A32EFBC2838F293DF38F55FDD1,39183,3,14,11,109.55542,18.28208,1715
192963,FE95B3A32EFBC2838F293DF38F55FDD1,31561,16,17,1,109.56792,18.28479,1765
192964,FE95B3A32EFBC2838F293DF38F55FDD1,39183,17,19,2,109.55542,18.28208,1715
192999,5A6C2C4A9B4DF43C379FCADC2CCFC5BC,39331,20,21,1,109.62125,18.22708,1956
193000,5A6C2C4A9B4DF43C379FCADC2CCFC5BC,30201,22,23,1,109.4909,18.26465,1462
193027,E8BAAF476E8FE57075BAB1A8D4FF1780,30232,0,4,4,109.6191,18.31701,1971
193028,E8BAAF476E8FE57075BAB1A8D4FF1780,39371,5,6,1,109.56627,18.2646,1762
193029,E8BAAF476E8FE57075BAB1A8D4FF1780,30181,11,12,1,109.51597,18.23313,1557
193030,E8BAAF476E8FE57075BAB1A8D4FF1780,39371,14,17,3,109.56627,18.2646,1762
193031,E8BAAF476E8FE57075BAB1A8D4FF1780,31181,18,21,3,109.50382,18.24813,1509
193073,9A1D1AA5EE2CD156CC396C667ED8C5B9,31071,2,7,5,109.58257,18.28458,1815
193074,9A1D1AA5EE2CD156CC396C667ED8C5B9,30854,8,11,3,109.56889,18.27076,1763
193075,9A1D1AA5EE2CD156CC396C667ED8C5B9,31071,14,16,2,109.58257,18.28458,1815
193076,9A1D1AA5EE2CD156CC396C667ED8C5B9,31071,20,22,2,109.58257,18.28458,1815
193101,5FEB0F79A440C59BADB91987EC64815F,30421,20,21,1,109.50021,18.25861,1511
193112,798BF3B08F72A16A6DEAAA235F1899BB,61011,9,13,4,109.60653,18.19076,1900
193114,798BF3B08F72A16A6DEAAA235F1899BB,61011,20,23,3,109.60653,18.19076,1900
193171,DF467C78D5F42677C535DD714DC268A2,30721,17,19,2,109.51597,18.28257,1565
193172,DF467C78D5F42677C535DD714DC268A2,38316,21,23,2,109.48542,18.27424,1464
193248,3B8907096B5BACD5BD7132435146A19A,60041,12,15,3,109.39889,18.31944,1121
193249,3B8907096B5BACD5BD7132435146A19A,30421,20,23,3,109.50021,18.25861,1511
193311,4C8D744F276EFA40FC3A14D352CC4C3A,31471,15,17,2,109.34583,18.29563,917
193312,4C8D744F276EFA40FC3A14D352CC4C3A,60401,18,20,2,109.47444,18.27583,1414
193313,4C8D744F276EFA40FC3A14D352CC4C3A,60371,21,23,2,109.53063,18.30056,1618
193316,1B6EBBFF3B9D8A3E18753343B6A29EAE,31071,0,13,13,109.58257,18.28458,1815
193317,1B6EBBFF3B9D8A3E18753343B6A29EAE,30851,15,16,1,109.5616,18.27396,1713
193318,1B6EBBFF3B9D8A3E18753343B6A29EAE,31071,18,23,5,109.58257,18.28458,1815
193323,02C53C5746E38501957FE72E2C83CCA4,31251,0,6,6,109.18528,18.2975,317
193324,02C53C5746E38501957FE72E2C83CCA4,30651,6,8,2,109.42611,18.385,1232
193325,02C53C5746E38501957FE72E2C83CCA4,31231,8,9,1,109.42597,18.29292,1217
193326,02C53C5746E38501957FE72E2C83CCA4,60161,12,22,10,109.49174,18.26181,1461
193357,FFCD3E0626E46D21B910BCE8EF3AFA0E,30731,3,5,2,109.50944,18.22306,1555
193358,FFCD3E0626E46D21B910BCE8EF3AFA0E,30191,5,13,8,109.50361,18.22701,1506
193359,FFCD3E0626E46D21B910BCE8EF3AFA0E,30711,13,19,6,109.50271,18.25347,1510
193360,FFCD3E0626E46D21B910BCE8EF3AFA0E,30711,21,23,2,109.50271,18.25347,1510
193362,39CA4FE8290F03A5AE8EA1D8371B2A6D,30121,19,23,4,109.52861,18.27222,1613
193372,572E2789911180212572284EC334CD9D,30661,14,15,1,109.37028,18.24361,1008
193373,572E2789911180212572284EC334CD9D,60501,18,19,1,109.48701,18.29021,1466
193374,572E2789911180212572284EC334CD9D,30421,20,23,3,109.50021,18.25861,1511
193410,BC7C85E5C2260F70932B05DBFD89E2B1,38951,0,7,7,109.48097,18.28868,1416
193411,BC7C85E5C2260F70932B05DBFD89E2B1,33051,9,10,1,109.6475,18.46618,2096
193412,BC7C85E5C2260F70932B05DBFD89E2B1,30661,13,15,2,109.37028,18.24361,1008
193420,68DBE0B52FD0AB95F1DD47068FD7847F,30181,0,11,11,109.51597,18.23313,1557
193421,68DBE0B52FD0AB95F1DD47068FD7847F,30181,16,19,3,109.51597,18.23313,1557
193422,68DBE0B52FD0AB95F1DD47068FD7847F,30181,20,21,1,109.51597,18.23313,1557
193423,68DBE0B52FD0AB95F1DD47068FD7847F,60291,22,23,1,109.50826,18.24639,1509
193431,8689824A579D05952F091FA3AFF461AB,60524,1,6,5,109.42951,18.28993,1216
193432,8689824A579D05952F091FA3AFF461AB,30351,6,7,1,109.41701,18.29292,1217
193433,8689824A579D05952F091FA3AFF461AB,31145,11,12,1,109.20431,18.30479,369
193451,6F6959FD6C59E6BB90C37E26B5C2BF83,30321,0,8,8,109.49563,18.29611,1467
193452,6F6959FD6C59E6BB90C37E26B5C2BF83,60361,8,10,2,109.51938,18.29681,1567
193453,6F6959FD6C59E6BB90C37E26B5C2BF83,30071,12,15,3,109.52819,18.30472,1619
193454,6F6959FD6C59E6BB90C37E26B5C2BF83,30071,15,19,4,109.52819,18.30472,1619
193455,6F6959FD6C59E6BB90C37E26B5C2BF83,60371,22,23,1,109.53063,18.30056,1618
193467,184447FB27346CCB581EA0ECE0E04766,38991,0,6,6,109.52681,18.30368,1618
193468,184447FB27346CCB581EA0ECE0E04766,31931,8,16,8,109.54771,18.29403,1667
193469,184447FB27346CCB581EA0ECE0E04766,30071,19,20,1,109.52819,18.30472,1619
193470,184447FB27346CCB581EA0ECE0E04766,38991,21,23,2,109.52681,18.30368,1618
193472,C2024D8A8EDBFD4FD401299F90BFADF5,39091,12,13,1,109.50097,18.25222,1510
193485,FDB9BD849EACDB9DE07F12A37BAD7769,60504,0,1,1,109.47917,18.28903,1416
193486,FDB9BD849EACDB9DE07F12A37BAD7769,38951,2,22,20,109.48097,18.28868,1416
193496,22CF7007721E0F1D863F25E4633BE1AD,60311,0,12,12,109.52097,18.24319,1558
193497,22CF7007721E0F1D863F25E4633BE1AD,31864,12,14,2,109.49014,18.28333,1465
193498,22CF7007721E0F1D863F25E4633BE1AD,30084,16,17,1,109.50118,18.26972,1513
193499,22CF7007721E0F1D863F25E4633BE1AD,60311,19,23,4,109.52097,18.24319,1558
193500,F0F4014EDBA84B976E9E99C8872ACAC4,30851,7,8,1,109.5616,18.27396,1713
193501,F0F4014EDBA84B976E9E99C8872ACAC4,31561,10,15,5,109.56792,18.28479,1765
193506,BCBE041A7FC025F9D2DFD86A6CB75E1D,60011,0,7,7,109.48965,18.30222,1468
193507,BCBE041A7FC025F9D2DFD86A6CB75E1D,30821,8,11,3,109.43681,18.33639,1274
193508,BCBE041A7FC025F9D2DFD86A6CB75E1D,30651,13,14,1,109.42611,18.385,1232
193509,BCBE041A7FC025F9D2DFD86A6CB75E1D,30821,18,19,1,109.43681,18.33639,1274
193523,E58E5EFF0A1D7ADABE8F5BBEE665ED0D,60641,0,7,7,109.53854,18.2359,1657
193524,E58E5EFF0A1D7ADABE8F5BBEE665ED0D,30861,8,11,3,109.52722,18.22743,1606
193525,E58E5EFF0A1D7ADABE8F5BBEE665ED0D,30861,14,16,2,109.52722,18.22743,1606
193526,E58E5EFF0A1D7ADABE8F5BBEE665ED0D,60661,18,19,1,109.548,18.2377,1657
193527,E58E5EFF0A1D7ADABE8F5BBEE665ED0D,30861,21,22,1,109.52722,18.22743,1606
193575,0D1ADFB613CDE463D41F9DE1E81A3FEA,31061,0,16,16,109.53333,18.23257,1607
193577,0D1ADFB613CDE463D41F9DE1E81A3FEA,30461,21,22,1,109.5116,18.26313,1562
193586,A9634A2AD8447824C1C9412CBBCC32E0,31181,0,9,9,109.50382,18.24813,1509
193587,A9634A2AD8447824C1C9412CBBCC32E0,31181,13,23,10,109.50382,18.24813,1509
193610,14BFE46EEAB2E234698393270A62605D,30661,0,11,11,109.37028,18.24361,1008
193611,14BFE46EEAB2E234698393270A62605D,60411,14,17,3,109.32514,18.30854,869
193612,14BFE46EEAB2E234698393270A62605D,30661,21,22,1,109.37028,18.24361,1008
193680,B175A0347ABEEA30E818C5CCD25E280F,30821,4,5,1,109.43681,18.33639,1274
193681,B175A0347ABEEA30E818C5CCD25E280F,60011,7,8,1,109.48965,18.30222,1468
193682,B175A0347ABEEA30E818C5CCD25E280F,30821,9,20,11,109.43681,18.33639,1274
193699,ED983BC21ECA3F6E34A13642C4FA2271,38484,11,12,1,109.53028,18.31528,1620
193707,8B69C410684F618B4BB94E686E30E787,31031,7,8,1,109.49979,18.25382,1510
193708,8B69C410684F618B4BB94E686E30E787,30201,8,9,1,109.4909,18.26465,1462
193709,8B69C410684F618B4BB94E686E30E787,38094,13,18,5,109.45403,18.28778,1316
193710,8B69C410684F618B4BB94E686E30E787,31531,19,22,3,109.49583,18.25972,1461
193737,EA4EEEA6F324C3F08DBAE63BA2B33BB6,30084,0,7,7,109.50118,18.26972,1513
193738,EA4EEEA6F324C3F08DBAE63BA2B33BB6,30361,8,11,3,109.50347,18.24,1508
193739,EA4EEEA6F324C3F08DBAE63BA2B33BB6,30084,12,16,4,109.50118,18.26972,1513
193740,EA4EEEA6F324C3F08DBAE63BA2B33BB6,30511,17,23,6,109.51069,18.24208,1558
193762,D0C08069F9C46B3F961C3CEB0437811E,38325,0,6,6,109.39792,18.2909,1116
193763,D0C08069F9C46B3F961C3CEB0437811E,60552,8,10,2,109.41729,18.30014,1218
193774,5403ECE41AD9921A5DEF63FF6DE6A9D1,31945,3,4,1,109.58021,18.29403,1817
193775,5403ECE41AD9921A5DEF63FF6DE6A9D1,31071,8,23,15,109.58257,18.28458,1815
193789,141A87FA0005158A87D02A7AC0237629,30421,18,20,2,109.50021,18.25861,1511
193800,B02D7A3F297B377D646E0F85B7C19006,61011,7,15,8,109.60653,18.19076,1900
193808,DC0A6E2B29DF09A30557DDD1B0786438,31031,15,17,2,109.49979,18.25382,1510
193809,DC0A6E2B29DF09A30557DDD1B0786438,31534,18,19,1,109.49368,18.25806,1461
193810,DC0A6E2B29DF09A30557DDD1B0786438,38251,21,23,2,109.49618,18.25493,1510
193819,BD5D5103B08534F20AF53FB58E9A43CA,39101,15,17,2,109.50132,18.24931,1509
193820,BD5D5103B08534F20AF53FB58E9A43CA,31931,21,22,1,109.54771,18.29403,1667
193821,7F6E66BC10419161F6457A6D79258EDB,60401,8,10,2,109.47444,18.27583,1414
193822,7F6E66BC10419161F6457A6D79258EDB,31031,11,13,2,109.49979,18.25382,1510
193823,7F6E66BC10419161F6457A6D79258EDB,38094,14,16,2,109.45403,18.28778,1316
193824,7F6E66BC10419161F6457A6D79258EDB,60621,20,23,3,109.48354,18.27451,1464
193860,372A5433078073EAD18922D679CE0A73,30661,4,6,2,109.37028,18.24361,1008
193861,372A5433078073EAD18922D679CE0A73,60411,6,8,2,109.32514,18.30854,869
193862,372A5433078073EAD18922D679CE0A73,30661,9,11,2,109.37028,18.24361,1008
193863,372A5433078073EAD18922D679CE0A73,60054,12,14,2,109.3016,18.31229,770
193864,372A5433078073EAD18922D679CE0A73,60411,17,19,2,109.32514,18.30854,869
193865,372A5433078073EAD18922D679CE0A73,30661,21,23,2,109.37028,18.24361,1008
193896,E008ACF509F77C075F3CE6807181F555,33354,11,12,1,109.67465,18.44583,2192
193897,E008ACF509F77C075F3CE6807181F555,33051,13,14,1,109.6475,18.46618,2096
193898,E008ACF509F77C075F3CE6807181F555,31101,16,17,1,109.65389,18.23403,2057
193899,E008ACF509F77C075F3CE6807181F555,38951,19,22,3,109.48097,18.28868,1416
193939,9316856FC9B7BE008DD2CC2209708EA4,30071,0,1,1,109.52819,18.30472,1619
193940,9316856FC9B7BE008DD2CC2209708EA4,60371,1,3,2,109.53063,18.30056,1618
193941,9316856FC9B7BE008DD2CC2209708EA4,30131,6,8,2,109.6959,18.215,2254
193942,9316856FC9B7BE008DD2CC2209708EA4,30121,10,20,10,109.52861,18.27222,1613
193943,9316856FC9B7BE008DD2CC2209708EA4,30131,22,23,1,109.6959,18.215,2254
193956,E99AD2D512B0301F624D366BCD84F80C,31781,13,15,2,109.19847,18.2975,367
193957,E99AD2D512B0301F624D366BCD84F80C,30071,17,19,2,109.52819,18.30472,1619
193958,B023927CBEC0A8053CBDF64A5B76E367,38017,0,6,6,109.49729,18.21424,1504
193959,B023927CBEC0A8053CBDF64A5B76E367,31931,9,15,6,109.54771,18.29403,1667
193960,B023927CBEC0A8053CBDF64A5B76E367,30921,15,16,1,109.53903,18.29451,1667
193961,B023927CBEC0A8053CBDF64A5B76E367,31931,16,17,1,109.54771,18.29403,1667
193962,B023927CBEC0A8053CBDF64A5B76E367,38017,18,20,2,109.49729,18.21424,1504
193963,B023927CBEC0A8053CBDF64A5B76E367,30051,21,22,1,109.48917,18.21215,1453
194016,45FA8AF959A216E06C82392E21728E7F,31561,0,10,10,109.56792,18.28479,1765
194017,45FA8AF959A216E06C82392E21728E7F,30851,14,16,2,109.5616,18.27396,1713
194018,45FA8AF959A216E06C82392E21728E7F,31561,21,23,2,109.56792,18.28479,1765
194059,D4EE8E1A4C04A1FF0596E4221D0B8B42,30854,1,2,1,109.56889,18.27076,1763
194060,D4EE8E1A4C04A1FF0596E4221D0B8B42,31071,7,8,1,109.58257,18.28458,1815
194061,D4EE8E1A4C04A1FF0596E4221D0B8B42,30854,8,12,4,109.56889,18.27076,1763
194062,D4EE8E1A4C04A1FF0596E4221D0B8B42,31071,13,15,2,109.58257,18.28458,1815
194069,7803AECF4FFC2BF233E3B7ACD0D2E9F8,39181,0,7,7,109.55153,18.28035,1715
194070,7803AECF4FFC2BF233E3B7ACD0D2E9F8,39183,7,8,1,109.55542,18.28208,1715
194071,7803AECF4FFC2BF233E3B7ACD0D2E9F8,31931,12,14,2,109.54771,18.29403,1667
194072,7803AECF4FFC2BF233E3B7ACD0D2E9F8,39183,14,15,1,109.55542,18.28208,1715
194073,7803AECF4FFC2BF233E3B7ACD0D2E9F8,39181,17,23,6,109.55153,18.28035,1715
194087,21C41A61C814FFC904BE2F7898C083F4,30854,0,7,7,109.56889,18.27076,1763
194088,21C41A61C814FFC904BE2F7898C083F4,31931,10,14,4,109.54771,18.29403,1667
194089,21C41A61C814FFC904BE2F7898C083F4,30854,19,23,4,109.56889,18.27076,1763
194105,5A888DC7A3AA300CC584D9862C5384A1,60331,2,8,6,109.505,18.26507,1512
194106,5A888DC7A3AA300CC584D9862C5384A1,30421,8,10,2,109.50021,18.25861,1511
194107,5A888DC7A3AA300CC584D9862C5384A1,39183,11,15,4,109.55542,18.28208,1715
194121,513C2C725960CB50EE4FAD755492AAB6,31471,13,14,1,109.34583,18.29563,917
194122,513C2C725960CB50EE4FAD755492AAB6,31861,15,23,8,109.49042,18.27549,1464
194161,546019449B49A5FCBBE36F9F3DB19C8A,30211,17,19,2,109.49882,18.23931,1508
194162,546019449B49A5FCBBE36F9F3DB19C8A,31231,19,23,4,109.42597,18.29292,1217
194193,FBDD80570A641C18D89F4987D07601F8,31071,4,6,2,109.58257,18.28458,1815
194194,FBDD80570A641C18D89F4987D07601F8,30854,10,21,11,109.56889,18.27076,1763
194253,92D84094136F2FB8B7D41AECD69A79AD,31206,0,8,8,109.50819,18.23549,1507
194254,92D84094136F2FB8B7D41AECD69A79AD,31201,12,14,2,109.51042,18.23819,1558
194255,92D84094136F2FB8B7D41AECD69A79AD,31461,15,18,3,109.5091,18.25389,1510
194256,92D84094136F2FB8B7D41AECD69A79AD,31201,22,23,1,109.51042,18.23819,1558
194298,E0B6F6926B372F679FEA2B9C5DA4FA6C,60071,1,6,5,109.75674,18.31583,2470
194324,86431DA9F6D3A0F087AFBE2023050B39,30071,0,14,14,109.52819,18.30472,1619
194326,9452CDA15F97056A23EBE77445992CB1,31701,0,8,8,109.44132,18.28833,1266
194327,9452CDA15F97056A23EBE77445992CB1,30341,8,9,1,109.3625,18.29167,966
194328,9452CDA15F97056A23EBE77445992CB1,30661,9,11,2,109.37028,18.24361,1008
194329,9452CDA15F97056A23EBE77445992CB1,31471,12,13,1,109.34583,18.29563,917
194330,9452CDA15F97056A23EBE77445992CB1,30661,13,15,2,109.37028,18.24361,1008
194331,9452CDA15F97056A23EBE77445992CB1,31701,20,23,3,109.44132,18.28833,1266
194332,3D8ADE80304FD3207128013D43F1118A,60421,0,13,13,109.46333,18.31743,1371
194333,3D8ADE80304FD3207128013D43F1118A,60274,14,17,3,109.514,18.2933,1567
194334,3D8ADE80304FD3207128013D43F1118A,30711,21,23,2,109.50271,18.25347,1510
194342,B80D6AB96D3D5CEE71A70ED25275F830,38951,1,8,7,109.48097,18.28868,1416
194343,B80D6AB96D3D5CEE71A70ED25275F830,30461,12,22,10,109.5116,18.26313,1562
194351,73409464FC717CED4BA77E4E505DD18C,31321,0,10,10,109.63799,18.23201,2007
194352,73409464FC717CED4BA77E4E505DD18C,31471,13,16,3,109.34583,18.29563,917
194353,73409464FC717CED4BA77E4E505DD18C,31321,19,23,4,109.63799,18.23201,2007
194354,0442B38E8824E569B00E80CCEFC70940,31561,1,4,3,109.56792,18.28479,1765
194355,0442B38E8824E569B00E80CCEFC70940,30071,7,9,2,109.52819,18.30472,1619
194356,0442B38E8824E569B00E80CCEFC70940,39183,9,11,2,109.55542,18.28208,1715
194357,0442B38E8824E569B00E80CCEFC70940,31561,12,22,10,109.56792,18.28479,1765
194387,06639AF8E634A2EA412E3ADD181BCABE,30361,12,14,2,109.50347,18.24,1508
194388,06639AF8E634A2EA412E3ADD181BCABE,31071,17,23,6,109.58257,18.28458,1815
194437,05A7525C75554A6F27954E59E5F0C64D,60291,18,19,1,109.50826,18.24639,1509
194438,05A7525C75554A6F27954E59E5F0C64D,30511,21,23,2,109.51069,18.24208,1558
194482,855D815DC19AA779325469411A9E7B8A,30251,0,6,6,109.50611,18.26653,1512
194483,855D815DC19AA779325469411A9E7B8A,38157,6,8,2,109.51483,18.26958,1563
194484,855D815DC19AA779325469411A9E7B8A,38157,12,14,2,109.51483,18.26958,1563
194485,855D815DC19AA779325469411A9E7B8A,38157,18,23,5,109.51483,18.26958,1563
194521,8621CFDF1B89A83351494618C53D033F,31071,0,6,6,109.58257,18.28458,1815
194522,8621CFDF1B89A83351494618C53D033F,39181,10,21,11,109.55153,18.28035,1715
194539,8E552343C8969B2EDD2EC2DFF2B0FA90,30561,11,16,5,109.52778,18.31938,1621
194540,8E552343C8969B2EDD2EC2DFF2B0FA90,60171,17,23,6,109.51292,18.30694,1569
194589,B125AF31137882D184643AC445C2034E,60381,0,19,19,109.5241,18.22458,1605
194590,B125AF31137882D184643AC445C2034E,30361,20,22,2,109.50347,18.24,1508
194595,E8BE10EF1C0A6A216F7B6C008ED029A8,60371,0,7,7,109.53063,18.30056,1618
194597,63CB222117AB8A54673799718246EF46,30084,0,11,11,109.50118,18.26972,1513
194598,63CB222117AB8A54673799718246EF46,39021,12,13,1,109.40368,18.41035,1186
194599,63CB222117AB8A54673799718246EF46,30081,16,17,1,109.50243,18.26632,1512
194600,63CB222117AB8A54673799718246EF46,60131,17,20,3,109.49819,18.24778,1509
194601,63CB222117AB8A54673799718246EF46,30084,21,23,2,109.50118,18.26972,1513
194614,4AA92C2276692190731459431C798101,31945,0,6,6,109.58021,18.29403,1817
194615,4AA92C2276692190731459431C798101,31071,7,8,1,109.58257,18.28458,1815
194616,4AA92C2276692190731459431C798101,31945,9,17,8,109.58021,18.29403,1817
194617,4AA92C2276692190731459431C798101,30854,19,21,2,109.56889,18.27076,1763
194627,09EFADEB7A93F2303481629CF2F84E98,31291,0,14,14,109.30375,18.40729,786
194647,7806585C0EBE4AA0D21C8F6E5805F92A,39321,12,14,2,109.529,18.2167,1604
194648,7806585C0EBE4AA0D21C8F6E5805F92A,60381,15,17,2,109.5241,18.22458,1605
194651,71429A794A28AC178BF0585C81690813,31431,0,7,7,109.44639,18.29042,1316
194652,71429A794A28AC178BF0585C81690813,60281,8,10,2,109.51743,18.25924,1561
194653,71429A794A28AC178BF0585C81690813,31431,13,23,10,109.44639,18.29042,1316
194654,4D190727D19452A2A511EC780EEEE090,30201,1,3,2,109.4909,18.26465,1462
194655,4D190727D19452A2A511EC780EEEE090,60361,3,5,2,109.51938,18.29681,1567
194656,4D190727D19452A2A511EC780EEEE090,30931,10,13,3,109.55653,18.32722,1722
194657,4D190727D19452A2A511EC780EEEE090,30941,13,14,1,109.5559,18.33938,1724
194736,2B7A53D30829A5F3F021AD579FE94CD8,31861,0,10,10,109.49042,18.27549,1464
194737,2B7A53D30829A5F3F021AD579FE94CD8,31471,12,14,2,109.34583,18.29563,917
194738,2B7A53D30829A5F3F021AD579FE94CD8,31861,17,18,1,109.49042,18.27549,1464
194739,2B7A53D30829A5F3F021AD579FE94CD8,31021,19,23,4,109.49021,18.27,1463
194740,A8D0FB018199C38EC19D3E276F96B59B,30741,0,13,13,109.49833,18.28681,1516
194741,A8D0FB018199C38EC19D3E276F96B59B,38911,14,15,1,109.51674,18.24965,1559
194742,A8D0FB018199C38EC19D3E276F96B59B,30741,16,17,1,109.49833,18.28681,1516
194743,A8D0FB018199C38EC19D3E276F96B59B,30121,21,22,1,109.52861,18.27222,1613
194752,2E29BE7E21F829BB8E4505964B146371,31561,1,4,3,109.56792,18.28479,1765
194753,2E29BE7E21F829BB8E4505964B146371,30854,8,23,15,109.56889,18.27076,1763
194794,58979C567AA82D4656FBA764FCCBAA6B,31671,0,7,7,109.38965,18.29813,1068
194795,58979C567AA82D4656FBA764FCCBAA6B,38027,7,15,8,109.38833,18.2909,1066
194796,58979C567AA82D4656FBA764FCCBAA6B,31671,19,23,4,109.38965,18.29813,1068
194806,5F05A258CA919BA01045F79DD70FBCC9,30854,1,5,4,109.56889,18.27076,1763
194807,5F05A258CA919BA01045F79DD70FBCC9,39183,7,17,10,109.55542,18.28208,1715
194817,878FC5EBB1B28FAABA6E6BFD01664318,30251,0,16,16,109.50611,18.26653,1512
194818,878FC5EBB1B28FAABA6E6BFD01664318,30421,18,20,2,109.50021,18.25861,1511
194906,58DE8A719D3ADBEDAE163213845B460A,31071,0,7,7,109.58257,18.28458,1815
194907,58DE8A719D3ADBEDAE163213845B460A,30854,9,12,3,109.56889,18.27076,1763
194908,58DE8A719D3ADBEDAE163213845B460A,31071,12,13,1,109.58257,18.28458,1815
194909,58DE8A719D3ADBEDAE163213845B460A,30854,14,17,3,109.56889,18.27076,1763
194914,A1EEE89B9C53AC2C13371CE13D1615DF,31421,0,6,6,109.55382,18.22347,1705
194915,A1EEE89B9C53AC2C13371CE13D1615DF,31061,6,8,2,109.53333,18.23257,1607
194916,A1EEE89B9C53AC2C13371CE13D1615DF,30381,8,10,2,109.52521,18.24507,1609
194917,A1EEE89B9C53AC2C13371CE13D1615DF,31145,13,15,2,109.20431,18.30479,369
195038,5264833F0013AE6B294396000613EF89,30251,0,5,5,109.50611,18.26653,1512
195039,5264833F0013AE6B294396000613EF89,31181,5,10,5,109.50382,18.24813,1509
195040,5264833F0013AE6B294396000613EF89,60581,11,13,2,109.59785,18.29931,1868
195041,5264833F0013AE6B294396000613EF89,39151,17,19,2,109.49875,18.25097,1510
195066,8BF73979F60E5F1BAAE4266406EB9535,31723,9,12,3,109.68563,18.23701,2207
195067,8BF73979F60E5F1BAAE4266406EB9535,60631,14,15,1,109.57778,18.27583,1814
195068,8BF73979F60E5F1BAAE4266406EB9535,30854,20,21,1,109.56889,18.27076,1763
195074,2F440A235E684ECEDD042B3100A4AE95,30161,1,2,1,109.50042,18.24389,1508
195075,2F440A235E684ECEDD042B3100A4AE95,31071,3,16,13,109.58257,18.28458,1815
195076,2F440A235E684ECEDD042B3100A4AE95,60331,20,22,2,109.505,18.26507,1512
195080,0402BD114B7D5E20705E302B756CD062,60631,1,6,5,109.57778,18.27583,1814
195081,0402BD114B7D5E20705E302B756CD062,30854,10,14,4,109.56889,18.27076,1763
195082,0402BD114B7D5E20705E302B756CD062,31071,19,21,2,109.58257,18.28458,1815
195106,E4E97404D888F47AC51F80D2483EF416,60231,0,11,11,109.49903,18.21972,1504
195107,E4E97404D888F47AC51F80D2483EF416,38017,11,13,2,109.49729,18.21424,1504
195108,E4E97404D888F47AC51F80D2483EF416,60231,14,15,1,109.49903,18.21972,1504
195109,E4E97404D888F47AC51F80D2483EF416,38017,15,17,2,109.49729,18.21424,1504
195110,E4E97404D888F47AC51F80D2483EF416,60231,20,23,3,109.49903,18.21972,1504
195111,ACDEAAF45B65DE48CF80A48DBD3C775E,30854,2,3,1,109.56889,18.27076,1763
195112,ACDEAAF45B65DE48CF80A48DBD3C775E,31071,5,6,1,109.58257,18.28458,1815
195113,ACDEAAF45B65DE48CF80A48DBD3C775E,30854,8,22,14,109.56889,18.27076,1763
195134,74F0A13130A31FF37EE281403AC1C753,60411,12,17,5,109.32514,18.30854,869
195138,5EBEA276FCB4A19AC5C987F5C7CC8908,60621,0,6,6,109.48354,18.27451,1464
195139,5EBEA276FCB4A19AC5C987F5C7CC8908,60401,10,23,13,109.47444,18.27583,1414
195147,54036114D002A873652B2123255670F7,30971,0,7,7,109.48708,18.29319,1467
195149,54036114D002A873652B2123255670F7,38127,18,23,5,109.50833,18.27222,1513
195152,3B6FF1F8D896A0A62DC7E65967011999,31561,1,4,3,109.56792,18.28479,1765
195153,3B6FF1F8D896A0A62DC7E65967011999,39183,5,11,6,109.55542,18.28208,1715
195154,3B6FF1F8D896A0A62DC7E65967011999,31561,11,12,1,109.56792,18.28479,1765
195155,3B6FF1F8D896A0A62DC7E65967011999,39183,13,17,4,109.55542,18.28208,1715
195156,3B6FF1F8D896A0A62DC7E65967011999,31561,18,19,1,109.56792,18.28479,1765
195164,028777DBF8176CB8A735B293EDB3D71F,39181,0,4,4,109.55153,18.28035,1715
195165,028777DBF8176CB8A735B293EDB3D71F,31931,4,6,2,109.54771,18.29403,1667
195166,B57DD43ADCB0BF56BB60384ABB1C13C6,38023,0,9,9,109.37132,18.28993,1016
195167,B57DD43ADCB0BF56BB60384ABB1C13C6,31145,10,11,1,109.20431,18.30479,369
195168,B57DD43ADCB0BF56BB60384ABB1C13C6,30341,12,14,2,109.3625,18.29167,966
195177,7B1A07C39637E996C01DF0A3D287D3C6,39371,6,8,2,109.56627,18.2646,1762
195178,7B1A07C39637E996C01DF0A3D287D3C6,30711,9,11,2,109.50271,18.25347,1510
195188,DB4DF566D4757FF3BB488F82DE126248,31561,0,6,6,109.56792,18.28479,1765
195189,DB4DF566D4757FF3BB488F82DE126248,30851,6,8,2,109.5616,18.27396,1713
195190,DB4DF566D4757FF3BB488F82DE126248,31561,8,16,8,109.56792,18.28479,1765
195191,DB4DF566D4757FF3BB488F82DE126248,30854,19,20,1,109.56889,18.27076,1763
195211,58D9A5715CD0EB0BC75B3571E4B93B4F,31145,13,14,1,109.20431,18.30479,369
195212,58D9A5715CD0EB0BC75B3571E4B93B4F,60381,15,18,3,109.5241,18.22458,1605
195213,58D9A5715CD0EB0BC75B3571E4B93B4F,30711,20,23,3,109.50271,18.25347,1510
195219,FBC323A047041F71D8997C22FDE88F17,31201,0,1,1,109.51042,18.23819,1558
195220,FBC323A047041F71D8997C22FDE88F17,30181,1,8,7,109.51597,18.23313,1557
195221,FBC323A047041F71D8997C22FDE88F17,30511,8,10,2,109.51069,18.24208,1558
195222,FBC323A047041F71D8997C22FDE88F17,38251,12,14,2,109.49618,18.25493,1510
195223,FBC323A047041F71D8997C22FDE88F17,30731,17,18,1,109.50944,18.22306,1555
195224,FBC323A047041F71D8997C22FDE88F17,39191,21,23,2,109.51493,18.23472,1557
195229,0312B43ACF9ED1D8304E325E851AEE29,30851,0,6,6,109.5616,18.27396,1713
195230,0312B43ACF9ED1D8304E325E851AEE29,31561,8,10,2,109.56792,18.28479,1765
195231,0312B43ACF9ED1D8304E325E851AEE29,30851,10,13,3,109.5616,18.27396,1713
195232,0312B43ACF9ED1D8304E325E851AEE29,31561,13,16,3,109.56792,18.28479,1765
195233,0312B43ACF9ED1D8304E325E851AEE29,30851,17,20,3,109.5616,18.27396,1713
195247,EEAA904909853FCE4C1006E1C626BEA2,60231,0,9,9,109.49903,18.21972,1504
195248,EEAA904909853FCE4C1006E1C626BEA2,31321,13,14,1,109.63799,18.23201,2007
195249,EEAA904909853FCE4C1006E1C626BEA2,60231,16,18,2,109.49903,18.21972,1504
195250,EEAA904909853FCE4C1006E1C626BEA2,60371,19,20,1,109.53063,18.30056,1618
195251,EEAA904909853FCE4C1006E1C626BEA2,30051,20,23,3,109.48917,18.21215,1453
195261,FBEC160C45CDB913BEE085C420C4068D,31031,10,13,3,109.49979,18.25382,1510
195262,FBEC160C45CDB913BEE085C420C4068D,31181,17,19,2,109.50382,18.24813,1509
195332,01F0083CC81D0009F9AAB8F7CAA0C106,30854,0,6,6,109.56889,18.27076,1763
195333,01F0083CC81D0009F9AAB8F7CAA0C106,31561,8,9,1,109.56792,18.28479,1765
195334,01F0083CC81D0009F9AAB8F7CAA0C106,30854,12,13,1,109.56889,18.27076,1763
195365,09390A13C8E5C15C1E5674E3DB9139EC,31231,9,10,1,109.42597,18.29292,1217
195366,09390A13C8E5C15C1E5674E3DB9139EC,60231,12,15,3,109.49903,18.21972,1504
195387,33D9A19F318C67B0D9189A6D3D4AAED6,30421,12,13,1,109.50021,18.25861,1511
195446,7EB4F76900011DECC835981CBE847D5E,30854,10,11,1,109.56889,18.27076,1763
195447,7EB4F76900011DECC835981CBE847D5E,31561,14,17,3,109.56792,18.28479,1765
195466,B7A2800FDF738E1064EAD2A5E58F7A3C,61011,1,9,8,109.60653,18.19076,1900
195468,B7A2800FDF738E1064EAD2A5E58F7A3C,31171,20,21,1,109.50938,18.24917,1559
195469,B7A2800FDF738E1064EAD2A5E58F7A3C,60381,21,23,2,109.5241,18.22458,1605
195501,0C8D15C0488D521680F0DE3A28CFE111,31811,0,11,11,109.54201,18.31806,1671
195502,0C8D15C0488D521680F0DE3A28CFE111,30701,12,21,9,109.59313,18.32007,1871
195503,0C8D15C0488D521680F0DE3A28CFE111,31811,21,23,2,109.54201,18.31806,1671
195532,CA3896FB33E9BC68E91955EDFF5D709B,60631,0,5,5,109.57778,18.27583,1814
195533,CA3896FB33E9BC68E91955EDFF5D709B,30854,8,11,3,109.56889,18.27076,1763
195534,CA3896FB33E9BC68E91955EDFF5D709B,31945,15,17,2,109.58021,18.29403,1817
195535,CA3896FB33E9BC68E91955EDFF5D709B,60381,18,19,1,109.5241,18.22458,1605
195536,CA3896FB33E9BC68E91955EDFF5D709B,31945,20,22,2,109.58021,18.29403,1817
195537,2784AD65C6F3580D4FC580DB3654BC4C,31521,0,7,7,109.51458,18.22542,1555
195538,2784AD65C6F3580D4FC580DB3654BC4C,31471,12,13,1,109.34583,18.29563,917
195539,2784AD65C6F3580D4FC580DB3654BC4C,60381,17,18,1,109.5241,18.22458,1605
195540,2784AD65C6F3580D4FC580DB3654BC4C,31521,20,23,3,109.51458,18.22542,1555
195548,45CCFCD3EBDF941E1C92B70ED06E8B5E,31561,1,5,4,109.56792,18.28479,1765
195549,45CCFCD3EBDF941E1C92B70ED06E8B5E,30854,5,23,18,109.56889,18.27076,1763
195584,1E9F6F4D6B7C40904E643E52078F97CE,30161,0,10,10,109.50042,18.24389,1508
195585,1E9F6F4D6B7C40904E643E52078F97CE,60084,10,12,2,109.4984,18.2334,1507
195586,1E9F6F4D6B7C40904E643E52078F97CE,31231,15,16,1,109.42597,18.29292,1217
195588,354DC607408BB828F25BA014BE4B0A10,38111,17,22,5,109.52007,18.22403,1555
195609,FA5581D3844E50B2A372DC72CD47A219,31471,17,19,2,109.34583,18.29563,917
195610,FA5581D3844E50B2A372DC72CD47A219,38951,20,21,1,109.48097,18.28868,1416
195611,FA5581D3844E50B2A372DC72CD47A219,38951,22,23,1,109.48097,18.28868,1416
195640,EA734477BB59A1DAF87BF8B753D8AFA0,31521,0,10,10,109.51458,18.22542,1555
195641,EA734477BB59A1DAF87BF8B753D8AFA0,30361,14,15,1,109.50347,18.24,1508
195642,EA734477BB59A1DAF87BF8B753D8AFA0,38141,17,20,3,109.39479,18.2916,1116
195643,EA734477BB59A1DAF87BF8B753D8AFA0,31671,20,22,2,109.38965,18.29813,1068
195644,EA734477BB59A1DAF87BF8B753D8AFA0,38141,22,23,1,109.39479,18.2916,1116
195653,49B3509BB0FF86B3DDAB6DD80329A93A,31471,14,15,1,109.34583,18.29563,917
195654,49B3509BB0FF86B3DDAB6DD80329A93A,60054,16,17,1,109.3016,18.31229,770
195655,49B3509BB0FF86B3DDAB6DD80329A93A,38951,18,23,5,109.48097,18.28868,1416
195719,2C7E329ABF5669760C98EF0FEA876F54,31521,0,10,10,109.51458,18.22542,1555
195720,2C7E329ABF5669760C98EF0FEA876F54,39111,12,13,1,109.5191,18.22597,1555
195735,83E7C4368A133CBB6B889F8FD57C41CF,39101,21,23,2,109.50132,18.24931,1509
195765,5AE5291D69C9CAB9DE596EEA8E795748,31391,0,6,6,109.50382,18.24285,1508
195766,5AE5291D69C9CAB9DE596EEA8E795748,60381,7,8,1,109.5241,18.22458,1605
195767,5AE5291D69C9CAB9DE596EEA8E795748,30181,9,10,1,109.51597,18.23313,1557
195768,5AE5291D69C9CAB9DE596EEA8E795748,31201,10,11,1,109.51042,18.23819,1558
195791,5A459B568F939BC327045343CB968445,31521,0,12,12,109.51458,18.22542,1555
195792,5A459B568F939BC327045343CB968445,30921,14,15,1,109.53903,18.29451,1667
195793,5A459B568F939BC327045343CB968445,39111,20,23,3,109.5191,18.22597,1555
195810,EF0AF6DFF11E792E87881ED5E6F91398,30721,15,21,6,109.51597,18.28257,1565
195811,EF0AF6DFF11E792E87881ED5E6F91398,38154,22,23,1,109.5266,18.28278,1615
195814,C93386A9D86FE22A1FD4E5116045DD8D,31561,3,5,2,109.56792,18.28479,1765
195815,C93386A9D86FE22A1FD4E5116045DD8D,39183,8,18,10,109.55542,18.28208,1715
195816,C93386A9D86FE22A1FD4E5116045DD8D,30854,20,21,1,109.56889,18.27076,1763
195817,C93386A9D86FE22A1FD4E5116045DD8D,31561,22,23,1,109.56792,18.28479,1765
195833,3F25BC2EA3BCB1B9CD49F368B0B58610,30854,10,13,3,109.56889,18.27076,1763
195834,3F25BC2EA3BCB1B9CD49F368B0B58610,30891,14,16,2,109.59431,18.28389,1865
195835,3F25BC2EA3BCB1B9CD49F368B0B58610,60501,18,19,1,109.48701,18.29021,1466
195836,3F25BC2EA3BCB1B9CD49F368B0B58610,39091,21,22,1,109.50097,18.25222,1510
195871,BFB4E5030A54D70D88FDBFB48AF8C1F3,30511,20,21,1,109.51069,18.24208,1558
195872,BFB4E5030A54D70D88FDBFB48AF8C1F3,60571,21,23,2,109.50722,18.25056,1510
195873,B007CA712767A3A793F1267D6B26E822,31931,16,17,1,109.54771,18.29403,1667
195874,B007CA712767A3A793F1267D6B26E822,31531,21,22,1,109.49583,18.25972,1461
195900,6587551DA47309E484D1302521C8D417,30854,7,8,1,109.56889,18.27076,1763
195901,6587551DA47309E484D1302521C8D417,60631,11,13,2,109.57778,18.27583,1814
195902,6587551DA47309E484D1302521C8D417,38275,14,22,8,109.62875,18.22938,2006
195948,DA10676C4DA702E02A2C3FFFAC40ABA2,39183,0,1,1,109.55542,18.28208,1715
195949,DA10676C4DA702E02A2C3FFFAC40ABA2,31561,3,4,1,109.56792,18.28479,1765
195950,DA10676C4DA702E02A2C3FFFAC40ABA2,39183,4,5,1,109.55542,18.28208,1715
195951,DA10676C4DA702E02A2C3FFFAC40ABA2,31561,7,9,2,109.56792,18.28479,1765
195952,DA10676C4DA702E02A2C3FFFAC40ABA2,39183,9,11,2,109.55542,18.28208,1715
195953,DA10676C4DA702E02A2C3FFFAC40ABA2,31561,12,16,4,109.56792,18.28479,1765
195954,DA10676C4DA702E02A2C3FFFAC40ABA2,39183,16,18,2,109.55542,18.28208,1715
195955,DA10676C4DA702E02A2C3FFFAC40ABA2,31561,18,20,2,109.56792,18.28479,1765
195956,3977578BE56276DA0700B04B81DC1356,30851,0,18,18,109.5616,18.27396,1713
195957,3977578BE56276DA0700B04B81DC1356,31561,20,21,1,109.56792,18.28479,1765
195983,EFDE35289FEC1E13D6F34EFEE66A8AD2,30151,0,16,16,109.50986,18.25083,1560
195984,EFDE35289FEC1E13D6F34EFEE66A8AD2,30854,17,19,2,109.56889,18.27076,1763
196005,002F5754EC66582DC6DA72516B3091EB,38185,9,11,2,109.51333,18.27347,1563
196006,002F5754EC66582DC6DA72516B3091EB,60501,12,13,1,109.48701,18.29021,1466
196047,AD608A919061B1C684914F8654FB2493,60161,12,14,2,109.49174,18.26181,1461
196048,AD608A919061B1C684914F8654FB2493,30361,17,20,3,109.50347,18.24,1508
196059,0133DDFFB5CECBB261CEDEF10A82D50B,30854,0,1,1,109.56889,18.27076,1763
196060,0133DDFFB5CECBB261CEDEF10A82D50B,31561,1,16,15,109.56792,18.28479,1765
196061,0133DDFFB5CECBB261CEDEF10A82D50B,30854,19,21,2,109.56889,18.27076,1763
196062,998ABE8C520F737BA8B4035E9C6950FC,38157,17,18,1,109.51483,18.26958,1563
196063,998ABE8C520F737BA8B4035E9C6950FC,60281,18,21,3,109.51743,18.25924,1561
196064,998ABE8C520F737BA8B4035E9C6950FC,38961,21,22,1,109.50847,18.23514,1507
196070,24892DF473AC6ED4692FBD552CF21D37,60381,0,11,11,109.5241,18.22458,1605
196071,24892DF473AC6ED4692FBD552CF21D37,39321,11,13,2,109.529,18.2167,1604
196072,24892DF473AC6ED4692FBD552CF21D37,60381,14,16,2,109.5241,18.22458,1605
196073,24892DF473AC6ED4692FBD552CF21D37,39321,18,20,2,109.529,18.2167,1604
196074,24892DF473AC6ED4692FBD552CF21D37,60381,20,23,3,109.5241,18.22458,1605
196099,10558344D002FD2874D637BA4ECA768A,30051,0,11,11,109.48917,18.21215,1453
196100,10558344D002FD2874D637BA4ECA768A,30771,11,14,3,109.49938,18.26042,1511
196101,10558344D002FD2874D637BA4ECA768A,30051,17,21,4,109.48917,18.21215,1453
196102,10558344D002FD2874D637BA4ECA768A,60291,21,23,2,109.50826,18.24639,1509
196113,2315F6E953FA87E5C2F5BE151F7177B3,31861,18,19,1,109.49042,18.27549,1464
196114,2315F6E953FA87E5C2F5BE151F7177B3,30271,21,23,2,109.49132,18.23153,1456
196122,0E129C09250C0D46273B4BD7E5225556,30151,0,6,6,109.50986,18.25083,1560
196123,0E129C09250C0D46273B4BD7E5225556,30421,6,11,5,109.50021,18.25861,1511
196124,0E129C09250C0D46273B4BD7E5225556,60161,11,13,2,109.49174,18.26181,1461
196131,44FF3F3995A0081423CE688C5217DF97,31781,15,16,1,109.19847,18.2975,367
196132,44FF3F3995A0081423CE688C5217DF97,31551,18,19,1,109.55868,18.24222,1708
196147,537CA9C3FED012868AB5E4DF92AD232C,30861,0,15,15,109.52722,18.22743,1606
196148,537CA9C3FED012868AB5E4DF92AD232C,30861,18,20,2,109.52722,18.22743,1606
196180,56C8C781972E8BFAF8A768A19AD7F590,38127,0,7,7,109.50833,18.27222,1513
196184,56C8C781972E8BFAF8A768A19AD7F590,30681,21,22,1,109.48493,18.26917,1463
196191,254704E101B8D6129E165FC845EECD1E,30581,9,11,2,109.62257,18.24951,1959
196192,254704E101B8D6129E165FC845EECD1E,30361,12,14,2,109.50347,18.24,1508
196193,254704E101B8D6129E165FC845EECD1E,30711,15,16,1,109.50271,18.25347,1510
196194,254704E101B8D6129E165FC845EECD1E,30771,16,17,1,109.49938,18.26042,1511
196201,C709D01469E0800AF998DFAF42105CDC,31561,6,16,10,109.56792,18.28479,1765
196202,C709D01469E0800AF998DFAF42105CDC,60631,21,23,2,109.57778,18.27583,1814
196221,FA14B010F60C7FB3B13194FAA13740E8,30854,3,5,2,109.56889,18.27076,1763
196222,FA14B010F60C7FB3B13194FAA13740E8,31561,8,9,1,109.56792,18.28479,1765
196223,FA14B010F60C7FB3B13194FAA13740E8,39183,9,11,2,109.55542,18.28208,1715
196224,FA14B010F60C7FB3B13194FAA13740E8,31561,12,13,1,109.56792,18.28479,1765
196225,FA14B010F60C7FB3B13194FAA13740E8,39183,15,17,2,109.55542,18.28208,1715
196231,451E2BF48CD7B253EB0892324E679BCC,60311,5,6,1,109.52097,18.24319,1558
196232,451E2BF48CD7B253EB0892324E679BCC,60281,7,9,2,109.51743,18.25924,1561
196233,451E2BF48CD7B253EB0892324E679BCC,31461,9,12,3,109.5091,18.25389,1510
196234,451E2BF48CD7B253EB0892324E679BCC,60281,13,18,5,109.51743,18.25924,1561
196235,451E2BF48CD7B253EB0892324E679BCC,38297,18,19,1,109.52576,18.24965,1609
196236,451E2BF48CD7B253EB0892324E679BCC,38291,21,22,1,109.51618,18.24313,1558
196237,7FB03ED475E7749CD7E0CA9888FB40B5,60501,0,7,7,109.48701,18.29021,1466
196277,CB9F456D1275025691EE74018BA9AEE8,30511,0,7,7,109.51069,18.24208,1558
196278,CB9F456D1275025691EE74018BA9AEE8,38251,11,13,2,109.49618,18.25493,1510
196279,CB9F456D1275025691EE74018BA9AEE8,31031,14,16,2,109.49979,18.25382,1510
196280,CB9F456D1275025691EE74018BA9AEE8,38251,17,18,1,109.49618,18.25493,1510
196281,CB9F456D1275025691EE74018BA9AEE8,60161,19,22,3,109.49174,18.26181,1461
196289,8345A9276E866C21971E3C408D4E0341,31071,0,1,1,109.58257,18.28458,1815
196290,8345A9276E866C21971E3C408D4E0341,30854,1,2,1,109.56889,18.27076,1763
196291,8345A9276E866C21971E3C408D4E0341,31071,5,6,1,109.58257,18.28458,1815
196292,8345A9276E866C21971E3C408D4E0341,30854,6,7,1,109.56889,18.27076,1763
196293,8345A9276E866C21971E3C408D4E0341,30361,12,13,1,109.50347,18.24,1508
196294,8345A9276E866C21971E3C408D4E0341,30854,15,23,8,109.56889,18.27076,1763
196323,0E5593A90D661690BE3DAAA17AD936E2,30281,0,6,6,109.50597,18.27583,1514
196324,0E5593A90D661690BE3DAAA17AD936E2,31206,6,7,1,109.50819,18.23549,1507
196325,0E5593A90D661690BE3DAAA17AD936E2,38127,8,15,7,109.50833,18.27222,1513
196332,DDE77D3A656666992FC3458B84010D43,39183,0,14,14,109.55542,18.28208,1715
196333,DDE77D3A656666992FC3458B84010D43,31561,14,19,5,109.56792,18.28479,1765
196335,AB6D23E0CDB95F5E821EDCA2C6982C89,39131,9,10,1,109.2066,18.29639,417
196336,AB6D23E0CDB95F5E821EDCA2C6982C89,60411,11,13,2,109.32514,18.30854,869
196375,D2062FDC3B9E181B9C558CD298CA8016,38871,2,8,6,109.44681,18.28625,1316
196376,D2062FDC3B9E181B9C558CD298CA8016,31431,8,12,4,109.44639,18.29042,1316
196377,D2062FDC3B9E181B9C558CD298CA8016,38871,13,14,1,109.44681,18.28625,1316
196378,D2062FDC3B9E181B9C558CD298CA8016,31701,15,17,2,109.44132,18.28833,1266
196379,D2062FDC3B9E181B9C558CD298CA8016,31861,17,18,1,109.49042,18.27549,1464
196380,D2062FDC3B9E181B9C558CD298CA8016,38871,21,23,2,109.44681,18.28625,1316
196381,529A14F498129B0238F7B12A9FC7F6F7,31205,0,1,1,109.51111,18.23736,1557
196382,529A14F498129B0238F7B12A9FC7F6F7,31671,2,15,13,109.38965,18.29813,1068
196383,529A14F498129B0238F7B12A9FC7F6F7,60361,17,21,4,109.51938,18.29681,1567
196396,2C3BD53A8702A47FB82F05FB4993B683,31561,1,5,4,109.56792,18.28479,1765
196397,2C3BD53A8702A47FB82F05FB4993B683,39183,7,8,1,109.55542,18.28208,1715
196398,2C3BD53A8702A47FB82F05FB4993B683,31561,12,13,1,109.56792,18.28479,1765
196399,2C3BD53A8702A47FB82F05FB4993B683,39181,14,17,3,109.55153,18.28035,1715
196400,2C3BD53A8702A47FB82F05FB4993B683,31561,20,23,3,109.56792,18.28479,1765
196406,8FAAC7EA21AE7BB6F52A4D0F285944CD,38157,1,7,6,109.51483,18.26958,1563
196407,8FAAC7EA21AE7BB6F52A4D0F285944CD,30191,10,19,9,109.50361,18.22701,1506
196408,8FAAC7EA21AE7BB6F52A4D0F285944CD,30281,20,23,3,109.50597,18.27583,1514
196409,807F73DE76DFE56E472FA61396F0887C,30151,12,13,1,109.50986,18.25083,1560
196417,4A7982D4CD3B194177EC6261E6672D24,31521,19,20,1,109.51458,18.22542,1555
196418,4A7982D4CD3B194177EC6261E6672D24,30731,20,22,2,109.50944,18.22306,1555
196423,F6A1EBB84FE583E84185C423218578F5,31561,0,5,5,109.56792,18.28479,1765
196424,F6A1EBB84FE583E84185C423218578F5,39181,6,7,1,109.55153,18.28035,1715
196425,F6A1EBB84FE583E84185C423218578F5,30854,8,9,1,109.56889,18.27076,1763
196426,F6A1EBB84FE583E84185C423218578F5,31561,12,22,10,109.56792,18.28479,1765
196467,283001ED673D8EDBEF7EEB00BDB31533,60231,0,1,1,109.49903,18.21972,1504
196468,283001ED673D8EDBEF7EEB00BDB31533,38017,2,4,2,109.49729,18.21424,1504
196469,283001ED673D8EDBEF7EEB00BDB31533,60201,8,9,1,109.5041,18.2509,1510
196470,283001ED673D8EDBEF7EEB00BDB31533,31181,9,12,3,109.50382,18.24813,1509
196471,283001ED673D8EDBEF7EEB00BDB31533,31181,13,14,1,109.50382,18.24813,1509
196477,CEEBF763278B92FC619368987985476F,38336,0,13,13,109.61111,18.21806,1904
196478,CEEBF763278B92FC619368987985476F,30421,18,19,1,109.50021,18.25861,1511
196479,CEEBF763278B92FC619368987985476F,38336,21,23,2,109.61111,18.21806,1904
196512,3E9C0673EA7EE82186269B93667BFAD6,30891,1,6,5,109.59431,18.28389,1865
196513,3E9C0673EA7EE82186269B93667BFAD6,31071,6,7,1,109.58257,18.28458,1815
196514,3E9C0673EA7EE82186269B93667BFAD6,39183,9,12,3,109.55542,18.28208,1715
196515,3E9C0673EA7EE82186269B93667BFAD6,31101,14,16,2,109.65389,18.23403,2057
196537,DD45307798B5E5E871398410DD7318C5,30441,14,15,1,109.64021,18.25424,2010
196538,DD45307798B5E5E871398410DD7318C5,38951,19,23,4,109.48097,18.28868,1416
196556,2951B609D4809F44409A5DD8DDED7FBC,60594,0,5,5,109.62694,18.22799,1956
196557,2951B609D4809F44409A5DD8DDED7FBC,31723,7,9,2,109.68563,18.23701,2207
196558,2951B609D4809F44409A5DD8DDED7FBC,60594,9,12,3,109.62694,18.22799,1956
196559,2951B609D4809F44409A5DD8DDED7FBC,38052,13,21,8,109.62618,18.23042,1956
196580,18E04CE5407B3EC01E2162F1F0904C8B,39371,0,7,7,109.56627,18.2646,1762
196581,18E04CE5407B3EC01E2162F1F0904C8B,30854,9,10,1,109.56889,18.27076,1763
196582,18E04CE5407B3EC01E2162F1F0904C8B,31561,10,12,2,109.56792,18.28479,1765
196583,18E04CE5407B3EC01E2162F1F0904C8B,39371,13,14,1,109.56627,18.2646,1762
196584,18E04CE5407B3EC01E2162F1F0904C8B,30854,14,16,2,109.56889,18.27076,1763
196585,18E04CE5407B3EC01E2162F1F0904C8B,39371,19,23,4,109.56627,18.2646,1762
196595,3570BE904888E551380F4347C7EA72F3,30361,20,22,2,109.50347,18.24,1508
196603,40C57F24FE0409ABB752B2031C349577,38951,0,17,17,109.48097,18.28868,1416
196604,40C57F24FE0409ABB752B2031C349577,30321,18,19,1,109.49563,18.29611,1467
196605,40C57F24FE0409ABB752B2031C349577,38951,20,23,3,109.48097,18.28868,1416
196642,1758F7A03033DAF462A8174615B0DBCE,60594,0,10,10,109.62694,18.22799,1956
196643,1758F7A03033DAF462A8174615B0DBCE,38052,11,13,2,109.62618,18.23042,1956
196644,1758F7A03033DAF462A8174615B0DBCE,38052,13,15,2,109.62618,18.23042,1956
196645,1758F7A03033DAF462A8174615B0DBCE,31321,17,18,1,109.63799,18.23201,2007
196646,1758F7A03033DAF462A8174615B0DBCE,38052,19,21,2,109.62618,18.23042,1956
196647,1758F7A03033DAF462A8174615B0DBCE,31723,21,23,2,109.68563,18.23701,2207
196681,1FE2866848043A2C10AD87212485FE15,31071,1,2,1,109.58257,18.28458,1815
196682,1FE2866848043A2C10AD87212485FE15,30854,2,17,15,109.56889,18.27076,1763
196683,34AB502A442AA8EA4A7FB30471B204DB,60621,2,3,1,109.48354,18.27451,1464
196684,34AB502A442AA8EA4A7FB30471B204DB,38325,5,7,2,109.39792,18.2909,1116
196685,34AB502A442AA8EA4A7FB30471B204DB,60401,8,10,2,109.47444,18.27583,1414
196686,34AB502A442AA8EA4A7FB30471B204DB,38094,10,12,2,109.45403,18.28778,1316
196687,34AB502A442AA8EA4A7FB30471B204DB,30341,13,14,1,109.3625,18.29167,966
196688,34AB502A442AA8EA4A7FB30471B204DB,38251,16,17,1,109.49618,18.25493,1510
196689,34AB502A442AA8EA4A7FB30471B204DB,60621,21,23,2,109.48354,18.27451,1464
196701,A97645679390087E090050CF3F130352,31931,0,19,19,109.54771,18.29403,1667
196702,A97645679390087E090050CF3F130352,30071,19,21,2,109.52819,18.30472,1619
196703,A97645679390087E090050CF3F130352,31931,22,23,1,109.54771,18.29403,1667
196775,B712327B6033C61F37801CFD6DAC08AD,31951,0,5,5,109.52174,18.30299,1568
196776,B712327B6033C61F37801CFD6DAC08AD,38484,6,11,5,109.53028,18.31528,1620
196777,B712327B6033C61F37801CFD6DAC08AD,38484,12,13,1,109.53028,18.31528,1620
196778,B712327B6033C61F37801CFD6DAC08AD,38484,14,18,4,109.53028,18.31528,1620
196779,B712327B6033C61F37801CFD6DAC08AD,38484,20,22,2,109.53028,18.31528,1620
196782,B0763B4A96052E2584E19B64C16E779B,30661,14,16,2,109.37028,18.24361,1008
196783,B0763B4A96052E2584E19B64C16E779B,60501,20,22,2,109.48701,18.29021,1466
196809,A7B3BDD8DC79485BA41EC7F220A41345,60631,0,11,11,109.57778,18.27583,1814
196810,A7B3BDD8DC79485BA41EC7F220A41345,30854,14,23,9,109.56889,18.27076,1763
196811,63FBAC0202144B00077561285E6A7F87,30821,0,9,9,109.43681,18.33639,1274
196812,63FBAC0202144B00077561285E6A7F87,30651,9,11,2,109.42611,18.385,1232
196813,63FBAC0202144B00077561285E6A7F87,30821,13,15,2,109.43681,18.33639,1274
196814,63FBAC0202144B00077561285E6A7F87,30651,15,17,2,109.42611,18.385,1232
196815,63FBAC0202144B00077561285E6A7F87,30821,18,23,5,109.43681,18.33639,1274
196843,4A181773B7D7DB21B899E84DBBF5FD51,60401,3,18,15,109.47444,18.27583,1414
196844,4A181773B7D7DB21B899E84DBBF5FD51,31391,19,21,2,109.50382,18.24285,1508
196865,848A877E923FAE990F640409C3D68042,60121,13,14,1,109.74507,18.37472,2430
196866,848A877E923FAE990F640409C3D68042,31041,15,18,3,109.50278,18.23701,1507
196867,848A877E923FAE990F640409C3D68042,60121,20,23,3,109.74507,18.37472,2430
196873,47C8C71AB8A291B23C6D0393C8109E46,38171,0,7,7,109.50799,18.28139,1515
196876,47C8C71AB8A291B23C6D0393C8109E46,38261,19,23,4,109.50361,18.28153,1515
196890,E755AD63601CF016CD8E32C53EBB1378,30421,16,20,4,109.50021,18.25861,1511
196891,E755AD63601CF016CD8E32C53EBB1378,31206,21,23,2,109.50819,18.23549,1507
196900,5533066D8871087CCD481B88DD73EF7D,31361,0,20,20,109.47417,18.28292,1415
196901,5533066D8871087CCD481B88DD73EF7D,60401,21,23,2,109.47444,18.27583,1414
196915,0792BDFC81E11DA91D31ED7576F7343E,30421,11,12,1,109.50021,18.25861,1511
196916,0792BDFC81E11DA91D31ED7576F7343E,31031,13,15,2,109.49979,18.25382,1510
196917,0792BDFC81E11DA91D31ED7576F7343E,30421,17,19,2,109.50021,18.25861,1511
196918,0792BDFC81E11DA91D31ED7576F7343E,39154,20,23,3,109.50201,18.25681,1511
196950,D93246693BF2DE328C78E4FC538C8F54,30084,15,16,1,109.50118,18.26972,1513
196951,D93246693BF2DE328C78E4FC538C8F54,60661,19,23,4,109.548,18.2377,1657
196970,B78E7295CB13532B4E2C30EF158E297F,39183,2,5,3,109.55542,18.28208,1715
196971,B78E7295CB13532B4E2C30EF158E297F,31931,7,9,2,109.54771,18.29403,1667
196972,B78E7295CB13532B4E2C30EF158E297F,39183,9,11,2,109.55542,18.28208,1715
197009,182D5101D28D51096306D4EF5FDD4501,38251,11,12,1,109.49618,18.25493,1510
197010,182D5101D28D51096306D4EF5FDD4501,60401,13,14,1,109.47444,18.27583,1414
197011,182D5101D28D51096306D4EF5FDD4501,30271,14,15,1,109.49132,18.23153,1456
197020,64EA917EAAD3EB55DA2ABB227203C131,60631,0,7,7,109.57778,18.27583,1814
197021,64EA917EAAD3EB55DA2ABB227203C131,31071,8,15,7,109.58257,18.28458,1815
197022,64EA917EAAD3EB55DA2ABB227203C131,31851,20,22,2,109.71736,18.29007,2316
197075,6F1C2EEBABDCCD4D60A02F44086A229B,60281,19,20,1,109.51743,18.25924,1561
197076,6F1C2EEBABDCCD4D60A02F44086A229B,39201,21,23,2,109.45056,18.28667,1316
197102,18073AD9E71B8DFC1E520C5E3653B1BD,31291,0,5,5,109.30375,18.40729,786
197103,18073AD9E71B8DFC1E520C5E3653B1BD,31951,9,16,7,109.52174,18.30299,1568
197104,18073AD9E71B8DFC1E520C5E3653B1BD,31291,17,23,6,109.30375,18.40729,786
197105,0F23B6E4E3B228AFE54C52B9B3D593D7,60524,1,10,9,109.42951,18.28993,1216
197106,0F23B6E4E3B228AFE54C52B9B3D593D7,60551,12,14,2,109.42722,18.30111,1218
197107,0F23B6E4E3B228AFE54C52B9B3D593D7,60524,14,18,4,109.42951,18.28993,1216
197108,0F23B6E4E3B228AFE54C52B9B3D593D7,60551,20,23,3,109.42722,18.30111,1218
197128,ED8F5CD7EC6E2CD49679883B2A184DD2,30561,1,6,5,109.52778,18.31938,1621
197129,ED8F5CD7EC6E2CD49679883B2A184DD2,31031,7,15,8,109.49979,18.25382,1510
197130,ED8F5CD7EC6E2CD49679883B2A184DD2,30201,19,22,3,109.4909,18.26465,1462
197142,725907B5E41C0055C10D17ED419C6B5D,60641,0,6,6,109.53854,18.2359,1657
197143,725907B5E41C0055C10D17ED419C6B5D,31301,10,11,1,109.14493,18.31222,170
197144,725907B5E41C0055C10D17ED419C6B5D,31471,13,14,1,109.34583,18.29563,917
197153,A928E9F6C796FE1A60807BA003DE87BB,30854,12,16,4,109.56889,18.27076,1763
197154,A928E9F6C796FE1A60807BA003DE87BB,31071,19,21,2,109.58257,18.28458,1815
197157,76DA946F4DC1318DD46A32E1D303D6B7,31931,0,17,17,109.54771,18.29403,1667
197158,76DA946F4DC1318DD46A32E1D303D6B7,39183,17,18,1,109.55542,18.28208,1715
197159,76DA946F4DC1318DD46A32E1D303D6B7,31931,19,23,4,109.54771,18.29403,1667
197165,975CB35586D2D95A387E2AA86A5AB719,31351,0,5,5,109.4959,18.28417,1465
197166,975CB35586D2D95A387E2AA86A5AB719,30671,7,22,15,109.43611,18.30139,1268
197173,8293619D825F160795AE71B17456FBCB,60354,0,6,6,109.58701,18.28521,1815
197174,8293619D825F160795AE71B17456FBCB,60631,11,13,2,109.57778,18.27583,1814
197175,8293619D825F160795AE71B17456FBCB,31071,14,16,2,109.58257,18.28458,1815
197191,491A112CD81B9085F752897809919691,31781,11,14,3,109.19847,18.2975,367
197192,491A112CD81B9085F752897809919691,31201,18,20,2,109.51042,18.23819,1558
197218,BF2B54690E8B5D78C4E66DC34DEE3501,30661,13,14,1,109.37028,18.24361,1008
197219,BF2B54690E8B5D78C4E66DC34DEE3501,60381,17,19,2,109.5241,18.22458,1605
197220,BF2B54690E8B5D78C4E66DC34DEE3501,60084,21,22,1,109.4984,18.2334,1507
197230,42158B50A96F4BB50162AD5AAF8D7E2D,31181,19,20,1,109.50382,18.24813,1509
197231,42158B50A96F4BB50162AD5AAF8D7E2D,31201,21,23,2,109.51042,18.23819,1558
197264,97C31877CA4226D0F1BA1C0E12066B56,30854,14,18,4,109.56889,18.27076,1763
197265,97C31877CA4226D0F1BA1C0E12066B56,30251,18,23,5,109.50611,18.26653,1512
197273,A549C024E6F63EDBD3DC866F10DB11CE,30234,4,6,2,109.60681,18.29979,1918
197274,A549C024E6F63EDBD3DC866F10DB11CE,30854,8,16,8,109.56889,18.27076,1763
197281,B0A549E924C57A31C8B59CCDAEE0ED2D,31471,13,15,2,109.34583,18.29563,917
197282,B0A549E924C57A31C8B59CCDAEE0ED2D,30421,17,23,6,109.50021,18.25861,1511
197286,21FBB6F0F825A6B1E89545963BB6C9D3,30851,4,6,2,109.5616,18.27396,1713
197287,21FBB6F0F825A6B1E89545963BB6C9D3,30854,9,10,1,109.56889,18.27076,1763
197318,608A55C14BAB2A5B627ACC1F39B89FB6,31945,0,7,7,109.58021,18.29403,1817
197319,608A55C14BAB2A5B627ACC1F39B89FB6,30854,8,19,11,109.56889,18.27076,1763
197320,608A55C14BAB2A5B627ACC1F39B89FB6,31945,20,22,2,109.58021,18.29403,1817
197379,28413CB0160B68347E92144BE214EF48,60081,17,19,2,109.51097,18.22639,1556
197380,28413CB0160B68347E92144BE214EF48,30191,19,23,4,109.50361,18.22701,1506
197400,85586D73EA48B4F4D520D899B0BE0554,39181,10,13,3,109.55153,18.28035,1715
197401,85586D73EA48B4F4D520D899B0BE0554,60631,15,17,2,109.57778,18.27583,1814
197402,85586D73EA48B4F4D520D899B0BE0554,30291,19,23,4,109.50403,18.27028,1513
197403,D75F3D28EEDDC3AAB22F587F99A79102,31071,0,8,8,109.58257,18.28458,1815
197404,D75F3D28EEDDC3AAB22F587F99A79102,30854,8,17,9,109.56889,18.27076,1763
197425,10EBF762D28520B09848288F7052CFDE,30854,1,7,6,109.56889,18.27076,1763
197426,10EBF762D28520B09848288F7052CFDE,31561,9,15,6,109.56792,18.28479,1765
197427,10EBF762D28520B09848288F7052CFDE,30854,18,20,2,109.56889,18.27076,1763
197432,3E01B14B28C0FDBF8BB343D61C8AA7D8,31301,14,17,3,109.14493,18.31222,170
197433,3E01B14B28C0FDBF8BB343D61C8AA7D8,31931,19,21,2,109.54771,18.29403,1667
197440,C30EF1A03F3ACD87114629BE5EBA14E8,31231,12,14,2,109.42597,18.29292,1217
197441,C30EF1A03F3ACD87114629BE5EBA14E8,60552,14,16,2,109.41729,18.30014,1218
197466,182603D8C7C4BF5CDDF16B2E79D9DF52,38251,17,18,1,109.49618,18.25493,1510
197467,182603D8C7C4BF5CDDF16B2E79D9DF52,60084,18,19,1,109.4984,18.2334,1507
197468,182603D8C7C4BF5CDDF16B2E79D9DF52,30211,20,21,1,109.49882,18.23931,1508
197479,87F6D9996659541EF975AE3E55004A94,31161,13,15,2,109.70229,18.31361,2270
197485,A00570F904F3AC2F214AE7E56CFC6E64,31031,0,7,7,109.49979,18.25382,1510
197486,A00570F904F3AC2F214AE7E56CFC6E64,38754,12,13,1,109.74667,18.37382,2430
197487,A00570F904F3AC2F214AE7E56CFC6E64,31701,17,18,1,109.44132,18.28833,1266
197488,A00570F904F3AC2F214AE7E56CFC6E64,38941,21,23,2,109.49625,18.25451,1510
197555,B61666307486DD531F980787F0F8A7B7,30854,17,21,4,109.56889,18.27076,1763
197556,B61666307486DD531F980787F0F8A7B7,31561,22,23,1,109.56792,18.28479,1765
197566,778E4116E7B891C10FAD01297450E954,31206,20,21,1,109.50819,18.23549,1507
197567,778E4116E7B891C10FAD01297450E954,31041,21,23,2,109.50278,18.23701,1507
197570,949173524C1E5F3B9BD54D60F0306D0C,30854,2,5,3,109.56889,18.27076,1763
197571,949173524C1E5F3B9BD54D60F0306D0C,30711,8,16,8,109.50271,18.25347,1510
197572,949173524C1E5F3B9BD54D60F0306D0C,31561,18,23,5,109.56792,18.28479,1765
197595,29C138323F7793FA5DE28E5154764E0B,60381,13,14,1,109.5241,18.22458,1605
197628,985A2EA61E10E912EF275486E93274F1,60161,0,6,6,109.49174,18.26181,1461
197629,985A2EA61E10E912EF275486E93274F1,60201,6,16,10,109.5041,18.2509,1510
197630,985A2EA61E10E912EF275486E93274F1,30581,18,19,1,109.62257,18.24951,1959
197631,985A2EA61E10E912EF275486E93274F1,30211,21,23,2,109.49882,18.23931,1508
197685,0F558B6653C655C7F0BAEA9D66B33F57,31071,0,6,6,109.58257,18.28458,1815
197686,0F558B6653C655C7F0BAEA9D66B33F57,30854,10,16,6,109.56889,18.27076,1763
197687,0F558B6653C655C7F0BAEA9D66B33F57,30721,18,20,2,109.51597,18.28257,1565
197688,0F558B6653C655C7F0BAEA9D66B33F57,39053,21,23,2,109.511,18.2771,1564
197689,89A01963B06628A3D6B13DA41FA507D1,30854,0,13,13,109.56889,18.27076,1763
197690,89A01963B06628A3D6B13DA41FA507D1,31561,14,15,1,109.56792,18.28479,1765
197691,89A01963B06628A3D6B13DA41FA507D1,30854,16,18,2,109.56889,18.27076,1763
197692,89A01963B06628A3D6B13DA41FA507D1,30361,20,22,2,109.50347,18.24,1508
197696,CE3E597F5969146BCA318406842E8817,60631,1,4,3,109.57778,18.27583,1814
197697,CE3E597F5969146BCA318406842E8817,39183,8,17,9,109.55542,18.28208,1715
197698,CE3E597F5969146BCA318406842E8817,60631,22,23,1,109.57778,18.27583,1814
197701,8B6E59C60C038C35AF90682694A368A0,30851,16,17,1,109.5616,18.27396,1713
197702,8B6E59C60C038C35AF90682694A368A0,30891,19,20,1,109.59431,18.28389,1865
197706,43F5AB52A0AF3FEB5880C6DCD16BBA02,60011,0,15,15,109.48965,18.30222,1468
197707,43F5AB52A0AF3FEB5880C6DCD16BBA02,30161,15,18,3,109.50042,18.24389,1508
197708,43F5AB52A0AF3FEB5880C6DCD16BBA02,30321,18,20,2,109.49563,18.29611,1467
197709,43F5AB52A0AF3FEB5880C6DCD16BBA02,60011,21,23,2,109.48965,18.30222,1468
197722,7421066246AAD1C230E7E2A7ADF06E9D,60631,0,7,7,109.57778,18.27583,1814
197723,7421066246AAD1C230E7E2A7ADF06E9D,30854,7,18,11,109.56889,18.27076,1763
197724,7421066246AAD1C230E7E2A7ADF06E9D,30721,19,21,2,109.51597,18.28257,1565
197725,7421066246AAD1C230E7E2A7ADF06E9D,39053,21,23,2,109.511,18.2771,1564
197738,B5D63E96812FAD17460F5BD0EE3EE49F,60084,8,10,2,109.4984,18.2334,1507
197739,B5D63E96812FAD17460F5BD0EE3EE49F,60614,15,17,2,109.48799,18.29521,1467
197740,B5D63E96812FAD17460F5BD0EE3EE49F,39154,20,23,3,109.50201,18.25681,1511
197778,417408FFDA93B177641D270D3A5C4B2D,30891,1,3,2,109.59431,18.28389,1865
197779,417408FFDA93B177641D270D3A5C4B2D,31071,5,6,1,109.58257,18.28458,1815
197780,417408FFDA93B177641D270D3A5C4B2D,30854,7,10,3,109.56889,18.27076,1763
197781,417408FFDA93B177641D270D3A5C4B2D,31071,10,23,13,109.58257,18.28458,1815
197787,00408CE72418A3CE9FCFA7311EFCBB62,31071,1,6,5,109.58257,18.28458,1815
197788,00408CE72418A3CE9FCFA7311EFCBB62,30854,7,8,1,109.56889,18.27076,1763
197789,00408CE72418A3CE9FCFA7311EFCBB62,31071,8,11,3,109.58257,18.28458,1815
197790,00408CE72418A3CE9FCFA7311EFCBB62,30854,12,20,8,109.56889,18.27076,1763
197809,2A3E5205AC8230AFA039AD71C1DA60B8,60661,0,8,8,109.548,18.2377,1657
197810,2A3E5205AC8230AFA039AD71C1DA60B8,30241,12,13,1,109.26174,18.3275,622
197811,2A3E5205AC8230AFA039AD71C1DA60B8,60201,14,16,2,109.5041,18.2509,1510
197841,8E74DEE1D6AD25525E0B9C766B9CBA47,30771,20,22,2,109.49938,18.26042,1511
197862,03CF17D18D5ABB539B8A67460591BD40,60291,0,1,1,109.50826,18.24639,1509
197863,03CF17D18D5ABB539B8A67460591BD40,30211,1,14,13,109.49882,18.23931,1508
197864,03CF17D18D5ABB539B8A67460591BD40,30681,14,15,1,109.48493,18.26917,1463
197865,03CF17D18D5ABB539B8A67460591BD40,30211,16,19,3,109.49882,18.23931,1508
197866,03CF17D18D5ABB539B8A67460591BD40,31251,21,23,2,109.18528,18.2975,317
197871,0A9117B90774715AACE2ED3045D6F579,60552,0,6,6,109.41729,18.30014,1218
197872,0A9117B90774715AACE2ED3045D6F579,30651,7,8,1,109.42611,18.385,1232
197873,0A9117B90774715AACE2ED3045D6F579,60551,12,15,3,109.42722,18.30111,1218
197875,0A9117B90774715AACE2ED3045D6F579,60552,22,23,1,109.41729,18.30014,1218
197876,EA27C1DACC015E381783BB03940DBA88,38484,0,2,2,109.53028,18.31528,1620
197877,EA27C1DACC015E381783BB03940DBA88,31951,3,7,4,109.52174,18.30299,1568
197878,EA27C1DACC015E381783BB03940DBA88,31561,11,12,1,109.56792,18.28479,1765
197880,1C170E7FDA19E425F091CDE0A56B7093,31781,10,13,3,109.19847,18.2975,367
197881,1C170E7FDA19E425F091CDE0A56B7093,31081,18,23,5,109.44639,18.30181,1318
197899,AA42C8D5F23E17A418E66C8770B385FE,30151,0,10,10,109.50986,18.25083,1560
197900,AA42C8D5F23E17A418E66C8770B385FE,30084,10,12,2,109.50118,18.26972,1513
197901,AA42C8D5F23E17A418E66C8770B385FE,30151,14,15,1,109.50986,18.25083,1560
197941,D2A5F87218CF25385163A2F3C4229CB8,30851,1,3,2,109.5616,18.27396,1713
197942,D2A5F87218CF25385163A2F3C4229CB8,31561,6,9,3,109.56792,18.28479,1765
197943,D2A5F87218CF25385163A2F3C4229CB8,30851,9,11,2,109.5616,18.27396,1713
197944,D2A5F87218CF25385163A2F3C4229CB8,31561,12,15,3,109.56792,18.28479,1765
197945,D2A5F87218CF25385163A2F3C4229CB8,30851,20,21,1,109.5616,18.27396,1713
197946,D2A5F87218CF25385163A2F3C4229CB8,31561,22,23,1,109.56792,18.28479,1765
197980,147470AD3D3B8724582C30D5F244A8B6,60421,0,16,16,109.46333,18.31743,1371
197981,147470AD3D3B8724582C30D5F244A8B6,30111,17,19,2,109.47583,18.30542,1419
197982,147470AD3D3B8724582C30D5F244A8B6,60421,19,23,4,109.46333,18.31743,1371
198001,8DD23AA43C0F7967C45F7488D66F9159,31531,0,2,2,109.49583,18.25972,1461
198002,8DD23AA43C0F7967C45F7488D66F9159,31945,3,7,4,109.58021,18.29403,1817
198003,8DD23AA43C0F7967C45F7488D66F9159,31071,9,11,2,109.58257,18.28458,1815
198036,1D10133A3A6B6A1226F963E2F33A13EC,38707,13,17,4,109.73778,18.35368,2427
198037,1D10133A3A6B6A1226F963E2F33A13EC,38707,19,23,4,109.73778,18.35368,2427
198048,D517610C2076C41FED0ED80CB6FFB44C,31561,0,6,6,109.56792,18.28479,1765
198049,D517610C2076C41FED0ED80CB6FFB44C,30851,6,20,14,109.5616,18.27396,1713
198050,D517610C2076C41FED0ED80CB6FFB44C,31561,22,23,1,109.56792,18.28479,1765
198067,A509D0CA53CD767E0234236B42930030,38094,20,23,3,109.45403,18.28778,1316
198108,3940DDDB655239C16F43D83626AAB86A,38241,0,11,11,109.54111,18.30542,1669
198109,3940DDDB655239C16F43D83626AAB86A,31931,13,14,1,109.54771,18.29403,1667
198110,3940DDDB655239C16F43D83626AAB86A,30921,14,19,5,109.53903,18.29451,1667
198111,3940DDDB655239C16F43D83626AAB86A,31931,19,21,2,109.54771,18.29403,1667
198112,3940DDDB655239C16F43D83626AAB86A,38241,22,23,1,109.54111,18.30542,1669
198115,BC2EDF4DF9C7FAD55BDEABA03DFA7284,31561,0,5,5,109.56792,18.28479,1765
198116,BC2EDF4DF9C7FAD55BDEABA03DFA7284,39183,6,10,4,109.55542,18.28208,1715
198117,BC2EDF4DF9C7FAD55BDEABA03DFA7284,31561,11,13,2,109.56792,18.28479,1765
198118,BC2EDF4DF9C7FAD55BDEABA03DFA7284,30854,14,17,3,109.56889,18.27076,1763
198119,BC2EDF4DF9C7FAD55BDEABA03DFA7284,31561,18,20,2,109.56792,18.28479,1765
198124,C85D0B931BEF54F05B9ABBBB03212DB7,30854,0,10,10,109.56889,18.27076,1763
198125,C85D0B931BEF54F05B9ABBBB03212DB7,31561,10,15,5,109.56792,18.28479,1765
198126,C85D0B931BEF54F05B9ABBBB03212DB7,30854,16,17,1,109.56889,18.27076,1763
198151,1582BEC240072EC51899932D6A0A257A,31561,0,1,1,109.56792,18.28479,1765
198152,1582BEC240072EC51899932D6A0A257A,30232,1,7,6,109.6191,18.31701,1971
198153,1582BEC240072EC51899932D6A0A257A,31561,8,10,2,109.56792,18.28479,1765
198154,1582BEC240072EC51899932D6A0A257A,30891,12,14,2,109.59431,18.28389,1865
198155,1582BEC240072EC51899932D6A0A257A,30232,16,18,2,109.6191,18.31701,1971
198196,EDD211647BCC1D3CABF473CB2801C791,30361,0,11,11,109.50347,18.24,1508
198197,EDD211647BCC1D3CABF473CB2801C791,30161,12,14,2,109.50042,18.24389,1508
198198,EDD211647BCC1D3CABF473CB2801C791,30161,16,22,6,109.50042,18.24389,1508
198240,E094C48A14335F51D2BE0671D37D0CCF,30181,0,9,9,109.51597,18.23313,1557
198241,E094C48A14335F51D2BE0671D37D0CCF,31471,13,15,2,109.34583,18.29563,917
198242,E094C48A14335F51D2BE0671D37D0CCF,30731,16,17,1,109.50944,18.22306,1555
198243,E094C48A14335F51D2BE0671D37D0CCF,30421,19,21,2,109.50021,18.25861,1511
198244,E094C48A14335F51D2BE0671D37D0CCF,30731,22,23,1,109.50944,18.22306,1555
198259,EBF906C5498076BCFA3E97DF6001B4F3,30854,14,16,2,109.56889,18.27076,1763
198260,EBF906C5498076BCFA3E97DF6001B4F3,60631,16,23,7,109.57778,18.27583,1814
198267,2939307F3A35285FC5072EF5354D23D7,38951,0,7,7,109.48097,18.28868,1416
198268,2939307F3A35285FC5072EF5354D23D7,33051,9,10,1,109.6475,18.46618,2096
198269,2939307F3A35285FC5072EF5354D23D7,30661,14,16,2,109.37028,18.24361,1008
198270,2939307F3A35285FC5072EF5354D23D7,38951,20,23,3,109.48097,18.28868,1416
198288,2A6BA0678DDF16AF08BAC9E3FA3C9391,30741,12,14,2,109.49833,18.28681,1516
198289,2A6BA0678DDF16AF08BAC9E3FA3C9391,30854,17,23,6,109.56889,18.27076,1763
198328,75817DB682187A07461734D66E1E6492,31061,19,20,1,109.53333,18.23257,1607
198329,75817DB682187A07461734D66E1E6492,60631,20,22,2,109.57778,18.27583,1814
198349,1D0D5E68B48956FE4622EC000952996C,60361,11,12,1,109.51938,18.29681,1567
198378,005F3AEFE6DBF371ED1FD57736434098,30854,14,21,7,109.56889,18.27076,1763
198379,005F3AEFE6DBF371ED1FD57736434098,31071,21,23,2,109.58257,18.28458,1815
198397,F57902A58026464B5BDED6D5CB0C8C35,31301,14,16,2,109.14493,18.31222,170
198398,F57902A58026464B5BDED6D5CB0C8C35,31021,19,23,4,109.49021,18.27,1463
198399,ECCCA5770AD6AA7162B63EC395B55856,60631,0,7,7,109.57778,18.27583,1814
198400,ECCCA5770AD6AA7162B63EC395B55856,30951,8,15,7,109.56208,18.25667,1761
198401,ECCCA5770AD6AA7162B63EC395B55856,60631,20,23,3,109.57778,18.27583,1814
198405,34F3D64B41C252481F72E5CF931AC833,30851,0,6,6,109.5616,18.27396,1713
198406,34F3D64B41C252481F72E5CF931AC833,31071,7,12,5,109.58257,18.28458,1815
198430,53875E69050EC42E511A64D3211FA7B3,60631,1,6,5,109.57778,18.27583,1814
198431,53875E69050EC42E511A64D3211FA7B3,30854,8,17,9,109.56889,18.27076,1763
198432,53875E69050EC42E511A64D3211FA7B3,60631,19,23,4,109.57778,18.27583,1814
198491,BD1C8CAB0CA377D9350002A865081450,30251,0,6,6,109.50611,18.26653,1512
198492,BD1C8CAB0CA377D9350002A865081450,30081,8,10,2,109.50243,18.26632,1512
198493,BD1C8CAB0CA377D9350002A865081450,30711,15,17,2,109.50271,18.25347,1510
198494,BD1C8CAB0CA377D9350002A865081450,30251,21,22,1,109.50611,18.26653,1512
198501,ABCD0851CC1C78BCD7AF6DBDF2F5DE49,60552,0,2,2,109.41729,18.30014,1218
198502,ABCD0851CC1C78BCD7AF6DBDF2F5DE49,30671,6,7,1,109.43611,18.30139,1268
198503,ABCD0851CC1C78BCD7AF6DBDF2F5DE49,60552,8,17,9,109.41729,18.30014,1218
198504,ABCD0851CC1C78BCD7AF6DBDF2F5DE49,60551,22,23,1,109.42722,18.30111,1218
198505,B48CF6FA27E864933632BDC922A5DB6B,30211,18,20,2,109.49882,18.23931,1508
198506,B48CF6FA27E864933632BDC922A5DB6B,31031,20,22,2,109.49979,18.25382,1510
198507,5E97A4561E11AAC4FBC53FD068EAA52B,30854,0,14,14,109.56889,18.27076,1763
198508,5E97A4561E11AAC4FBC53FD068EAA52B,31031,16,19,3,109.49979,18.25382,1510
198509,5E97A4561E11AAC4FBC53FD068EAA52B,30854,21,23,2,109.56889,18.27076,1763
198532,17A4545370685D172A08774EFEF86DD3,39181,2,9,7,109.55153,18.28035,1715
198533,17A4545370685D172A08774EFEF86DD3,31071,11,12,1,109.58257,18.28458,1815
198534,17A4545370685D172A08774EFEF86DD3,39181,13,17,4,109.55153,18.28035,1715
198543,E6541B4F346982101D887BAAF0315541,30854,1,7,6,109.56889,18.27076,1763
198544,E6541B4F346982101D887BAAF0315541,31561,8,18,10,109.56792,18.28479,1765
198545,E6541B4F346982101D887BAAF0315541,30861,21,23,2,109.52722,18.22743,1606
198560,F61486EBE9C0037CE6ECF4E72C7FFAB0,31521,0,8,8,109.51458,18.22542,1555
198561,F61486EBE9C0037CE6ECF4E72C7FFAB0,31521,8,11,3,109.51458,18.22542,1555
198562,F61486EBE9C0037CE6ECF4E72C7FFAB0,31521,12,17,5,109.51458,18.22542,1555
198563,F61486EBE9C0037CE6ECF4E72C7FFAB0,30731,20,22,2,109.50944,18.22306,1555
198621,B643AC77F8D8498A9694D45BA8B0F75F,60631,1,12,11,109.57778,18.27583,1814
198622,B643AC77F8D8498A9694D45BA8B0F75F,30854,14,19,5,109.56889,18.27076,1763
198709,27BCEF3137923B84211F08830816C810,31561,0,1,1,109.56792,18.28479,1765
198710,27BCEF3137923B84211F08830816C810,30851,1,8,7,109.5616,18.27396,1713
198712,27BCEF3137923B84211F08830816C810,30851,21,23,2,109.5616,18.27396,1713
198716,CD2333A80921E2508A5B160841254ACF,38251,1,7,6,109.49618,18.25493,1510
198717,CD2333A80921E2508A5B160841254ACF,30171,11,23,12,109.48458,18.27139,1463
198746,CBFB6695A565EE8288E80536B0FF653C,60631,0,6,6,109.57778,18.27583,1814
198747,CBFB6695A565EE8288E80536B0FF653C,30854,6,8,2,109.56889,18.27076,1763
198748,CBFB6695A565EE8288E80536B0FF653C,60631,12,13,1,109.57778,18.27583,1814
198771,5426296000364EE32711CD0E73D782C8,31561,1,2,1,109.56792,18.28479,1765
198772,5426296000364EE32711CD0E73D782C8,30854,5,11,6,109.56889,18.27076,1763
198773,5426296000364EE32711CD0E73D782C8,31071,12,13,1,109.58257,18.28458,1815
198777,42208654DD68D689FEE2FABD4C7FC956,38271,0,9,9,109.62632,18.23049,1956
198778,42208654DD68D689FEE2FABD4C7FC956,33481,13,15,2,109.67278,18.41278,2187
198779,42208654DD68D689FEE2FABD4C7FC956,30161,19,20,1,109.50042,18.24389,1508
198780,42208654DD68D689FEE2FABD4C7FC956,31031,22,23,1,109.49979,18.25382,1510
198794,4995463B780282C9C030A19D9F49AEAC,31071,0,7,7,109.58257,18.28458,1815
198795,4995463B780282C9C030A19D9F49AEAC,30854,10,16,6,109.56889,18.27076,1763
198812,4E94ADAE7ABEB20EEFAF67519DFCC1BE,31081,1,8,7,109.44639,18.30181,1318
198813,4E94ADAE7ABEB20EEFAF67519DFCC1BE,31031,10,22,12,109.49979,18.25382,1510
198871,4D9A472B7DD43E0DD6EF3059F08EEEB1,38251,8,11,3,109.49618,18.25493,1510
198872,4D9A472B7DD43E0DD6EF3059F08EEEB1,60401,12,13,1,109.47444,18.27583,1414
198873,4D9A472B7DD43E0DD6EF3059F08EEEB1,60161,16,19,3,109.49174,18.26181,1461
198874,4D9A472B7DD43E0DD6EF3059F08EEEB1,31231,21,23,2,109.42597,18.29292,1217
198884,C3485CDC6A0EB2B046EA3123960E45A0,31101,0,11,11,109.65389,18.23403,2057
198885,C3485CDC6A0EB2B046EA3123960E45A0,30511,14,16,2,109.51069,18.24208,1558
198886,C3485CDC6A0EB2B046EA3123960E45A0,31521,18,20,2,109.51458,18.22542,1555
198887,C3485CDC6A0EB2B046EA3123960E45A0,30511,20,23,3,109.51069,18.24208,1558
198888,00FD2268DE6E83934D2916174E81532F,60472,0,6,6,109.46625,18.29542,1367
198889,00FD2268DE6E83934D2916174E81532F,30111,6,9,3,109.47583,18.30542,1419
198890,00FD2268DE6E83934D2916174E81532F,30761,10,11,1,109.45201,18.3,1318
198891,00FD2268DE6E83934D2916174E81532F,30111,11,14,3,109.47583,18.30542,1419
198892,00FD2268DE6E83934D2916174E81532F,60472,14,16,2,109.46625,18.29542,1367
198893,00FD2268DE6E83934D2916174E81532F,30111,17,19,2,109.47583,18.30542,1419
198921,996C0D9500BF90CC0E7F5A04C49A464B,31931,0,1,1,109.54771,18.29403,1667
198922,996C0D9500BF90CC0E7F5A04C49A464B,39181,3,7,4,109.55153,18.28035,1715
198923,996C0D9500BF90CC0E7F5A04C49A464B,31931,9,21,12,109.54771,18.29403,1667
198936,B340EDEF4A878E8DF5CBEC25E465EACE,31071,0,2,2,109.58257,18.28458,1815
198937,B340EDEF4A878E8DF5CBEC25E465EACE,30854,3,11,8,109.56889,18.27076,1763
198938,B340EDEF4A878E8DF5CBEC25E465EACE,30084,12,13,1,109.50118,18.26972,1513
198939,B340EDEF4A878E8DF5CBEC25E465EACE,30854,15,16,1,109.56889,18.27076,1763
198958,F198CAA1F49ACA5D003FD8F8473B3798,31071,0,7,7,109.58257,18.28458,1815
198959,F198CAA1F49ACA5D003FD8F8473B3798,30854,8,23,15,109.56889,18.27076,1763
198971,25F8E03F1120E0B7927A22C7EA6DF1B4,31031,0,13,13,109.49979,18.25382,1510
198972,25F8E03F1120E0B7927A22C7EA6DF1B4,38315,14,15,1,109.48979,18.29764,1467
199020,DAB08D254D49BF150533311BD904D49C,31411,19,20,1,109.5016,18.23576,1507
199021,DAB08D254D49BF150533311BD904D49C,60291,21,23,2,109.50826,18.24639,1509
199039,968151594EB4BCD9EBED877ECCD5C3EC,30351,0,8,8,109.41701,18.29292,1217
199040,968151594EB4BCD9EBED877ECCD5C3EC,60054,12,15,3,109.3016,18.31229,770
199041,8C5A16299A6D294198C90C34C25C5949,30851,0,2,2,109.5616,18.27396,1713
199042,8C5A16299A6D294198C90C34C25C5949,39183,3,6,3,109.55542,18.28208,1715
199043,8C5A16299A6D294198C90C34C25C5949,31561,8,11,3,109.56792,18.28479,1765
199044,35C6EDC8AAC6B5ABA770190223528BA2,31061,0,8,8,109.53333,18.23257,1607
199045,35C6EDC8AAC6B5ABA770190223528BA2,33521,10,15,5,109.66313,18.45174,2143
199058,FCC0ADE407C88A97F8FDA735A86E80B1,31864,0,6,6,109.49014,18.28333,1465
199060,FCC0ADE407C88A97F8FDA735A86E80B1,30391,20,22,2,109.4975,18.27118,1513
199086,0423E588F6BE60693A7FCE42ABBAFF59,31231,0,14,14,109.42597,18.29292,1217
199087,0423E588F6BE60693A7FCE42ABBAFF59,31471,16,17,1,109.34583,18.29563,917
199088,0423E588F6BE60693A7FCE42ABBAFF59,31231,18,23,5,109.42597,18.29292,1217
199106,AE9453D604AF88F4293DEF99463B2345,30391,12,13,1,109.4975,18.27118,1513
199139,63359C177BE67F4FFCD2DF5C06228A23,60401,0,3,3,109.47444,18.27583,1414
199140,63359C177BE67F4FFCD2DF5C06228A23,30051,3,4,1,109.48917,18.21215,1453
199141,63359C177BE67F4FFCD2DF5C06228A23,60401,4,8,4,109.47444,18.27583,1414
199142,63359C177BE67F4FFCD2DF5C06228A23,30051,8,9,1,109.48917,18.21215,1453
199143,63359C177BE67F4FFCD2DF5C06228A23,60401,9,19,10,109.47444,18.27583,1414
199144,63359C177BE67F4FFCD2DF5C06228A23,30161,19,21,2,109.50042,18.24389,1508
199164,C711EA8F4B039EAC279F7CFC24309A8A,30051,12,13,1,109.48917,18.21215,1453
199165,C711EA8F4B039EAC279F7CFC24309A8A,60671,14,15,1,109.52979,18.31757,1621
199166,C711EA8F4B039EAC279F7CFC24309A8A,30071,20,23,3,109.52819,18.30472,1619
199167,2D39AE6120F2674000C6DBB8A6E572A0,31945,2,13,11,109.58021,18.29403,1817
199168,2D39AE6120F2674000C6DBB8A6E572A0,30854,13,15,2,109.56889,18.27076,1763
199200,44F505B3929E26B4B29F00CC284F3084,60631,3,9,6,109.57778,18.27583,1814
199201,44F505B3929E26B4B29F00CC284F3084,30854,10,16,6,109.56889,18.27076,1763
199202,770A00BDAFE9BCA8C9E9FA68066EED7D,30854,18,19,1,109.56889,18.27076,1763
199203,770A00BDAFE9BCA8C9E9FA68066EED7D,31071,20,23,3,109.58257,18.28458,1815
199253,86C0171C8311911DC85F52F1754351D5,30021,0,8,8,109.12014,18.40986,86
199254,86C0171C8311911DC85F52F1754351D5,30911,10,11,1,109.50493,18.26181,1511
199255,86C0171C8311911DC85F52F1754351D5,30771,15,16,1,109.49938,18.26042,1511
199256,86C0171C8311911DC85F52F1754351D5,30421,18,21,3,109.50021,18.25861,1511
199257,86C0171C8311911DC85F52F1754351D5,30911,21,23,2,109.50493,18.26181,1511
199286,3878C4CD0EA74CE57B1537A7F0A483EE,38023,0,9,9,109.37132,18.28993,1016
199287,3878C4CD0EA74CE57B1537A7F0A483EE,30341,13,14,1,109.3625,18.29167,966
199288,3878C4CD0EA74CE57B1537A7F0A483EE,38023,15,18,3,109.37132,18.28993,1016
199289,3878C4CD0EA74CE57B1537A7F0A483EE,30341,19,20,1,109.3625,18.29167,966
199290,3878C4CD0EA74CE57B1537A7F0A483EE,38023,21,23,2,109.37132,18.28993,1016
199371,AD6C1B3AC9CE359429A262FC83337FDE,31471,15,17,2,109.34583,18.29563,917
199372,AD6C1B3AC9CE359429A262FC83337FDE,30351,17,19,2,109.41701,18.29292,1217
199373,AD6C1B3AC9CE359429A262FC83337FDE,60551,19,20,1,109.42722,18.30111,1218
199374,AD6C1B3AC9CE359429A262FC83337FDE,38671,21,23,2,109.41576,18.29285,1167
199457,94C4D5691F7DFC1AB38806AFFAC1389E,30921,1,7,6,109.53903,18.29451,1667
199458,94C4D5691F7DFC1AB38806AFFAC1389E,31931,7,8,1,109.54771,18.29403,1667
199459,94C4D5691F7DFC1AB38806AFFAC1389E,30921,9,10,1,109.53903,18.29451,1667
199460,94C4D5691F7DFC1AB38806AFFAC1389E,31041,19,21,2,109.50278,18.23701,1507
199461,94C4D5691F7DFC1AB38806AFFAC1389E,31931,22,23,1,109.54771,18.29403,1667
199486,E191BF114A3C2277CB7C3323BAA13F43,30854,0,8,8,109.56889,18.27076,1763
199487,E191BF114A3C2277CB7C3323BAA13F43,31121,12,14,2,109.16292,18.37063,230
199488,E191BF114A3C2277CB7C3323BAA13F43,30854,16,17,1,109.56889,18.27076,1763
199489,E191BF114A3C2277CB7C3323BAA13F43,31561,17,18,1,109.56792,18.28479,1765
199490,E191BF114A3C2277CB7C3323BAA13F43,30854,21,22,1,109.56889,18.27076,1763
199491,9FC721E86703223349C05C95FE4BBB6F,60081,0,9,9,109.51097,18.22639,1556
199492,9FC721E86703223349C05C95FE4BBB6F,60381,11,20,9,109.5241,18.22458,1605
199493,9FC721E86703223349C05C95FE4BBB6F,60081,20,22,2,109.51097,18.22639,1556
199508,CE134334D65848FE094D43D90ED46C80,38111,0,6,6,109.52007,18.22403,1555
199509,CE134334D65848FE094D43D90ED46C80,38111,7,19,12,109.52007,18.22403,1555
199510,CE134334D65848FE094D43D90ED46C80,31521,19,20,1,109.51458,18.22542,1555
199511,CE134334D65848FE094D43D90ED46C80,38111,21,23,2,109.52007,18.22403,1555
199518,293757429670FEF848C950D685169FCC,31071,0,7,7,109.58257,18.28458,1815
199519,293757429670FEF848C950D685169FCC,30854,11,18,7,109.56889,18.27076,1763
199528,A68637AA89BD62624E677D9E66C32FAD,31391,0,4,4,109.50382,18.24285,1508
199529,A68637AA89BD62624E677D9E66C32FAD,30361,5,8,3,109.50347,18.24,1508
199530,A68637AA89BD62624E677D9E66C32FAD,30161,9,13,4,109.50042,18.24389,1508
199531,A68637AA89BD62624E677D9E66C32FAD,30161,15,18,3,109.50042,18.24389,1508
199532,A68637AA89BD62624E677D9E66C32FAD,60281,18,20,2,109.51743,18.25924,1561
199533,A68637AA89BD62624E677D9E66C32FAD,31461,20,21,1,109.5091,18.25389,1510
199557,B5EEA30F2FFAABF51AE99311CDE9203E,39111,0,6,6,109.5191,18.22597,1555
199558,B5EEA30F2FFAABF51AE99311CDE9203E,31145,8,10,2,109.20431,18.30479,369
199559,B5EEA30F2FFAABF51AE99311CDE9203E,31521,13,16,3,109.51458,18.22542,1555
199560,B5EEA30F2FFAABF51AE99311CDE9203E,39111,19,23,4,109.5191,18.22597,1555
199605,05905F60112FFA73902399BABD12025F,30181,1,11,10,109.51597,18.23313,1557
199606,05905F60112FFA73902399BABD12025F,38754,12,16,4,109.74667,18.37382,2430
199607,05905F60112FFA73902399BABD12025F,30361,18,21,3,109.50347,18.24,1508
199608,05905F60112FFA73902399BABD12025F,30181,21,23,2,109.51597,18.23313,1557
199627,3389A095460231D31BA622B7185D6321,31231,0,1,1,109.42597,18.29292,1217
199628,3389A095460231D31BA622B7185D6321,60552,2,3,1,109.41729,18.30014,1218
199629,3389A095460231D31BA622B7185D6321,31681,6,19,13,109.40396,18.29979,1168
199630,3389A095460231D31BA622B7185D6321,60552,21,23,2,109.41729,18.30014,1218
199663,46DF9F7A9481895A9B0E6AFE3F8BF4F5,30511,10,11,1,109.51069,18.24208,1558
199665,3237597F614A630A7507AC0232ABB23F,31031,18,20,2,109.49979,18.25382,1510
199666,3237597F614A630A7507AC0232ABB23F,30201,20,22,2,109.4909,18.26465,1462
199679,90B0A60855A43B2DB99A0964CE51D3AF,31071,1,12,11,109.58257,18.28458,1815
199680,90B0A60855A43B2DB99A0964CE51D3AF,30854,13,20,7,109.56889,18.27076,1763
199686,EE1DC3D3663945EFC02BAB5EE6A065E9,31071,0,7,7,109.58257,18.28458,1815
199687,EE1DC3D3663945EFC02BAB5EE6A065E9,30854,7,8,1,109.56889,18.27076,1763
199688,EE1DC3D3663945EFC02BAB5EE6A065E9,31945,9,12,3,109.58021,18.29403,1817
199689,EE1DC3D3663945EFC02BAB5EE6A065E9,30854,13,17,4,109.56889,18.27076,1763
199690,EE1DC3D3663945EFC02BAB5EE6A065E9,31071,21,23,2,109.58257,18.28458,1815
199712,301C6D43A4835F6C303372D1D4AB6B2B,30151,0,2,2,109.50986,18.25083,1560
199713,301C6D43A4835F6C303372D1D4AB6B2B,30151,2,9,7,109.50986,18.25083,1560
199714,301C6D43A4835F6C303372D1D4AB6B2B,60291,12,15,3,109.50826,18.24639,1509
199715,301C6D43A4835F6C303372D1D4AB6B2B,30101,15,16,1,109.57299,18.33333,1773
199716,301C6D43A4835F6C303372D1D4AB6B2B,31421,17,21,4,109.55382,18.22347,1705
199717,301C6D43A4835F6C303372D1D4AB6B2B,30151,21,23,2,109.50986,18.25083,1560
199756,7108C89027EB031E7A5F6707D053C8A4,38061,0,11,11,109.50597,18.23118,1506
199757,7108C89027EB031E7A5F6707D053C8A4,60381,13,15,2,109.5241,18.22458,1605
199758,7108C89027EB031E7A5F6707D053C8A4,38052,17,21,4,109.62618,18.23042,1956
199770,122D07F80E4FAC68FAE7EDBB2DF1AFA3,31071,12,14,2,109.58257,18.28458,1815
199771,122D07F80E4FAC68FAE7EDBB2DF1AFA3,30854,14,17,3,109.56889,18.27076,1763
199797,A65416E0023DB5B05C85EFD796D8188E,60401,0,1,1,109.47444,18.27583,1414
199798,A65416E0023DB5B05C85EFD796D8188E,38251,2,14,12,109.49618,18.25493,1510
199799,A65416E0023DB5B05C85EFD796D8188E,60441,16,18,2,109.46792,18.28604,1366
199800,A65416E0023DB5B05C85EFD796D8188E,31031,20,22,2,109.49979,18.25382,1510
199813,D334753E33AD01D79142036B3D85543F,31561,0,5,5,109.56792,18.28479,1765
199814,D334753E33AD01D79142036B3D85543F,39183,6,17,11,109.55542,18.28208,1715
199825,00145806BBF2F60A963743509F901155,60331,0,7,7,109.505,18.26507,1512
199826,00145806BBF2F60A963743509F901155,30291,12,13,1,109.50403,18.27028,1513
199827,00145806BBF2F60A963743509F901155,60221,15,17,2,109.52569,18.29188,1616
199828,00145806BBF2F60A963743509F901155,30291,18,20,2,109.50403,18.27028,1513
199829,00145806BBF2F60A963743509F901155,60331,21,23,2,109.505,18.26507,1512
199847,25A98576A428F536C695E42B71201D8E,31021,17,19,2,109.49021,18.27,1463
199848,25A98576A428F536C695E42B71201D8E,38162,20,21,1,109.43944,18.28889,1266
199849,25A98576A428F536C695E42B71201D8E,31701,22,23,1,109.44132,18.28833,1266
199868,46B472A67DC212EE4047EBC9FB351124,31071,0,6,6,109.58257,18.28458,1815
199869,46B472A67DC212EE4047EBC9FB351124,31071,7,9,2,109.58257,18.28458,1815
199870,46B472A67DC212EE4047EBC9FB351124,30854,10,12,2,109.56889,18.27076,1763
199916,A9FCE0049DB44FE004EAFBF5B783F4A5,60631,3,8,5,109.57778,18.27583,1814
199917,A9FCE0049DB44FE004EAFBF5B783F4A5,30854,8,18,10,109.56889,18.27076,1763
199918,A9FCE0049DB44FE004EAFBF5B783F4A5,30191,20,22,2,109.50361,18.22701,1506
199979,1AFA3FBCD4D68449B676809F8F32C1FB,30324,0,1,1,109.50326,18.29257,1517
199980,1AFA3FBCD4D68449B676809F8F32C1FB,30741,2,3,1,109.49833,18.28681,1516
199981,1AFA3FBCD4D68449B676809F8F32C1FB,30324,3,6,3,109.50326,18.29257,1517
200036,AE469023AED34059A59DE7E300668B8A,30681,0,6,6,109.48493,18.26917,1463
200037,AE469023AED34059A59DE7E300668B8A,30271,8,9,1,109.49132,18.23153,1456
200038,AE469023AED34059A59DE7E300668B8A,31231,11,14,3,109.42597,18.29292,1217
200039,84DF4A7C208235D171EF56473BCCF210,30851,0,5,5,109.5616,18.27396,1713
200040,84DF4A7C208235D171EF56473BCCF210,60631,8,18,10,109.57778,18.27583,1814
200041,67E18D6323A016C43955B0A9A1FA3659,30211,5,11,6,109.49882,18.23931,1508
200042,67E18D6323A016C43955B0A9A1FA3659,31231,16,17,1,109.42597,18.29292,1217
200043,67E18D6323A016C43955B0A9A1FA3659,38281,19,22,3,109.6525,18.23403,2057
200047,9220DF509B1CBDCE8F6FF4B7184ACC0D,31561,2,18,16,109.56792,18.28479,1765
200048,9220DF509B1CBDCE8F6FF4B7184ACC0D,30421,19,21,2,109.50021,18.25861,1511
200085,BCE29A3A46F5A479B3F0FA50B11216DE,60631,2,15,13,109.57778,18.27583,1814
200086,BCE29A3A46F5A479B3F0FA50B11216DE,30854,15,16,1,109.56889,18.27076,1763
200087,BCE29A3A46F5A479B3F0FA50B11216DE,31071,20,21,1,109.58257,18.28458,1815
200090,C3071072DB6684DC75BE160268E6323C,31071,1,6,5,109.58257,18.28458,1815
200091,C3071072DB6684DC75BE160268E6323C,30854,11,13,2,109.56889,18.27076,1763
200092,A94F66C88B84FF0658441320CD9F667C,31071,1,7,6,109.58257,18.28458,1815
200093,A94F66C88B84FF0658441320CD9F667C,30854,9,16,7,109.56889,18.27076,1763
200094,A94F66C88B84FF0658441320CD9F667C,31071,17,18,1,109.58257,18.28458,1815
200095,A94F66C88B84FF0658441320CD9F667C,31071,20,23,3,109.58257,18.28458,1815
200101,7024F3A14F6F554DC6E80063E30315F0,30854,19,20,1,109.56889,18.27076,1763
200102,7024F3A14F6F554DC6E80063E30315F0,31561,22,23,1,109.56792,18.28479,1765
200114,9905C3E423D151CCE1280F3A1732CE90,30854,0,6,6,109.56889,18.27076,1763
200115,9905C3E423D151CCE1280F3A1732CE90,31071,7,8,1,109.58257,18.28458,1815
200116,9905C3E423D151CCE1280F3A1732CE90,30851,8,11,3,109.5616,18.27396,1713
200117,9905C3E423D151CCE1280F3A1732CE90,30951,13,18,5,109.56208,18.25667,1761
200118,9905C3E423D151CCE1280F3A1732CE90,30854,19,22,3,109.56889,18.27076,1763
200133,C316CE65034FB3C77BE459147CBF943A,60291,0,9,9,109.50826,18.24639,1509
200134,C316CE65034FB3C77BE459147CBF943A,30161,11,12,1,109.50042,18.24389,1508
200135,C316CE65034FB3C77BE459147CBF943A,39101,13,16,3,109.50132,18.24931,1509
200136,C316CE65034FB3C77BE459147CBF943A,30161,17,20,3,109.50042,18.24389,1508
200137,C316CE65034FB3C77BE459147CBF943A,31181,21,23,2,109.50382,18.24813,1509
200143,BE586ACB441383CC10D7CF3923850B73,31931,0,7,7,109.54771,18.29403,1667
200144,BE586ACB441383CC10D7CF3923850B73,39181,8,10,2,109.55153,18.28035,1715
200145,BE586ACB441383CC10D7CF3923850B73,31931,12,13,1,109.54771,18.29403,1667
200146,BE586ACB441383CC10D7CF3923850B73,39181,14,15,1,109.55153,18.28035,1715
200147,BE586ACB441383CC10D7CF3923850B73,39181,16,17,1,109.55153,18.28035,1715
200148,BE586ACB441383CC10D7CF3923850B73,31931,19,23,4,109.54771,18.29403,1667
200168,5E1CFBE3DFE86DADC6CC4F4423C546C7,38331,0,13,13,109.62465,18.22736,1956
200169,5E1CFBE3DFE86DADC6CC4F4423C546C7,38283,14,16,2,109.62229,18.22618,1956
200170,5E1CFBE3DFE86DADC6CC4F4423C546C7,30441,18,21,3,109.64021,18.25424,2010
200171,B8587D3CED4B79DF3F07DD5419A719F9,38251,11,12,1,109.49618,18.25493,1510
200172,B8587D3CED4B79DF3F07DD5419A719F9,38325,13,14,1,109.39792,18.2909,1116
200173,B8587D3CED4B79DF3F07DD5419A719F9,30211,16,17,1,109.49882,18.23931,1508
200193,D6A345956751BA2ACC5430EDF68A104F,39181,0,6,6,109.55153,18.28035,1715
200194,D6A345956751BA2ACC5430EDF68A104F,31931,6,9,3,109.54771,18.29403,1667
200195,D6A345956751BA2ACC5430EDF68A104F,30071,9,11,2,109.52819,18.30472,1619
200196,D6A345956751BA2ACC5430EDF68A104F,31931,12,19,7,109.54771,18.29403,1667
200197,D6A345956751BA2ACC5430EDF68A104F,39181,20,23,3,109.55153,18.28035,1715
200211,C50EC98EBB3AD6F34D76F87C749DAC01,39181,0,6,6,109.55153,18.28035,1715
200212,C50EC98EBB3AD6F34D76F87C749DAC01,31931,6,9,3,109.54771,18.29403,1667
200213,C50EC98EBB3AD6F34D76F87C749DAC01,39181,13,17,4,109.55153,18.28035,1715
200214,C50EC98EBB3AD6F34D76F87C749DAC01,39181,18,23,5,109.55153,18.28035,1715
200230,3C81431CE72C8A68AA7DD35602A2B093,33481,13,15,2,109.67278,18.41278,2187
200231,3C81431CE72C8A68AA7DD35602A2B093,60221,19,21,2,109.52569,18.29188,1616
200232,3C81431CE72C8A68AA7DD35602A2B093,30861,22,23,1,109.52722,18.22743,1606
200250,7AFC8085101D104BD77EE20C33AECEB4,48647,0,6,6,109.48701,18.29042,1466
200251,7AFC8085101D104BD77EE20C33AECEB4,30764,6,7,1,109.45806,18.29486,1367
200252,7AFC8085101D104BD77EE20C33AECEB4,48647,8,9,1,109.48701,18.29042,1466
200260,F00821368F615DCDAF214035D8EC4A44,31071,0,4,4,109.58257,18.28458,1815
200261,F00821368F615DCDAF214035D8EC4A44,31071,5,7,2,109.58257,18.28458,1815
200262,F00821368F615DCDAF214035D8EC4A44,30854,7,16,9,109.56889,18.27076,1763
200263,F00821368F615DCDAF214035D8EC4A44,31071,18,22,4,109.58257,18.28458,1815
200276,FF90B6855593CFEA9A07FE008E94551D,60371,19,21,2,109.53063,18.30056,1618
200277,FF90B6855593CFEA9A07FE008E94551D,30071,21,23,2,109.52819,18.30472,1619
200278,559FD1DF7FB03AA92C9149566C4A2E28,60131,0,5,5,109.49819,18.24778,1509
200279,559FD1DF7FB03AA92C9149566C4A2E28,60291,5,7,2,109.50826,18.24639,1509
200281,559FD1DF7FB03AA92C9149566C4A2E28,30361,19,22,3,109.50347,18.24,1508
200282,8C0E6B51FAFE21C31FB9AE08C36DF0A2,30921,0,16,16,109.53903,18.29451,1667
200283,8C0E6B51FAFE21C31FB9AE08C36DF0A2,31931,18,20,2,109.54771,18.29403,1667
200293,C54CD3A42CE5AE9A9396503ECCB4A236,39371,0,7,7,109.56627,18.2646,1762
200294,C54CD3A42CE5AE9A9396503ECCB4A236,30111,7,17,10,109.47583,18.30542,1419
200295,C54CD3A42CE5AE9A9396503ECCB4A236,30861,22,23,1,109.52722,18.22743,1606
200313,934029FB5F97BCE114EDCE88F0393A63,30854,0,12,12,109.56889,18.27076,1763
200314,934029FB5F97BCE114EDCE88F0393A63,30421,15,18,3,109.50021,18.25861,1511
200315,934029FB5F97BCE114EDCE88F0393A63,39371,21,23,2,109.56627,18.2646,1762
200327,3D689A9568FAADEA2EB7920B95888F95,60504,0,9,9,109.47917,18.28903,1416
200328,3D689A9568FAADEA2EB7920B95888F95,60391,11,15,4,109.47667,18.28757,1416
200329,3D689A9568FAADEA2EB7920B95888F95,31411,18,21,3,109.5016,18.23576,1507
200330,3D689A9568FAADEA2EB7920B95888F95,31091,22,23,1,109.41201,18.31222,1170
200347,D947D8D9432E18EA6A214259B6E2987E,60054,0,4,4,109.3016,18.31229,770
200348,D947D8D9432E18EA6A214259B6E2987E,30661,6,12,6,109.37028,18.24361,1008
200349,D947D8D9432E18EA6A214259B6E2987E,60411,13,14,1,109.32514,18.30854,869
200350,D947D8D9432E18EA6A214259B6E2987E,30661,14,15,1,109.37028,18.24361,1008
200351,D947D8D9432E18EA6A214259B6E2987E,60411,17,18,1,109.32514,18.30854,869
200371,E082FB5BD091C5B334EC1176FF352EE0,30071,0,15,15,109.52819,18.30472,1619
200372,E082FB5BD091C5B334EC1176FF352EE0,30921,15,16,1,109.53903,18.29451,1667
200373,E082FB5BD091C5B334EC1176FF352EE0,30071,19,23,4,109.52819,18.30472,1619
200385,D5B91D126489D960AE97CC8A6C1B036B,31571,0,12,12,109.61563,18.23326,1957
200386,D5B91D126489D960AE97CC8A6C1B036B,30441,15,17,2,109.64021,18.25424,2010
200387,D5B91D126489D960AE97CC8A6C1B036B,31571,20,22,2,109.61563,18.23326,1957
200395,173F9710B8D6B9F1AA39189FE9F9512E,38017,19,20,1,109.49729,18.21424,1504
200396,173F9710B8D6B9F1AA39189FE9F9512E,38251,22,23,1,109.49618,18.25493,1510
200420,6ED697962F10CC0C2236463F9FC9376B,30821,7,20,13,109.43681,18.33639,1274
200421,6ED697962F10CC0C2236463F9FC9376B,30761,21,22,1,109.45201,18.3,1318
200431,B93185B4820D7E0DEE74EBEA00941D15,30911,0,5,5,109.50493,18.26181,1511
200432,B93185B4820D7E0DEE74EBEA00941D15,30251,5,6,1,109.50611,18.26653,1512
200433,B93185B4820D7E0DEE74EBEA00941D15,30911,6,19,13,109.50493,18.26181,1511
200434,B93185B4820D7E0DEE74EBEA00941D15,38291,20,22,2,109.51618,18.24313,1558
200458,54A6757CA4BF8A47C41CF1DDCA6EA505,30854,16,18,2,109.56889,18.27076,1763
200459,54A6757CA4BF8A47C41CF1DDCA6EA505,31071,22,23,1,109.58257,18.28458,1815
200480,71048DA762610C5657DD6D8242833DC9,30234,0,2,2,109.60681,18.29979,1918
200481,71048DA762610C5657DD6D8242833DC9,39371,3,5,2,109.56627,18.2646,1762
200482,71048DA762610C5657DD6D8242833DC9,30234,5,7,2,109.60681,18.29979,1918
200485,409F5E8F01172D32BBE91132149C037E,30511,0,9,9,109.51069,18.24208,1558
200486,409F5E8F01172D32BBE91132149C037E,39101,9,10,1,109.50132,18.24931,1509
200487,409F5E8F01172D32BBE91132149C037E,30361,12,13,1,109.50347,18.24,1508
200488,409F5E8F01172D32BBE91132149C037E,31201,17,18,1,109.51042,18.23819,1558
200489,409F5E8F01172D32BBE91132149C037E,38157,22,23,1,109.51483,18.26958,1563
200491,07169E7114E4F14C073261BAAC0D4491,61011,10,12,2,109.60653,18.19076,1900
200493,53490AD77ACCA93C3ED0F3DE79CA488B,31071,11,13,2,109.58257,18.28458,1815
200494,53490AD77ACCA93C3ED0F3DE79CA488B,30854,15,16,1,109.56889,18.27076,1763
200495,53490AD77ACCA93C3ED0F3DE79CA488B,31071,18,20,2,109.58257,18.28458,1815
200518,6F590AF2C10C4B9F0F4E76B8E922550E,31071,0,7,7,109.58257,18.28458,1815
200519,6F590AF2C10C4B9F0F4E76B8E922550E,31071,9,11,2,109.58257,18.28458,1815
200520,6F590AF2C10C4B9F0F4E76B8E922550E,30854,15,16,1,109.56889,18.27076,1763
200521,6F590AF2C10C4B9F0F4E76B8E922550E,31761,18,21,3,109.60521,18.27965,1914
200522,6F590AF2C10C4B9F0F4E76B8E922550E,60354,21,23,2,109.58701,18.28521,1815
200544,2785D5AA4FE0918A7AF0E1FD0BB88176,30854,13,16,3,109.56889,18.27076,1763
200545,2785D5AA4FE0918A7AF0E1FD0BB88176,38361,21,23,2,109.43667,18.29201,1267
200569,9C1407835BC54BEBDB541F52E1DA1820,61011,17,21,4,109.60653,18.19076,1900
200597,D4ACE21EA3DCCDD758BC5FDCC5A3C794,30351,0,7,7,109.41701,18.29292,1217
200598,D4ACE21EA3DCCDD758BC5FDCC5A3C794,31781,9,12,3,109.19847,18.2975,367
200599,D4ACE21EA3DCCDD758BC5FDCC5A3C794,60054,14,16,2,109.3016,18.31229,770
200600,D4ACE21EA3DCCDD758BC5FDCC5A3C794,30351,19,23,4,109.41701,18.29292,1217
200653,C666BDF91E2AEE4AB0E8446E7282D156,60463,10,12,2,109.52507,18.22438,1605
200654,C666BDF91E2AEE4AB0E8446E7282D156,39053,14,16,2,109.511,18.2771,1564
200655,C666BDF91E2AEE4AB0E8446E7282D156,31061,18,19,1,109.53333,18.23257,1607
200656,C666BDF91E2AEE4AB0E8446E7282D156,60221,20,22,2,109.52569,18.29188,1616
200661,0E355C05F79BCBF53145724D835D4901,38105,0,6,6,109.40299,18.29229,1117
200662,0E355C05F79BCBF53145724D835D4901,31301,9,12,3,109.14493,18.31222,170
200663,0E355C05F79BCBF53145724D835D4901,31471,13,15,2,109.34583,18.29563,917
200674,87C93C09107C554DB19E0C119A198391,31531,8,9,1,109.49583,18.25972,1461
200675,87C93C09107C554DB19E0C119A198391,30071,9,10,1,109.52819,18.30472,1619
200676,87C93C09107C554DB19E0C119A198391,31031,12,13,1,109.49979,18.25382,1510
200699,3D973863443908C78D38AAF704284294,30671,0,6,6,109.43611,18.30139,1268
200700,3D973863443908C78D38AAF704284294,60054,10,11,1,109.3016,18.31229,770
200701,3D973863443908C78D38AAF704284294,30661,11,13,2,109.37028,18.24361,1008
200725,D9689370CD6256E9753C2B0B13067E2B,60631,1,6,5,109.57778,18.27583,1814
200727,D9689370CD6256E9753C2B0B13067E2B,30854,15,23,8,109.56889,18.27076,1763
200759,6A74DBCF68C394F15C6D2F7F45531CD3,60054,14,15,1,109.3016,18.31229,770
200760,6A74DBCF68C394F15C6D2F7F45531CD3,60221,15,19,4,109.52569,18.29188,1616
200761,6A74DBCF68C394F15C6D2F7F45531CD3,31421,22,23,1,109.55382,18.22347,1705
200780,9D08739092826F08F2C268E72E8D5521,60281,19,21,2,109.51743,18.25924,1561
200781,9D08739092826F08F2C268E72E8D5521,38325,22,23,1,109.39792,18.2909,1116
200800,2091DB2ACA69B10ADE950A23CC278A98,31431,0,1,1,109.44639,18.29042,1316
200801,2091DB2ACA69B10ADE950A23CC278A98,60361,3,5,2,109.51938,18.29681,1567
200802,2091DB2ACA69B10ADE950A23CC278A98,31431,7,16,9,109.44639,18.29042,1316
200803,2091DB2ACA69B10ADE950A23CC278A98,38251,16,17,1,109.49618,18.25493,1510
200804,2091DB2ACA69B10ADE950A23CC278A98,31431,18,19,1,109.44639,18.29042,1316
200808,B6F812E63295803956F25D278E925B23,30681,0,9,9,109.48493,18.26917,1463
200809,B6F812E63295803956F25D278E925B23,30854,13,14,1,109.56889,18.27076,1763
200810,B6F812E63295803956F25D278E925B23,38127,14,22,8,109.50833,18.27222,1513
200842,38C163CD965FA1BEEEA1CEB4AE4ADD90,39181,12,14,2,109.55153,18.28035,1715
200843,38C163CD965FA1BEEEA1CEB4AE4ADD90,60201,14,22,8,109.5041,18.2509,1510
200864,99CBAA6A65A50998F0A10B72B36210E4,60161,9,10,1,109.49174,18.26181,1461
200865,99CBAA6A65A50998F0A10B72B36210E4,60231,11,22,11,109.49903,18.21972,1504
200866,2FE0F3A82C27452F04A6B927F514EFA7,31554,0,10,10,109.55521,18.2459,1709
200867,2FE0F3A82C27452F04A6B927F514EFA7,31561,11,12,1,109.56792,18.28479,1765
200868,2FE0F3A82C27452F04A6B927F514EFA7,31181,14,15,1,109.50382,18.24813,1509
200869,2FE0F3A82C27452F04A6B927F514EFA7,30911,16,17,1,109.50493,18.26181,1511
200870,2FE0F3A82C27452F04A6B927F514EFA7,60381,18,23,5,109.5241,18.22458,1605
200874,A2DBFF4E352E7B7C1EE25431C02FC741,31931,0,14,14,109.54771,18.29403,1667
200875,A2DBFF4E352E7B7C1EE25431C02FC741,39181,15,18,3,109.55153,18.28035,1715
200876,A2DBFF4E352E7B7C1EE25431C02FC741,31931,19,21,2,109.54771,18.29403,1667
200885,000584B3023702F3E9DDF521B1C35B1A,30854,17,18,1,109.56889,18.27076,1763
200886,000584B3023702F3E9DDF521B1C35B1A,31945,19,20,1,109.58021,18.29403,1817
200887,7EBC20D0E5F0FBA046CA1D08E7FF47C1,30854,1,19,18,109.56889,18.27076,1763
200888,7EBC20D0E5F0FBA046CA1D08E7FF47C1,30191,22,23,1,109.50361,18.22701,1506
200949,E34FF61340C5B86CF9FD0AD454D26266,60331,0,7,7,109.505,18.26507,1512
200950,E34FF61340C5B86CF9FD0AD454D26266,30251,10,14,4,109.50611,18.26653,1512
200951,E34FF61340C5B86CF9FD0AD454D26266,60131,14,18,4,109.49819,18.24778,1509
200952,E34FF61340C5B86CF9FD0AD454D26266,60331,19,23,4,109.505,18.26507,1512
200959,3C5AEA306E8A69C707195C4150E77D90,31931,1,6,5,109.54771,18.29403,1667
200960,3C5AEA306E8A69C707195C4150E77D90,39181,7,10,3,109.55153,18.28035,1715
200961,3C5AEA306E8A69C707195C4150E77D90,39181,14,17,3,109.55153,18.28035,1715
200962,3C5AEA306E8A69C707195C4150E77D90,31931,19,22,3,109.54771,18.29403,1667
200976,DF1914B7230B32BA806E8A8749CAD846,60261,0,10,10,109.44326,18.3075,1319
200977,DF1914B7230B32BA806E8A8749CAD846,60421,12,15,3,109.46333,18.31743,1371
200978,DF1914B7230B32BA806E8A8749CAD846,60501,18,20,2,109.48701,18.29021,1466
200982,01FF6D65AF5B6ECAD8BD2BEF97B00B84,38052,0,1,1,109.62618,18.23042,1956
200983,01FF6D65AF5B6ECAD8BD2BEF97B00B84,31571,3,7,4,109.61563,18.23326,1957
200984,01FF6D65AF5B6ECAD8BD2BEF97B00B84,38052,7,8,1,109.62618,18.23042,1956
200985,01FF6D65AF5B6ECAD8BD2BEF97B00B84,30441,10,12,2,109.64021,18.25424,2010
200986,01FF6D65AF5B6ECAD8BD2BEF97B00B84,38052,14,23,9,109.62618,18.23042,1956
200999,7E544E07A6F29B69DAF0EA624E4EEAAD,60054,16,18,2,109.3016,18.31229,770
201000,7E544E07A6F29B69DAF0EA624E4EEAAD,39281,21,23,2,109.21333,18.30271,418
201018,E5E2DA460104E389257158E8D8C9FBDA,60281,0,6,6,109.51743,18.25924,1561
201019,E5E2DA460104E389257158E8D8C9FBDA,60311,6,11,5,109.52097,18.24319,1558
201020,E5E2DA460104E389257158E8D8C9FBDA,31261,11,12,1,109.51174,18.2466,1559
201021,E5E2DA460104E389257158E8D8C9FBDA,60311,14,17,3,109.52097,18.24319,1558
201022,E5E2DA460104E389257158E8D8C9FBDA,60281,17,23,6,109.51743,18.25924,1561
201023,79BABDF74F5861A434085432A23D4B92,31071,0,8,8,109.58257,18.28458,1815
201024,79BABDF74F5861A434085432A23D4B92,30854,10,13,3,109.56889,18.27076,1763
201025,79BABDF74F5861A434085432A23D4B92,31071,14,20,6,109.58257,18.28458,1815
201066,020753EF78F0A0C39658113A3377EA1E,31561,0,7,7,109.56792,18.28479,1765
201067,020753EF78F0A0C39658113A3377EA1E,39183,7,8,1,109.55542,18.28208,1715
201068,020753EF78F0A0C39658113A3377EA1E,31561,8,22,14,109.56792,18.28479,1765
201075,8D496C0E2DB1FF881021B05CE10C0242,31071,0,4,4,109.58257,18.28458,1815
201076,8D496C0E2DB1FF881021B05CE10C0242,30854,7,23,16,109.56889,18.27076,1763
201098,7FD31F65A9E7574FDAD4A110ACBA289D,60171,14,16,2,109.51292,18.30694,1569
201099,7FD31F65A9E7574FDAD4A110ACBA289D,60371,18,19,1,109.53063,18.30056,1618
201112,EB0139E0BBB300F5407E4F7BCDA3B148,38291,0,14,14,109.51618,18.24313,1558
201113,EB0139E0BBB300F5407E4F7BCDA3B148,31521,14,18,4,109.51458,18.22542,1555
201114,EB0139E0BBB300F5407E4F7BCDA3B148,30421,19,20,1,109.50021,18.25861,1511
201115,0CE734CF9AAD35EF26955DDF1FD6DDAB,38871,15,17,2,109.44681,18.28625,1316
201116,0CE734CF9AAD35EF26955DDF1FD6DDAB,39091,18,19,1,109.50097,18.25222,1510
201117,0CE734CF9AAD35EF26955DDF1FD6DDAB,39091,21,22,1,109.50097,18.25222,1510
201231,51061B3DE820AF1C1C713EF684728003,30854,8,18,10,109.56889,18.27076,1763
201232,51061B3DE820AF1C1C713EF684728003,31071,21,23,2,109.58257,18.28458,1815
201238,213AF2099653A4ADAEF799CCC144B279,30021,0,11,11,109.12014,18.40986,86
201240,213AF2099653A4ADAEF799CCC144B279,30021,17,22,5,109.12014,18.40986,86
201241,5EC06FAC313B2D21C1321F01A9E06016,30661,13,15,2,109.37028,18.24361,1008
201242,5EC06FAC313B2D21C1321F01A9E06016,60054,18,19,1,109.3016,18.31229,770
201243,5EC06FAC313B2D21C1321F01A9E06016,38951,20,23,3,109.48097,18.28868,1416
201244,A9BC995AD7BCE38026731A45BAD73591,31521,0,1,1,109.51458,18.22542,1555
201245,A9BC995AD7BCE38026731A45BAD73591,30731,2,6,4,109.50944,18.22306,1555
201246,A9BC995AD7BCE38026731A45BAD73591,38754,9,12,3,109.74667,18.37382,2430
201278,1C7CD110946177CB33C47D26152F6C47,39183,1,6,5,109.55542,18.28208,1715
201279,1C7CD110946177CB33C47D26152F6C47,30851,7,8,1,109.5616,18.27396,1713
201293,207A3717E11AB3AC89EB226444DE97A9,31031,12,15,3,109.49979,18.25382,1510
201294,207A3717E11AB3AC89EB226444DE97A9,31031,15,17,2,109.49979,18.25382,1510
201295,207A3717E11AB3AC89EB226444DE97A9,30771,18,20,2,109.49938,18.26042,1511
201296,207A3717E11AB3AC89EB226444DE97A9,30771,21,22,1,109.49938,18.26042,1511
201320,D9AE11CD16B231308C3F0FB3F53BC3E9,31071,0,13,13,109.58257,18.28458,1815
201321,D9AE11CD16B231308C3F0FB3F53BC3E9,30854,15,17,2,109.56889,18.27076,1763
201338,7CE7C06285D7493A1117F256B3BBCC56,31031,8,9,1,109.49979,18.25382,1510
201339,7CE7C06285D7493A1117F256B3BBCC56,30151,10,16,6,109.50986,18.25083,1560
201340,7CE7C06285D7493A1117F256B3BBCC56,38291,18,19,1,109.51618,18.24313,1558
201341,7CE7C06285D7493A1117F256B3BBCC56,30151,20,23,3,109.50986,18.25083,1560
201383,8B9A9BFD1ACAD480EB101A91DBF2024D,38291,1,17,16,109.51618,18.24313,1558
201384,8B9A9BFD1ACAD480EB101A91DBF2024D,30371,18,20,2,109.51,18.24771,1559
201394,E9A67CAEAD4E146EE721320A56F893AA,31071,0,2,2,109.58257,18.28458,1815
201395,E9A67CAEAD4E146EE721320A56F893AA,31945,4,6,2,109.58021,18.29403,1817
201396,E9A67CAEAD4E146EE721320A56F893AA,30711,9,11,2,109.50271,18.25347,1510
201397,E9A67CAEAD4E146EE721320A56F893AA,30854,17,20,3,109.56889,18.27076,1763
201398,E9A67CAEAD4E146EE721320A56F893AA,31945,21,22,1,109.58021,18.29403,1817
201409,43E035AE85036EBD9891453E9567CB81,30151,0,8,8,109.50986,18.25083,1560
201410,43E035AE85036EBD9891453E9567CB81,30151,12,14,2,109.50986,18.25083,1560
201411,43E035AE85036EBD9891453E9567CB81,30321,16,22,6,109.49563,18.29611,1467
201424,F3EA4B3DF8A619A30272A53ECD9E968F,38185,0,7,7,109.51333,18.27347,1563
201425,F3EA4B3DF8A619A30272A53ECD9E968F,38013,12,14,2,109.49514,18.21951,1454
201426,F3EA4B3DF8A619A30272A53ECD9E968F,39191,17,19,2,109.51493,18.23472,1557
201427,F3EA4B3DF8A619A30272A53ECD9E968F,60201,20,22,2,109.5041,18.2509,1510
201432,B993C2FD00BD91EAEE002C4003C4B7E2,31071,0,7,7,109.58257,18.28458,1815
201433,B993C2FD00BD91EAEE002C4003C4B7E2,31071,8,9,1,109.58257,18.28458,1815
201434,B993C2FD00BD91EAEE002C4003C4B7E2,38251,14,15,1,109.49618,18.25493,1510
201438,F7EB65229708BABC838B2F6907E461CE,31521,0,7,7,109.51458,18.22542,1555
201439,F7EB65229708BABC838B2F6907E461CE,30661,9,14,5,109.37028,18.24361,1008
201440,F7EB65229708BABC838B2F6907E461CE,60054,16,17,1,109.3016,18.31229,770
201441,F7EB65229708BABC838B2F6907E461CE,31521,20,23,3,109.51458,18.22542,1555
201448,2123231E14775D9A8DE8B95E56EEF6DC,31471,12,14,2,109.34583,18.29563,917
201496,8752BC71725B50257436D50C6598F252,30854,13,15,2,109.56889,18.27076,1763
201497,8752BC71725B50257436D50C6598F252,31071,19,23,4,109.58257,18.28458,1815
201501,92E14A6094471B9C1A50CE8585136EC6,60087,15,17,2,109.50688,18.22299,1505
201502,92E14A6094471B9C1A50CE8585136EC6,30731,19,23,4,109.50944,18.22306,1555
201518,D2FA8B3378302724EAD475376DD7D7E4,30661,13,15,2,109.37028,18.24361,1008
201519,D2FA8B3378302724EAD475376DD7D7E4,31303,19,23,4,109.15826,18.29549,217
201556,4538154FE025AC6453F6CD695BA5F0AF,31261,14,15,1,109.51174,18.2466,1559
201557,4538154FE025AC6453F6CD695BA5F0AF,30731,17,19,2,109.50944,18.22306,1555
201558,4538154FE025AC6453F6CD695BA5F0AF,31261,19,23,4,109.51174,18.2466,1559
201568,DC9973204E62AA99FA79F0696CF6C0F6,31945,0,7,7,109.58021,18.29403,1817
201569,DC9973204E62AA99FA79F0696CF6C0F6,30854,8,14,6,109.56889,18.27076,1763
201570,DC9973204E62AA99FA79F0696CF6C0F6,30361,17,18,1,109.50347,18.24,1508
201571,DC9973204E62AA99FA79F0696CF6C0F6,31411,19,20,1,109.5016,18.23576,1507
201572,DC9973204E62AA99FA79F0696CF6C0F6,30854,21,23,2,109.56889,18.27076,1763
201573,C983E73D646629A775690ECA8920EB29,30101,0,5,5,109.57299,18.33333,1773
201574,C983E73D646629A775690ECA8920EB29,31631,6,7,1,109.59542,18.36826,1879
201575,C983E73D646629A775690ECA8920EB29,30101,8,11,3,109.57299,18.33333,1773
201576,C983E73D646629A775690ECA8920EB29,31631,16,17,1,109.59542,18.36826,1879
201577,C983E73D646629A775690ECA8920EB29,30101,19,20,1,109.57299,18.33333,1773
201578,C983E73D646629A775690ECA8920EB29,31631,21,23,2,109.59542,18.36826,1879
201593,86EDF7CD143DD19E47E6DF8DE8411FF2,31951,1,21,20,109.52174,18.30299,1568
201594,86EDF7CD143DD19E47E6DF8DE8411FF2,30561,21,22,1,109.52778,18.31938,1621
201639,8FE97C1052D63DE830211C405D8F5442,39371,5,7,2,109.56627,18.2646,1762
201640,8FE97C1052D63DE830211C405D8F5442,60631,7,12,5,109.57778,18.27583,1814
201661,37657A593A7A700C5ECCE5BB0AAAABA7,31931,0,13,13,109.54771,18.29403,1667
201662,37657A593A7A700C5ECCE5BB0AAAABA7,30921,13,18,5,109.53903,18.29451,1667
201663,37657A593A7A700C5ECCE5BB0AAAABA7,31931,18,19,1,109.54771,18.29403,1667
201696,D0644281647025A7A26484BC424A7256,38331,2,6,4,109.62465,18.22736,1956
201697,D0644281647025A7A26484BC424A7256,38052,9,13,4,109.62618,18.23042,1956
201698,D0644281647025A7A26484BC424A7256,31321,17,18,1,109.63799,18.23201,2007
201699,D0644281647025A7A26484BC424A7256,38052,19,22,3,109.62618,18.23042,1956
201700,87C5E55D14972DAB6DC404BB48A37840,31471,11,12,1,109.34583,18.29563,917
201701,87C5E55D14972DAB6DC404BB48A37840,60054,12,14,2,109.3016,18.31229,770
201711,664AAF94F095BCD14233E5648F0324F0,60491,7,8,1,109.43354,18.30847,1269
201717,53453D8B736810206EC5A6632D159BE6,31931,0,15,15,109.54771,18.29403,1667
201718,53453D8B736810206EC5A6632D159BE6,30921,17,18,1,109.53903,18.29451,1667
201719,53453D8B736810206EC5A6632D159BE6,31931,19,23,4,109.54771,18.29403,1667
201732,AE8680286B45D9D0276D665A2B272582,38251,0,7,7,109.49618,18.25493,1510
201733,AE8680286B45D9D0276D665A2B272582,31471,12,14,2,109.34583,18.29563,917
201734,AE8680286B45D9D0276D665A2B272582,60381,16,18,2,109.5241,18.22458,1605
201735,AE8680286B45D9D0276D665A2B272582,38251,22,23,1,109.49618,18.25493,1510
201736,9AA959ED87D1ECC3053DED17290EFCBD,30854,1,2,1,109.56889,18.27076,1763
201737,9AA959ED87D1ECC3053DED17290EFCBD,31561,4,6,2,109.56792,18.28479,1765
201738,9AA959ED87D1ECC3053DED17290EFCBD,39181,7,10,3,109.55153,18.28035,1715
201739,9AA959ED87D1ECC3053DED17290EFCBD,39183,13,15,2,109.55542,18.28208,1715
201740,9AA959ED87D1ECC3053DED17290EFCBD,31561,17,18,1,109.56792,18.28479,1765
201750,BCDE01A4E2BDFB1588B63A66AC193559,31421,0,8,8,109.55382,18.22347,1705
201751,BCDE01A4E2BDFB1588B63A66AC193559,31061,12,13,1,109.53333,18.23257,1607
201752,BCDE01A4E2BDFB1588B63A66AC193559,31561,14,16,2,109.56792,18.28479,1765
201762,058BB35E9365186FDBD53CD2B8640A1D,30731,1,6,5,109.50944,18.22306,1555
201763,058BB35E9365186FDBD53CD2B8640A1D,31521,7,8,1,109.51458,18.22542,1555
201766,7890099D98AA300C5BF12527E7372DB0,60631,0,6,6,109.57778,18.27583,1814
201767,7890099D98AA300C5BF12527E7372DB0,30854,9,11,2,109.56889,18.27076,1763
201768,7890099D98AA300C5BF12527E7372DB0,31071,12,14,2,109.58257,18.28458,1815
201769,7890099D98AA300C5BF12527E7372DB0,30854,16,17,1,109.56889,18.27076,1763
201770,7890099D98AA300C5BF12527E7372DB0,31071,18,20,2,109.58257,18.28458,1815
201771,7890099D98AA300C5BF12527E7372DB0,60631,22,23,1,109.57778,18.27583,1814
201806,D96E01B8E0F0DE9C160C9FEAFDCFDB6D,31071,1,7,6,109.58257,18.28458,1815
201807,D96E01B8E0F0DE9C160C9FEAFDCFDB6D,30854,8,18,10,109.56889,18.27076,1763
201825,3C1A2536A78CF30193CED5E3EEACBE7E,30851,0,6,6,109.5616,18.27396,1713
201826,3C1A2536A78CF30193CED5E3EEACBE7E,31561,6,8,2,109.56792,18.28479,1765
201827,3C1A2536A78CF30193CED5E3EEACBE7E,30851,12,13,1,109.5616,18.27396,1713
201828,3C1A2536A78CF30193CED5E3EEACBE7E,30854,15,17,2,109.56889,18.27076,1763
201829,3C1A2536A78CF30193CED5E3EEACBE7E,30851,19,22,3,109.5616,18.27396,1713
201866,2261FA59C58CA1DB4ED476451BEA0AD4,60501,0,18,18,109.48701,18.29021,1466
201867,2261FA59C58CA1DB4ED476451BEA0AD4,30321,19,20,1,109.49563,18.29611,1467
201918,40285EE8CCE25C38988EC087545664EC,30854,0,17,17,109.56889,18.27076,1763
201919,40285EE8CCE25C38988EC087545664EC,31071,19,20,1,109.58257,18.28458,1815
201920,40285EE8CCE25C38988EC087545664EC,30854,22,23,1,109.56889,18.27076,1763
201967,03E3094FE0344513E64DAE470C33E920,39181,0,10,10,109.55153,18.28035,1715
201968,03E3094FE0344513E64DAE470C33E920,31931,12,17,5,109.54771,18.29403,1667
201969,03E3094FE0344513E64DAE470C33E920,39181,19,23,4,109.55153,18.28035,1715
201976,00262F856825A94933CC2BDE5C3D9737,60581,0,1,1,109.59785,18.29931,1868
201977,00262F856825A94933CC2BDE5C3D9737,31421,2,3,1,109.55382,18.22347,1705
201978,00262F856825A94933CC2BDE5C3D9737,60581,4,21,17,109.59785,18.29931,1868
202032,AF32B82432A4AC8FBC8A961D5DCDD7BD,38331,1,17,16,109.62465,18.22736,1956
202033,AF32B82432A4AC8FBC8A961D5DCDD7BD,31571,20,22,2,109.61563,18.23326,1957
202034,9E8746086915F9D4A063A74CF0B5B7AB,30854,0,1,1,109.56889,18.27076,1763
202035,9E8746086915F9D4A063A74CF0B5B7AB,31561,1,21,20,109.56792,18.28479,1765
202053,95426015650BC53898B8F1908C1F7E01,38754,13,15,2,109.74667,18.37382,2430
202078,C8922FAF66F21ECAECB6B717FCD5A53B,60614,0,6,6,109.48799,18.29521,1467
202079,C8922FAF66F21ECAECB6B717FCD5A53B,60391,6,9,3,109.47667,18.28757,1416
202080,C8922FAF66F21ECAECB6B717FCD5A53B,60614,9,23,14,109.48799,18.29521,1467
202090,3FAB7316FD33FC7E819B12F3936E0C0E,31461,10,12,2,109.5091,18.25389,1510
202091,3FAB7316FD33FC7E819B12F3936E0C0E,31781,14,15,1,109.19847,18.2975,367
202092,A503639E15A0B5D04B0130D882921438,31031,0,15,15,109.49979,18.25382,1510
202093,A503639E15A0B5D04B0130D882921438,31031,16,17,1,109.49979,18.25382,1510
202094,A503639E15A0B5D04B0130D882921438,31031,17,22,5,109.49979,18.25382,1510
202124,19DF3AF20A6216C60974B8B3423BEBC6,31931,0,2,2,109.54771,18.29403,1667
202125,19DF3AF20A6216C60974B8B3423BEBC6,30921,3,4,1,109.53903,18.29451,1667
202126,19DF3AF20A6216C60974B8B3423BEBC6,31931,6,21,15,109.54771,18.29403,1667
202198,F0ED2F3817EE271ED7B659D7D4093D86,30071,0,11,11,109.52819,18.30472,1619
202215,E9E473F09C342630187345312F4A31D8,39181,0,14,14,109.55153,18.28035,1715
202216,E9E473F09C342630187345312F4A31D8,31931,15,16,1,109.54771,18.29403,1667
202217,E9E473F09C342630187345312F4A31D8,39181,16,23,7,109.55153,18.28035,1715
202220,968E09217B26E1E21B124536BDB6DBAA,31931,1,11,10,109.54771,18.29403,1667
202221,968E09217B26E1E21B124536BDB6DBAA,30921,11,12,1,109.53903,18.29451,1667
202276,6C92EA68FFD99D11BB9BA660C1C2B71D,38261,0,10,10,109.50361,18.28153,1515
202277,6C92EA68FFD99D11BB9BA660C1C2B71D,38754,12,13,1,109.74667,18.37382,2430
202278,6C92EA68FFD99D11BB9BA660C1C2B71D,39191,17,18,1,109.51493,18.23472,1557
202279,6C92EA68FFD99D11BB9BA660C1C2B71D,38171,19,20,1,109.50799,18.28139,1515
202280,6C92EA68FFD99D11BB9BA660C1C2B71D,38251,21,22,1,109.49618,18.25493,1510
202312,D8EBCB05DE029B0DEDBF9FBDF3DA3C2D,38251,10,12,2,109.49618,18.25493,1510
202313,D8EBCB05DE029B0DEDBF9FBDF3DA3C2D,60084,12,13,1,109.4984,18.2334,1507
202314,D8EBCB05DE029B0DEDBF9FBDF3DA3C2D,30211,14,16,2,109.49882,18.23931,1508
202327,ED6C06A9523B96BECA45DFE9D14D9117,31031,0,1,1,109.49979,18.25382,1510
202328,ED6C06A9523B96BECA45DFE9D14D9117,31701,2,9,7,109.44132,18.28833,1266
202329,ED6C06A9523B96BECA45DFE9D14D9117,30661,13,14,1,109.37028,18.24361,1008
202330,ED6C06A9523B96BECA45DFE9D14D9117,38754,15,17,2,109.74667,18.37382,2430
202331,ED6C06A9523B96BECA45DFE9D14D9117,38291,22,23,1,109.51618,18.24313,1558
202334,270A449E9E9FA455CDA0F1612D07A3C0,30341,0,4,4,109.3625,18.29167,966
202335,270A449E9E9FA455CDA0F1612D07A3C0,31691,7,8,1,109.36604,18.3075,1019
202336,270A449E9E9FA455CDA0F1612D07A3C0,30341,8,9,1,109.3625,18.29167,966
202337,270A449E9E9FA455CDA0F1612D07A3C0,30421,11,13,2,109.50021,18.25861,1511
202338,270A449E9E9FA455CDA0F1612D07A3C0,30421,16,17,1,109.50021,18.25861,1511
202339,270A449E9E9FA455CDA0F1612D07A3C0,60552,18,22,4,109.41729,18.30014,1218
202361,9AD8D18F2EF225E5E5CB5327E1407C0D,38951,0,7,7,109.48097,18.28868,1416
202362,9AD8D18F2EF225E5E5CB5327E1407C0D,33051,9,10,1,109.6475,18.46618,2096
202363,9AD8D18F2EF225E5E5CB5327E1407C0D,30661,14,16,2,109.37028,18.24361,1008
202364,9AD8D18F2EF225E5E5CB5327E1407C0D,38951,20,23,3,109.48097,18.28868,1416
202367,31A35D1F4FE97CCC4436EF0B61B8BAAF,60411,0,3,3,109.32514,18.30854,869
202368,31A35D1F4FE97CCC4436EF0B61B8BAAF,30511,4,8,4,109.51069,18.24208,1558
202369,31A35D1F4FE97CCC4436EF0B61B8BAAF,31121,11,14,3,109.16292,18.37063,230
202370,31A35D1F4FE97CCC4436EF0B61B8BAAF,30511,15,19,4,109.51069,18.24208,1558
202371,31A35D1F4FE97CCC4436EF0B61B8BAAF,31811,20,21,1,109.54201,18.31806,1671
202372,31A35D1F4FE97CCC4436EF0B61B8BAAF,31841,22,23,1,109.73201,18.33382,2373
202392,2AE38FAF341950B0B91404FFCE5A0F3E,31931,5,6,1,109.54771,18.29403,1667
202393,2AE38FAF341950B0B91404FFCE5A0F3E,30921,7,14,7,109.53903,18.29451,1667
202397,D6A5EA158BCFCEC27478CC8D9C57322E,30854,12,14,2,109.56889,18.27076,1763
202398,D6A5EA158BCFCEC27478CC8D9C57322E,30361,15,16,1,109.50347,18.24,1508
202399,D6A5EA158BCFCEC27478CC8D9C57322E,31671,20,21,1,109.38965,18.29813,1068
202407,39F25FE146A03325C93C111F2A943B6C,31945,0,7,7,109.58021,18.29403,1817
202408,39F25FE146A03325C93C111F2A943B6C,30854,8,17,9,109.56889,18.27076,1763
202501,7A8D78B1079C175566DB4AED32858CF3,31021,17,19,2,109.49021,18.27,1463
202505,1E36640BE395A4EE8CCB2697222419A5,39191,1,8,7,109.51493,18.23472,1557
202506,1E36640BE395A4EE8CCB2697222419A5,30854,10,18,8,109.56889,18.27076,1763
202507,1E36640BE395A4EE8CCB2697222419A5,30191,21,22,1,109.50361,18.22701,1506
202527,F59D1DD533185F561FFF6EDE7E603AAA,30561,0,14,14,109.52778,18.31938,1621
202528,F59D1DD533185F561FFF6EDE7E603AAA,30071,15,18,3,109.52819,18.30472,1619
202529,F59D1DD533185F561FFF6EDE7E603AAA,30561,18,23,5,109.52778,18.31938,1621
202532,3DCAC27BD35B2FC8704C8768B6D049BB,60201,12,15,3,109.5041,18.2509,1510
202612,8CD15CF6B5FB4821940FF9AFE6D6CB84,30071,0,5,5,109.52819,18.30472,1619
202613,8CD15CF6B5FB4821940FF9AFE6D6CB84,31931,9,11,2,109.54771,18.29403,1667
202620,7E28863E3E4D0101A7DD8A6B64D39C6D,60463,15,17,2,109.52507,18.22438,1605
202621,7E28863E3E4D0101A7DD8A6B64D39C6D,31041,19,20,1,109.50278,18.23701,1507
202631,DFEFB1CD7965FB8E2BDF1B532ED92233,30921,0,7,7,109.53903,18.29451,1667
202632,DFEFB1CD7965FB8E2BDF1B532ED92233,31561,8,15,7,109.56792,18.28479,1765
202633,DFEFB1CD7965FB8E2BDF1B532ED92233,30921,16,23,7,109.53903,18.29451,1667
202656,10E6DCB22C04D9E1B01193CDA87B3193,39183,12,13,1,109.55542,18.28208,1715
202657,10E6DCB22C04D9E1B01193CDA87B3193,30721,15,23,8,109.51597,18.28257,1565
202730,82F21893ACB53C60BC226BBEC5F58D74,38185,0,7,7,109.51333,18.27347,1563
202731,82F21893ACB53C60BC226BBEC5F58D74,38157,7,9,2,109.51483,18.26958,1563
202732,82F21893ACB53C60BC226BBEC5F58D74,38754,12,15,3,109.74667,18.37382,2430
202733,82F21893ACB53C60BC226BBEC5F58D74,30421,16,18,2,109.50021,18.25861,1511
202734,82F21893ACB53C60BC226BBEC5F58D74,38157,18,23,5,109.51483,18.26958,1563
202796,301E657A2E52A15D5305B0C9B3D5B8BC,30921,0,8,8,109.53903,18.29451,1667
202797,301E657A2E52A15D5305B0C9B3D5B8BC,31931,12,14,2,109.54771,18.29403,1667
202813,03CEC0FDDD5484124514C6D24A63D4DD,31561,1,8,7,109.56792,18.28479,1765
202814,03CEC0FDDD5484124514C6D24A63D4DD,39183,10,12,2,109.55542,18.28208,1715
202817,5C5C16E98C1163D699B17F68D2A1C502,30941,0,8,8,109.5559,18.33938,1724
202818,5C5C16E98C1163D699B17F68D2A1C502,30051,11,13,2,109.48917,18.21215,1453
202819,5C5C16E98C1163D699B17F68D2A1C502,60291,14,15,1,109.50826,18.24639,1509
202820,5C5C16E98C1163D699B17F68D2A1C502,30711,18,23,5,109.50271,18.25347,1510
202824,5106C265E7997749AD66854B6E7AAB9E,60401,0,1,1,109.47444,18.27583,1414
202825,5106C265E7997749AD66854B6E7AAB9E,60161,2,8,6,109.49174,18.26181,1461
202826,5106C265E7997749AD66854B6E7AAB9E,60131,9,11,2,109.49819,18.24778,1509
202845,102A3C1C3179D6FF6A52B59C3B4087A1,31391,0,8,8,109.50382,18.24285,1508
202846,102A3C1C3179D6FF6A52B59C3B4087A1,31181,9,23,14,109.50382,18.24813,1509
202896,6A4AE6B8374B8D13D516D5D8F4C03ACD,31261,0,7,7,109.51174,18.2466,1559
202912,26AEADD88C2136C19E538838866C5D29,60501,0,21,21,109.48701,18.29021,1466
202913,26AEADD88C2136C19E538838866C5D29,38951,22,23,1,109.48097,18.28868,1416
202917,FEAE9163841AC1AA2EA5C6B7C414FE65,39091,0,7,7,109.50097,18.25222,1510
202918,FEAE9163841AC1AA2EA5C6B7C414FE65,31171,7,9,2,109.50938,18.24917,1559
202919,FEAE9163841AC1AA2EA5C6B7C414FE65,31171,9,11,2,109.50938,18.24917,1559
202920,FEAE9163841AC1AA2EA5C6B7C414FE65,31521,14,15,1,109.51458,18.22542,1555
202921,FEAE9163841AC1AA2EA5C6B7C414FE65,31031,16,17,1,109.49979,18.25382,1510
202922,FEAE9163841AC1AA2EA5C6B7C414FE65,60571,17,19,2,109.50722,18.25056,1510
202923,FEAE9163841AC1AA2EA5C6B7C414FE65,31031,20,21,1,109.49979,18.25382,1510
202953,14F1CC63CDA098F9694EAC8584B9C7A5,30854,8,10,2,109.56889,18.27076,1763
202954,14F1CC63CDA098F9694EAC8584B9C7A5,31561,13,16,3,109.56792,18.28479,1765
202985,A6714C443816C19D990E7A07DCADADAD,60371,0,10,10,109.53063,18.30056,1618
202986,A6714C443816C19D990E7A07DCADADAD,30911,12,13,1,109.50493,18.26181,1511
202987,A6714C443816C19D990E7A07DCADADAD,31781,15,18,3,109.19847,18.2975,367
202988,A6714C443816C19D990E7A07DCADADAD,38154,19,21,2,109.5266,18.28278,1615
203063,8F38E05146537B1A75A31B873BB68479,30891,0,4,4,109.59431,18.28389,1865
203064,8F38E05146537B1A75A31B873BB68479,60631,4,7,3,109.57778,18.27583,1814
203065,8F38E05146537B1A75A31B873BB68479,30591,11,12,1,109.63021,18.3334,2023
203066,8F38E05146537B1A75A31B873BB68479,30891,13,15,2,109.59431,18.28389,1865
203067,8F38E05146537B1A75A31B873BB68479,60631,20,23,3,109.57778,18.27583,1814
203181,4F1F2C63B1D8098AD9ABA50013979078,31461,3,18,15,109.5091,18.25389,1510
203182,4F1F2C63B1D8098AD9ABA50013979078,30151,19,22,3,109.50986,18.25083,1560
203192,EE14FB3C39B357FEEB92988D3DA74974,60331,0,1,1,109.505,18.26507,1512
203193,EE14FB3C39B357FEEB92988D3DA74974,38826,2,4,2,109.50326,18.25514,1510
203194,EE14FB3C39B357FEEB92988D3DA74974,60331,4,7,3,109.505,18.26507,1512
203195,EE14FB3C39B357FEEB92988D3DA74974,30711,7,9,2,109.50271,18.25347,1510
203196,EE14FB3C39B357FEEB92988D3DA74974,60331,10,11,1,109.505,18.26507,1512
203197,EE14FB3C39B357FEEB92988D3DA74974,60291,12,13,1,109.50826,18.24639,1509
203198,EE14FB3C39B357FEEB92988D3DA74974,38017,14,23,9,109.49729,18.21424,1504
203204,30165500CA5F6A8CB10812947A58AC25,60131,17,23,6,109.49819,18.24778,1509
203265,71D35ED12FD809FD321ED1C8285B5582,38951,19,20,1,109.48097,18.28868,1416
203266,71D35ED12FD809FD321ED1C8285B5582,38951,20,23,3,109.48097,18.28868,1416
203326,E6F79A5F6F7C034FE4F98780B21D590B,30281,16,23,7,109.50597,18.27583,1514
203343,D8AD821A5FC20BAF011DEF41BC24FC46,30661,0,2,2,109.37028,18.24361,1008
203344,D8AD821A5FC20BAF011DEF41BC24FC46,60411,2,5,3,109.32514,18.30854,869
203345,D8AD821A5FC20BAF011DEF41BC24FC46,31471,5,7,2,109.34583,18.29563,917
203346,D8AD821A5FC20BAF011DEF41BC24FC46,60411,12,14,2,109.32514,18.30854,869
203347,D8AD821A5FC20BAF011DEF41BC24FC46,31471,16,18,2,109.34583,18.29563,917
203348,D8AD821A5FC20BAF011DEF41BC24FC46,60411,21,23,2,109.32514,18.30854,869
203379,23019CE071DC0B0CEC6E78ADA422CE57,31861,0,5,5,109.49042,18.27549,1464
203380,23019CE071DC0B0CEC6E78ADA422CE57,60261,6,7,1,109.44326,18.3075,1319
203381,23019CE071DC0B0CEC6E78ADA422CE57,39151,11,12,1,109.49875,18.25097,1510
203382,23019CE071DC0B0CEC6E78ADA422CE57,31861,13,16,3,109.49042,18.27549,1464
203383,23019CE071DC0B0CEC6E78ADA422CE57,60291,17,20,3,109.50826,18.24639,1509
203384,23019CE071DC0B0CEC6E78ADA422CE57,30151,22,23,1,109.50986,18.25083,1560
203387,A51C0E173E848AB55C983CAEC8E3EC6F,31781,14,16,2,109.19847,18.2975,367
203388,A51C0E173E848AB55C983CAEC8E3EC6F,30421,20,23,3,109.50021,18.25861,1511
203404,C17A8098B013F904BD9DA05D90234A30,30581,13,18,5,109.62257,18.24951,1959
203405,C17A8098B013F904BD9DA05D90234A30,30731,22,23,1,109.50944,18.22306,1555
203424,5FFBB1AD7CFFD00A6727DD7B087830E2,31071,1,3,2,109.58257,18.28458,1815
203425,5FFBB1AD7CFFD00A6727DD7B087830E2,31561,5,6,1,109.56792,18.28479,1765
203426,5FFBB1AD7CFFD00A6727DD7B087830E2,30851,6,11,5,109.5616,18.27396,1713
203427,5FFBB1AD7CFFD00A6727DD7B087830E2,30324,13,15,2,109.50326,18.29257,1517
203430,591FE6773219F44C74B8131639493332,31571,8,10,2,109.61563,18.23326,1957
203431,591FE6773219F44C74B8131639493332,60594,11,17,6,109.62694,18.22799,1956
203432,FCFB14BA36BDB7CD6A39612B9AE933B2,38127,0,7,7,109.50833,18.27222,1513
203433,FCFB14BA36BDB7CD6A39612B9AE933B2,39181,7,8,1,109.55153,18.28035,1715
203434,FCFB14BA36BDB7CD6A39612B9AE933B2,31931,9,16,7,109.54771,18.29403,1667
203435,FCFB14BA36BDB7CD6A39612B9AE933B2,38127,19,23,4,109.50833,18.27222,1513
203436,DE91F768E6CCDB78867FF54F078574C9,30854,8,9,1,109.56889,18.27076,1763
203437,DE91F768E6CCDB78867FF54F078574C9,60631,9,11,2,109.57778,18.27583,1814
203438,DE91F768E6CCDB78867FF54F078574C9,30854,15,18,3,109.56889,18.27076,1763
203445,44FFDAD9EC2A7281B5299E15C5B9AD3B,31471,13,14,1,109.34583,18.29563,917
203446,44FFDAD9EC2A7281B5299E15C5B9AD3B,60381,17,18,1,109.5241,18.22458,1605
203447,DE53B37CEE1651DC363C1A8BF5282EDE,31081,0,6,6,109.44639,18.30181,1318
203448,DE53B37CEE1651DC363C1A8BF5282EDE,31781,8,9,1,109.19847,18.2975,367
203449,DE53B37CEE1651DC363C1A8BF5282EDE,31471,12,14,2,109.34583,18.29563,917
203463,C0CA4E58B15F58D7F48B8BEF10CEB35A,30851,1,8,7,109.5616,18.27396,1713
203464,C0CA4E58B15F58D7F48B8BEF10CEB35A,60591,12,13,1,109.61118,18.21715,1904
203474,A94AF470D3EAB89524069477242B4D22,31021,17,19,2,109.49021,18.27,1463
203475,A94AF470D3EAB89524069477242B4D22,31701,20,23,3,109.44132,18.28833,1266
203490,E7DB0F55EDE33BB4C08C98B80B7173BF,60371,0,7,7,109.53063,18.30056,1618
203491,E7DB0F55EDE33BB4C08C98B80B7173BF,30921,7,9,2,109.53903,18.29451,1667
203492,E7DB0F55EDE33BB4C08C98B80B7173BF,30421,11,12,1,109.50021,18.25861,1511
203493,E7DB0F55EDE33BB4C08C98B80B7173BF,60371,13,16,3,109.53063,18.30056,1618
203494,E7DB0F55EDE33BB4C08C98B80B7173BF,31864,17,20,3,109.49014,18.28333,1465
203501,7BF65E5054DA81A230AB5423620158E1,60631,0,7,7,109.57778,18.27583,1814
203502,7BF65E5054DA81A230AB5423620158E1,30854,8,19,11,109.56889,18.27076,1763
203581,E6651E3C6D8FEA2077D9EFC6D097D06C,31864,18,20,2,109.49014,18.28333,1465
203582,E6651E3C6D8FEA2077D9EFC6D097D06C,38251,21,23,2,109.49618,18.25493,1510
203639,AAC7E9546787DDB508C41969C1E453E7,38157,18,19,1,109.51483,18.26958,1563
203640,AAC7E9546787DDB508C41969C1E453E7,38881,20,21,1,109.51618,18.26431,1562
203648,4053323049FA57896819CD5356E38746,31071,1,4,3,109.58257,18.28458,1815
203649,4053323049FA57896819CD5356E38746,30854,5,23,18,109.56889,18.27076,1763
203661,A46BA306DAEA889FAC7ACE9E5FD6A1FF,30081,0,10,10,109.50243,18.26632,1512
203662,A46BA306DAEA889FAC7ACE9E5FD6A1FF,30511,10,12,2,109.51069,18.24208,1558
203663,A46BA306DAEA889FAC7ACE9E5FD6A1FF,60291,12,14,2,109.50826,18.24639,1509
203664,A46BA306DAEA889FAC7ACE9E5FD6A1FF,30911,15,18,3,109.50493,18.26181,1511
203676,B84B247FA61A8C12DFCCCF3C2D72006D,31071,0,7,7,109.58257,18.28458,1815
203677,B84B247FA61A8C12DFCCCF3C2D72006D,31071,12,13,1,109.58257,18.28458,1815
203678,B84B247FA61A8C12DFCCCF3C2D72006D,30854,15,17,2,109.56889,18.27076,1763
203690,C6C3BC01E542B810EF853FEEB6C81198,31391,6,7,1,109.50382,18.24285,1508
203691,C6C3BC01E542B810EF853FEEB6C81198,60361,8,9,1,109.51938,18.29681,1567
203692,C6C3BC01E542B810EF853FEEB6C81198,60221,10,14,4,109.52569,18.29188,1616
203693,C6C3BC01E542B810EF853FEEB6C81198,60274,15,17,2,109.514,18.2933,1567
203723,6C0260646767B781577B5B8CE2471E51,60361,3,5,2,109.51938,18.29681,1567
203724,6C0260646767B781577B5B8CE2471E51,38484,9,10,1,109.53028,18.31528,1620
203725,6C0260646767B781577B5B8CE2471E51,30561,11,12,1,109.52778,18.31938,1621
203726,6C0260646767B781577B5B8CE2471E51,38484,13,23,10,109.53028,18.31528,1620
203750,895819ED5A8DD11C7D2D0F75F1A32EF3,30854,0,17,17,109.56889,18.27076,1763
203751,895819ED5A8DD11C7D2D0F75F1A32EF3,30232,17,21,4,109.6191,18.31701,1971
203752,895819ED5A8DD11C7D2D0F75F1A32EF3,30854,22,23,1,109.56889,18.27076,1763
203756,39D4F14340B4650E084697607335F122,30161,0,11,11,109.50042,18.24389,1508
203757,39D4F14340B4650E084697607335F122,30161,12,15,3,109.50042,18.24389,1508
203758,39D4F14340B4650E084697607335F122,31031,19,23,4,109.49979,18.25382,1510
203790,D212E372ACDD591706F32A616297B314,30854,0,8,8,109.56889,18.27076,1763
203791,D212E372ACDD591706F32A616297B314,39371,9,10,1,109.56627,18.2646,1762
203792,D212E372ACDD591706F32A616297B314,30891,13,14,1,109.59431,18.28389,1865
203799,5257BB62833F353E4A854C5B6B0C57D3,60614,12,14,2,109.48799,18.29521,1467
203800,5257BB62833F353E4A854C5B6B0C57D3,60221,15,17,2,109.52569,18.29188,1616
203815,F141782F156A0C79026F316BE530CBC2,31471,14,16,2,109.34583,18.29563,917
203816,F141782F156A0C79026F316BE530CBC2,38951,18,23,5,109.48097,18.28868,1416
203861,CFFDD1BF3134B9FDD71614F40E1DE0FD,31561,1,3,2,109.56792,18.28479,1765
203862,CFFDD1BF3134B9FDD71614F40E1DE0FD,31071,4,21,17,109.58257,18.28458,1815
203916,E9F21C024419BD4EFA39BBB9E3204A71,31864,0,10,10,109.49014,18.28333,1465
203917,E9F21C024419BD4EFA39BBB9E3204A71,31701,11,14,3,109.44132,18.28833,1266
203918,E9F21C024419BD4EFA39BBB9E3204A71,31781,14,17,3,109.19847,18.2975,367
203919,E9F21C024419BD4EFA39BBB9E3204A71,31701,18,21,3,109.44132,18.28833,1266
203932,FD8E83DD7FF39A687AC2462EEEA479A1,30051,11,16,5,109.48917,18.21215,1453
203982,29B6F28DC818DD1AE018C5F359E62A49,39111,0,7,7,109.5191,18.22597,1555
203983,29B6F28DC818DD1AE018C5F359E62A49,31521,9,11,2,109.51458,18.22542,1555
203984,29B6F28DC818DD1AE018C5F359E62A49,31521,12,19,7,109.51458,18.22542,1555
203985,29B6F28DC818DD1AE018C5F359E62A49,31521,19,20,1,109.51458,18.22542,1555
203986,29B6F28DC818DD1AE018C5F359E62A49,60381,21,23,2,109.5241,18.22458,1605
203997,5A6C2C4A9B4DF43C379FCADC2CCFC5BC,30201,0,7,7,109.4909,18.26465,1462
203998,5A6C2C4A9B4DF43C379FCADC2CCFC5BC,38283,8,13,5,109.62229,18.22618,1956
203999,5A6C2C4A9B4DF43C379FCADC2CCFC5BC,31571,13,15,2,109.61563,18.23326,1957
204000,5A6C2C4A9B4DF43C379FCADC2CCFC5BC,30201,19,20,1,109.4909,18.26465,1462
204001,5A6C2C4A9B4DF43C379FCADC2CCFC5BC,60161,21,23,2,109.49174,18.26181,1461
204002,FC8552628F8A5A5219C1C30314657039,60661,0,8,8,109.548,18.2377,1657
204003,FC8552628F8A5A5219C1C30314657039,60084,12,13,1,109.4984,18.2334,1507
204004,FC8552628F8A5A5219C1C30314657039,30771,16,18,2,109.49938,18.26042,1511
204005,FC8552628F8A5A5219C1C30314657039,60661,20,23,3,109.548,18.2377,1657
204039,E8BAAF476E8FE57075BAB1A8D4FF1780,30232,0,3,3,109.6191,18.31701,1971
204040,E8BAAF476E8FE57075BAB1A8D4FF1780,39371,4,19,15,109.56627,18.2646,1762
204041,E8BAAF476E8FE57075BAB1A8D4FF1780,30232,22,23,1,109.6191,18.31701,1971
204063,30CE72A519D49881F23B8123486E3A02,30661,2,3,1,109.37028,18.24361,1008
204064,30CE72A519D49881F23B8123486E3A02,60054,4,6,2,109.3016,18.31229,770
204065,30CE72A519D49881F23B8123486E3A02,30661,8,9,1,109.37028,18.24361,1008
204066,30CE72A519D49881F23B8123486E3A02,31471,10,12,2,109.34583,18.29563,917
204067,30CE72A519D49881F23B8123486E3A02,60411,12,16,4,109.32514,18.30854,869
204100,64FF3E93355E6DCA29977E04D316EABA,31461,0,8,8,109.5091,18.25389,1510
204101,64FF3E93355E6DCA29977E04D316EABA,31171,9,12,3,109.50938,18.24917,1559
204102,64FF3E93355E6DCA29977E04D316EABA,60311,13,15,2,109.52097,18.24319,1558
204103,64FF3E93355E6DCA29977E04D316EABA,60381,18,20,2,109.5241,18.22458,1605
204104,64FF3E93355E6DCA29977E04D316EABA,30191,21,23,2,109.50361,18.22701,1506
204110,C8BA90B71F14C638D3BB67D8000591A9,60381,21,22,1,109.5241,18.22458,1605
204111,C8BA90B71F14C638D3BB67D8000591A9,31521,22,23,1,109.51458,18.22542,1555
204116,9A1D1AA5EE2CD156CC396C667ED8C5B9,31071,0,4,4,109.58257,18.28458,1815
204117,9A1D1AA5EE2CD156CC396C667ED8C5B9,30854,4,6,2,109.56889,18.27076,1763
204118,9A1D1AA5EE2CD156CC396C667ED8C5B9,31071,8,9,1,109.58257,18.28458,1815
204119,9A1D1AA5EE2CD156CC396C667ED8C5B9,30854,16,17,1,109.56889,18.27076,1763
204120,9A1D1AA5EE2CD156CC396C667ED8C5B9,30191,20,22,2,109.50361,18.22701,1506
204193,10BCCD747640470AAA03DB965CE24293,30291,0,7,7,109.50403,18.27028,1513
204194,10BCCD747640470AAA03DB965CE24293,31261,9,10,1,109.51174,18.2466,1559
204196,798BF3B08F72A16A6DEAAA235F1899BB,61011,2,10,8,109.60653,18.19076,1900
204255,4CDEF469091C8CEDD8E49BC000B05A1D,60491,0,15,15,109.43354,18.30847,1269
204256,4CDEF469091C8CEDD8E49BC000B05A1D,60381,19,20,1,109.5241,18.22458,1605
204284,8FEFA204EA7EEB362556D906D163980A,31071,14,16,2,109.58257,18.28458,1815
204285,8FEFA204EA7EEB362556D906D163980A,30854,19,20,1,109.56889,18.27076,1763
204335,7E2EA58FE60AC1C253C1CC188337CCC8,60541,2,11,9,109.4084,18.29208,1167
204336,7E2EA58FE60AC1C253C1CC188337CCC8,39041,16,18,2,109.40021,18.29278,1117
204337,7E2EA58FE60AC1C253C1CC188337CCC8,60463,20,21,1,109.52507,18.22438,1605
204371,A1F17EB69AE1223ABE34664A234EFB68,38111,13,16,3,109.52007,18.22403,1555
204372,A1F17EB69AE1223ABE34664A234EFB68,38111,16,18,2,109.52007,18.22403,1555
204373,A1F17EB69AE1223ABE34664A234EFB68,38111,21,23,2,109.52007,18.22403,1555
204402,BC9FBD966A235C9E8690F2D93EAA6882,31521,13,14,1,109.51458,18.22542,1555
204403,BC9FBD966A235C9E8690F2D93EAA6882,60381,15,16,1,109.5241,18.22458,1605
204404,BC9FBD966A235C9E8690F2D93EAA6882,38111,21,23,2,109.52007,18.22403,1555
204437,6751CEC3CF9B2AE78246C7287443D2B4,31071,0,6,6,109.58257,18.28458,1815
204438,6751CEC3CF9B2AE78246C7287443D2B4,30854,8,19,11,109.56889,18.27076,1763
204439,6751CEC3CF9B2AE78246C7287443D2B4,31945,20,21,1,109.58021,18.29403,1817
204450,C2B7B3A3FAB31B432C169B25FFB0A1F6,60354,0,7,7,109.58701,18.28521,1815
204451,C2B7B3A3FAB31B432C169B25FFB0A1F6,31945,8,18,10,109.58021,18.29403,1817
204452,C2B7B3A3FAB31B432C169B25FFB0A1F6,30854,22,23,1,109.56889,18.27076,1763
204453,942FD8205298EEBE7ED108DC820DF6A5,31521,13,16,3,109.51458,18.22542,1555
204454,942FD8205298EEBE7ED108DC820DF6A5,30361,17,19,2,109.50347,18.24,1508
204455,942FD8205298EEBE7ED108DC820DF6A5,31521,20,23,3,109.51458,18.22542,1555
204456,1B6EBBFF3B9D8A3E18753343B6A29EAE,31071,0,6,6,109.58257,18.28458,1815
204457,1B6EBBFF3B9D8A3E18753343B6A29EAE,30851,10,11,1,109.5616,18.27396,1713
204458,1B6EBBFF3B9D8A3E18753343B6A29EAE,31071,11,23,12,109.58257,18.28458,1815
204471,02C53C5746E38501957FE72E2C83CCA4,38251,11,16,5,109.49618,18.25493,1510
204472,02C53C5746E38501957FE72E2C83CCA4,31251,17,19,2,109.18528,18.2975,317
204473,EC89B2FFE00F967E6D0A3B697A6D636D,31071,0,8,8,109.58257,18.28458,1815
204474,EC89B2FFE00F967E6D0A3B697A6D636D,30854,9,15,6,109.56889,18.27076,1763
204475,EC89B2FFE00F967E6D0A3B697A6D636D,31071,18,22,4,109.58257,18.28458,1815
204515,664E81D16FEEE8383C260AACBBA56CD3,38541,0,15,15,109.73715,18.34875,2426
204516,664E81D16FEEE8383C260AACBBA56CD3,60344,17,20,3,109.68847,18.31931,2221
204522,6E797C1848A21F63AB5DC14D455CFF22,31431,0,8,8,109.44639,18.29042,1316
204523,6E797C1848A21F63AB5DC14D455CFF22,30271,8,9,1,109.49132,18.23153,1456
204524,6E797C1848A21F63AB5DC14D455CFF22,31781,11,13,2,109.19847,18.2975,367
204525,6E797C1848A21F63AB5DC14D455CFF22,31431,18,23,5,109.44639,18.29042,1316
204541,4D4289AE0DFBF4B5C79A47559DC2EBDD,60463,19,20,1,109.52507,18.22438,1605
204542,4D4289AE0DFBF4B5C79A47559DC2EBDD,30854,22,23,1,109.56889,18.27076,1763
204551,68DBE0B52FD0AB95F1DD47068FD7847F,30181,20,21,1,109.51597,18.23313,1557
204552,68DBE0B52FD0AB95F1DD47068FD7847F,60311,21,23,2,109.52097,18.24319,1558
204603,7A9EDF4DC03F94839B13F40FCA0FD567,60661,0,10,10,109.548,18.2377,1657
204604,7A9EDF4DC03F94839B13F40FCA0FD567,30391,12,15,3,109.4975,18.27118,1513
204605,7A9EDF4DC03F94839B13F40FCA0FD567,30421,18,19,1,109.50021,18.25861,1511
204606,7A9EDF4DC03F94839B13F40FCA0FD567,60661,20,23,3,109.548,18.2377,1657
204612,22CF7007721E0F1D863F25E4633BE1AD,60311,0,8,8,109.52097,18.24319,1558
204613,22CF7007721E0F1D863F25E4633BE1AD,39154,12,14,2,109.50201,18.25681,1511
204614,22CF7007721E0F1D863F25E4633BE1AD,30084,14,15,1,109.50118,18.26972,1513
204615,22CF7007721E0F1D863F25E4633BE1AD,60311,16,23,7,109.52097,18.24319,1558
204616,F0F4014EDBA84B976E9E99C8872ACAC4,31561,7,13,6,109.56792,18.28479,1765
204617,F0F4014EDBA84B976E9E99C8872ACAC4,30854,13,15,2,109.56889,18.27076,1763
204618,F0F4014EDBA84B976E9E99C8872ACAC4,31561,15,18,3,109.56792,18.28479,1765
204619,F0F4014EDBA84B976E9E99C8872ACAC4,60331,19,23,4,109.505,18.26507,1512
204652,E58E5EFF0A1D7ADABE8F5BBEE665ED0D,60381,0,1,1,109.5241,18.22458,1605
204653,E58E5EFF0A1D7ADABE8F5BBEE665ED0D,39321,4,10,6,109.529,18.2167,1604
204654,E58E5EFF0A1D7ADABE8F5BBEE665ED0D,30861,13,17,4,109.52722,18.22743,1606
204655,E58E5EFF0A1D7ADABE8F5BBEE665ED0D,30861,19,22,3,109.52722,18.22743,1606
204667,DECB7B3FC95BFA8620EFD8D9DE328252,30854,2,4,2,109.56889,18.27076,1763
204668,DECB7B3FC95BFA8620EFD8D9DE328252,30791,7,9,2,109.72333,18.40889,2386
204669,DECB7B3FC95BFA8620EFD8D9DE328252,60661,12,13,1,109.548,18.2377,1657
204670,DECB7B3FC95BFA8620EFD8D9DE328252,30854,14,17,3,109.56889,18.27076,1763
204697,172CB232BBE684655CFBDFD055BB1CB5,60491,0,7,7,109.43354,18.30847,1269
204698,172CB232BBE684655CFBDFD055BB1CB5,31031,8,9,1,109.49979,18.25382,1510
204699,172CB232BBE684655CFBDFD055BB1CB5,60491,12,13,1,109.43354,18.30847,1269
204700,172CB232BBE684655CFBDFD055BB1CB5,30831,14,16,2,109.69813,18.32076,2271
204701,172CB232BBE684655CFBDFD055BB1CB5,60491,20,23,3,109.43354,18.30847,1269
204707,C7B596C3998F49DC6B86FB54AB7111B3,31071,0,6,6,109.58257,18.28458,1815
204708,C7B596C3998F49DC6B86FB54AB7111B3,30706,6,8,2,109.58833,18.31125,1820
204709,C7B596C3998F49DC6B86FB54AB7111B3,31071,11,13,2,109.58257,18.28458,1815
204710,C7B596C3998F49DC6B86FB54AB7111B3,30706,14,17,3,109.58833,18.31125,1820
204711,C7B596C3998F49DC6B86FB54AB7111B3,31071,19,23,4,109.58257,18.28458,1815
204712,33048F4905708D565A25CD4E82BC6E99,30711,0,9,9,109.50271,18.25347,1510
204713,33048F4905708D565A25CD4E82BC6E99,60381,12,13,1,109.5241,18.22458,1605
204714,33048F4905708D565A25CD4E82BC6E99,30711,13,16,3,109.50271,18.25347,1510
204715,33048F4905708D565A25CD4E82BC6E99,30711,17,18,1,109.50271,18.25347,1510
204716,33048F4905708D565A25CD4E82BC6E99,30421,20,22,2,109.50021,18.25861,1511
204720,05A6C1DED7CE090E72BB3736D69758C5,60631,0,6,6,109.57778,18.27583,1814
204721,05A6C1DED7CE090E72BB3736D69758C5,30854,6,11,5,109.56889,18.27076,1763
204722,05A6C1DED7CE090E72BB3736D69758C5,31071,14,15,1,109.58257,18.28458,1815
204723,05A6C1DED7CE090E72BB3736D69758C5,30851,18,19,1,109.5616,18.27396,1713
204772,019CCF25DBCE9B21B5D2698F82FCE788,30854,7,8,1,109.56889,18.27076,1763
204773,019CCF25DBCE9B21B5D2698F82FCE788,30234,12,13,1,109.60681,18.29979,1918
204774,019CCF25DBCE9B21B5D2698F82FCE788,60281,18,19,1,109.51743,18.25924,1561
204775,019CCF25DBCE9B21B5D2698F82FCE788,30854,22,23,1,109.56889,18.27076,1763
204779,5D5B29A994BBA3635D38463A75BE58F6,30171,14,18,4,109.48458,18.27139,1463
204780,5D5B29A994BBA3635D38463A75BE58F6,38826,19,20,1,109.50326,18.25514,1510
204788,14BFE46EEAB2E234698393270A62605D,31471,0,5,5,109.34583,18.29563,917
204789,14BFE46EEAB2E234698393270A62605D,30661,6,10,4,109.37028,18.24361,1008
204790,14BFE46EEAB2E234698393270A62605D,60411,11,12,1,109.32514,18.30854,869
204791,14BFE46EEAB2E234698393270A62605D,30661,14,20,6,109.37028,18.24361,1008
204821,222E0B6922623CE9FBB280F81068D40E,30281,0,1,1,109.50597,18.27583,1514
204822,222E0B6922623CE9FBB280F81068D40E,30121,1,6,5,109.52861,18.27222,1613
204823,222E0B6922623CE9FBB280F81068D40E,30854,7,13,6,109.56889,18.27076,1763
204880,F3A1E5EFCE6AF399DB0F684A07A854DA,31071,0,13,13,109.58257,18.28458,1815
204881,F3A1E5EFCE6AF399DB0F684A07A854DA,39091,16,19,3,109.50097,18.25222,1510
204882,F3A1E5EFCE6AF399DB0F684A07A854DA,31071,20,21,1,109.58257,18.28458,1815
204903,7C68E1F4B8B2F3CBBD5427BF66BF9C2E,30581,11,12,1,109.62257,18.24951,1959
204904,7C68E1F4B8B2F3CBBD5427BF66BF9C2E,60591,15,16,1,109.61118,18.21715,1904
204935,15195C578D4A8081B069C4B518039EFC,60161,2,4,2,109.49174,18.26181,1461
204936,15195C578D4A8081B069C4B518039EFC,60501,8,11,3,109.48701,18.29021,1466
204951,212EA0454AC4BCC194B0282F93607BB4,30741,7,8,1,109.49833,18.28681,1516
204952,212EA0454AC4BCC194B0282F93607BB4,31471,11,12,1,109.34583,18.29563,917
204953,212EA0454AC4BCC194B0282F93607BB4,30581,14,15,1,109.62257,18.24951,1959
204976,7F6E66BC10419161F6457A6D79258EDB,60401,8,9,1,109.47444,18.27583,1414
204977,7F6E66BC10419161F6457A6D79258EDB,38251,12,14,2,109.49618,18.25493,1510
204978,7F6E66BC10419161F6457A6D79258EDB,30531,14,16,2,109.53271,18.21472,1604
204982,95E4224EFEFA1EA72F67A01D68EC939D,38541,0,9,9,109.73715,18.34875,2426
204983,95E4224EFEFA1EA72F67A01D68EC939D,38751,13,15,2,109.74903,18.37639,2481
204984,95E4224EFEFA1EA72F67A01D68EC939D,38541,16,18,2,109.73715,18.34875,2426
204985,95E4224EFEFA1EA72F67A01D68EC939D,60131,20,22,2,109.49819,18.24778,1509
204986,AAD6CC23C5CDBF026C42805D3EA95680,31231,0,5,5,109.42597,18.29292,1217
204987,AAD6CC23C5CDBF026C42805D3EA95680,30151,9,12,3,109.50986,18.25083,1560
204988,AAD6CC23C5CDBF026C42805D3EA95680,60552,14,22,8,109.41729,18.30014,1218
204989,3E314B350F6DFD63303B103E9B7D6941,30731,0,10,10,109.50944,18.22306,1555
204990,3E314B350F6DFD63303B103E9B7D6941,60381,10,11,1,109.5241,18.22458,1605
204991,3E314B350F6DFD63303B103E9B7D6941,38111,16,17,1,109.52007,18.22403,1555
204992,3E314B350F6DFD63303B103E9B7D6941,31521,19,22,3,109.51458,18.22542,1555
204996,ADF0A7CED2B8DFD757D8FCA8B507C37E,31321,10,12,2,109.63799,18.23201,2007
204997,ADF0A7CED2B8DFD757D8FCA8B507C37E,38271,12,13,1,109.62632,18.23049,1956
204998,ADF0A7CED2B8DFD757D8FCA8B507C37E,38283,15,17,2,109.62229,18.22618,1956
204999,ADF0A7CED2B8DFD757D8FCA8B507C37E,39371,21,22,1,109.56627,18.2646,1762
205009,080247CC19405F981D4BEFE1A1E9D339,31931,0,17,17,109.54771,18.29403,1667
205010,080247CC19405F981D4BEFE1A1E9D339,39181,22,23,1,109.55153,18.28035,1715
205026,1B64F4DC850DA18B432360F1D2319D7A,31061,0,7,7,109.53333,18.23257,1607
205027,1B64F4DC850DA18B432360F1D2319D7A,60381,8,9,1,109.5241,18.22458,1605
205028,1B64F4DC850DA18B432360F1D2319D7A,31781,11,13,2,109.19847,18.2975,367
205029,1B64F4DC850DA18B432360F1D2319D7A,60081,17,18,1,109.51097,18.22639,1556
205030,1B64F4DC850DA18B432360F1D2319D7A,31061,21,23,2,109.53333,18.23257,1607
205053,E008ACF509F77C075F3CE6807181F555,30661,13,15,2,109.37028,18.24361,1008
205054,E008ACF509F77C075F3CE6807181F555,30201,20,21,1,109.4909,18.26465,1462
205067,F9F80EDABF5B8107FB24FA24BEE7566E,60201,3,5,2,109.5041,18.2509,1510
205068,F9F80EDABF5B8107FB24FA24BEE7566E,38251,7,8,1,109.49618,18.25493,1510
205069,F9F80EDABF5B8107FB24FA24BEE7566E,31781,10,13,3,109.19847,18.2975,367
205108,E6EF54F1CF70515EF78AA8E68729F281,60614,14,15,1,109.48799,18.29521,1467
205113,F568EAB7DFDD5D41E19A6F375B979656,60361,17,20,3,109.51938,18.29681,1567
205114,F568EAB7DFDD5D41E19A6F375B979656,31861,22,23,1,109.49042,18.27549,1464
205117,B023927CBEC0A8053CBDF64A5B76E367,38017,18,19,1,109.49729,18.21424,1504
205118,B023927CBEC0A8053CBDF64A5B76E367,30361,19,21,2,109.50347,18.24,1508
205136,A6CF31A63571639AB283D5F43FB98748,39191,2,4,2,109.51493,18.23472,1557
205137,A6CF31A63571639AB283D5F43FB98748,30181,5,7,2,109.51597,18.23313,1557
205138,A6CF31A63571639AB283D5F43FB98748,30361,8,9,1,109.50347,18.24,1508
205173,F95DF9F1082F8C3737D4149B9D06BBC7,38251,0,9,9,109.49618,18.25493,1510
205174,F95DF9F1082F8C3737D4149B9D06BBC7,31461,11,15,4,109.5091,18.25389,1510
205175,F95DF9F1082F8C3737D4149B9D06BBC7,60281,15,18,3,109.51743,18.25924,1561
205178,BB31DF7CD95EBDC65D12089CF34DDE37,31521,1,12,11,109.51458,18.22542,1555
205179,BB31DF7CD95EBDC65D12089CF34DDE37,30421,15,16,1,109.50021,18.25861,1511
205180,BB31DF7CD95EBDC65D12089CF34DDE37,31521,17,23,6,109.51458,18.22542,1555
205204,104EE6D0AC628B9E88D507A87EA8C333,30201,22,23,1,109.4909,18.26465,1462
205220,A9D6360D2777AEED781C57F7264711FD,38951,0,6,6,109.48097,18.28868,1416
205222,A9D6360D2777AEED781C57F7264711FD,60054,12,13,1,109.3016,18.31229,770
205226,D4EE8E1A4C04A1FF0596E4221D0B8B42,30854,0,6,6,109.56889,18.27076,1763
205227,D4EE8E1A4C04A1FF0596E4221D0B8B42,31071,7,8,1,109.58257,18.28458,1815
205228,D4EE8E1A4C04A1FF0596E4221D0B8B42,30854,10,11,1,109.56889,18.27076,1763
205229,D4EE8E1A4C04A1FF0596E4221D0B8B42,31071,12,23,11,109.58257,18.28458,1815
205315,546019449B49A5FCBBE36F9F3DB19C8A,31231,0,5,5,109.42597,18.29292,1217
205316,546019449B49A5FCBBE36F9F3DB19C8A,31781,8,12,4,109.19847,18.2975,367
205317,546019449B49A5FCBBE36F9F3DB19C8A,31471,14,15,1,109.34583,18.29563,917
205318,546019449B49A5FCBBE36F9F3DB19C8A,31231,20,21,1,109.42597,18.29292,1217
205396,7A214C2AB4CE0E87DF8DB230B9F95561,30101,0,6,6,109.57299,18.33333,1773
205397,7A214C2AB4CE0E87DF8DB230B9F95561,31631,8,9,1,109.59542,18.36826,1879
205398,7A214C2AB4CE0E87DF8DB230B9F95561,30101,11,14,3,109.57299,18.33333,1773
205399,7A214C2AB4CE0E87DF8DB230B9F95561,31631,18,19,1,109.59542,18.36826,1879
205400,7A214C2AB4CE0E87DF8DB230B9F95561,30101,21,23,2,109.57299,18.33333,1773
205423,A9F97D2464709590426A157138F3C687,31931,0,20,20,109.54771,18.29403,1667
205424,A9F97D2464709590426A157138F3C687,31071,21,22,1,109.58257,18.28458,1815
205475,C17F2EF1DEA79C8C951E3013EE071B2C,60351,19,20,1,109.58403,18.28958,1816
205476,C17F2EF1DEA79C8C951E3013EE071B2C,60354,20,21,1,109.58701,18.28521,1815
205479,3D8ADE80304FD3207128013D43F1118A,60421,1,9,8,109.46333,18.31743,1371
205480,3D8ADE80304FD3207128013D43F1118A,31171,14,15,1,109.50938,18.24917,1559
205481,3D8ADE80304FD3207128013D43F1118A,60274,15,17,2,109.514,18.2933,1567
205482,3D8ADE80304FD3207128013D43F1118A,30721,18,19,1,109.51597,18.28257,1565
205494,7C05FB990908C67257EE8EEE421F2B91,30361,17,18,1,109.50347,18.24,1508
205495,7C05FB990908C67257EE8EEE421F2B91,38094,21,23,2,109.45403,18.28778,1316
205500,17D13F6A66037B54FAB5668CDC734401,30721,0,6,6,109.51597,18.28257,1565
205501,17D13F6A66037B54FAB5668CDC734401,31931,7,15,8,109.54771,18.29403,1667
205502,17D13F6A66037B54FAB5668CDC734401,30721,20,23,3,109.51597,18.28257,1565
205514,08D5EFAE8388B70BF24B8C765A0BDF86,31561,0,7,7,109.56792,18.28479,1765
205515,08D5EFAE8388B70BF24B8C765A0BDF86,30854,10,11,1,109.56889,18.27076,1763
205516,08D5EFAE8388B70BF24B8C765A0BDF86,31561,13,23,10,109.56792,18.28479,1765
205555,33D03C41649B47EDC5176C93FF6F1D8D,60411,1,8,7,109.32514,18.30854,869
205556,33D03C41649B47EDC5176C93FF6F1D8D,30661,11,15,4,109.37028,18.24361,1008
205557,33D03C41649B47EDC5176C93FF6F1D8D,60411,17,18,1,109.32514,18.30854,869
205558,33D03C41649B47EDC5176C93FF6F1D8D,31251,22,23,1,109.18528,18.2975,317
205565,A950B25B10B5260D4693DCD3A4C6281C,31931,7,15,8,109.54771,18.29403,1667
205566,A950B25B10B5260D4693DCD3A4C6281C,39181,16,17,1,109.55153,18.28035,1715
205567,A950B25B10B5260D4693DCD3A4C6281C,31931,19,23,4,109.54771,18.29403,1667
205600,74CF56553C56FC34941FD45214B7C747,31071,0,7,7,109.58257,18.28458,1815
205601,74CF56553C56FC34941FD45214B7C747,30854,10,12,2,109.56889,18.27076,1763
205605,8D3B10FD4DBC46DB93DA60040668F697,30854,0,6,6,109.56889,18.27076,1763
205606,8D3B10FD4DBC46DB93DA60040668F697,30071,7,9,2,109.52819,18.30472,1619
205607,8D3B10FD4DBC46DB93DA60040668F697,30854,11,23,12,109.56889,18.27076,1763
205610,06FF0F05B2BE9154F50882BB32DB7B12,38361,5,7,2,109.43667,18.29201,1267
205611,06FF0F05B2BE9154F50882BB32DB7B12,31781,10,12,2,109.19847,18.2975,367
205612,06FF0F05B2BE9154F50882BB32DB7B12,31471,13,15,2,109.34583,18.29563,917
205688,335B5CB406D45A33C3125AB87085288E,30854,1,7,6,109.56889,18.27076,1763
205689,335B5CB406D45A33C3125AB87085288E,31071,7,21,14,109.58257,18.28458,1815
205694,D5F7EFA0DFDB55DFCF47173578729EA6,30854,0,12,12,109.56889,18.27076,1763
205695,D5F7EFA0DFDB55DFCF47173578729EA6,30731,14,16,2,109.50944,18.22306,1555
205742,EB291EA7E3235FF23960DA865075F183,38911,0,7,7,109.51674,18.24965,1559
205743,EB291EA7E3235FF23960DA865075F183,31801,10,11,1,109.20417,18.32118,371
205744,EB291EA7E3235FF23960DA865075F183,38871,13,14,1,109.44681,18.28625,1316
205745,EB291EA7E3235FF23960DA865075F183,60201,15,17,2,109.5041,18.2509,1510
205746,EB291EA7E3235FF23960DA865075F183,30421,18,21,3,109.50021,18.25861,1511
205747,EB291EA7E3235FF23960DA865075F183,60311,21,23,2,109.52097,18.24319,1558
205802,2191B2AD5C915B8862D4C345F0A13CFB,31071,7,18,11,109.58257,18.28458,1815
205803,2191B2AD5C915B8862D4C345F0A13CFB,60351,19,23,4,109.58403,18.28958,1816
205806,E9F64FD67E39C3E2C15C20715338A941,30921,0,13,13,109.53903,18.29451,1667
205807,E9F64FD67E39C3E2C15C20715338A941,31931,15,17,2,109.54771,18.29403,1667
205808,67D1CD42FE90F28C58E4A4ECE73C13C7,38141,0,8,8,109.39479,18.2916,1116
205809,67D1CD42FE90F28C58E4A4ECE73C13C7,31781,10,13,3,109.19847,18.2975,367
205810,67D1CD42FE90F28C58E4A4ECE73C13C7,30661,15,16,1,109.37028,18.24361,1008
205811,67D1CD42FE90F28C58E4A4ECE73C13C7,38141,19,22,3,109.39479,18.2916,1116
205827,EDC17F917D3B692B137ACF040E1D7AE4,30421,0,8,8,109.50021,18.25861,1511
205828,EDC17F917D3B692B137ACF040E1D7AE4,31561,9,17,8,109.56792,18.28479,1765
205829,EDC17F917D3B692B137ACF040E1D7AE4,30421,21,23,2,109.50021,18.25861,1511
205870,BFD935D49CB103A2B1D4E8EFFB13D28D,31471,14,17,3,109.34583,18.29563,917
205871,BFD935D49CB103A2B1D4E8EFFB13D28D,60371,21,22,1,109.53063,18.30056,1618
205873,26DECA4A496D5594EA57F7546CECA764,60201,12,13,1,109.5041,18.2509,1510
205882,EB316856896788EC8FD871E122E95728,30701,0,6,6,109.59313,18.32007,1871
205883,EB316856896788EC8FD871E122E95728,31811,6,11,5,109.54201,18.31806,1671
205884,EB316856896788EC8FD871E122E95728,30701,12,13,1,109.59313,18.32007,1871
205885,EB316856896788EC8FD871E122E95728,31811,14,16,2,109.54201,18.31806,1671
205886,EB316856896788EC8FD871E122E95728,30701,17,23,6,109.59313,18.32007,1871
205895,DEFDF52078F80D0DB257A40413FF368C,31071,1,6,5,109.58257,18.28458,1815
205896,DEFDF52078F80D0DB257A40413FF368C,30271,7,10,3,109.49132,18.23153,1456
205923,5F05A258CA919BA01045F79DD70FBCC9,39183,13,15,2,109.55542,18.28208,1715
205924,5F05A258CA919BA01045F79DD70FBCC9,31561,16,22,6,109.56792,18.28479,1765
205962,CD3BCBAB8571FB81953C842A434E5DB8,31071,8,10,2,109.58257,18.28458,1815
205963,CD3BCBAB8571FB81953C842A434E5DB8,30854,11,12,1,109.56889,18.27076,1763
205964,CD3BCBAB8571FB81953C842A434E5DB8,31071,12,20,8,109.58257,18.28458,1815
206022,4B004637D3CFBCA65EA00FFD3F1EF7A6,31561,0,7,7,109.56792,18.28479,1765
206023,4B004637D3CFBCA65EA00FFD3F1EF7A6,31931,9,10,1,109.54771,18.29403,1667
206024,4B004637D3CFBCA65EA00FFD3F1EF7A6,31561,11,12,1,109.56792,18.28479,1765
206025,4B004637D3CFBCA65EA00FFD3F1EF7A6,30071,16,18,2,109.52819,18.30472,1619
206026,4B004637D3CFBCA65EA00FFD3F1EF7A6,30854,21,22,1,109.56889,18.27076,1763
206041,58DE8A719D3ADBEDAE163213845B460A,31071,0,7,7,109.58257,18.28458,1815
206042,58DE8A719D3ADBEDAE163213845B460A,30854,8,10,2,109.56889,18.27076,1763
206043,58DE8A719D3ADBEDAE163213845B460A,31071,12,14,2,109.58257,18.28458,1815
206077,DAAE5DFD68A77B087B889719E639CD9C,60381,0,10,10,109.5241,18.22458,1605
206078,DAAE5DFD68A77B087B889719E639CD9C,60491,11,12,1,109.43354,18.30847,1269
206079,DAAE5DFD68A77B087B889719E639CD9C,30861,14,23,9,109.52722,18.22743,1606
206085,95FD09E80C431C5EBD01FFAFF8AFA522,60371,0,7,7,109.53063,18.30056,1618
206086,95FD09E80C431C5EBD01FFAFF8AFA522,31301,9,12,3,109.14493,18.31222,170
206087,95FD09E80C431C5EBD01FFAFF8AFA522,31471,14,16,2,109.34583,18.29563,917
206092,706B8E0F0F5D1C9FC2F8EBB2574EE89F,30711,0,1,1,109.50271,18.25347,1510
206093,706B8E0F0F5D1C9FC2F8EBB2574EE89F,30711,2,3,1,109.50271,18.25347,1510
206094,706B8E0F0F5D1C9FC2F8EBB2574EE89F,31461,6,8,2,109.5091,18.25389,1510
206095,706B8E0F0F5D1C9FC2F8EBB2574EE89F,30711,8,18,10,109.50271,18.25347,1510
206096,706B8E0F0F5D1C9FC2F8EBB2574EE89F,30711,20,21,1,109.50271,18.25347,1510
206097,706B8E0F0F5D1C9FC2F8EBB2574EE89F,38297,21,23,2,109.52576,18.24965,1609
206129,EBD16061EA20EE33D9344D33735E5205,38291,0,6,6,109.51618,18.24313,1558
206130,EBD16061EA20EE33D9344D33735E5205,31261,6,12,6,109.51174,18.2466,1559
206131,EBD16061EA20EE33D9344D33735E5205,31441,12,16,4,109.51181,18.24424,1559
206132,EBD16061EA20EE33D9344D33735E5205,31261,16,20,4,109.51174,18.2466,1559
206133,EBD16061EA20EE33D9344D33735E5205,60311,21,23,2,109.52097,18.24319,1558
206173,D57C96947D36188D750CB1E91A678FDA,39061,15,17,2,109.38222,18.28958,1066
206174,D57C96947D36188D750CB1E91A678FDA,30421,18,23,5,109.50021,18.25861,1511
206179,BB2A705402C0F8D59021F6C4976A196E,30854,19,20,1,109.56889,18.27076,1763
206180,BB2A705402C0F8D59021F6C4976A196E,60631,20,21,1,109.57778,18.27583,1814
206181,B164B8C0AEC0E295C9ED3DBE75B5D547,30581,0,6,6,109.62257,18.24951,1959
206182,B164B8C0AEC0E295C9ED3DBE75B5D547,31851,7,8,1,109.71736,18.29007,2316
206183,B164B8C0AEC0E295C9ED3DBE75B5D547,31571,11,13,2,109.61563,18.23326,1957
206219,C2C9FC62B57DBBBE2D4CFD5ADB03E0F1,30851,11,16,5,109.5616,18.27396,1713
206220,C2C9FC62B57DBBBE2D4CFD5ADB03E0F1,31071,16,23,7,109.58257,18.28458,1815
206231,04257A4027CF767681E241CBFFC5B331,31881,5,7,2,109.7441,18.40785,2436
206254,756F7869BDD7D5958992D7847F42858F,31236,14,19,5,109.42965,18.29111,1216
206255,756F7869BDD7D5958992D7847F42858F,38071,19,23,4,109.40722,18.30938,1169
206279,2F440A235E684ECEDD042B3100A4AE95,31071,0,7,7,109.58257,18.28458,1815
206280,2F440A235E684ECEDD042B3100A4AE95,30854,7,19,12,109.56889,18.27076,1763
206281,2F440A235E684ECEDD042B3100A4AE95,31071,20,23,3,109.58257,18.28458,1815
206294,0402BD114B7D5E20705E302B756CD062,60631,0,6,6,109.57778,18.27583,1814
206295,0402BD114B7D5E20705E302B756CD062,31071,8,19,11,109.58257,18.28458,1815
206309,ACDEAAF45B65DE48CF80A48DBD3C775E,30854,8,14,6,109.56889,18.27076,1763
206310,ACDEAAF45B65DE48CF80A48DBD3C775E,31071,16,18,2,109.58257,18.28458,1815
206311,3E507BA86FBA703DAF19C68A80411CA5,60311,0,1,1,109.52097,18.24319,1558
206312,3E507BA86FBA703DAF19C68A80411CA5,30854,2,9,7,109.56889,18.27076,1763
206313,3E507BA86FBA703DAF19C68A80411CA5,31031,13,14,1,109.49979,18.25382,1510
206314,3E507BA86FBA703DAF19C68A80411CA5,60354,19,20,1,109.58701,18.28521,1815
206315,3E507BA86FBA703DAF19C68A80411CA5,30854,21,23,2,109.56889,18.27076,1763
206316,282786EFD7BB2C684B51EB83D9362631,60501,0,8,8,109.48701,18.29021,1466
206317,282786EFD7BB2C684B51EB83D9362631,30971,12,14,2,109.48708,18.29319,1467
206339,5EBEA276FCB4A19AC5C987F5C7CC8908,60401,0,1,1,109.47444,18.27583,1414
206340,5EBEA276FCB4A19AC5C987F5C7CC8908,60524,2,6,4,109.42951,18.28993,1216
206341,5EBEA276FCB4A19AC5C987F5C7CC8908,60621,6,7,1,109.48354,18.27451,1464
206342,5EBEA276FCB4A19AC5C987F5C7CC8908,60552,8,11,3,109.41729,18.30014,1218
206343,5EBEA276FCB4A19AC5C987F5C7CC8908,60621,14,23,9,109.48354,18.27451,1464
206348,3B6FF1F8D896A0A62DC7E65967011999,39183,0,20,20,109.55542,18.28208,1715
206349,3B6FF1F8D896A0A62DC7E65967011999,31561,20,22,2,109.56792,18.28479,1765
206364,A5678EE319F8EC08843C9F20545373D3,31231,0,11,11,109.42597,18.29292,1217
206365,A5678EE319F8EC08843C9F20545373D3,60524,12,23,11,109.42951,18.28993,1216
206386,F945D1EC910CAA5B207559CC99738BE6,30851,15,17,2,109.5616,18.27396,1713
206387,F945D1EC910CAA5B207559CC99738BE6,30361,19,23,4,109.50347,18.24,1508
206388,DB4DF566D4757FF3BB488F82DE126248,30851,2,3,1,109.5616,18.27396,1713
206389,DB4DF566D4757FF3BB488F82DE126248,31561,3,20,17,109.56792,18.28479,1765
206421,0312B43ACF9ED1D8304E325E851AEE29,30851,0,7,7,109.5616,18.27396,1713
206422,0312B43ACF9ED1D8304E325E851AEE29,31181,9,10,1,109.50382,18.24813,1509
206423,0312B43ACF9ED1D8304E325E851AEE29,31561,15,19,4,109.56792,18.28479,1765
206424,0312B43ACF9ED1D8304E325E851AEE29,30851,21,23,2,109.5616,18.27396,1713
206455,11E9088AC74BC50879349ACDDB708B24,31571,0,5,5,109.61563,18.23326,1957
206456,11E9088AC74BC50879349ACDDB708B24,38054,6,7,1,109.63479,18.23097,2006
206457,11E9088AC74BC50879349ACDDB708B24,31145,11,13,2,109.20431,18.30479,369
206460,063A6C1319C2FB8D51BDBDBC79DDAACC,31521,0,13,13,109.51458,18.22542,1555
206461,063A6C1319C2FB8D51BDBDBC79DDAACC,31471,16,18,2,109.34583,18.29563,917
206462,063A6C1319C2FB8D51BDBDBC79DDAACC,31781,19,20,1,109.19847,18.2975,367
206530,01F0083CC81D0009F9AAB8F7CAA0C106,30854,1,7,6,109.56889,18.27076,1763
206531,01F0083CC81D0009F9AAB8F7CAA0C106,31071,9,16,7,109.58257,18.28458,1815
206542,1994505627B8B8D1C8508885623DB6F8,38251,0,9,9,109.49618,18.25493,1510
206543,1994505627B8B8D1C8508885623DB6F8,31311,11,14,3,109.72299,18.27438,2364
206548,64F066E95B9E85CA35F8A30036F511A3,38951,0,8,8,109.48097,18.28868,1416
206549,64F066E95B9E85CA35F8A30036F511A3,38951,12,14,2,109.48097,18.28868,1416
206550,64F066E95B9E85CA35F8A30036F511A3,38951,14,19,5,109.48097,18.28868,1416
206555,8088BB824557EB3DC3C65BFEE10DC938,30854,12,13,1,109.56889,18.27076,1763
206556,8088BB824557EB3DC3C65BFEE10DC938,60071,15,19,4,109.75674,18.31583,2470
206557,8088BB824557EB3DC3C65BFEE10DC938,60071,21,23,2,109.75674,18.31583,2470
206584,B9273D09079A968E7733706E64683561,31471,12,14,2,109.34583,18.29563,917
206585,68B818C9FDFA6C8A4859B6710E9B6AA7,38391,0,4,4,109.44111,18.29083,1266
206586,68B818C9FDFA6C8A4859B6710E9B6AA7,31701,5,9,4,109.44132,18.28833,1266
206587,68B818C9FDFA6C8A4859B6710E9B6AA7,30661,10,12,2,109.37028,18.24361,1008
206588,68B818C9FDFA6C8A4859B6710E9B6AA7,38162,17,23,6,109.43944,18.28889,1266
206599,296E9ABEFB8BDFEF115E6A6255085681,31411,18,19,1,109.5016,18.23576,1507
206600,296E9ABEFB8BDFEF115E6A6255085681,60161,21,22,1,109.49174,18.26181,1461
206616,D8BF2F572E169414CEFD83D7D44137A4,33481,9,10,1,109.67278,18.41278,2187
206617,D8BF2F572E169414CEFD83D7D44137A4,31301,12,14,2,109.14493,18.31222,170
206623,1791D76BD285CB6677B879C940A7CBDA,30051,15,16,1,109.48917,18.21215,1453
206624,1791D76BD285CB6677B879C940A7CBDA,30731,21,22,1,109.50944,18.22306,1555
206718,CA3896FB33E9BC68E91955EDFF5D709B,30854,0,8,8,109.56889,18.27076,1763
206719,CA3896FB33E9BC68E91955EDFF5D709B,30731,10,12,2,109.50944,18.22306,1555
206724,64F4CDF664AA04E7B79DE93C57128CF6,31931,0,4,4,109.54771,18.29403,1667
206725,64F4CDF664AA04E7B79DE93C57128CF6,39181,8,17,9,109.55153,18.28035,1715
206742,45CCFCD3EBDF941E1C92B70ED06E8B5E,30854,0,7,7,109.56889,18.27076,1763
206743,45CCFCD3EBDF941E1C92B70ED06E8B5E,31945,8,9,1,109.58021,18.29403,1817
206744,45CCFCD3EBDF941E1C92B70ED06E8B5E,30854,11,22,11,109.56889,18.27076,1763
206745,D334A3AB9A5F6BA25F6C66B0B76EC47B,30911,0,7,7,109.50493,18.26181,1511
206746,D334A3AB9A5F6BA25F6C66B0B76EC47B,30421,7,12,5,109.50021,18.25861,1511
206747,D334A3AB9A5F6BA25F6C66B0B76EC47B,31031,14,16,2,109.49979,18.25382,1510
206748,D334A3AB9A5F6BA25F6C66B0B76EC47B,30711,16,19,3,109.50271,18.25347,1510
206749,D334A3AB9A5F6BA25F6C66B0B76EC47B,30421,19,21,2,109.50021,18.25861,1511
206773,6B806948BC9187A91D033B4096721B00,31561,5,7,2,109.56792,18.28479,1765
206774,6B806948BC9187A91D033B4096721B00,31071,11,19,8,109.58257,18.28458,1815
206775,6B806948BC9187A91D033B4096721B00,31561,20,22,2,109.56792,18.28479,1765
206789,354DC607408BB828F25BA014BE4B0A10,30731,0,3,3,109.50944,18.22306,1555
206790,354DC607408BB828F25BA014BE4B0A10,38111,4,5,1,109.52007,18.22403,1555
206791,354DC607408BB828F25BA014BE4B0A10,30731,7,10,3,109.50944,18.22306,1555
206792,354DC607408BB828F25BA014BE4B0A10,30741,10,12,2,109.49833,18.28681,1516
206793,354DC607408BB828F25BA014BE4B0A10,30731,14,16,2,109.50944,18.22306,1555
206794,354DC607408BB828F25BA014BE4B0A10,38111,16,18,2,109.52007,18.22403,1555
206795,354DC607408BB828F25BA014BE4B0A10,30731,20,23,3,109.50944,18.22306,1555
206802,F621296F333E8058687ACD884B135C6E,31901,15,18,3,109.68236,18.35368,2227
206803,F621296F333E8058687ACD884B135C6E,60114,19,22,3,109.73028,18.33847,2374
206825,FA5581D3844E50B2A372DC72CD47A219,38951,0,7,7,109.48097,18.28868,1416
206826,FA5581D3844E50B2A372DC72CD47A219,31101,9,10,1,109.65389,18.23403,2057
206872,56F4A25A0E603B5B2CF39EF89A2DE812,31061,19,20,1,109.53333,18.23257,1607
206873,56F4A25A0E603B5B2CF39EF89A2DE812,31611,22,23,1,109.63076,18.34944,2026
206898,49B3509BB0FF86B3DDAB6DD80329A93A,33051,12,14,2,109.6475,18.46618,2096
206900,49B3509BB0FF86B3DDAB6DD80329A93A,38951,21,22,1,109.48097,18.28868,1416
206915,E65658506C2BF9C993BA69EE6D38B3C6,31951,0,17,17,109.52174,18.30299,1568
206916,E65658506C2BF9C993BA69EE6D38B3C6,60361,17,19,2,109.51938,18.29681,1567
206917,E65658506C2BF9C993BA69EE6D38B3C6,31561,21,23,2,109.56792,18.28479,1765
206956,2C7E329ABF5669760C98EF0FEA876F54,39111,18,22,4,109.5191,18.22597,1555
206967,011859AA130B61CD7FFEFC39AEF2B9BF,31061,0,5,5,109.53333,18.23257,1607
206968,011859AA130B61CD7FFEFC39AEF2B9BF,30821,7,23,16,109.43681,18.33639,1274
206969,CF3B86CDBB32A56F162AF624AA34A4EF,31864,0,7,7,109.49014,18.28333,1465
206970,CF3B86CDBB32A56F162AF624AA34A4EF,60591,9,16,7,109.61118,18.21715,1904
207021,73C621BBBABF29F29DF18108CE1A5D74,38951,0,7,7,109.48097,18.28868,1416
207022,73C621BBBABF29F29DF18108CE1A5D74,31471,10,11,1,109.34583,18.29563,917
207023,73C621BBBABF29F29DF18108CE1A5D74,30661,14,16,2,109.37028,18.24361,1008
207071,C93386A9D86FE22A1FD4E5116045DD8D,31561,0,6,6,109.56792,18.28479,1765
207072,C93386A9D86FE22A1FD4E5116045DD8D,39183,7,11,4,109.55542,18.28208,1715
207073,C93386A9D86FE22A1FD4E5116045DD8D,31561,13,14,1,109.56792,18.28479,1765
207074,C93386A9D86FE22A1FD4E5116045DD8D,39183,14,15,1,109.55542,18.28208,1715
207094,7BD1580BA480E545686438B39D58DB57,31124,0,2,2,109.17069,18.35,276
207095,7BD1580BA480E545686438B39D58DB57,30434,3,8,5,109.17083,18.35861,278
207096,7BD1580BA480E545686438B39D58DB57,31781,12,13,1,109.19847,18.2975,367
207102,8511528E14FB4539CD9D9028DC875E91,31561,0,1,1,109.56792,18.28479,1765
207103,8511528E14FB4539CD9D9028DC875E91,31271,2,9,7,109.48958,18.26257,1462
207106,8A13D61E438E2D948DE2F55318BED098,60071,0,5,5,109.75674,18.31583,2470
207107,8A13D61E438E2D948DE2F55318BED098,38707,5,6,1,109.73778,18.35368,2427
207108,8A13D61E438E2D948DE2F55318BED098,38707,8,9,1,109.73778,18.35368,2427
207147,EFDE35289FEC1E13D6F34EFEE66A8AD2,31561,0,1,1,109.56792,18.28479,1765
207148,EFDE35289FEC1E13D6F34EFEE66A8AD2,60631,2,15,13,109.57778,18.27583,1814
207171,DA10676C4DA702E02A2C3FFFAC40ABA2,31561,6,9,3,109.56792,18.28479,1765
207172,DA10676C4DA702E02A2C3FFFAC40ABA2,39183,10,21,11,109.55542,18.28208,1715
207188,EBC6234FE3CA0714B9EB5EC0230C1FEB,31531,0,7,7,109.49583,18.25972,1461
207189,EBC6234FE3CA0714B9EB5EC0230C1FEB,31271,8,9,1,109.48958,18.26257,1462
207190,EBC6234FE3CA0714B9EB5EC0230C1FEB,30711,13,16,3,109.50271,18.25347,1510
207191,EBC6234FE3CA0714B9EB5EC0230C1FEB,38271,17,22,5,109.62632,18.23049,1956
207219,AFFFE5C6CF1F48C4FC9E7C5DE978BF0D,31071,0,1,1,109.58257,18.28458,1815
207220,AFFFE5C6CF1F48C4FC9E7C5DE978BF0D,31761,1,4,3,109.60521,18.27965,1914
207221,AFFFE5C6CF1F48C4FC9E7C5DE978BF0D,60354,5,6,1,109.58701,18.28521,1815
207222,AFFFE5C6CF1F48C4FC9E7C5DE978BF0D,30854,7,10,3,109.56889,18.27076,1763
207223,AFFFE5C6CF1F48C4FC9E7C5DE978BF0D,31071,15,16,1,109.58257,18.28458,1815
207224,AFFFE5C6CF1F48C4FC9E7C5DE978BF0D,30854,17,19,2,109.56889,18.27076,1763
207225,AFFFE5C6CF1F48C4FC9E7C5DE978BF0D,31461,20,21,1,109.5091,18.25389,1510
207236,9C0A03DCBFD1D5F11DF957CDAC9B1222,60161,0,10,10,109.49174,18.26181,1461
207285,998ABE8C520F737BA8B4035E9C6950FC,30271,0,8,8,109.49132,18.23153,1456
207286,998ABE8C520F737BA8B4035E9C6950FC,38754,12,13,1,109.74667,18.37382,2430
207287,998ABE8C520F737BA8B4035E9C6950FC,60221,16,17,1,109.52569,18.29188,1616
207288,998ABE8C520F737BA8B4035E9C6950FC,60381,19,20,1,109.5241,18.22458,1605
207289,998ABE8C520F737BA8B4035E9C6950FC,60084,21,22,1,109.4984,18.2334,1507
207301,187C0A1E258087BFAE75FA12EB6B5B08,31951,14,18,4,109.52174,18.30299,1568
207302,187C0A1E258087BFAE75FA12EB6B5B08,30561,19,20,1,109.52778,18.31938,1621
207303,187C0A1E258087BFAE75FA12EB6B5B08,30031,21,23,2,109.53681,18.33313,1673
207329,0E129C09250C0D46273B4BD7E5225556,30151,0,6,6,109.50986,18.25083,1560
207330,0E129C09250C0D46273B4BD7E5225556,60201,8,11,3,109.5041,18.2509,1510
207331,0E129C09250C0D46273B4BD7E5225556,31303,13,16,3,109.15826,18.29549,217
207332,0E129C09250C0D46273B4BD7E5225556,31301,17,18,1,109.14493,18.31222,170
207333,0E129C09250C0D46273B4BD7E5225556,60281,20,22,2,109.51743,18.25924,1561
207350,075E831221D825E42B68255A703AEB8B,60614,1,7,6,109.48799,18.29521,1467
207351,075E831221D825E42B68255A703AEB8B,31471,9,10,1,109.34583,18.29563,917
207352,075E831221D825E42B68255A703AEB8B,30661,13,16,3,109.37028,18.24361,1008
207353,075E831221D825E42B68255A703AEB8B,38951,21,22,1,109.48097,18.28868,1416
207357,BE7A0BE04118D373FA5A1BB3F88D90A9,30084,12,15,3,109.50118,18.26972,1513
207358,BE7A0BE04118D373FA5A1BB3F88D90A9,31931,15,17,2,109.54771,18.29403,1667
207359,D3CC138F01596B858EB1ECAA73909436,60381,2,4,2,109.5241,18.22458,1605
207360,D3CC138F01596B858EB1ECAA73909436,39111,5,6,1,109.5191,18.22597,1555
207361,D3CC138F01596B858EB1ECAA73909436,31521,8,9,1,109.51458,18.22542,1555
207362,D3CC138F01596B858EB1ECAA73909436,38754,12,13,1,109.74667,18.37382,2430
207363,D3CC138F01596B858EB1ECAA73909436,30181,15,16,1,109.51597,18.23313,1557
207364,D3CC138F01596B858EB1ECAA73909436,30711,17,20,3,109.50271,18.25347,1510
207365,D3CC138F01596B858EB1ECAA73909436,38111,20,23,3,109.52007,18.22403,1555
207375,3F80F6C7ECC59E36D89C8EF1746C8724,38961,0,3,3,109.50847,18.23514,1507
207376,3F80F6C7ECC59E36D89C8EF1746C8724,39053,4,10,6,109.511,18.2771,1564
207377,3F80F6C7ECC59E36D89C8EF1746C8724,30281,13,14,1,109.50597,18.27583,1514
207378,3F80F6C7ECC59E36D89C8EF1746C8724,31206,17,20,3,109.50819,18.23549,1507
207382,2269D1065FFE77B23BCA730F1F57BDCE,30361,19,21,2,109.50347,18.24,1508
207383,2269D1065FFE77B23BCA730F1F57BDCE,38961,21,23,2,109.50847,18.23514,1507
207389,56C8C781972E8BFAF8A768A19AD7F590,30281,0,9,9,109.50597,18.27583,1514
207390,56C8C781972E8BFAF8A768A19AD7F590,30421,12,14,2,109.50021,18.25861,1511
207391,56C8C781972E8BFAF8A768A19AD7F590,38127,18,23,5,109.50833,18.27222,1513
207402,C709D01469E0800AF998DFAF42105CDC,60631,0,5,5,109.57778,18.27583,1814
207403,C709D01469E0800AF998DFAF42105CDC,31561,7,10,3,109.56792,18.28479,1765
207404,C709D01469E0800AF998DFAF42105CDC,30854,10,11,1,109.56889,18.27076,1763
207405,C709D01469E0800AF998DFAF42105CDC,31561,12,16,4,109.56792,18.28479,1765
207406,C709D01469E0800AF998DFAF42105CDC,30854,18,23,5,109.56889,18.27076,1763
207424,FA14B010F60C7FB3B13194FAA13740E8,31561,1,3,2,109.56792,18.28479,1765
207425,FA14B010F60C7FB3B13194FAA13740E8,39183,7,8,1,109.55542,18.28208,1715
207426,FA14B010F60C7FB3B13194FAA13740E8,31561,8,22,14,109.56792,18.28479,1765
207435,451E2BF48CD7B253EB0892324E679BCC,31461,0,4,4,109.5091,18.25389,1510
207436,451E2BF48CD7B253EB0892324E679BCC,38297,5,6,1,109.52576,18.24965,1609
207437,451E2BF48CD7B253EB0892324E679BCC,60281,6,11,5,109.51743,18.25924,1561
207438,451E2BF48CD7B253EB0892324E679BCC,38291,11,13,2,109.51618,18.24313,1558
207439,451E2BF48CD7B253EB0892324E679BCC,60281,13,17,4,109.51743,18.25924,1561
207440,451E2BF48CD7B253EB0892324E679BCC,38297,19,22,3,109.52576,18.24965,1609
207465,8A0382A2385C362EFE2664E8795F133E,31561,0,1,1,109.56792,18.28479,1765
207466,8A0382A2385C362EFE2664E8795F133E,39183,1,18,17,109.55542,18.28208,1715
207467,8A0382A2385C362EFE2664E8795F133E,31561,20,23,3,109.56792,18.28479,1765
207524,78D44725626E719FF0C0FCBC8763A33E,31561,15,16,1,109.56792,18.28479,1765
207525,78D44725626E719FF0C0FCBC8763A33E,60361,19,22,3,109.51938,18.29681,1567
207538,0E5593A90D661690BE3DAAA17AD936E2,30281,1,7,6,109.50597,18.27583,1514
207539,0E5593A90D661690BE3DAAA17AD936E2,38127,11,19,8,109.50833,18.27222,1513
207540,0E5593A90D661690BE3DAAA17AD936E2,30291,20,21,1,109.50403,18.27028,1513
207543,DDE77D3A656666992FC3458B84010D43,39183,0,3,3,109.55542,18.28208,1715
207544,DDE77D3A656666992FC3458B84010D43,31561,5,11,6,109.56792,18.28479,1765
207545,15A05498D3CF3495981AAE982CA69170,60161,15,19,4,109.49174,18.26181,1461
207546,15A05498D3CF3495981AAE982CA69170,31031,19,21,2,109.49979,18.25382,1510
207574,529A14F498129B0238F7B12A9FC7F6F7,31205,0,1,1,109.51111,18.23736,1557
207575,529A14F498129B0238F7B12A9FC7F6F7,31671,2,9,7,109.38965,18.29813,1068
207576,529A14F498129B0238F7B12A9FC7F6F7,31081,12,13,1,109.44639,18.30181,1318
207577,529A14F498129B0238F7B12A9FC7F6F7,31701,15,16,1,109.44132,18.28833,1266
207578,529A14F498129B0238F7B12A9FC7F6F7,31671,18,20,2,109.38965,18.29813,1068
207579,529A14F498129B0238F7B12A9FC7F6F7,31701,20,23,3,109.44132,18.28833,1266
207583,4CAA61941552055167911FDA303E0716,60311,19,20,1,109.52097,18.24319,1558
207584,4CAA61941552055167911FDA303E0716,31201,21,22,1,109.51042,18.23819,1558
207602,2C3BD53A8702A47FB82F05FB4993B683,31561,0,6,6,109.56792,18.28479,1765
207603,2C3BD53A8702A47FB82F05FB4993B683,39183,7,8,1,109.55542,18.28208,1715
207604,2C3BD53A8702A47FB82F05FB4993B683,31561,11,13,2,109.56792,18.28479,1765
207605,2C3BD53A8702A47FB82F05FB4993B683,30854,14,15,1,109.56889,18.27076,1763
207606,2C3BD53A8702A47FB82F05FB4993B683,31561,18,22,4,109.56792,18.28479,1765
207625,6BB908E717D43CA60DB426B647CF8DE4,31091,0,14,14,109.41201,18.31222,1170
207626,6BB908E717D43CA60DB426B647CF8DE4,60041,14,15,1,109.39889,18.31944,1121
207627,6BB908E717D43CA60DB426B647CF8DE4,31091,17,23,6,109.41201,18.31222,1170
207663,C2622C284BAD8F487DCD454B3FAF9432,30721,0,12,12,109.51597,18.28257,1565
207664,C2622C284BAD8F487DCD454B3FAF9432,38881,13,14,1,109.51618,18.26431,1562
207665,C2622C284BAD8F487DCD454B3FAF9432,31021,15,18,3,109.49021,18.27,1463
207666,C2622C284BAD8F487DCD454B3FAF9432,39154,20,21,1,109.50201,18.25681,1511
207667,C2622C284BAD8F487DCD454B3FAF9432,60361,21,23,2,109.51938,18.29681,1567
207683,03400E70232608A9491D68EE417E3691,30771,0,6,6,109.49938,18.26042,1511
207684,03400E70232608A9491D68EE417E3691,60281,7,13,6,109.51743,18.25924,1561
207685,03400E70232608A9491D68EE417E3691,31521,14,16,2,109.51458,18.22542,1555
207686,283001ED673D8EDBEF7EEB00BDB31533,38017,1,3,2,109.49729,18.21424,1504
207687,283001ED673D8EDBEF7EEB00BDB31533,31181,6,10,4,109.50382,18.24813,1509
207688,283001ED673D8EDBEF7EEB00BDB31533,39151,11,13,2,109.49875,18.25097,1510
207689,283001ED673D8EDBEF7EEB00BDB31533,60201,13,16,3,109.5041,18.2509,1510
207690,283001ED673D8EDBEF7EEB00BDB31533,31181,16,18,2,109.50382,18.24813,1509
207691,283001ED673D8EDBEF7EEB00BDB31533,30051,19,21,2,109.48917,18.21215,1453
207732,0E1B3CFC64EBB658DA96D0DCA834701E,61011,0,6,6,109.60653,18.19076,1900
207734,0E1B3CFC64EBB658DA96D0DCA834701E,61011,11,18,7,109.60653,18.19076,1900
207759,DD45307798B5E5E871398410DD7318C5,38951,0,1,1,109.48097,18.28868,1416
207760,DD45307798B5E5E871398410DD7318C5,38951,2,23,21,109.48097,18.28868,1416
207776,6CFAB52F14B9F6126A5F32C6F3BFD184,31521,10,12,2,109.51458,18.22542,1555
207777,6CFAB52F14B9F6126A5F32C6F3BFD184,30421,12,13,1,109.50021,18.25861,1511
207778,6CFAB52F14B9F6126A5F32C6F3BFD184,39321,14,15,1,109.529,18.2167,1604
207779,6CFAB52F14B9F6126A5F32C6F3BFD184,31521,18,21,3,109.51458,18.22542,1555
207780,6CFAB52F14B9F6126A5F32C6F3BFD184,60381,21,22,1,109.5241,18.22458,1605
207800,D39D64452E6BBEF7B3056CA239E1B86E,30851,0,5,5,109.5616,18.27396,1713
207801,D39D64452E6BBEF7B3056CA239E1B86E,30854,5,23,18,109.56889,18.27076,1763
207859,D1B09D14086A317457A98E1E3E3BED6B,39181,13,14,1,109.55153,18.28035,1715
207860,D1B09D14086A317457A98E1E3E3BED6B,31931,15,16,1,109.54771,18.29403,1667
207861,D1B09D14086A317457A98E1E3E3BED6B,39181,17,23,6,109.55153,18.28035,1715
207891,34AB502A442AA8EA4A7FB30471B204DB,38094,10,12,2,109.45403,18.28778,1316
207892,34AB502A442AA8EA4A7FB30471B204DB,30341,13,14,1,109.3625,18.29167,966
207893,34AB502A442AA8EA4A7FB30471B204DB,31031,15,17,2,109.49979,18.25382,1510
207894,34AB502A442AA8EA4A7FB30471B204DB,60401,20,21,1,109.47444,18.27583,1414
207954,CD576F1C1CDFB89E6A99A20E65927346,30854,2,7,5,109.56889,18.27076,1763
207955,CD576F1C1CDFB89E6A99A20E65927346,31561,8,19,11,109.56792,18.28479,1765
207956,CD576F1C1CDFB89E6A99A20E65927346,30854,20,22,2,109.56889,18.27076,1763
208006,B712327B6033C61F37801CFD6DAC08AD,31951,5,6,1,109.52174,18.30299,1568
208007,B712327B6033C61F37801CFD6DAC08AD,38484,7,13,6,109.53028,18.31528,1620
208008,B712327B6033C61F37801CFD6DAC08AD,38484,14,23,9,109.53028,18.31528,1620
208028,A7B3BDD8DC79485BA41EC7F220A41345,30854,0,1,1,109.56889,18.27076,1763
208029,A7B3BDD8DC79485BA41EC7F220A41345,60631,3,10,7,109.57778,18.27583,1814
208030,A7B3BDD8DC79485BA41EC7F220A41345,30854,12,13,1,109.56889,18.27076,1763
208031,A7B3BDD8DC79485BA41EC7F220A41345,60631,14,16,2,109.57778,18.27583,1814
208032,A7B3BDD8DC79485BA41EC7F220A41345,30854,18,19,1,109.56889,18.27076,1763
208033,A7B3BDD8DC79485BA41EC7F220A41345,31554,22,23,1,109.55521,18.2459,1709
208034,63FBAC0202144B00077561285E6A7F87,30821,1,14,13,109.43681,18.33639,1274
208035,63FBAC0202144B00077561285E6A7F87,30651,14,16,2,109.42611,18.385,1232
208036,63FBAC0202144B00077561285E6A7F87,30821,16,23,7,109.43681,18.33639,1274
208104,E755AD63601CF016CD8E32C53EBB1378,31864,2,12,10,109.49014,18.28333,1465
208167,77D805C7CC3CDE277FD34ED04AB294D2,30731,0,1,1,109.50944,18.22306,1555
208168,77D805C7CC3CDE277FD34ED04AB294D2,39321,4,9,5,109.529,18.2167,1604
208188,09605A95AE7BE30FC92DC699DB3FCBD0,31461,18,20,2,109.5091,18.25389,1510
208189,09605A95AE7BE30FC92DC699DB3FCBD0,30711,20,22,2,109.50271,18.25347,1510
208192,8DA7661E8E46B66EF011FB9B9FA15609,60081,3,6,3,109.51097,18.22639,1556
208193,8DA7661E8E46B66EF011FB9B9FA15609,60381,8,10,2,109.5241,18.22458,1605
208194,8DA7661E8E46B66EF011FB9B9FA15609,31521,10,14,4,109.51458,18.22542,1555
208195,8DA7661E8E46B66EF011FB9B9FA15609,30711,18,20,2,109.50271,18.25347,1510
208196,8DA7661E8E46B66EF011FB9B9FA15609,39111,21,22,1,109.5191,18.22597,1555
208242,1B452E7E79B6B7878FCAC5F7CC906FE5,38951,0,8,8,109.48097,18.28868,1416
208244,1B452E7E79B6B7878FCAC5F7CC906FE5,31471,15,16,1,109.34583,18.29563,917
208245,1B452E7E79B6B7878FCAC5F7CC906FE5,30821,19,21,2,109.43681,18.33639,1274
208246,1B452E7E79B6B7878FCAC5F7CC906FE5,38951,22,23,1,109.48097,18.28868,1416
208247,E46795A590C643FCDE6B993B35621D2F,30921,1,2,1,109.53903,18.29451,1667
208248,E46795A590C643FCDE6B993B35621D2F,31931,5,6,1,109.54771,18.29403,1667
208249,E46795A590C643FCDE6B993B35621D2F,30351,9,11,2,109.41701,18.29292,1217
208250,B78E7295CB13532B4E2C30EF158E297F,31931,0,1,1,109.54771,18.29403,1667
208251,B78E7295CB13532B4E2C30EF158E297F,30854,2,6,4,109.56889,18.27076,1763
208252,B78E7295CB13532B4E2C30EF158E297F,31931,8,11,3,109.54771,18.29403,1667
208268,ED45C49A067CEAF327959541A0BCB0AF,38706,0,9,9,109.74625,18.37097,2430
208269,ED45C49A067CEAF327959541A0BCB0AF,31671,13,15,2,109.38965,18.29813,1068
208270,ED45C49A067CEAF327959541A0BCB0AF,38141,15,18,3,109.39479,18.2916,1116
208276,D4451AAE094A43FD2A07E613CA7CF12F,30171,0,8,8,109.48458,18.27139,1463
208277,D4451AAE094A43FD2A07E613CA7CF12F,60501,8,10,2,109.48701,18.29021,1466
208278,D4451AAE094A43FD2A07E613CA7CF12F,30171,12,14,2,109.48458,18.27139,1463
208279,D4451AAE094A43FD2A07E613CA7CF12F,60501,15,17,2,109.48701,18.29021,1466
208280,D4451AAE094A43FD2A07E613CA7CF12F,30611,20,21,1,109.74958,18.40188,2485
208281,182D5101D28D51096306D4EF5FDD4501,30421,17,19,2,109.50021,18.25861,1511
208282,182D5101D28D51096306D4EF5FDD4501,38251,20,21,1,109.49618,18.25493,1510
208291,64EA917EAAD3EB55DA2ABB227203C131,30854,13,14,1,109.56889,18.27076,1763
208292,64EA917EAAD3EB55DA2ABB227203C131,60631,19,22,3,109.57778,18.27583,1814
208355,999DEB7BFC175BF03EAE5DB1D4B2EFB6,60361,2,7,5,109.51938,18.29681,1567
208356,999DEB7BFC175BF03EAE5DB1D4B2EFB6,30161,9,10,1,109.50042,18.24389,1508
208357,999DEB7BFC175BF03EAE5DB1D4B2EFB6,60361,12,17,5,109.51938,18.29681,1567
208358,999DEB7BFC175BF03EAE5DB1D4B2EFB6,31951,22,23,1,109.52174,18.30299,1568
208396,76DA946F4DC1318DD46A32E1D303D6B7,31931,0,7,7,109.54771,18.29403,1667
208397,76DA946F4DC1318DD46A32E1D303D6B7,39181,11,13,2,109.55153,18.28035,1715
208398,76DA946F4DC1318DD46A32E1D303D6B7,31931,16,23,7,109.54771,18.29403,1667
208405,975CB35586D2D95A387E2AA86A5AB719,31351,0,9,9,109.4959,18.28417,1465
208406,975CB35586D2D95A387E2AA86A5AB719,30671,10,22,12,109.43611,18.30139,1268
208413,8293619D825F160795AE71B17456FBCB,30854,0,1,1,109.56889,18.27076,1763
208414,8293619D825F160795AE71B17456FBCB,60631,1,2,1,109.57778,18.27583,1814
208415,8293619D825F160795AE71B17456FBCB,60211,3,6,3,109.63549,18.26049,2011
208416,8293619D825F160795AE71B17456FBCB,30854,9,23,14,109.56889,18.27076,1763
208435,491A112CD81B9085F752897809919691,31201,0,5,5,109.51042,18.23819,1558
208436,491A112CD81B9085F752897809919691,30181,7,8,1,109.51597,18.23313,1557
208437,491A112CD81B9085F752897809919691,30151,12,14,2,109.50986,18.25083,1560
208445,DD056101D68CBFC24096E8F587CC747C,30071,2,5,3,109.52819,18.30472,1619
208446,DD056101D68CBFC24096E8F587CC747C,31931,7,22,15,109.54771,18.29403,1667
208491,CD10EF600C408C94A1E83184DAC14278,30371,0,1,1,109.51,18.24771,1559
208492,CD10EF600C408C94A1E83184DAC14278,31521,2,11,9,109.51458,18.22542,1555
208493,CD10EF600C408C94A1E83184DAC14278,60381,11,13,2,109.5241,18.22458,1605
208494,97C31877CA4226D0F1BA1C0E12066B56,30251,0,6,6,109.50611,18.26653,1512
208495,97C31877CA4226D0F1BA1C0E12066B56,31561,9,13,4,109.56792,18.28479,1765
208496,97C31877CA4226D0F1BA1C0E12066B56,30854,13,17,4,109.56889,18.27076,1763
208497,97C31877CA4226D0F1BA1C0E12066B56,60331,22,23,1,109.505,18.26507,1512
208503,A549C024E6F63EDBD3DC866F10DB11CE,30234,0,5,5,109.60681,18.29979,1918
208504,A549C024E6F63EDBD3DC866F10DB11CE,30854,8,9,1,109.56889,18.27076,1763
208505,A549C024E6F63EDBD3DC866F10DB11CE,31945,12,13,1,109.58021,18.29403,1817
208506,A549C024E6F63EDBD3DC866F10DB11CE,30854,15,17,2,109.56889,18.27076,1763
208507,A549C024E6F63EDBD3DC866F10DB11CE,31071,17,21,4,109.58257,18.28458,1815
208508,A549C024E6F63EDBD3DC866F10DB11CE,30234,22,23,1,109.60681,18.29979,1918
208533,8C2A72A3EA8DBE7544B4A433B2BC3FE0,60261,0,14,14,109.44326,18.3075,1319
208534,8C2A72A3EA8DBE7544B4A433B2BC3FE0,60491,17,19,2,109.43354,18.30847,1269
208535,A749E400BFD3B5908671E939EC104DEE,31071,1,7,6,109.58257,18.28458,1815
208536,A749E400BFD3B5908671E939EC104DEE,30854,7,23,16,109.56889,18.27076,1763
208552,86435198F57620D5DAC23B4A4DA78009,31931,8,10,2,109.54771,18.29403,1667
208553,86435198F57620D5DAC23B4A4DA78009,39183,11,20,9,109.55542,18.28208,1715
208565,5AF4B6D21D340C22355F444305E9AFA1,31951,15,17,2,109.52174,18.30299,1568
208566,5AF4B6D21D340C22355F444305E9AFA1,30421,18,20,2,109.50021,18.25861,1511
208589,608A55C14BAB2A5B627ACC1F39B89FB6,31945,0,7,7,109.58021,18.29403,1817
208590,608A55C14BAB2A5B627ACC1F39B89FB6,31071,9,12,3,109.58257,18.28458,1815
208591,608A55C14BAB2A5B627ACC1F39B89FB6,31945,15,23,8,109.58021,18.29403,1817
208617,28413CB0160B68347E92144BE214EF48,60084,0,6,6,109.4984,18.2334,1507
208618,28413CB0160B68347E92144BE214EF48,30191,6,7,1,109.50361,18.22701,1506
208619,28413CB0160B68347E92144BE214EF48,30511,8,9,1,109.51069,18.24208,1558
208620,28413CB0160B68347E92144BE214EF48,60081,10,11,1,109.51097,18.22639,1556
208674,10EBF762D28520B09848288F7052CFDE,30854,0,6,6,109.56889,18.27076,1763
208675,10EBF762D28520B09848288F7052CFDE,31561,6,16,10,109.56792,18.28479,1765
208676,10EBF762D28520B09848288F7052CFDE,30854,17,23,6,109.56889,18.27076,1763
208681,D5C80E85989FC489DEFCCD6817C6F0CE,31031,0,7,7,109.49979,18.25382,1510
208682,D5C80E85989FC489DEFCCD6817C6F0CE,31864,12,14,2,109.49014,18.28333,1465
208683,D5C80E85989FC489DEFCCD6817C6F0CE,39151,19,23,4,109.49875,18.25097,1510
208690,6E6193514D8E876D83956A94AD4F3FB1,30921,18,21,3,109.53903,18.29451,1667
208691,6E6193514D8E876D83956A94AD4F3FB1,31931,21,23,2,109.54771,18.29403,1667
208697,C30EF1A03F3ACD87114629BE5EBA14E8,60552,0,7,7,109.41729,18.30014,1218
208698,C30EF1A03F3ACD87114629BE5EBA14E8,31231,9,10,1,109.42597,18.29292,1217
208699,C30EF1A03F3ACD87114629BE5EBA14E8,60041,11,13,2,109.39889,18.31944,1121
208700,C30EF1A03F3ACD87114629BE5EBA14E8,31231,15,16,1,109.42597,18.29292,1217
208701,C30EF1A03F3ACD87114629BE5EBA14E8,60552,18,20,2,109.41729,18.30014,1218
208705,66DAA2740440F603A26B0FC0D4309DF2,30071,0,8,8,109.52819,18.30472,1619
208706,66DAA2740440F603A26B0FC0D4309DF2,31931,10,23,13,109.54771,18.29403,1667
208734,182603D8C7C4BF5CDDF16B2E79D9DF52,30161,8,10,2,109.50042,18.24389,1508
208735,182603D8C7C4BF5CDDF16B2E79D9DF52,31231,13,17,4,109.42597,18.29292,1217
208760,1FDB2743111B6AD36C2D7C9496C22062,30821,19,21,2,109.43681,18.33639,1274
208761,1FDB2743111B6AD36C2D7C9496C22062,38951,21,23,2,109.48097,18.28868,1416
208799,B61666307486DD531F980787F0F8A7B7,31561,0,1,1,109.56792,18.28479,1765
208800,B61666307486DD531F980787F0F8A7B7,60631,4,19,15,109.57778,18.27583,1814
208804,949173524C1E5F3B9BD54D60F0306D0C,31561,0,6,6,109.56792,18.28479,1765
208805,949173524C1E5F3B9BD54D60F0306D0C,30711,8,13,5,109.50271,18.25347,1510
208806,949173524C1E5F3B9BD54D60F0306D0C,31071,17,18,1,109.58257,18.28458,1815
208807,949173524C1E5F3B9BD54D60F0306D0C,31071,20,23,3,109.58257,18.28458,1815
208829,6D0CBC29417959EBDF12F1FD604A5C61,31091,14,15,1,109.41201,18.31222,1170
208830,6D0CBC29417959EBDF12F1FD604A5C61,60661,19,23,4,109.548,18.2377,1657
208851,985A2EA61E10E912EF275486E93274F1,60201,0,3,3,109.5041,18.2509,1510
208852,985A2EA61E10E912EF275486E93274F1,39151,4,5,1,109.49875,18.25097,1510
208853,985A2EA61E10E912EF275486E93274F1,60201,6,7,1,109.5041,18.2509,1510
208854,985A2EA61E10E912EF275486E93274F1,31781,10,13,3,109.19847,18.2975,367
208855,985A2EA61E10E912EF275486E93274F1,31471,16,17,1,109.34583,18.29563,917
208856,985A2EA61E10E912EF275486E93274F1,30361,20,22,2,109.50347,18.24,1508
208857,2C5F898948A2B7909519666936FBF333,60341,0,4,4,109.70597,18.31778,2271
208858,2C5F898948A2B7909519666936FBF333,38707,8,23,15,109.73778,18.35368,2427
208897,C1372D8DF0C6109FD496E05E1E1566AD,30681,0,5,5,109.48493,18.26917,1463
208898,C1372D8DF0C6109FD496E05E1E1566AD,30171,6,8,2,109.48458,18.27139,1463
208899,C1372D8DF0C6109FD496E05E1E1566AD,38251,10,11,1,109.49618,18.25493,1510
208900,C1372D8DF0C6109FD496E05E1E1566AD,60401,14,16,2,109.47444,18.27583,1414
208901,C1372D8DF0C6109FD496E05E1E1566AD,30171,16,20,4,109.48458,18.27139,1463
208902,C1372D8DF0C6109FD496E05E1E1566AD,60401,21,23,2,109.47444,18.27583,1414
208937,0F558B6653C655C7F0BAEA9D66B33F57,31071,4,5,1,109.58257,18.28458,1815
208938,0F558B6653C655C7F0BAEA9D66B33F57,31071,8,9,1,109.58257,18.28458,1815
208939,0F558B6653C655C7F0BAEA9D66B33F57,30854,12,15,3,109.56889,18.27076,1763
208940,DC6FAC9E4085B298085CB0CDBEACDBC4,31101,15,17,2,109.65389,18.23403,2057
208941,DC6FAC9E4085B298085CB0CDBEACDBC4,60552,19,22,3,109.41729,18.30014,1218
208949,1026894DC5FF9A7FAF3A2EE28B95E239,30854,0,22,22,109.56889,18.27076,1763
208950,1026894DC5FF9A7FAF3A2EE28B95E239,39183,22,23,1,109.55542,18.28208,1715
208956,7421066246AAD1C230E7E2A7ADF06E9D,60631,3,7,4,109.57778,18.27583,1814
208957,7421066246AAD1C230E7E2A7ADF06E9D,30854,10,17,7,109.56889,18.27076,1763
208958,7421066246AAD1C230E7E2A7ADF06E9D,60381,20,22,2,109.5241,18.22458,1605
208965,A4823EEC9A8E697E80697432C029B488,60331,1,6,5,109.505,18.26507,1512
208966,A4823EEC9A8E697E80697432C029B488,30421,6,8,2,109.50021,18.25861,1511
208967,A4823EEC9A8E697E80697432C029B488,30391,12,13,1,109.4975,18.27118,1513
208968,A4823EEC9A8E697E80697432C029B488,31021,15,16,1,109.49021,18.27,1463
208969,A4823EEC9A8E697E80697432C029B488,31561,20,21,1,109.56792,18.28479,1765
209001,0A48A76A646C70DF6B9924881BA2168A,30071,0,6,6,109.52819,18.30472,1619
209002,0A48A76A646C70DF6B9924881BA2168A,31931,9,18,9,109.54771,18.29403,1667
209003,0A48A76A646C70DF6B9924881BA2168A,30071,19,23,4,109.52819,18.30472,1619
209008,417408FFDA93B177641D270D3A5C4B2D,31071,0,6,6,109.58257,18.28458,1815
209009,417408FFDA93B177641D270D3A5C4B2D,30854,6,15,9,109.56889,18.27076,1763
209010,417408FFDA93B177641D270D3A5C4B2D,31071,15,23,8,109.58257,18.28458,1815
209017,8394F4F81295DA567F75BB12D1616CF3,31521,15,16,1,109.51458,18.22542,1555
209018,8394F4F81295DA567F75BB12D1616CF3,30511,17,19,2,109.51069,18.24208,1558
209019,8394F4F81295DA567F75BB12D1616CF3,60361,19,23,4,109.51938,18.29681,1567
209056,8E74DEE1D6AD25525E0B9C766B9CBA47,31531,0,9,9,109.49583,18.25972,1461
209057,8E74DEE1D6AD25525E0B9C766B9CBA47,60614,12,13,1,109.48799,18.29521,1467
209058,8E74DEE1D6AD25525E0B9C766B9CBA47,30771,14,16,2,109.49938,18.26042,1511
209059,8E74DEE1D6AD25525E0B9C766B9CBA47,31091,18,20,2,109.41201,18.31222,1170
209060,8E74DEE1D6AD25525E0B9C766B9CBA47,30741,21,22,1,109.49833,18.28681,1516
209086,0A9117B90774715AACE2ED3045D6F579,60552,0,9,9,109.41729,18.30014,1218
209087,0A9117B90774715AACE2ED3045D6F579,31351,10,14,4,109.4959,18.28417,1465
209116,7BAE1D02C0D214D20907C3472A373B1E,31521,10,12,2,109.51458,18.22542,1555
209117,7BAE1D02C0D214D20907C3472A373B1E,30661,13,15,2,109.37028,18.24361,1008
209121,F866B6E34CEF853A6497211DD74A607E,30711,1,5,4,109.50271,18.25347,1510
209122,F866B6E34CEF853A6497211DD74A607E,30591,6,7,1,109.63021,18.3334,2023
209123,F866B6E34CEF853A6497211DD74A607E,60117,8,9,1,109.73604,18.35681,2427
209124,F866B6E34CEF853A6497211DD74A607E,30281,12,14,2,109.50597,18.27583,1514
209125,F866B6E34CEF853A6497211DD74A607E,30711,15,17,2,109.50271,18.25347,1510
209126,F866B6E34CEF853A6497211DD74A607E,31071,18,23,5,109.58257,18.28458,1815
209187,D2A5F87218CF25385163A2F3C4229CB8,31561,0,2,2,109.56792,18.28479,1765
209188,D2A5F87218CF25385163A2F3C4229CB8,30851,2,16,14,109.5616,18.27396,1713
209189,D2A5F87218CF25385163A2F3C4229CB8,31271,18,19,1,109.48958,18.26257,1462
209190,D2A5F87218CF25385163A2F3C4229CB8,31561,21,22,1,109.56792,18.28479,1765
209191,9EF4A95256B94781E773FD041E0B016F,38127,0,9,9,109.50833,18.27222,1513
209229,8DD23AA43C0F7967C45F7488D66F9159,31945,0,1,1,109.58021,18.29403,1817
209230,8DD23AA43C0F7967C45F7488D66F9159,31071,1,5,4,109.58257,18.28458,1815
209231,8DD23AA43C0F7967C45F7488D66F9159,30854,7,10,3,109.56889,18.27076,1763
209232,8DD23AA43C0F7967C45F7488D66F9159,31945,12,14,2,109.58021,18.29403,1817
209233,BCC8232F5CE277D549F349BCFC9101AB,30711,0,9,9,109.50271,18.25347,1510
209234,BCC8232F5CE277D549F349BCFC9101AB,30711,13,16,3,109.50271,18.25347,1510
209235,BCC8232F5CE277D549F349BCFC9101AB,30711,18,20,2,109.50271,18.25347,1510
209236,BCC8232F5CE277D549F349BCFC9101AB,30421,20,21,1,109.50021,18.25861,1511
209237,BCC8232F5CE277D549F349BCFC9101AB,30711,21,23,2,109.50271,18.25347,1510
209259,147470AD3D3B8724582C30D5F244A8B6,60421,0,8,8,109.46333,18.31743,1371
209260,147470AD3D3B8724582C30D5F244A8B6,30111,8,10,2,109.47583,18.30542,1419
209261,147470AD3D3B8724582C30D5F244A8B6,60421,11,22,11,109.46333,18.31743,1371
209319,A509D0CA53CD767E0234236B42930030,38094,0,8,8,109.45403,18.28778,1316
209320,A509D0CA53CD767E0234236B42930030,31781,9,12,3,109.19847,18.2975,367
209321,A509D0CA53CD767E0234236B42930030,60054,13,15,2,109.3016,18.31229,770
209322,A509D0CA53CD767E0234236B42930030,38094,19,23,4,109.45403,18.28778,1316
209364,BC2EDF4DF9C7FAD55BDEABA03DFA7284,31561,0,6,6,109.56792,18.28479,1765
209365,BC2EDF4DF9C7FAD55BDEABA03DFA7284,30854,6,8,2,109.56889,18.27076,1763
209366,BC2EDF4DF9C7FAD55BDEABA03DFA7284,31561,10,13,3,109.56792,18.28479,1765
209367,BC2EDF4DF9C7FAD55BDEABA03DFA7284,39181,13,15,2,109.55153,18.28035,1715
209368,C85D0B931BEF54F05B9ABBBB03212DB7,31561,4,18,14,109.56792,18.28479,1765
209369,C85D0B931BEF54F05B9ABBBB03212DB7,30854,20,22,2,109.56889,18.27076,1763
209413,3A887AE7038DEACD71C8879078F4404A,30151,0,13,13,109.50986,18.25083,1560
209414,3A887AE7038DEACD71C8879078F4404A,38094,16,17,1,109.45403,18.28778,1316
209415,3A887AE7038DEACD71C8879078F4404A,31821,20,23,3,109.51181,18.24924,1559
209468,740A252E141CF3F62997C00883EFD2C6,31101,0,2,2,109.65389,18.23403,2057
209469,740A252E141CF3F62997C00883EFD2C6,38052,5,7,2,109.62618,18.23042,1956
209470,740A252E141CF3F62997C00883EFD2C6,60594,9,10,1,109.62694,18.22799,1956
209471,740A252E141CF3F62997C00883EFD2C6,38052,14,16,2,109.62618,18.23042,1956
209472,740A252E141CF3F62997C00883EFD2C6,38331,19,22,3,109.62465,18.22736,1956
209482,E58F7930139B2ED51DE79005F05C056D,39181,3,15,12,109.55153,18.28035,1715
209483,E58F7930139B2ED51DE79005F05C056D,39183,16,18,2,109.55542,18.28208,1715
209484,E58F7930139B2ED51DE79005F05C056D,31561,21,23,2,109.56792,18.28479,1765
209491,856FED43C24F39C7284040D716161D86,31081,0,9,9,109.44639,18.30181,1318
209492,856FED43C24F39C7284040D716161D86,38754,11,12,1,109.74667,18.37382,2430
209493,856FED43C24F39C7284040D716161D86,30731,17,18,1,109.50944,18.22306,1555
209494,856FED43C24F39C7284040D716161D86,31701,19,21,2,109.44132,18.28833,1266
209495,856FED43C24F39C7284040D716161D86,31081,22,23,1,109.44639,18.30181,1318
209513,402581B1124C1361D0FBA391D98CFB5F,33051,12,14,2,109.6475,18.46618,2096
209526,2A6BA0678DDF16AF08BAC9E3FA3C9391,30854,0,1,1,109.56889,18.27076,1763
209527,2A6BA0678DDF16AF08BAC9E3FA3C9391,31561,2,7,5,109.56792,18.28479,1765
209528,2A6BA0678DDF16AF08BAC9E3FA3C9391,30854,9,18,9,109.56889,18.27076,1763
209556,62FCB15297A7724012720DDE29CC0405,31145,13,15,2,109.20431,18.30479,369
209557,62FCB15297A7724012720DDE29CC0405,60571,18,21,3,109.50722,18.25056,1510
209558,62FCB15297A7724012720DDE29CC0405,31761,22,23,1,109.60521,18.27965,1914
209573,C90A127FC935FC5139F523C5C932A70E,38017,0,9,9,109.49729,18.21424,1504
209574,C90A127FC935FC5139F523C5C932A70E,31781,12,14,2,109.19847,18.2975,367
209575,C90A127FC935FC5139F523C5C932A70E,38017,19,22,3,109.49729,18.21424,1504
209589,864183CB94ABE5E80322CE852D5C129B,60084,0,7,7,109.4984,18.2334,1507
209590,864183CB94ABE5E80322CE852D5C129B,31781,9,11,2,109.19847,18.2975,367
209591,864183CB94ABE5E80322CE852D5C129B,30211,14,15,1,109.49882,18.23931,1508
209592,864183CB94ABE5E80322CE852D5C129B,60084,18,20,2,109.4984,18.2334,1507
209593,864183CB94ABE5E80322CE852D5C129B,31521,20,21,1,109.51458,18.22542,1555
209597,18EE47452FD5BE7C01D5DBC710576D9F,60274,17,23,6,109.514,18.2933,1567
209607,0D7FD96B164D7D9CD6D0D8B8C05CAF7C,31081,19,21,2,109.44639,18.30181,1318
209608,0D7FD96B164D7D9CD6D0D8B8C05CAF7C,60491,21,22,1,109.43354,18.30847,1269
209634,005F3AEFE6DBF371ED1FD57736434098,31071,0,7,7,109.58257,18.28458,1815
209635,005F3AEFE6DBF371ED1FD57736434098,30854,8,10,2,109.56889,18.27076,1763
209636,005F3AEFE6DBF371ED1FD57736434098,31071,11,12,1,109.58257,18.28458,1815
209637,005F3AEFE6DBF371ED1FD57736434098,30854,18,20,2,109.56889,18.27076,1763
209638,005F3AEFE6DBF371ED1FD57736434098,31071,20,22,2,109.58257,18.28458,1815
209665,E8A62C362548F9D5791FD06549C42092,60054,0,10,10,109.3016,18.31229,770
209666,E8A62C362548F9D5791FD06549C42092,30661,10,11,1,109.37028,18.24361,1008
209667,E8A62C362548F9D5791FD06549C42092,60054,11,23,12,109.3016,18.31229,770
209678,34F3D64B41C252481F72E5CF931AC833,30851,0,12,12,109.5616,18.27396,1713
209679,34F3D64B41C252481F72E5CF931AC833,31071,16,19,3,109.58257,18.28458,1815
209680,A249BB92E18839D454C438B797D69714,60261,0,7,7,109.44326,18.3075,1319
209681,A249BB92E18839D454C438B797D69714,60491,11,13,2,109.43354,18.30847,1269
209682,A249BB92E18839D454C438B797D69714,60261,17,19,2,109.44326,18.3075,1319
209708,769D7D978DB2A1F24C6E03C572F6F52F,38361,0,9,9,109.43667,18.29201,1267
209709,769D7D978DB2A1F24C6E03C572F6F52F,30731,13,17,4,109.50944,18.22306,1555
209710,769D7D978DB2A1F24C6E03C572F6F52F,38361,18,23,5,109.43667,18.29201,1267
209733,00C9D9AB8C31F2634E8E8174C9C57D7E,30181,0,8,8,109.51597,18.23313,1557
209734,00C9D9AB8C31F2634E8E8174C9C57D7E,31781,13,15,2,109.19847,18.2975,367
209735,00C9D9AB8C31F2634E8E8174C9C57D7E,30181,20,23,3,109.51597,18.23313,1557
209757,BD1C8CAB0CA377D9350002A865081450,30251,0,13,13,109.50611,18.26653,1512
209758,BD1C8CAB0CA377D9350002A865081450,31021,15,20,5,109.49021,18.27,1463
209759,ABCD0851CC1C78BCD7AF6DBDF2F5DE49,60551,0,2,2,109.42722,18.30111,1218
209760,ABCD0851CC1C78BCD7AF6DBDF2F5DE49,60552,5,19,14,109.41729,18.30014,1218
209761,B48CF6FA27E864933632BDC922A5DB6B,31781,14,15,1,109.19847,18.2975,367
209762,B48CF6FA27E864933632BDC922A5DB6B,31031,18,22,4,109.49979,18.25382,1510
209786,17A4545370685D172A08774EFEF86DD3,30851,0,1,1,109.5616,18.27396,1713
209787,17A4545370685D172A08774EFEF86DD3,31071,1,2,1,109.58257,18.28458,1815
209788,17A4545370685D172A08774EFEF86DD3,30851,5,7,2,109.5616,18.27396,1713
209789,17A4545370685D172A08774EFEF86DD3,39181,9,15,6,109.55153,18.28035,1715
209811,F61486EBE9C0037CE6ECF4E72C7FFAB0,38117,0,6,6,109.51611,18.22354,1555
209812,F61486EBE9C0037CE6ECF4E72C7FFAB0,30731,6,8,2,109.50944,18.22306,1555
209813,F61486EBE9C0037CE6ECF4E72C7FFAB0,31521,9,15,6,109.51458,18.22542,1555
209814,F61486EBE9C0037CE6ECF4E72C7FFAB0,31521,19,21,2,109.51458,18.22542,1555
209822,BA22E9DF5AF7E43CF73CB10FC8453FF1,30854,8,11,3,109.56889,18.27076,1763
209823,BA22E9DF5AF7E43CF73CB10FC8453FF1,31071,12,14,2,109.58257,18.28458,1815
209824,BA22E9DF5AF7E43CF73CB10FC8453FF1,39091,16,18,2,109.50097,18.25222,1510
209825,BA22E9DF5AF7E43CF73CB10FC8453FF1,31071,20,22,2,109.58257,18.28458,1815
209826,04874B86EA4291E8B43131C5ED885BE2,33481,9,11,2,109.67278,18.41278,2187
209827,04874B86EA4291E8B43131C5ED885BE2,33051,15,17,2,109.6475,18.46618,2096
209828,04874B86EA4291E8B43131C5ED885BE2,30854,20,21,1,109.56889,18.27076,1763
209832,37B1280251A3C52411E939549A58D078,39183,0,14,14,109.55542,18.28208,1715
209833,37B1280251A3C52411E939549A58D078,39181,16,17,1,109.55153,18.28035,1715
209834,37B1280251A3C52411E939549A58D078,39183,18,23,5,109.55542,18.28208,1715
209846,B643AC77F8D8498A9694D45BA8B0F75F,60631,1,7,6,109.57778,18.27583,1814
209847,B643AC77F8D8498A9694D45BA8B0F75F,30854,8,11,3,109.56889,18.27076,1763
209848,B643AC77F8D8498A9694D45BA8B0F75F,60631,13,16,3,109.57778,18.27583,1814
209849,B643AC77F8D8498A9694D45BA8B0F75F,31561,20,22,2,109.56792,18.28479,1765
209882,CE70D3AAC3EF6B01DB8A5F34BD94E77D,30821,0,13,13,109.43681,18.33639,1274
209883,CE70D3AAC3EF6B01DB8A5F34BD94E77D,30651,13,15,2,109.42611,18.385,1232
209884,CE70D3AAC3EF6B01DB8A5F34BD94E77D,30821,16,22,6,109.43681,18.33639,1274
209885,CE70D3AAC3EF6B01DB8A5F34BD94E77D,30651,22,23,1,109.42611,18.385,1232
209927,B584ECCE32EE4C49FF68F8E796132301,31531,0,1,1,109.49583,18.25972,1461
209928,B584ECCE32EE4C49FF68F8E796132301,30721,1,13,12,109.51597,18.28257,1565
209956,27BCEF3137923B84211F08830816C810,61011,16,17,1,109.60653,18.19076,1900
209957,27BCEF3137923B84211F08830816C810,30851,18,20,2,109.5616,18.27396,1713
209966,5426296000364EE32711CD0E73D782C8,60421,14,17,3,109.46333,18.31743,1371
209967,5426296000364EE32711CD0E73D782C8,30741,18,19,1,109.49833,18.28681,1516
209977,2361E8D6BAB0231B2E8E3C0F34517282,30291,0,7,7,109.50403,18.27028,1513
209978,2361E8D6BAB0231B2E8E3C0F34517282,60501,9,11,2,109.48701,18.29021,1466
209979,2361E8D6BAB0231B2E8E3C0F34517282,60334,12,17,5,109.50215,18.26458,1512
209980,2361E8D6BAB0231B2E8E3C0F34517282,60331,18,19,1,109.505,18.26507,1512
209981,2361E8D6BAB0231B2E8E3C0F34517282,30291,19,22,3,109.50403,18.27028,1513
209982,439C404954398764464D854D76F475D8,30321,15,16,1,109.49563,18.29611,1467
209983,439C404954398764464D854D76F475D8,31864,19,20,1,109.49014,18.28333,1465
209984,439C404954398764464D854D76F475D8,31861,22,23,1,109.49042,18.27549,1464
210004,42208654DD68D689FEE2FABD4C7FC956,30051,2,3,1,109.48917,18.21215,1453
210005,42208654DD68D689FEE2FABD4C7FC956,30511,6,7,1,109.51069,18.24208,1558
210006,42208654DD68D689FEE2FABD4C7FC956,30361,11,13,2,109.50347,18.24,1508
210042,4E94ADAE7ABEB20EEFAF67519DFCC1BE,31081,0,9,9,109.44639,18.30181,1318
210043,4E94ADAE7ABEB20EEFAF67519DFCC1BE,31031,9,21,12,109.49979,18.25382,1510
210077,3980EAA193EA22B4F7FBFB486C5AD1BA,30111,0,6,6,109.47583,18.30542,1419
210078,3980EAA193EA22B4F7FBFB486C5AD1BA,30241,8,9,1,109.26174,18.3275,622
210079,3980EAA193EA22B4F7FBFB486C5AD1BA,31781,10,12,2,109.19847,18.2975,367
210090,00FD2268DE6E83934D2916174E81532F,30761,18,20,2,109.45201,18.3,1318
210091,00FD2268DE6E83934D2916174E81532F,30111,21,22,1,109.47583,18.30542,1419
210119,B87EA32D7A8C628CB2B89E95996DDE3E,60371,0,7,7,109.53063,18.30056,1618
210120,B87EA32D7A8C628CB2B89E95996DDE3E,31931,8,15,7,109.54771,18.29403,1667
210121,B87EA32D7A8C628CB2B89E95996DDE3E,30854,16,17,1,109.56889,18.27076,1763
210135,22130435C432F057AB9DDA7C1A223C66,60084,0,7,7,109.4984,18.2334,1507
210136,22130435C432F057AB9DDA7C1A223C66,30051,8,11,3,109.48917,18.21215,1453
210137,22130435C432F057AB9DDA7C1A223C66,38251,11,13,2,109.49618,18.25493,1510
210138,22130435C432F057AB9DDA7C1A223C66,31471,15,16,1,109.34583,18.29563,917
210139,22130435C432F057AB9DDA7C1A223C66,60084,21,23,2,109.4984,18.2334,1507
210143,B340EDEF4A878E8DF5CBEC25E465EACE,30854,0,2,2,109.56889,18.27076,1763
210144,B340EDEF4A878E8DF5CBEC25E465EACE,60354,4,8,4,109.58701,18.28521,1815
210145,B340EDEF4A878E8DF5CBEC25E465EACE,30854,9,23,14,109.56889,18.27076,1763
210164,F198CAA1F49ACA5D003FD8F8473B3798,31071,1,14,13,109.58257,18.28458,1815
210165,F198CAA1F49ACA5D003FD8F8473B3798,30854,14,20,6,109.56889,18.27076,1763
210166,F198CAA1F49ACA5D003FD8F8473B3798,30191,21,22,1,109.50361,18.22701,1506
210179,9FD9B533440DEDA093A3D6D9A5E4AA42,31945,3,7,4,109.58021,18.29403,1817
210180,9FD9B533440DEDA093A3D6D9A5E4AA42,60361,11,14,3,109.51938,18.29681,1567
210181,9FD9B533440DEDA093A3D6D9A5E4AA42,31945,17,20,3,109.58021,18.29403,1817
210182,9FD9B533440DEDA093A3D6D9A5E4AA42,60361,21,22,1,109.51938,18.29681,1567
210229,7334BFE245C0E1675EC3C07645407CF3,31121,0,2,2,109.16292,18.37063,230
210230,7334BFE245C0E1675EC3C07645407CF3,31541,3,5,2,109.1809,18.36722,329
210231,7334BFE245C0E1675EC3C07645407CF3,60411,7,12,5,109.32514,18.30854,869
210232,7334BFE245C0E1675EC3C07645407CF3,30661,13,16,3,109.37028,18.24361,1008
210233,7334BFE245C0E1675EC3C07645407CF3,60411,16,18,2,109.32514,18.30854,869
210234,7334BFE245C0E1675EC3C07645407CF3,31121,18,21,3,109.16292,18.37063,230
210249,C7A58F45156649A612134237290C5B69,30821,0,8,8,109.43681,18.33639,1274
210250,C7A58F45156649A612134237290C5B69,31081,9,11,2,109.44639,18.30181,1318
210251,C7A58F45156649A612134237290C5B69,30651,14,16,2,109.42611,18.385,1232
210252,C7A58F45156649A612134237290C5B69,30821,16,18,2,109.43681,18.33639,1274
210253,C7A58F45156649A612134237290C5B69,31081,20,21,1,109.44639,18.30181,1318
210254,C7A58F45156649A612134237290C5B69,30821,21,23,2,109.43681,18.33639,1274
210261,1D2F8DB1F8B6A2081E1A43DDF558491D,31951,11,14,3,109.52174,18.30299,1568
210262,1D2F8DB1F8B6A2081E1A43DDF558491D,60361,15,16,1,109.51938,18.29681,1567
210263,1D2F8DB1F8B6A2081E1A43DDF558491D,31951,16,23,7,109.52174,18.30299,1568
210264,8C5A16299A6D294198C90C34C25C5949,30854,13,14,1,109.56889,18.27076,1763
210265,8C5A16299A6D294198C90C34C25C5949,39183,15,17,2,109.55542,18.28208,1715
210266,8C5A16299A6D294198C90C34C25C5949,31561,17,18,1,109.56792,18.28479,1765
210306,01C2118F7C72B72DC3ED114C4AC903DC,60401,0,8,8,109.47444,18.27583,1414
210307,01C2118F7C72B72DC3ED114C4AC903DC,60552,8,10,2,109.41729,18.30014,1218
210311,10A38EAB1548E22B36293FDAA86FC250,31071,0,8,8,109.58257,18.28458,1815
210312,10A38EAB1548E22B36293FDAA86FC250,30361,12,13,1,109.50347,18.24,1508
210342,F3CFDDD39C8B8B5FE5E615E3E5F400DF,30181,0,8,8,109.51597,18.23313,1557
210343,F3CFDDD39C8B8B5FE5E615E3E5F400DF,60171,10,11,1,109.51292,18.30694,1569
210344,F3CFDDD39C8B8B5FE5E615E3E5F400DF,39111,14,16,2,109.5191,18.22597,1555
210345,F3CFDDD39C8B8B5FE5E615E3E5F400DF,31521,18,21,3,109.51458,18.22542,1555
210346,F3CFDDD39C8B8B5FE5E615E3E5F400DF,30511,21,23,2,109.51069,18.24208,1558
210400,2D39AE6120F2674000C6DBB8A6E572A0,31945,0,7,7,109.58021,18.29403,1817
210401,2D39AE6120F2674000C6DBB8A6E572A0,30854,10,21,11,109.56889,18.27076,1763
210409,0DB031C0FC798B5BDEAA8EA2CB39B9C0,30711,12,13,1,109.50271,18.25347,1510
210410,0DB031C0FC798B5BDEAA8EA2CB39B9C0,31521,14,15,1,109.51458,18.22542,1555
210411,0DB031C0FC798B5BDEAA8EA2CB39B9C0,31521,19,20,1,109.51458,18.22542,1555
210412,0DB031C0FC798B5BDEAA8EA2CB39B9C0,31521,21,23,2,109.51458,18.22542,1555
210421,44F505B3929E26B4B29F00CC284F3084,60631,2,8,6,109.57778,18.27583,1814
210422,44F505B3929E26B4B29F00CC284F3084,30854,11,18,7,109.56889,18.27076,1763
210423,44F505B3929E26B4B29F00CC284F3084,31071,18,21,3,109.58257,18.28458,1815
210424,770A00BDAFE9BCA8C9E9FA68066EED7D,31071,0,6,6,109.58257,18.28458,1815
210425,770A00BDAFE9BCA8C9E9FA68066EED7D,31561,9,17,8,109.56792,18.28479,1765
210426,770A00BDAFE9BCA8C9E9FA68066EED7D,31071,21,23,2,109.58257,18.28458,1815
210441,C1F9914EF577AE2A8300B1A3945A50FF,31561,0,2,2,109.56792,18.28479,1765
210442,C1F9914EF577AE2A8300B1A3945A50FF,30851,3,20,17,109.5616,18.27396,1713
210447,21EA50B7F2072F2024B9F3B7B9174B94,30021,7,11,4,109.12014,18.40986,86
210448,21EA50B7F2072F2024B9F3B7B9174B94,30911,12,14,2,109.50493,18.26181,1511
210455,1F75615E1DADB7B28D1F65C84D87DC7F,38241,15,18,3,109.54111,18.30542,1669
210456,1F75615E1DADB7B28D1F65C84D87DC7F,31031,19,21,2,109.49979,18.25382,1510
210483,22328E79B5A8943E5A27CE35499D706B,38251,0,8,8,109.49618,18.25493,1510
210484,22328E79B5A8943E5A27CE35499D706B,60274,9,10,1,109.514,18.2933,1567
210485,22328E79B5A8943E5A27CE35499D706B,38127,11,12,1,109.50833,18.27222,1513
210486,22328E79B5A8943E5A27CE35499D706B,60274,14,16,2,109.514,18.2933,1567
210493,3BB007FDF28DB0E7E883BA594F721FFE,31181,0,1,1,109.50382,18.24813,1509
210494,3BB007FDF28DB0E7E883BA594F721FFE,39151,1,6,5,109.49875,18.25097,1510
210495,3BB007FDF28DB0E7E883BA594F721FFE,31181,7,11,4,109.50382,18.24813,1509
210496,3BB007FDF28DB0E7E883BA594F721FFE,30561,12,14,2,109.52778,18.31938,1621
210521,D3FB1B9D3C241050E5FB29B7C0AA31BE,31611,0,6,6,109.63076,18.34944,2026
210522,D3FB1B9D3C241050E5FB29B7C0AA31BE,31061,8,20,12,109.53333,18.23257,1607
210523,D3FB1B9D3C241050E5FB29B7C0AA31BE,31611,22,23,1,109.63076,18.34944,2026
210576,9FEA4B85EAE4FAEE1CAF0EABFF2FAEA1,31561,0,5,5,109.56792,18.28479,1765
210577,9FEA4B85EAE4FAEE1CAF0EABFF2FAEA1,39183,7,8,1,109.55542,18.28208,1715
210578,9FEA4B85EAE4FAEE1CAF0EABFF2FAEA1,31561,12,13,1,109.56792,18.28479,1765
210579,9FEA4B85EAE4FAEE1CAF0EABFF2FAEA1,39183,13,16,3,109.55542,18.28208,1715
210580,9FEA4B85EAE4FAEE1CAF0EABFF2FAEA1,31561,19,21,2,109.56792,18.28479,1765
210585,32A3CE1C280040E7ED0898AB2CE878E8,38165,0,12,12,109.44847,18.28896,1316
210586,32A3CE1C280040E7ED0898AB2CE878E8,31181,13,14,1,109.50382,18.24813,1509
210587,32A3CE1C280040E7ED0898AB2CE878E8,38071,17,18,1,109.40722,18.30938,1169
210601,474C69A25C5BE237EAB7C712686B73B1,60401,0,4,4,109.47444,18.27583,1414
210602,474C69A25C5BE237EAB7C712686B73B1,38951,6,8,2,109.48097,18.28868,1416
210603,474C69A25C5BE237EAB7C712686B73B1,31145,12,14,2,109.20431,18.30479,369
210604,474C69A25C5BE237EAB7C712686B73B1,31471,15,17,2,109.34583,18.29563,917
210605,474C69A25C5BE237EAB7C712686B73B1,30821,20,21,1,109.43681,18.33639,1274
210622,D771BADDFC8F8EC32B8C9D302A579CF4,60084,19,20,1,109.4984,18.2334,1507
210623,D771BADDFC8F8EC32B8C9D302A579CF4,30731,21,22,1,109.50944,18.22306,1555
210636,2A177ADF4F6516EDDF22425D74B17CFB,60221,0,5,5,109.52569,18.29188,1616
210639,D0D16C12E8B96689EDFBB50650CC1F5C,60381,2,3,1,109.5241,18.22458,1605
210640,D0D16C12E8B96689EDFBB50650CC1F5C,38117,4,7,3,109.51611,18.22354,1555
210641,D0D16C12E8B96689EDFBB50650CC1F5C,31781,11,13,2,109.19847,18.2975,367
210642,D0D16C12E8B96689EDFBB50650CC1F5C,38291,18,20,2,109.51618,18.24313,1558
210643,D0D16C12E8B96689EDFBB50650CC1F5C,31521,20,23,3,109.51458,18.22542,1555
210658,94C4D5691F7DFC1AB38806AFFAC1389E,30921,1,11,10,109.53903,18.29451,1667
210659,94C4D5691F7DFC1AB38806AFFAC1389E,31931,13,14,1,109.54771,18.29403,1667
210660,94C4D5691F7DFC1AB38806AFFAC1389E,30921,16,18,2,109.53903,18.29451,1667
210661,94C4D5691F7DFC1AB38806AFFAC1389E,31931,20,23,3,109.54771,18.29403,1667
210716,E191BF114A3C2277CB7C3323BAA13F43,31561,8,10,2,109.56792,18.28479,1765
210717,E191BF114A3C2277CB7C3323BAA13F43,30854,11,23,12,109.56889,18.27076,1763
210725,9FC721E86703223349C05C95FE4BBB6F,60081,0,8,8,109.51097,18.22639,1556
210726,9FC721E86703223349C05C95FE4BBB6F,60381,13,20,7,109.5241,18.22458,1605
210727,9FC721E86703223349C05C95FE4BBB6F,60087,21,23,2,109.50688,18.22299,1505
210735,B81DEDE33B0853E35D97557F334A4861,60361,0,5,5,109.51938,18.29681,1567
210736,B81DEDE33B0853E35D97557F334A4861,31931,8,18,10,109.54771,18.29403,1667
210737,B81DEDE33B0853E35D97557F334A4861,60361,19,23,4,109.51938,18.29681,1567
210746,289060A56CDB4D33EB944FB1093FD036,33481,12,14,2,109.67278,18.41278,2187
210747,289060A56CDB4D33EB944FB1093FD036,30581,15,16,1,109.62257,18.24951,1959
210759,A68637AA89BD62624E677D9E66C32FAD,31461,0,8,8,109.5091,18.25389,1510
210760,A68637AA89BD62624E677D9E66C32FAD,30161,8,17,9,109.50042,18.24389,1508
210761,A68637AA89BD62624E677D9E66C32FAD,30361,19,23,4,109.50347,18.24,1508
210786,CFCFA94681CDD57855D6405C244168DD,31201,3,11,8,109.51042,18.23819,1558
210787,CFCFA94681CDD57855D6405C244168DD,38891,12,18,6,109.51486,18.24118,1558
210788,CFCFA94681CDD57855D6405C244168DD,31821,21,22,1,109.51181,18.24924,1559
210859,3389A095460231D31BA622B7185D6321,60552,0,2,2,109.41729,18.30014,1218
210860,3389A095460231D31BA622B7185D6321,31681,6,17,11,109.40396,18.29979,1168
210861,3389A095460231D31BA622B7185D6321,60552,18,20,2,109.41729,18.30014,1218
210862,3389A095460231D31BA622B7185D6321,31231,22,23,1,109.42597,18.29292,1217
210928,90B0A60855A43B2DB99A0964CE51D3AF,30854,16,17,1,109.56889,18.27076,1763
210929,90B0A60855A43B2DB99A0964CE51D3AF,31071,17,20,3,109.58257,18.28458,1815
210930,90B0A60855A43B2DB99A0964CE51D3AF,30234,21,22,1,109.60681,18.29979,1918
210942,35C83AAA1A53416FB80F07AE6FF8EDFD,60331,0,2,2,109.505,18.26507,1512
210943,35C83AAA1A53416FB80F07AE6FF8EDFD,30771,6,7,1,109.49938,18.26042,1511
210944,35C83AAA1A53416FB80F07AE6FF8EDFD,30241,8,10,2,109.26174,18.3275,622
210945,35C83AAA1A53416FB80F07AE6FF8EDFD,31781,12,13,1,109.19847,18.2975,367
210962,51B9FE31A6261A2E6FE900B23D8E8A33,60391,0,17,17,109.47667,18.28757,1416
210963,51B9FE31A6261A2E6FE900B23D8E8A33,30741,20,21,1,109.49833,18.28681,1516
210964,51B9FE31A6261A2E6FE900B23D8E8A33,60391,22,23,1,109.47667,18.28757,1416
210971,60ACD2B6657BEEA3D1B558DE71329F84,60311,0,8,8,109.52097,18.24319,1558
210972,60ACD2B6657BEEA3D1B558DE71329F84,30271,11,16,5,109.49132,18.23153,1456
210973,60ACD2B6657BEEA3D1B558DE71329F84,60311,20,23,3,109.52097,18.24319,1558
210976,DF34F38BEE4872598B76E0C6734B5964,30121,0,9,9,109.52861,18.27222,1613
210977,DF34F38BEE4872598B76E0C6734B5964,60241,14,15,1,109.53319,18.28667,1616
210978,DF34F38BEE4872598B76E0C6734B5964,31931,18,23,5,109.54771,18.29403,1667
211033,122D07F80E4FAC68FAE7EDBB2DF1AFA3,60631,2,5,3,109.57778,18.27583,1814
211034,122D07F80E4FAC68FAE7EDBB2DF1AFA3,30854,9,11,2,109.56889,18.27076,1763
211035,122D07F80E4FAC68FAE7EDBB2DF1AFA3,31071,13,14,1,109.58257,18.28458,1815
211036,122D07F80E4FAC68FAE7EDBB2DF1AFA3,30854,15,18,3,109.56889,18.27076,1763
211059,00145806BBF2F60A963743509F901155,60331,1,6,5,109.505,18.26507,1512
211060,00145806BBF2F60A963743509F901155,38157,6,15,9,109.51483,18.26958,1563
211061,00145806BBF2F60A963743509F901155,30291,16,19,3,109.50403,18.27028,1513
211062,00145806BBF2F60A963743509F901155,60331,21,22,1,109.505,18.26507,1512
211065,97DFCEF20461204135ADC6D971200EB4,31091,22,23,1,109.41201,18.31222,1170
211086,47A18820FDA9856131F74091D44B6BCB,31561,0,7,7,109.56792,18.28479,1765
211087,47A18820FDA9856131F74091D44B6BCB,31071,12,13,1,109.58257,18.28458,1815
211088,47A18820FDA9856131F74091D44B6BCB,31561,14,23,9,109.56792,18.28479,1765
211098,B7EDD7EF574DDD321F8378E2BE84CCD6,33051,15,17,2,109.6475,18.46618,2096
211099,B7EDD7EF574DDD321F8378E2BE84CCD6,30854,20,21,1,109.56889,18.27076,1763
211127,F5A39DF146F73F37BA63CAB6EB58C447,31071,0,7,7,109.58257,18.28458,1815
211128,F5A39DF146F73F37BA63CAB6EB58C447,31031,7,10,3,109.49979,18.25382,1510
211129,F5A39DF146F73F37BA63CAB6EB58C447,30711,10,14,4,109.50271,18.25347,1510
211130,F5A39DF146F73F37BA63CAB6EB58C447,31071,16,23,7,109.58257,18.28458,1815
211131,2A028F9A0AC84A80514E52694F20F378,38991,0,6,6,109.52681,18.30368,1618
211132,2A028F9A0AC84A80514E52694F20F378,31931,6,12,6,109.54771,18.29403,1667
211133,2A028F9A0AC84A80514E52694F20F378,31561,14,16,2,109.56792,18.28479,1765
211134,2A028F9A0AC84A80514E52694F20F378,30921,17,18,1,109.53903,18.29451,1667
211135,2A028F9A0AC84A80514E52694F20F378,30071,21,23,2,109.52819,18.30472,1619
211142,E8F8C6C52075F75066BCDBFD2FA15D47,31071,0,6,6,109.58257,18.28458,1815
211143,E8F8C6C52075F75066BCDBFD2FA15D47,30731,9,17,8,109.50944,18.22306,1555
211144,E8F8C6C52075F75066BCDBFD2FA15D47,30854,19,22,3,109.56889,18.27076,1763
211240,8E06EAC16B0EF776FA1BAAC5B9747325,30511,0,7,7,109.51069,18.24208,1558
211241,8E06EAC16B0EF776FA1BAAC5B9747325,60201,11,12,1,109.5041,18.2509,1510
211242,8E06EAC16B0EF776FA1BAAC5B9747325,30511,12,23,11,109.51069,18.24208,1558
211249,84DF4A7C208235D171EF56473BCCF210,30851,1,4,3,109.5616,18.27396,1713
211250,84DF4A7C208235D171EF56473BCCF210,31561,4,6,2,109.56792,18.28479,1765
211251,84DF4A7C208235D171EF56473BCCF210,31411,6,8,2,109.5016,18.23576,1507
211252,84DF4A7C208235D171EF56473BCCF210,60631,10,19,9,109.57778,18.27583,1814
211253,84DF4A7C208235D171EF56473BCCF210,31071,19,20,1,109.58257,18.28458,1815
211263,2873D39E7EAE4EB9FF7882E90907EED7,30764,13,16,3,109.45806,18.29486,1367
211264,2873D39E7EAE4EB9FF7882E90907EED7,30111,16,23,7,109.47583,18.30542,1419
211275,015CDEB9169BCE5537ABAE49B6A63F2B,31071,0,7,7,109.58257,18.28458,1815
211276,015CDEB9169BCE5537ABAE49B6A63F2B,30854,10,11,1,109.56889,18.27076,1763
211277,015CDEB9169BCE5537ABAE49B6A63F2B,60114,15,16,1,109.73028,18.33847,2374
211278,015CDEB9169BCE5537ABAE49B6A63F2B,31071,17,19,2,109.58257,18.28458,1815
211279,015CDEB9169BCE5537ABAE49B6A63F2B,30854,20,22,2,109.56889,18.27076,1763
211292,7E5829ED545598C52143FC1F86559D63,30861,0,6,6,109.52722,18.22743,1606
211293,7E5829ED545598C52143FC1F86559D63,31091,8,10,2,109.41201,18.31222,1170
211295,7E5829ED545598C52143FC1F86559D63,30861,21,23,2,109.52722,18.22743,1606
211302,E4D199FCE009427481C9D06B9609AB1E,31931,1,14,13,109.54771,18.29403,1667
211303,E4D199FCE009427481C9D06B9609AB1E,39181,17,20,3,109.55153,18.28035,1715
211304,E4D199FCE009427481C9D06B9609AB1E,31931,20,21,1,109.54771,18.29403,1667
211307,AD025C3F50B6CF31383182CF8709389F,31431,0,11,11,109.44639,18.29042,1316
211308,AD025C3F50B6CF31383182CF8709389F,31671,12,14,2,109.38965,18.29813,1068
211309,AD025C3F50B6CF31383182CF8709389F,31031,18,19,1,109.49979,18.25382,1510
211310,AD025C3F50B6CF31383182CF8709389F,38141,20,21,1,109.39479,18.2916,1116
211361,B8587D3CED4B79DF3F07DD5419A719F9,31231,0,2,2,109.42597,18.29292,1217
211362,B8587D3CED4B79DF3F07DD5419A719F9,60524,4,6,2,109.42951,18.28993,1216
211363,B8587D3CED4B79DF3F07DD5419A719F9,38251,6,8,2,109.49618,18.25493,1510
211364,B8587D3CED4B79DF3F07DD5419A719F9,31781,12,13,1,109.19847,18.2975,367
211365,B8587D3CED4B79DF3F07DD5419A719F9,31031,16,17,1,109.49979,18.25382,1510
211366,663CE56232D73D50E42DEC41EA33269F,31931,0,21,21,109.54771,18.29403,1667
211367,663CE56232D73D50E42DEC41EA33269F,30171,22,23,1,109.48458,18.27139,1463
211380,D55448AF780DC440D7CB0F00F1D6CA8C,31531,15,21,6,109.49583,18.25972,1461
211381,D55448AF780DC440D7CB0F00F1D6CA8C,31534,21,23,2,109.49368,18.25806,1461
211390,41332C8361F6C8A51074BE394B72EF60,30771,17,21,4,109.49938,18.26042,1511
211391,41332C8361F6C8A51074BE394B72EF60,38094,21,23,2,109.45403,18.28778,1316
211420,4DE3E9C2C0E7F48C3178063DD53BC336,31941,15,16,1,109.62451,18.31222,1970
211421,4DE3E9C2C0E7F48C3178063DD53BC336,30921,19,22,3,109.53903,18.29451,1667
211430,72378A653B4F571F903CABFC8BEF5042,31591,18,19,1,109.46924,18.34882,1376
211431,72378A653B4F571F903CABFC8BEF5042,30111,22,23,1,109.47583,18.30542,1419
211445,96F98526707B06BE1263CCD4F72E07A1,31071,0,16,16,109.58257,18.28458,1815
211446,96F98526707B06BE1263CCD4F72E07A1,30854,17,19,2,109.56889,18.27076,1763
211447,96F98526707B06BE1263CCD4F72E07A1,31071,19,20,1,109.58257,18.28458,1815
211457,1639B81A43FFF124C17E59CAD0C4F339,31931,0,14,14,109.54771,18.29403,1667
211458,1639B81A43FFF124C17E59CAD0C4F339,30921,16,18,2,109.53903,18.29451,1667
211462,48E412C068F936A4922628B0DC57FE76,38251,0,9,9,109.49618,18.25493,1510
211463,48E412C068F936A4922628B0DC57FE76,38754,10,13,3,109.74667,18.37382,2430
211464,48E412C068F936A4922628B0DC57FE76,38251,16,18,2,109.49618,18.25493,1510
211465,48E412C068F936A4922628B0DC57FE76,31021,18,20,2,109.49021,18.27,1463
211466,48E412C068F936A4922628B0DC57FE76,38251,20,23,3,109.49618,18.25493,1510
211474,356E75600A8901067E9EDB6E5BE4617A,30281,12,13,1,109.50597,18.27583,1514
211475,356E75600A8901067E9EDB6E5BE4617A,38157,16,17,1,109.51483,18.26958,1563
211476,356E75600A8901067E9EDB6E5BE4617A,30281,17,20,3,109.50597,18.27583,1514
211477,CB2B883155D37146FD4D4AA009B8CC00,31531,0,4,4,109.49583,18.25972,1461
211478,CB2B883155D37146FD4D4AA009B8CC00,30771,5,17,12,109.49938,18.26042,1511
211479,CB2B883155D37146FD4D4AA009B8CC00,38251,21,22,1,109.49618,18.25493,1510
211502,97F87E25D267410278E74FDFD0CF66D1,30234,0,3,3,109.60681,18.29979,1918
211503,97F87E25D267410278E74FDFD0CF66D1,31071,4,5,1,109.58257,18.28458,1815
211504,97F87E25D267410278E74FDFD0CF66D1,38291,9,12,3,109.51618,18.24313,1558
211529,CE87BCFF4C9FDB07C8CD6075D1328156,60661,17,18,1,109.548,18.2377,1657
211530,CE87BCFF4C9FDB07C8CD6075D1328156,60221,20,23,3,109.52569,18.29188,1616
211539,6ED697962F10CC0C2236463F9FC9376B,30821,8,20,12,109.43681,18.33639,1274
211540,6ED697962F10CC0C2236463F9FC9376B,30761,20,21,1,109.45201,18.3,1318
211544,B93185B4820D7E0DEE74EBEA00941D15,38291,0,1,1,109.51618,18.24313,1558
211545,B93185B4820D7E0DEE74EBEA00941D15,30911,2,10,8,109.50493,18.26181,1511
211546,B93185B4820D7E0DEE74EBEA00941D15,30911,10,22,12,109.50493,18.26181,1511
211571,54A6757CA4BF8A47C41CF1DDCA6EA505,30854,6,13,7,109.56889,18.27076,1763
211572,54A6757CA4BF8A47C41CF1DDCA6EA505,30861,14,16,2,109.52722,18.22743,1606
211573,54A6757CA4BF8A47C41CF1DDCA6EA505,30854,17,18,1,109.56889,18.27076,1763
211588,F84D949DDCBF25D5530F771BC55E0B9D,31321,0,3,3,109.63799,18.23201,2007
211589,F84D949DDCBF25D5530F771BC55E0B9D,31571,4,5,1,109.61563,18.23326,1957
211590,F84D949DDCBF25D5530F771BC55E0B9D,61011,6,16,10,109.60653,18.19076,1900
211591,F84D949DDCBF25D5530F771BC55E0B9D,31321,18,23,5,109.63799,18.23201,2007
211606,07169E7114E4F14C073261BAAC0D4491,61011,0,7,7,109.60653,18.19076,1900
211608,07169E7114E4F14C073261BAAC0D4491,61011,19,23,4,109.60653,18.19076,1900
211609,53490AD77ACCA93C3ED0F3DE79CA488B,31071,6,7,1,109.58257,18.28458,1815
211610,53490AD77ACCA93C3ED0F3DE79CA488B,30854,8,21,13,109.56889,18.27076,1763
211670,AA17AFDA929E42B241ADF1BFA6E7435E,31251,15,16,1,109.18528,18.2975,317
211671,AA17AFDA929E42B241ADF1BFA6E7435E,31206,21,22,1,109.50819,18.23549,1507
211681,9C1407835BC54BEBDB541F52E1DA1820,61011,0,1,1,109.60653,18.19076,1900
211683,9C1407835BC54BEBDB541F52E1DA1820,61011,5,10,5,109.60653,18.19076,1900
211707,4E29CE086935B3CD8038A4A6640FE864,30671,1,10,9,109.43611,18.30139,1268
211708,4E29CE086935B3CD8038A4A6640FE864,60041,11,15,4,109.39889,18.31944,1121
211709,4E29CE086935B3CD8038A4A6640FE864,31201,16,17,1,109.51042,18.23819,1558
211710,4E29CE086935B3CD8038A4A6640FE864,60041,17,19,2,109.39889,18.31944,1121
211711,4E29CE086935B3CD8038A4A6640FE864,60291,21,23,2,109.50826,18.24639,1509
211746,C666BDF91E2AEE4AB0E8446E7282D156,31561,0,9,9,109.56792,18.28479,1765
211747,C666BDF91E2AEE4AB0E8446E7282D156,30721,9,12,3,109.51597,18.28257,1565
211748,C666BDF91E2AEE4AB0E8446E7282D156,61011,14,16,2,109.60653,18.19076,1900
211749,C666BDF91E2AEE4AB0E8446E7282D156,30161,18,22,4,109.50042,18.24389,1508
211787,7B9D64657CE26DF907B4C2AC87C9F431,60371,8,10,2,109.53063,18.30056,1618
211788,7B9D64657CE26DF907B4C2AC87C9F431,38241,12,16,4,109.54111,18.30542,1669
211789,7B9D64657CE26DF907B4C2AC87C9F431,31931,19,23,4,109.54771,18.29403,1667
211821,8BFB49F9AE47BA01DA64200A7313BAB6,31951,14,15,1,109.52174,18.30299,1568
211822,8BFB49F9AE47BA01DA64200A7313BAB6,60621,16,17,1,109.48354,18.27451,1464
211823,8BFB49F9AE47BA01DA64200A7313BAB6,30391,18,19,1,109.4975,18.27118,1513
211829,DBB710D279E76C79F1E4B0766F579F8A,31071,0,1,1,109.58257,18.28458,1815
211830,DBB710D279E76C79F1E4B0766F579F8A,60211,3,4,1,109.63549,18.26049,2011
211831,DBB710D279E76C79F1E4B0766F579F8A,31071,5,14,9,109.58257,18.28458,1815
211854,F47B82183D87369F74615895846A6BA9,38721,0,5,5,109.50368,18.27542,1514
211855,F47B82183D87369F74615895846A6BA9,30291,5,8,3,109.50403,18.27028,1513
211856,F47B82183D87369F74615895846A6BA9,31031,9,10,1,109.49979,18.25382,1510
211857,F47B82183D87369F74615895846A6BA9,38171,19,20,1,109.50799,18.28139,1515
211858,F47B82183D87369F74615895846A6BA9,30291,21,22,1,109.50403,18.27028,1513
211859,8799356B7181F28146A203E5F86C52F0,31351,0,8,8,109.4959,18.28417,1465
211860,8799356B7181F28146A203E5F86C52F0,30321,9,12,3,109.49563,18.29611,1467
211861,8799356B7181F28146A203E5F86C52F0,31351,15,16,1,109.4959,18.28417,1465
211862,5A430B3542A9634CA3883245A4BAF022,60381,16,19,3,109.5241,18.22458,1605
211863,5A430B3542A9634CA3883245A4BAF022,31461,19,23,4,109.5091,18.25389,1510
211887,DC29C676832347947F366933ECB88090,39183,16,18,2,109.55542,18.28208,1715
211888,DC29C676832347947F366933ECB88090,31561,21,22,1,109.56792,18.28479,1765
211907,A2DBFF4E352E7B7C1EE25431C02FC741,31931,0,5,5,109.54771,18.29403,1667
211908,A2DBFF4E352E7B7C1EE25431C02FC741,39183,9,10,1,109.55542,18.28208,1715
211909,A2DBFF4E352E7B7C1EE25431C02FC741,31931,12,23,11,109.54771,18.29403,1667
211910,0BABF9C6516F437130A3DD3C99553A57,31201,0,2,2,109.51042,18.23819,1558
211911,0BABF9C6516F437130A3DD3C99553A57,39191,3,11,8,109.51493,18.23472,1557
211912,0BABF9C6516F437130A3DD3C99553A57,31201,13,14,1,109.51042,18.23819,1558
211913,0BABF9C6516F437130A3DD3C99553A57,31521,18,19,1,109.51458,18.22542,1555
211914,0BABF9C6516F437130A3DD3C99553A57,31206,20,23,3,109.50819,18.23549,1507
211915,0B625DE57093602A177FF6EF2935F6D3,31521,0,1,1,109.51458,18.22542,1555
211916,0B625DE57093602A177FF6EF2935F6D3,31521,2,3,1,109.51458,18.22542,1555
211917,0B625DE57093602A177FF6EF2935F6D3,60381,4,11,7,109.5241,18.22458,1605
211918,0B625DE57093602A177FF6EF2935F6D3,31521,12,23,11,109.51458,18.22542,1555
211985,4E2E832AE9D054F6D1F41FA6FCE0E148,31561,16,17,1,109.56792,18.28479,1765
211986,4E2E832AE9D054F6D1F41FA6FCE0E148,30854,21,23,2,109.56889,18.27076,1763
211992,3C5AEA306E8A69C707195C4150E77D90,31931,1,4,3,109.54771,18.29403,1667
211993,3C5AEA306E8A69C707195C4150E77D90,39181,6,10,4,109.55153,18.28035,1715
211994,3C5AEA306E8A69C707195C4150E77D90,31931,11,13,2,109.54771,18.29403,1667
211995,3C5AEA306E8A69C707195C4150E77D90,39181,15,21,6,109.55153,18.28035,1715
212007,E34FF61340C5B86CF9FD0AD454D26266,60331,0,6,6,109.505,18.26507,1512
212008,E34FF61340C5B86CF9FD0AD454D26266,60131,7,10,3,109.49819,18.24778,1509
212009,E34FF61340C5B86CF9FD0AD454D26266,30251,11,14,3,109.50611,18.26653,1512
212010,E34FF61340C5B86CF9FD0AD454D26266,38251,15,16,1,109.49618,18.25493,1510
212011,E34FF61340C5B86CF9FD0AD454D26266,60331,19,23,4,109.505,18.26507,1512
212018,94F0184D0BA3E27BCB47A57DA614F9FC,60411,0,13,13,109.32514,18.30854,869
212019,94F0184D0BA3E27BCB47A57DA614F9FC,30661,14,16,2,109.37028,18.24361,1008
212020,94F0184D0BA3E27BCB47A57DA614F9FC,60411,16,17,1,109.32514,18.30854,869
212021,94F0184D0BA3E27BCB47A57DA614F9FC,30661,19,22,3,109.37028,18.24361,1008
212022,94F0184D0BA3E27BCB47A57DA614F9FC,60411,22,23,1,109.32514,18.30854,869
212063,8D496C0E2DB1FF881021B05CE10C0242,30854,0,10,10,109.56889,18.27076,1763
212064,8D496C0E2DB1FF881021B05CE10C0242,30711,11,13,2,109.50271,18.25347,1510
212065,8D496C0E2DB1FF881021B05CE10C0242,30854,16,19,3,109.56889,18.27076,1763
212089,5DC6E4C80EB444425AE8AF64A7960C0A,60614,0,6,6,109.48799,18.29521,1467
212090,5DC6E4C80EB444425AE8AF64A7960C0A,60501,7,8,1,109.48701,18.29021,1466
212091,5DC6E4C80EB444425AE8AF64A7960C0A,60614,8,10,2,109.48799,18.29521,1467
212093,5DC6E4C80EB444425AE8AF64A7960C0A,60614,16,23,7,109.48799,18.29521,1467
212139,8819F09BB0735F6A8E80552A57CCCF5D,31521,1,9,8,109.51458,18.22542,1555
212140,8819F09BB0735F6A8E80552A57CCCF5D,38111,10,12,2,109.52007,18.22403,1555
212141,8819F09BB0735F6A8E80552A57CCCF5D,30361,12,14,2,109.50347,18.24,1508
212162,1FE34463C604482338E93206E38E7B82,31321,8,14,6,109.63799,18.23201,2007
212163,1FE34463C604482338E93206E38E7B82,60161,15,19,4,109.49174,18.26181,1461
212231,51061B3DE820AF1C1C713EF684728003,31071,2,6,4,109.58257,18.28458,1815
212232,51061B3DE820AF1C1C713EF684728003,30854,7,20,13,109.56889,18.27076,1763
212233,A8E9C7BB918ADAD29A3EA7ACDDCD32D7,38951,2,10,8,109.48097,18.28868,1416
212234,A8E9C7BB918ADAD29A3EA7ACDDCD32D7,38951,10,14,4,109.48097,18.28868,1416
212250,D356A9515C42A4641DD61B7F30BFB752,60201,0,8,8,109.5041,18.2509,1510
212251,D356A9515C42A4641DD61B7F30BFB752,60161,9,10,1,109.49174,18.26181,1461
212252,D356A9515C42A4641DD61B7F30BFB752,38251,10,12,2,109.49618,18.25493,1510
212253,D356A9515C42A4641DD61B7F30BFB752,31021,13,14,1,109.49021,18.27,1463
212254,D356A9515C42A4641DD61B7F30BFB752,31864,15,17,2,109.49014,18.28333,1465
212255,D356A9515C42A4641DD61B7F30BFB752,31021,18,20,2,109.49021,18.27,1463
212256,D356A9515C42A4641DD61B7F30BFB752,31861,22,23,1,109.49042,18.27549,1464
212280,1980C8D409DE9551539224B3D393CDAA,30071,0,1,1,109.52819,18.30472,1619
212281,1980C8D409DE9551539224B3D393CDAA,30071,4,21,17,109.52819,18.30472,1619
212284,66B46B2B6466319F5394240B88A355B7,38911,0,1,1,109.51674,18.24965,1559
212285,66B46B2B6466319F5394240B88A355B7,38291,2,5,3,109.51618,18.24313,1558
212286,66B46B2B6466319F5394240B88A355B7,39183,6,14,8,109.55542,18.28208,1715
212287,66B46B2B6466319F5394240B88A355B7,38911,16,22,6,109.51674,18.24965,1559
212376,8AFD060E1E9DC727605442142067AD03,38951,0,10,10,109.48097,18.28868,1416
212378,8AFD060E1E9DC727605442142067AD03,38951,21,23,2,109.48097,18.28868,1416
212430,8B9A9BFD1ACAD480EB101A91DBF2024D,38291,15,19,4,109.51618,18.24313,1558
212431,8B9A9BFD1ACAD480EB101A91DBF2024D,30191,22,23,1,109.50361,18.22701,1506
212450,750172FB82300DA02225CC4F7256EE00,39183,13,14,1,109.55542,18.28208,1715
212451,750172FB82300DA02225CC4F7256EE00,30381,16,23,7,109.52521,18.24507,1609
212506,8752BC71725B50257436D50C6598F252,30234,14,15,1,109.60681,18.29979,1918
212507,8752BC71725B50257436D50C6598F252,30854,16,19,3,109.56889,18.27076,1763
212508,8752BC71725B50257436D50C6598F252,31071,20,23,3,109.58257,18.28458,1815
212562,4538154FE025AC6453F6CD695BA5F0AF,38911,1,6,5,109.51674,18.24965,1559
212563,4538154FE025AC6453F6CD695BA5F0AF,31471,8,9,1,109.34583,18.29563,917
212564,4538154FE025AC6453F6CD695BA5F0AF,31821,11,13,2,109.51181,18.24924,1559
212565,4538154FE025AC6453F6CD695BA5F0AF,38297,13,15,2,109.52576,18.24965,1609
212566,4538154FE025AC6453F6CD695BA5F0AF,38754,17,18,1,109.74667,18.37382,2430
212567,189633BA4D39EBA8A203BC9E364D4B1F,30381,0,10,10,109.52521,18.24507,1609
212568,189633BA4D39EBA8A203BC9E364D4B1F,60231,13,17,4,109.49903,18.21972,1504
212569,189633BA4D39EBA8A203BC9E364D4B1F,60381,18,19,1,109.5241,18.22458,1605
212570,189633BA4D39EBA8A203BC9E364D4B1F,30741,21,23,2,109.49833,18.28681,1516
212592,815B1E622D05FD49F310F3AFE15701D1,60661,0,8,8,109.548,18.2377,1657
212593,815B1E622D05FD49F310F3AFE15701D1,60463,9,15,6,109.52507,18.22438,1605
212594,815B1E622D05FD49F310F3AFE15701D1,30854,17,21,4,109.56889,18.27076,1763
212653,8FE97C1052D63DE830211C405D8F5442,39371,0,5,5,109.56627,18.2646,1762
212654,8FE97C1052D63DE830211C405D8F5442,39183,6,7,1,109.55542,18.28208,1715
212655,8FE97C1052D63DE830211C405D8F5442,30854,8,15,7,109.56889,18.27076,1763
212670,37657A593A7A700C5ECCE5BB0AAAABA7,39181,9,10,1,109.55153,18.28035,1715
212671,37657A593A7A700C5ECCE5BB0AAAABA7,31931,13,17,4,109.54771,18.29403,1667
212672,37657A593A7A700C5ECCE5BB0AAAABA7,30721,18,21,3,109.51597,18.28257,1565
212699,6AFD900AAA635A8603B035488C44B76B,30711,10,15,5,109.50271,18.25347,1510
212700,6AFD900AAA635A8603B035488C44B76B,31124,16,17,1,109.17069,18.35,276
212705,6422CB87ACC55DDEF6EBE8946593C808,60291,1,2,1,109.50826,18.24639,1509
212706,6422CB87ACC55DDEF6EBE8946593C808,30721,2,10,8,109.51597,18.28257,1565
212707,6422CB87ACC55DDEF6EBE8946593C808,38171,13,21,8,109.50799,18.28139,1515
212746,4B672ABD46E5A5E3AE2E2A8075F2FA4B,30421,10,11,1,109.50021,18.25861,1511
212747,4B672ABD46E5A5E3AE2E2A8075F2FA4B,30854,13,14,1,109.56889,18.27076,1763
212748,4B672ABD46E5A5E3AE2E2A8075F2FA4B,39183,15,16,1,109.55542,18.28208,1715
212749,4B672ABD46E5A5E3AE2E2A8075F2FA4B,60463,17,18,1,109.52507,18.22438,1605
212760,9AA959ED87D1ECC3053DED17290EFCBD,30854,0,2,2,109.56889,18.27076,1763
212761,9AA959ED87D1ECC3053DED17290EFCBD,31561,3,7,4,109.56792,18.28479,1765
212762,9AA959ED87D1ECC3053DED17290EFCBD,39183,8,9,1,109.55542,18.28208,1715
212763,9AA959ED87D1ECC3053DED17290EFCBD,31561,19,21,2,109.56792,18.28479,1765
212764,9AA959ED87D1ECC3053DED17290EFCBD,30854,21,22,1,109.56889,18.27076,1763
212780,7890099D98AA300C5BF12527E7372DB0,30854,13,14,1,109.56889,18.27076,1763
212781,7890099D98AA300C5BF12527E7372DB0,31071,19,21,2,109.58257,18.28458,1815
212794,C1F80FD61770F46AF18F3BEF2B67E7ED,38171,18,20,2,109.50799,18.28139,1515
212795,C1F80FD61770F46AF18F3BEF2B67E7ED,31551,20,23,3,109.55868,18.24222,1708
212826,D96E01B8E0F0DE9C160C9FEAFDCFDB6D,31071,0,7,7,109.58257,18.28458,1815
212827,D96E01B8E0F0DE9C160C9FEAFDCFDB6D,30854,7,20,13,109.56889,18.27076,1763
212852,3C1A2536A78CF30193CED5E3EEACBE7E,30854,0,17,17,109.56889,18.27076,1763
212853,3C1A2536A78CF30193CED5E3EEACBE7E,30851,19,23,4,109.5616,18.27396,1713
212869,32D92CA589BCDC1A419C60C7E36F8BC2,60614,0,5,5,109.48799,18.29521,1467
212870,32D92CA589BCDC1A419C60C7E36F8BC2,38951,6,7,1,109.48097,18.28868,1416
212889,A23D20D52F2319A584B0A74D271DDBDA,31231,2,7,5,109.42597,18.29292,1217
212890,A23D20D52F2319A584B0A74D271DDBDA,30731,8,10,2,109.50944,18.22306,1555
212891,A23D20D52F2319A584B0A74D271DDBDA,31521,12,13,1,109.51458,18.22542,1555
212949,67F0367E877FC8B8EED5BAE43170FD94,30181,0,4,4,109.51597,18.23313,1557
212950,67F0367E877FC8B8EED5BAE43170FD94,30711,6,14,8,109.50271,18.25347,1510
212951,67F0367E877FC8B8EED5BAE43170FD94,30181,14,23,9,109.51597,18.23313,1557
212952,40285EE8CCE25C38988EC087545664EC,31071,2,7,5,109.58257,18.28458,1815
212953,40285EE8CCE25C38988EC087545664EC,30854,8,22,14,109.56889,18.27076,1763
212985,E16401EA38059619DFCD6F8BB2A2CA65,31261,13,14,1,109.51174,18.2466,1559
213010,3B46764DEE9C1A14D1C3F1D56B4284FD,31931,0,2,2,109.54771,18.29403,1667
213011,3B46764DEE9C1A14D1C3F1D56B4284FD,30071,4,6,2,109.52819,18.30472,1619
213012,3B46764DEE9C1A14D1C3F1D56B4284FD,60361,6,10,4,109.51938,18.29681,1567
213013,3B46764DEE9C1A14D1C3F1D56B4284FD,31121,16,17,1,109.16292,18.37063,230
213014,3B46764DEE9C1A14D1C3F1D56B4284FD,60241,20,21,1,109.53319,18.28667,1616
213022,00262F856825A94933CC2BDE5C3D9737,60581,0,5,5,109.59785,18.29931,1868
213023,00262F856825A94933CC2BDE5C3D9737,31421,7,8,1,109.55382,18.22347,1705
213024,00262F856825A94933CC2BDE5C3D9737,60581,13,17,4,109.59785,18.29931,1868
213025,00262F856825A94933CC2BDE5C3D9737,31421,18,20,2,109.55382,18.22347,1705
213026,00262F856825A94933CC2BDE5C3D9737,60581,20,23,3,109.59785,18.29931,1868
213027,69F4307E378774E8E49F5A5A6F5C64A6,30921,0,9,9,109.53903,18.29451,1667
213028,69F4307E378774E8E49F5A5A6F5C64A6,31931,13,16,3,109.54771,18.29403,1667
213029,69F4307E378774E8E49F5A5A6F5C64A6,60221,18,20,2,109.52569,18.29188,1616
213030,69F4307E378774E8E49F5A5A6F5C64A6,30921,21,23,2,109.53903,18.29451,1667
213055,C8922FAF66F21ECAECB6B717FCD5A53B,60614,0,7,7,109.48799,18.29521,1467
213056,C8922FAF66F21ECAECB6B717FCD5A53B,60391,9,11,2,109.47667,18.28757,1416
213057,C8922FAF66F21ECAECB6B717FCD5A53B,60614,11,12,1,109.48799,18.29521,1467
213058,C8922FAF66F21ECAECB6B717FCD5A53B,60391,16,19,3,109.47667,18.28757,1416
213059,C8922FAF66F21ECAECB6B717FCD5A53B,60614,21,23,2,109.48799,18.29521,1467
213075,7D1ED6067ECBD941EFC43CE0A6ADAE71,30854,0,1,1,109.56889,18.27076,1763
213076,7D1ED6067ECBD941EFC43CE0A6ADAE71,31071,2,4,2,109.58257,18.28458,1815
213077,7D1ED6067ECBD941EFC43CE0A6ADAE71,30854,4,21,17,109.56889,18.27076,1763
213086,9E8746086915F9D4A063A74CF0B5B7AB,31561,0,3,3,109.56792,18.28479,1765
213087,9E8746086915F9D4A063A74CF0B5B7AB,30851,4,6,2,109.5616,18.27396,1713
213088,9E8746086915F9D4A063A74CF0B5B7AB,31561,9,10,1,109.56792,18.28479,1765
213098,9F3EB2BFFB1C9BCF2031C397D642D9F1,38094,21,23,2,109.45403,18.28778,1316
213133,A503639E15A0B5D04B0130D882921438,31031,0,13,13,109.49979,18.25382,1510
213134,A503639E15A0B5D04B0130D882921438,30711,14,22,8,109.50271,18.25347,1510
213146,FD5B9AB034F15F72E8BEF02193669238,31931,9,10,1,109.54771,18.29403,1667
213147,FD5B9AB034F15F72E8BEF02193669238,60241,12,23,11,109.53319,18.28667,1616
213197,89E9D5A5271FF46B57D9025356B7D83E,30324,8,10,2,109.50326,18.29257,1517
213198,89E9D5A5271FF46B57D9025356B7D83E,30741,12,13,1,109.49833,18.28681,1516
213203,033CEEC20746801745CF4A53CD517C31,31261,0,8,8,109.51174,18.2466,1559
213204,033CEEC20746801745CF4A53CD517C31,30741,9,13,4,109.49833,18.28681,1516
213205,033CEEC20746801745CF4A53CD517C31,60241,13,16,3,109.53319,18.28667,1616
213206,033CEEC20746801745CF4A53CD517C31,30711,19,20,1,109.50271,18.25347,1510
213215,00678D3F0FE479614070948AEC721AF0,30854,17,18,1,109.56889,18.27076,1763
213245,5CFFF8D919E96524101209E188C669B3,31951,0,9,9,109.52174,18.30299,1568
213246,5CFFF8D919E96524101209E188C669B3,60301,9,10,1,109.60715,18.30993,1919
213247,5CFFF8D919E96524101209E188C669B3,31951,12,14,2,109.52174,18.30299,1568
213271,08A066736557478B1013C0CF834491DF,30921,0,6,6,109.53903,18.29451,1667
213272,08A066736557478B1013C0CF834491DF,31931,7,16,9,109.54771,18.29403,1667
213276,2A4D7C29737BD5444FB22FA470A46C75,31781,12,13,1,109.19847,18.2975,367
213277,2A4D7C29737BD5444FB22FA470A46C75,31471,15,17,2,109.34583,18.29563,917
213278,2A4D7C29737BD5444FB22FA470A46C75,30771,21,22,1,109.49938,18.26042,1511
213320,E75CF54BA14775FEDD26504F9F6B7365,31071,0,6,6,109.58257,18.28458,1815
213321,E75CF54BA14775FEDD26504F9F6B7365,31561,6,9,3,109.56792,18.28479,1765
213322,E75CF54BA14775FEDD26504F9F6B7365,30851,11,13,2,109.5616,18.27396,1713
213323,E75CF54BA14775FEDD26504F9F6B7365,31561,13,18,5,109.56792,18.28479,1765
213324,E75CF54BA14775FEDD26504F9F6B7365,30234,19,21,2,109.60681,18.29979,1918
213348,D8EBCB05DE029B0DEDBF9FBDF3DA3C2D,30211,2,6,4,109.49882,18.23931,1508
213349,D8EBCB05DE029B0DEDBF9FBDF3DA3C2D,30271,8,9,1,109.49132,18.23153,1456
213350,D8EBCB05DE029B0DEDBF9FBDF3DA3C2D,30661,13,15,2,109.37028,18.24361,1008
213351,D8EBCB05DE029B0DEDBF9FBDF3DA3C2D,30271,16,17,1,109.49132,18.23153,1456
213352,D8EBCB05DE029B0DEDBF9FBDF3DA3C2D,30421,18,19,1,109.50021,18.25861,1511
213353,D8EBCB05DE029B0DEDBF9FBDF3DA3C2D,38251,19,21,2,109.49618,18.25493,1510
213354,D8EBCB05DE029B0DEDBF9FBDF3DA3C2D,60084,22,23,1,109.4984,18.2334,1507
213367,81946AFE1D298F3B40176C804AE3EF84,31951,0,3,3,109.52174,18.30299,1568
213368,81946AFE1D298F3B40176C804AE3EF84,38484,4,5,1,109.53028,18.31528,1620
213369,81946AFE1D298F3B40176C804AE3EF84,60241,8,16,8,109.53319,18.28667,1616
213372,176C6455055846C83CDA64CD9B071B7A,60381,17,18,1,109.5241,18.22458,1605
213373,176C6455055846C83CDA64CD9B071B7A,31534,20,22,2,109.49368,18.25806,1461
213374,AFB5BA168951839870415DB36DAB089E,60354,0,8,8,109.58701,18.28521,1815
213375,AFB5BA168951839870415DB36DAB089E,31421,8,9,1,109.55382,18.22347,1705
213376,AFB5BA168951839870415DB36DAB089E,30731,10,11,1,109.50944,18.22306,1555
213377,AFB5BA168951839870415DB36DAB089E,31421,13,14,1,109.55382,18.22347,1705
213378,AFB5BA168951839870415DB36DAB089E,30731,15,17,2,109.50944,18.22306,1555
213379,AFB5BA168951839870415DB36DAB089E,30854,19,21,2,109.56889,18.27076,1763
213380,ED6C06A9523B96BECA45DFE9D14D9117,31701,1,10,9,109.44132,18.28833,1266
213381,ED6C06A9523B96BECA45DFE9D14D9117,30181,11,12,1,109.51597,18.23313,1557
213382,ED6C06A9523B96BECA45DFE9D14D9117,30051,13,14,1,109.48917,18.21215,1453
213383,ED6C06A9523B96BECA45DFE9D14D9117,38251,18,19,1,109.49618,18.25493,1510
213384,ED6C06A9523B96BECA45DFE9D14D9117,38071,21,23,2,109.40722,18.30938,1169
213398,93B7D316229EF1618C51F67797BDF883,30191,0,9,9,109.50361,18.22701,1506
213399,93B7D316229EF1618C51F67797BDF883,38951,12,14,2,109.48097,18.28868,1416
213400,93B7D316229EF1618C51F67797BDF883,38821,15,17,2,109.50354,18.25243,1510
213410,46D4D50B5B9F043295625FA342CF0B25,38911,0,8,8,109.51674,18.24965,1559
213411,46D4D50B5B9F043295625FA342CF0B25,31821,8,9,1,109.51181,18.24924,1559
213412,46D4D50B5B9F043295625FA342CF0B25,31471,11,12,1,109.34583,18.29563,917
213413,46D4D50B5B9F043295625FA342CF0B25,30661,14,16,2,109.37028,18.24361,1008
213417,D46DE9169E4BACF1D272EA5E0FDEF68F,30854,0,4,4,109.56889,18.27076,1763
213418,D46DE9169E4BACF1D272EA5E0FDEF68F,30851,6,11,5,109.5616,18.27396,1713
213419,D46DE9169E4BACF1D272EA5E0FDEF68F,31561,11,16,5,109.56792,18.28479,1765
213426,2981C8B3C1AD0C63670497656AA260BB,30721,0,7,7,109.51597,18.28257,1565
213427,2981C8B3C1AD0C63670497656AA260BB,60084,9,10,1,109.4984,18.2334,1507
213429,2981C8B3C1AD0C63670497656AA260BB,60031,18,20,2,109.49694,18.31632,1521
213460,39F25FE146A03325C93C111F2A943B6C,31945,0,5,5,109.58021,18.29403,1817
213461,39F25FE146A03325C93C111F2A943B6C,30854,8,21,13,109.56889,18.27076,1763
213462,39F25FE146A03325C93C111F2A943B6C,31945,21,23,2,109.58021,18.29403,1817
213503,5DE4A4FBB65CCE260678025A043BEB2F,38105,0,15,15,109.40299,18.29229,1117
213504,5DE4A4FBB65CCE260678025A043BEB2F,38102,16,17,1,109.40875,18.29111,1166
213505,5DE4A4FBB65CCE260678025A043BEB2F,38105,19,23,4,109.40299,18.29229,1117
213546,CFA6DB42B4EA79576A8AEA8F93765E81,30721,1,10,9,109.51597,18.28257,1565
213547,CFA6DB42B4EA79576A8AEA8F93765E81,39181,10,11,1,109.55153,18.28035,1715
213548,CFA6DB42B4EA79576A8AEA8F93765E81,30721,15,23,8,109.51597,18.28257,1565
213575,B34415F599F0ED7D1A073EE314A60B9B,60541,1,6,5,109.4084,18.29208,1167
213576,B34415F599F0ED7D1A073EE314A60B9B,31671,7,22,15,109.38965,18.29813,1068
213585,D5A941B7629B76426207AF63E861B5B0,60354,0,11,11,109.58701,18.28521,1815
213586,D5A941B7629B76426207AF63E861B5B0,31071,14,17,3,109.58257,18.28458,1815
213587,D5A941B7629B76426207AF63E861B5B0,30854,19,21,2,109.56889,18.27076,1763
213613,829F436C92FECF274888E348549D23CB,31931,13,14,1,109.54771,18.29403,1667
213614,829F436C92FECF274888E348549D23CB,60361,16,19,3,109.51938,18.29681,1567
213615,829F436C92FECF274888E348549D23CB,31071,20,23,3,109.58257,18.28458,1815
213616,197B005CFC0BCB591E8EE809CF956AA0,38331,0,6,6,109.62465,18.22736,1956
213617,197B005CFC0BCB591E8EE809CF956AA0,31571,7,8,1,109.61563,18.23326,1957
213618,197B005CFC0BCB591E8EE809CF956AA0,39091,9,11,2,109.50097,18.25222,1510
213619,197B005CFC0BCB591E8EE809CF956AA0,38105,14,15,1,109.40299,18.29229,1117
213620,197B005CFC0BCB591E8EE809CF956AA0,60381,19,20,1,109.5241,18.22458,1605
213661,13BA422D9C6FCE9CD249F0603D3E98AC,31681,7,11,4,109.40396,18.29979,1168
213662,13BA422D9C6FCE9CD249F0603D3E98AC,30201,12,15,3,109.4909,18.26465,1462
213679,5A1FDC762E3A00EF6FB4C515806ADF6A,38911,0,8,8,109.51674,18.24965,1559
213680,5A1FDC762E3A00EF6FB4C515806ADF6A,31261,8,9,1,109.51174,18.2466,1559
213681,5A1FDC762E3A00EF6FB4C515806ADF6A,38291,10,12,2,109.51618,18.24313,1558
213682,5A1FDC762E3A00EF6FB4C515806ADF6A,38911,13,15,2,109.51674,18.24965,1559
213683,5A1FDC762E3A00EF6FB4C515806ADF6A,38291,15,18,3,109.51618,18.24313,1558
213684,5A1FDC762E3A00EF6FB4C515806ADF6A,38911,21,23,2,109.51674,18.24965,1559
213687,C1BB6603CFDF86A619E9B76EAEAEF5D3,31071,0,7,7,109.58257,18.28458,1815
213688,C1BB6603CFDF86A619E9B76EAEAEF5D3,31071,11,13,2,109.58257,18.28458,1815
213689,C1BB6603CFDF86A619E9B76EAEAEF5D3,38315,15,17,2,109.48979,18.29764,1467
213832,301E657A2E52A15D5305B0C9B3D5B8BC,30921,0,8,8,109.53903,18.29451,1667
213842,2D2AA9A27DF87A65B05C7C9802082107,38871,6,10,4,109.44681,18.28625,1316
213843,2D2AA9A27DF87A65B05C7C9802082107,31431,11,12,1,109.44639,18.29042,1316
213844,2D2AA9A27DF87A65B05C7C9802082107,38871,15,16,1,109.44681,18.28625,1316
213845,2D2AA9A27DF87A65B05C7C9802082107,30111,16,18,2,109.47583,18.30542,1419
213846,2D2AA9A27DF87A65B05C7C9802082107,31021,18,19,1,109.49021,18.27,1463
213847,2D2AA9A27DF87A65B05C7C9802082107,31431,21,23,2,109.44639,18.29042,1316
213857,03CEC0FDDD5484124514C6D24A63D4DD,31561,0,19,19,109.56792,18.28479,1765
213858,03CEC0FDDD5484124514C6D24A63D4DD,30854,21,22,1,109.56889,18.27076,1763
213905,7F8955F4F4AC0CABDF46144206275D48,38094,21,23,2,109.45403,18.28778,1316
213906,102A3C1C3179D6FF6A52B59C3B4087A1,31181,0,1,1,109.50382,18.24813,1509
213907,102A3C1C3179D6FF6A52B59C3B4087A1,31391,2,10,8,109.50382,18.24285,1508
213908,102A3C1C3179D6FF6A52B59C3B4087A1,31181,11,23,12,109.50382,18.24813,1509
213950,B7182D0394EEB5B5974D259CBCE91CB4,38241,15,18,3,109.54111,18.30542,1669
213951,B7182D0394EEB5B5974D259CBCE91CB4,31031,19,21,2,109.49979,18.25382,1510
214010,14F1CC63CDA098F9694EAC8584B9C7A5,31041,2,3,1,109.50278,18.23701,1507
214011,14F1CC63CDA098F9694EAC8584B9C7A5,31561,4,22,18,109.56792,18.28479,1765
214015,72DCCAC1A2B013E19459B9B611396AC3,30171,6,10,4,109.48458,18.27139,1463
214016,72DCCAC1A2B013E19459B9B611396AC3,38171,15,19,4,109.50799,18.28139,1515
214017,72DCCAC1A2B013E19459B9B611396AC3,30171,20,23,3,109.48458,18.27139,1463
214036,A6714C443816C19D990E7A07DCADADAD,31206,0,1,1,109.50819,18.23549,1507
214037,A6714C443816C19D990E7A07DCADADAD,60371,1,8,7,109.53063,18.30056,1618
214038,A6714C443816C19D990E7A07DCADADAD,30581,10,13,3,109.62257,18.24951,1959
214039,A6714C443816C19D990E7A07DCADADAD,38271,13,14,1,109.62632,18.23049,1956
214040,A6714C443816C19D990E7A07DCADADAD,38754,15,17,2,109.74667,18.37382,2430
214041,A6714C443816C19D990E7A07DCADADAD,31461,19,20,1,109.5091,18.25389,1510
214042,A6714C443816C19D990E7A07DCADADAD,60371,22,23,1,109.53063,18.30056,1618
214087,96EB2AA1C15710F8D6D518B464991E6E,30711,9,14,5,109.50271,18.25347,1510
214088,96EB2AA1C15710F8D6D518B464991E6E,30711,14,16,2,109.50271,18.25347,1510
214112,1D8B814EC83D52D7C5F3FED99C129EE0,30854,0,9,9,109.56889,18.27076,1763
214113,1D8B814EC83D52D7C5F3FED99C129EE0,38271,10,20,10,109.62632,18.23049,1956
214129,D02479913B5C50E5D55D6F7DB176A542,39183,12,18,6,109.55542,18.28208,1715
214130,D02479913B5C50E5D55D6F7DB176A542,30851,21,22,1,109.5616,18.27396,1713
214131,D02479913B5C50E5D55D6F7DB176A542,39183,22,23,1,109.55542,18.28208,1715
214180,AB8B051428E5E5EDACDABEECED7F5A35,31421,13,17,4,109.55382,18.22347,1705
214181,AB8B051428E5E5EDACDABEECED7F5A35,39371,19,20,1,109.56627,18.2646,1762
214182,AB8B051428E5E5EDACDABEECED7F5A35,31421,20,21,1,109.55382,18.22347,1705
214192,FEB695B11F58C51C72553BEB72CBDB8F,31521,0,19,19,109.51458,18.22542,1555
214193,FEB695B11F58C51C72553BEB72CBDB8F,31031,19,21,2,109.49979,18.25382,1510
214194,FEB695B11F58C51C72553BEB72CBDB8F,60201,21,22,1,109.5041,18.2509,1510
214233,4F1F2C63B1D8098AD9ABA50013979078,31461,1,12,11,109.5091,18.25389,1510
214234,4F1F2C63B1D8098AD9ABA50013979078,30861,15,18,3,109.52722,18.22743,1606
214235,4F1F2C63B1D8098AD9ABA50013979078,30421,19,21,2,109.50021,18.25861,1511
214236,4F1F2C63B1D8098AD9ABA50013979078,31261,21,23,2,109.51174,18.2466,1559
214314,71D35ED12FD809FD321ED1C8285B5582,38951,0,4,4,109.48097,18.28868,1416
214315,71D35ED12FD809FD321ED1C8285B5582,38951,5,7,2,109.48097,18.28868,1416
214316,71D35ED12FD809FD321ED1C8285B5582,30371,7,9,2,109.51,18.24771,1559
214317,71D35ED12FD809FD321ED1C8285B5582,38951,12,21,9,109.48097,18.28868,1416
214327,6BF671BC76B2463D72102139E4EB1018,60371,10,15,5,109.53063,18.30056,1618
214328,6BF671BC76B2463D72102139E4EB1018,38241,16,17,1,109.54111,18.30542,1669
214329,6BF671BC76B2463D72102139E4EB1018,31931,20,22,2,109.54771,18.29403,1667
214391,AB43182259122294244C13D6FC66D4A1,31561,12,18,6,109.56792,18.28479,1765
214392,AB43182259122294244C13D6FC66D4A1,60631,19,23,4,109.57778,18.27583,1814
214406,513EF547BB35B1E6C402224AC99915BE,39111,1,6,5,109.5191,18.22597,1555
214407,513EF547BB35B1E6C402224AC99915BE,31521,7,9,2,109.51458,18.22542,1555
214408,513EF547BB35B1E6C402224AC99915BE,31521,10,16,6,109.51458,18.22542,1555
214409,513EF547BB35B1E6C402224AC99915BE,39321,16,17,1,109.529,18.2167,1604
214410,513EF547BB35B1E6C402224AC99915BE,31521,19,20,1,109.51458,18.22542,1555
214411,513EF547BB35B1E6C402224AC99915BE,60381,21,22,1,109.5241,18.22458,1605
214415,C17A8098B013F904BD9DA05D90234A30,30731,1,8,7,109.50944,18.22306,1555
214416,C17A8098B013F904BD9DA05D90234A30,30581,10,16,6,109.62257,18.24951,1959
214417,C17A8098B013F904BD9DA05D90234A30,30731,19,20,1,109.50944,18.22306,1555
214453,FCFB14BA36BDB7CD6A39612B9AE933B2,31931,14,17,3,109.54771,18.29403,1667
214454,FCFB14BA36BDB7CD6A39612B9AE933B2,60331,20,23,3,109.505,18.26507,1512
214476,7BF65E5054DA81A230AB5423620158E1,60631,0,7,7,109.57778,18.27583,1814
214477,7BF65E5054DA81A230AB5423620158E1,31071,9,11,2,109.58257,18.28458,1815
214478,7BF65E5054DA81A230AB5423620158E1,30854,13,16,3,109.56889,18.27076,1763
214479,7BF65E5054DA81A230AB5423620158E1,60631,20,23,3,109.57778,18.27583,1814
214480,ADC7B707FBBD7BF3F9ACE0C092DAADE5,31931,16,17,1,109.54771,18.29403,1667
214481,ADC7B707FBBD7BF3F9ACE0C092DAADE5,30921,17,19,2,109.53903,18.29451,1667
214482,ADC7B707FBBD7BF3F9ACE0C092DAADE5,31931,20,21,1,109.54771,18.29403,1667
214516,C58D0182BFC61ED113EE3B09763C30B2,38185,0,14,14,109.51333,18.27347,1563
214517,C58D0182BFC61ED113EE3B09763C30B2,31031,14,17,3,109.49979,18.25382,1510
214518,C58D0182BFC61ED113EE3B09763C30B2,38185,18,23,5,109.51333,18.27347,1563
214532,FD588CE6BF8E5F650A7E883677D290AD,60201,0,10,10,109.5041,18.2509,1510
214533,FD588CE6BF8E5F650A7E883677D290AD,31145,14,15,1,109.20431,18.30479,369
214534,FD588CE6BF8E5F650A7E883677D290AD,31781,15,16,1,109.19847,18.2975,367
214584,AAC7E9546787DDB508C41969C1E453E7,30711,0,1,1,109.50271,18.25347,1510
214585,AAC7E9546787DDB508C41969C1E453E7,30421,2,12,10,109.50021,18.25861,1511
214586,AAC7E9546787DDB508C41969C1E453E7,31031,12,14,2,109.49979,18.25382,1510
214587,AAC7E9546787DDB508C41969C1E453E7,60114,16,17,1,109.73028,18.33847,2374
214588,AAC7E9546787DDB508C41969C1E453E7,30771,19,21,2,109.49938,18.26042,1511
214589,AAC7E9546787DDB508C41969C1E453E7,30421,21,23,2,109.50021,18.25861,1511
214600,4053323049FA57896819CD5356E38746,31071,0,6,6,109.58257,18.28458,1815
214601,4053323049FA57896819CD5356E38746,30854,6,23,17,109.56889,18.27076,1763
214617,9BF33DB1F7AC1D27E06AF501C14CCF2C,31931,0,7,7,109.54771,18.29403,1667
214618,9BF33DB1F7AC1D27E06AF501C14CCF2C,39181,8,11,3,109.55153,18.28035,1715
214619,9BF33DB1F7AC1D27E06AF501C14CCF2C,31931,11,23,12,109.54771,18.29403,1667
214684,CDF76DCF3BBF11957A82B60E762E0DF7,31201,0,6,6,109.51042,18.23819,1558
214685,CDF76DCF3BBF11957A82B60E762E0DF7,31121,7,12,5,109.16292,18.37063,230
214686,CDF76DCF3BBF11957A82B60E762E0DF7,31201,14,17,3,109.51042,18.23819,1558
214687,CDF76DCF3BBF11957A82B60E762E0DF7,60661,20,22,2,109.548,18.2377,1657
214696,A05C5224EBD39E4769ABC987F547C22B,31611,0,6,6,109.63076,18.34944,2026
214697,A05C5224EBD39E4769ABC987F547C22B,31061,8,10,2,109.53333,18.23257,1607
214698,A05C5224EBD39E4769ABC987F547C22B,30051,14,16,2,109.48917,18.21215,1453
214699,A05C5224EBD39E4769ABC987F547C22B,31061,19,20,1,109.53333,18.23257,1607
214700,A05C5224EBD39E4769ABC987F547C22B,31611,21,23,2,109.63076,18.34944,2026
214708,6C0260646767B781577B5B8CE2471E51,38484,0,13,13,109.53028,18.31528,1620
214709,6C0260646767B781577B5B8CE2471E51,31521,14,20,6,109.51458,18.22542,1555
214710,6C0260646767B781577B5B8CE2471E51,38484,22,23,1,109.53028,18.31528,1620
214714,20C15B76A1E0DF79D86EDEAC7BC3D7B7,30511,0,1,1,109.51069,18.24208,1558
214715,20C15B76A1E0DF79D86EDEAC7BC3D7B7,31071,2,8,6,109.58257,18.28458,1815
214721,895819ED5A8DD11C7D2D0F75F1A32EF3,30232,2,17,15,109.6191,18.31701,1971
214722,895819ED5A8DD11C7D2D0F75F1A32EF3,30854,19,21,2,109.56889,18.27076,1763
214723,AFCD9EE6DC5FA934D04A396BCB0F342C,38061,0,7,7,109.50597,18.23118,1506
214725,AFCD9EE6DC5FA934D04A396BCB0F342C,38061,18,23,5,109.50597,18.23118,1506
214735,2EB46D736E608EB8E50DA36D9E401F1D,38331,0,10,10,109.62465,18.22736,1956
214736,2EB46D736E608EB8E50DA36D9E401F1D,31221,11,13,2,109.61333,18.26833,1913
214737,2EB46D736E608EB8E50DA36D9E401F1D,38331,14,23,9,109.62465,18.22736,1956
214738,8F6EA1C108FADA76A214A7ED71ECE3D1,30891,1,5,4,109.59431,18.28389,1865
214739,8F6EA1C108FADA76A214A7ED71ECE3D1,30854,6,14,8,109.56889,18.27076,1763
214740,8F6EA1C108FADA76A214A7ED71ECE3D1,30851,14,15,1,109.5616,18.27396,1713
214741,8F6EA1C108FADA76A214A7ED71ECE3D1,30854,17,18,1,109.56889,18.27076,1763
214852,E988DA8DA294A7CCEAA28AECB6C26A8F,31431,0,8,8,109.44639,18.29042,1316
214853,E988DA8DA294A7CCEAA28AECB6C26A8F,31701,12,14,2,109.44132,18.28833,1266
214854,E988DA8DA294A7CCEAA28AECB6C26A8F,38871,14,18,4,109.44681,18.28625,1316
214855,E988DA8DA294A7CCEAA28AECB6C26A8F,31701,18,20,2,109.44132,18.28833,1266
214863,A88B35A7108477CCC954BD53412ECC82,31951,0,11,11,109.52174,18.30299,1568
214877,8AABF5FDF2B06EB445749240A3894969,30854,0,9,9,109.56889,18.27076,1763
214878,8AABF5FDF2B06EB445749240A3894969,31071,13,20,7,109.58257,18.28458,1815
214879,8AABF5FDF2B06EB445749240A3894969,30854,22,23,1,109.56889,18.27076,1763
214914,B2035C0684FF9CA861B7EB217CE5A160,60331,0,6,6,109.505,18.26507,1512
214915,B2035C0684FF9CA861B7EB217CE5A160,30809,9,11,2,109.4891,18.28229,1465
214916,B2035C0684FF9CA861B7EB217CE5A160,31471,14,15,1,109.34583,18.29563,917
214917,B2035C0684FF9CA861B7EB217CE5A160,30201,20,23,3,109.4909,18.26465,1462
214921,F315998EC48289C5B7879B7FA5033861,30711,0,9,9,109.50271,18.25347,1510
214922,F315998EC48289C5B7879B7FA5033861,31461,12,15,3,109.5091,18.25389,1510
214923,F315998EC48289C5B7879B7FA5033861,39154,20,22,2,109.50201,18.25681,1511
214986,9ABDF6B7269693E50046DC87610AF02C,60171,17,18,1,109.51292,18.30694,1569
214987,9ABDF6B7269693E50046DC87610AF02C,30854,19,22,3,109.56889,18.27076,1763
215038,30CE72A519D49881F23B8123486E3A02,30661,0,4,4,109.37028,18.24361,1008
215039,30CE72A519D49881F23B8123486E3A02,60411,6,14,8,109.32514,18.30854,869
215040,30CE72A519D49881F23B8123486E3A02,31471,16,18,2,109.34583,18.29563,917
215041,30CE72A519D49881F23B8123486E3A02,60411,21,23,2,109.32514,18.30854,869
215055,C4D5CB245E1DDCF5D6C45439D24370A5,30711,10,13,3,109.50271,18.25347,1510
215056,C4D5CB245E1DDCF5D6C45439D24370A5,60331,13,15,2,109.505,18.26507,1512
215073,64FF3E93355E6DCA29977E04D316EABA,39091,2,7,5,109.50097,18.25222,1510
215074,64FF3E93355E6DCA29977E04D316EABA,60311,9,10,1,109.52097,18.24319,1558
215075,64FF3E93355E6DCA29977E04D316EABA,31261,12,16,4,109.51174,18.2466,1559
215076,64FF3E93355E6DCA29977E04D316EABA,38973,17,22,5,109.51097,18.25389,1560
215080,7759EF7DB89C14B0A835B8F55ECF34F6,38052,19,20,1,109.62618,18.23042,1956
215081,7759EF7DB89C14B0A835B8F55ECF34F6,60594,20,22,2,109.62694,18.22799,1956
215099,9A1D1AA5EE2CD156CC396C667ED8C5B9,30854,0,1,1,109.56889,18.27076,1763
215100,9A1D1AA5EE2CD156CC396C667ED8C5B9,31071,1,16,15,109.58257,18.28458,1815
215101,9A1D1AA5EE2CD156CC396C667ED8C5B9,60631,17,18,1,109.57778,18.27583,1814
215145,798BF3B08F72A16A6DEAAA235F1899BB,61011,1,7,6,109.60653,18.19076,1900
215147,798BF3B08F72A16A6DEAAA235F1899BB,61011,13,20,7,109.60653,18.19076,1900
215149,AB2302AD7944C06CE36272AAFB1B4F9D,31071,0,6,6,109.58257,18.28458,1815
215150,AB2302AD7944C06CE36272AAFB1B4F9D,31271,10,12,2,109.48958,18.26257,1462
215151,AB2302AD7944C06CE36272AAFB1B4F9D,31101,13,15,2,109.65389,18.23403,2057
215152,AB2302AD7944C06CE36272AAFB1B4F9D,30854,17,19,2,109.56889,18.27076,1763
215153,AB2302AD7944C06CE36272AAFB1B4F9D,38071,21,22,1,109.40722,18.30938,1169
215189,267109764004253FF1AD548611BE6E82,39371,0,6,6,109.56627,18.2646,1762
215190,267109764004253FF1AD548611BE6E82,30891,9,14,5,109.59431,18.28389,1865
215191,267109764004253FF1AD548611BE6E82,39371,18,23,5,109.56627,18.2646,1762
215226,9663F099E8404BD79B503843A8139A66,31701,13,16,3,109.44132,18.28833,1266
215227,9663F099E8404BD79B503843A8139A66,31071,19,20,1,109.58257,18.28458,1815
215228,9663F099E8404BD79B503843A8139A66,31701,21,23,2,109.44132,18.28833,1266
215252,0C412ED9747C602710D1782A20EF4EFD,60201,9,11,2,109.5041,18.2509,1510
215269,7E2EA58FE60AC1C253C1CC188337CCC8,39041,1,12,11,109.40021,18.29278,1117
215270,7E2EA58FE60AC1C253C1CC188337CCC8,31031,13,15,2,109.49979,18.25382,1510
215271,7E2EA58FE60AC1C253C1CC188337CCC8,30681,15,16,1,109.48493,18.26917,1463
215272,7E2EA58FE60AC1C253C1CC188337CCC8,30391,16,18,2,109.4975,18.27118,1513
215273,7E2EA58FE60AC1C253C1CC188337CCC8,30711,19,21,2,109.50271,18.25347,1510
215280,9B979E9430BCD0DDB6C78BBE525EBD2D,60631,0,1,1,109.57778,18.27583,1814
215281,9B979E9430BCD0DDB6C78BBE525EBD2D,30854,2,18,16,109.56889,18.27076,1763
215282,9B979E9430BCD0DDB6C78BBE525EBD2D,39371,20,21,1,109.56627,18.2646,1762
215336,E499E78D259E27068B57F40CF87421E0,60614,0,7,7,109.48799,18.29521,1467
215337,E499E78D259E27068B57F40CF87421E0,60501,8,9,1,109.48701,18.29021,1466
215338,E499E78D259E27068B57F40CF87421E0,30421,11,14,3,109.50021,18.25861,1511
215355,0C0D5781C6ACB120CCF29A5B55073E7D,38271,1,6,5,109.62632,18.23049,1956
215356,0C0D5781C6ACB120CCF29A5B55073E7D,31781,11,13,2,109.19847,18.2975,367
215357,0C0D5781C6ACB120CCF29A5B55073E7D,30361,17,18,1,109.50347,18.24,1508
215366,C1F100A79C441D3FFDBAE922D32DC8D2,30854,0,20,20,109.56889,18.27076,1763
215367,C1F100A79C441D3FFDBAE922D32DC8D2,31945,20,21,1,109.58021,18.29403,1817
215368,C1F100A79C441D3FFDBAE922D32DC8D2,30854,22,23,1,109.56889,18.27076,1763
215378,C2B7B3A3FAB31B432C169B25FFB0A1F6,30854,0,8,8,109.56889,18.27076,1763
215379,C2B7B3A3FAB31B432C169B25FFB0A1F6,31071,12,14,2,109.58257,18.28458,1815
215380,C2B7B3A3FAB31B432C169B25FFB0A1F6,31945,14,16,2,109.58021,18.29403,1817
215383,942FD8205298EEBE7ED108DC820DF6A5,39081,13,14,1,109.19382,18.29111,366
215384,942FD8205298EEBE7ED108DC820DF6A5,31521,16,22,6,109.51458,18.22542,1555
215385,1B6EBBFF3B9D8A3E18753343B6A29EAE,31071,0,6,6,109.58257,18.28458,1815
215386,1B6EBBFF3B9D8A3E18753343B6A29EAE,31561,10,11,1,109.56792,18.28479,1765
215387,1B6EBBFF3B9D8A3E18753343B6A29EAE,31071,12,13,1,109.58257,18.28458,1815
215388,1B6EBBFF3B9D8A3E18753343B6A29EAE,30851,17,18,1,109.5616,18.27396,1713
215389,1B6EBBFF3B9D8A3E18753343B6A29EAE,31071,20,23,3,109.58257,18.28458,1815
215404,EC89B2FFE00F967E6D0A3B697A6D636D,31071,0,4,4,109.58257,18.28458,1815
215405,EC89B2FFE00F967E6D0A3B697A6D636D,31071,5,6,1,109.58257,18.28458,1815
215406,EC89B2FFE00F967E6D0A3B697A6D636D,30854,8,10,2,109.56889,18.27076,1763
215407,EC89B2FFE00F967E6D0A3B697A6D636D,31071,11,13,2,109.58257,18.28458,1815
215408,EC89B2FFE00F967E6D0A3B697A6D636D,30854,13,15,2,109.56889,18.27076,1763
215409,EC89B2FFE00F967E6D0A3B697A6D636D,31071,16,21,5,109.58257,18.28458,1815
215410,EC89B2FFE00F967E6D0A3B697A6D636D,31071,21,22,1,109.58257,18.28458,1815
215463,4D4289AE0DFBF4B5C79A47559DC2EBDD,30854,14,15,1,109.56889,18.27076,1763
215464,4D4289AE0DFBF4B5C79A47559DC2EBDD,30271,18,20,2,109.49132,18.23153,1456
215465,4D4289AE0DFBF4B5C79A47559DC2EBDD,30854,21,22,1,109.56889,18.27076,1763
215470,DFD2E125802FB9E2FB2F393417866810,31071,19,22,3,109.58257,18.28458,1815
215471,DFD2E125802FB9E2FB2F393417866810,31071,22,23,1,109.58257,18.28458,1815
215479,68DBE0B52FD0AB95F1DD47068FD7847F,60311,0,5,5,109.52097,18.24319,1558
215480,68DBE0B52FD0AB95F1DD47068FD7847F,30181,9,11,2,109.51597,18.23313,1557
215481,68DBE0B52FD0AB95F1DD47068FD7847F,60311,12,14,2,109.52097,18.24319,1558
215482,68DBE0B52FD0AB95F1DD47068FD7847F,30181,18,20,2,109.51597,18.23313,1557
215483,68DBE0B52FD0AB95F1DD47068FD7847F,60311,20,22,2,109.52097,18.24319,1558
215494,1D73A39CD9D00E7A842906C3097D7487,30851,14,15,1,109.5616,18.27396,1713
215495,1D73A39CD9D00E7A842906C3097D7487,31561,16,18,2,109.56792,18.28479,1765
215496,1D73A39CD9D00E7A842906C3097D7487,31461,20,23,3,109.5091,18.25389,1510
215513,7A9EDF4DC03F94839B13F40FCA0FD567,60661,0,12,12,109.548,18.2377,1657
215514,7A9EDF4DC03F94839B13F40FCA0FD567,60171,15,16,1,109.51292,18.30694,1569
215515,7A9EDF4DC03F94839B13F40FCA0FD567,60661,20,21,1,109.548,18.2377,1657
215543,794109BFC4D0C5504E1A62AB391C7DDC,30181,11,13,2,109.51597,18.23313,1557
215544,794109BFC4D0C5504E1A62AB391C7DDC,31521,13,15,2,109.51458,18.22542,1555
215545,794109BFC4D0C5504E1A62AB391C7DDC,30181,16,23,7,109.51597,18.23313,1557
215552,FBD855000564CE6EC034501219E56C85,30741,0,6,6,109.49833,18.28681,1516
215553,FBD855000564CE6EC034501219E56C85,31781,7,14,7,109.19847,18.2975,367
215554,FBD855000564CE6EC034501219E56C85,31031,16,19,3,109.49979,18.25382,1510
215555,FBD855000564CE6EC034501219E56C85,30171,19,22,3,109.48458,18.27139,1463
215563,BF81F972CCF4D6D938A0BB87928D3D21,31521,0,9,9,109.51458,18.22542,1555
215564,BF81F972CCF4D6D938A0BB87928D3D21,31781,10,12,2,109.19847,18.2975,367
215565,BF81F972CCF4D6D938A0BB87928D3D21,60381,14,16,2,109.5241,18.22458,1605
215566,BF81F972CCF4D6D938A0BB87928D3D21,30421,19,20,1,109.50021,18.25861,1511
215567,BF81F972CCF4D6D938A0BB87928D3D21,31521,21,23,2,109.51458,18.22542,1555
215605,172CB232BBE684655CFBDFD055BB1CB5,60491,0,14,14,109.43354,18.30847,1269
215606,172CB232BBE684655CFBDFD055BB1CB5,60551,15,23,8,109.42722,18.30111,1218
215610,C7B596C3998F49DC6B86FB54AB7111B3,31071,0,5,5,109.58257,18.28458,1815
215611,C7B596C3998F49DC6B86FB54AB7111B3,30706,6,9,3,109.58833,18.31125,1820
215612,C7B596C3998F49DC6B86FB54AB7111B3,31071,10,22,12,109.58257,18.28458,1815
215660,F91D2D97BDB5B9086FEBA7934E43CF03,60421,0,7,7,109.46333,18.31743,1371
215664,A9634A2AD8447824C1C9412CBBCC32E0,31181,0,14,14,109.50382,18.24813,1509
215665,A9634A2AD8447824C1C9412CBBCC32E0,31531,14,15,1,109.49583,18.25972,1461
215666,A9634A2AD8447824C1C9412CBBCC32E0,31181,20,23,3,109.50382,18.24813,1509
215740,222E0B6922623CE9FBB280F81068D40E,39321,0,5,5,109.529,18.2167,1604
215741,222E0B6922623CE9FBB280F81068D40E,30531,6,8,2,109.53271,18.21472,1604
215742,222E0B6922623CE9FBB280F81068D40E,30731,10,13,3,109.50944,18.22306,1555
215779,A795428793D2273B4ACFDADC5E61AEC2,60661,11,12,1,109.548,18.2377,1657
215780,A795428793D2273B4ACFDADC5E61AEC2,31061,13,17,4,109.53333,18.23257,1607
215818,15195C578D4A8081B069C4B518039EFC,60231,6,8,2,109.49903,18.21972,1504
215819,15195C578D4A8081B069C4B518039EFC,60084,8,11,3,109.4984,18.2334,1507
215820,15195C578D4A8081B069C4B518039EFC,60231,15,22,7,109.49903,18.21972,1504
215842,7F6E66BC10419161F6457A6D79258EDB,60401,8,10,2,109.47444,18.27583,1414
215843,7F6E66BC10419161F6457A6D79258EDB,38094,10,11,1,109.45403,18.28778,1316
215844,7F6E66BC10419161F6457A6D79258EDB,31031,12,14,2,109.49979,18.25382,1510
215845,7F6E66BC10419161F6457A6D79258EDB,31431,14,15,1,109.44639,18.29042,1316
215846,7F6E66BC10419161F6457A6D79258EDB,60621,19,23,4,109.48354,18.27451,1464
215856,3E314B350F6DFD63303B103E9B7D6941,31521,0,5,5,109.51458,18.22542,1555
215857,3E314B350F6DFD63303B103E9B7D6941,31781,9,11,2,109.19847,18.2975,367
215858,3E314B350F6DFD63303B103E9B7D6941,31471,14,16,2,109.34583,18.29563,917
215859,AAD6CC23C5CDBF026C42805D3EA95680,60552,0,5,5,109.41729,18.30014,1218
215860,AAD6CC23C5CDBF026C42805D3EA95680,31461,10,11,1,109.5091,18.25389,1510
215865,1E2DBE5C967C66E080BAF11FED240B2A,30711,10,12,2,109.50271,18.25347,1510
215866,1E2DBE5C967C66E080BAF11FED240B2A,31181,13,15,2,109.50382,18.24813,1509
215867,1E2DBE5C967C66E080BAF11FED240B2A,31031,16,20,4,109.49979,18.25382,1510
215868,1E2DBE5C967C66E080BAF11FED240B2A,31181,20,22,2,109.50382,18.24813,1509
215873,3B4B2DFBA1D31CE7FAD823FC175E4B2C,31864,0,8,8,109.49014,18.28333,1465
215874,3B4B2DFBA1D31CE7FAD823FC175E4B2C,31101,9,12,3,109.65389,18.23403,2057
215875,3B4B2DFBA1D31CE7FAD823FC175E4B2C,30581,13,14,1,109.62257,18.24951,1959
215876,3B4B2DFBA1D31CE7FAD823FC175E4B2C,30271,19,21,2,109.49132,18.23153,1456
215877,3B4B2DFBA1D31CE7FAD823FC175E4B2C,60084,21,22,1,109.4984,18.2334,1507
215883,372A5433078073EAD18922D679CE0A73,60054,0,1,1,109.3016,18.31229,770
215884,372A5433078073EAD18922D679CE0A73,30661,2,3,1,109.37028,18.24361,1008
215885,372A5433078073EAD18922D679CE0A73,60411,7,18,11,109.32514,18.30854,869
215886,372A5433078073EAD18922D679CE0A73,30661,21,23,2,109.37028,18.24361,1008
215894,F9F80EDABF5B8107FB24FA24BEE7566E,39151,0,4,4,109.49875,18.25097,1510
215895,F9F80EDABF5B8107FB24FA24BEE7566E,60201,4,8,4,109.5041,18.2509,1510
215896,F9F80EDABF5B8107FB24FA24BEE7566E,60161,8,9,1,109.49174,18.26181,1461
215897,F9F80EDABF5B8107FB24FA24BEE7566E,60211,12,13,1,109.63549,18.26049,2011
215910,50F6E2D553B36EAFE6AA22613C3D5EDD,30191,0,7,7,109.50361,18.22701,1506
215911,50F6E2D553B36EAFE6AA22613C3D5EDD,31521,7,9,2,109.51458,18.22542,1555
215912,50F6E2D553B36EAFE6AA22613C3D5EDD,39321,11,13,2,109.529,18.2167,1604
215913,50F6E2D553B36EAFE6AA22613C3D5EDD,60401,16,19,3,109.47444,18.27583,1414
215914,50F6E2D553B36EAFE6AA22613C3D5EDD,38157,19,20,1,109.51483,18.26958,1563
215961,638A4C82143660BDE3EA7A4291713A14,38871,6,8,2,109.44681,18.28625,1316
215962,638A4C82143660BDE3EA7A4291713A14,60411,11,15,4,109.32514,18.30854,869
215968,7D9FE20353178BD0E18334ADA0227839,38903,3,5,2,109.39229,18.29243,1117
215969,7D9FE20353178BD0E18334ADA0227839,31145,9,10,1,109.20431,18.30479,369
215979,A6CF31A63571639AB283D5F43FB98748,31441,18,20,2,109.51181,18.24424,1559
215980,A6CF31A63571639AB283D5F43FB98748,31201,20,23,3,109.51042,18.23819,1558
216014,A7BE283E59850CFEF23FCDC9B4A2FEF4,30731,0,21,21,109.50944,18.22306,1555
216015,A7BE283E59850CFEF23FCDC9B4A2FEF4,39321,22,23,1,109.529,18.2167,1604
216055,943AD2B0B23FF40406FC81AD8E89FDB0,30201,0,9,9,109.4909,18.26465,1462
216056,943AD2B0B23FF40406FC81AD8E89FDB0,31181,12,13,1,109.50382,18.24813,1509
216057,943AD2B0B23FF40406FC81AD8E89FDB0,31271,14,15,1,109.48958,18.26257,1462
216058,943AD2B0B23FF40406FC81AD8E89FDB0,30201,15,21,6,109.4909,18.26465,1462
216059,943AD2B0B23FF40406FC81AD8E89FDB0,31271,21,23,2,109.48958,18.26257,1462
216076,1CB1A7233BC41BA057D58445B53DCE0D,38903,0,6,6,109.39229,18.29243,1117
216077,1CB1A7233BC41BA057D58445B53DCE0D,60552,8,10,2,109.41729,18.30014,1218
216078,1CB1A7233BC41BA057D58445B53DCE0D,38754,12,16,4,109.74667,18.37382,2430
216081,45FC4D7B7AEB1BB8222449DDC064C06B,31945,0,6,6,109.58021,18.29403,1817
216082,45FC4D7B7AEB1BB8222449DDC064C06B,30854,10,11,1,109.56889,18.27076,1763
216083,45FC4D7B7AEB1BB8222449DDC064C06B,31945,13,18,5,109.58021,18.29403,1817
216084,45FC4D7B7AEB1BB8222449DDC064C06B,30201,19,20,1,109.4909,18.26465,1462
216085,45FC4D7B7AEB1BB8222449DDC064C06B,31071,22,23,1,109.58257,18.28458,1815
216163,A673316D9E7622125C9B466801BB0DCE,31221,0,1,1,109.61333,18.26833,1913
216164,A673316D9E7622125C9B466801BB0DCE,38275,2,6,4,109.62875,18.22938,2006
216165,A673316D9E7622125C9B466801BB0DCE,31571,6,7,1,109.61563,18.23326,1957
216209,9B389AE8E9B004176803CCEAFF69104A,39371,1,4,3,109.56627,18.2646,1762
216210,9B389AE8E9B004176803CCEAFF69104A,30951,7,15,8,109.56208,18.25667,1761
216211,9B389AE8E9B004176803CCEAFF69104A,30854,18,20,2,109.56889,18.27076,1763
216294,0442B38E8824E569B00E80CCEFC70940,39183,9,10,1,109.55542,18.28208,1715
216295,0442B38E8824E569B00E80CCEFC70940,31561,13,16,3,109.56792,18.28479,1765
216296,0442B38E8824E569B00E80CCEFC70940,39183,16,18,2,109.55542,18.28208,1715
216297,0442B38E8824E569B00E80CCEFC70940,31561,18,23,5,109.56792,18.28479,1765
216298,17D13F6A66037B54FAB5668CDC734401,30721,0,6,6,109.51597,18.28257,1565
216299,17D13F6A66037B54FAB5668CDC734401,31931,8,9,1,109.54771,18.29403,1667
216300,17D13F6A66037B54FAB5668CDC734401,39181,9,17,8,109.55153,18.28035,1715
216301,17D13F6A66037B54FAB5668CDC734401,30721,21,23,2,109.51597,18.28257,1565
216328,33D03C41649B47EDC5176C93FF6F1D8D,30661,1,2,1,109.37028,18.24361,1008
216329,33D03C41649B47EDC5176C93FF6F1D8D,60411,4,8,4,109.32514,18.30854,869
216330,33D03C41649B47EDC5176C93FF6F1D8D,30661,11,17,6,109.37028,18.24361,1008
216331,33D03C41649B47EDC5176C93FF6F1D8D,60411,18,23,5,109.32514,18.30854,869
216332,490A5F2D9652290BBCEA32DFC103B993,60331,15,17,2,109.505,18.26507,1512
216333,490A5F2D9652290BBCEA32DFC103B993,30201,17,18,1,109.4909,18.26465,1462
216334,490A5F2D9652290BBCEA32DFC103B993,31031,19,20,1,109.49979,18.25382,1510
216393,4F49ADA2EE71E2E5C2D426996D3142E6,30661,13,14,1,109.37028,18.24361,1008
216394,4F49ADA2EE71E2E5C2D426996D3142E6,60411,15,22,7,109.32514,18.30854,869
216395,855D815DC19AA779325469411A9E7B8A,30251,0,1,1,109.50611,18.26653,1512
216396,855D815DC19AA779325469411A9E7B8A,38157,3,8,5,109.51483,18.26958,1563
216397,855D815DC19AA779325469411A9E7B8A,30251,11,12,1,109.50611,18.26653,1512
216398,855D815DC19AA779325469411A9E7B8A,38157,12,16,4,109.51483,18.26958,1563
216434,5D19AE00A7DE9CA9A8F4923462026C8B,31231,1,6,5,109.42597,18.29292,1217
216436,5D19AE00A7DE9CA9A8F4923462026C8B,60381,16,18,2,109.5241,18.22458,1605
216437,5D19AE00A7DE9CA9A8F4923462026C8B,31031,19,20,1,109.49979,18.25382,1510
216438,5D19AE00A7DE9CA9A8F4923462026C8B,60081,20,22,2,109.51097,18.22639,1556
216448,8621CFDF1B89A83351494618C53D033F,31071,0,5,5,109.58257,18.28458,1815
216449,8621CFDF1B89A83351494618C53D033F,39181,6,11,5,109.55153,18.28035,1715
216450,8621CFDF1B89A83351494618C53D033F,31071,11,14,3,109.58257,18.28458,1815
216451,8621CFDF1B89A83351494618C53D033F,39181,14,21,7,109.55153,18.28035,1715
216452,8621CFDF1B89A83351494618C53D033F,31071,22,23,1,109.58257,18.28458,1815
216511,BE7763F8096EB5A037146E1CC4190538,31561,11,13,2,109.56792,18.28479,1765
216512,BE7763F8096EB5A037146E1CC4190538,30854,13,15,2,109.56889,18.27076,1763
216519,E8BE10EF1C0A6A216F7B6C008ED029A8,60371,0,7,7,109.53063,18.30056,1618
216520,E8BE10EF1C0A6A216F7B6C008ED029A8,31571,8,11,3,109.61563,18.23326,1957
216547,AE1D2CB811A45E9D0BA691392CEA1100,31071,15,16,1,109.58257,18.28458,1815
216548,AE1D2CB811A45E9D0BA691392CEA1100,31071,17,19,2,109.58257,18.28458,1815
216549,AE1D2CB811A45E9D0BA691392CEA1100,30854,20,22,2,109.56889,18.27076,1763
216675,DEFDF52078F80D0DB257A40413FF368C,31071,0,5,5,109.58257,18.28458,1815
216676,DEFDF52078F80D0DB257A40413FF368C,30854,6,20,14,109.56889,18.27076,1763
216677,DEFDF52078F80D0DB257A40413FF368C,31071,21,22,1,109.58257,18.28458,1815
216678,DEFDF52078F80D0DB257A40413FF368C,30854,22,23,1,109.56889,18.27076,1763
216720,CD3BCBAB8571FB81953C842A434E5DB8,31071,8,16,8,109.58257,18.28458,1815
216721,CD3BCBAB8571FB81953C842A434E5DB8,30854,16,17,1,109.56889,18.27076,1763
216776,4B004637D3CFBCA65EA00FFD3F1EF7A6,31561,0,6,6,109.56792,18.28479,1765
216777,4B004637D3CFBCA65EA00FFD3F1EF7A6,30071,8,9,1,109.52819,18.30472,1619
216778,4B004637D3CFBCA65EA00FFD3F1EF7A6,39183,9,11,2,109.55542,18.28208,1715
216779,4B004637D3CFBCA65EA00FFD3F1EF7A6,31561,11,23,12,109.56792,18.28479,1765
216827,EBD16061EA20EE33D9344D33735E5205,31441,0,12,12,109.51181,18.24424,1559
216828,EBD16061EA20EE33D9344D33735E5205,31261,14,17,3,109.51174,18.2466,1559
216829,EBD16061EA20EE33D9344D33735E5205,31441,17,23,6,109.51181,18.24424,1559
216843,E27729CF5C68766C958C34CEBE1241B2,30351,0,10,10,109.41701,18.29292,1217
216844,E27729CF5C68766C958C34CEBE1241B2,38671,12,13,1,109.41576,18.29285,1167
216845,E27729CF5C68766C958C34CEBE1241B2,31251,14,15,1,109.18528,18.2975,317
216846,E27729CF5C68766C958C34CEBE1241B2,38671,17,19,2,109.41576,18.29285,1167
216847,E27729CF5C68766C958C34CEBE1241B2,31231,19,21,2,109.42597,18.29292,1217
216892,4879DE9CACF93CF08E9DC08004A43027,38951,14,18,4,109.48097,18.28868,1416
216893,4879DE9CACF93CF08E9DC08004A43027,30721,19,21,2,109.51597,18.28257,1565
216915,AE6DC7ACB81DB5F351E45AC25E5F5A3B,60281,0,1,1,109.51743,18.25924,1561
216916,AE6DC7ACB81DB5F351E45AC25E5F5A3B,60381,2,3,1,109.5241,18.22458,1605
216917,AE6DC7ACB81DB5F351E45AC25E5F5A3B,38297,5,7,2,109.52576,18.24965,1609
216918,AE6DC7ACB81DB5F351E45AC25E5F5A3B,39154,8,11,3,109.50201,18.25681,1511
216944,0402BD114B7D5E20705E302B756CD062,31071,0,7,7,109.58257,18.28458,1815
216945,0402BD114B7D5E20705E302B756CD062,30854,8,11,3,109.56889,18.27076,1763
216946,0402BD114B7D5E20705E302B756CD062,60631,12,13,1,109.57778,18.27583,1814
216947,0402BD114B7D5E20705E302B756CD062,30854,15,21,6,109.56889,18.27076,1763
216948,0402BD114B7D5E20705E302B756CD062,31071,21,23,2,109.58257,18.28458,1815
216961,ACDEAAF45B65DE48CF80A48DBD3C775E,31071,1,6,5,109.58257,18.28458,1815
216962,ACDEAAF45B65DE48CF80A48DBD3C775E,30854,7,19,12,109.56889,18.27076,1763
216963,ACDEAAF45B65DE48CF80A48DBD3C775E,31071,19,20,1,109.58257,18.28458,1815
216968,5EBEA276FCB4A19AC5C987F5C7CC8908,60621,0,9,9,109.48354,18.27451,1464
216969,5EBEA276FCB4A19AC5C987F5C7CC8908,60551,10,11,1,109.42722,18.30111,1218
216970,5EBEA276FCB4A19AC5C987F5C7CC8908,38361,13,14,1,109.43667,18.29201,1267
216981,DB4DF566D4757FF3BB488F82DE126248,31561,0,15,15,109.56792,18.28479,1765
216982,DB4DF566D4757FF3BB488F82DE126248,30851,16,18,2,109.5616,18.27396,1713
216983,DB4DF566D4757FF3BB488F82DE126248,31561,18,23,5,109.56792,18.28479,1765
217031,B55959B64746A18ECF5077B5F7359221,31561,0,5,5,109.56792,18.28479,1765
217032,B55959B64746A18ECF5077B5F7359221,60331,8,10,2,109.505,18.26507,1512
217033,B55959B64746A18ECF5077B5F7359221,31561,11,13,2,109.56792,18.28479,1765
217036,59B48C7DD533E36B4AA6ADABEB53F8C6,60631,0,6,6,109.57778,18.27583,1814
217037,59B48C7DD533E36B4AA6ADABEB53F8C6,31571,7,9,2,109.61563,18.23326,1957
217038,59B48C7DD533E36B4AA6ADABEB53F8C6,60591,11,16,5,109.61118,18.21715,1904
217053,063A6C1319C2FB8D51BDBDBC79DDAACC,39131,1,4,3,109.2066,18.29639,417
217054,063A6C1319C2FB8D51BDBDBC79DDAACC,31781,9,11,2,109.19847,18.2975,367
217147,179FD4660C817BD29234A518F00339D3,60231,0,10,10,109.49903,18.21972,1504
217148,179FD4660C817BD29234A518F00339D3,60161,14,18,4,109.49174,18.26181,1461
217165,13664B2E5419DDA8E26BAB65AA04153C,31861,19,21,2,109.49042,18.27549,1464
217166,13664B2E5419DDA8E26BAB65AA04153C,31181,21,23,2,109.50382,18.24813,1509
217194,B7A2800FDF738E1064EAD2A5E58F7A3C,61011,1,5,4,109.60653,18.19076,1900
217196,B7A2800FDF738E1064EAD2A5E58F7A3C,61011,19,23,4,109.60653,18.19076,1900
217233,0C8D15C0488D521680F0DE3A28CFE111,31811,0,6,6,109.54201,18.31806,1671
217234,0C8D15C0488D521680F0DE3A28CFE111,30701,7,8,1,109.59313,18.32007,1871
217235,0C8D15C0488D521680F0DE3A28CFE111,31811,10,12,2,109.54201,18.31806,1671
217236,0C8D15C0488D521680F0DE3A28CFE111,30701,12,15,3,109.59313,18.32007,1871
217237,0C8D15C0488D521680F0DE3A28CFE111,31811,20,21,1,109.54201,18.31806,1671
217238,0C8D15C0488D521680F0DE3A28CFE111,30701,22,23,1,109.59313,18.32007,1871
217242,CA3896FB33E9BC68E91955EDFF5D709B,60631,0,6,6,109.57778,18.27583,1814
217243,CA3896FB33E9BC68E91955EDFF5D709B,31945,10,11,1,109.58021,18.29403,1817
217244,CA3896FB33E9BC68E91955EDFF5D709B,30854,15,23,8,109.56889,18.27076,1763
217288,6B806948BC9187A91D033B4096721B00,31561,2,8,6,109.56792,18.28479,1765
217289,6B806948BC9187A91D033B4096721B00,30851,10,12,2,109.5616,18.27396,1713
217290,6B806948BC9187A91D033B4096721B00,31071,12,17,5,109.58257,18.28458,1815
217299,F621296F333E8058687ACD884B135C6E,60114,2,7,5,109.73028,18.33847,2374
217300,F621296F333E8058687ACD884B135C6E,31901,11,13,2,109.68236,18.35368,2227
217360,2B3A265A9E3070334490C5E224B5CAE0,31421,7,9,2,109.55382,18.22347,1705
217361,2B3A265A9E3070334490C5E224B5CAE0,30854,13,14,1,109.56889,18.27076,1763
217362,2B3A265A9E3070334490C5E224B5CAE0,31071,18,22,4,109.58257,18.28458,1815
217408,149F44702DEC8C73589BE6524F0A1FFD,30854,5,14,9,109.56889,18.27076,1763
217409,149F44702DEC8C73589BE6524F0A1FFD,60631,15,17,2,109.57778,18.27583,1814
217410,149F44702DEC8C73589BE6524F0A1FFD,30854,18,20,2,109.56889,18.27076,1763
217411,011859AA130B61CD7FFEFC39AEF2B9BF,30821,1,11,10,109.43681,18.33639,1274
217412,011859AA130B61CD7FFEFC39AEF2B9BF,30651,13,15,2,109.42611,18.385,1232
217413,011859AA130B61CD7FFEFC39AEF2B9BF,60472,15,19,4,109.46625,18.29542,1367
217414,011859AA130B61CD7FFEFC39AEF2B9BF,30821,21,22,1,109.43681,18.33639,1274
217458,14DC9638CB494ECD60B58F300BAA61B6,38154,0,6,6,109.5266,18.28278,1615
217459,14DC9638CB494ECD60B58F300BAA61B6,31931,7,9,2,109.54771,18.29403,1667
217460,14DC9638CB494ECD60B58F300BAA61B6,39181,10,13,3,109.55153,18.28035,1715
217461,14DC9638CB494ECD60B58F300BAA61B6,31561,15,16,1,109.56792,18.28479,1765
217462,14DC9638CB494ECD60B58F300BAA61B6,38154,19,23,4,109.5266,18.28278,1615
217473,372BCC9E34709FCD9ED7D887E115E777,31561,0,7,7,109.56792,18.28479,1765
217474,372BCC9E34709FCD9ED7D887E115E777,30854,7,9,2,109.56889,18.27076,1763
217475,372BCC9E34709FCD9ED7D887E115E777,31071,14,15,1,109.58257,18.28458,1815
217476,372BCC9E34709FCD9ED7D887E115E777,31071,15,16,1,109.58257,18.28458,1815
217477,372BCC9E34709FCD9ED7D887E115E777,31071,18,21,3,109.58257,18.28458,1815
217478,4EC716C6116001DCCA61DAB5E48F9371,30421,12,13,1,109.50021,18.25861,1511
217479,4EC716C6116001DCCA61DAB5E48F9371,31781,15,17,2,109.19847,18.2975,367
217480,4EC716C6116001DCCA61DAB5E48F9371,60421,20,21,1,109.46333,18.31743,1371
217499,C93386A9D86FE22A1FD4E5116045DD8D,31561,3,6,3,109.56792,18.28479,1765
217500,C93386A9D86FE22A1FD4E5116045DD8D,39183,9,10,1,109.55542,18.28208,1715
217501,C93386A9D86FE22A1FD4E5116045DD8D,31561,11,13,2,109.56792,18.28479,1765
217532,3E1EE5C3B3EA02D05BA98946F054AD5C,38291,21,22,1,109.51618,18.24313,1558
217533,2B8C748A18FA7D08D4335AD7C9DEF01B,30851,10,14,4,109.5616,18.27396,1713
217534,2B8C748A18FA7D08D4335AD7C9DEF01B,31761,18,23,5,109.60521,18.27965,1914
217541,48EC852B1939DE9DE8D67EA49BF6D736,30071,13,14,1,109.52819,18.30472,1619
217542,48EC852B1939DE9DE8D67EA49BF6D736,60171,18,19,1,109.51292,18.30694,1569
217543,DED64374A4602648AE7C998119F6E01F,60171,12,14,2,109.51292,18.30694,1569
217544,DED64374A4602648AE7C998119F6E01F,30381,19,20,1,109.52521,18.24507,1609
217561,6587551DA47309E484D1302521C8D417,60631,1,6,5,109.57778,18.27583,1814
217562,6587551DA47309E484D1302521C8D417,38275,7,22,15,109.62875,18.22938,2006
217563,01C3A40E8C2D18FB80BE4CD2C78B4B61,39091,0,12,12,109.50097,18.25222,1510
217564,01C3A40E8C2D18FB80BE4CD2C78B4B61,39091,15,21,6,109.50097,18.25222,1510
217583,DA10676C4DA702E02A2C3FFFAC40ABA2,30211,9,10,1,109.49882,18.23931,1508
217584,DA10676C4DA702E02A2C3FFFAC40ABA2,31561,12,22,10,109.56792,18.28479,1765
217589,3977578BE56276DA0700B04B81DC1356,31561,7,11,4,109.56792,18.28479,1765
217590,3977578BE56276DA0700B04B81DC1356,30851,11,16,5,109.5616,18.27396,1713
217610,671F8FFC6DE1C9E23B99BCA5E485BAC3,30084,2,9,7,109.50118,18.26972,1513
217611,671F8FFC6DE1C9E23B99BCA5E485BAC3,30441,11,12,1,109.64021,18.25424,2010
217612,671F8FFC6DE1C9E23B99BCA5E485BAC3,60401,16,20,4,109.47444,18.27583,1414
217613,671F8FFC6DE1C9E23B99BCA5E485BAC3,30201,22,23,1,109.4909,18.26465,1462
217632,7C9A3DA4FAA96538C9DBC71D98F4E61B,38157,0,7,7,109.51483,18.26958,1563
217633,7C9A3DA4FAA96538C9DBC71D98F4E61B,30854,9,10,1,109.56889,18.27076,1763
217634,7C9A3DA4FAA96538C9DBC71D98F4E61B,31561,12,14,2,109.56792,18.28479,1765
217635,7C9A3DA4FAA96538C9DBC71D98F4E61B,30854,17,18,1,109.56889,18.27076,1763
217713,0E129C09250C0D46273B4BD7E5225556,30151,0,6,6,109.50986,18.25083,1560
217714,0E129C09250C0D46273B4BD7E5225556,39154,7,8,1,109.50201,18.25681,1511
217717,0E129C09250C0D46273B4BD7E5225556,60281,19,21,2,109.51743,18.25924,1561
217718,0E129C09250C0D46273B4BD7E5225556,30151,21,23,2,109.50986,18.25083,1560
217721,44FF3F3995A0081423CE688C5217DF97,31864,18,19,1,109.49014,18.28333,1465
217722,44FF3F3995A0081423CE688C5217DF97,38903,22,23,1,109.39229,18.29243,1117
217742,1D4558B4C0B5F77B61048106C84086AA,31091,0,5,5,109.41201,18.31222,1170
217743,1D4558B4C0B5F77B61048106C84086AA,31231,6,10,4,109.42597,18.29292,1217
217754,3F80F6C7ECC59E36D89C8EF1746C8724,39053,2,10,8,109.511,18.2771,1564
217755,3F80F6C7ECC59E36D89C8EF1746C8724,60291,12,13,1,109.50826,18.24639,1509
217756,3F80F6C7ECC59E36D89C8EF1746C8724,30191,13,14,1,109.50361,18.22701,1506
217757,3F80F6C7ECC59E36D89C8EF1746C8724,38891,19,20,1,109.51486,18.24118,1558
217768,5D4E252AC551D7DB97A6F7C764F981F2,31351,0,7,7,109.4959,18.28417,1465
217769,5D4E252AC551D7DB97A6F7C764F981F2,60331,12,13,1,109.505,18.26507,1512
217770,5D4E252AC551D7DB97A6F7C764F981F2,38127,16,17,1,109.50833,18.27222,1513
217771,5D4E252AC551D7DB97A6F7C764F981F2,31351,20,23,3,109.4959,18.28417,1465
217776,C709D01469E0800AF998DFAF42105CDC,30854,1,2,1,109.56889,18.27076,1763
217777,C709D01469E0800AF998DFAF42105CDC,31561,7,16,9,109.56792,18.28479,1765
217778,C709D01469E0800AF998DFAF42105CDC,30854,18,22,4,109.56889,18.27076,1763
217802,451E2BF48CD7B253EB0892324E679BCC,60311,1,2,1,109.52097,18.24319,1558
217803,451E2BF48CD7B253EB0892324E679BCC,38297,3,5,2,109.52576,18.24965,1609
217804,451E2BF48CD7B253EB0892324E679BCC,38291,6,13,7,109.51618,18.24313,1558
217805,451E2BF48CD7B253EB0892324E679BCC,60281,13,16,3,109.51743,18.25924,1561
217806,451E2BF48CD7B253EB0892324E679BCC,38291,19,21,2,109.51618,18.24313,1558
217807,451E2BF48CD7B253EB0892324E679BCC,38297,21,22,1,109.52576,18.24965,1609
217831,3160CBE2F0CDCB610575CDC881D9968C,38297,0,14,14,109.52576,18.24965,1609
217832,3160CBE2F0CDCB610575CDC881D9968C,38185,17,18,1,109.51333,18.27347,1563
217833,3160CBE2F0CDCB610575CDC881D9968C,30861,18,20,2,109.52722,18.22743,1606
217834,3160CBE2F0CDCB610575CDC881D9968C,38297,22,23,1,109.52576,18.24965,1609
217849,CB9F456D1275025691EE74018BA9AEE8,60401,6,8,2,109.47444,18.27583,1414
217850,CB9F456D1275025691EE74018BA9AEE8,31231,12,13,1,109.42597,18.29292,1217
217851,CB9F456D1275025691EE74018BA9AEE8,31231,14,16,2,109.42597,18.29292,1217
217856,5ABFF3E8EB470884C270C0C936A89A00,30421,16,19,3,109.50021,18.25861,1511
217892,DDE77D3A656666992FC3458B84010D43,39183,0,4,4,109.55542,18.28208,1715
217893,DDE77D3A656666992FC3458B84010D43,31561,7,8,1,109.56792,18.28479,1765
217894,DDE77D3A656666992FC3458B84010D43,39183,9,13,4,109.55542,18.28208,1715
217925,529A14F498129B0238F7B12A9FC7F6F7,31205,0,1,1,109.51111,18.23736,1557
217926,529A14F498129B0238F7B12A9FC7F6F7,31701,2,5,3,109.44132,18.28833,1266
217927,529A14F498129B0238F7B12A9FC7F6F7,31671,6,8,2,109.38965,18.29813,1068
217928,529A14F498129B0238F7B12A9FC7F6F7,30421,19,21,2,109.50021,18.25861,1511
217929,529A14F498129B0238F7B12A9FC7F6F7,31671,21,23,2,109.38965,18.29813,1068
218004,C2622C284BAD8F487DCD454B3FAF9432,60361,0,8,8,109.51938,18.29681,1567
218005,C2622C284BAD8F487DCD454B3FAF9432,30721,10,11,1,109.51597,18.28257,1565
218006,C2622C284BAD8F487DCD454B3FAF9432,60274,12,13,1,109.514,18.2933,1567
218007,C2622C284BAD8F487DCD454B3FAF9432,31121,17,20,3,109.16292,18.37063,230
218008,C2622C284BAD8F487DCD454B3FAF9432,30721,22,23,1,109.51597,18.28257,1565
218021,5202825DF51CA068C8B204422480230F,31945,1,2,1,109.58021,18.29403,1817
218022,5202825DF51CA068C8B204422480230F,31071,3,6,3,109.58257,18.28458,1815
218050,0E1B3CFC64EBB658DA96D0DCA834701E,61011,10,12,2,109.60653,18.19076,1900
218066,638CB96B52752860DC8C286EB33044A7,31471,0,4,4,109.34583,18.29563,917
218067,638CB96B52752860DC8C286EB33044A7,30661,5,7,2,109.37028,18.24361,1008
218069,348BC15248D83C0CF0D2494FAD03D52E,30201,9,11,2,109.4909,18.26465,1462
218070,348BC15248D83C0CF0D2494FAD03D52E,39053,12,23,11,109.511,18.2771,1564
218071,6CFAB52F14B9F6126A5F32C6F3BFD184,31521,0,8,8,109.51458,18.22542,1555
218072,6CFAB52F14B9F6126A5F32C6F3BFD184,60381,13,14,1,109.5241,18.22458,1605
218073,6CFAB52F14B9F6126A5F32C6F3BFD184,31521,15,16,1,109.51458,18.22542,1555
218074,6CFAB52F14B9F6126A5F32C6F3BFD184,30201,17,19,2,109.4909,18.26465,1462
218075,6CFAB52F14B9F6126A5F32C6F3BFD184,31521,21,22,1,109.51458,18.22542,1555
218098,D39D64452E6BBEF7B3056CA239E1B86E,30854,0,6,6,109.56889,18.27076,1763
218099,D39D64452E6BBEF7B3056CA239E1B86E,31561,6,8,2,109.56792,18.28479,1765
218100,D39D64452E6BBEF7B3056CA239E1B86E,30854,9,17,8,109.56889,18.27076,1763
218105,4F11D612346C7FFB90217D3B5C38FCCC,31236,0,6,6,109.42965,18.29111,1216
218106,4F11D612346C7FFB90217D3B5C38FCCC,31781,9,11,2,109.19847,18.2975,367
218107,4F11D612346C7FFB90217D3B5C38FCCC,31231,16,19,3,109.42597,18.29292,1217
218108,4F11D612346C7FFB90217D3B5C38FCCC,60551,19,21,2,109.42722,18.30111,1218
218109,4F11D612346C7FFB90217D3B5C38FCCC,60524,21,23,2,109.42951,18.28993,1216
218139,A7D270EF8C74F66D966F17A0E3BC8BC9,31071,0,6,6,109.58257,18.28458,1815
218140,A7D270EF8C74F66D966F17A0E3BC8BC9,30854,8,10,2,109.56889,18.27076,1763
218141,A7D270EF8C74F66D966F17A0E3BC8BC9,31071,12,15,3,109.58257,18.28458,1815
218142,A7D270EF8C74F66D966F17A0E3BC8BC9,38891,18,19,1,109.51486,18.24118,1558
218143,A7D270EF8C74F66D966F17A0E3BC8BC9,31071,22,23,1,109.58257,18.28458,1815
218184,6ECBE8E4C20070F8B38521B2287A305F,31145,14,15,1,109.20431,18.30479,369
218185,6ECBE8E4C20070F8B38521B2287A305F,31071,20,23,3,109.58257,18.28458,1815
218190,6E55CCA79B55B824AD4C2A947EDB25E3,38361,0,10,10,109.43667,18.29201,1267
218191,6E55CCA79B55B824AD4C2A947EDB25E3,31471,11,12,1,109.34583,18.29563,917
218192,6E55CCA79B55B824AD4C2A947EDB25E3,38361,16,23,7,109.43667,18.29201,1267
218196,34AB502A442AA8EA4A7FB30471B204DB,30171,0,6,6,109.48458,18.27139,1463
218197,34AB502A442AA8EA4A7FB30471B204DB,60401,8,19,11,109.47444,18.27583,1414
218198,34AB502A442AA8EA4A7FB30471B204DB,60621,19,23,4,109.48354,18.27451,1464
218212,0502EBC4DE012139F0DB860901E25767,38361,0,9,9,109.43667,18.29201,1267
218213,0502EBC4DE012139F0DB860901E25767,31471,10,14,4,109.34583,18.29563,917
218214,0502EBC4DE012139F0DB860901E25767,38361,16,23,7,109.43667,18.29201,1267
218218,B0C6DED232762D9BAF78468BD2731104,60541,13,14,1,109.4084,18.29208,1167
218219,B0C6DED232762D9BAF78468BD2731104,30581,19,23,4,109.62257,18.24951,1959
218250,CD576F1C1CDFB89E6A99A20E65927346,30854,5,6,1,109.56889,18.27076,1763
218251,CD576F1C1CDFB89E6A99A20E65927346,31561,7,10,3,109.56792,18.28479,1765
218252,CD576F1C1CDFB89E6A99A20E65927346,30854,12,15,3,109.56889,18.27076,1763
218253,CD576F1C1CDFB89E6A99A20E65927346,31561,16,18,2,109.56792,18.28479,1765
218308,B712327B6033C61F37801CFD6DAC08AD,31951,0,2,2,109.52174,18.30299,1568
218309,B712327B6033C61F37801CFD6DAC08AD,38484,5,22,17,109.53028,18.31528,1620
218330,135D4111C8DB5F7D1A5E83743F59E45E,30851,4,5,1,109.5616,18.27396,1713
218331,135D4111C8DB5F7D1A5E83743F59E45E,31121,7,12,5,109.16292,18.37063,230
218332,135D4111C8DB5F7D1A5E83743F59E45E,31021,13,16,3,109.49021,18.27,1463
218340,63FBAC0202144B00077561285E6A7F87,30821,0,7,7,109.43681,18.33639,1274
218341,63FBAC0202144B00077561285E6A7F87,30651,8,9,1,109.42611,18.385,1232
218342,63FBAC0202144B00077561285E6A7F87,30821,9,22,13,109.43681,18.33639,1274
218382,225EDE82328108AFB3E7EE610CA3F074,60371,0,5,5,109.53063,18.30056,1618
218383,225EDE82328108AFB3E7EE610CA3F074,31931,7,9,2,109.54771,18.29403,1667
218384,225EDE82328108AFB3E7EE610CA3F074,60371,11,12,1,109.53063,18.30056,1618
218431,89362A3CA3AE6F5B75871F2110924F99,30851,0,6,6,109.5616,18.27396,1713
218432,89362A3CA3AE6F5B75871F2110924F99,30951,10,13,3,109.56208,18.25667,1761
218433,89362A3CA3AE6F5B75871F2110924F99,39371,14,16,2,109.56627,18.2646,1762
218434,89362A3CA3AE6F5B75871F2110924F99,30851,18,23,5,109.5616,18.27396,1713
218453,7D632B68A96EBB9D6582527232D6634C,31461,0,8,8,109.5091,18.25389,1510
218454,7D632B68A96EBB9D6582527232D6634C,31231,9,11,2,109.42597,18.29292,1217
218455,7D632B68A96EBB9D6582527232D6634C,31461,11,13,2,109.5091,18.25389,1510
218456,7D632B68A96EBB9D6582527232D6634C,31291,15,16,1,109.30375,18.40729,786
218472,4E42F3C8BFACF58FB6187931BEBBDF23,31931,19,20,1,109.54771,18.29403,1667
218473,4E42F3C8BFACF58FB6187931BEBBDF23,38484,21,23,2,109.53028,18.31528,1620
218474,DA7F75EB1D499DC5A1A7DEE3CAD1DCEE,30731,6,8,2,109.50944,18.22306,1555
218475,DA7F75EB1D499DC5A1A7DEE3CAD1DCEE,60631,13,14,1,109.57778,18.27583,1814
218476,DA7F75EB1D499DC5A1A7DEE3CAD1DCEE,39183,17,18,1,109.55542,18.28208,1715
218483,09605A95AE7BE30FC92DC699DB3FCBD0,30711,0,9,9,109.50271,18.25347,1510
218484,09605A95AE7BE30FC92DC699DB3FCBD0,31171,9,10,1,109.50938,18.24917,1559
218485,09605A95AE7BE30FC92DC699DB3FCBD0,31461,10,12,2,109.5091,18.25389,1510
218486,09605A95AE7BE30FC92DC699DB3FCBD0,30711,12,13,1,109.50271,18.25347,1510
218526,B78E7295CB13532B4E2C30EF158E297F,30854,0,7,7,109.56889,18.27076,1763
218527,B78E7295CB13532B4E2C30EF158E297F,39183,11,20,9,109.55542,18.28208,1715
218556,D6E72F3649E9FA4F285A8682EF1A1E3A,60381,6,8,2,109.5241,18.22458,1605
218557,D6E72F3649E9FA4F285A8682EF1A1E3A,31521,8,14,6,109.51458,18.22542,1555
218558,D6E72F3649E9FA4F285A8682EF1A1E3A,38071,17,19,2,109.40722,18.30938,1169
218561,AA2A5396AD753E9245AC53C94BAEDECD,61011,1,18,17,109.60653,18.19076,1900
218578,182D5101D28D51096306D4EF5FDD4501,60084,0,1,1,109.4984,18.2334,1507
218579,182D5101D28D51096306D4EF5FDD4501,30271,1,5,4,109.49132,18.23153,1456
218581,182D5101D28D51096306D4EF5FDD4501,30271,20,21,1,109.49132,18.23153,1456
218602,44CE0EC5534779B9EE45B4716AA8F607,60221,18,21,3,109.52569,18.29188,1616
218603,44CE0EC5534779B9EE45B4716AA8F607,31461,21,23,2,109.5091,18.25389,1510
218652,999DEB7BFC175BF03EAE5DB1D4B2EFB6,60361,18,20,2,109.51938,18.29681,1567
218653,999DEB7BFC175BF03EAE5DB1D4B2EFB6,31951,22,23,1,109.52174,18.30299,1568
218667,18073AD9E71B8DFC1E520C5E3653B1BD,30721,1,6,5,109.51597,18.28257,1565
218668,18073AD9E71B8DFC1E520C5E3653B1BD,31951,10,14,4,109.52174,18.30299,1568
218669,18073AD9E71B8DFC1E520C5E3653B1BD,31291,19,23,4,109.30375,18.40729,786
218675,30F5D42A1A8F1CF26F5C9617FCB06C4F,39181,0,5,5,109.55153,18.28035,1715
218676,30F5D42A1A8F1CF26F5C9617FCB06C4F,31561,8,9,1,109.56792,18.28479,1765
218677,30F5D42A1A8F1CF26F5C9617FCB06C4F,39181,13,16,3,109.55153,18.28035,1715
218678,30F5D42A1A8F1CF26F5C9617FCB06C4F,31561,20,23,3,109.56792,18.28479,1765
218755,8293619D825F160795AE71B17456FBCB,60631,4,5,1,109.57778,18.27583,1814
218756,8293619D825F160795AE71B17456FBCB,30854,8,10,2,109.56889,18.27076,1763
218757,8293619D825F160795AE71B17456FBCB,38071,14,23,9,109.40722,18.30938,1169
218837,97C31877CA4226D0F1BA1C0E12066B56,30251,0,6,6,109.50611,18.26653,1512
218838,97C31877CA4226D0F1BA1C0E12066B56,30854,7,14,7,109.56889,18.27076,1763
218839,97C31877CA4226D0F1BA1C0E12066B56,30251,18,20,2,109.50611,18.26653,1512
218840,97C31877CA4226D0F1BA1C0E12066B56,60331,21,23,2,109.505,18.26507,1512
218850,A549C024E6F63EDBD3DC866F10DB11CE,30854,18,21,3,109.56889,18.27076,1763
218882,56C816225242DBDB8077A15C902CFC9F,30421,11,13,2,109.50021,18.25861,1511
218883,56C816225242DBDB8077A15C902CFC9F,60351,14,16,2,109.58403,18.28958,1816
218910,9AF351B3CC27394DFED45513F0E32162,31071,0,7,7,109.58257,18.28458,1815
218911,9AF351B3CC27394DFED45513F0E32162,31551,11,13,2,109.55868,18.24222,1708
218912,9AF351B3CC27394DFED45513F0E32162,30951,14,16,2,109.56208,18.25667,1761
218913,9AF351B3CC27394DFED45513F0E32162,60351,18,21,3,109.58403,18.28958,1816
218914,9AF351B3CC27394DFED45513F0E32162,31071,21,23,2,109.58257,18.28458,1815
218915,EF760E312F2C3813DF12E817771E652B,38017,0,7,7,109.49729,18.21424,1504
218916,EF760E312F2C3813DF12E817771E652B,31521,7,9,2,109.51458,18.22542,1555
218917,EF760E312F2C3813DF12E817771E652B,31145,11,12,1,109.20431,18.30479,369
218918,EF760E312F2C3813DF12E817771E652B,31471,16,18,2,109.34583,18.29563,917
218919,EF760E312F2C3813DF12E817771E652B,38017,21,23,2,109.49729,18.21424,1504
218926,86435198F57620D5DAC23B4A4DA78009,31931,3,5,2,109.54771,18.29403,1667
218927,86435198F57620D5DAC23B4A4DA78009,39183,7,15,8,109.55542,18.28208,1715
218933,17CAFA3F8664F13D5B9674760A5254BD,30854,13,14,1,109.56889,18.27076,1763
218934,17CAFA3F8664F13D5B9674760A5254BD,30071,15,16,1,109.52819,18.30472,1619
218935,17CAFA3F8664F13D5B9674760A5254BD,38991,18,19,1,109.52681,18.30368,1618
218964,A551EAA1DE74C03D4B9F4BD7AE33BA27,39183,0,6,6,109.55542,18.28208,1715
218965,A551EAA1DE74C03D4B9F4BD7AE33BA27,60631,7,8,1,109.57778,18.27583,1814
218966,A551EAA1DE74C03D4B9F4BD7AE33BA27,30854,8,17,9,109.56889,18.27076,1763
218994,85586D73EA48B4F4D520D899B0BE0554,30854,13,15,2,109.56889,18.27076,1763
218995,85586D73EA48B4F4D520D899B0BE0554,30291,19,23,4,109.50403,18.27028,1513
219016,10EBF762D28520B09848288F7052CFDE,30854,0,7,7,109.56889,18.27076,1763
219017,10EBF762D28520B09848288F7052CFDE,31561,8,18,10,109.56792,18.28479,1765
219029,C30EF1A03F3ACD87114629BE5EBA14E8,31231,13,14,1,109.42597,18.29292,1217
219030,C30EF1A03F3ACD87114629BE5EBA14E8,31231,17,18,1,109.42597,18.29292,1217
219031,C30EF1A03F3ACD87114629BE5EBA14E8,60041,22,23,1,109.39889,18.31944,1121
219056,546C572FC49C780F9A9AF62ED98666DF,30351,0,21,21,109.41701,18.29292,1217
219057,546C572FC49C780F9A9AF62ED98666DF,30681,22,23,1,109.48493,18.26917,1463
219058,182603D8C7C4BF5CDDF16B2E79D9DF52,31231,0,9,9,109.42597,18.29292,1217
219059,182603D8C7C4BF5CDDF16B2E79D9DF52,60401,12,13,1,109.47444,18.27583,1414
219067,87F6D9996659541EF975AE3E55004A94,38484,13,14,1,109.53028,18.31528,1620
219068,87F6D9996659541EF975AE3E55004A94,31031,15,19,4,109.49979,18.25382,1510
219069,487FC583F0AF1414583ADA3127598053,60631,12,14,2,109.57778,18.27583,1814
219070,487FC583F0AF1414583ADA3127598053,30854,17,19,2,109.56889,18.27076,1763
219082,B09F6CB43F7BB3E6391589239BFB1120,38951,0,12,12,109.48097,18.28868,1416
219083,B09F6CB43F7BB3E6391589239BFB1120,60041,14,16,2,109.39889,18.31944,1121
219084,B09F6CB43F7BB3E6391589239BFB1120,38951,21,23,2,109.48097,18.28868,1416
219087,66B36EAB2804138C84FF096B3B06E748,30421,0,1,1,109.50021,18.25861,1511
219088,66B36EAB2804138C84FF096B3B06E748,38881,3,5,2,109.51618,18.26431,1562
219089,66B36EAB2804138C84FF096B3B06E748,30421,7,15,8,109.50021,18.25861,1511
219129,13166628932DF36C0AD7B1DB5811240A,30854,14,16,2,109.56889,18.27076,1763
219130,13166628932DF36C0AD7B1DB5811240A,60591,19,23,4,109.61118,18.21715,1904
219148,B621E9075674E792CCB217233825F9D1,39371,3,7,4,109.56627,18.2646,1762
219149,B621E9075674E792CCB217233825F9D1,60591,11,14,3,109.61118,18.21715,1904
219150,E605B26D53F08A0D3360A4541E09F4E2,30721,0,5,5,109.51597,18.28257,1565
219151,E605B26D53F08A0D3360A4541E09F4E2,38283,7,8,1,109.62229,18.22618,1956
219152,E605B26D53F08A0D3360A4541E09F4E2,38283,11,23,12,109.62229,18.22618,1956
219156,AAFC39C1714209381987EB0F1F011F0B,39151,0,8,8,109.49875,18.25097,1510
219157,AAFC39C1714209381987EB0F1F011F0B,31031,8,10,2,109.49979,18.25382,1510
219158,AAFC39C1714209381987EB0F1F011F0B,31471,15,16,1,109.34583,18.29563,917
219159,AAFC39C1714209381987EB0F1F011F0B,30361,19,21,2,109.50347,18.24,1508
219160,AAFC39C1714209381987EB0F1F011F0B,39151,21,23,2,109.49875,18.25097,1510
219177,2C5F898948A2B7909519666936FBF333,38707,0,6,6,109.73778,18.35368,2427
219178,2C5F898948A2B7909519666936FBF333,38707,8,13,5,109.73778,18.35368,2427
219179,2C5F898948A2B7909519666936FBF333,38707,15,23,8,109.73778,18.35368,2427
219233,FD383D619F571E97F6F509FAB965E5A5,60291,0,12,12,109.50826,18.24639,1509
219244,7AF4921BC4D1712A961904D0ECC91550,30071,0,7,7,109.52819,18.30472,1619
219245,7AF4921BC4D1712A961904D0ECC91550,30071,8,11,3,109.52819,18.30472,1619
219247,7AF4921BC4D1712A961904D0ECC91550,60291,18,20,2,109.50826,18.24639,1509
219248,7AF4921BC4D1712A961904D0ECC91550,30281,21,23,2,109.50597,18.27583,1514
219249,0F558B6653C655C7F0BAEA9D66B33F57,31071,0,5,5,109.58257,18.28458,1815
219250,0F558B6653C655C7F0BAEA9D66B33F57,30854,8,10,2,109.56889,18.27076,1763
219251,0F558B6653C655C7F0BAEA9D66B33F57,31071,10,13,3,109.58257,18.28458,1815
219252,0F558B6653C655C7F0BAEA9D66B33F57,30854,13,16,3,109.56889,18.27076,1763
219253,0F558B6653C655C7F0BAEA9D66B33F57,31071,19,21,2,109.58257,18.28458,1815
219254,DC6FAC9E4085B298085CB0CDBEACDBC4,60524,0,5,5,109.42951,18.28993,1216
219255,DC6FAC9E4085B298085CB0CDBEACDBC4,60552,6,8,2,109.41729,18.30014,1218
219256,DC6FAC9E4085B298085CB0CDBEACDBC4,31781,9,11,2,109.19847,18.2975,367
219264,1026894DC5FF9A7FAF3A2EE28B95E239,60631,9,10,1,109.57778,18.27583,1814
219265,1026894DC5FF9A7FAF3A2EE28B95E239,30854,11,14,3,109.56889,18.27076,1763
219270,43F5AB52A0AF3FEB5880C6DCD16BBA02,60011,0,7,7,109.48965,18.30222,1468
219271,43F5AB52A0AF3FEB5880C6DCD16BBA02,31411,8,12,4,109.5016,18.23576,1507
219272,43F5AB52A0AF3FEB5880C6DCD16BBA02,39101,15,16,1,109.50132,18.24931,1509
219273,43F5AB52A0AF3FEB5880C6DCD16BBA02,30271,19,21,2,109.49132,18.23153,1456
219311,6E580E35F1856BA2850385BDFB597BF5,39371,0,14,14,109.56627,18.2646,1762
219312,6E580E35F1856BA2850385BDFB597BF5,38891,17,18,1,109.51486,18.24118,1558
219313,A01B4012B619D942E7CC3AC9B78722B4,31561,0,6,6,109.56792,18.28479,1765
219314,A01B4012B619D942E7CC3AC9B78722B4,31931,7,9,2,109.54771,18.29403,1667
219315,A01B4012B619D942E7CC3AC9B78722B4,31561,11,15,4,109.56792,18.28479,1765
219316,A01B4012B619D942E7CC3AC9B78722B4,39183,17,18,1,109.55542,18.28208,1715
219317,A01B4012B619D942E7CC3AC9B78722B4,31561,19,23,4,109.56792,18.28479,1765
219329,E2A4A2ABBE2AAFDE32C6FA06BCCC268D,31071,0,4,4,109.58257,18.28458,1815
219330,E2A4A2ABBE2AAFDE32C6FA06BCCC268D,30854,8,9,1,109.56889,18.27076,1763
219331,E2A4A2ABBE2AAFDE32C6FA06BCCC268D,31071,9,23,14,109.58257,18.28458,1815
219332,C153552CEA2677B0FF473AE565EA979E,30821,0,7,7,109.43681,18.33639,1274
219333,C153552CEA2677B0FF473AE565EA979E,30651,8,9,1,109.42611,18.385,1232
219334,C153552CEA2677B0FF473AE565EA979E,30821,9,11,2,109.43681,18.33639,1274
219335,C153552CEA2677B0FF473AE565EA979E,30651,18,20,2,109.42611,18.385,1232
219336,C153552CEA2677B0FF473AE565EA979E,30821,21,23,2,109.43681,18.33639,1274
219337,417408FFDA93B177641D270D3A5C4B2D,31071,0,6,6,109.58257,18.28458,1815
219338,417408FFDA93B177641D270D3A5C4B2D,30854,6,17,11,109.56889,18.27076,1763
219339,417408FFDA93B177641D270D3A5C4B2D,31071,20,22,2,109.58257,18.28458,1815
219344,8394F4F81295DA567F75BB12D1616CF3,60361,0,6,6,109.51938,18.29681,1567
219345,8394F4F81295DA567F75BB12D1616CF3,60274,7,9,2,109.514,18.2933,1567
219346,8394F4F81295DA567F75BB12D1616CF3,31521,14,16,2,109.51458,18.22542,1555
219347,8394F4F81295DA567F75BB12D1616CF3,60361,20,23,3,109.51938,18.29681,1567
219413,84633D8BA654ABD696C26ED03FF61CB6,30084,0,8,8,109.50118,18.26972,1513
219414,84633D8BA654ABD696C26ED03FF61CB6,31531,8,14,6,109.49583,18.25972,1461
219416,84633D8BA654ABD696C26ED03FF61CB6,30084,21,23,2,109.50118,18.26972,1513
219426,1BDE433888973A22F2D9A5CC8B5A34FF,31251,0,3,3,109.18528,18.2975,317
219427,1BDE433888973A22F2D9A5CC8B5A34FF,30861,7,8,1,109.52722,18.22743,1606
219428,1BDE433888973A22F2D9A5CC8B5A34FF,60661,11,14,3,109.548,18.2377,1657
219435,4C70C56742FCE6C02E7446B5A71E4F50,30854,0,5,5,109.56889,18.27076,1763
219436,4C70C56742FCE6C02E7446B5A71E4F50,60354,10,14,4,109.58701,18.28521,1815
219437,4C70C56742FCE6C02E7446B5A71E4F50,30854,14,20,6,109.56889,18.27076,1763
219438,4C70C56742FCE6C02E7446B5A71E4F50,31071,21,23,2,109.58257,18.28458,1815
219461,690F9954285850032888DF5646F55612,38903,0,6,6,109.39229,18.29243,1117
219462,690F9954285850032888DF5646F55612,38325,7,8,1,109.39792,18.2909,1116
219463,690F9954285850032888DF5646F55612,60552,8,10,2,109.41729,18.30014,1218
219464,690F9954285850032888DF5646F55612,38754,11,14,3,109.74667,18.37382,2430
219465,690F9954285850032888DF5646F55612,30671,17,18,1,109.43611,18.30139,1268
219485,D2A5F87218CF25385163A2F3C4229CB8,30851,1,5,4,109.5616,18.27396,1713
219486,D2A5F87218CF25385163A2F3C4229CB8,31561,5,9,4,109.56792,18.28479,1765
219487,D2A5F87218CF25385163A2F3C4229CB8,30851,9,18,9,109.5616,18.27396,1713
219488,D2A5F87218CF25385163A2F3C4229CB8,31561,18,20,2,109.56792,18.28479,1765
219489,D2A5F87218CF25385163A2F3C4229CB8,30851,20,23,3,109.5616,18.27396,1713
219499,DF49F834C08C7E8FA6D78272EE1FB651,60361,0,7,7,109.51938,18.29681,1567
219500,DF49F834C08C7E8FA6D78272EE1FB651,30951,11,14,3,109.56208,18.25667,1761
219501,DF49F834C08C7E8FA6D78272EE1FB651,60361,19,23,4,109.51938,18.29681,1567
219526,BD4652414D5C17466BA36FD4BD943A94,39181,11,13,2,109.55153,18.28035,1715
219527,BD4652414D5C17466BA36FD4BD943A94,31561,15,17,2,109.56792,18.28479,1765
219528,BD4652414D5C17466BA36FD4BD943A94,30421,20,22,2,109.50021,18.25861,1511
219529,147470AD3D3B8724582C30D5F244A8B6,60421,0,8,8,109.46333,18.31743,1371
219530,147470AD3D3B8724582C30D5F244A8B6,30111,9,11,2,109.47583,18.30542,1419
219531,147470AD3D3B8724582C30D5F244A8B6,60421,12,23,11,109.46333,18.31743,1371
219564,B0D9C7F7AA90828414D1A7F1933C372F,60631,0,10,10,109.57778,18.27583,1814
219565,B0D9C7F7AA90828414D1A7F1933C372F,31561,15,17,2,109.56792,18.28479,1765
219566,B0D9C7F7AA90828414D1A7F1933C372F,60631,20,23,3,109.57778,18.27583,1814
219573,D6B14C7387647D8C883334DAFB518257,30854,0,7,7,109.56889,18.27076,1763
219574,D6B14C7387647D8C883334DAFB518257,31561,7,10,3,109.56792,18.28479,1765
219575,D6B14C7387647D8C883334DAFB518257,30854,13,22,9,109.56889,18.27076,1763
219592,D517610C2076C41FED0ED80CB6FFB44C,31561,0,6,6,109.56792,18.28479,1765
219593,D517610C2076C41FED0ED80CB6FFB44C,30851,6,22,16,109.5616,18.27396,1713
219604,6D2D20F4D67580FE7309C23DCCA820C3,31071,0,7,7,109.58257,18.28458,1815
219605,6D2D20F4D67580FE7309C23DCCA820C3,39371,8,9,1,109.56627,18.2646,1762
219606,6D2D20F4D67580FE7309C23DCCA820C3,31421,14,18,4,109.55382,18.22347,1705
219607,6D2D20F4D67580FE7309C23DCCA820C3,31071,20,23,3,109.58257,18.28458,1815
219631,1BF8178261179ACA5D85408F2640E631,60121,16,18,2,109.74507,18.37472,2430
219632,1BF8178261179ACA5D85408F2640E631,30511,21,23,2,109.51069,18.24208,1558
219651,BC2EDF4DF9C7FAD55BDEABA03DFA7284,31561,0,5,5,109.56792,18.28479,1765
219652,BC2EDF4DF9C7FAD55BDEABA03DFA7284,39183,6,8,2,109.55542,18.28208,1715
219653,BC2EDF4DF9C7FAD55BDEABA03DFA7284,30854,9,11,2,109.56889,18.27076,1763
219654,BC2EDF4DF9C7FAD55BDEABA03DFA7284,39183,16,18,2,109.55542,18.28208,1715
219655,C85D0B931BEF54F05B9ABBBB03212DB7,30854,0,15,15,109.56889,18.27076,1763
219656,C85D0B931BEF54F05B9ABBBB03212DB7,31561,16,17,1,109.56792,18.28479,1765
219681,1582BEC240072EC51899932D6A0A257A,30891,1,8,7,109.59431,18.28389,1865
219682,1582BEC240072EC51899932D6A0A257A,30854,9,12,3,109.56889,18.27076,1763
219683,1582BEC240072EC51899932D6A0A257A,30891,15,21,6,109.59431,18.28389,1865
219802,62FCB15297A7724012720DDE29CC0405,31761,0,8,8,109.60521,18.27965,1914
219803,62FCB15297A7724012720DDE29CC0405,38121,12,14,2,109.51361,18.27813,1564
219804,62FCB15297A7724012720DDE29CC0405,30321,15,17,2,109.49563,18.29611,1467
219805,62FCB15297A7724012720DDE29CC0405,38261,21,23,2,109.50361,18.28153,1515
219833,75817DB682187A07461734D66E1E6492,60631,0,4,4,109.57778,18.27583,1814
219834,75817DB682187A07461734D66E1E6492,30854,7,15,8,109.56889,18.27076,1763
219835,75817DB682187A07461734D66E1E6492,60631,18,20,2,109.57778,18.27583,1814
219836,75817DB682187A07461734D66E1E6492,31061,22,23,1,109.53333,18.23257,1607
219873,005F3AEFE6DBF371ED1FD57736434098,31071,4,7,3,109.58257,18.28458,1815
219874,005F3AEFE6DBF371ED1FD57736434098,30854,8,9,1,109.56889,18.27076,1763
219875,005F3AEFE6DBF371ED1FD57736434098,31071,12,13,1,109.58257,18.28458,1815
219876,005F3AEFE6DBF371ED1FD57736434098,30854,20,21,1,109.56889,18.27076,1763
219877,005F3AEFE6DBF371ED1FD57736434098,31071,21,23,2,109.58257,18.28458,1815
219901,163EFE976A3776107F7F37C28AD840B9,38145,1,2,1,109.378,18.2912,1066
219902,163EFE976A3776107F7F37C28AD840B9,38903,3,7,4,109.39229,18.29243,1117
219903,163EFE976A3776107F7F37C28AD840B9,38754,11,15,4,109.74667,18.37382,2430
219904,163EFE976A3776107F7F37C28AD840B9,60551,19,20,1,109.42722,18.30111,1218
219920,06FCF67485A2B44C8ABC96FDB92547C5,61011,0,8,8,109.60653,18.19076,1900
219922,06FCF67485A2B44C8ABC96FDB92547C5,61011,12,15,3,109.60653,18.19076,1900
219924,06FCF67485A2B44C8ABC96FDB92547C5,61011,18,23,5,109.60653,18.19076,1900
219942,53875E69050EC42E511A64D3211FA7B3,30854,14,17,3,109.56889,18.27076,1763
219943,53875E69050EC42E511A64D3211FA7B3,30851,18,19,1,109.5616,18.27396,1713
219944,53875E69050EC42E511A64D3211FA7B3,60631,20,21,1,109.57778,18.27583,1814
219945,53875E69050EC42E511A64D3211FA7B3,30891,22,23,1,109.59431,18.28389,1865
219963,6040C1D616FEA927996002EE01FC4BDC,31071,0,7,7,109.58257,18.28458,1815
219964,6040C1D616FEA927996002EE01FC4BDC,30854,8,9,1,109.56889,18.27076,1763
219965,6040C1D616FEA927996002EE01FC4BDC,31071,10,23,13,109.58257,18.28458,1815
219989,8D8AA41210FC9E2D5DD4D81CF4DB18D7,39151,17,19,2,109.49875,18.25097,1510
219990,8D8AA41210FC9E2D5DD4D81CF4DB18D7,31421,19,21,2,109.55382,18.22347,1705
219991,8D8AA41210FC9E2D5DD4D81CF4DB18D7,60361,21,22,1,109.51938,18.29681,1567
219999,434A797657732D96E867632E246AC267,60381,0,15,15,109.5241,18.22458,1605
220000,434A797657732D96E867632E246AC267,31421,15,16,1,109.55382,18.22347,1705
220001,434A797657732D96E867632E246AC267,60381,17,23,6,109.5241,18.22458,1605
220011,BAB9B8A3D1E7FB96DB94A06687C464B3,31471,13,14,1,109.34583,18.29563,917
220012,BAB9B8A3D1E7FB96DB94A06687C464B3,38094,16,18,2,109.45403,18.28778,1316
220013,BAB9B8A3D1E7FB96DB94A06687C464B3,31864,19,23,4,109.49014,18.28333,1465
220016,ABCD0851CC1C78BCD7AF6DBDF2F5DE49,60552,7,10,3,109.41729,18.30014,1218
220017,ABCD0851CC1C78BCD7AF6DBDF2F5DE49,30671,14,18,4,109.43611,18.30139,1268
220096,37B1280251A3C52411E939549A58D078,39183,0,13,13,109.55542,18.28208,1715
220097,37B1280251A3C52411E939549A58D078,31561,16,17,1,109.56792,18.28479,1765
220098,37B1280251A3C52411E939549A58D078,39183,17,23,6,109.55542,18.28208,1715
220099,B643AC77F8D8498A9694D45BA8B0F75F,60631,0,8,8,109.57778,18.27583,1814
220100,B643AC77F8D8498A9694D45BA8B0F75F,30854,9,11,2,109.56889,18.27076,1763
220101,B643AC77F8D8498A9694D45BA8B0F75F,60631,12,14,2,109.57778,18.27583,1814
220102,B643AC77F8D8498A9694D45BA8B0F75F,31561,17,18,1,109.56792,18.28479,1765
220103,B643AC77F8D8498A9694D45BA8B0F75F,30854,19,21,2,109.56889,18.27076,1763
220131,7252A0F90E29EC78621699C082578EF7,60504,14,17,3,109.47917,18.28903,1416
220132,7252A0F90E29EC78621699C082578EF7,30121,18,19,1,109.52861,18.27222,1613
220133,7252A0F90E29EC78621699C082578EF7,60361,20,22,2,109.51938,18.29681,1567
220145,CE70D3AAC3EF6B01DB8A5F34BD94E77D,30821,0,2,2,109.43681,18.33639,1274
220146,CE70D3AAC3EF6B01DB8A5F34BD94E77D,60011,2,6,4,109.48965,18.30222,1468
220147,CE70D3AAC3EF6B01DB8A5F34BD94E77D,30821,9,23,14,109.43681,18.33639,1274
220180,5F8365FB0789CEF561E94F959B476B78,39063,0,6,6,109.386,18.2919,1066
220181,5F8365FB0789CEF561E94F959B476B78,38754,11,16,5,109.74667,18.37382,2430
220182,5F8365FB0789CEF561E94F959B476B78,60551,19,20,1,109.42722,18.30111,1218
220183,5F8365FB0789CEF561E94F959B476B78,38071,21,23,2,109.40722,18.30938,1169
220239,4734AFF1B70F6E2220C283E468A26DA6,38017,0,8,8,109.49729,18.21424,1504
220240,4734AFF1B70F6E2220C283E468A26DA6,31145,11,12,1,109.20431,18.30479,369
220241,4734AFF1B70F6E2220C283E468A26DA6,60234,15,17,2,109.49577,18.2096,1453
220252,CBFB6695A565EE8288E80536B0FF653C,30854,0,1,1,109.56889,18.27076,1763
220253,CBFB6695A565EE8288E80536B0FF653C,60631,4,8,4,109.57778,18.27583,1814
220254,CBFB6695A565EE8288E80536B0FF653C,30854,12,13,1,109.56889,18.27076,1763
220255,CBFB6695A565EE8288E80536B0FF653C,60381,14,15,1,109.5241,18.22458,1605
220256,5426296000364EE32711CD0E73D782C8,31561,1,4,3,109.56792,18.28479,1765
220257,5426296000364EE32711CD0E73D782C8,30771,9,11,2,109.49938,18.26042,1511
220283,4D944399BAAD1AD37CC1D68A51FA53FD,30161,0,6,6,109.50042,18.24389,1508
220284,4D944399BAAD1AD37CC1D68A51FA53FD,31021,9,10,1,109.49021,18.27,1463
220285,4D944399BAAD1AD37CC1D68A51FA53FD,30161,11,23,12,109.50042,18.24389,1508
220301,4995463B780282C9C030A19D9F49AEAC,31071,0,7,7,109.58257,18.28458,1815
220302,4995463B780282C9C030A19D9F49AEAC,30854,8,18,10,109.56889,18.27076,1763
220303,4995463B780282C9C030A19D9F49AEAC,31071,19,21,2,109.58257,18.28458,1815
220304,4995463B780282C9C030A19D9F49AEAC,30854,21,22,1,109.56889,18.27076,1763
220305,4995463B780282C9C030A19D9F49AEAC,31071,22,23,1,109.58257,18.28458,1815
220316,4E94ADAE7ABEB20EEFAF67519DFCC1BE,31081,1,9,8,109.44639,18.30181,1318
220317,4E94ADAE7ABEB20EEFAF67519DFCC1BE,31031,9,13,4,109.49979,18.25382,1510
220318,4E94ADAE7ABEB20EEFAF67519DFCC1BE,31031,13,22,9,109.49979,18.25382,1510
220397,8C8DB7A18864109B823771C405E00B29,39371,7,10,3,109.56627,18.2646,1762
220398,8C8DB7A18864109B823771C405E00B29,30951,11,12,1,109.56208,18.25667,1761
220399,8C8DB7A18864109B823771C405E00B29,30851,12,15,3,109.5616,18.27396,1713
220400,B340EDEF4A878E8DF5CBEC25E465EACE,30854,9,12,3,109.56889,18.27076,1763
220401,B340EDEF4A878E8DF5CBEC25E465EACE,60631,14,17,3,109.57778,18.27583,1814
220402,B340EDEF4A878E8DF5CBEC25E465EACE,30854,17,23,6,109.56889,18.27076,1763
220418,F198CAA1F49ACA5D003FD8F8473B3798,30191,0,1,1,109.50361,18.22701,1506
220419,F198CAA1F49ACA5D003FD8F8473B3798,30854,4,6,2,109.56889,18.27076,1763
220420,F198CAA1F49ACA5D003FD8F8473B3798,31071,9,10,1,109.58257,18.28458,1815
220421,F198CAA1F49ACA5D003FD8F8473B3798,30854,16,17,1,109.56889,18.27076,1763
220422,F198CAA1F49ACA5D003FD8F8473B3798,31071,22,23,1,109.58257,18.28458,1815
220464,621EE06E912A2B2F41B7CF45E15EDD34,30081,0,4,4,109.50243,18.26632,1512
220465,621EE06E912A2B2F41B7CF45E15EDD34,60161,5,6,1,109.49174,18.26181,1461
220466,621EE06E912A2B2F41B7CF45E15EDD34,30661,10,11,1,109.37028,18.24361,1008
220467,621EE06E912A2B2F41B7CF45E15EDD34,31561,14,15,1,109.56792,18.28479,1765
220484,1D2F8DB1F8B6A2081E1A43DDF558491D,31951,0,3,3,109.52174,18.30299,1568
220485,1D2F8DB1F8B6A2081E1A43DDF558491D,30561,6,10,4,109.52778,18.31938,1621
220486,1D2F8DB1F8B6A2081E1A43DDF558491D,60361,13,14,1,109.51938,18.29681,1567
220487,1D2F8DB1F8B6A2081E1A43DDF558491D,38484,14,15,1,109.53028,18.31528,1620
220488,1D2F8DB1F8B6A2081E1A43DDF558491D,38484,17,20,3,109.53028,18.31528,1620
220489,1D2F8DB1F8B6A2081E1A43DDF558491D,31951,22,23,1,109.52174,18.30299,1568
220492,662D882A6A10D0E6C3566690F0A40636,30854,0,12,12,109.56889,18.27076,1763
220493,662D882A6A10D0E6C3566690F0A40636,31071,13,22,9,109.58257,18.28458,1815
220546,6C1B85A5DA00EF7C1AE90EE47B67586A,31421,12,14,2,109.55382,18.22347,1705
220547,6C1B85A5DA00EF7C1AE90EE47B67586A,39371,14,15,1,109.56627,18.2646,1762
220548,6C1B85A5DA00EF7C1AE90EE47B67586A,60311,18,22,4,109.52097,18.24319,1558
220574,03C62551F9F52C12E6188B98E0F16BF3,30861,13,17,4,109.52722,18.22743,1606
220581,AB23564C2A438938AB9FCEB6A1EF8561,30121,0,8,8,109.52861,18.27222,1613
220582,AB23564C2A438938AB9FCEB6A1EF8561,30771,9,11,2,109.49938,18.26042,1511
220583,AB23564C2A438938AB9FCEB6A1EF8561,30121,12,18,6,109.52861,18.27222,1613
220584,AB23564C2A438938AB9FCEB6A1EF8561,30771,18,22,4,109.49938,18.26042,1511
220606,0E0D6E55BB1995EBF85F6B7AA8765E55,30851,2,4,2,109.5616,18.27396,1713
220607,0E0D6E55BB1995EBF85F6B7AA8765E55,30854,4,7,3,109.56889,18.27076,1763
220608,0E0D6E55BB1995EBF85F6B7AA8765E55,38271,7,15,8,109.62632,18.23049,1956
220609,0E0D6E55BB1995EBF85F6B7AA8765E55,30854,19,23,4,109.56889,18.27076,1763
220622,C711EA8F4B039EAC279F7CFC24309A8A,60361,19,20,1,109.51938,18.29681,1567
220623,C711EA8F4B039EAC279F7CFC24309A8A,38157,21,23,2,109.51483,18.26958,1563
220624,2D39AE6120F2674000C6DBB8A6E572A0,31945,0,6,6,109.58021,18.29403,1817
220625,2D39AE6120F2674000C6DBB8A6E572A0,30854,9,12,3,109.56889,18.27076,1763
220659,C1F9914EF577AE2A8300B1A3945A50FF,30854,8,9,1,109.56889,18.27076,1763
220660,C1F9914EF577AE2A8300B1A3945A50FF,31561,9,11,2,109.56792,18.28479,1765
220661,C1F9914EF577AE2A8300B1A3945A50FF,30851,12,22,10,109.5616,18.27396,1713
220730,F5FE23BF42FC224C310CD42E08B0B950,31431,0,7,7,109.44639,18.29042,1316
220731,F5FE23BF42FC224C310CD42E08B0B950,38094,7,9,2,109.45403,18.28778,1316
220732,F5FE23BF42FC224C310CD42E08B0B950,60441,9,10,1,109.46792,18.28604,1366
220733,F5FE23BF42FC224C310CD42E08B0B950,38094,11,13,2,109.45403,18.28778,1316
220734,F5FE23BF42FC224C310CD42E08B0B950,38871,13,14,1,109.44681,18.28625,1316
220735,F5FE23BF42FC224C310CD42E08B0B950,38094,15,18,3,109.45403,18.28778,1316
220736,F5FE23BF42FC224C310CD42E08B0B950,31431,20,23,3,109.44639,18.29042,1316
220778,9FEA4B85EAE4FAEE1CAF0EABFF2FAEA1,31561,0,2,2,109.56792,18.28479,1765
220779,9FEA4B85EAE4FAEE1CAF0EABFF2FAEA1,30854,2,3,1,109.56889,18.27076,1763
220780,9FEA4B85EAE4FAEE1CAF0EABFF2FAEA1,31561,4,6,2,109.56792,18.28479,1765
220781,9FEA4B85EAE4FAEE1CAF0EABFF2FAEA1,39183,16,18,2,109.55542,18.28208,1715
220782,9FEA4B85EAE4FAEE1CAF0EABFF2FAEA1,31561,20,22,2,109.56792,18.28479,1765
220806,C01D7F4C525517694A04D5EAA5AD2420,39181,8,9,1,109.55153,18.28035,1715
220807,C01D7F4C525517694A04D5EAA5AD2420,31945,10,12,2,109.58021,18.29403,1817
220808,C01D7F4C525517694A04D5EAA5AD2420,31071,13,14,1,109.58257,18.28458,1815
220809,C01D7F4C525517694A04D5EAA5AD2420,39181,15,18,3,109.55153,18.28035,1715
220810,C01D7F4C525517694A04D5EAA5AD2420,31071,19,22,3,109.58257,18.28458,1815
220852,C3EF49B0098C6C3C4B26CC8869DE86AF,30854,1,6,5,109.56889,18.27076,1763
220853,C3EF49B0098C6C3C4B26CC8869DE86AF,38271,9,14,5,109.62632,18.23049,1956
220854,94C4D5691F7DFC1AB38806AFFAC1389E,30921,1,16,15,109.53903,18.29451,1667
220855,94C4D5691F7DFC1AB38806AFFAC1389E,31931,18,21,3,109.54771,18.29403,1667
220866,78F4DA0EE4B5885E5D194334926C0B4F,31431,0,1,1,109.44639,18.29042,1316
220867,78F4DA0EE4B5885E5D194334926C0B4F,30051,2,8,6,109.48917,18.21215,1453
220868,78F4DA0EE4B5885E5D194334926C0B4F,31431,8,9,1,109.44639,18.29042,1316
220869,78F4DA0EE4B5885E5D194334926C0B4F,30581,12,13,1,109.62257,18.24951,1959
220899,B81DEDE33B0853E35D97557F334A4861,60361,0,6,6,109.51938,18.29681,1567
220900,B81DEDE33B0853E35D97557F334A4861,31931,6,11,5,109.54771,18.29403,1667
220901,B81DEDE33B0853E35D97557F334A4861,60371,14,18,4,109.53063,18.30056,1618
220902,B81DEDE33B0853E35D97557F334A4861,60361,18,23,5,109.51938,18.29681,1567
220917,289060A56CDB4D33EB944FB1093FD036,31071,0,3,3,109.58257,18.28458,1815
220918,289060A56CDB4D33EB944FB1093FD036,30854,3,6,3,109.56889,18.27076,1763
220919,289060A56CDB4D33EB944FB1093FD036,60552,11,12,1,109.41729,18.30014,1218
220928,B616D64706FE00CB4CDA3E3D124853B8,31671,0,7,7,109.38965,18.29813,1068
220929,B616D64706FE00CB4CDA3E3D124853B8,60214,10,12,2,109.63104,18.24493,2009
220930,B616D64706FE00CB4CDA3E3D124853B8,30171,14,20,6,109.48458,18.27139,1463
220939,E4199729A84482014747EE1ECF3FF7D9,30701,0,3,3,109.59313,18.32007,1871
220940,E4199729A84482014747EE1ECF3FF7D9,30931,4,7,3,109.55653,18.32722,1722
220941,E4199729A84482014747EE1ECF3FF7D9,30701,8,9,1,109.59313,18.32007,1871
220942,E4199729A84482014747EE1ECF3FF7D9,30931,11,14,3,109.55653,18.32722,1722
220943,E4199729A84482014747EE1ECF3FF7D9,30701,16,20,4,109.59313,18.32007,1871
220944,E4199729A84482014747EE1ECF3FF7D9,30931,20,23,3,109.55653,18.32722,1722
220953,E8D51F8B53F290BFD73338AD2AD8C728,31561,3,6,3,109.56792,18.28479,1765
220954,E8D51F8B53F290BFD73338AD2AD8C728,39183,6,8,2,109.55542,18.28208,1715
220955,E8D51F8B53F290BFD73338AD2AD8C728,30851,8,9,1,109.5616,18.27396,1713
220956,E8D51F8B53F290BFD73338AD2AD8C728,39183,16,18,2,109.55542,18.28208,1715
220957,E8D51F8B53F290BFD73338AD2AD8C728,31561,19,20,1,109.56792,18.28479,1765
221013,B17D654C0C5F0BF2FDFE2DB8B9C0B83F,31206,0,2,2,109.50819,18.23549,1507
221014,B17D654C0C5F0BF2FDFE2DB8B9C0B83F,60084,3,4,1,109.4984,18.2334,1507
221015,B17D654C0C5F0BF2FDFE2DB8B9C0B83F,30771,5,12,7,109.49938,18.26042,1511
221016,B17D654C0C5F0BF2FDFE2DB8B9C0B83F,31551,16,20,4,109.55868,18.24222,1708
221048,90B0A60855A43B2DB99A0964CE51D3AF,31071,0,7,7,109.58257,18.28458,1815
221049,90B0A60855A43B2DB99A0964CE51D3AF,30854,12,13,1,109.56889,18.27076,1763
221050,90B0A60855A43B2DB99A0964CE51D3AF,31071,15,16,1,109.58257,18.28458,1815
221051,90B0A60855A43B2DB99A0964CE51D3AF,30854,18,19,1,109.56889,18.27076,1763
221052,90B0A60855A43B2DB99A0964CE51D3AF,30234,19,21,2,109.60681,18.29979,1918
221053,90B0A60855A43B2DB99A0964CE51D3AF,30854,22,23,1,109.56889,18.27076,1763
221064,C6C611BB014ED26237271F906108D403,30731,7,9,2,109.50944,18.22306,1555
221065,C6C611BB014ED26237271F906108D403,31071,11,13,2,109.58257,18.28458,1815
221066,C6C611BB014ED26237271F906108D403,30854,13,14,1,109.56889,18.27076,1763
221082,60ACD2B6657BEEA3D1B558DE71329F84,38251,12,14,2,109.49618,18.25493,1510
221083,60ACD2B6657BEEA3D1B558DE71329F84,31311,15,17,2,109.72299,18.27438,2364
221084,60ACD2B6657BEEA3D1B558DE71329F84,60311,21,23,2,109.52097,18.24319,1558
221086,C6DA185F5F0F58094C4390F3E9E2A3DE,31521,13,16,3,109.51458,18.22542,1555
221087,C6DA185F5F0F58094C4390F3E9E2A3DE,60221,18,21,3,109.52569,18.29188,1616
221088,C6DA185F5F0F58094C4390F3E9E2A3DE,30181,21,23,2,109.51597,18.23313,1557
221093,7353E0D0F8DB71C781DB049F9A7D0F1B,30851,20,21,1,109.5616,18.27396,1713
221126,122D07F80E4FAC68FAE7EDBB2DF1AFA3,31071,0,8,8,109.58257,18.28458,1815
221127,122D07F80E4FAC68FAE7EDBB2DF1AFA3,30854,12,13,1,109.56889,18.27076,1763
221128,122D07F80E4FAC68FAE7EDBB2DF1AFA3,31071,13,15,2,109.58257,18.28458,1815
221129,122D07F80E4FAC68FAE7EDBB2DF1AFA3,30854,15,17,2,109.56889,18.27076,1763
221130,122D07F80E4FAC68FAE7EDBB2DF1AFA3,31071,19,21,2,109.58257,18.28458,1815
221157,1472501D05A1FAACE24DF762AD55D1B1,38023,0,15,15,109.37132,18.28993,1016
221158,1472501D05A1FAACE24DF762AD55D1B1,30361,17,20,3,109.50347,18.24,1508
221159,1472501D05A1FAACE24DF762AD55D1B1,38023,21,23,2,109.37132,18.28993,1016
221167,D334753E33AD01D79142036B3D85543F,31561,0,5,5,109.56792,18.28479,1765
221168,D334753E33AD01D79142036B3D85543F,39183,6,8,2,109.55542,18.28208,1715
221169,D334753E33AD01D79142036B3D85543F,31561,12,23,11,109.56792,18.28479,1765
221170,00145806BBF2F60A963743509F901155,60331,0,15,15,109.505,18.26507,1512
221171,00145806BBF2F60A963743509F901155,30291,16,19,3,109.50403,18.27028,1513
221172,00145806BBF2F60A963743509F901155,60331,20,23,3,109.505,18.26507,1512
221187,FF9BA552E9DDFB17524AA333EB7B78B5,31931,0,9,9,109.54771,18.29403,1667
221188,FF9BA552E9DDFB17524AA333EB7B78B5,60371,13,16,3,109.53063,18.30056,1618
221189,FF9BA552E9DDFB17524AA333EB7B78B5,31931,17,19,2,109.54771,18.29403,1667
221192,47A18820FDA9856131F74091D44B6BCB,31561,0,6,6,109.56792,18.28479,1765
221193,47A18820FDA9856131F74091D44B6BCB,30851,10,11,1,109.5616,18.27396,1713
221194,47A18820FDA9856131F74091D44B6BCB,31561,12,22,10,109.56792,18.28479,1765
221241,1040BF12FA1471751318415E0E9540B3,30231,0,5,5,109.59924,18.29639,1867
221242,1040BF12FA1471751318415E0E9540B3,31321,8,17,9,109.63799,18.23201,2007
221243,1040BF12FA1471751318415E0E9540B3,30854,20,22,2,109.56889,18.27076,1763
221258,A9FCE0049DB44FE004EAFBF5B783F4A5,31945,0,1,1,109.58021,18.29403,1817
221259,A9FCE0049DB44FE004EAFBF5B783F4A5,31761,1,7,6,109.60521,18.27965,1914
221260,A9FCE0049DB44FE004EAFBF5B783F4A5,30854,8,9,1,109.56889,18.27076,1763
221261,A9FCE0049DB44FE004EAFBF5B783F4A5,31945,12,13,1,109.58021,18.29403,1817
221262,A9FCE0049DB44FE004EAFBF5B783F4A5,31071,14,16,2,109.58257,18.28458,1815
221263,A9FCE0049DB44FE004EAFBF5B783F4A5,31945,17,23,6,109.58021,18.29403,1817
221302,36F5BD1EC1DA32FE1633E251344E0BAC,31471,14,16,2,109.34583,18.29563,917
221303,36F5BD1EC1DA32FE1633E251344E0BAC,31521,21,23,2,109.51458,18.22542,1555
221307,43DCA4A54D551EB9E56C0160DC714BC6,31561,0,6,6,109.56792,18.28479,1765
221308,43DCA4A54D551EB9E56C0160DC714BC6,39053,7,8,1,109.511,18.2771,1564
221309,43DCA4A54D551EB9E56C0160DC714BC6,30084,8,11,3,109.50118,18.26972,1513
221310,43DCA4A54D551EB9E56C0160DC714BC6,31351,14,15,1,109.4959,18.28417,1465
221311,43DCA4A54D551EB9E56C0160DC714BC6,30711,16,17,1,109.50271,18.25347,1510
221312,43DCA4A54D551EB9E56C0160DC714BC6,30854,18,19,1,109.56889,18.27076,1763
221313,43DCA4A54D551EB9E56C0160DC714BC6,60084,20,22,2,109.4984,18.2334,1507
221321,01571BA7F657FDD036DA743344472E7B,31521,0,6,6,109.51458,18.22542,1555
221322,01571BA7F657FDD036DA743344472E7B,31781,11,14,3,109.19847,18.2975,367
221323,01571BA7F657FDD036DA743344472E7B,31471,16,17,1,109.34583,18.29563,917
221324,01571BA7F657FDD036DA743344472E7B,31521,20,23,3,109.51458,18.22542,1555
221346,12A0D13AED64522A8A0ABBA021E92F4C,60361,0,4,4,109.51938,18.29681,1567
221349,84DF4A7C208235D171EF56473BCCF210,30851,0,4,4,109.5616,18.27396,1713
221350,84DF4A7C208235D171EF56473BCCF210,31561,4,7,3,109.56792,18.28479,1765
221351,84DF4A7C208235D171EF56473BCCF210,60631,8,18,10,109.57778,18.27583,1814
221360,D0B130BB73D573D27319D926F1342D67,31271,0,7,7,109.48958,18.26257,1462
221361,D0B130BB73D573D27319D926F1342D67,31781,9,11,2,109.19847,18.2975,367
221362,D0B130BB73D573D27319D926F1342D67,31471,13,14,1,109.34583,18.29563,917
221363,C0D9A8D1FC57A96EA766A127A0E8EAAC,60591,14,17,3,109.61118,18.21715,1904
221364,C0D9A8D1FC57A96EA766A127A0E8EAAC,30581,20,21,1,109.62257,18.24951,1959
221371,2873D39E7EAE4EB9FF7882E90907EED7,30111,0,1,1,109.47583,18.30542,1419
221372,2873D39E7EAE4EB9FF7882E90907EED7,30764,4,23,19,109.45806,18.29486,1367
221373,1411F9F89E8C658605CC1C5E821DCFD9,31071,3,4,1,109.58257,18.28458,1815
221374,1411F9F89E8C658605CC1C5E821DCFD9,31071,5,10,5,109.58257,18.28458,1815
221375,1411F9F89E8C658605CC1C5E821DCFD9,30854,12,17,5,109.56889,18.27076,1763
221376,1411F9F89E8C658605CC1C5E821DCFD9,39091,18,21,3,109.50097,18.25222,1510
221377,015CDEB9169BCE5537ABAE49B6A63F2B,31071,1,7,6,109.58257,18.28458,1815
221378,015CDEB9169BCE5537ABAE49B6A63F2B,30854,9,19,10,109.56889,18.27076,1763
221389,BCE29A3A46F5A479B3F0FA50B11216DE,31071,0,8,8,109.58257,18.28458,1815
221390,BCE29A3A46F5A479B3F0FA50B11216DE,30854,12,19,7,109.56889,18.27076,1763
221393,A94F66C88B84FF0658441320CD9F667C,60631,0,6,6,109.57778,18.27583,1814
221394,A94F66C88B84FF0658441320CD9F667C,30854,7,12,5,109.56889,18.27076,1763
221395,A94F66C88B84FF0658441320CD9F667C,31071,14,15,1,109.58257,18.28458,1815
221396,A94F66C88B84FF0658441320CD9F667C,30854,18,19,1,109.56889,18.27076,1763
221416,7024F3A14F6F554DC6E80063E30315F0,31561,0,5,5,109.56792,18.28479,1765
221417,7024F3A14F6F554DC6E80063E30315F0,39183,8,16,8,109.55542,18.28208,1715
221418,7024F3A14F6F554DC6E80063E30315F0,31561,18,19,1,109.56792,18.28479,1765
221478,F6B0C4B9BFBC5C0F5D704098C64B8B01,31864,11,14,3,109.49014,18.28333,1465
221495,3C81431CE72C8A68AA7DD35602A2B093,30861,0,7,7,109.52722,18.22743,1606
221496,3C81431CE72C8A68AA7DD35602A2B093,60551,9,11,2,109.42722,18.30111,1218
221497,3C81431CE72C8A68AA7DD35602A2B093,31571,12,13,1,109.61563,18.23326,1957
221503,567BF1868FBA42FA9B3B29F2CA13F65D,60361,0,3,3,109.51938,18.29681,1567
221504,567BF1868FBA42FA9B3B29F2CA13F65D,31931,5,6,1,109.54771,18.29403,1667
221505,567BF1868FBA42FA9B3B29F2CA13F65D,30921,6,16,10,109.53903,18.29451,1667
221506,567BF1868FBA42FA9B3B29F2CA13F65D,31931,17,22,5,109.54771,18.29403,1667
221522,F00821368F615DCDAF214035D8EC4A44,31761,1,3,2,109.60521,18.27965,1914
221523,F00821368F615DCDAF214035D8EC4A44,31071,4,12,8,109.58257,18.28458,1815
221524,F00821368F615DCDAF214035D8EC4A44,30854,14,19,5,109.56889,18.27076,1763
221545,934029FB5F97BCE114EDCE88F0393A63,31071,0,5,5,109.58257,18.28458,1815
221546,934029FB5F97BCE114EDCE88F0393A63,30854,8,20,12,109.56889,18.27076,1763
221547,934029FB5F97BCE114EDCE88F0393A63,39371,20,23,3,109.56627,18.2646,1762
221565,96F98526707B06BE1263CCD4F72E07A1,30854,14,16,2,109.56889,18.27076,1763
221566,96F98526707B06BE1263CCD4F72E07A1,31071,17,23,6,109.58257,18.28458,1815
221567,335A7B1DE8538918FDA774EE3E402A76,30191,0,7,7,109.50361,18.22701,1506
221568,335A7B1DE8538918FDA774EE3E402A76,31521,9,13,4,109.51458,18.22542,1555
221569,335A7B1DE8538918FDA774EE3E402A76,30191,14,23,9,109.50361,18.22701,1506
221582,356E75600A8901067E9EDB6E5BE4617A,31741,15,16,1,109.10229,18.37271,30
221587,D5B91D126489D960AE97CC8A6C1B036B,39331,2,4,2,109.62125,18.22708,1956
221588,D5B91D126489D960AE97CC8A6C1B036B,31571,6,9,3,109.61563,18.23326,1957
221589,D5B91D126489D960AE97CC8A6C1B036B,30441,10,15,5,109.64021,18.25424,2010
221590,D5B91D126489D960AE97CC8A6C1B036B,31571,15,21,6,109.61563,18.23326,1957
221607,AA17C9279A63248D7DCDF49F93EB8817,39183,3,4,1,109.55542,18.28208,1715
221608,AA17C9279A63248D7DCDF49F93EB8817,31071,6,7,1,109.58257,18.28458,1815
221609,AA17C9279A63248D7DCDF49F93EB8817,38275,8,18,10,109.62875,18.22938,2006
221618,4EB941D0395ADB322D16D159FEDE659B,60524,17,23,6,109.42951,18.28993,1216
221641,68D5553872A94DDAC491FB747742F965,30854,0,7,7,109.56889,18.27076,1763
221642,68D5553872A94DDAC491FB747742F965,30851,8,9,1,109.5616,18.27396,1713
221644,68D5553872A94DDAC491FB747742F965,30854,17,22,5,109.56889,18.27076,1763
221648,B93185B4820D7E0DEE74EBEA00941D15,30911,1,20,19,109.50493,18.26181,1511
221649,B93185B4820D7E0DEE74EBEA00941D15,38291,21,23,2,109.51618,18.24313,1558
221687,409F5E8F01172D32BBE91132149C037E,31205,0,7,7,109.51111,18.23736,1557
221688,409F5E8F01172D32BBE91132149C037E,60381,10,13,3,109.5241,18.22458,1605
221689,409F5E8F01172D32BBE91132149C037E,38261,15,17,2,109.50361,18.28153,1515
221690,409F5E8F01172D32BBE91132149C037E,30511,17,20,3,109.51069,18.24208,1558
221691,409F5E8F01172D32BBE91132149C037E,31861,21,23,2,109.49042,18.27549,1464
221692,07169E7114E4F14C073261BAAC0D4491,61011,2,6,4,109.60653,18.19076,1900
221694,07169E7114E4F14C073261BAAC0D4491,61011,11,16,5,109.60653,18.19076,1900
221701,53490AD77ACCA93C3ED0F3DE79CA488B,31071,16,17,1,109.58257,18.28458,1815
221702,53490AD77ACCA93C3ED0F3DE79CA488B,30854,20,21,1,109.56889,18.27076,1763
221706,6E2021B014C4D0B652A2E4FE8D2CF038,31071,0,9,9,109.58257,18.28458,1815
221707,6E2021B014C4D0B652A2E4FE8D2CF038,30854,9,16,7,109.56889,18.27076,1763
221708,6E2021B014C4D0B652A2E4FE8D2CF038,31071,21,23,2,109.58257,18.28458,1815
221723,7A78C0FC1F95A27BAD5AE87C12E0EE4B,31031,2,7,5,109.49979,18.25382,1510
221724,7A78C0FC1F95A27BAD5AE87C12E0EE4B,31145,9,10,1,109.20431,18.30479,369
221725,7A78C0FC1F95A27BAD5AE87C12E0EE4B,31781,10,11,1,109.19847,18.2975,367
221726,7A78C0FC1F95A27BAD5AE87C12E0EE4B,31471,12,14,2,109.34583,18.29563,917
221774,AA17AFDA929E42B241ADF1BFA6E7435E,31206,1,3,2,109.50819,18.23549,1507
221775,AA17AFDA929E42B241ADF1BFA6E7435E,39191,6,7,1,109.51493,18.23472,1557
221776,AA17AFDA929E42B241ADF1BFA6E7435E,31201,7,22,15,109.51042,18.23819,1558
221780,B1CCD68E3CC8A7232EF2DE7E986C4789,30681,0,11,11,109.48493,18.26917,1463
221781,B1CCD68E3CC8A7232EF2DE7E986C4789,38094,11,13,2,109.45403,18.28778,1316
221782,B1CCD68E3CC8A7232EF2DE7E986C4789,30681,15,23,8,109.48493,18.26917,1463
221783,9C1407835BC54BEBDB541F52E1DA1820,61011,1,5,4,109.60653,18.19076,1900
221872,7B9D64657CE26DF907B4C2AC87C9F431,38241,9,11,2,109.54111,18.30542,1669
221873,7B9D64657CE26DF907B4C2AC87C9F431,60241,12,13,1,109.53319,18.28667,1616
221874,7B9D64657CE26DF907B4C2AC87C9F431,60371,14,17,3,109.53063,18.30056,1618
221875,7B9D64657CE26DF907B4C2AC87C9F431,31931,19,21,2,109.54771,18.29403,1667
221903,DBB710D279E76C79F1E4B0766F579F8A,31071,16,19,3,109.58257,18.28458,1815
221904,DBB710D279E76C79F1E4B0766F579F8A,30854,19,21,2,109.56889,18.27076,1763
221913,F171E3DE518F39702D793F73F669E12A,31071,0,7,7,109.58257,18.28458,1815
221914,F171E3DE518F39702D793F73F669E12A,30854,10,16,6,109.56889,18.27076,1763
221915,F171E3DE518F39702D793F73F669E12A,39091,19,20,1,109.50097,18.25222,1510
221916,F171E3DE518F39702D793F73F669E12A,31071,22,23,1,109.58257,18.28458,1815
221935,9D08739092826F08F2C268E72E8D5521,38325,0,7,7,109.39792,18.2909,1116
221944,8799356B7181F28146A203E5F86C52F0,31351,0,7,7,109.4959,18.28417,1465
221945,8799356B7181F28146A203E5F86C52F0,60231,11,14,3,109.49903,18.21972,1504
221946,8799356B7181F28146A203E5F86C52F0,60381,19,20,1,109.5241,18.22458,1605
221947,8799356B7181F28146A203E5F86C52F0,60661,20,23,3,109.548,18.2377,1657
221948,CCCD2290FB632A48009771412BE68ADD,31561,0,9,9,109.56792,18.28479,1765
221949,CCCD2290FB632A48009771412BE68ADD,39183,9,11,2,109.55542,18.28208,1715
221950,CCCD2290FB632A48009771412BE68ADD,31561,11,15,4,109.56792,18.28479,1765
221951,CCCD2290FB632A48009771412BE68ADD,39183,15,17,2,109.55542,18.28208,1715
221961,EEA35E4D5CC4D9232BFB0C99E2CB356B,30731,7,9,2,109.50944,18.22306,1555
221962,EEA35E4D5CC4D9232BFB0C99E2CB356B,30854,11,19,8,109.56889,18.27076,1763
221963,DC29C676832347947F366933ECB88090,39183,16,18,2,109.55542,18.28208,1715
221964,DC29C676832347947F366933ECB88090,31561,20,23,3,109.56792,18.28479,1765
221976,CD5C4336AE9024E93B35D94EFB29A4ED,60471,0,5,5,109.44653,18.30646,1319
221977,CD5C4336AE9024E93B35D94EFB29A4ED,31351,7,9,2,109.4959,18.28417,1465
221978,CD5C4336AE9024E93B35D94EFB29A4ED,38094,10,12,2,109.45403,18.28778,1316
221979,CD5C4336AE9024E93B35D94EFB29A4ED,39321,14,16,2,109.529,18.2167,1604
221980,CD5C4336AE9024E93B35D94EFB29A4ED,31031,20,22,2,109.49979,18.25382,1510
221987,6300414882932A98E73E91790947DC62,60281,0,9,9,109.51743,18.25924,1561
221988,6300414882932A98E73E91790947DC62,38291,9,12,3,109.51618,18.24313,1558
221989,6300414882932A98E73E91790947DC62,60281,13,22,9,109.51743,18.25924,1561
221990,99CBAA6A65A50998F0A10B72B36210E4,60231,2,5,3,109.49903,18.21972,1504
221991,99CBAA6A65A50998F0A10B72B36210E4,30271,6,10,4,109.49132,18.23153,1456
221992,99CBAA6A65A50998F0A10B72B36210E4,60231,11,14,3,109.49903,18.21972,1504
221993,99CBAA6A65A50998F0A10B72B36210E4,60201,19,20,1,109.5041,18.2509,1510
221994,99CBAA6A65A50998F0A10B72B36210E4,30271,21,23,2,109.49132,18.23153,1456
221995,0A42606864F4219FA2114E5C6B187F5F,30151,0,5,5,109.50986,18.25083,1560
221996,0A42606864F4219FA2114E5C6B187F5F,30151,5,16,11,109.50986,18.25083,1560
221997,0A42606864F4219FA2114E5C6B187F5F,30421,16,18,2,109.50021,18.25861,1511
221998,0A42606864F4219FA2114E5C6B187F5F,30151,19,20,1,109.50986,18.25083,1560
221999,0A42606864F4219FA2114E5C6B187F5F,31461,21,23,2,109.5091,18.25389,1510
222007,6DA732BBEB142DF897DCE85AB09B72FB,38052,17,18,1,109.62618,18.23042,1956
222008,6DA732BBEB142DF897DCE85AB09B72FB,38052,19,21,2,109.62618,18.23042,1956
222042,4E2E832AE9D054F6D1F41FA6FCE0E148,30854,0,6,6,109.56889,18.27076,1763
222043,4E2E832AE9D054F6D1F41FA6FCE0E148,31561,8,9,1,109.56792,18.28479,1765
222044,4E2E832AE9D054F6D1F41FA6FCE0E148,39183,12,13,1,109.55542,18.28208,1715
222045,4E2E832AE9D054F6D1F41FA6FCE0E148,31561,15,16,1,109.56792,18.28479,1765
222046,4E2E832AE9D054F6D1F41FA6FCE0E148,39183,17,18,1,109.55542,18.28208,1715
222049,E34FF61340C5B86CF9FD0AD454D26266,60331,0,7,7,109.505,18.26507,1512
222050,E34FF61340C5B86CF9FD0AD454D26266,60131,7,8,1,109.49819,18.24778,1509
222051,E34FF61340C5B86CF9FD0AD454D26266,60401,9,12,3,109.47444,18.27583,1414
222052,E34FF61340C5B86CF9FD0AD454D26266,60131,14,18,4,109.49819,18.24778,1509
222053,E34FF61340C5B86CF9FD0AD454D26266,60331,19,23,4,109.505,18.26507,1512
222092,653C072409915817F60C156ADD74B0CE,38903,0,6,6,109.39229,18.29243,1117
222093,653C072409915817F60C156ADD74B0CE,38325,7,8,1,109.39792,18.2909,1116
222094,653C072409915817F60C156ADD74B0CE,38754,11,16,5,109.74667,18.37382,2430
222095,653C072409915817F60C156ADD74B0CE,60551,19,20,1,109.42722,18.30111,1218
222096,653C072409915817F60C156ADD74B0CE,38071,21,23,2,109.40722,18.30938,1169
222142,020753EF78F0A0C39658113A3377EA1E,31561,0,7,7,109.56792,18.28479,1765
222143,020753EF78F0A0C39658113A3377EA1E,39183,10,11,1,109.55542,18.28208,1715
222144,020753EF78F0A0C39658113A3377EA1E,31561,12,22,10,109.56792,18.28479,1765
222151,3971E288F0FB50DDE06A11C534E966DA,31561,2,7,5,109.56792,18.28479,1765
222152,3971E288F0FB50DDE06A11C534E966DA,30891,12,13,1,109.59431,18.28389,1865
222153,3971E288F0FB50DDE06A11C534E966DA,31071,14,20,6,109.58257,18.28458,1815
222159,1FE34463C604482338E93206E38E7B82,39151,1,7,6,109.49875,18.25097,1510
222160,1FE34463C604482338E93206E38E7B82,60161,8,14,6,109.49174,18.26181,1461
222161,1FE34463C604482338E93206E38E7B82,30361,18,21,3,109.50347,18.24,1508
222195,8819F09BB0735F6A8E80552A57CCCF5D,38111,0,9,9,109.52007,18.22403,1555
222196,8819F09BB0735F6A8E80552A57CCCF5D,39111,13,15,2,109.5191,18.22597,1555
222197,8819F09BB0735F6A8E80552A57CCCF5D,39321,15,16,1,109.529,18.2167,1604
222198,8819F09BB0735F6A8E80552A57CCCF5D,60381,17,18,1,109.5241,18.22458,1605
222199,8819F09BB0735F6A8E80552A57CCCF5D,39111,19,23,4,109.5191,18.22597,1555
222265,51061B3DE820AF1C1C713EF684728003,31071,1,6,5,109.58257,18.28458,1815
222266,51061B3DE820AF1C1C713EF684728003,30854,7,19,12,109.56889,18.27076,1763
222271,A8E9C7BB918ADAD29A3EA7ACDDCD32D7,38951,5,15,10,109.48097,18.28868,1416
222272,A8E9C7BB918ADAD29A3EA7ACDDCD32D7,38951,16,23,7,109.48097,18.28868,1416
222288,1DC4D3E6415CD2F16BAC0F0FD6BEA638,60371,0,7,7,109.53063,18.30056,1618
222289,1DC4D3E6415CD2F16BAC0F0FD6BEA638,30151,8,11,3,109.50986,18.25083,1560
222290,1DC4D3E6415CD2F16BAC0F0FD6BEA638,31381,12,15,3,109.1375,18.36833,129
222291,1DC4D3E6415CD2F16BAC0F0FD6BEA638,30151,16,20,4,109.50986,18.25083,1560
222292,1DC4D3E6415CD2F16BAC0F0FD6BEA638,31461,22,23,1,109.5091,18.25389,1510
222302,DA42D442B42F4821B174308450A49075,38361,0,8,8,109.43667,18.29201,1267
222303,DA42D442B42F4821B174308450A49075,31471,12,14,2,109.34583,18.29563,917
222304,DA42D442B42F4821B174308450A49075,38361,16,23,7,109.43667,18.29201,1267
222327,1980C8D409DE9551539224B3D393CDAA,30071,0,16,16,109.52819,18.30472,1619
222328,1980C8D409DE9551539224B3D393CDAA,30081,17,20,3,109.50243,18.26632,1512
222338,207A3717E11AB3AC89EB226444DE97A9,31031,0,20,20,109.49979,18.25382,1510
222339,207A3717E11AB3AC89EB226444DE97A9,38071,21,23,2,109.40722,18.30938,1169
222340,35336623A064EB876235CF439E741F00,60401,0,7,7,109.47444,18.27583,1414
222341,35336623A064EB876235CF439E741F00,60552,8,10,2,109.41729,18.30014,1218
222342,35336623A064EB876235CF439E741F00,30581,11,12,1,109.62257,18.24951,1959
222343,35336623A064EB876235CF439E741F00,31861,18,20,2,109.49042,18.27549,1464
222344,35336623A064EB876235CF439E741F00,60401,21,23,2,109.47444,18.27583,1414
222362,8060F1CDA5B02D0FFB5AD4CB4F63BD54,38331,12,15,3,109.62465,18.22736,1956
222363,8060F1CDA5B02D0FFB5AD4CB4F63BD54,30581,17,18,1,109.62257,18.24951,1959
222364,8060F1CDA5B02D0FFB5AD4CB4F63BD54,38331,19,23,4,109.62465,18.22736,1956
222365,5D56123A0C68AD72DA20EA4585A51B48,60381,0,8,8,109.5241,18.22458,1605
222366,5D56123A0C68AD72DA20EA4585A51B48,60641,9,16,7,109.53854,18.2359,1657
222367,5D56123A0C68AD72DA20EA4585A51B48,30861,16,18,2,109.52722,18.22743,1606
222371,D9AE11CD16B231308C3F0FB3F53BC3E9,31071,1,6,5,109.58257,18.28458,1815
222372,D9AE11CD16B231308C3F0FB3F53BC3E9,30854,10,12,2,109.56889,18.27076,1763
222373,D9AE11CD16B231308C3F0FB3F53BC3E9,31071,13,18,5,109.58257,18.28458,1815
222396,D5309758D880DC161B61C8C47A33D4DF,31031,12,17,5,109.49979,18.25382,1510
222415,AD0C0928989E5F84A5B5D3B80DD05CE5,30581,14,15,1,109.62257,18.24951,1959
222425,134AFB75C5EE5F34B187E109F7D26A7A,60361,0,12,12,109.51938,18.29681,1567
222441,8B9A9BFD1ACAD480EB101A91DBF2024D,38291,1,8,7,109.51618,18.24313,1558
222442,8B9A9BFD1ACAD480EB101A91DBF2024D,38911,8,11,3,109.51674,18.24965,1559
222443,8B9A9BFD1ACAD480EB101A91DBF2024D,38291,12,23,11,109.51618,18.24313,1558
222446,D61883A9E0C7F2103C981F95E51C66DA,31931,0,6,6,109.54771,18.29403,1667
222447,D61883A9E0C7F2103C981F95E51C66DA,39321,6,11,5,109.529,18.2167,1604
222448,D61883A9E0C7F2103C981F95E51C66DA,60241,15,16,1,109.53319,18.28667,1616
222451,F22E2350B3BBD3E296D591A1B269AAD3,30711,14,15,1,109.50271,18.25347,1510
222456,43E035AE85036EBD9891453E9567CB81,30151,12,15,3,109.50986,18.25083,1560
222457,43E035AE85036EBD9891453E9567CB81,30151,20,23,3,109.50986,18.25083,1560
222462,7573F757DDCCBF2E29AC0A68CDB02052,60501,13,15,2,109.48701,18.29021,1466
222463,7573F757DDCCBF2E29AC0A68CDB02052,30232,18,20,2,109.6191,18.31701,1971
222475,F3EA4B3DF8A619A30272A53ECD9E968F,30251,0,7,7,109.50611,18.26653,1512
222476,F3EA4B3DF8A619A30272A53ECD9E968F,38157,11,13,2,109.51483,18.26958,1563
222477,F3EA4B3DF8A619A30272A53ECD9E968F,30251,13,15,2,109.50611,18.26653,1512
222483,750172FB82300DA02225CC4F7256EE00,30381,0,6,6,109.52521,18.24507,1609
222484,750172FB82300DA02225CC4F7256EE00,39183,6,14,8,109.55542,18.28208,1715
222485,750172FB82300DA02225CC4F7256EE00,31561,14,15,1,109.56792,18.28479,1765
222486,750172FB82300DA02225CC4F7256EE00,30381,19,23,4,109.52521,18.24507,1609
222541,8752BC71725B50257436D50C6598F252,31071,0,7,7,109.58257,18.28458,1815
222542,8752BC71725B50257436D50C6598F252,30854,9,11,2,109.56889,18.27076,1763
222543,8752BC71725B50257436D50C6598F252,31071,11,13,2,109.58257,18.28458,1815
222544,8752BC71725B50257436D50C6598F252,30854,15,22,7,109.56889,18.27076,1763
222620,C983E73D646629A775690ECA8920EB29,31631,0,5,5,109.59542,18.36826,1879
222621,C983E73D646629A775690ECA8920EB29,30101,8,23,15,109.57299,18.33333,1773
222632,4400F433FA6469B70604006808D90C30,30731,0,5,5,109.50944,18.22306,1555
222633,4400F433FA6469B70604006808D90C30,31421,6,12,6,109.55382,18.22347,1705
222634,4400F433FA6469B70604006808D90C30,60381,14,15,1,109.5241,18.22458,1605
222635,4400F433FA6469B70604006808D90C30,31421,15,23,8,109.55382,18.22347,1705
222636,815B1E622D05FD49F310F3AFE15701D1,60661,0,8,8,109.548,18.2377,1657
222637,815B1E622D05FD49F310F3AFE15701D1,60463,8,15,7,109.52507,18.22438,1605
222638,815B1E622D05FD49F310F3AFE15701D1,30854,18,22,4,109.56889,18.27076,1763
222683,49C9684FD0CADCB0880FDC9F00AD4E38,31951,0,7,7,109.52174,18.30299,1568
222684,49C9684FD0CADCB0880FDC9F00AD4E38,38484,7,9,2,109.53028,18.31528,1620
222685,49C9684FD0CADCB0880FDC9F00AD4E38,30161,11,14,3,109.50042,18.24389,1508
222686,49C9684FD0CADCB0880FDC9F00AD4E38,38251,16,18,2,109.49618,18.25493,1510
222687,49C9684FD0CADCB0880FDC9F00AD4E38,60161,18,20,2,109.49174,18.26181,1461
222698,D4AA3869830031578B573FD0033C24A8,31931,0,8,8,109.54771,18.29403,1667
222699,D4AA3869830031578B573FD0033C24A8,60371,12,18,6,109.53063,18.30056,1618
222700,D4AA3869830031578B573FD0033C24A8,31931,18,22,4,109.54771,18.29403,1667
222703,8FE97C1052D63DE830211C405D8F5442,30854,10,11,1,109.56889,18.27076,1763
222704,8FE97C1052D63DE830211C405D8F5442,39183,13,15,2,109.55542,18.28208,1715
222736,C8330C25843897A146832CFB6279BF35,30201,0,18,18,109.4909,18.26465,1462
222737,C8330C25843897A146832CFB6279BF35,30911,20,23,3,109.50493,18.26181,1511
222738,E5B7402820F985EB208F9919AD7281A4,30854,18,20,2,109.56889,18.27076,1763
222739,E5B7402820F985EB208F9919AD7281A4,60631,20,21,1,109.57778,18.27583,1814
222757,6422CB87ACC55DDEF6EBE8946593C808,30721,0,7,7,109.51597,18.28257,1565
222758,6422CB87ACC55DDEF6EBE8946593C808,39053,9,12,3,109.511,18.2771,1564
222759,6422CB87ACC55DDEF6EBE8946593C808,60231,14,16,2,109.49903,18.21972,1504
222760,6422CB87ACC55DDEF6EBE8946593C808,60381,18,19,1,109.5241,18.22458,1605
222761,6422CB87ACC55DDEF6EBE8946593C808,30721,21,23,2,109.51597,18.28257,1565
222779,53453D8B736810206EC5A6632D159BE6,60371,14,17,3,109.53063,18.30056,1618
222780,53453D8B736810206EC5A6632D159BE6,31931,17,23,6,109.54771,18.29403,1667
222781,4B672ABD46E5A5E3AE2E2A8075F2FA4B,30854,10,20,10,109.56889,18.27076,1763
222782,4B672ABD46E5A5E3AE2E2A8075F2FA4B,30232,22,23,1,109.6191,18.31701,1971
222792,9AA959ED87D1ECC3053DED17290EFCBD,30851,17,18,1,109.5616,18.27396,1713
222793,9AA959ED87D1ECC3053DED17290EFCBD,31561,20,22,2,109.56792,18.28479,1765
222796,7890099D98AA300C5BF12527E7372DB0,31071,15,17,2,109.58257,18.28458,1815
222797,7890099D98AA300C5BF12527E7372DB0,30854,18,20,2,109.56889,18.27076,1763
222798,7890099D98AA300C5BF12527E7372DB0,60631,20,23,3,109.57778,18.27583,1814
222829,D96E01B8E0F0DE9C160C9FEAFDCFDB6D,31071,0,7,7,109.58257,18.28458,1815
222830,D96E01B8E0F0DE9C160C9FEAFDCFDB6D,30854,7,23,16,109.56889,18.27076,1763
222831,9AEFA19190845F00DF14D3FEC240F037,38871,19,21,2,109.44681,18.28625,1316
222832,9AEFA19190845F00DF14D3FEC240F037,31531,21,23,2,109.49583,18.25972,1461
222852,3C1A2536A78CF30193CED5E3EEACBE7E,30851,0,6,6,109.5616,18.27396,1713
222853,3C1A2536A78CF30193CED5E3EEACBE7E,30854,7,8,1,109.56889,18.27076,1763
222854,3C1A2536A78CF30193CED5E3EEACBE7E,31561,8,9,1,109.56792,18.28479,1765
222883,1EC0B0F463B9D564AF3039640EFE6DA3,60054,12,13,1,109.3016,18.31229,770
222884,1EC0B0F463B9D564AF3039640EFE6DA3,31471,13,15,2,109.34583,18.29563,917
222885,1EC0B0F463B9D564AF3039640EFE6DA3,30361,18,19,1,109.50347,18.24,1508
222886,1EC0B0F463B9D564AF3039640EFE6DA3,60381,20,23,3,109.5241,18.22458,1605
222953,40285EE8CCE25C38988EC087545664EC,31071,4,13,9,109.58257,18.28458,1815
222954,40285EE8CCE25C38988EC087545664EC,30854,13,21,8,109.56889,18.27076,1763
222997,528DF0E8B4B73FA0C9FB75037E21B5BA,31931,0,12,12,109.54771,18.29403,1667
222998,528DF0E8B4B73FA0C9FB75037E21B5BA,60241,15,16,1,109.53319,18.28667,1616
223002,00262F856825A94933CC2BDE5C3D9737,39371,1,3,2,109.56627,18.2646,1762
223003,00262F856825A94933CC2BDE5C3D9737,60581,3,6,3,109.59785,18.29931,1868
223004,00262F856825A94933CC2BDE5C3D9737,31421,7,11,4,109.55382,18.22347,1705
223005,00262F856825A94933CC2BDE5C3D9737,39371,12,13,1,109.56627,18.2646,1762
223006,00262F856825A94933CC2BDE5C3D9737,60581,14,16,2,109.59785,18.29931,1868
223055,84599FEEE94509A3E8D44F4C45C7CC01,31671,0,7,7,109.38965,18.29813,1068
223056,84599FEEE94509A3E8D44F4C45C7CC01,30764,8,9,1,109.45806,18.29486,1367
223057,84599FEEE94509A3E8D44F4C45C7CC01,31671,12,22,10,109.38965,18.29813,1068
223062,9E8746086915F9D4A063A74CF0B5B7AB,30851,0,5,5,109.5616,18.27396,1713
223063,9E8746086915F9D4A063A74CF0B5B7AB,39183,9,11,2,109.55542,18.28208,1715
223064,9E8746086915F9D4A063A74CF0B5B7AB,31561,12,13,1,109.56792,18.28479,1765
223074,C8922FAF66F21ECAECB6B717FCD5A53B,60614,0,15,15,109.48799,18.29521,1467
223075,C8922FAF66F21ECAECB6B717FCD5A53B,60391,16,17,1,109.47667,18.28757,1416
223076,C8922FAF66F21ECAECB6B717FCD5A53B,60614,17,20,3,109.48799,18.29521,1467
223105,A503639E15A0B5D04B0130D882921438,30711,0,12,12,109.50271,18.25347,1510
223106,A503639E15A0B5D04B0130D882921438,31031,13,23,10,109.49979,18.25382,1510
223131,4759B4AA548945325B49F4F737EA2B26,30461,18,20,2,109.5116,18.26313,1562
223132,4759B4AA548945325B49F4F737EA2B26,38094,21,23,2,109.45403,18.28778,1316
223133,51DF765CB634D9549D20AD1F2C37BA18,30854,14,17,3,109.56889,18.27076,1763
223134,51DF765CB634D9549D20AD1F2C37BA18,31071,20,22,2,109.58257,18.28458,1815
223149,6A001C9D1BB80FEAD1801B539C4E1BA7,30731,0,5,5,109.50944,18.22306,1555
223150,6A001C9D1BB80FEAD1801B539C4E1BA7,31781,10,11,1,109.19847,18.2975,367
223151,6A001C9D1BB80FEAD1801B539C4E1BA7,31471,14,16,2,109.34583,18.29563,917
223152,6A001C9D1BB80FEAD1801B539C4E1BA7,31521,16,17,1,109.51458,18.22542,1555
223153,6A001C9D1BB80FEAD1801B539C4E1BA7,30731,18,23,5,109.50944,18.22306,1555
223214,5CFFF8D919E96524101209E188C669B3,31951,19,23,4,109.52174,18.30299,1568
223215,123358A15833F823249D8A62EDE35161,31461,0,1,1,109.5091,18.25389,1510
223216,123358A15833F823249D8A62EDE35161,39091,1,3,2,109.50097,18.25222,1510
223217,123358A15833F823249D8A62EDE35161,30711,5,7,2,109.50271,18.25347,1510
223218,123358A15833F823249D8A62EDE35161,31461,9,11,2,109.5091,18.25389,1510
223279,E75CF54BA14775FEDD26504F9F6B7365,31945,0,4,4,109.58021,18.29403,1817
223280,E75CF54BA14775FEDD26504F9F6B7365,31561,7,9,2,109.56792,18.28479,1765
223281,E75CF54BA14775FEDD26504F9F6B7365,30854,9,12,3,109.56889,18.27076,1763
223282,E75CF54BA14775FEDD26504F9F6B7365,31561,13,18,5,109.56792,18.28479,1765
223283,E75CF54BA14775FEDD26504F9F6B7365,31945,21,23,2,109.58021,18.29403,1817
223288,96C474E5BFF92BC21432A4ADDD7A543D,31071,12,13,1,109.58257,18.28458,1815
223289,96C474E5BFF92BC21432A4ADDD7A543D,39371,15,16,1,109.56627,18.2646,1762
223311,D8EBCB05DE029B0DEDBF9FBDF3DA3C2D,38251,17,19,2,109.49618,18.25493,1510
223312,D8EBCB05DE029B0DEDBF9FBDF3DA3C2D,60084,21,23,2,109.4984,18.2334,1507
223319,556BB0E48CDC393D98CC29C252B17ABD,31461,19,21,2,109.5091,18.25389,1510
223320,556BB0E48CDC393D98CC29C252B17ABD,31864,21,23,2,109.49014,18.28333,1465
223336,D46DE9169E4BACF1D272EA5E0FDEF68F,31561,0,13,13,109.56792,18.28479,1765
223337,D46DE9169E4BACF1D272EA5E0FDEF68F,30854,14,16,2,109.56889,18.27076,1763
223338,D46DE9169E4BACF1D272EA5E0FDEF68F,31561,18,19,1,109.56792,18.28479,1765
223371,2AE38FAF341950B0B91404FFCE5A0F3E,30921,12,16,4,109.53903,18.29451,1667
223372,2AE38FAF341950B0B91404FFCE5A0F3E,31931,20,21,1,109.54771,18.29403,1667
223379,39F25FE146A03325C93C111F2A943B6C,31945,0,13,13,109.58021,18.29403,1817
223380,39F25FE146A03325C93C111F2A943B6C,30854,13,15,2,109.56889,18.27076,1763
223381,39F25FE146A03325C93C111F2A943B6C,31071,17,19,2,109.58257,18.28458,1815
223382,39F25FE146A03325C93C111F2A943B6C,30854,19,20,1,109.56889,18.27076,1763
223383,58418A9EA4A7DC03127CB79C039A5185,60354,0,8,8,109.58701,18.28521,1815
223384,58418A9EA4A7DC03127CB79C039A5185,30854,10,18,8,109.56889,18.27076,1763
223385,58418A9EA4A7DC03127CB79C039A5185,60354,19,23,4,109.58701,18.28521,1815
223454,AB8F95D841F69DCC3177A6274025E5E6,39183,0,14,14,109.55542,18.28208,1715
223455,AB8F95D841F69DCC3177A6274025E5E6,31561,15,16,1,109.56792,18.28479,1765
223456,AB8F95D841F69DCC3177A6274025E5E6,39183,16,23,7,109.55542,18.28208,1715
223551,EC4B90EDBF35256FDB4D4F8B87DB8A04,31071,4,17,13,109.58257,18.28458,1815
223552,EC4B90EDBF35256FDB4D4F8B87DB8A04,30191,21,23,2,109.50361,18.22701,1506
223559,8CD15CF6B5FB4821940FF9AFE6D6CB84,39181,13,17,4,109.55153,18.28035,1715
223560,8CD15CF6B5FB4821940FF9AFE6D6CB84,31931,19,20,1,109.54771,18.29403,1667
223649,F7B78088C9D5070A9DC85E9635B06C5E,31471,13,14,1,109.34583,18.29563,917
223650,F7B78088C9D5070A9DC85E9635B06C5E,60551,19,20,1,109.42722,18.30111,1218
223651,1CA52953D80A93E278268F121C1B48FB,31206,0,7,7,109.50819,18.23549,1507
223652,1CA52953D80A93E278268F121C1B48FB,38754,11,13,2,109.74667,18.37382,2430
223653,1CA52953D80A93E278268F121C1B48FB,30211,15,16,1,109.49882,18.23931,1508
223654,1CA52953D80A93E278268F121C1B48FB,30161,17,19,2,109.50042,18.24389,1508
223655,1CA52953D80A93E278268F121C1B48FB,31031,19,20,1,109.49979,18.25382,1510
223656,1CA52953D80A93E278268F121C1B48FB,30271,20,23,3,109.49132,18.23153,1456
223713,B0378DF43FA7734384BC89D53958FB62,31531,0,2,2,109.49583,18.25972,1461
223714,B0378DF43FA7734384BC89D53958FB62,38251,3,6,3,109.49618,18.25493,1510
223715,B0378DF43FA7734384BC89D53958FB62,31531,7,8,1,109.49583,18.25972,1461
223716,B0378DF43FA7734384BC89D53958FB62,31471,15,17,2,109.34583,18.29563,917
223717,B0378DF43FA7734384BC89D53958FB62,31531,21,23,2,109.49583,18.25972,1461
223730,4C38E9EA73C70042E952A9DE08A1B2B7,38871,0,18,18,109.44681,18.28625,1316
223731,4C38E9EA73C70042E952A9DE08A1B2B7,60621,20,22,2,109.48354,18.27451,1464
223734,622234A65D292D040A9E438A2770674C,30851,0,6,6,109.5616,18.27396,1713
223735,622234A65D292D040A9E438A2770674C,31561,8,10,2,109.56792,18.28479,1765
223736,622234A65D292D040A9E438A2770674C,30851,10,14,4,109.5616,18.27396,1713
223737,E99D6570F853F6293054C74E1A290524,60354,1,7,6,109.58701,18.28521,1815
223738,E99D6570F853F6293054C74E1A290524,30854,7,10,3,109.56889,18.27076,1763
223739,E99D6570F853F6293054C74E1A290524,60354,13,15,2,109.58701,18.28521,1815
223740,E99D6570F853F6293054C74E1A290524,30854,18,21,3,109.56889,18.27076,1763
223774,102A3C1C3179D6FF6A52B59C3B4087A1,31181,0,4,4,109.50382,18.24813,1509
223775,102A3C1C3179D6FF6A52B59C3B4087A1,30161,4,12,8,109.50042,18.24389,1508
223776,102A3C1C3179D6FF6A52B59C3B4087A1,31181,12,14,2,109.50382,18.24813,1509
223777,102A3C1C3179D6FF6A52B59C3B4087A1,30161,14,16,2,109.50042,18.24389,1508
223778,102A3C1C3179D6FF6A52B59C3B4087A1,31181,16,23,7,109.50382,18.24813,1509
223869,B75467468326B44066FD3D51F4AC58E8,30661,0,6,6,109.37028,18.24361,1008
223870,B75467468326B44066FD3D51F4AC58E8,39131,11,12,1,109.2066,18.29639,417
223871,B75467468326B44066FD3D51F4AC58E8,30201,16,18,2,109.4909,18.26465,1462
223872,B75467468326B44066FD3D51F4AC58E8,31471,20,22,2,109.34583,18.29563,917
223895,84AE8021499D54593ACB2FDF894A6FF2,38871,0,7,7,109.44681,18.28625,1316
223896,84AE8021499D54593ACB2FDF894A6FF2,38251,7,8,1,109.49618,18.25493,1510
223897,84AE8021499D54593ACB2FDF894A6FF2,60054,11,14,3,109.3016,18.31229,770
223898,84AE8021499D54593ACB2FDF894A6FF2,30361,17,19,2,109.50347,18.24,1508
223899,84AE8021499D54593ACB2FDF894A6FF2,60381,21,23,2,109.5241,18.22458,1605
223917,E218C587552A5DADC05C4E69685FE374,39371,19,21,2,109.56627,18.2646,1762
223918,E218C587552A5DADC05C4E69685FE374,39183,22,23,1,109.55542,18.28208,1715
223976,96EB2AA1C15710F8D6D518B464991E6E,30711,10,11,1,109.50271,18.25347,1510
224001,1D8B814EC83D52D7C5F3FED99C129EE0,38271,10,17,7,109.62632,18.23049,1956
224002,1D8B814EC83D52D7C5F3FED99C129EE0,30854,19,20,1,109.56889,18.27076,1763
224013,2B4762F46C69FA98E9BBA41DCB08BB34,61011,0,14,14,109.60653,18.19076,1900
224014,2B4762F46C69FA98E9BBA41DCB08BB34,31571,18,19,1,109.61563,18.23326,1957
224120,93163425D5E4D00B602BA1B3C48E3D76,30821,0,6,6,109.43681,18.33639,1274
224123,5B9C285272AE492ED486BC17CC95AEAF,60381,18,20,2,109.5241,18.22458,1605
224124,5B9C285272AE492ED486BC17CC95AEAF,30771,21,23,2,109.49938,18.26042,1511
224127,6BF671BC76B2463D72102139E4EB1018,38241,8,14,6,109.54111,18.30542,1669
224128,6BF671BC76B2463D72102139E4EB1018,60371,14,17,3,109.53063,18.30056,1618
224129,DF1B441334AF356197894BB02F2FD2C7,60552,0,5,5,109.41729,18.30014,1218
224130,DF1B441334AF356197894BB02F2FD2C7,31231,5,7,2,109.42597,18.29292,1217
224131,DF1B441334AF356197894BB02F2FD2C7,30854,9,10,1,109.56889,18.27076,1763
224145,5121CF17D14D2AAD91DBD81D7766DFCC,38052,0,10,10,109.62618,18.23042,1956
224146,5121CF17D14D2AAD91DBD81D7766DFCC,31521,12,13,1,109.51458,18.22542,1555
224147,5121CF17D14D2AAD91DBD81D7766DFCC,31521,14,20,6,109.51458,18.22542,1555
224148,5121CF17D14D2AAD91DBD81D7766DFCC,30731,22,23,1,109.50944,18.22306,1555
224182,5C4B759B8D2905A494B81A3EB710A8F3,60631,1,16,15,109.57778,18.27583,1814
224183,5C4B759B8D2905A494B81A3EB710A8F3,31206,17,18,1,109.50819,18.23549,1507
224189,AB43182259122294244C13D6FC66D4A1,31561,16,17,1,109.56792,18.28479,1765
224190,AB43182259122294244C13D6FC66D4A1,60631,19,23,4,109.57778,18.27583,1814
224203,C17A8098B013F904BD9DA05D90234A30,30581,0,7,7,109.62257,18.24951,1959
224204,C17A8098B013F904BD9DA05D90234A30,31221,9,17,8,109.61333,18.26833,1913
224228,DE91F768E6CCDB78867FF54F078574C9,30854,0,13,13,109.56889,18.27076,1763
224229,DE91F768E6CCDB78867FF54F078574C9,38754,18,20,2,109.74667,18.37382,2430
224230,DE91F768E6CCDB78867FF54F078574C9,30854,22,23,1,109.56889,18.27076,1763
224231,F8D799D9161B0143E0D71C40472A357E,30071,0,14,14,109.52819,18.30472,1619
224232,F8D799D9161B0143E0D71C40472A357E,38484,17,20,3,109.53028,18.31528,1620
224233,F8D799D9161B0143E0D71C40472A357E,31261,20,23,3,109.51174,18.2466,1559
224245,FB3BDA15BDB6B05D4B2E90881ABDD6BD,31071,15,16,1,109.58257,18.28458,1815
224246,FB3BDA15BDB6B05D4B2E90881ABDD6BD,31031,20,21,1,109.49979,18.25382,1510
224281,7BF65E5054DA81A230AB5423620158E1,31071,14,16,2,109.58257,18.28458,1815
224282,7BF65E5054DA81A230AB5423620158E1,30854,16,18,2,109.56889,18.27076,1763
224283,7BF65E5054DA81A230AB5423620158E1,31071,18,21,3,109.58257,18.28458,1815
224284,7BF65E5054DA81A230AB5423620158E1,60631,22,23,1,109.57778,18.27583,1814
224285,ADC7B707FBBD7BF3F9ACE0C092DAADE5,31351,13,15,2,109.4959,18.28417,1465
224286,ADC7B707FBBD7BF3F9ACE0C092DAADE5,30921,15,17,2,109.53903,18.29451,1667
224287,ADC7B707FBBD7BF3F9ACE0C092DAADE5,31931,18,23,5,109.54771,18.29403,1667
224295,D3C9663E989D180AFC5AB38F1AB14DA3,31071,2,7,5,109.58257,18.28458,1815
224296,D3C9663E989D180AFC5AB38F1AB14DA3,30854,11,12,1,109.56889,18.27076,1763
224333,E6651E3C6D8FEA2077D9EFC6D097D06C,38251,0,20,20,109.49618,18.25493,1510
224334,E6651E3C6D8FEA2077D9EFC6D097D06C,31031,21,23,2,109.49979,18.25382,1510
224353,079A114D194FE2EFB0C89059CA4EBC03,31251,17,23,6,109.18528,18.2975,317
224354,F213C5748E79ACD5D5D964220028F628,31521,11,18,7,109.51458,18.22542,1555
224355,F213C5748E79ACD5D5D964220028F628,30911,18,19,1,109.50493,18.26181,1511
224370,095299F3770B7A2302718B195EB336D4,31161,18,19,1,109.70229,18.31361,2270
224371,095299F3770B7A2302718B195EB336D4,30151,21,23,2,109.50986,18.25083,1560
224412,4053323049FA57896819CD5356E38746,31071,1,6,5,109.58257,18.28458,1815
224413,4053323049FA57896819CD5356E38746,30681,10,11,1,109.48493,18.26917,1463
224414,4053323049FA57896819CD5356E38746,30854,12,22,10,109.56889,18.27076,1763
224445,32A9EB9777CB2D1EF5E41D4825060093,30421,14,16,2,109.50021,18.25861,1511
224448,A46BA306DAEA889FAC7ACE9E5FD6A1FF,31171,1,3,2,109.50938,18.24917,1559
224449,A46BA306DAEA889FAC7ACE9E5FD6A1FF,30371,4,9,5,109.51,18.24771,1559
224450,A46BA306DAEA889FAC7ACE9E5FD6A1FF,30421,9,11,2,109.50021,18.25861,1511
224451,A46BA306DAEA889FAC7ACE9E5FD6A1FF,60291,17,18,1,109.50826,18.24639,1509
224452,A46BA306DAEA889FAC7ACE9E5FD6A1FF,31171,19,21,2,109.50938,18.24917,1559
224466,C6C3BC01E542B810EF853FEEB6C81198,60361,14,17,3,109.51938,18.29681,1567
224467,C6C3BC01E542B810EF853FEEB6C81198,31561,20,22,2,109.56792,18.28479,1765
224478,D17842D1E850E617B4B15889C460D1C5,30921,0,5,5,109.53903,18.29451,1667
224479,D17842D1E850E617B4B15889C460D1C5,31931,5,21,16,109.54771,18.29403,1667
224490,6C0260646767B781577B5B8CE2471E51,30321,17,19,2,109.49563,18.29611,1467
224491,6C0260646767B781577B5B8CE2471E51,38484,19,21,2,109.53028,18.31528,1620
224492,6C0260646767B781577B5B8CE2471E51,31951,21,23,2,109.52174,18.30299,1568
224513,8F6EA1C108FADA76A214A7ED71ECE3D1,30891,1,6,5,109.59431,18.28389,1865
224514,8F6EA1C108FADA76A214A7ED71ECE3D1,30854,10,15,5,109.56889,18.27076,1763
224515,8F6EA1C108FADA76A214A7ED71ECE3D1,39183,17,19,2,109.55542,18.28208,1715
224516,39D4F14340B4650E084697607335F122,31031,0,3,3,109.49979,18.25382,1510
224517,39D4F14340B4650E084697607335F122,30161,3,19,16,109.50042,18.24389,1508
224571,E96216D8F4849958E43701C810AEF688,31521,15,16,1,109.51458,18.22542,1555
224572,E96216D8F4849958E43701C810AEF688,31231,21,23,2,109.42597,18.29292,1217
224589,5257BB62833F353E4A854C5B6B0C57D3,38315,11,13,2,109.48979,18.29764,1467
224591,BA20AC03D63076D89C5025E4CF905079,38325,0,1,1,109.39792,18.2909,1116
224592,BA20AC03D63076D89C5025E4CF905079,38325,6,8,2,109.39792,18.2909,1116
224593,BA20AC03D63076D89C5025E4CF905079,31145,9,11,2,109.20431,18.30479,369
224594,BA20AC03D63076D89C5025E4CF905079,31471,13,15,2,109.34583,18.29563,917
224595,BA20AC03D63076D89C5025E4CF905079,38027,19,20,1,109.38833,18.2909,1066
224599,5206B4948238D5BEDA899C0EB669640A,38094,0,7,7,109.45403,18.28778,1316
224600,5206B4948238D5BEDA899C0EB669640A,31781,12,14,2,109.19847,18.2975,367
224601,5206B4948238D5BEDA899C0EB669640A,60221,18,19,1,109.52569,18.29188,1616
224645,8AABF5FDF2B06EB445749240A3894969,31071,0,11,11,109.58257,18.28458,1815
224646,8AABF5FDF2B06EB445749240A3894969,30854,13,14,1,109.56889,18.27076,1763
224647,8AABF5FDF2B06EB445749240A3894969,31851,15,17,2,109.71736,18.29007,2316
224648,8AABF5FDF2B06EB445749240A3894969,31071,19,21,2,109.58257,18.28458,1815
224649,8AABF5FDF2B06EB445749240A3894969,30854,22,23,1,109.56889,18.27076,1763
224669,F315998EC48289C5B7879B7FA5033861,31461,12,14,2,109.5091,18.25389,1510
224670,F315998EC48289C5B7879B7FA5033861,31461,17,23,6,109.5091,18.25389,1510
224683,FE95B3A32EFBC2838F293DF38F55FDD1,39183,1,5,4,109.55542,18.28208,1715
224684,FE95B3A32EFBC2838F293DF38F55FDD1,31561,7,17,10,109.56792,18.28479,1765
224685,FE95B3A32EFBC2838F293DF38F55FDD1,39181,21,23,2,109.55153,18.28035,1715
224689,2684D96F8074AD1F9109C47C4A6D7EF7,31471,15,17,2,109.34583,18.29563,917
224690,2684D96F8074AD1F9109C47C4A6D7EF7,39091,18,23,5,109.50097,18.25222,1510
224691,CC674AAAC7C027C8C72DEA73AA338EF1,30181,0,8,8,109.51597,18.23313,1557
224692,CC674AAAC7C027C8C72DEA73AA338EF1,31031,12,13,1,109.49979,18.25382,1510
224693,CC674AAAC7C027C8C72DEA73AA338EF1,30111,17,23,6,109.47583,18.30542,1419
224753,E8BAAF476E8FE57075BAB1A8D4FF1780,39371,0,16,16,109.56627,18.2646,1762
224754,E8BAAF476E8FE57075BAB1A8D4FF1780,30232,16,18,2,109.6191,18.31701,1971
224755,E8BAAF476E8FE57075BAB1A8D4FF1780,39371,20,22,2,109.56627,18.2646,1762
224777,1FEE70E9EF5E783035F8B1F1E4B483EC,31071,10,13,3,109.58257,18.28458,1815
224778,1FEE70E9EF5E783035F8B1F1E4B483EC,30854,13,16,3,109.56889,18.27076,1763
224779,1FEE70E9EF5E783035F8B1F1E4B483EC,30851,17,19,2,109.5616,18.27396,1713
224780,1FEE70E9EF5E783035F8B1F1E4B483EC,30854,20,21,1,109.56889,18.27076,1763
224802,64FF3E93355E6DCA29977E04D316EABA,38973,0,9,9,109.51097,18.25389,1560
224803,64FF3E93355E6DCA29977E04D316EABA,30151,13,14,1,109.50986,18.25083,1560
224804,64FF3E93355E6DCA29977E04D316EABA,30151,16,18,2,109.50986,18.25083,1560
224809,9A1D1AA5EE2CD156CC396C667ED8C5B9,31071,0,1,1,109.58257,18.28458,1815
224810,9A1D1AA5EE2CD156CC396C667ED8C5B9,30854,1,10,9,109.56889,18.27076,1763
224811,9A1D1AA5EE2CD156CC396C667ED8C5B9,31071,13,14,1,109.58257,18.28458,1815
224829,3EE8EB9E13BDBC14B74108086C37B269,31261,18,20,2,109.51174,18.2466,1559
224830,3EE8EB9E13BDBC14B74108086C37B269,31201,20,22,2,109.51042,18.23819,1558
224843,3B2185E7415B009217EFBA2F675D0372,31571,14,18,4,109.61563,18.23326,1957
224844,3B2185E7415B009217EFBA2F675D0372,31701,21,23,2,109.44132,18.28833,1266
224845,408C4FED868686E7B96333835F4C4205,30854,14,16,2,109.56889,18.27076,1763
224846,408C4FED868686E7B96333835F4C4205,60381,20,21,1,109.5241,18.22458,1605
224865,798BF3B08F72A16A6DEAAA235F1899BB,61011,0,7,7,109.60653,18.19076,1900
224867,798BF3B08F72A16A6DEAAA235F1899BB,61011,21,23,2,109.60653,18.19076,1900
224871,D001062E96DDE99C5A38D3DD89B4A1A5,31071,0,10,10,109.58257,18.28458,1815
224872,D001062E96DDE99C5A38D3DD89B4A1A5,30854,10,11,1,109.56889,18.27076,1763
224873,D001062E96DDE99C5A38D3DD89B4A1A5,31321,15,16,1,109.63799,18.23201,2007
224874,D001062E96DDE99C5A38D3DD89B4A1A5,30854,20,23,3,109.56889,18.27076,1763
224920,C83E4E683A415C41D5DAD6125B64597B,31531,1,3,2,109.49583,18.25972,1461
224921,C83E4E683A415C41D5DAD6125B64597B,38251,3,4,1,109.49618,18.25493,1510
224922,C83E4E683A415C41D5DAD6125B64597B,31531,5,6,1,109.49583,18.25972,1461
224923,C83E4E683A415C41D5DAD6125B64597B,60054,15,17,2,109.3016,18.31229,770
224924,C83E4E683A415C41D5DAD6125B64597B,60541,20,22,2,109.4084,18.29208,1167
224934,267109764004253FF1AD548611BE6E82,39371,0,6,6,109.56627,18.2646,1762
224935,267109764004253FF1AD548611BE6E82,30891,8,10,2,109.59431,18.28389,1865
224936,267109764004253FF1AD548611BE6E82,39183,10,11,1,109.55542,18.28208,1715
224943,0A1180E82C5CC50239F2164B7CC7F6A9,30021,0,1,1,109.12014,18.40986,86
224944,0A1180E82C5CC50239F2164B7CC7F6A9,31124,2,4,2,109.17069,18.35,276
224945,0A1180E82C5CC50239F2164B7CC7F6A9,30021,4,5,1,109.12014,18.40986,86
224997,2EB34315F52BDC60A50691DD7C88DC95,30721,0,8,8,109.51597,18.28257,1565
224998,2EB34315F52BDC60A50691DD7C88DC95,60581,9,10,1,109.59785,18.29931,1868
225026,E4C7AB656E412C7E33554D18277C9478,31461,14,16,2,109.5091,18.25389,1510
225027,E4C7AB656E412C7E33554D18277C9478,30421,21,23,2,109.50021,18.25861,1511
225077,A6FDD6F461ADD11041AF4D599066AA12,33051,16,17,1,109.6475,18.46618,2096
225078,A6FDD6F461ADD11041AF4D599066AA12,60084,19,21,2,109.4984,18.2334,1507
225079,A6FDD6F461ADD11041AF4D599066AA12,30771,22,23,1,109.49938,18.26042,1511
225103,6751CEC3CF9B2AE78246C7287443D2B4,30854,11,15,4,109.56889,18.27076,1763
225104,6751CEC3CF9B2AE78246C7287443D2B4,31945,20,22,2,109.58021,18.29403,1817
225115,1B6EBBFF3B9D8A3E18753343B6A29EAE,31071,3,14,11,109.58257,18.28458,1815
225116,1B6EBBFF3B9D8A3E18753343B6A29EAE,30851,15,16,1,109.5616,18.27396,1713
225117,1B6EBBFF3B9D8A3E18753343B6A29EAE,31071,19,23,4,109.58257,18.28458,1815
225121,EC89B2FFE00F967E6D0A3B697A6D636D,30854,15,18,3,109.56889,18.27076,1763
225122,EC89B2FFE00F967E6D0A3B697A6D636D,60354,19,23,4,109.58701,18.28521,1815
225140,9EF16DF8533539CE4DAE7B335414DA7E,30171,20,21,1,109.48458,18.27139,1463
225144,45D6FEED987FF96C23D5532C0D645AC3,30281,0,13,13,109.50597,18.27583,1514
225145,45D6FEED987FF96C23D5532C0D645AC3,30854,14,17,3,109.56889,18.27076,1763
225146,45D6FEED987FF96C23D5532C0D645AC3,30151,19,20,1,109.50986,18.25083,1560
225149,C9067C88665B737B441D0CB735A19383,38251,12,18,6,109.49618,18.25493,1510
225150,C9067C88665B737B441D0CB735A19383,30051,22,23,1,109.48917,18.21215,1453
225177,59F29435D748531F416A4F1636997ECF,60354,2,8,6,109.58701,18.28521,1815
225178,59F29435D748531F416A4F1636997ECF,30711,9,10,1,109.50271,18.25347,1510
225181,DFD2E125802FB9E2FB2F393417866810,30854,4,9,5,109.56889,18.27076,1763
225182,DFD2E125802FB9E2FB2F393417866810,30731,11,12,1,109.50944,18.22306,1555
225183,68DBE0B52FD0AB95F1DD47068FD7847F,60311,0,6,6,109.52097,18.24319,1558
225184,68DBE0B52FD0AB95F1DD47068FD7847F,30181,7,8,1,109.51597,18.23313,1557
225185,68DBE0B52FD0AB95F1DD47068FD7847F,60311,12,14,2,109.52097,18.24319,1558
225186,68DBE0B52FD0AB95F1DD47068FD7847F,30181,15,20,5,109.51597,18.23313,1557
225187,68DBE0B52FD0AB95F1DD47068FD7847F,60311,21,23,2,109.52097,18.24319,1558
225214,1D73A39CD9D00E7A842906C3097D7487,60571,0,8,8,109.50722,18.25056,1510
225215,1D73A39CD9D00E7A842906C3097D7487,30851,9,17,8,109.5616,18.27396,1713
225244,4E9700B026D20ABF45FFBA72DED9D886,38951,1,15,14,109.48097,18.28868,1416
225245,4E9700B026D20ABF45FFBA72DED9D886,38951,16,18,2,109.48097,18.28868,1416
225246,4E9700B026D20ABF45FFBA72DED9D886,60621,19,20,1,109.48354,18.27451,1464
225247,4E9700B026D20ABF45FFBA72DED9D886,38951,22,23,1,109.48097,18.28868,1416
225248,794109BFC4D0C5504E1A62AB391C7DDC,30181,0,7,7,109.51597,18.23313,1557
225249,794109BFC4D0C5504E1A62AB391C7DDC,30241,10,12,2,109.26174,18.3275,622
225250,794109BFC4D0C5504E1A62AB391C7DDC,31145,13,15,2,109.20431,18.30479,369
225251,794109BFC4D0C5504E1A62AB391C7DDC,31021,18,19,1,109.49021,18.27,1463
225252,794109BFC4D0C5504E1A62AB391C7DDC,30181,20,23,3,109.51597,18.23313,1557
225253,FBD855000564CE6EC034501219E56C85,38171,1,6,5,109.50799,18.28139,1515
225254,FBD855000564CE6EC034501219E56C85,31781,7,10,3,109.19847,18.2975,367
225255,FBD855000564CE6EC034501219E56C85,31351,12,13,1,109.4959,18.28417,1465
225256,FBD855000564CE6EC034501219E56C85,38127,18,20,2,109.50833,18.27222,1513
225259,E58E5EFF0A1D7ADABE8F5BBEE665ED0D,60641,0,7,7,109.53854,18.2359,1657
225260,E58E5EFF0A1D7ADABE8F5BBEE665ED0D,30861,11,22,11,109.52722,18.22743,1606
225267,DECB7B3FC95BFA8620EFD8D9DE328252,30854,0,6,6,109.56889,18.27076,1763
225268,DECB7B3FC95BFA8620EFD8D9DE328252,39021,8,10,2,109.40368,18.41035,1186
225269,DECB7B3FC95BFA8620EFD8D9DE328252,30854,12,13,1,109.56889,18.27076,1763
225270,DECB7B3FC95BFA8620EFD8D9DE328252,31945,15,16,1,109.58021,18.29403,1817
225271,DECB7B3FC95BFA8620EFD8D9DE328252,30854,16,23,7,109.56889,18.27076,1763
225315,A9634A2AD8447824C1C9412CBBCC32E0,31181,0,7,7,109.50382,18.24813,1509
225316,A9634A2AD8447824C1C9412CBBCC32E0,31851,8,10,2,109.71736,18.29007,2316
225317,A9634A2AD8447824C1C9412CBBCC32E0,31181,13,14,1,109.50382,18.24813,1509
225318,A9634A2AD8447824C1C9412CBBCC32E0,31531,15,16,1,109.49583,18.25972,1461
225319,A9634A2AD8447824C1C9412CBBCC32E0,31181,21,23,2,109.50382,18.24813,1509
225346,14BFE46EEAB2E234698393270A62605D,31251,15,17,2,109.18528,18.2975,317
225347,14BFE46EEAB2E234698393270A62605D,30661,18,20,2,109.37028,18.24361,1008
225348,14BFE46EEAB2E234698393270A62605D,60411,21,23,2,109.32514,18.30854,869
225371,2CF83F5125C6075E2ACA9C17C2979C64,31071,0,5,5,109.58257,18.28458,1815
225372,2CF83F5125C6075E2ACA9C17C2979C64,30854,9,18,9,109.56889,18.27076,1763
225373,2CF83F5125C6075E2ACA9C17C2979C64,31071,18,22,4,109.58257,18.28458,1815
225405,A795428793D2273B4ACFDADC5E61AEC2,31421,13,15,2,109.55382,18.22347,1705
225406,A795428793D2273B4ACFDADC5E61AEC2,60641,20,22,2,109.53854,18.2359,1657
225434,D64831AB91543B58745F58E928C5C4B9,30391,13,15,2,109.4975,18.27118,1513
225435,D64831AB91543B58745F58E928C5C4B9,38157,18,21,3,109.51483,18.26958,1563
225451,15195C578D4A8081B069C4B518039EFC,60084,3,5,2,109.4984,18.2334,1507
225452,15195C578D4A8081B069C4B518039EFC,60161,6,11,5,109.49174,18.26181,1461
225453,15195C578D4A8081B069C4B518039EFC,60231,12,13,1,109.49903,18.21972,1504
225454,15195C578D4A8081B069C4B518039EFC,30051,16,17,1,109.48917,18.21215,1453
225467,7171A8398911756415ECFCDCF96F249B,39371,2,18,16,109.56627,18.2646,1762
225468,7171A8398911756415ECFCDCF96F249B,30851,20,21,1,109.5616,18.27396,1713
225476,7F6E66BC10419161F6457A6D79258EDB,60401,19,20,1,109.47444,18.27583,1414
225477,7F6E66BC10419161F6457A6D79258EDB,60621,21,23,2,109.48354,18.27451,1464
225502,BB817C31A3F12EE16D15A558C65FED5B,60354,19,20,1,109.58701,18.28521,1815
225503,BB817C31A3F12EE16D15A558C65FED5B,30854,20,21,1,109.56889,18.27076,1763
225507,3B4B2DFBA1D31CE7FAD823FC175E4B2C,31311,16,17,1,109.72299,18.27438,2364
225508,3B4B2DFBA1D31CE7FAD823FC175E4B2C,31864,22,23,1,109.49014,18.28333,1465
225569,072AC77F929EC299627C26126B4FB4CE,31181,16,18,2,109.50382,18.24813,1509
225570,072AC77F929EC299627C26126B4FB4CE,60131,19,21,2,109.49819,18.24778,1509
225585,958BCA5AB937B4D5786BAEFD072B8D05,30861,14,23,9,109.52722,18.22743,1606
225596,897B0D6D4872744F8715BD66DA63B237,30854,0,11,11,109.56889,18.27076,1763
225597,897B0D6D4872744F8715BD66DA63B237,31521,12,14,2,109.51458,18.22542,1555
225598,897B0D6D4872744F8715BD66DA63B237,60381,15,17,2,109.5241,18.22458,1605
225599,897B0D6D4872744F8715BD66DA63B237,30361,18,20,2,109.50347,18.24,1508
225600,A6CF31A63571639AB283D5F43FB98748,31201,0,2,2,109.51042,18.23819,1558
225601,A6CF31A63571639AB283D5F43FB98748,38961,2,4,2,109.50847,18.23514,1507
225602,A6CF31A63571639AB283D5F43FB98748,39191,5,6,1,109.51493,18.23472,1557
225603,A6CF31A63571639AB283D5F43FB98748,38961,6,7,1,109.50847,18.23514,1507
225604,A6CF31A63571639AB283D5F43FB98748,31201,10,16,6,109.51042,18.23819,1558
225605,A6CF31A63571639AB283D5F43FB98748,38754,17,19,2,109.74667,18.37382,2430
225608,2F57AF45FF7C3D7310AEA860A5A34AF4,30281,15,23,8,109.50597,18.27583,1514
225671,B172E1B17A92EA23226EC822FB6F7B82,39191,0,7,7,109.51493,18.23472,1557
225672,B172E1B17A92EA23226EC822FB6F7B82,31521,12,13,1,109.51458,18.22542,1555
225673,B172E1B17A92EA23226EC822FB6F7B82,30181,14,15,1,109.51597,18.23313,1557
225674,B172E1B17A92EA23226EC822FB6F7B82,30161,17,18,1,109.50042,18.24389,1508
225675,B172E1B17A92EA23226EC822FB6F7B82,30324,20,22,2,109.50326,18.29257,1517
225678,4DFEF4FCCBFCE7F58299570FFFF0AFFF,30771,15,20,5,109.49938,18.26042,1511
225703,D4EE8E1A4C04A1FF0596E4221D0B8B42,31071,0,8,8,109.58257,18.28458,1815
225704,D4EE8E1A4C04A1FF0596E4221D0B8B42,30854,9,21,12,109.56889,18.27076,1763
225705,D4EE8E1A4C04A1FF0596E4221D0B8B42,31071,21,23,2,109.58257,18.28458,1815
225709,3B22FF0293ABF6F27B33414A85B9BAFE,60524,0,6,6,109.42951,18.28993,1216
225710,3B22FF0293ABF6F27B33414A85B9BAFE,31781,10,13,3,109.19847,18.2975,367
225711,3B22FF0293ABF6F27B33414A85B9BAFE,31471,13,15,2,109.34583,18.29563,917
225712,943AD2B0B23FF40406FC81AD8E89FDB0,30201,12,13,1,109.4909,18.26465,1462
225713,943AD2B0B23FF40406FC81AD8E89FDB0,31271,18,19,1,109.48958,18.26257,1462
225747,8CF08DEE8EF83AC7333B837D79034776,38251,0,3,3,109.49618,18.25493,1510
225748,8CF08DEE8EF83AC7333B837D79034776,31531,3,5,2,109.49583,18.25972,1461
225749,8CF08DEE8EF83AC7333B837D79034776,38251,6,8,2,109.49618,18.25493,1510
225758,803884DAE228D36B780CDE250AFE5FD1,31031,13,19,6,109.49979,18.25382,1510
225759,803884DAE228D36B780CDE250AFE5FD1,31031,21,23,2,109.49979,18.25382,1510
225779,1A6EAA2168CC835EA94CCB88CD588780,60551,0,3,3,109.42722,18.30111,1218
225780,1A6EAA2168CC835EA94CCB88CD588780,30731,7,8,1,109.50944,18.22306,1555
225781,1A6EAA2168CC835EA94CCB88CD588780,38291,11,12,1,109.51618,18.24313,1558
225792,52132FCB4C4F2E635BC05915915367CC,38073,3,9,6,109.40813,18.30958,1169
225793,52132FCB4C4F2E635BC05915915367CC,31471,10,11,1,109.34583,18.29563,917
225794,52132FCB4C4F2E635BC05915915367CC,30661,13,23,10,109.37028,18.24361,1008
225795,6F55ACFC3A2BD8567407A1426439CC11,38991,1,7,6,109.52681,18.30368,1618
225796,6F55ACFC3A2BD8567407A1426439CC11,60171,7,8,1,109.51292,18.30694,1569
225797,6F55ACFC3A2BD8567407A1426439CC11,38484,9,10,1,109.53028,18.31528,1620
225798,6F55ACFC3A2BD8567407A1426439CC11,30071,11,12,1,109.52819,18.30472,1619
225799,6F55ACFC3A2BD8567407A1426439CC11,60171,14,16,2,109.51292,18.30694,1569
225800,6F55ACFC3A2BD8567407A1426439CC11,30071,19,21,2,109.52819,18.30472,1619
225808,7A214C2AB4CE0E87DF8DB230B9F95561,30101,0,6,6,109.57299,18.33333,1773
225809,7A214C2AB4CE0E87DF8DB230B9F95561,31631,8,9,1,109.59542,18.36826,1879
225810,7A214C2AB4CE0E87DF8DB230B9F95561,30101,11,23,12,109.57299,18.33333,1773
225811,9B389AE8E9B004176803CCEAFF69104A,30951,7,14,7,109.56208,18.25667,1761
225812,9B389AE8E9B004176803CCEAFF69104A,39371,16,18,2,109.56627,18.2646,1762
225821,A9F97D2464709590426A157138F3C687,31931,0,7,7,109.54771,18.29403,1667
225822,A9F97D2464709590426A157138F3C687,39181,10,17,7,109.55153,18.28035,1715
225823,A9F97D2464709590426A157138F3C687,31931,21,23,2,109.54771,18.29403,1667
225833,97C13EC52CDF5FAD62877D12E655CD2A,33101,0,1,1,109.68438,18.44368,2242
225834,97C13EC52CDF5FAD62877D12E655CD2A,33354,2,5,3,109.67465,18.44583,2192
225835,97C13EC52CDF5FAD62877D12E655CD2A,33101,8,11,3,109.68438,18.44368,2242
225836,97C13EC52CDF5FAD62877D12E655CD2A,31931,13,15,2,109.54771,18.29403,1667
225837,97C13EC52CDF5FAD62877D12E655CD2A,33101,16,23,7,109.68438,18.44368,2242
225862,3CF2D78F1F91A0C91CD3B960F425BF0F,31521,0,10,10,109.51458,18.22542,1555
225863,3CF2D78F1F91A0C91CD3B960F425BF0F,31471,11,14,3,109.34583,18.29563,917
225864,3CF2D78F1F91A0C91CD3B960F425BF0F,31521,17,23,6,109.51458,18.22542,1555
225865,6733B324E753B6172A50174A4CB1E5C2,31251,0,16,16,109.18528,18.2975,317
225880,80779C982E47128931C5479B9B9DAF80,60131,17,19,2,109.49819,18.24778,1509
225881,80779C982E47128931C5479B9B9DAF80,39091,19,23,4,109.50097,18.25222,1510
225884,C17F2EF1DEA79C8C951E3013EE071B2C,30854,16,17,1,109.56889,18.27076,1763
225885,C17F2EF1DEA79C8C951E3013EE071B2C,31071,18,20,2,109.58257,18.28458,1815
225907,B80D6AB96D3D5CEE71A70ED25275F830,60472,0,1,1,109.46625,18.29542,1367
225908,B80D6AB96D3D5CEE71A70ED25275F830,38951,2,3,1,109.48097,18.28868,1416
225909,B80D6AB96D3D5CEE71A70ED25275F830,38951,3,7,4,109.48097,18.28868,1416
225910,B80D6AB96D3D5CEE71A70ED25275F830,30251,12,14,2,109.50611,18.26653,1512
225911,B80D6AB96D3D5CEE71A70ED25275F830,38951,19,20,1,109.48097,18.28868,1416
225912,B80D6AB96D3D5CEE71A70ED25275F830,38951,20,23,3,109.48097,18.28868,1416
225923,17D13F6A66037B54FAB5668CDC734401,31931,13,16,3,109.54771,18.29403,1667
225924,17D13F6A66037B54FAB5668CDC734401,30721,21,22,1,109.51597,18.28257,1565
225952,2C222853895C7F3CD32A59ECC6E42FBB,60281,0,3,3,109.51743,18.25924,1561
225953,2C222853895C7F3CD32A59ECC6E42FBB,30251,3,4,1,109.50611,18.26653,1512
225954,2C222853895C7F3CD32A59ECC6E42FBB,30461,5,9,4,109.5116,18.26313,1562
225974,12C3A1F813E3302C96798332CE4982EC,60524,0,6,6,109.42951,18.28993,1216
225975,12C3A1F813E3302C96798332CE4982EC,30351,7,8,1,109.41701,18.29292,1217
225976,12C3A1F813E3302C96798332CE4982EC,60552,12,13,1,109.41729,18.30014,1218
225977,12C3A1F813E3302C96798332CE4982EC,31236,14,15,1,109.42965,18.29111,1216
226062,8621CFDF1B89A83351494618C53D033F,31071,0,1,1,109.58257,18.28458,1815
226063,8621CFDF1B89A83351494618C53D033F,39181,2,16,14,109.55153,18.28035,1715
226064,8621CFDF1B89A83351494618C53D033F,31071,16,17,1,109.58257,18.28458,1815
226065,8621CFDF1B89A83351494618C53D033F,39181,17,23,6,109.55153,18.28035,1715
226104,174A4B9C6ABA56DD185EEFF3295DCED3,30171,0,13,13,109.48458,18.27139,1463
226105,174A4B9C6ABA56DD185EEFF3295DCED3,60381,15,16,1,109.5241,18.22458,1605
226106,174A4B9C6ABA56DD185EEFF3295DCED3,30171,18,20,2,109.48458,18.27139,1463
226107,174A4B9C6ABA56DD185EEFF3295DCED3,30711,21,23,2,109.50271,18.25347,1510
226123,BE7763F8096EB5A037146E1CC4190538,39183,18,19,1,109.55542,18.28208,1715
226124,BE7763F8096EB5A037146E1CC4190538,30854,20,21,1,109.56889,18.27076,1763
226143,332A868849E47177376F9755C981E1C1,60391,3,4,1,109.47667,18.28757,1416
226144,332A868849E47177376F9755C981E1C1,60441,5,6,1,109.46792,18.28604,1366
226145,332A868849E47177376F9755C981E1C1,30111,9,10,1,109.47583,18.30542,1419
226146,332A868849E47177376F9755C981E1C1,60441,10,13,3,109.46792,18.28604,1366
226147,332A868849E47177376F9755C981E1C1,60391,13,19,6,109.47667,18.28757,1416
226148,332A868849E47177376F9755C981E1C1,60441,21,22,1,109.46792,18.28604,1366
226154,AE1D2CB811A45E9D0BA691392CEA1100,31071,0,9,9,109.58257,18.28458,1815
226155,AE1D2CB811A45E9D0BA691392CEA1100,30854,10,17,7,109.56889,18.27076,1763
226156,AE1D2CB811A45E9D0BA691392CEA1100,31071,19,23,4,109.58257,18.28458,1815
226192,0CF6CC5FF24D6A6AB1B738BADBD1459E,31461,17,18,1,109.5091,18.25389,1510
226193,0CF6CC5FF24D6A6AB1B738BADBD1459E,60281,18,23,5,109.51743,18.25924,1561
226227,51B53CEC1B760EF1347019B41B791499,60541,9,12,3,109.4084,18.29208,1167
226228,51B53CEC1B760EF1347019B41B791499,31521,12,14,2,109.51458,18.22542,1555
226229,51B53CEC1B760EF1347019B41B791499,31521,15,17,2,109.51458,18.22542,1555
226230,51B53CEC1B760EF1347019B41B791499,30361,18,19,1,109.50347,18.24,1508
226231,51B53CEC1B760EF1347019B41B791499,31521,21,22,1,109.51458,18.22542,1555
226292,EB316856896788EC8FD871E122E95728,31811,8,10,2,109.54201,18.31806,1671
226293,EB316856896788EC8FD871E122E95728,30701,13,14,1,109.59313,18.32007,1871
226294,EB316856896788EC8FD871E122E95728,31811,14,20,6,109.54201,18.31806,1671
226364,CD3BCBAB8571FB81953C842A434E5DB8,30854,8,11,3,109.56889,18.27076,1763
226365,CD3BCBAB8571FB81953C842A434E5DB8,31071,12,16,4,109.58257,18.28458,1815
226406,9CCF240AA09CA64BC883A0FAC7F89243,31521,0,8,8,109.51458,18.22542,1555
226407,9CCF240AA09CA64BC883A0FAC7F89243,60381,12,14,2,109.5241,18.22458,1605
226408,9CCF240AA09CA64BC883A0FAC7F89243,31521,14,15,1,109.51458,18.22542,1555
226409,9CCF240AA09CA64BC883A0FAC7F89243,60381,18,20,2,109.5241,18.22458,1605
226410,9CCF240AA09CA64BC883A0FAC7F89243,31521,21,23,2,109.51458,18.22542,1555
226421,4B004637D3CFBCA65EA00FFD3F1EF7A6,39183,13,14,1,109.55542,18.28208,1715
226422,4B004637D3CFBCA65EA00FFD3F1EF7A6,31931,15,16,1,109.54771,18.29403,1667
226423,4B004637D3CFBCA65EA00FFD3F1EF7A6,30854,20,23,3,109.56889,18.27076,1763
226432,E5079E88FAE163C2D4174FAA9A13E19E,30681,0,11,11,109.48493,18.26917,1463
226433,E5079E88FAE163C2D4174FAA9A13E19E,30861,11,13,2,109.52722,18.22743,1606
226434,E5079E88FAE163C2D4174FAA9A13E19E,30861,18,19,1,109.52722,18.22743,1606
226435,E5079E88FAE163C2D4174FAA9A13E19E,30731,20,22,2,109.50944,18.22306,1555
226471,3018A59307B3FCF174C9259743A17A51,31071,0,7,7,109.58257,18.28458,1815
226472,3018A59307B3FCF174C9259743A17A51,30854,9,12,3,109.56889,18.27076,1763
226473,3018A59307B3FCF174C9259743A17A51,31071,12,16,4,109.58257,18.28458,1815
226474,3018A59307B3FCF174C9259743A17A51,31071,20,23,3,109.58257,18.28458,1815
226478,706B8E0F0F5D1C9FC2F8EBB2574EE89F,39154,0,3,3,109.50201,18.25681,1511
226479,706B8E0F0F5D1C9FC2F8EBB2574EE89F,30711,4,13,9,109.50271,18.25347,1510
226480,706B8E0F0F5D1C9FC2F8EBB2574EE89F,60131,13,22,9,109.49819,18.24778,1509
226484,8181CAD16E195D45E1DC6491D97F9BEA,30891,0,7,7,109.59431,18.28389,1865
226485,8181CAD16E195D45E1DC6491D97F9BEA,30581,11,17,6,109.62257,18.24951,1959
226486,8181CAD16E195D45E1DC6491D97F9BEA,30181,18,19,1,109.51597,18.23313,1557
226496,3C6B416FA80A7A03E14FC0317D60CB00,30854,0,21,21,109.56889,18.27076,1763
226497,3C6B416FA80A7A03E14FC0317D60CB00,31071,21,22,1,109.58257,18.28458,1815
226536,20D1C5EEC84E3CA2311E758AF8880F3B,60311,0,3,3,109.52097,18.24319,1558
226537,20D1C5EEC84E3CA2311E758AF8880F3B,38911,4,7,3,109.51674,18.24965,1559
226538,20D1C5EEC84E3CA2311E758AF8880F3B,60281,11,12,1,109.51743,18.25924,1561
226539,20D1C5EEC84E3CA2311E758AF8880F3B,38911,13,15,2,109.51674,18.24965,1559
226553,78F6F1AD59E58A4AF036125B18ED2B6C,38157,0,8,8,109.51483,18.26958,1563
226554,78F6F1AD59E58A4AF036125B18ED2B6C,38121,12,14,2,109.51361,18.27813,1564
226555,78F6F1AD59E58A4AF036125B18ED2B6C,31071,15,18,3,109.58257,18.28458,1815
226556,78F6F1AD59E58A4AF036125B18ED2B6C,39053,20,23,3,109.511,18.2771,1564
226559,383C0E06F28B3BC35ED5F39E5789F4E7,30661,13,15,2,109.37028,18.24361,1008
226560,383C0E06F28B3BC35ED5F39E5789F4E7,31201,17,19,2,109.51042,18.23819,1558
226561,383C0E06F28B3BC35ED5F39E5789F4E7,38961,21,23,2,109.50847,18.23514,1507
226566,54EA5A03224802DD904B7C6F69D9E71B,38951,0,7,7,109.48097,18.28868,1416
226567,54EA5A03224802DD904B7C6F69D9E71B,33481,11,12,1,109.67278,18.41278,2187
226578,993300654839821E7CBC0B1D6C1A4599,30232,0,7,7,109.6191,18.31701,1971
226579,993300654839821E7CBC0B1D6C1A4599,61011,8,19,11,109.60653,18.19076,1900
226590,2F440A235E684ECEDD042B3100A4AE95,31071,0,7,7,109.58257,18.28458,1815
226591,2F440A235E684ECEDD042B3100A4AE95,30854,7,11,4,109.56889,18.27076,1763
226592,2F440A235E684ECEDD042B3100A4AE95,31561,11,12,1,109.56792,18.28479,1765
226593,2F440A235E684ECEDD042B3100A4AE95,30854,15,17,2,109.56889,18.27076,1763
226594,2F440A235E684ECEDD042B3100A4AE95,30251,20,23,3,109.50611,18.26653,1512
226595,0402BD114B7D5E20705E302B756CD062,30854,7,8,1,109.56889,18.27076,1763
226596,0402BD114B7D5E20705E302B756CD062,31071,8,10,2,109.58257,18.28458,1815
226597,0402BD114B7D5E20705E302B756CD062,31311,13,14,1,109.72299,18.27438,2364
226613,5EBEA276FCB4A19AC5C987F5C7CC8908,60621,0,7,7,109.48354,18.27451,1464
226614,5EBEA276FCB4A19AC5C987F5C7CC8908,60401,7,22,15,109.47444,18.27583,1414
226615,C6702CA511246E70666F9E56EFC53769,60221,0,6,6,109.52569,18.29188,1616
226616,C6702CA511246E70666F9E56EFC53769,30851,9,14,5,109.5616,18.27396,1713
226639,7B1A07C39637E996C01DF0A3D287D3C6,30854,8,9,1,109.56889,18.27076,1763
226640,7B1A07C39637E996C01DF0A3D287D3C6,39371,13,14,1,109.56627,18.2646,1762
226651,0312B43ACF9ED1D8304E325E851AEE29,30851,0,14,14,109.5616,18.27396,1713
226652,0312B43ACF9ED1D8304E325E851AEE29,31561,15,16,1,109.56792,18.28479,1765
226653,0312B43ACF9ED1D8304E325E851AEE29,30851,19,23,4,109.5616,18.27396,1713
226661,75CDA53495DB73CFDD1D926B26EDAAA8,30861,0,7,7,109.52722,18.22743,1606
226662,75CDA53495DB73CFDD1D926B26EDAAA8,31145,12,13,1,109.20431,18.30479,369
226663,75CDA53495DB73CFDD1D926B26EDAAA8,38094,17,19,2,109.45403,18.28778,1316
226664,75CDA53495DB73CFDD1D926B26EDAAA8,30861,20,23,3,109.52722,18.22743,1606
226676,B55959B64746A18ECF5077B5F7359221,31561,0,19,19,109.56792,18.28479,1765
226677,B55959B64746A18ECF5077B5F7359221,30854,19,21,2,109.56889,18.27076,1763
226726,D1E9F173C78819C710E28E8ACB6462D5,31391,0,11,11,109.50382,18.24285,1508
226727,D1E9F173C78819C710E28E8ACB6462D5,60201,11,13,2,109.5041,18.2509,1510
226728,D1E9F173C78819C710E28E8ACB6462D5,30511,13,23,10,109.51069,18.24208,1558
226779,179FD4660C817BD29234A518F00339D3,60231,0,14,14,109.49903,18.21972,1504
226780,179FD4660C817BD29234A518F00339D3,60084,14,17,3,109.4984,18.2334,1507
226781,179FD4660C817BD29234A518F00339D3,60231,17,19,2,109.49903,18.21972,1504
226782,179FD4660C817BD29234A518F00339D3,30341,19,20,1,109.3625,18.29167,966
226783,179FD4660C817BD29234A518F00339D3,60231,20,23,3,109.49903,18.21972,1504
226827,7EB4F76900011DECC835981CBE847D5E,30854,16,17,1,109.56889,18.27076,1763
226828,7EB4F76900011DECC835981CBE847D5E,31561,19,21,2,109.56792,18.28479,1765
226841,B7A2800FDF738E1064EAD2A5E58F7A3C,61011,0,14,14,109.60653,18.19076,1900
226843,B7A2800FDF738E1064EAD2A5E58F7A3C,61011,19,20,1,109.60653,18.19076,1900
226875,8265A029C672FE0377EF574CC3ADF2A8,30851,0,2,2,109.5616,18.27396,1713
226876,8265A029C672FE0377EF574CC3ADF2A8,31561,2,5,3,109.56792,18.28479,1765
226877,8265A029C672FE0377EF574CC3ADF2A8,39183,7,17,10,109.55542,18.28208,1715
226878,8265A029C672FE0377EF574CC3ADF2A8,30854,21,23,2,109.56889,18.27076,1763
226912,64F4CDF664AA04E7B79DE93C57128CF6,39181,8,18,10,109.55153,18.28035,1715
226913,64F4CDF664AA04E7B79DE93C57128CF6,31931,21,23,2,109.54771,18.29403,1667
226936,6B806948BC9187A91D033B4096721B00,31561,0,8,8,109.56792,18.28479,1765
226937,6B806948BC9187A91D033B4096721B00,31071,9,20,11,109.58257,18.28458,1815
226938,6B806948BC9187A91D033B4096721B00,31561,20,22,2,109.56792,18.28479,1765
226941,97E1B26BF8A5E1ECE36FFEB9F9E6544C,30681,0,6,6,109.48493,18.26917,1463
226942,97E1B26BF8A5E1ECE36FFEB9F9E6544C,60401,7,9,2,109.47444,18.27583,1414
226943,97E1B26BF8A5E1ECE36FFEB9F9E6544C,30681,10,12,2,109.48493,18.26917,1463
226949,5ACB2494699EB2F10AA3427B417842C4,39151,15,16,1,109.49875,18.25097,1510
226993,56F4A25A0E603B5B2CF39EF89A2DE812,38251,13,15,2,109.49618,18.25493,1510
226994,56F4A25A0E603B5B2CF39EF89A2DE812,60161,17,19,2,109.49174,18.26181,1461
226995,56F4A25A0E603B5B2CF39EF89A2DE812,31611,20,22,2,109.63076,18.34944,2026
227010,EBBF71074D6F0C4C82B27902F4E823C5,38145,0,9,9,109.378,18.2912,1066
227011,EBBF71074D6F0C4C82B27902F4E823C5,31471,12,14,2,109.34583,18.29563,917
227012,EBBF71074D6F0C4C82B27902F4E823C5,38145,17,19,2,109.378,18.2912,1066
227013,EBBF71074D6F0C4C82B27902F4E823C5,30681,20,21,1,109.48493,18.26917,1463
227014,EBBF71074D6F0C4C82B27902F4E823C5,38145,21,23,2,109.378,18.2912,1066
227022,80BA695BEE7DAB7E0B7889A474F27816,31071,0,1,1,109.58257,18.28458,1815
227023,80BA695BEE7DAB7E0B7889A474F27816,30854,4,6,2,109.56889,18.27076,1763
227024,80BA695BEE7DAB7E0B7889A474F27816,31071,7,8,1,109.58257,18.28458,1815
227025,E65658506C2BF9C993BA69EE6D38B3C6,31951,3,4,1,109.52174,18.30299,1568
227026,E65658506C2BF9C993BA69EE6D38B3C6,60361,5,6,1,109.51938,18.29681,1567
227027,E65658506C2BF9C993BA69EE6D38B3C6,31951,6,19,13,109.52174,18.30299,1568
227028,E65658506C2BF9C993BA69EE6D38B3C6,31561,21,23,2,109.56792,18.28479,1765
227044,E292D83051830D054E89D209EEABA4B9,31071,0,1,1,109.58257,18.28458,1815
227045,E292D83051830D054E89D209EEABA4B9,31561,1,20,19,109.56792,18.28479,1765
227046,2C7E329ABF5669760C98EF0FEA876F54,39111,0,10,10,109.5191,18.22597,1555
227108,4EC716C6116001DCCA61DAB5E48F9371,30111,0,5,5,109.47583,18.30542,1419
227109,4EC716C6116001DCCA61DAB5E48F9371,38391,6,7,1,109.44111,18.29083,1266
227110,4EC716C6116001DCCA61DAB5E48F9371,60201,9,11,2,109.5041,18.2509,1510
227111,4EC716C6116001DCCA61DAB5E48F9371,60441,15,16,1,109.46792,18.28604,1366
227135,C93386A9D86FE22A1FD4E5116045DD8D,31561,0,9,9,109.56792,18.28479,1765
227136,C93386A9D86FE22A1FD4E5116045DD8D,39183,10,15,5,109.55542,18.28208,1715
227137,C93386A9D86FE22A1FD4E5116045DD8D,31561,15,17,2,109.56792,18.28479,1765
227138,C93386A9D86FE22A1FD4E5116045DD8D,30854,19,20,1,109.56889,18.27076,1763
227152,9C068F0C3303F33ADE079F339455F990,30181,9,10,1,109.51597,18.23313,1557
227154,9C068F0C3303F33ADE079F339455F990,31031,17,20,3,109.49979,18.25382,1510
227155,9C068F0C3303F33ADE079F339455F990,30181,22,23,1,109.51597,18.23313,1557
227162,2B8C748A18FA7D08D4335AD7C9DEF01B,30851,9,10,1,109.5616,18.27396,1713
227163,2B8C748A18FA7D08D4335AD7C9DEF01B,30951,10,12,2,109.56208,18.25667,1761
227164,2B8C748A18FA7D08D4335AD7C9DEF01B,39371,12,14,2,109.56627,18.2646,1762
227190,5F78EA2742F6109E8DCBBEDB5D54405A,30661,12,13,1,109.37028,18.24361,1008
227191,5F78EA2742F6109E8DCBBEDB5D54405A,60381,17,21,4,109.5241,18.22458,1605
227192,5F78EA2742F6109E8DCBBEDB5D54405A,60401,21,23,2,109.47444,18.27583,1414
227206,6587551DA47309E484D1302521C8D417,38275,7,12,5,109.62875,18.22938,2006
227207,6587551DA47309E484D1302521C8D417,60631,15,16,1,109.57778,18.27583,1814
227208,6587551DA47309E484D1302521C8D417,60381,18,20,2,109.5241,18.22458,1605
227227,2BCF009C69FE42CE27D7818D7C0D0313,60524,1,7,6,109.42951,18.28993,1216
227228,2BCF009C69FE42CE27D7818D7C0D0313,31781,10,12,2,109.19847,18.2975,367
227229,2BCF009C69FE42CE27D7818D7C0D0313,60054,14,15,1,109.3016,18.31229,770
227230,2BCF009C69FE42CE27D7818D7C0D0313,31471,15,16,1,109.34583,18.29563,917
227231,2BCF009C69FE42CE27D7818D7C0D0313,60524,21,23,2,109.42951,18.28993,1216
227263,DA10676C4DA702E02A2C3FFFAC40ABA2,31561,0,3,3,109.56792,18.28479,1765
227264,DA10676C4DA702E02A2C3FFFAC40ABA2,39183,6,22,16,109.55542,18.28208,1715
227281,61F5089BD2CABA4C6A48281A94E5821D,30854,9,12,3,109.56889,18.27076,1763
227282,61F5089BD2CABA4C6A48281A94E5821D,31071,12,14,2,109.58257,18.28458,1815
227283,61F5089BD2CABA4C6A48281A94E5821D,30854,15,16,1,109.56889,18.27076,1763
227284,89DE8482DFDA2DF79D79EDE80E8DF6A7,30581,17,19,2,109.62257,18.24951,1959
227285,89DE8482DFDA2DF79D79EDE80E8DF6A7,60321,19,21,2,109.63611,18.24306,2008
227335,D37BF241A4A35F0F341582CAF9EF0DD2,39191,0,9,9,109.51493,18.23472,1557
227336,D37BF241A4A35F0F341582CAF9EF0DD2,30181,12,16,4,109.51597,18.23313,1557
227385,D3CC138F01596B858EB1ECAA73909436,31391,17,18,1,109.50382,18.24285,1508
227386,D3CC138F01596B858EB1ECAA73909436,31231,21,23,2,109.42597,18.29292,1217
227395,ADD1B12D647B225460C017E17E9790EE,30111,0,5,5,109.47583,18.30542,1419
227396,ADD1B12D647B225460C017E17E9790EE,60391,5,6,1,109.47667,18.28757,1416
227397,ADD1B12D647B225460C017E17E9790EE,31471,8,9,1,109.34583,18.29563,917
227403,7D3715670DBD868CBE84944A90E4C6E8,38027,0,6,6,109.38833,18.2909,1066
227404,7D3715670DBD868CBE84944A90E4C6E8,60561,8,13,5,109.38229,18.29785,1067
227405,7D3715670DBD868CBE84944A90E4C6E8,38027,13,16,3,109.38833,18.2909,1066
227406,7D3715670DBD868CBE84944A90E4C6E8,30761,19,20,1,109.45201,18.3,1318
227415,BF762132BA656C7D6C16E7D07F31AF3B,30201,8,10,2,109.4909,18.26465,1462
227416,BF762132BA656C7D6C16E7D07F31AF3B,31471,11,16,5,109.34583,18.29563,917
227417,BF762132BA656C7D6C16E7D07F31AF3B,30201,17,23,6,109.4909,18.26465,1462
227421,C709D01469E0800AF998DFAF42105CDC,30854,0,3,3,109.56889,18.27076,1763
227422,C709D01469E0800AF998DFAF42105CDC,31561,7,16,9,109.56792,18.28479,1765
227443,451E2BF48CD7B253EB0892324E679BCC,38297,0,7,7,109.52576,18.24965,1609
227444,451E2BF48CD7B253EB0892324E679BCC,60281,7,12,5,109.51743,18.25924,1561
227445,451E2BF48CD7B253EB0892324E679BCC,38291,12,14,2,109.51618,18.24313,1558
227446,451E2BF48CD7B253EB0892324E679BCC,60281,14,17,3,109.51743,18.25924,1561
227447,451E2BF48CD7B253EB0892324E679BCC,38297,18,22,4,109.52576,18.24965,1609
227515,4F3A073B0E00F2C591EAC7CA3550DBAE,39181,0,6,6,109.55153,18.28035,1715
227516,4F3A073B0E00F2C591EAC7CA3550DBAE,39181,6,8,2,109.55153,18.28035,1715
227517,4F3A073B0E00F2C591EAC7CA3550DBAE,31071,11,13,2,109.58257,18.28458,1815
227518,4F3A073B0E00F2C591EAC7CA3550DBAE,39181,15,16,1,109.55153,18.28035,1715
227519,4F3A073B0E00F2C591EAC7CA3550DBAE,30851,19,21,2,109.5616,18.27396,1713
227529,FE119DB57322892B4DF62B443B992BDF,38871,1,6,5,109.44681,18.28625,1316
227530,FE119DB57322892B4DF62B443B992BDF,31781,9,11,2,109.19847,18.2975,367
227531,FE119DB57322892B4DF62B443B992BDF,31471,13,14,1,109.34583,18.29563,917
227546,DDE77D3A656666992FC3458B84010D43,39183,3,4,1,109.55542,18.28208,1715
227547,DDE77D3A656666992FC3458B84010D43,31561,5,21,16,109.56792,18.28479,1765
227548,DDE77D3A656666992FC3458B84010D43,39183,21,22,1,109.55542,18.28208,1715
227573,C5190185E6A850F6CC88937542E0EA31,30854,7,18,11,109.56889,18.27076,1763
227574,C5190185E6A850F6CC88937542E0EA31,39371,19,20,1,109.56627,18.2646,1762
227575,C5190185E6A850F6CC88937542E0EA31,31071,20,21,1,109.58257,18.28458,1815
227584,4C3E554FCF9940CA0E814B61B4474B2F,38105,0,16,16,109.40299,18.29229,1117
227585,4C3E554FCF9940CA0E814B61B4474B2F,30361,19,22,3,109.50347,18.24,1508
227621,F6A1EBB84FE583E84185C423218578F5,31561,0,13,13,109.56792,18.28479,1765
227622,F6A1EBB84FE583E84185C423218578F5,39183,14,15,1,109.55542,18.28208,1715
227666,EAD0F857A028E27AEC5E665129C31CC4,60121,0,7,7,109.74507,18.37472,2430
227667,EAD0F857A028E27AEC5E665129C31CC4,30961,9,15,6,109.74042,18.37903,2431
227668,EAD0F857A028E27AEC5E665129C31CC4,60121,18,19,1,109.74507,18.37472,2430
227716,E7BFEC31FDC076FECACC6CDB673FEF47,60381,2,16,14,109.5241,18.22458,1605
227717,E7BFEC31FDC076FECACC6CDB673FEF47,30221,17,23,6,109.57833,18.20222,1802
227718,A9FC13A339FBA35C9F749CD7B532151B,60641,12,14,2,109.53854,18.2359,1657
227719,A9FC13A339FBA35C9F749CD7B532151B,39091,14,15,1,109.50097,18.25222,1510
227720,A9FC13A339FBA35C9F749CD7B532151B,31723,17,23,6,109.68563,18.23701,2207
227742,40C57F24FE0409ABB752B2031C349577,38951,0,18,18,109.48097,18.28868,1416
227743,40C57F24FE0409ABB752B2031C349577,38951,19,23,4,109.48097,18.28868,1416
227761,767325C9C51C25E76A4781E7E66DE8D0,38023,15,17,2,109.37132,18.28993,1016
227762,767325C9C51C25E76A4781E7E66DE8D0,31181,18,20,2,109.50382,18.24813,1509
227763,767325C9C51C25E76A4781E7E66DE8D0,38023,21,22,1,109.37132,18.28993,1016
227772,D1B09D14086A317457A98E1E3E3BED6B,39181,0,6,6,109.55153,18.28035,1715
227773,D1B09D14086A317457A98E1E3E3BED6B,31931,7,9,2,109.54771,18.29403,1667
227774,D1B09D14086A317457A98E1E3E3BED6B,39181,11,16,5,109.55153,18.28035,1715
227775,D1B09D14086A317457A98E1E3E3BED6B,30711,18,23,5,109.50271,18.25347,1510
227804,E72C27EE9814EBDCED7E0237D87F0F45,60401,0,14,14,109.47444,18.27583,1414
227805,E72C27EE9814EBDCED7E0237D87F0F45,31951,17,19,2,109.52174,18.30299,1568
227806,E72C27EE9814EBDCED7E0237D87F0F45,60401,21,22,1,109.47444,18.27583,1414
227807,34AB502A442AA8EA4A7FB30471B204DB,60621,0,5,5,109.48354,18.27451,1464
227808,34AB502A442AA8EA4A7FB30471B204DB,60401,8,9,1,109.47444,18.27583,1414
227809,34AB502A442AA8EA4A7FB30471B204DB,30341,13,14,1,109.3625,18.29167,966
227810,34AB502A442AA8EA4A7FB30471B204DB,38094,16,17,1,109.45403,18.28778,1316
227811,34AB502A442AA8EA4A7FB30471B204DB,30171,21,22,1,109.48458,18.27139,1463
227833,B0C6DED232762D9BAF78468BD2731104,60041,12,14,2,109.39889,18.31944,1121
227834,B0C6DED232762D9BAF78468BD2731104,31571,16,17,1,109.61563,18.23326,1957
227835,B0C6DED232762D9BAF78468BD2731104,30581,19,23,4,109.62257,18.24951,1959
227836,4BCFB9B7DA47F954D069C9FF9050BF88,31071,0,5,5,109.58257,18.28458,1815
227837,4BCFB9B7DA47F954D069C9FF9050BF88,30854,8,15,7,109.56889,18.27076,1763
227838,4BCFB9B7DA47F954D069C9FF9050BF88,31071,18,21,3,109.58257,18.28458,1815
227839,4BCFB9B7DA47F954D069C9FF9050BF88,30854,22,23,1,109.56889,18.27076,1763
227844,6FDD8510FC3FD17D36965B0963BD7329,30854,0,5,5,109.56889,18.27076,1763
227845,6FDD8510FC3FD17D36965B0963BD7329,31561,6,7,1,109.56792,18.28479,1765
227846,6FDD8510FC3FD17D36965B0963BD7329,30854,9,23,14,109.56889,18.27076,1763
227867,CD576F1C1CDFB89E6A99A20E65927346,38251,16,17,1,109.49618,18.25493,1510
227868,CD576F1C1CDFB89E6A99A20E65927346,30854,19,21,2,109.56889,18.27076,1763
227878,E9DC5E3F06A9FBF162477C6043E75224,30851,0,3,3,109.5616,18.27396,1713
227879,E9DC5E3F06A9FBF162477C6043E75224,31071,3,6,3,109.58257,18.28458,1815
227880,E9DC5E3F06A9FBF162477C6043E75224,31931,7,9,2,109.54771,18.29403,1667
227888,0695D4E7B3E726CA09D841B87798B560,30854,0,14,14,109.56889,18.27076,1763
227889,0695D4E7B3E726CA09D841B87798B560,31561,18,19,1,109.56792,18.28479,1765
227890,0695D4E7B3E726CA09D841B87798B560,30854,22,23,1,109.56889,18.27076,1763
227932,B6073F75180440AD0128577E76B732CE,30809,12,14,2,109.4891,18.28229,1465
227933,B6073F75180440AD0128577E76B732CE,31261,17,18,1,109.51174,18.2466,1559
227934,B6073F75180440AD0128577E76B732CE,60401,22,23,1,109.47444,18.27583,1414
227935,A7B3BDD8DC79485BA41EC7F220A41345,60631,0,9,9,109.57778,18.27583,1814
227936,A7B3BDD8DC79485BA41EC7F220A41345,30854,10,17,7,109.56889,18.27076,1763
227937,A7B3BDD8DC79485BA41EC7F220A41345,60631,19,22,3,109.57778,18.27583,1814
227997,225EDE82328108AFB3E7EE610CA3F074,31931,0,11,11,109.54771,18.29403,1667
227998,225EDE82328108AFB3E7EE610CA3F074,31561,12,14,2,109.56792,18.28479,1765
227999,225EDE82328108AFB3E7EE610CA3F074,30361,15,16,1,109.50347,18.24,1508
228022,9E2CAA912E7C38B3460AB2C8B985CA0D,30854,2,22,20,109.56889,18.27076,1763
228023,9E2CAA912E7C38B3460AB2C8B985CA0D,31071,22,23,1,109.58257,18.28458,1815
228037,89362A3CA3AE6F5B75871F2110924F99,30851,0,7,7,109.5616,18.27396,1713
228038,89362A3CA3AE6F5B75871F2110924F99,30951,11,16,5,109.56208,18.25667,1761
228039,89362A3CA3AE6F5B75871F2110924F99,30851,19,23,4,109.5616,18.27396,1713
228064,DA7F75EB1D499DC5A1A7DEE3CAD1DCEE,31561,0,5,5,109.56792,18.28479,1765
228065,DA7F75EB1D499DC5A1A7DEE3CAD1DCEE,31071,8,10,2,109.58257,18.28458,1815
228112,7FF3C6569A3990C03CAF6C52D3C8BC6C,30921,0,3,3,109.53903,18.29451,1667
228113,7FF3C6569A3990C03CAF6C52D3C8BC6C,31931,7,8,1,109.54771,18.29403,1667
228114,7FF3C6569A3990C03CAF6C52D3C8BC6C,30921,10,13,3,109.53903,18.29451,1667
228115,7FF3C6569A3990C03CAF6C52D3C8BC6C,31931,13,19,6,109.54771,18.29403,1667
228116,7FF3C6569A3990C03CAF6C52D3C8BC6C,30921,21,23,2,109.53903,18.29451,1667
228124,BA9F8903EC2A1C9DFCBB7CC5DE07DE50,39151,1,7,6,109.49875,18.25097,1510
228125,BA9F8903EC2A1C9DFCBB7CC5DE07DE50,31071,10,19,9,109.58257,18.28458,1815
228126,BA9F8903EC2A1C9DFCBB7CC5DE07DE50,30854,20,22,2,109.56889,18.27076,1763
228129,B78E7295CB13532B4E2C30EF158E297F,39183,2,3,1,109.55542,18.28208,1715
228130,B78E7295CB13532B4E2C30EF158E297F,30851,3,6,3,109.5616,18.27396,1713
228131,B78E7295CB13532B4E2C30EF158E297F,31561,10,11,1,109.56792,18.28479,1765
228132,B78E7295CB13532B4E2C30EF158E297F,30854,12,14,2,109.56889,18.27076,1763
228148,066E3B290AAC556F650E56DD0F693AB2,38251,22,23,1,109.49618,18.25493,1510
228168,F47C4E1E39056C43B0AD32AC994AB7C0,31931,0,22,22,109.54771,18.29403,1667
228169,F47C4E1E39056C43B0AD32AC994AB7C0,60361,22,23,1,109.51938,18.29681,1567
228190,182D5101D28D51096306D4EF5FDD4501,60084,0,4,4,109.4984,18.2334,1507
228191,182D5101D28D51096306D4EF5FDD4501,30211,5,6,1,109.49882,18.23931,1508
228192,182D5101D28D51096306D4EF5FDD4501,31031,9,10,1,109.49979,18.25382,1510
228193,182D5101D28D51096306D4EF5FDD4501,31101,11,13,2,109.65389,18.23403,2057
228194,182D5101D28D51096306D4EF5FDD4501,30271,14,16,2,109.49132,18.23153,1456
228195,182D5101D28D51096306D4EF5FDD4501,38251,18,20,2,109.49618,18.25493,1510
228196,182D5101D28D51096306D4EF5FDD4501,31231,21,22,1,109.42597,18.29292,1217
228201,64EA917EAAD3EB55DA2ABB227203C131,60631,0,7,7,109.57778,18.27583,1814
228202,64EA917EAAD3EB55DA2ABB227203C131,30851,10,23,13,109.5616,18.27396,1713
228228,95AA3325BCDA7D9697384F31CB14FBD1,30111,0,7,7,109.47583,18.30542,1419
228229,95AA3325BCDA7D9697384F31CB14FBD1,31781,11,12,1,109.19847,18.2975,367
228230,95AA3325BCDA7D9697384F31CB14FBD1,31471,12,14,2,109.34583,18.29563,917
228231,95AA3325BCDA7D9697384F31CB14FBD1,30111,19,20,1,109.47583,18.30542,1419
228276,30F5D42A1A8F1CF26F5C9617FCB06C4F,30854,0,1,1,109.56889,18.27076,1763
228277,30F5D42A1A8F1CF26F5C9617FCB06C4F,39183,2,4,2,109.55542,18.28208,1715
228278,30F5D42A1A8F1CF26F5C9617FCB06C4F,31561,4,14,10,109.56792,18.28479,1765
228290,5291560AC3CA28497E4CB7832DDE2A8C,30581,18,19,1,109.62257,18.24951,1959
228291,5291560AC3CA28497E4CB7832DDE2A8C,60214,22,23,1,109.63104,18.24493,2009
228292,A9C8F328449201624A136B13BD43BEFF,31521,0,2,2,109.51458,18.22542,1555
228293,A9C8F328449201624A136B13BD43BEFF,60291,4,8,4,109.50826,18.24639,1509
228294,A9C8F328449201624A136B13BD43BEFF,30661,11,14,3,109.37028,18.24361,1008
228354,491A112CD81B9085F752897809919691,60291,2,3,1,109.50826,18.24639,1509
228355,491A112CD81B9085F752897809919691,31206,3,5,2,109.50819,18.23549,1507
228356,491A112CD81B9085F752897809919691,60291,5,7,2,109.50826,18.24639,1509
228362,DD056101D68CBFC24096E8F587CC747C,30071,0,1,1,109.52819,18.30472,1619
228363,DD056101D68CBFC24096E8F587CC747C,30921,1,6,5,109.53903,18.29451,1667
228364,DD056101D68CBFC24096E8F587CC747C,31931,6,22,16,109.54771,18.29403,1667
228412,54CB15055EFF66319A7EAB3FC49E46B1,38891,19,20,1,109.51486,18.24118,1558
228413,54CB15055EFF66319A7EAB3FC49E46B1,30421,20,21,1,109.50021,18.25861,1511
228414,54CB15055EFF66319A7EAB3FC49E46B1,30809,22,23,1,109.4891,18.28229,1465
228426,E6D4DFF479624FE5A6D32ED2123EE444,31521,0,1,1,109.51458,18.22542,1555
228427,E6D4DFF479624FE5A6D32ED2123EE444,38891,3,5,2,109.51486,18.24118,1558
228428,E6D4DFF479624FE5A6D32ED2123EE444,30511,5,6,1,109.51069,18.24208,1558
228429,E6D4DFF479624FE5A6D32ED2123EE444,60291,7,9,2,109.50826,18.24639,1509
228430,E6D4DFF479624FE5A6D32ED2123EE444,33051,13,14,1,109.6475,18.46618,2096
228431,E6D4DFF479624FE5A6D32ED2123EE444,31521,17,19,2,109.51458,18.22542,1555
228432,E6D4DFF479624FE5A6D32ED2123EE444,60291,19,22,3,109.50826,18.24639,1509
228443,A549C024E6F63EDBD3DC866F10DB11CE,31071,12,13,1,109.58257,18.28458,1815
228444,A549C024E6F63EDBD3DC866F10DB11CE,30854,16,18,2,109.56889,18.27076,1763
228458,8C2A72A3EA8DBE7544B4A433B2BC3FE0,31261,0,6,6,109.51174,18.2466,1559
228459,8C2A72A3EA8DBE7544B4A433B2BC3FE0,38291,7,10,3,109.51618,18.24313,1558
228460,8C2A72A3EA8DBE7544B4A433B2BC3FE0,60491,14,15,1,109.43354,18.30847,1269
228461,8C2A72A3EA8DBE7544B4A433B2BC3FE0,31021,18,20,2,109.49021,18.27,1463
228462,8C2A72A3EA8DBE7544B4A433B2BC3FE0,60261,20,23,3,109.44326,18.3075,1319
228463,A749E400BFD3B5908671E939EC104DEE,30854,0,9,9,109.56889,18.27076,1763
228464,A749E400BFD3B5908671E939EC104DEE,31071,10,12,2,109.58257,18.28458,1815
228465,A749E400BFD3B5908671E939EC104DEE,30854,12,14,2,109.56889,18.27076,1763
228466,A749E400BFD3B5908671E939EC104DEE,31071,18,20,2,109.58257,18.28458,1815
228504,608A55C14BAB2A5B627ACC1F39B89FB6,30854,13,17,4,109.56889,18.27076,1763
228505,608A55C14BAB2A5B627ACC1F39B89FB6,31071,18,21,3,109.58257,18.28458,1815
228506,608A55C14BAB2A5B627ACC1F39B89FB6,31945,22,23,1,109.58021,18.29403,1817
228561,10EBF762D28520B09848288F7052CFDE,30854,3,6,3,109.56889,18.27076,1763
228562,10EBF762D28520B09848288F7052CFDE,39101,8,17,9,109.50132,18.24931,1509
228563,10EBF762D28520B09848288F7052CFDE,30854,18,23,5,109.56889,18.27076,1763
228564,85586D73EA48B4F4D520D899B0BE0554,30291,0,5,5,109.50403,18.27028,1513
228565,85586D73EA48B4F4D520D899B0BE0554,30854,6,9,3,109.56889,18.27076,1763
228566,85586D73EA48B4F4D520D899B0BE0554,31071,10,15,5,109.58257,18.28458,1815
228567,85586D73EA48B4F4D520D899B0BE0554,30854,15,18,3,109.56889,18.27076,1763
228568,85586D73EA48B4F4D520D899B0BE0554,30291,19,23,4,109.50403,18.27028,1513
228579,C30EF1A03F3ACD87114629BE5EBA14E8,60041,13,14,1,109.39889,18.31944,1121
228580,C30EF1A03F3ACD87114629BE5EBA14E8,60552,14,16,2,109.41729,18.30014,1218
228581,C30EF1A03F3ACD87114629BE5EBA14E8,30711,20,21,1,109.50271,18.25347,1510
228603,546C572FC49C780F9A9AF62ED98666DF,30681,0,14,14,109.48493,18.26917,1463
228604,546C572FC49C780F9A9AF62ED98666DF,30351,14,22,8,109.41701,18.29292,1217
228605,908C7D49FB1480C9AB62D9B8DA7BEC53,30441,13,14,1,109.64021,18.25424,2010
228606,908C7D49FB1480C9AB62D9B8DA7BEC53,31031,15,19,4,109.49979,18.25382,1510
228607,908C7D49FB1480C9AB62D9B8DA7BEC53,31031,19,21,2,109.49979,18.25382,1510
228608,908C7D49FB1480C9AB62D9B8DA7BEC53,38251,21,23,2,109.49618,18.25493,1510
228618,5E6F81A7DA23F57413C15AC7514275E5,31945,0,12,12,109.58021,18.29403,1817
228619,5E6F81A7DA23F57413C15AC7514275E5,31071,13,14,1,109.58257,18.28458,1815
228620,5E6F81A7DA23F57413C15AC7514275E5,31945,14,16,2,109.58021,18.29403,1817
228621,5E6F81A7DA23F57413C15AC7514275E5,31561,20,22,2,109.56792,18.28479,1765
228642,B09F6CB43F7BB3E6391589239BFB1120,38951,0,12,12,109.48097,18.28868,1416
228643,B09F6CB43F7BB3E6391589239BFB1120,60041,13,15,2,109.39889,18.31944,1121
228644,B09F6CB43F7BB3E6391589239BFB1120,38951,19,23,4,109.48097,18.28868,1416
228645,7B537E00BE7633BC2F59AF379F204FC9,38356,0,8,8,109.50201,18.21486,1504
228646,7B537E00BE7633BC2F59AF379F204FC9,38881,10,12,2,109.51618,18.26431,1562
228685,AF53449CC3CDD3E221C0679AB81040FD,60041,0,1,1,109.39889,18.31944,1121
228686,AF53449CC3CDD3E221C0679AB81040FD,38275,2,20,18,109.62875,18.22938,2006
228687,AF53449CC3CDD3E221C0679AB81040FD,39101,21,23,2,109.50132,18.24931,1509
228739,CF73D0D52A41EE420FB8269A6F6AF679,39371,2,8,6,109.56627,18.2646,1762
228740,CF73D0D52A41EE420FB8269A6F6AF679,30854,12,15,3,109.56889,18.27076,1763
228741,CF73D0D52A41EE420FB8269A6F6AF679,60131,19,22,3,109.49819,18.24778,1509
228765,3930042D05CE9089B6239DEA3A3E855C,31471,17,18,1,109.34583,18.29563,917
228766,3930042D05CE9089B6239DEA3A3E855C,30661,19,22,3,109.37028,18.24361,1008
228767,3930042D05CE9089B6239DEA3A3E855C,60411,22,23,1,109.32514,18.30854,869
228778,5E4E8438E1ACB3B3BDC485F2AF3A8A03,30071,0,14,14,109.52819,18.30472,1619
228779,5E4E8438E1ACB3B3BDC485F2AF3A8A03,31931,15,16,1,109.54771,18.29403,1667
228780,5E4E8438E1ACB3B3BDC485F2AF3A8A03,30071,20,22,2,109.52819,18.30472,1619
228784,7AF4921BC4D1712A961904D0ECC91550,38484,0,5,5,109.53028,18.31528,1620
228785,7AF4921BC4D1712A961904D0ECC91550,38991,6,7,1,109.52681,18.30368,1618
228786,7AF4921BC4D1712A961904D0ECC91550,30071,9,10,1,109.52819,18.30472,1619
228788,7AF4921BC4D1712A961904D0ECC91550,38484,19,23,4,109.53028,18.31528,1620
228789,0F558B6653C655C7F0BAEA9D66B33F57,31071,0,7,7,109.58257,18.28458,1815
228790,0F558B6653C655C7F0BAEA9D66B33F57,30854,9,11,2,109.56889,18.27076,1763
228791,0F558B6653C655C7F0BAEA9D66B33F57,31071,12,13,1,109.58257,18.28458,1815
228792,0F558B6653C655C7F0BAEA9D66B33F57,30854,16,20,4,109.56889,18.27076,1763
228806,43F5AB52A0AF3FEB5880C6DCD16BBA02,60011,0,9,9,109.48965,18.30222,1468
228807,43F5AB52A0AF3FEB5880C6DCD16BBA02,39101,14,15,1,109.50132,18.24931,1509
228808,43F5AB52A0AF3FEB5880C6DCD16BBA02,60011,20,23,3,109.48965,18.30222,1468
228833,7421066246AAD1C230E7E2A7ADF06E9D,30711,0,1,1,109.50271,18.25347,1510
228834,7421066246AAD1C230E7E2A7ADF06E9D,60631,2,6,4,109.57778,18.27583,1814
228835,7421066246AAD1C230E7E2A7ADF06E9D,30854,7,10,3,109.56889,18.27076,1763
228848,10026EC528DC65E6B062D4E8B47727C1,38127,0,6,6,109.50833,18.27222,1513
228849,10026EC528DC65E6B062D4E8B47727C1,60117,10,11,1,109.73604,18.35681,2427
228850,10026EC528DC65E6B062D4E8B47727C1,38127,13,23,10,109.50833,18.27222,1513
228869,417408FFDA93B177641D270D3A5C4B2D,30854,17,18,1,109.56889,18.27076,1763
228870,417408FFDA93B177641D270D3A5C4B2D,31071,19,23,4,109.58257,18.28458,1815
228886,C39A87B1BC9DA20E7546ED50A7A8B13C,30854,0,9,9,109.56889,18.27076,1763
228887,C39A87B1BC9DA20E7546ED50A7A8B13C,31321,13,15,2,109.63799,18.23201,2007
228888,C39A87B1BC9DA20E7546ED50A7A8B13C,60631,18,19,1,109.57778,18.27583,1814
228889,C39A87B1BC9DA20E7546ED50A7A8B13C,30854,21,22,1,109.56889,18.27076,1763
228923,503843EC837742985DC0A9C166C6B65E,31061,0,2,2,109.53333,18.23257,1607
228924,503843EC837742985DC0A9C166C6B65E,31421,3,4,1,109.55382,18.22347,1705
228925,503843EC837742985DC0A9C166C6B65E,31061,7,23,16,109.53333,18.23257,1607
228929,E484FD222AE68252EABA732103338917,31071,2,6,4,109.58257,18.28458,1815
228930,E484FD222AE68252EABA732103338917,30854,9,20,11,109.56889,18.27076,1763
228939,AAD294F97E8F953422B544ED61B36D13,39371,12,14,2,109.56627,18.2646,1762
228940,AAD294F97E8F953422B544ED61B36D13,60381,16,17,1,109.5241,18.22458,1605
228941,AAD294F97E8F953422B544ED61B36D13,31071,19,23,4,109.58257,18.28458,1815
228967,EFFEF00C078D502D6D0D1D469ACBA466,39041,0,8,8,109.40021,18.29278,1117
228968,EFFEF00C078D502D6D0D1D469ACBA466,31471,9,11,2,109.34583,18.29563,917
228969,EFFEF00C078D502D6D0D1D469ACBA466,39041,12,14,2,109.40021,18.29278,1117
228970,EFFEF00C078D502D6D0D1D469ACBA466,31471,15,16,1,109.34583,18.29563,917
228971,EFFEF00C078D502D6D0D1D469ACBA466,31534,19,20,1,109.49368,18.25806,1461
228972,EFFEF00C078D502D6D0D1D469ACBA466,30421,22,23,1,109.50021,18.25861,1511
228978,AEB67BDC79FE6552942E6F2DEC149F32,31864,21,23,2,109.49014,18.28333,1465
228981,D4448A1349B0563C78F16B479359A95F,31071,1,2,1,109.58257,18.28458,1815
228982,D4448A1349B0563C78F16B479359A95F,31761,2,8,6,109.60521,18.27965,1914
228983,D4448A1349B0563C78F16B479359A95F,30854,9,12,3,109.56889,18.27076,1763
229012,DF49F834C08C7E8FA6D78272EE1FB651,60361,0,6,6,109.51938,18.29681,1567
229013,DF49F834C08C7E8FA6D78272EE1FB651,30851,6,8,2,109.5616,18.27396,1713
229014,DF49F834C08C7E8FA6D78272EE1FB651,39371,9,10,1,109.56627,18.2646,1762
229015,DF49F834C08C7E8FA6D78272EE1FB651,30851,10,15,5,109.5616,18.27396,1713
229016,DF49F834C08C7E8FA6D78272EE1FB651,60361,19,22,3,109.51938,18.29681,1567
229041,BD4652414D5C17466BA36FD4BD943A94,60221,3,7,4,109.52569,18.29188,1616
229042,BD4652414D5C17466BA36FD4BD943A94,31931,9,10,1,109.54771,18.29403,1667
229069,B421B0364BC07B443944D07A1DCB065A,60571,0,8,8,109.50722,18.25056,1510
229070,B421B0364BC07B443944D07A1DCB065A,30711,9,11,2,109.50271,18.25347,1510
229071,B421B0364BC07B443944D07A1DCB065A,30711,12,14,2,109.50271,18.25347,1510
229072,B421B0364BC07B443944D07A1DCB065A,60131,14,19,5,109.49819,18.24778,1509
229073,B421B0364BC07B443944D07A1DCB065A,60201,20,21,1,109.5041,18.2509,1510
229076,D6B14C7387647D8C883334DAFB518257,31561,16,17,1,109.56792,18.28479,1765
229077,D6B14C7387647D8C883334DAFB518257,39183,20,22,2,109.55542,18.28208,1715
229105,D517610C2076C41FED0ED80CB6FFB44C,31561,0,6,6,109.56792,18.28479,1765
229106,D517610C2076C41FED0ED80CB6FFB44C,30851,6,10,4,109.5616,18.27396,1713
229107,D517610C2076C41FED0ED80CB6FFB44C,31561,13,14,1,109.56792,18.28479,1765
229108,D517610C2076C41FED0ED80CB6FFB44C,30851,14,22,8,109.5616,18.27396,1713
229162,C85D0B931BEF54F05B9ABBBB03212DB7,30854,8,9,1,109.56889,18.27076,1763
229163,C85D0B931BEF54F05B9ABBBB03212DB7,31561,9,11,2,109.56792,18.28479,1765
229164,C85D0B931BEF54F05B9ABBBB03212DB7,30854,12,14,2,109.56889,18.27076,1763
229165,C85D0B931BEF54F05B9ABBBB03212DB7,31031,16,17,1,109.49979,18.25382,1510
229166,C85D0B931BEF54F05B9ABBBB03212DB7,30854,18,20,2,109.56889,18.27076,1763
229225,8F0EF70AFA814412ECB04C3460518F08,38027,0,1,1,109.38833,18.2909,1066
229226,8F0EF70AFA814412ECB04C3460518F08,39061,2,5,3,109.38222,18.28958,1066
229227,8F0EF70AFA814412ECB04C3460518F08,31145,9,11,2,109.20431,18.30479,369
229228,8F0EF70AFA814412ECB04C3460518F08,31781,11,12,1,109.19847,18.2975,367
229229,8F0EF70AFA814412ECB04C3460518F08,38027,13,18,5,109.38833,18.2909,1066
229230,8F0EF70AFA814412ECB04C3460518F08,31671,18,19,1,109.38965,18.29813,1068
229231,8F0EF70AFA814412ECB04C3460518F08,38027,20,21,1,109.38833,18.2909,1066
229232,88ED3F2D6DF6080D65EC7DC0BC60DC48,31071,0,14,14,109.58257,18.28458,1815
229233,88ED3F2D6DF6080D65EC7DC0BC60DC48,31061,19,20,1,109.53333,18.23257,1607
229234,88ED3F2D6DF6080D65EC7DC0BC60DC48,30854,21,22,1,109.56889,18.27076,1763
229239,EE34D692D2A50A103F8F57F242651A73,30711,13,14,1,109.50271,18.25347,1510
229240,EE34D692D2A50A103F8F57F242651A73,38271,16,21,5,109.62632,18.23049,1956
229282,E58F7930139B2ED51DE79005F05C056D,39183,0,16,16,109.55542,18.28208,1715
229283,E58F7930139B2ED51DE79005F05C056D,39181,19,21,2,109.55153,18.28035,1715
229288,EBF906C5498076BCFA3E97DF6001B4F3,60631,0,7,7,109.57778,18.27583,1814
229289,EBF906C5498076BCFA3E97DF6001B4F3,30854,8,9,1,109.56889,18.27076,1763
229319,2A6BA0678DDF16AF08BAC9E3FA3C9391,31561,4,8,4,109.56792,18.28479,1765
229320,2A6BA0678DDF16AF08BAC9E3FA3C9391,30854,8,23,15,109.56889,18.27076,1763
229328,928DF0385E8541CFD2F5858501C04155,60354,0,4,4,109.58701,18.28521,1815
229329,928DF0385E8541CFD2F5858501C04155,30854,7,11,4,109.56889,18.27076,1763
229351,EA4D123112CD0AE32B6D1280D2074CF8,30921,0,7,7,109.53903,18.29451,1667
229352,EA4D123112CD0AE32B6D1280D2074CF8,31931,7,10,3,109.54771,18.29403,1667
229353,EA4D123112CD0AE32B6D1280D2074CF8,30171,14,20,6,109.48458,18.27139,1463
229356,18EE47452FD5BE7C01D5DBC710576D9F,30121,19,20,1,109.52861,18.27222,1613
229357,18EE47452FD5BE7C01D5DBC710576D9F,39131,22,23,1,109.2066,18.29639,417
229363,75817DB682187A07461734D66E1E6492,30854,2,13,11,109.56889,18.27076,1763
229364,75817DB682187A07461734D66E1E6492,31071,15,17,2,109.58257,18.28458,1815
229365,75817DB682187A07461734D66E1E6492,31061,19,20,1,109.53333,18.23257,1607
229366,75817DB682187A07461734D66E1E6492,60631,22,23,1,109.57778,18.27583,1814
229391,E16204D131FCD957D5ADB9592C1DD0ED,31071,0,14,14,109.58257,18.28458,1815
229392,E16204D131FCD957D5ADB9592C1DD0ED,30854,14,15,1,109.56889,18.27076,1763
229400,005F3AEFE6DBF371ED1FD57736434098,31071,0,7,7,109.58257,18.28458,1815
229401,005F3AEFE6DBF371ED1FD57736434098,30854,9,17,8,109.56889,18.27076,1763
229402,005F3AEFE6DBF371ED1FD57736434098,31071,18,19,1,109.58257,18.28458,1815
229430,A5AB87B7C2F022350AE3B375F8C35F85,60491,0,6,6,109.43354,18.30847,1269
229431,A5AB87B7C2F022350AE3B375F8C35F85,31145,10,11,1,109.20431,18.30479,369
229446,F57902A58026464B5BDED6D5CB0C8C35,30201,0,3,3,109.4909,18.26465,1462
229447,F57902A58026464B5BDED6D5CB0C8C35,30081,4,12,8,109.50243,18.26632,1512
229448,ECCCA5770AD6AA7162B63EC395B55856,60631,0,7,7,109.57778,18.27583,1814
229449,ECCCA5770AD6AA7162B63EC395B55856,39371,11,13,2,109.56627,18.2646,1762
229450,ECCCA5770AD6AA7162B63EC395B55856,30951,15,16,1,109.56208,18.25667,1761
229451,ECCCA5770AD6AA7162B63EC395B55856,60631,18,23,5,109.57778,18.27583,1814
229498,4DA47CA7E0DF1887A4FCFA8DEF75F8FC,31761,0,3,3,109.60521,18.27965,1914
229499,4DA47CA7E0DF1887A4FCFA8DEF75F8FC,31421,8,11,3,109.55382,18.22347,1705
229500,4DA47CA7E0DF1887A4FCFA8DEF75F8FC,30851,11,13,2,109.5616,18.27396,1713
229508,ABCD0851CC1C78BCD7AF6DBDF2F5DE49,60551,0,4,4,109.42722,18.30111,1218
229509,ABCD0851CC1C78BCD7AF6DBDF2F5DE49,60552,5,23,18,109.41729,18.30014,1218
229510,5E97A4561E11AAC4FBC53FD068EAA52B,30854,0,7,7,109.56889,18.27076,1763
229511,5E97A4561E11AAC4FBC53FD068EAA52B,30531,11,18,7,109.53271,18.21472,1604
229531,17A4545370685D172A08774EFEF86DD3,30851,0,1,1,109.5616,18.27396,1713
229532,17A4545370685D172A08774EFEF86DD3,31071,3,6,3,109.58257,18.28458,1815
229533,17A4545370685D172A08774EFEF86DD3,39181,6,15,9,109.55153,18.28035,1715
229534,E9B9BA7767032FDC0F26CEC5BEDEFC07,38157,0,6,6,109.51483,18.26958,1563
229535,E9B9BA7767032FDC0F26CEC5BEDEFC07,30854,8,10,2,109.56889,18.27076,1763
229536,E9B9BA7767032FDC0F26CEC5BEDEFC07,30181,12,16,4,109.51597,18.23313,1557
229548,15BEF05F9BAA02E1947325DA4F75A74C,38141,0,1,1,109.39479,18.2916,1116
229549,15BEF05F9BAA02E1947325DA4F75A74C,38027,3,4,1,109.38833,18.2909,1066
229550,15BEF05F9BAA02E1947325DA4F75A74C,38141,4,6,2,109.39479,18.2916,1116
229551,15BEF05F9BAA02E1947325DA4F75A74C,38141,7,8,1,109.39479,18.2916,1116
229552,15BEF05F9BAA02E1947325DA4F75A74C,31781,10,12,2,109.19847,18.2975,367
229553,15BEF05F9BAA02E1947325DA4F75A74C,31471,14,15,1,109.34583,18.29563,917
229577,D9E71D1287A0AD1E1349273E1141510C,60552,0,6,6,109.41729,18.30014,1218
229578,D9E71D1287A0AD1E1349273E1141510C,60524,7,8,1,109.42951,18.28993,1216
229579,D9E71D1287A0AD1E1349273E1141510C,60552,9,11,2,109.41729,18.30014,1218
229580,D9E71D1287A0AD1E1349273E1141510C,30361,15,18,3,109.50347,18.24,1508
229581,D9E71D1287A0AD1E1349273E1141510C,60552,19,21,2,109.41729,18.30014,1218
229620,5A8AFFF7EC3EBF07BA91D30C77FA1962,31471,13,14,1,109.34583,18.29563,917
229621,5A8AFFF7EC3EBF07BA91D30C77FA1962,38094,18,19,1,109.45403,18.28778,1316
229622,5A8AFFF7EC3EBF07BA91D30C77FA1962,31271,21,23,2,109.48958,18.26257,1462
229698,91EC74D2B208A10BECBB101C6735C578,30151,12,13,1,109.50986,18.25083,1560
229699,91EC74D2B208A10BECBB101C6735C578,30151,14,16,2,109.50986,18.25083,1560
229700,91EC74D2B208A10BECBB101C6735C578,31864,18,23,5,109.49014,18.28333,1465
229716,4995463B780282C9C030A19D9F49AEAC,31071,0,6,6,109.58257,18.28458,1815
229717,4995463B780282C9C030A19D9F49AEAC,30854,7,14,7,109.56889,18.27076,1763
229718,4995463B780282C9C030A19D9F49AEAC,38251,15,16,1,109.49618,18.25493,1510
229719,4995463B780282C9C030A19D9F49AEAC,30854,21,22,1,109.56889,18.27076,1763
229801,8C8DB7A18864109B823771C405E00B29,60351,0,6,6,109.58403,18.28958,1816
229802,8C8DB7A18864109B823771C405E00B29,30951,8,17,9,109.56208,18.25667,1761
229803,8C8DB7A18864109B823771C405E00B29,60351,21,22,1,109.58403,18.28958,1816
229804,B340EDEF4A878E8DF5CBEC25E465EACE,30854,0,4,4,109.56889,18.27076,1763
229805,B340EDEF4A878E8DF5CBEC25E465EACE,31071,5,7,2,109.58257,18.28458,1815
229806,B340EDEF4A878E8DF5CBEC25E465EACE,30854,7,9,2,109.56889,18.27076,1763
229807,B340EDEF4A878E8DF5CBEC25E465EACE,60631,9,10,1,109.57778,18.27583,1814
229808,B340EDEF4A878E8DF5CBEC25E465EACE,30854,13,15,2,109.56889,18.27076,1763
229809,B340EDEF4A878E8DF5CBEC25E465EACE,60631,15,17,2,109.57778,18.27583,1814
229810,B340EDEF4A878E8DF5CBEC25E465EACE,30191,21,23,2,109.50361,18.22701,1506
229822,F198CAA1F49ACA5D003FD8F8473B3798,31071,0,6,6,109.58257,18.28458,1815
229823,F198CAA1F49ACA5D003FD8F8473B3798,30854,7,23,16,109.56889,18.27076,1763
229846,C860767955774E3494068CF38C009FB6,60391,0,9,9,109.47667,18.28757,1416
229847,C860767955774E3494068CF38C009FB6,31061,10,11,1,109.53333,18.23257,1607
229848,C860767955774E3494068CF38C009FB6,60391,13,15,2,109.47667,18.28757,1416
229849,C860767955774E3494068CF38C009FB6,31061,16,17,1,109.53333,18.23257,1607
229850,C860767955774E3494068CF38C009FB6,31031,19,21,2,109.49979,18.25382,1510
229851,C860767955774E3494068CF38C009FB6,60391,21,23,2,109.47667,18.28757,1416
229871,DAB08D254D49BF150533311BD904D49C,39183,21,22,1,109.55542,18.28208,1715
229872,7334BFE245C0E1675EC3C07645407CF3,31121,0,6,6,109.16292,18.37063,230
229873,7334BFE245C0E1675EC3C07645407CF3,60411,7,11,4,109.32514,18.30854,869
229874,7334BFE245C0E1675EC3C07645407CF3,30661,11,13,2,109.37028,18.24361,1008
229875,7334BFE245C0E1675EC3C07645407CF3,60411,14,18,4,109.32514,18.30854,869
229876,7334BFE245C0E1675EC3C07645407CF3,31121,19,20,1,109.16292,18.37063,230
229891,1D2F8DB1F8B6A2081E1A43DDF558491D,31951,1,9,8,109.52174,18.30299,1568
229892,1D2F8DB1F8B6A2081E1A43DDF558491D,38484,9,11,2,109.53028,18.31528,1620
229893,1D2F8DB1F8B6A2081E1A43DDF558491D,31951,11,23,12,109.52174,18.30299,1568
229894,662D882A6A10D0E6C3566690F0A40636,30854,0,8,8,109.56889,18.27076,1763
229895,662D882A6A10D0E6C3566690F0A40636,31071,9,10,1,109.58257,18.28458,1815
229898,0526FBDD03CECB7E3925506B4441EC17,31441,0,8,8,109.51181,18.24424,1559
229899,0526FBDD03CECB7E3925506B4441EC17,30511,8,19,11,109.51069,18.24208,1558
229949,1C9FB52F3215AC60A67CACDC4AFA4355,60411,0,7,7,109.32514,18.30854,869
229950,1C9FB52F3215AC60A67CACDC4AFA4355,60054,7,9,2,109.3016,18.31229,770
229963,3A3335F59AAFA980A696389C11716C78,60371,19,23,4,109.53063,18.30056,1618
229964,23BB561D2463E4EE34970643BFB775BC,38017,0,7,7,109.49729,18.21424,1504
229965,23BB561D2463E4EE34970643BFB775BC,31851,9,10,1,109.71736,18.29007,2316
229966,23BB561D2463E4EE34970643BFB775BC,38017,12,21,9,109.49729,18.21424,1504
229967,23BB561D2463E4EE34970643BFB775BC,30051,21,23,2,109.48917,18.21215,1453
230008,C711EA8F4B039EAC279F7CFC24309A8A,38157,0,1,1,109.51483,18.26958,1563
230009,C711EA8F4B039EAC279F7CFC24309A8A,31951,4,5,1,109.52174,18.30299,1568
230010,C711EA8F4B039EAC279F7CFC24309A8A,30071,6,8,2,109.52819,18.30472,1619
230011,C711EA8F4B039EAC279F7CFC24309A8A,30071,10,11,1,109.52819,18.30472,1619
230012,C711EA8F4B039EAC279F7CFC24309A8A,38157,14,16,2,109.51483,18.26958,1563
230058,A6CCB3B38301DFF4978B708468E178C6,30281,13,14,1,109.50597,18.27583,1514
230059,A6CCB3B38301DFF4978B708468E178C6,31864,17,18,1,109.49014,18.28333,1465
230060,A6CCB3B38301DFF4978B708468E178C6,38185,19,23,4,109.51333,18.27347,1563
230076,AED8643ACDE55B6379729A30DFF61487,31561,4,11,7,109.56792,18.28479,1765
230077,AED8643ACDE55B6379729A30DFF61487,38157,11,13,2,109.51483,18.26958,1563
230078,AED8643ACDE55B6379729A30DFF61487,30281,15,16,1,109.50597,18.27583,1514
230079,AED8643ACDE55B6379729A30DFF61487,38157,16,23,7,109.51483,18.26958,1563
230099,D3FB1B9D3C241050E5FB29B7C0AA31BE,31611,1,8,7,109.63076,18.34944,2026
230100,D3FB1B9D3C241050E5FB29B7C0AA31BE,30711,9,11,2,109.50271,18.25347,1510
230101,D3FB1B9D3C241050E5FB29B7C0AA31BE,60231,13,18,5,109.49903,18.21972,1504
230102,D3FB1B9D3C241050E5FB29B7C0AA31BE,31611,21,23,2,109.63076,18.34944,2026
230143,FFFC0994E5C15BDB165344716912442C,30854,0,6,6,109.56889,18.27076,1763
230144,FFFC0994E5C15BDB165344716912442C,31551,6,9,3,109.55868,18.24222,1708
230145,FFFC0994E5C15BDB165344716912442C,31554,9,17,8,109.55521,18.2459,1709
230146,FFFC0994E5C15BDB165344716912442C,39371,20,22,2,109.56627,18.2646,1762
230150,9FEA4B85EAE4FAEE1CAF0EABFF2FAEA1,31561,0,5,5,109.56792,18.28479,1765
230151,9FEA4B85EAE4FAEE1CAF0EABFF2FAEA1,39183,8,9,1,109.55542,18.28208,1715
230152,9FEA4B85EAE4FAEE1CAF0EABFF2FAEA1,31561,12,13,1,109.56792,18.28479,1765
230244,5C8931079B2869B17047E4E857E99006,30921,0,14,14,109.53903,18.29451,1667
230245,5C8931079B2869B17047E4E857E99006,60371,17,18,1,109.53063,18.30056,1618
230246,8507BAE8053D976762BBCE04A96D60EE,38903,0,10,10,109.39229,18.29243,1117
230247,8507BAE8053D976762BBCE04A96D60EE,38325,11,14,3,109.39792,18.2909,1116
230248,8507BAE8053D976762BBCE04A96D60EE,38903,14,17,3,109.39229,18.29243,1117
230260,8AD9F37216B2D3FCE05CA77434307672,30741,0,7,7,109.49833,18.28681,1516
230261,8AD9F37216B2D3FCE05CA77434307672,31041,8,15,7,109.50278,18.23701,1507
230283,B81DEDE33B0853E35D97557F334A4861,60361,0,6,6,109.51938,18.29681,1567
230284,B81DEDE33B0853E35D97557F334A4861,31931,7,8,1,109.54771,18.29403,1667
230285,B81DEDE33B0853E35D97557F334A4861,60371,8,10,2,109.53063,18.30056,1618
230286,B81DEDE33B0853E35D97557F334A4861,31931,12,15,3,109.54771,18.29403,1667
230287,B81DEDE33B0853E35D97557F334A4861,60371,15,17,2,109.53063,18.30056,1618
230288,B81DEDE33B0853E35D97557F334A4861,60361,18,23,5,109.51938,18.29681,1567
230289,9FC721E86703223349C05C95FE4BBB6F,60081,0,9,9,109.51097,18.22639,1556
230290,9FC721E86703223349C05C95FE4BBB6F,31521,10,17,7,109.51458,18.22542,1555
230291,9FC721E86703223349C05C95FE4BBB6F,31521,19,20,1,109.51458,18.22542,1555
230292,9FC721E86703223349C05C95FE4BBB6F,60087,21,23,2,109.50688,18.22299,1505
230296,A68637AA89BD62624E677D9E66C32FAD,30161,1,10,9,109.50042,18.24389,1508
230297,A68637AA89BD62624E677D9E66C32FAD,30361,12,17,5,109.50347,18.24,1508
230298,A68637AA89BD62624E677D9E66C32FAD,30161,17,23,6,109.50042,18.24389,1508
230317,E8D51F8B53F290BFD73338AD2AD8C728,31561,4,6,2,109.56792,18.28479,1765
230318,E8D51F8B53F290BFD73338AD2AD8C728,39183,8,9,1,109.55542,18.28208,1715
230319,E8D51F8B53F290BFD73338AD2AD8C728,31561,10,13,3,109.56792,18.28479,1765
230320,E8D51F8B53F290BFD73338AD2AD8C728,30854,14,18,4,109.56889,18.27076,1763
230321,E8D51F8B53F290BFD73338AD2AD8C728,31561,20,22,2,109.56792,18.28479,1765
230330,D77A5C2E97A74D805A87772560CE2BFF,60661,2,8,6,109.548,18.2377,1657
230331,D77A5C2E97A74D805A87772560CE2BFF,31421,8,10,2,109.55382,18.22347,1705
230332,D77A5C2E97A74D805A87772560CE2BFF,60381,10,11,1,109.5241,18.22458,1605
230333,D77A5C2E97A74D805A87772560CE2BFF,60661,13,15,2,109.548,18.2377,1657
230334,D77A5C2E97A74D805A87772560CE2BFF,31551,18,21,3,109.55868,18.24222,1708
230352,FA60FF8C4CEE422324352ED1E74F3300,31521,16,18,2,109.51458,18.22542,1555
230353,FA60FF8C4CEE422324352ED1E74F3300,39321,18,19,1,109.529,18.2167,1604
230354,FA60FF8C4CEE422324352ED1E74F3300,31521,20,23,3,109.51458,18.22542,1555
230374,3389A095460231D31BA622B7185D6321,30351,0,1,1,109.41701,18.29292,1217
230375,3389A095460231D31BA622B7185D6321,31231,1,6,5,109.42597,18.29292,1217
230376,3389A095460231D31BA622B7185D6321,31681,6,18,12,109.40396,18.29979,1168
230377,E93606C251F3F3CCDD3B5586D2DAFE77,30854,14,17,3,109.56889,18.27076,1763
230378,E93606C251F3F3CCDD3B5586D2DAFE77,31041,19,20,1,109.50278,18.23701,1507
230379,E93606C251F3F3CCDD3B5586D2DAFE77,30854,22,23,1,109.56889,18.27076,1763
230426,60ACD2B6657BEEA3D1B558DE71329F84,60084,19,21,2,109.4984,18.2334,1507
230427,60ACD2B6657BEEA3D1B558DE71329F84,30271,22,23,1,109.49132,18.23153,1456
230432,7353E0D0F8DB71C781DB049F9A7D0F1B,30854,21,22,1,109.56889,18.27076,1763
230471,0D3DA8126B134D203BB35373EAFFB116,31071,4,5,1,109.58257,18.28458,1815
230472,0D3DA8126B134D203BB35373EAFFB116,30854,8,10,2,109.56889,18.27076,1763
230473,0D3DA8126B134D203BB35373EAFFB116,31071,12,13,1,109.58257,18.28458,1815
230474,0D3DA8126B134D203BB35373EAFFB116,30854,17,22,5,109.56889,18.27076,1763
230481,D334753E33AD01D79142036B3D85543F,31561,0,13,13,109.56792,18.28479,1765
230482,D334753E33AD01D79142036B3D85543F,39181,14,16,2,109.55153,18.28035,1715
230483,D334753E33AD01D79142036B3D85543F,30854,17,18,1,109.56889,18.27076,1763
230484,D334753E33AD01D79142036B3D85543F,31561,18,23,5,109.56792,18.28479,1765
230485,00145806BBF2F60A963743509F901155,30081,0,7,7,109.50243,18.26632,1512
230486,00145806BBF2F60A963743509F901155,30081,7,12,5,109.50243,18.26632,1512
230487,00145806BBF2F60A963743509F901155,38754,13,14,1,109.74667,18.37382,2430
230626,84DF4A7C208235D171EF56473BCCF210,30851,0,4,4,109.5616,18.27396,1713
230627,84DF4A7C208235D171EF56473BCCF210,31561,4,6,2,109.56792,18.28479,1765
230628,84DF4A7C208235D171EF56473BCCF210,60631,7,18,11,109.57778,18.27583,1814
230643,C0D9A8D1FC57A96EA766A127A0E8EAAC,30854,2,6,4,109.56889,18.27076,1763
230644,C0D9A8D1FC57A96EA766A127A0E8EAAC,31571,7,16,9,109.61563,18.23326,1957
230645,1411F9F89E8C658605CC1C5E821DCFD9,60361,13,14,1,109.51938,18.29681,1567
230646,1411F9F89E8C658605CC1C5E821DCFD9,30854,14,17,3,109.56889,18.27076,1763
230650,015CDEB9169BCE5537ABAE49B6A63F2B,60354,1,6,5,109.58701,18.28521,1815
230651,015CDEB9169BCE5537ABAE49B6A63F2B,30854,10,20,10,109.56889,18.27076,1763
230677,E4D199FCE009427481C9D06B9609AB1E,31931,12,14,2,109.54771,18.29403,1667
230678,E4D199FCE009427481C9D06B9609AB1E,39181,17,18,1,109.55153,18.28035,1715
230679,E4D199FCE009427481C9D06B9609AB1E,31931,19,20,1,109.54771,18.29403,1667
230680,E4D199FCE009427481C9D06B9609AB1E,39181,20,23,3,109.55153,18.28035,1715
230690,7024F3A14F6F554DC6E80063E30315F0,31561,0,5,5,109.56792,18.28479,1765
230691,7024F3A14F6F554DC6E80063E30315F0,39183,9,18,9,109.55542,18.28208,1715
230692,7024F3A14F6F554DC6E80063E30315F0,31561,22,23,1,109.56792,18.28479,1765
230693,17E33F98086F9D71B1BE47BE6FC58756,30681,0,8,8,109.48493,18.26917,1463
230694,17E33F98086F9D71B1BE47BE6FC58756,31145,11,13,2,109.20431,18.30479,369
230695,17E33F98086F9D71B1BE47BE6FC58756,38271,15,17,2,109.62632,18.23049,1956
230696,17E33F98086F9D71B1BE47BE6FC58756,30171,21,23,2,109.48458,18.27139,1463
230699,BE586ACB441383CC10D7CF3923850B73,31931,0,6,6,109.54771,18.29403,1667
230700,BE586ACB441383CC10D7CF3923850B73,39181,9,10,1,109.55153,18.28035,1715
230701,BE586ACB441383CC10D7CF3923850B73,31931,12,14,2,109.54771,18.29403,1667
230704,68D17CEA0DFC47DDDEC25D4A4CC5A3DB,30421,15,16,1,109.50021,18.25861,1511
230705,68D17CEA0DFC47DDDEC25D4A4CC5A3DB,60381,17,19,2,109.5241,18.22458,1605
230714,663CE56232D73D50E42DEC41EA33269F,31931,0,1,1,109.54771,18.29403,1667
230715,663CE56232D73D50E42DEC41EA33269F,30921,2,3,1,109.53903,18.29451,1667
230716,663CE56232D73D50E42DEC41EA33269F,31931,3,17,14,109.54771,18.29403,1667
230717,663CE56232D73D50E42DEC41EA33269F,39191,18,20,2,109.51493,18.23472,1557
230718,D6A345956751BA2ACC5430EDF68A104F,31931,12,17,5,109.54771,18.29403,1667
230719,D6A345956751BA2ACC5430EDF68A104F,39181,18,23,5,109.55153,18.28035,1715
230744,A3EBD017781EF0DCA61FC195095D2D3C,31471,13,14,1,109.34583,18.29563,917
230745,A3EBD017781EF0DCA61FC195095D2D3C,30761,18,23,5,109.45201,18.3,1318
230772,567BF1868FBA42FA9B3B29F2CA13F65D,31931,0,15,15,109.54771,18.29403,1667
230773,567BF1868FBA42FA9B3B29F2CA13F65D,30921,16,17,1,109.53903,18.29451,1667
230774,567BF1868FBA42FA9B3B29F2CA13F65D,31931,19,22,3,109.54771,18.29403,1667
230784,F00821368F615DCDAF214035D8EC4A44,31071,1,2,1,109.58257,18.28458,1815
230785,F00821368F615DCDAF214035D8EC4A44,31945,3,5,2,109.58021,18.29403,1817
230786,F00821368F615DCDAF214035D8EC4A44,30854,7,17,10,109.56889,18.27076,1763
230787,F00821368F615DCDAF214035D8EC4A44,31821,18,20,2,109.51181,18.24924,1559
230788,F00821368F615DCDAF214035D8EC4A44,30854,22,23,1,109.56889,18.27076,1763
230795,FF90B6855593CFEA9A07FE008E94551D,60221,3,5,2,109.52569,18.29188,1616
230796,FF90B6855593CFEA9A07FE008E94551D,60241,5,7,2,109.53319,18.28667,1616
230797,FF90B6855593CFEA9A07FE008E94551D,31931,8,17,9,109.54771,18.29403,1667
230798,FF90B6855593CFEA9A07FE008E94551D,60241,20,23,3,109.53319,18.28667,1616
230815,934029FB5F97BCE114EDCE88F0393A63,30854,12,15,3,109.56889,18.27076,1763
230816,934029FB5F97BCE114EDCE88F0393A63,39371,19,20,1,109.56627,18.2646,1762
230845,D947D8D9432E18EA6A214259B6E2987E,60411,1,2,1,109.32514,18.30854,869
230846,D947D8D9432E18EA6A214259B6E2987E,30661,3,4,1,109.37028,18.24361,1008
230847,D947D8D9432E18EA6A214259B6E2987E,60411,4,15,11,109.32514,18.30854,869
230848,D947D8D9432E18EA6A214259B6E2987E,30661,16,19,3,109.37028,18.24361,1008
230849,D947D8D9432E18EA6A214259B6E2987E,60411,20,23,3,109.32514,18.30854,869
230850,335A7B1DE8538918FDA774EE3E402A76,30191,0,7,7,109.50361,18.22701,1506
230851,335A7B1DE8538918FDA774EE3E402A76,31521,7,9,2,109.51458,18.22542,1555
230853,335A7B1DE8538918FDA774EE3E402A76,30191,17,21,4,109.50361,18.22701,1506
230856,E082FB5BD091C5B334EC1176FF352EE0,30071,6,7,1,109.52819,18.30472,1619
230857,E082FB5BD091C5B334EC1176FF352EE0,31931,11,12,1,109.54771,18.29403,1667
230858,E082FB5BD091C5B334EC1176FF352EE0,30071,13,14,1,109.52819,18.30472,1619
230859,E082FB5BD091C5B334EC1176FF352EE0,39181,15,16,1,109.55153,18.28035,1715
230860,E082FB5BD091C5B334EC1176FF352EE0,30071,21,22,1,109.52819,18.30472,1619
230867,D5B91D126489D960AE97CC8A6C1B036B,31571,0,11,11,109.61563,18.23326,1957
230868,D5B91D126489D960AE97CC8A6C1B036B,38071,16,18,2,109.40722,18.30938,1169
230901,D73D0E1690714CD7F442C709F67E4771,60361,0,7,7,109.51938,18.29681,1567
230902,D73D0E1690714CD7F442C709F67E4771,39371,10,14,4,109.56627,18.2646,1762
230903,D73D0E1690714CD7F442C709F67E4771,60361,18,23,5,109.51938,18.29681,1567
230909,6ED697962F10CC0C2236463F9FC9376B,30821,8,14,6,109.43681,18.33639,1274
230910,6ED697962F10CC0C2236463F9FC9376B,30761,19,21,2,109.45201,18.3,1318
230911,7050D1E0A5553A00BB03B768ACFBCA8F,30211,0,6,6,109.49882,18.23931,1508
230916,B93185B4820D7E0DEE74EBEA00941D15,38291,0,1,1,109.51618,18.24313,1558
230917,B93185B4820D7E0DEE74EBEA00941D15,30911,3,18,15,109.50493,18.26181,1511
230918,B93185B4820D7E0DEE74EBEA00941D15,60201,19,20,1,109.5041,18.2509,1510
230919,B93185B4820D7E0DEE74EBEA00941D15,38291,21,22,1,109.51618,18.24313,1558
230943,54A6757CA4BF8A47C41CF1DDCA6EA505,30854,0,6,6,109.56889,18.27076,1763
230944,54A6757CA4BF8A47C41CF1DDCA6EA505,30434,7,9,2,109.17083,18.35861,278
230945,54A6757CA4BF8A47C41CF1DDCA6EA505,30854,13,14,1,109.56889,18.27076,1763
230956,4B0C0C6341A3C2E5744F0897553B14A8,31345,14,17,3,109.39,18.29,1066
230957,4B0C0C6341A3C2E5744F0897553B14A8,39151,19,22,3,109.49875,18.25097,1510
230965,409F5E8F01172D32BBE91132149C037E,31861,0,1,1,109.49042,18.27549,1464
230966,409F5E8F01172D32BBE91132149C037E,38371,2,7,5,109.50972,18.23924,1558
230967,409F5E8F01172D32BBE91132149C037E,31931,8,17,9,109.54771,18.29403,1667
230980,6EF68F35CE79552C1164E70C67C72C02,30121,0,8,8,109.52861,18.27222,1613
230981,6EF68F35CE79552C1164E70C67C72C02,30854,11,17,6,109.56889,18.27076,1763
230982,6EF68F35CE79552C1164E70C67C72C02,60661,19,21,2,109.548,18.2377,1657
230987,6E2021B014C4D0B652A2E4FE8D2CF038,30854,16,18,2,109.56889,18.27076,1763
230988,6E2021B014C4D0B652A2E4FE8D2CF038,31071,21,22,1,109.58257,18.28458,1815
231009,55CBF233BA3606523955A1093C92D734,31864,0,6,6,109.49014,18.28333,1465
231075,8F5513F47F2EB8223DE46B4728AB5258,38145,0,10,10,109.378,18.2912,1066
231076,8F5513F47F2EB8223DE46B4728AB5258,31471,12,14,2,109.34583,18.29563,917
231077,8F5513F47F2EB8223DE46B4728AB5258,60054,14,15,1,109.3016,18.31229,770
231078,8F5513F47F2EB8223DE46B4728AB5258,38145,17,18,1,109.378,18.2912,1066
231079,8F5513F47F2EB8223DE46B4728AB5258,38145,21,23,2,109.378,18.2912,1066
231092,D2BE39F7C6BE2553FAEEB8E39136B40A,60274,0,10,10,109.514,18.2933,1567
231093,D2BE39F7C6BE2553FAEEB8E39136B40A,30151,12,13,1,109.50986,18.25083,1560
231094,D2BE39F7C6BE2553FAEEB8E39136B40A,30721,15,16,1,109.51597,18.28257,1565
231095,D2BE39F7C6BE2553FAEEB8E39136B40A,60401,20,23,3,109.47444,18.27583,1414
231096,3520FED22A4D572CBFE1B08BD2743E22,30361,1,4,3,109.50347,18.24,1508
231097,3520FED22A4D572CBFE1B08BD2743E22,30361,6,16,10,109.50347,18.24,1508
231098,3520FED22A4D572CBFE1B08BD2743E22,31181,16,19,3,109.50382,18.24813,1509
231099,3520FED22A4D572CBFE1B08BD2743E22,60235,21,22,1,109.49269,18.2253,1455
231102,9C1407835BC54BEBDB541F52E1DA1820,61011,0,10,10,109.60653,18.19076,1900
231104,9C1407835BC54BEBDB541F52E1DA1820,61011,13,16,3,109.60653,18.19076,1900
231214,D9689370CD6256E9753C2B0B13067E2B,30854,0,6,6,109.56889,18.27076,1763
231215,D9689370CD6256E9753C2B0B13067E2B,31071,7,8,1,109.58257,18.28458,1815
231216,D9689370CD6256E9753C2B0B13067E2B,30854,8,22,14,109.56889,18.27076,1763
231229,C82725A09C032EE9BFF2088FCCC60D1D,60354,0,2,2,109.58701,18.28521,1815
231230,C82725A09C032EE9BFF2088FCCC60D1D,31761,3,7,4,109.60521,18.27965,1914
231231,C82725A09C032EE9BFF2088FCCC60D1D,30731,11,13,2,109.50944,18.22306,1555
231232,C82725A09C032EE9BFF2088FCCC60D1D,60631,15,17,2,109.57778,18.27583,1814
231233,C82725A09C032EE9BFF2088FCCC60D1D,30854,20,23,3,109.56889,18.27076,1763
231237,DBB710D279E76C79F1E4B0766F579F8A,31071,0,6,6,109.58257,18.28458,1815
231238,DBB710D279E76C79F1E4B0766F579F8A,30854,7,9,2,109.56889,18.27076,1763
231239,DBB710D279E76C79F1E4B0766F579F8A,60631,9,10,1,109.57778,18.27583,1814
231240,DBB710D279E76C79F1E4B0766F579F8A,31071,12,13,1,109.58257,18.28458,1815
231241,DBB710D279E76C79F1E4B0766F579F8A,30854,18,19,1,109.56889,18.27076,1763
231252,38AA3DA5E97F70E8689E8DE10EE9EB59,30854,3,14,11,109.56889,18.27076,1763
231253,38AA3DA5E97F70E8689E8DE10EE9EB59,31945,14,16,2,109.58021,18.29403,1817
231254,38AA3DA5E97F70E8689E8DE10EE9EB59,30854,17,23,6,109.56889,18.27076,1763
231271,CCCD2290FB632A48009771412BE68ADD,31561,2,8,6,109.56792,18.28479,1765
231272,CCCD2290FB632A48009771412BE68ADD,39183,8,10,2,109.55542,18.28208,1715
231273,CCCD2290FB632A48009771412BE68ADD,31561,12,16,4,109.56792,18.28479,1765
231277,8799356B7181F28146A203E5F86C52F0,60661,0,8,8,109.548,18.2377,1657
231278,8799356B7181F28146A203E5F86C52F0,30051,13,14,1,109.48917,18.21215,1453
231279,8799356B7181F28146A203E5F86C52F0,60231,17,22,5,109.49903,18.21972,1504
231294,EEA35E4D5CC4D9232BFB0C99E2CB356B,30854,6,7,1,109.56889,18.27076,1763
231295,EEA35E4D5CC4D9232BFB0C99E2CB356B,30711,8,11,3,109.50271,18.25347,1510
231296,EEA35E4D5CC4D9232BFB0C99E2CB356B,30854,13,16,3,109.56889,18.27076,1763
231300,DC29C676832347947F366933ECB88090,39183,15,16,1,109.55542,18.28208,1715
231301,DC29C676832347947F366933ECB88090,31561,18,23,5,109.56792,18.28479,1765
231320,86C993124F0A6688CA06DBAE1F6DEC77,31951,1,15,14,109.52174,18.30299,1568
231325,6DA732BBEB142DF897DCE85AB09B72FB,31571,1,5,4,109.61563,18.23326,1957
231326,6DA732BBEB142DF897DCE85AB09B72FB,38052,6,10,4,109.62618,18.23042,1956
231327,6DA732BBEB142DF897DCE85AB09B72FB,60594,14,17,3,109.62694,18.22799,1956
231328,6DA732BBEB142DF897DCE85AB09B72FB,38052,20,22,2,109.62618,18.23042,1956
231331,000584B3023702F3E9DDF521B1C35B1A,60354,1,6,5,109.58701,18.28521,1815
231332,000584B3023702F3E9DDF521B1C35B1A,31071,9,10,1,109.58257,18.28458,1815
231362,4E2E832AE9D054F6D1F41FA6FCE0E148,39183,0,6,6,109.55542,18.28208,1715
231363,4E2E832AE9D054F6D1F41FA6FCE0E148,31561,7,12,5,109.56792,18.28479,1765
231364,4E2E832AE9D054F6D1F41FA6FCE0E148,39183,16,17,1,109.55542,18.28208,1715
231379,E34FF61340C5B86CF9FD0AD454D26266,30251,0,11,11,109.50611,18.26653,1512
231380,E34FF61340C5B86CF9FD0AD454D26266,31521,14,18,4,109.51458,18.22542,1555
231381,E34FF61340C5B86CF9FD0AD454D26266,60331,19,23,4,109.505,18.26507,1512
231397,DF1914B7230B32BA806E8A8749CAD846,60491,0,14,14,109.43354,18.30847,1269
231398,DF1914B7230B32BA806E8A8749CAD846,60261,18,20,2,109.44326,18.3075,1319
231406,1A64C98E678C33D33EBB9AF4943063A2,30854,0,14,14,109.56889,18.27076,1763
231407,1A64C98E678C33D33EBB9AF4943063A2,31071,17,21,4,109.58257,18.28458,1815
231410,94F0184D0BA3E27BCB47A57DA614F9FC,60411,0,4,4,109.32514,18.30854,869
231411,94F0184D0BA3E27BCB47A57DA614F9FC,30661,4,9,5,109.37028,18.24361,1008
231412,94F0184D0BA3E27BCB47A57DA614F9FC,60411,10,11,1,109.32514,18.30854,869
231413,94F0184D0BA3E27BCB47A57DA614F9FC,30661,11,14,3,109.37028,18.24361,1008
231414,94F0184D0BA3E27BCB47A57DA614F9FC,60411,17,19,2,109.32514,18.30854,869
231415,94F0184D0BA3E27BCB47A57DA614F9FC,30661,19,23,4,109.37028,18.24361,1008
231416,EF24901D99384F703B20FE07F2784FA0,30101,2,10,8,109.57299,18.33333,1773
231417,EF24901D99384F703B20FE07F2784FA0,31631,11,16,5,109.59542,18.36826,1879
231418,EF24901D99384F703B20FE07F2784FA0,30101,18,23,5,109.57299,18.33333,1773
231421,79BABDF74F5861A434085432A23D4B92,31071,2,11,9,109.58257,18.28458,1815
231422,79BABDF74F5861A434085432A23D4B92,30854,14,19,5,109.56889,18.27076,1763
231432,5CC4EB91087C17C4BD77E4324091759F,60524,0,6,6,109.42951,18.28993,1216
231437,E5E2DA460104E389257158E8D8C9FBDA,60281,0,5,5,109.51743,18.25924,1561
231438,E5E2DA460104E389257158E8D8C9FBDA,60311,6,7,1,109.52097,18.24319,1558
231439,E5E2DA460104E389257158E8D8C9FBDA,38291,9,14,5,109.51618,18.24313,1558
231440,E5E2DA460104E389257158E8D8C9FBDA,60311,14,17,3,109.52097,18.24319,1558
231441,E5E2DA460104E389257158E8D8C9FBDA,60281,18,23,5,109.51743,18.25924,1561
231466,020753EF78F0A0C39658113A3377EA1E,30071,16,18,2,109.52819,18.30472,1619
231467,020753EF78F0A0C39658113A3377EA1E,31561,19,21,2,109.56792,18.28479,1765
231468,208924560927AE5872A8D9BB3F5EF3B6,30764,0,1,1,109.45806,18.29486,1367
231469,208924560927AE5872A8D9BB3F5EF3B6,38171,1,5,4,109.50799,18.28139,1515
231498,B7CCC709A3C9F7475C199BE4055253B6,38721,12,18,6,109.50368,18.27542,1514
231499,B7CCC709A3C9F7475C199BE4055253B6,31951,20,21,1,109.52174,18.30299,1568
231500,3971E288F0FB50DDE06A11C534E966DA,31071,13,17,4,109.58257,18.28458,1815
231501,3971E288F0FB50DDE06A11C534E966DA,30854,20,21,1,109.56889,18.27076,1763
231509,7FD31F65A9E7574FDAD4A110ACBA289D,31206,15,16,1,109.50819,18.23549,1507
231510,7FD31F65A9E7574FDAD4A110ACBA289D,60371,18,19,1,109.53063,18.30056,1618
231511,7FD31F65A9E7574FDAD4A110ACBA289D,31931,21,23,2,109.54771,18.29403,1667
231535,76F6A54588C8DF7DDADFC50CAA11D44C,31571,13,15,2,109.61563,18.23326,1957
231536,76F6A54588C8DF7DDADFC50CAA11D44C,38085,16,17,1,109.6291,18.23625,2007
231599,56F818D0924E7BDB02CCC04065747626,31421,0,19,19,109.55382,18.22347,1705
231600,56F818D0924E7BDB02CCC04065747626,38205,20,23,3,109.62743,18.23139,1956
231601,012ABD06F231728C214A4BA917E75B1C,31561,0,15,15,109.56792,18.28479,1765
231602,012ABD06F231728C214A4BA917E75B1C,30851,19,20,1,109.5616,18.27396,1713
231603,012ABD06F231728C214A4BA917E75B1C,31561,20,21,1,109.56792,18.28479,1765
231617,A8E9C7BB918ADAD29A3EA7ACDDCD32D7,38951,0,8,8,109.48097,18.28868,1416
231618,A8E9C7BB918ADAD29A3EA7ACDDCD32D7,38951,9,12,3,109.48097,18.28868,1416
231619,A8E9C7BB918ADAD29A3EA7ACDDCD32D7,38951,16,19,3,109.48097,18.28868,1416
231620,A8E9C7BB918ADAD29A3EA7ACDDCD32D7,30741,20,23,3,109.49833,18.28681,1516
231649,8AB002F52B01E966C9A29627703ED688,31391,0,7,7,109.50382,18.24285,1508
231650,8AB002F52B01E966C9A29627703ED688,31471,9,11,2,109.34583,18.29563,917
231651,8AB002F52B01E966C9A29627703ED688,31181,14,16,2,109.50382,18.24813,1509
231656,8468419E5C597B7D73CBDE87F8FF8BC8,30721,0,8,8,109.51597,18.28257,1565
231657,8468419E5C597B7D73CBDE87F8FF8BC8,39053,8,11,3,109.511,18.2771,1564
231658,8468419E5C597B7D73CBDE87F8FF8BC8,38171,12,14,2,109.50799,18.28139,1515
231659,8468419E5C597B7D73CBDE87F8FF8BC8,39053,14,17,3,109.511,18.2771,1564
231660,1980C8D409DE9551539224B3D393CDAA,31951,0,3,3,109.52174,18.30299,1568
231661,1980C8D409DE9551539224B3D393CDAA,30071,6,13,7,109.52819,18.30472,1619
231662,1980C8D409DE9551539224B3D393CDAA,31951,13,14,1,109.52174,18.30299,1568
231663,1980C8D409DE9551539224B3D393CDAA,30071,14,19,5,109.52819,18.30472,1619
231664,1980C8D409DE9551539224B3D393CDAA,30071,20,22,2,109.52819,18.30472,1619
231670,A0CFD24F8D50ABCF6002C5FC96CEAB76,39183,0,6,6,109.55542,18.28208,1715
231671,A0CFD24F8D50ABCF6002C5FC96CEAB76,31931,7,8,1,109.54771,18.29403,1667
231672,A0CFD24F8D50ABCF6002C5FC96CEAB76,39183,11,19,8,109.55542,18.28208,1715
231673,A0CFD24F8D50ABCF6002C5FC96CEAB76,39181,20,23,3,109.55153,18.28035,1715
231703,D9AE11CD16B231308C3F0FB3F53BC3E9,30854,0,8,8,109.56889,18.27076,1763
231704,D9AE11CD16B231308C3F0FB3F53BC3E9,31071,8,13,5,109.58257,18.28458,1815
231705,D9AE11CD16B231308C3F0FB3F53BC3E9,30854,15,17,2,109.56889,18.27076,1763
231706,D9AE11CD16B231308C3F0FB3F53BC3E9,31071,18,19,1,109.58257,18.28458,1815
231707,D9AE11CD16B231308C3F0FB3F53BC3E9,30854,22,23,1,109.56889,18.27076,1763
231712,7CE7C06285D7493A1117F256B3BBCC56,30151,0,14,14,109.50986,18.25083,1560
231713,7CE7C06285D7493A1117F256B3BBCC56,30371,18,23,5,109.51,18.24771,1559
231744,ED7913F0E84A3913E9686380D06A1441,60084,3,15,12,109.4984,18.2334,1507
231745,ED7913F0E84A3913E9686380D06A1441,60381,18,20,2,109.5241,18.22458,1605
231746,ED7913F0E84A3913E9686380D06A1441,60291,21,22,1,109.50826,18.24639,1509
231769,8B9A9BFD1ACAD480EB101A91DBF2024D,38291,1,14,13,109.51618,18.24313,1558
231770,8B9A9BFD1ACAD480EB101A91DBF2024D,30371,15,16,1,109.51,18.24771,1559
231771,8B9A9BFD1ACAD480EB101A91DBF2024D,30421,20,23,3,109.50021,18.25861,1511
231787,AD5AB89DB5C961852FD7AC69F7F5D882,30854,15,16,1,109.56889,18.27076,1763
231828,8752BC71725B50257436D50C6598F252,31071,0,7,7,109.58257,18.28458,1815
231829,8752BC71725B50257436D50C6598F252,30854,7,20,13,109.56889,18.27076,1763
231830,8752BC71725B50257436D50C6598F252,31071,21,22,1,109.58257,18.28458,1815
231926,4400F433FA6469B70604006808D90C30,60381,0,1,1,109.5241,18.22458,1605
231927,4400F433FA6469B70604006808D90C30,31421,2,22,20,109.55382,18.22347,1705
231952,F1FA54BCDE7297F39D6C0507CA898D49,38361,0,6,6,109.43667,18.29201,1267
231953,F1FA54BCDE7297F39D6C0507CA898D49,60551,8,9,1,109.42722,18.30111,1218
231954,F1FA54BCDE7297F39D6C0507CA898D49,60524,9,11,2,109.42951,18.28993,1216
231955,F1FA54BCDE7297F39D6C0507CA898D49,60552,11,12,1,109.41729,18.30014,1218
231956,F1FA54BCDE7297F39D6C0507CA898D49,38361,12,23,11,109.43667,18.29201,1267
231972,D4AA3869830031578B573FD0033C24A8,30921,3,5,2,109.53903,18.29451,1667
231973,D4AA3869830031578B573FD0033C24A8,31931,7,16,9,109.54771,18.29403,1667
232015,37657A593A7A700C5ECCE5BB0AAAABA7,31931,0,17,17,109.54771,18.29403,1667
232016,37657A593A7A700C5ECCE5BB0AAAABA7,30921,18,19,1,109.53903,18.29451,1667
232017,37657A593A7A700C5ECCE5BB0AAAABA7,30281,19,21,2,109.50597,18.27583,1514
232018,789033FF9671BBE480F6F60FF87489C2,31541,19,20,1,109.1809,18.36722,329
232019,789033FF9671BBE480F6F60FF87489C2,30434,21,22,1,109.17083,18.35861,278
232042,ACAB8C7B92298FFCEC0006246A6D65D6,39183,0,6,6,109.55542,18.28208,1715
232043,ACAB8C7B92298FFCEC0006246A6D65D6,39181,11,14,3,109.55153,18.28035,1715
232044,ACAB8C7B92298FFCEC0006246A6D65D6,39183,14,23,9,109.55542,18.28208,1715
232075,53453D8B736810206EC5A6632D159BE6,31931,0,13,13,109.54771,18.29403,1667
232076,53453D8B736810206EC5A6632D159BE6,60371,14,15,1,109.53063,18.30056,1618
232077,53453D8B736810206EC5A6632D159BE6,31931,17,22,5,109.54771,18.29403,1667
232078,1BAA4EB92824E45EC2E36C90288F6A84,31531,1,7,6,109.49583,18.25972,1461
232079,1BAA4EB92824E45EC2E36C90288F6A84,31031,10,14,4,109.49979,18.25382,1510
232080,1BAA4EB92824E45EC2E36C90288F6A84,31031,18,22,4,109.49979,18.25382,1510
232081,9AA959ED87D1ECC3053DED17290EFCBD,39183,0,1,1,109.55542,18.28208,1715
232082,9AA959ED87D1ECC3053DED17290EFCBD,31561,1,7,6,109.56792,18.28479,1765
232083,9AA959ED87D1ECC3053DED17290EFCBD,30854,8,9,1,109.56889,18.27076,1763
232084,9AA959ED87D1ECC3053DED17290EFCBD,39183,10,11,1,109.55542,18.28208,1715
232085,9AA959ED87D1ECC3053DED17290EFCBD,31561,11,12,1,109.56792,18.28479,1765
232086,9AA959ED87D1ECC3053DED17290EFCBD,39183,13,17,4,109.55542,18.28208,1715
232113,06537811BB9239FB7E750F0ECA1D11A2,30941,0,2,2,109.5559,18.33938,1724
232114,06537811BB9239FB7E750F0ECA1D11A2,30931,2,6,4,109.55653,18.32722,1722
232115,06537811BB9239FB7E750F0ECA1D11A2,30941,6,7,1,109.5559,18.33938,1724
232124,D96E01B8E0F0DE9C160C9FEAFDCFDB6D,31071,1,7,6,109.58257,18.28458,1815
232125,D96E01B8E0F0DE9C160C9FEAFDCFDB6D,30854,7,9,2,109.56889,18.27076,1763
232126,D96E01B8E0F0DE9C160C9FEAFDCFDB6D,31071,12,14,2,109.58257,18.28458,1815
232142,3C1A2536A78CF30193CED5E3EEACBE7E,30854,0,3,3,109.56889,18.27076,1763
232143,3C1A2536A78CF30193CED5E3EEACBE7E,30851,4,23,19,109.5616,18.27396,1713
232184,135A88CD829AF2C6F8DE6655F28EC360,31931,11,16,5,109.54771,18.29403,1667
232185,135A88CD829AF2C6F8DE6655F28EC360,60371,16,18,2,109.53063,18.30056,1618
232230,40285EE8CCE25C38988EC087545664EC,30854,7,17,10,109.56889,18.27076,1763
232231,40285EE8CCE25C38988EC087545664EC,60661,18,21,3,109.548,18.2377,1657
232232,40285EE8CCE25C38988EC087545664EC,60381,22,23,1,109.5241,18.22458,1605
232238,2830CAA81E07F1E0509E8845A87AD419,30161,0,10,10,109.50042,18.24389,1508
232239,2830CAA81E07F1E0509E8845A87AD419,31471,11,13,2,109.34583,18.29563,917
232240,2830CAA81E07F1E0509E8845A87AD419,30901,13,15,2,109.27597,18.3134,670
232241,2830CAA81E07F1E0509E8845A87AD419,30161,17,23,6,109.50042,18.24389,1508
232250,468231DFF07583BA8A222D360B2FDB3A,60501,0,8,8,109.48701,18.29021,1466
232251,468231DFF07583BA8A222D360B2FDB3A,30084,9,10,1,109.50118,18.26972,1513
232252,468231DFF07583BA8A222D360B2FDB3A,30391,14,18,4,109.4975,18.27118,1513
232253,468231DFF07583BA8A222D360B2FDB3A,60501,20,23,3,109.48701,18.29021,1466
232271,566423B784470FF1F6B17BF1D21CA750,38961,0,2,2,109.50847,18.23514,1507
232272,566423B784470FF1F6B17BF1D21CA750,38171,5,10,5,109.50799,18.28139,1515
232273,566423B784470FF1F6B17BF1D21CA750,60211,13,16,3,109.63549,18.26049,2011
232274,566423B784470FF1F6B17BF1D21CA750,31701,19,20,1,109.44132,18.28833,1266
232275,566423B784470FF1F6B17BF1D21CA750,38171,21,23,2,109.50799,18.28139,1515
232295,03E3094FE0344513E64DAE470C33E920,39181,0,10,10,109.55153,18.28035,1715
232296,03E3094FE0344513E64DAE470C33E920,31931,12,14,2,109.54771,18.29403,1667
232297,03E3094FE0344513E64DAE470C33E920,39181,18,23,5,109.55153,18.28035,1715
232322,C8922FAF66F21ECAECB6B717FCD5A53B,60614,6,14,8,109.48799,18.29521,1467
232323,C8922FAF66F21ECAECB6B717FCD5A53B,60391,15,17,2,109.47667,18.28757,1416
232324,C8922FAF66F21ECAECB6B717FCD5A53B,60504,17,18,1,109.47917,18.28903,1416
232325,C8922FAF66F21ECAECB6B717FCD5A53B,60614,20,23,3,109.48799,18.29521,1467
232335,8FA14F3D719E2918EE3FBDE51EA0AD04,60354,0,11,11,109.58701,18.28521,1815
232336,8FA14F3D719E2918EE3FBDE51EA0AD04,30854,11,13,2,109.56889,18.27076,1763
232337,8FA14F3D719E2918EE3FBDE51EA0AD04,31071,16,23,7,109.58257,18.28458,1815
232397,51DF765CB634D9549D20AD1F2C37BA18,30854,1,11,10,109.56889,18.27076,1763
232398,51DF765CB634D9549D20AD1F2C37BA18,31561,14,15,1,109.56792,18.28479,1765
232399,487521C796C9B83A04D2BF725345DF16,31521,14,18,4,109.51458,18.22542,1555
232400,487521C796C9B83A04D2BF725345DF16,31521,19,21,2,109.51458,18.22542,1555
232401,487521C796C9B83A04D2BF725345DF16,60381,21,23,2,109.5241,18.22458,1605
232414,033CEEC20746801745CF4A53CD517C31,60241,0,2,2,109.53319,18.28667,1616
232415,033CEEC20746801745CF4A53CD517C31,31181,2,8,6,109.50382,18.24813,1509
232416,033CEEC20746801745CF4A53CD517C31,60291,10,15,5,109.50826,18.24639,1509
232417,033CEEC20746801745CF4A53CD517C31,31821,18,22,4,109.51181,18.24924,1559
232457,E9E473F09C342630187345312F4A31D8,39181,0,8,8,109.55153,18.28035,1715
232458,E9E473F09C342630187345312F4A31D8,31931,8,10,2,109.54771,18.29403,1667
232459,E9E473F09C342630187345312F4A31D8,39181,13,23,10,109.55153,18.28035,1715
232473,08A066736557478B1013C0CF834491DF,30921,0,7,7,109.53903,18.29451,1667
232474,08A066736557478B1013C0CF834491DF,31931,9,11,2,109.54771,18.29403,1667
232478,3A4D58C03EB6FFBD8D8160CFC0ADA249,30111,0,22,22,109.47583,18.30542,1419
232479,3A4D58C03EB6FFBD8D8160CFC0ADA249,60131,22,23,1,109.49819,18.24778,1509
232490,B1715BAACD2551A031737B51F74CE832,30371,0,9,9,109.51,18.24771,1559
232491,B1715BAACD2551A031737B51F74CE832,30421,9,17,8,109.50021,18.25861,1511
232492,B1715BAACD2551A031737B51F74CE832,30371,20,23,3,109.51,18.24771,1559
232523,E75CF54BA14775FEDD26504F9F6B7365,31945,0,5,5,109.58021,18.29403,1817
232524,E75CF54BA14775FEDD26504F9F6B7365,31561,6,18,12,109.56792,18.28479,1765
232525,E75CF54BA14775FEDD26504F9F6B7365,31945,22,23,1,109.58021,18.29403,1817
232526,00FC332040A284DA251A8D0705989FE9,31071,0,7,7,109.58257,18.28458,1815
232527,00FC332040A284DA251A8D0705989FE9,30854,7,8,1,109.56889,18.27076,1763
232528,00FC332040A284DA251A8D0705989FE9,31071,10,21,11,109.58257,18.28458,1815
232540,D8EBCB05DE029B0DEDBF9FBDF3DA3C2D,30421,17,19,2,109.50021,18.25861,1511
232541,D8EBCB05DE029B0DEDBF9FBDF3DA3C2D,60084,20,22,2,109.4984,18.2334,1507
232550,D04CD9DD8CE80FB000DDFF2A9F0DD83D,30771,0,8,8,109.49938,18.26042,1511
232551,D04CD9DD8CE80FB000DDFF2A9F0DD83D,30771,9,13,4,109.49938,18.26042,1511
232552,D04CD9DD8CE80FB000DDFF2A9F0DD83D,30771,16,18,2,109.49938,18.26042,1511
232553,D04CD9DD8CE80FB000DDFF2A9F0DD83D,30391,18,20,2,109.4975,18.27118,1513
232554,D04CD9DD8CE80FB000DDFF2A9F0DD83D,60131,21,23,2,109.49819,18.24778,1509
232592,2AE38FAF341950B0B91404FFCE5A0F3E,30921,6,18,12,109.53903,18.29451,1667
232593,2AE38FAF341950B0B91404FFCE5A0F3E,39183,20,21,1,109.55542,18.28208,1715
232594,2AE38FAF341950B0B91404FFCE5A0F3E,31931,21,22,1,109.54771,18.29403,1667
232600,39F25FE146A03325C93C111F2A943B6C,31945,0,7,7,109.58021,18.29403,1817
232601,39F25FE146A03325C93C111F2A943B6C,31071,8,21,13,109.58257,18.28458,1815
232602,58418A9EA4A7DC03127CB79C039A5185,60354,0,9,9,109.58701,18.28521,1815
232603,58418A9EA4A7DC03127CB79C039A5185,30854,12,18,6,109.56889,18.27076,1763
232604,58418A9EA4A7DC03127CB79C039A5185,60354,19,23,4,109.58701,18.28521,1815
232658,14AE6C820CE45F96077630992CABD33D,31551,9,10,1,109.55868,18.24222,1708
232659,14AE6C820CE45F96077630992CABD33D,39371,12,16,4,109.56627,18.2646,1762
232660,14AE6C820CE45F96077630992CABD33D,31551,17,18,1,109.55868,18.24222,1708
232663,CFA6DB42B4EA79576A8AEA8F93765E81,30721,0,7,7,109.51597,18.28257,1565
232664,CFA6DB42B4EA79576A8AEA8F93765E81,30084,12,15,3,109.50118,18.26972,1513
232665,DFFF17B7FE30E79B8AABBB5CE171272F,31561,0,11,11,109.56792,18.28479,1765
232666,DFFF17B7FE30E79B8AABBB5CE171272F,39183,12,14,2,109.55542,18.28208,1715
232667,DFFF17B7FE30E79B8AABBB5CE171272F,31561,14,21,7,109.56792,18.28479,1765
232682,B8B175F9D4B3A6BE919C03568EC254A7,30131,0,6,6,109.6959,18.215,2254
232683,B8B175F9D4B3A6BE919C03568EC254A7,30851,7,9,2,109.5616,18.27396,1713
232684,B8B175F9D4B3A6BE919C03568EC254A7,60641,12,14,2,109.53854,18.2359,1657
232685,B8B175F9D4B3A6BE919C03568EC254A7,60201,14,15,1,109.5041,18.2509,1510
232686,B8B175F9D4B3A6BE919C03568EC254A7,31723,18,20,2,109.68563,18.23701,2207
232724,DD386856863F7E131E32C81950505B78,30711,10,15,5,109.50271,18.25347,1510
232725,DD386856863F7E131E32C81950505B78,31031,15,23,8,109.49979,18.25382,1510
232726,8CD15CF6B5FB4821940FF9AFE6D6CB84,30921,0,5,5,109.53903,18.29451,1667
232727,8CD15CF6B5FB4821940FF9AFE6D6CB84,31931,5,15,10,109.54771,18.29403,1667
232728,8CD15CF6B5FB4821940FF9AFE6D6CB84,30071,16,18,2,109.52819,18.30472,1619
232762,10E6DCB22C04D9E1B01193CDA87B3193,31561,14,15,1,109.56792,18.28479,1765
232763,10E6DCB22C04D9E1B01193CDA87B3193,30721,20,21,1,109.51597,18.28257,1565
232764,10E6DCB22C04D9E1B01193CDA87B3193,38154,22,23,1,109.5266,18.28278,1615
232771,DB48AA878B132AB3008870DF5EDEF58A,31701,16,18,2,109.44132,18.28833,1266
232772,DB48AA878B132AB3008870DF5EDEF58A,38162,21,23,2,109.43944,18.28889,1266
232773,5A1FDC762E3A00EF6FB4C515806ADF6A,38911,0,13,13,109.51674,18.24965,1559
232774,5A1FDC762E3A00EF6FB4C515806ADF6A,38291,14,22,8,109.51618,18.24313,1558
232775,5A1FDC762E3A00EF6FB4C515806ADF6A,31261,22,23,1,109.51174,18.2466,1559
232806,8C54F679DD59F109DAF19BDB41D1658A,60121,15,16,1,109.74507,18.37472,2430
232807,8C54F679DD59F109DAF19BDB41D1658A,38271,20,21,1,109.62632,18.23049,1956
232808,8C54F679DD59F109DAF19BDB41D1658A,30441,22,23,1,109.64021,18.25424,2010
232889,61CCBFBC45E266F13FBC5AB00CB5A2E1,31471,13,14,1,109.34583,18.29563,917
232890,61CCBFBC45E266F13FBC5AB00CB5A2E1,39321,16,18,2,109.529,18.2167,1604
232891,61CCBFBC45E266F13FBC5AB00CB5A2E1,60381,18,20,2,109.5241,18.22458,1605
232892,61CCBFBC45E266F13FBC5AB00CB5A2E1,39321,20,23,3,109.529,18.2167,1604
232913,1428E8B6DBD9DB5B29DD45307A677470,30111,0,4,4,109.47583,18.30542,1419
232914,1428E8B6DBD9DB5B29DD45307A677470,31471,7,8,1,109.34583,18.29563,917
232925,353D5D9D3440E88066F84F662B26A25B,31461,14,15,1,109.5091,18.25389,1510
232927,03CEC0FDDD5484124514C6D24A63D4DD,30854,0,1,1,109.56889,18.27076,1763
232928,03CEC0FDDD5484124514C6D24A63D4DD,31561,1,5,4,109.56792,18.28479,1765
232929,03CEC0FDDD5484124514C6D24A63D4DD,39183,7,17,10,109.55542,18.28208,1715
232941,2881766FA99B9AF1E265FF9153E350E0,31671,0,9,9,109.38965,18.29813,1068
232942,2881766FA99B9AF1E265FF9153E350E0,31471,10,12,2,109.34583,18.29563,917
232943,2881766FA99B9AF1E265FF9153E350E0,60411,14,15,1,109.32514,18.30854,869
232949,102A3C1C3179D6FF6A52B59C3B4087A1,39101,0,1,1,109.50132,18.24931,1509
232950,102A3C1C3179D6FF6A52B59C3B4087A1,30161,3,13,10,109.50042,18.24389,1508
232951,102A3C1C3179D6FF6A52B59C3B4087A1,31181,13,18,5,109.50382,18.24813,1509
232952,102A3C1C3179D6FF6A52B59C3B4087A1,30161,19,21,2,109.50042,18.24389,1508
232953,102A3C1C3179D6FF6A52B59C3B4087A1,31181,21,23,2,109.50382,18.24813,1509
233008,B7182D0394EEB5B5974D259CBCE91CB4,60231,14,16,2,109.49903,18.21972,1504
233009,B7182D0394EEB5B5974D259CBCE91CB4,38241,17,20,3,109.54111,18.30542,1669
233067,E218C587552A5DADC05C4E69685FE374,30421,15,16,1,109.50021,18.25861,1511
233068,E218C587552A5DADC05C4E69685FE374,60201,19,20,1,109.5041,18.2509,1510
233069,E218C587552A5DADC05C4E69685FE374,39371,22,23,1,109.56627,18.2646,1762
233074,82FA50C876D91311B7DA8BB626927288,31945,0,4,4,109.58021,18.29403,1817
233075,82FA50C876D91311B7DA8BB626927288,30854,8,10,2,109.56889,18.27076,1763
233076,82FA50C876D91311B7DA8BB626927288,31351,13,16,3,109.4959,18.28417,1465
233117,1D8B814EC83D52D7C5F3FED99C129EE0,30854,2,3,1,109.56889,18.27076,1763
233118,1D8B814EC83D52D7C5F3FED99C129EE0,60631,4,9,5,109.57778,18.27583,1814
233119,1D8B814EC83D52D7C5F3FED99C129EE0,38271,11,19,8,109.62632,18.23049,1956
233148,E49583CA7DCFF2BB28C62ECBE9D165BD,31031,0,8,8,109.49979,18.25382,1510
233149,E49583CA7DCFF2BB28C62ECBE9D165BD,31471,10,12,2,109.34583,18.29563,917
233150,E49583CA7DCFF2BB28C62ECBE9D165BD,31181,15,21,6,109.50382,18.24813,1509
233181,135EE8DF22FD9C3BDEB0E1201CDDDB65,30161,0,8,8,109.50042,18.24389,1508
233182,135EE8DF22FD9C3BDEB0E1201CDDDB65,31471,12,13,1,109.34583,18.29563,917
233183,135EE8DF22FD9C3BDEB0E1201CDDDB65,30661,13,15,2,109.37028,18.24361,1008
233184,135EE8DF22FD9C3BDEB0E1201CDDDB65,30161,17,19,2,109.50042,18.24389,1508
233185,135EE8DF22FD9C3BDEB0E1201CDDDB65,31031,20,21,1,109.49979,18.25382,1510
233186,135EE8DF22FD9C3BDEB0E1201CDDDB65,30161,22,23,1,109.50042,18.24389,1508
233239,6BF671BC76B2463D72102139E4EB1018,60371,0,1,1,109.53063,18.30056,1618
233240,6BF671BC76B2463D72102139E4EB1018,31931,4,5,1,109.54771,18.29403,1667
233241,6BF671BC76B2463D72102139E4EB1018,38241,6,15,9,109.54111,18.30542,1669
233242,6BF671BC76B2463D72102139E4EB1018,60371,16,17,1,109.53063,18.30056,1618
233251,5121CF17D14D2AAD91DBD81D7766DFCC,31521,0,6,6,109.51458,18.22542,1555
233252,5121CF17D14D2AAD91DBD81D7766DFCC,30731,7,10,3,109.50944,18.22306,1555
233253,5121CF17D14D2AAD91DBD81D7766DFCC,31521,10,16,6,109.51458,18.22542,1555
233259,E6F79A5F6F7C034FE4F98780B21D590B,30281,6,9,3,109.50597,18.27583,1514
233260,E6F79A5F6F7C034FE4F98780B21D590B,31161,12,13,1,109.70229,18.31361,2270
233261,E6F79A5F6F7C034FE4F98780B21D590B,30281,14,15,1,109.50597,18.27583,1514
233262,E6F79A5F6F7C034FE4F98780B21D590B,38157,16,18,2,109.51483,18.26958,1563
233278,5C4B759B8D2905A494B81A3EB710A8F3,60631,8,18,10,109.57778,18.27583,1814
233279,5C4B759B8D2905A494B81A3EB710A8F3,38094,20,22,2,109.45403,18.28778,1316
233280,5C4B759B8D2905A494B81A3EB710A8F3,31031,22,23,1,109.49979,18.25382,1510
233281,AB43182259122294244C13D6FC66D4A1,60631,0,6,6,109.57778,18.27583,1814
233282,AB43182259122294244C13D6FC66D4A1,31561,7,12,5,109.56792,18.28479,1765
233283,23019CE071DC0B0CEC6E78ADA422CE57,60281,0,3,3,109.51743,18.25924,1561
233284,23019CE071DC0B0CEC6E78ADA422CE57,38973,3,13,10,109.51097,18.25389,1560
233285,23019CE071DC0B0CEC6E78ADA422CE57,30151,14,16,2,109.50986,18.25083,1560
233286,23019CE071DC0B0CEC6E78ADA422CE57,31381,18,20,2,109.1375,18.36833,129
233287,23019CE071DC0B0CEC6E78ADA422CE57,30711,22,23,1,109.50271,18.25347,1510
233288,C462628FF36F8FF2D0B7493E6DDA38BB,60411,1,9,8,109.32514,18.30854,869
233289,C462628FF36F8FF2D0B7493E6DDA38BB,30661,9,14,5,109.37028,18.24361,1008
233290,C462628FF36F8FF2D0B7493E6DDA38BB,60411,16,19,3,109.32514,18.30854,869
233291,C462628FF36F8FF2D0B7493E6DDA38BB,31471,19,21,2,109.34583,18.29563,917
233319,F8D799D9161B0143E0D71C40472A357E,30071,7,12,5,109.52819,18.30472,1619
233320,F8D799D9161B0143E0D71C40472A357E,60371,14,15,1,109.53063,18.30056,1618
233321,F8D799D9161B0143E0D71C40472A357E,30071,15,22,7,109.52819,18.30472,1619
233322,5EE25A6E7DD554FFDA0C9C1A504114B7,31071,0,8,8,109.58257,18.28458,1815
233323,5EE25A6E7DD554FFDA0C9C1A504114B7,30711,9,11,2,109.50271,18.25347,1510
233324,5EE25A6E7DD554FFDA0C9C1A504114B7,31461,12,13,1,109.5091,18.25389,1510
233325,5EE25A6E7DD554FFDA0C9C1A504114B7,31071,17,23,6,109.58257,18.28458,1815
233349,7BF65E5054DA81A230AB5423620158E1,31071,0,7,7,109.58257,18.28458,1815
233350,7BF65E5054DA81A230AB5423620158E1,30854,7,23,16,109.56889,18.27076,1763
233362,F5EB56BD5801B85A9E4703584DF6DFA6,31071,0,2,2,109.58257,18.28458,1815
233363,F5EB56BD5801B85A9E4703584DF6DFA6,31071,3,10,7,109.58257,18.28458,1815
233364,F5EB56BD5801B85A9E4703584DF6DFA6,31071,12,16,4,109.58257,18.28458,1815
233392,E6651E3C6D8FEA2077D9EFC6D097D06C,38251,0,14,14,109.49618,18.25493,1510
233393,E6651E3C6D8FEA2077D9EFC6D097D06C,31031,17,21,4,109.49979,18.25382,1510
233394,E6651E3C6D8FEA2077D9EFC6D097D06C,38251,22,23,1,109.49618,18.25493,1510
233421,D9E60CECBCF3335BA62A418C133E83E2,31521,17,19,2,109.51458,18.22542,1555
233422,D9E60CECBCF3335BA62A418C133E83E2,30731,19,22,3,109.50944,18.22306,1555
233464,4053323049FA57896819CD5356E38746,30854,2,3,1,109.56889,18.27076,1763
233465,4053323049FA57896819CD5356E38746,31071,4,5,1,109.58257,18.28458,1815
233466,4053323049FA57896819CD5356E38746,30854,6,8,2,109.56889,18.27076,1763
233467,4053323049FA57896819CD5356E38746,30681,9,10,1,109.48493,18.26917,1463
233468,4053323049FA57896819CD5356E38746,30854,12,16,4,109.56889,18.27076,1763
233469,4053323049FA57896819CD5356E38746,31945,20,23,3,109.58021,18.29403,1817
233497,B84B247FA61A8C12DFCCCF3C2D72006D,31071,2,7,5,109.58257,18.28458,1815
233498,B84B247FA61A8C12DFCCCF3C2D72006D,30854,8,9,1,109.56889,18.27076,1763
233499,B84B247FA61A8C12DFCCCF3C2D72006D,31945,13,15,2,109.58021,18.29403,1817
233528,6C0260646767B781577B5B8CE2471E51,38484,9,12,3,109.53028,18.31528,1620
233529,6C0260646767B781577B5B8CE2471E51,30071,14,17,3,109.52819,18.30472,1619
233530,6C0260646767B781577B5B8CE2471E51,38484,18,22,4,109.53028,18.31528,1620
233531,20C15B76A1E0DF79D86EDEAC7BC3D7B7,31071,0,14,14,109.58257,18.28458,1815
233532,20C15B76A1E0DF79D86EDEAC7BC3D7B7,31031,15,16,1,109.49979,18.25382,1510
233533,20C15B76A1E0DF79D86EDEAC7BC3D7B7,30854,18,23,5,109.56889,18.27076,1763
233553,8F6EA1C108FADA76A214A7ED71ECE3D1,30232,1,4,3,109.6191,18.31701,1971
233554,8F6EA1C108FADA76A214A7ED71ECE3D1,30854,8,9,1,109.56889,18.27076,1763
233555,8F6EA1C108FADA76A214A7ED71ECE3D1,60117,13,15,2,109.73604,18.35681,2427
233556,8F6EA1C108FADA76A214A7ED71ECE3D1,30854,20,21,1,109.56889,18.27076,1763
233618,E988DA8DA294A7CCEAA28AECB6C26A8F,31701,13,15,2,109.44132,18.28833,1266
233619,E988DA8DA294A7CCEAA28AECB6C26A8F,30711,18,20,2,109.50271,18.25347,1510
233629,8AABF5FDF2B06EB445749240A3894969,31071,1,12,11,109.58257,18.28458,1815
233630,8AABF5FDF2B06EB445749240A3894969,31851,16,17,1,109.71736,18.29007,2316
233631,8AABF5FDF2B06EB445749240A3894969,31071,21,22,1,109.58257,18.28458,1815
233661,B2035C0684FF9CA861B7EB217CE5A160,60524,2,7,5,109.42951,18.28993,1216
233662,B2035C0684FF9CA861B7EB217CE5A160,31471,8,17,9,109.34583,18.29563,917
233663,B2035C0684FF9CA861B7EB217CE5A160,60552,18,19,1,109.41729,18.30014,1218
233664,B2035C0684FF9CA861B7EB217CE5A160,31031,19,21,2,109.49979,18.25382,1510
233675,FE95B3A32EFBC2838F293DF38F55FDD1,39183,0,4,4,109.55542,18.28208,1715
233676,FE95B3A32EFBC2838F293DF38F55FDD1,30071,7,11,4,109.52819,18.30472,1619
233729,2C4F6A9565FCA7FBA040CF077F5F71B3,31534,0,9,9,109.49368,18.25806,1461
233747,30CE72A519D49881F23B8123486E3A02,31471,18,20,2,109.34583,18.29563,917
233748,30CE72A519D49881F23B8123486E3A02,60411,21,23,2,109.32514,18.30854,869
233754,DBD424CB499D5AB1C47BB7F6EFB84A2C,30271,0,1,1,109.49132,18.23153,1456
233755,DBD424CB499D5AB1C47BB7F6EFB84A2C,60084,3,6,3,109.4984,18.2334,1507
233756,DBD424CB499D5AB1C47BB7F6EFB84A2C,30661,11,12,1,109.37028,18.24361,1008
233757,DBD424CB499D5AB1C47BB7F6EFB84A2C,31301,15,16,1,109.14493,18.31222,170
233758,1FEE70E9EF5E783035F8B1F1E4B483EC,39183,1,8,7,109.55542,18.28208,1715
233759,1FEE70E9EF5E783035F8B1F1E4B483EC,38071,12,13,1,109.40722,18.30938,1169
233798,408C4FED868686E7B96333835F4C4205,31071,2,7,5,109.58257,18.28458,1815
233799,408C4FED868686E7B96333835F4C4205,30854,12,14,2,109.56889,18.27076,1763
233816,F7035E4742EE25797FD00CAEBC81D218,31251,0,19,19,109.18528,18.2975,317
233817,F7035E4742EE25797FD00CAEBC81D218,30441,19,21,2,109.64021,18.25424,2010
233818,798BF3B08F72A16A6DEAAA235F1899BB,61011,0,5,5,109.60653,18.19076,1900
233820,798BF3B08F72A16A6DEAAA235F1899BB,61011,9,20,11,109.60653,18.19076,1900
233822,D001062E96DDE99C5A38D3DD89B4A1A5,30854,0,1,1,109.56889,18.27076,1763
233823,D001062E96DDE99C5A38D3DD89B4A1A5,39371,1,2,1,109.56627,18.2646,1762
233824,D001062E96DDE99C5A38D3DD89B4A1A5,30854,4,7,3,109.56889,18.27076,1763
233832,6C09CE755C8436D31143C1E3AA51623D,39371,0,1,1,109.56627,18.2646,1762
233833,6C09CE755C8436D31143C1E3AA51623D,31071,1,2,1,109.58257,18.28458,1815
233834,6C09CE755C8436D31143C1E3AA51623D,39371,5,6,1,109.56627,18.2646,1762
233835,6C09CE755C8436D31143C1E3AA51623D,30854,11,16,5,109.56889,18.27076,1763
233884,D56A67341D1DA856D04BC2181FD404FB,60552,20,21,1,109.41729,18.30014,1218
233885,D56A67341D1DA856D04BC2181FD404FB,60541,22,23,1,109.4084,18.29208,1167
234010,6751CEC3CF9B2AE78246C7287443D2B4,31071,13,15,2,109.58257,18.28458,1815
234011,6751CEC3CF9B2AE78246C7287443D2B4,30854,16,21,5,109.56889,18.27076,1763
234031,1B6EBBFF3B9D8A3E18753343B6A29EAE,31071,0,6,6,109.58257,18.28458,1815
234032,1B6EBBFF3B9D8A3E18753343B6A29EAE,31561,9,11,2,109.56792,18.28479,1765
234033,1B6EBBFF3B9D8A3E18753343B6A29EAE,31071,11,13,2,109.58257,18.28458,1815
234034,1B6EBBFF3B9D8A3E18753343B6A29EAE,30851,17,18,1,109.5616,18.27396,1713
234035,1B6EBBFF3B9D8A3E18753343B6A29EAE,31071,19,21,2,109.58257,18.28458,1815
234095,59F29435D748531F416A4F1636997ECF,31201,0,2,2,109.51042,18.23819,1558
234096,59F29435D748531F416A4F1636997ECF,31071,4,7,3,109.58257,18.28458,1815
234097,59F29435D748531F416A4F1636997ECF,31781,10,11,1,109.19847,18.2975,367
234098,59F29435D748531F416A4F1636997ECF,31301,11,12,1,109.14493,18.31222,170
234109,68DBE0B52FD0AB95F1DD47068FD7847F,60311,0,5,5,109.52097,18.24319,1558
234110,68DBE0B52FD0AB95F1DD47068FD7847F,30181,8,11,3,109.51597,18.23313,1557
234127,A8ABE4987042D12DD458C81CFD9663F5,38127,0,6,6,109.50833,18.27222,1513
234128,A8ABE4987042D12DD458C81CFD9663F5,60571,8,9,1,109.50722,18.25056,1510
234129,A8ABE4987042D12DD458C81CFD9663F5,30771,10,11,1,109.49938,18.26042,1511
234130,A8ABE4987042D12DD458C81CFD9663F5,60524,12,13,1,109.42951,18.28993,1216
234131,A8ABE4987042D12DD458C81CFD9663F5,30421,17,18,1,109.50021,18.25861,1511
234132,A8ABE4987042D12DD458C81CFD9663F5,38127,20,23,3,109.50833,18.27222,1513
234133,1D73A39CD9D00E7A842906C3097D7487,60571,0,7,7,109.50722,18.25056,1510
234134,1D73A39CD9D00E7A842906C3097D7487,30851,8,10,2,109.5616,18.27396,1713
234135,1D73A39CD9D00E7A842906C3097D7487,31561,13,15,2,109.56792,18.28479,1765
234148,184447FB27346CCB581EA0ECE0E04766,38991,0,6,6,109.52681,18.30368,1618
234149,184447FB27346CCB581EA0ECE0E04766,31931,8,16,8,109.54771,18.29403,1667
234150,184447FB27346CCB581EA0ECE0E04766,30071,19,23,4,109.52819,18.30472,1619
234168,69EA58E2C68065F45F7A1847747C7961,60081,15,18,3,109.51097,18.22639,1556
234169,69EA58E2C68065F45F7A1847747C7961,31205,18,20,2,109.51111,18.23736,1557
234170,69EA58E2C68065F45F7A1847747C7961,60081,22,23,1,109.51097,18.22639,1556
234171,22CF7007721E0F1D863F25E4633BE1AD,38291,13,15,2,109.51618,18.24313,1558
234172,22CF7007721E0F1D863F25E4633BE1AD,60311,19,23,4,109.52097,18.24319,1558
234254,EE64858856622F3C84C475424C7DD813,60221,0,7,7,109.52569,18.29188,1616
234255,EE64858856622F3C84C475424C7DD813,31931,7,10,3,109.54771,18.29403,1667
234256,EE64858856622F3C84C475424C7DD813,60221,12,14,2,109.52569,18.29188,1616
234257,EE64858856622F3C84C475424C7DD813,60371,14,18,4,109.53063,18.30056,1618
234258,EE64858856622F3C84C475424C7DD813,60221,20,23,3,109.52569,18.29188,1616
234288,A9634A2AD8447824C1C9412CBBCC32E0,31181,0,6,6,109.50382,18.24813,1509
234289,A9634A2AD8447824C1C9412CBBCC32E0,31531,9,12,3,109.49583,18.25972,1461
234290,A9634A2AD8447824C1C9412CBBCC32E0,31181,12,15,3,109.50382,18.24813,1509
234291,A9634A2AD8447824C1C9412CBBCC32E0,31531,15,16,1,109.49583,18.25972,1461
234347,2CF83F5125C6075E2ACA9C17C2979C64,31071,1,9,8,109.58257,18.28458,1815
234348,2CF83F5125C6075E2ACA9C17C2979C64,30854,14,15,1,109.56889,18.27076,1763
234349,2CF83F5125C6075E2ACA9C17C2979C64,31071,16,19,3,109.58257,18.28458,1815
234350,2CF83F5125C6075E2ACA9C17C2979C64,30854,20,21,1,109.56889,18.27076,1763
234351,2CF83F5125C6075E2ACA9C17C2979C64,31071,22,23,1,109.58257,18.28458,1815
234352,6456DEC363530A787C41268FA27E3CAD,31471,15,17,2,109.34583,18.29563,917
234353,6456DEC363530A787C41268FA27E3CAD,60221,18,21,3,109.52569,18.29188,1616
234354,6456DEC363530A787C41268FA27E3CAD,60261,21,23,2,109.44326,18.3075,1319
234394,46D10B971C10D2856504DC61068F66E7,31091,13,15,2,109.41201,18.31222,1170
234423,20D67F66127BDA58E8931E7738FE6E65,30441,1,2,1,109.64021,18.25424,2010
234424,20D67F66127BDA58E8931E7738FE6E65,31071,3,7,4,109.58257,18.28458,1815
234425,20D67F66127BDA58E8931E7738FE6E65,30854,8,9,1,109.56889,18.27076,1763
234426,20D67F66127BDA58E8931E7738FE6E65,31071,10,12,2,109.58257,18.28458,1815
234427,20D67F66127BDA58E8931E7738FE6E65,30854,14,16,2,109.56889,18.27076,1763
234449,BA9833B5432B77210DF0C38140389BAD,38117,0,5,5,109.51611,18.22354,1555
234450,BA9833B5432B77210DF0C38140389BAD,30191,6,13,7,109.50361,18.22701,1506
234451,BA9833B5432B77210DF0C38140389BAD,31251,16,17,1,109.18528,18.2975,317
234452,BA9833B5432B77210DF0C38140389BAD,31461,19,21,2,109.5091,18.25389,1510
234453,BA9833B5432B77210DF0C38140389BAD,38117,22,23,1,109.51611,18.22354,1555
234471,5DA31B6468DF5449C1F287501972F73D,31271,0,7,7,109.48958,18.26257,1462
234472,5DA31B6468DF5449C1F287501972F73D,31781,10,12,2,109.19847,18.2975,367
234473,5DA31B6468DF5449C1F287501972F73D,60054,13,15,2,109.3016,18.31229,770
234474,5DA31B6468DF5449C1F287501972F73D,30771,19,20,1,109.49938,18.26042,1511
234475,5DA31B6468DF5449C1F287501972F73D,31271,22,23,1,109.48958,18.26257,1462
234507,2E1B710612E1C9FE838A221C1A8E8C66,38903,0,1,1,109.39229,18.29243,1117
234508,2E1B710612E1C9FE838A221C1A8E8C66,38325,5,7,2,109.39792,18.2909,1116
234516,ADF0A7CED2B8DFD757D8FCA8B507C37E,38283,11,12,1,109.62229,18.22618,1956
234517,ADF0A7CED2B8DFD757D8FCA8B507C37E,31561,17,19,2,109.56792,18.28479,1765
234518,080247CC19405F981D4BEFE1A1E9D339,31931,18,19,1,109.54771,18.29403,1667
234519,080247CC19405F981D4BEFE1A1E9D339,39181,21,22,1,109.55153,18.28035,1715
234520,080247CC19405F981D4BEFE1A1E9D339,31931,22,23,1,109.54771,18.29403,1667
234527,372A5433078073EAD18922D679CE0A73,60054,0,3,3,109.3016,18.31229,770
234528,372A5433078073EAD18922D679CE0A73,60411,4,10,6,109.32514,18.30854,869
234529,372A5433078073EAD18922D679CE0A73,60054,12,13,1,109.3016,18.31229,770
234530,372A5433078073EAD18922D679CE0A73,60411,14,18,4,109.32514,18.30854,869
234531,372A5433078073EAD18922D679CE0A73,30661,19,21,2,109.37028,18.24361,1008
234532,372A5433078073EAD18922D679CE0A73,60054,21,23,2,109.3016,18.31229,770
234533,F9F80EDABF5B8107FB24FA24BEE7566E,60161,0,2,2,109.49174,18.26181,1461
234534,F9F80EDABF5B8107FB24FA24BEE7566E,60201,4,5,1,109.5041,18.2509,1510
234535,F9F80EDABF5B8107FB24FA24BEE7566E,30211,8,10,2,109.49882,18.23931,1508
234536,F9F80EDABF5B8107FB24FA24BEE7566E,38754,12,15,3,109.74667,18.37382,2430
234599,B023927CBEC0A8053CBDF64A5B76E367,30051,0,6,6,109.48917,18.21215,1453
234600,B023927CBEC0A8053CBDF64A5B76E367,31931,9,12,3,109.54771,18.29403,1667
234601,B023927CBEC0A8053CBDF64A5B76E367,30921,12,13,1,109.53903,18.29451,1667
234602,B023927CBEC0A8053CBDF64A5B76E367,31931,13,15,2,109.54771,18.29403,1667
234603,B023927CBEC0A8053CBDF64A5B76E367,30051,18,19,1,109.48917,18.21215,1453
234604,B023927CBEC0A8053CBDF64A5B76E367,60231,22,23,1,109.49903,18.21972,1504
234662,BA987FAAC62A550769ECB5E13AC256A5,30191,0,1,1,109.50361,18.22701,1506
234663,BA987FAAC62A550769ECB5E13AC256A5,38261,2,8,6,109.50361,18.28153,1515
234679,A3B0EE5751B9E452997C5AA979B90C91,38951,0,8,8,109.48097,18.28868,1416
234680,A3B0EE5751B9E452997C5AA979B90C91,39131,9,10,1,109.2066,18.29639,417
234681,A3B0EE5751B9E452997C5AA979B90C91,31471,13,14,1,109.34583,18.29563,917
234682,A3B0EE5751B9E452997C5AA979B90C91,30821,17,18,1,109.43681,18.33639,1274
234683,A3B0EE5751B9E452997C5AA979B90C91,38951,20,23,3,109.48097,18.28868,1416
234719,D4EE8E1A4C04A1FF0596E4221D0B8B42,31071,0,7,7,109.58257,18.28458,1815
234720,D4EE8E1A4C04A1FF0596E4221D0B8B42,30854,8,21,13,109.56889,18.27076,1763
234772,4A260D34614CE6238F06D54A86B043DE,30854,0,16,16,109.56889,18.27076,1763
234773,4A260D34614CE6238F06D54A86B043DE,60631,16,17,1,109.57778,18.27583,1814
234774,4A260D34614CE6238F06D54A86B043DE,30854,19,20,1,109.56889,18.27076,1763
234806,1A6EAA2168CC835EA94CCB88CD588780,60551,0,5,5,109.42722,18.30111,1218
234807,1A6EAA2168CC835EA94CCB88CD588780,60552,6,8,2,109.41729,18.30014,1218
234808,1A6EAA2168CC835EA94CCB88CD588780,60551,10,11,1,109.42722,18.30111,1218
234809,1A6EAA2168CC835EA94CCB88CD588780,60524,11,12,1,109.42951,18.28993,1216
234810,1A6EAA2168CC835EA94CCB88CD588780,60551,15,23,8,109.42722,18.30111,1218
234820,D2D609608AA1D4DD8E18DD3745793D0D,31071,1,8,7,109.58257,18.28458,1815
234821,D2D609608AA1D4DD8E18DD3745793D0D,30421,11,12,1,109.50021,18.25861,1511
234822,D2D609608AA1D4DD8E18DD3745793D0D,31071,16,17,1,109.58257,18.28458,1815
234823,D2D609608AA1D4DD8E18DD3745793D0D,30854,17,20,3,109.56889,18.27076,1763
234833,7A214C2AB4CE0E87DF8DB230B9F95561,30101,0,6,6,109.57299,18.33333,1773
234834,7A214C2AB4CE0E87DF8DB230B9F95561,31631,6,8,2,109.59542,18.36826,1879
234835,7A214C2AB4CE0E87DF8DB230B9F95561,30101,10,23,13,109.57299,18.33333,1773
234838,9B389AE8E9B004176803CCEAFF69104A,60631,1,3,2,109.57778,18.27583,1814
234839,9B389AE8E9B004176803CCEAFF69104A,30951,6,17,11,109.56208,18.25667,1761
234840,9B389AE8E9B004176803CCEAFF69104A,60631,17,19,2,109.57778,18.27583,1814
234851,6733B324E753B6172A50174A4CB1E5C2,31251,0,15,15,109.18528,18.2975,317
234866,E07DFD25EAC694A41002C6648E3A4E3C,38911,19,20,1,109.51674,18.24965,1559
234867,E07DFD25EAC694A41002C6648E3A4E3C,30084,21,22,1,109.50118,18.26972,1513
234908,80779C982E47128931C5479B9B9DAF80,30421,0,10,10,109.50021,18.25861,1511
234909,80779C982E47128931C5479B9B9DAF80,30854,11,12,1,109.56889,18.27076,1763
234910,80779C982E47128931C5479B9B9DAF80,31071,15,17,2,109.58257,18.28458,1815
234911,80779C982E47128931C5479B9B9DAF80,30771,21,23,2,109.49938,18.26042,1511
234935,86431DA9F6D3A0F087AFBE2023050B39,30071,12,14,2,109.52819,18.30472,1619
234936,86431DA9F6D3A0F087AFBE2023050B39,31071,16,18,2,109.58257,18.28458,1815
234937,86431DA9F6D3A0F087AFBE2023050B39,31951,19,21,2,109.52174,18.30299,1568
234950,B80D6AB96D3D5CEE71A70ED25275F830,38951,0,9,9,109.48097,18.28868,1416
234951,B80D6AB96D3D5CEE71A70ED25275F830,31531,13,16,3,109.49583,18.25972,1461
234952,B80D6AB96D3D5CEE71A70ED25275F830,38951,20,21,1,109.48097,18.28868,1416
234964,0442B38E8824E569B00E80CCEFC70940,30854,3,4,1,109.56889,18.27076,1763
234965,0442B38E8824E569B00E80CCEFC70940,39183,9,16,7,109.55542,18.28208,1715
234966,0442B38E8824E569B00E80CCEFC70940,30854,18,19,1,109.56889,18.27076,1763
234967,0442B38E8824E569B00E80CCEFC70940,31561,20,22,2,109.56792,18.28479,1765
234992,106CA3A9375076B84A466DFC7E9F4CF9,30081,0,6,6,109.50243,18.26632,1512
234993,106CA3A9375076B84A466DFC7E9F4CF9,60591,7,17,10,109.61118,18.21715,1904
234994,106CA3A9375076B84A466DFC7E9F4CF9,30081,20,23,3,109.50243,18.26632,1512
235015,2C222853895C7F3CD32A59ECC6E42FBB,38151,18,19,1,109.51361,18.26542,1562
235016,2C222853895C7F3CD32A59ECC6E42FBB,30681,20,23,3,109.48493,18.26917,1463
235035,490A5F2D9652290BBCEA32DFC103B993,31181,18,19,1,109.50382,18.24813,1509
235036,490A5F2D9652290BBCEA32DFC103B993,31171,20,21,1,109.50938,18.24917,1559
235093,8D3B10FD4DBC46DB93DA60040668F697,30854,0,6,6,109.56889,18.27076,1763
235094,8D3B10FD4DBC46DB93DA60040668F697,31561,9,10,1,109.56792,18.28479,1765
235095,8D3B10FD4DBC46DB93DA60040668F697,30854,12,23,11,109.56889,18.27076,1763
235112,855D815DC19AA779325469411A9E7B8A,30251,2,6,4,109.50611,18.26653,1512
235113,855D815DC19AA779325469411A9E7B8A,38157,7,19,12,109.51483,18.26958,1563
235144,A5CE8EC163B2D3DFB2CA8F669B7180D4,38205,15,16,1,109.62743,18.23139,1956
235145,A5CE8EC163B2D3DFB2CA8F669B7180D4,31861,18,23,5,109.49042,18.27549,1464
235158,8621CFDF1B89A83351494618C53D033F,39181,0,5,5,109.55153,18.28035,1715
235159,8621CFDF1B89A83351494618C53D033F,31071,6,16,10,109.58257,18.28458,1815
235160,8621CFDF1B89A83351494618C53D033F,39181,16,20,4,109.55153,18.28035,1715
235218,BE7763F8096EB5A037146E1CC4190538,30854,0,5,5,109.56889,18.27076,1763
235219,BE7763F8096EB5A037146E1CC4190538,39183,7,18,11,109.55542,18.28208,1715
235220,BE7763F8096EB5A037146E1CC4190538,31071,19,20,1,109.58257,18.28458,1815
235235,C96547CFFA00338796E1443E47F99499,39321,14,16,2,109.529,18.2167,1604
235236,C96547CFFA00338796E1443E47F99499,38361,20,21,1,109.43667,18.29201,1267
235268,07E1A2BEF06E96D54732D75ED1E262EB,31471,15,16,1,109.34583,18.29563,917
235269,07E1A2BEF06E96D54732D75ED1E262EB,31554,21,23,2,109.55521,18.2459,1709
235278,AE1D2CB811A45E9D0BA691392CEA1100,31945,4,6,2,109.58021,18.29403,1817
235279,AE1D2CB811A45E9D0BA691392CEA1100,31071,9,22,13,109.58257,18.28458,1815
235316,5A01EB8FA74506E0F21D58D31F716299,30791,13,14,1,109.72333,18.40889,2386
235317,5A01EB8FA74506E0F21D58D31F716299,31461,18,19,1,109.5091,18.25389,1510
235318,5A01EB8FA74506E0F21D58D31F716299,39053,20,21,1,109.511,18.2771,1564
235389,B9910ED12590156FA874C8F711421C56,60084,0,2,2,109.4984,18.2334,1507
235390,B9910ED12590156FA874C8F711421C56,30051,2,5,3,109.48917,18.21215,1453
235391,B9910ED12590156FA874C8F711421C56,60381,9,10,1,109.5241,18.22458,1605
235392,B9910ED12590156FA874C8F711421C56,31145,13,14,1,109.20431,18.30479,369
235393,B9910ED12590156FA874C8F711421C56,30051,19,21,2,109.48917,18.21215,1453
235394,B9910ED12590156FA874C8F711421C56,60084,21,23,2,109.4984,18.2334,1507
235409,EB316856896788EC8FD871E122E95728,31811,1,4,3,109.54201,18.31806,1671
235410,EB316856896788EC8FD871E122E95728,30701,6,14,8,109.59313,18.32007,1871
235411,EB316856896788EC8FD871E122E95728,31811,14,18,4,109.54201,18.31806,1671
235412,EB316856896788EC8FD871E122E95728,30701,18,23,5,109.59313,18.32007,1871
235413,0EEF00D524FC221E0814F0ECEF97AD09,31351,12,14,2,109.4959,18.28417,1465
235415,0EEF00D524FC221E0814F0ECEF97AD09,31351,19,23,4,109.4959,18.28417,1465
235438,5F05A258CA919BA01045F79DD70FBCC9,30854,1,6,5,109.56889,18.27076,1763
235439,5F05A258CA919BA01045F79DD70FBCC9,31561,6,7,1,109.56792,18.28479,1765
235440,5F05A258CA919BA01045F79DD70FBCC9,39183,8,10,2,109.55542,18.28208,1715
235441,5F05A258CA919BA01045F79DD70FBCC9,30071,15,16,1,109.52819,18.30472,1619
235442,5F05A258CA919BA01045F79DD70FBCC9,31561,19,20,1,109.56792,18.28479,1765
235469,CD3BCBAB8571FB81953C842A434E5DB8,30854,6,10,4,109.56889,18.27076,1763
235470,CD3BCBAB8571FB81953C842A434E5DB8,31071,11,22,11,109.58257,18.28458,1815
235516,4B004637D3CFBCA65EA00FFD3F1EF7A6,31561,0,12,12,109.56792,18.28479,1765
235517,4B004637D3CFBCA65EA00FFD3F1EF7A6,30071,14,15,1,109.52819,18.30472,1619
235518,4B004637D3CFBCA65EA00FFD3F1EF7A6,31561,18,20,2,109.56792,18.28479,1765
235531,9DE8C13901CC7D63E2F1A6CC92603604,31071,1,2,1,109.58257,18.28458,1815
235532,9DE8C13901CC7D63E2F1A6CC92603604,30851,3,5,2,109.5616,18.27396,1713
235533,9DE8C13901CC7D63E2F1A6CC92603604,30854,8,20,12,109.56889,18.27076,1763
235587,E27729CF5C68766C958C34CEBE1241B2,39041,0,4,4,109.40021,18.29278,1117
235588,E27729CF5C68766C958C34CEBE1241B2,38903,5,6,1,109.39229,18.29243,1117
235589,E27729CF5C68766C958C34CEBE1241B2,30351,7,9,2,109.41701,18.29292,1217
235590,E27729CF5C68766C958C34CEBE1241B2,30351,16,17,1,109.41701,18.29292,1217
235591,E27729CF5C68766C958C34CEBE1241B2,30351,17,19,2,109.41701,18.29292,1217
235592,E27729CF5C68766C958C34CEBE1241B2,31236,19,22,3,109.42965,18.29111,1216
235605,C2C5F3D1EDFF2B77820D06649C507C1B,31021,8,13,5,109.49021,18.27,1463
235619,B164B8C0AEC0E295C9ED3DBE75B5D547,30391,1,7,6,109.4975,18.27118,1513
235620,B164B8C0AEC0E295C9ED3DBE75B5D547,31181,8,9,1,109.50382,18.24813,1509
235621,B164B8C0AEC0E295C9ED3DBE75B5D547,30361,9,11,2,109.50347,18.24,1508
235622,B164B8C0AEC0E295C9ED3DBE75B5D547,30084,12,14,2,109.50118,18.26972,1513
235623,B164B8C0AEC0E295C9ED3DBE75B5D547,60291,16,17,1,109.50826,18.24639,1509
235624,B164B8C0AEC0E295C9ED3DBE75B5D547,30151,18,19,1,109.50986,18.25083,1560
235681,5264833F0013AE6B294396000613EF89,31351,12,13,1,109.4959,18.28417,1465
235682,5264833F0013AE6B294396000613EF89,31041,15,16,1,109.50278,18.23701,1507
235683,5264833F0013AE6B294396000613EF89,31041,18,19,1,109.50278,18.23701,1507
235687,54EA5A03224802DD904B7C6F69D9E71B,31471,15,16,1,109.34583,18.29563,917
235688,54EA5A03224802DD904B7C6F69D9E71B,38951,21,23,2,109.48097,18.28868,1416
235700,993300654839821E7CBC0B1D6C1A4599,61011,2,21,19,109.60653,18.19076,1900
235713,2F440A235E684ECEDD042B3100A4AE95,31071,6,7,1,109.58257,18.28458,1815
235714,2F440A235E684ECEDD042B3100A4AE95,31561,12,14,2,109.56792,18.28479,1765
235717,0402BD114B7D5E20705E302B756CD062,31071,0,6,6,109.58257,18.28458,1815
235718,0402BD114B7D5E20705E302B756CD062,30854,9,11,2,109.56889,18.27076,1763
235719,0402BD114B7D5E20705E302B756CD062,60631,12,13,1,109.57778,18.27583,1814
235720,0402BD114B7D5E20705E302B756CD062,30854,14,15,1,109.56889,18.27076,1763
235721,0402BD114B7D5E20705E302B756CD062,31071,16,18,2,109.58257,18.28458,1815
235722,0402BD114B7D5E20705E302B756CD062,30854,19,21,2,109.56889,18.27076,1763
235748,5EBEA276FCB4A19AC5C987F5C7CC8908,60552,1,3,2,109.41729,18.30014,1218
235749,5EBEA276FCB4A19AC5C987F5C7CC8908,60524,5,6,1,109.42951,18.28993,1216
235750,5EBEA276FCB4A19AC5C987F5C7CC8908,60552,10,11,1,109.41729,18.30014,1218
235751,5EBEA276FCB4A19AC5C987F5C7CC8908,60401,11,13,2,109.47444,18.27583,1414
235752,5EBEA276FCB4A19AC5C987F5C7CC8908,60621,13,15,2,109.48354,18.27451,1464
235753,5EBEA276FCB4A19AC5C987F5C7CC8908,38361,19,20,1,109.43667,18.29201,1267
235754,C6702CA511246E70666F9E56EFC53769,60221,1,7,6,109.52569,18.29188,1616
235755,C6702CA511246E70666F9E56EFC53769,30851,8,9,1,109.5616,18.27396,1713
235756,C6702CA511246E70666F9E56EFC53769,31561,10,12,2,109.56792,18.28479,1765
235757,C6702CA511246E70666F9E56EFC53769,30851,15,16,1,109.5616,18.27396,1713
235758,C6702CA511246E70666F9E56EFC53769,31561,16,18,2,109.56792,18.28479,1765
235765,EEF2FC7D161D746ED74FFF65C3D590CD,31781,12,14,2,109.19847,18.2975,367
235766,EEF2FC7D161D746ED74FFF65C3D590CD,31271,19,20,1,109.48958,18.26257,1462
235767,EEF2FC7D161D746ED74FFF65C3D590CD,30171,20,23,3,109.48458,18.27139,1463
235771,3B6FF1F8D896A0A62DC7E65967011999,39183,0,12,12,109.55542,18.28208,1715
235772,3B6FF1F8D896A0A62DC7E65967011999,31561,13,15,2,109.56792,18.28479,1765
235773,3B6FF1F8D896A0A62DC7E65967011999,39183,15,20,5,109.55542,18.28208,1715
235781,7B1A07C39637E996C01DF0A3D287D3C6,39371,1,14,13,109.56627,18.2646,1762
235782,7B1A07C39637E996C01DF0A3D287D3C6,31071,17,19,2,109.58257,18.28458,1815
235792,DEEF519781F9588D37AD928845C2355A,31781,13,15,2,109.19847,18.2975,367
235793,DEEF519781F9588D37AD928845C2355A,31521,18,21,3,109.51458,18.22542,1555
235794,DEEF519781F9588D37AD928845C2355A,30511,22,23,1,109.51069,18.24208,1558
235795,DB4DF566D4757FF3BB488F82DE126248,30851,10,11,1,109.5616,18.27396,1713
235796,DB4DF566D4757FF3BB488F82DE126248,31561,12,17,5,109.56792,18.28479,1765
235813,25DF9BDDEDA9DA85FA8972A7B6B93BF8,30681,0,10,10,109.48493,18.26917,1463
235814,25DF9BDDEDA9DA85FA8972A7B6B93BF8,60054,12,15,3,109.3016,18.31229,770
235815,25DF9BDDEDA9DA85FA8972A7B6B93BF8,30681,18,19,1,109.48493,18.26917,1463
235816,25DF9BDDEDA9DA85FA8972A7B6B93BF8,30361,20,21,1,109.50347,18.24,1508
235819,FBC323A047041F71D8997C22FDE88F17,30181,1,9,8,109.51597,18.23313,1557
235820,FBC323A047041F71D8997C22FDE88F17,38346,10,17,7,109.49688,18.21306,1503
235821,FBC323A047041F71D8997C22FDE88F17,38017,19,21,2,109.49729,18.21424,1504
235826,0312B43ACF9ED1D8304E325E851AEE29,30851,0,9,9,109.5616,18.27396,1713
235827,0312B43ACF9ED1D8304E325E851AEE29,31561,10,12,2,109.56792,18.28479,1765
235828,0312B43ACF9ED1D8304E325E851AEE29,30851,13,14,1,109.5616,18.27396,1713
235829,0312B43ACF9ED1D8304E325E851AEE29,31561,14,15,1,109.56792,18.28479,1765
235830,0312B43ACF9ED1D8304E325E851AEE29,30851,15,19,4,109.5616,18.27396,1713
235835,EEAA904909853FCE4C1006E1C626BEA2,60231,0,11,11,109.49903,18.21972,1504
235838,EEAA904909853FCE4C1006E1C626BEA2,60231,21,23,2,109.49903,18.21972,1504
235844,1FC5887E4053936D3ED4D738338DC172,31421,0,7,7,109.55382,18.22347,1705
235845,1FC5887E4053936D3ED4D738338DC172,30851,11,23,12,109.5616,18.27396,1713
235848,9F7BD4B191C6CDB262073FE9BC5F12C5,30281,0,3,3,109.50597,18.27583,1514
235849,9F7BD4B191C6CDB262073FE9BC5F12C5,38127,4,9,5,109.50833,18.27222,1513
235850,9F7BD4B191C6CDB262073FE9BC5F12C5,38721,9,10,1,109.50368,18.27542,1514
235919,91FC837E1F046F1B43F9D8C2C0F1555F,30321,19,21,2,109.49563,18.29611,1467
235920,91FC837E1F046F1B43F9D8C2C0F1555F,39321,21,23,2,109.529,18.2167,1604
235966,7DE63B500AAA8596FED98730536D4512,30351,0,11,11,109.41701,18.29292,1217
235967,7DE63B500AAA8596FED98730536D4512,30661,12,13,1,109.37028,18.24361,1008
235968,7DE63B500AAA8596FED98730536D4512,30341,13,14,1,109.3625,18.29167,966
236008,13664B2E5419DDA8E26BAB65AA04153C,39191,0,16,16,109.51493,18.23472,1557
236009,13664B2E5419DDA8E26BAB65AA04153C,30271,17,18,1,109.49132,18.23153,1456
236010,13664B2E5419DDA8E26BAB65AA04153C,30191,20,21,1,109.50361,18.22701,1506
236014,2C3EB493C3D5668656C0F89E35138F88,30111,0,1,1,109.47583,18.30542,1419
236015,2C3EB493C3D5668656C0F89E35138F88,60421,1,4,3,109.46333,18.31743,1371
236016,2C3EB493C3D5668656C0F89E35138F88,30821,5,6,1,109.43681,18.33639,1274
236017,2C3EB493C3D5668656C0F89E35138F88,60221,18,21,3,109.52569,18.29188,1616
236018,2C3EB493C3D5668656C0F89E35138F88,30821,22,23,1,109.43681,18.33639,1274
236019,DF98647F15F7D91E899C4DF73529607A,30921,5,7,2,109.53903,18.29451,1667
236020,DF98647F15F7D91E899C4DF73529607A,60371,7,9,2,109.53063,18.30056,1618
236021,DF98647F15F7D91E899C4DF73529607A,31931,11,16,5,109.54771,18.29403,1667
236026,7B28F954C024CD32BD4419981FD19B1F,31781,12,14,2,109.19847,18.2975,367
236027,7B28F954C024CD32BD4419981FD19B1F,38105,18,23,5,109.40299,18.29229,1117
236035,8265A029C672FE0377EF574CC3ADF2A8,39183,14,16,2,109.55542,18.28208,1715
236036,8265A029C672FE0377EF574CC3ADF2A8,30854,21,23,2,109.56889,18.27076,1763
236050,CA3896FB33E9BC68E91955EDFF5D709B,30234,18,20,2,109.60681,18.29979,1918
236051,CA3896FB33E9BC68E91955EDFF5D709B,30854,22,23,1,109.56889,18.27076,1763
236061,64F4CDF664AA04E7B79DE93C57128CF6,31931,2,7,5,109.54771,18.29403,1667
236062,64F4CDF664AA04E7B79DE93C57128CF6,39181,10,18,8,109.55153,18.28035,1715
236080,6B806948BC9187A91D033B4096721B00,31561,1,7,6,109.56792,18.28479,1765
236081,6B806948BC9187A91D033B4096721B00,31071,9,20,11,109.58257,18.28458,1815
236113,5A31AA15CC197C9237A9A16B14069CB4,31864,19,23,4,109.49014,18.28333,1465
236150,56F4A25A0E603B5B2CF39EF89A2DE812,31611,0,8,8,109.63076,18.34944,2026
236151,56F4A25A0E603B5B2CF39EF89A2DE812,60231,11,13,2,109.49903,18.21972,1504
236152,56F4A25A0E603B5B2CF39EF89A2DE812,30711,16,18,2,109.50271,18.25347,1510
236153,56F4A25A0E603B5B2CF39EF89A2DE812,30421,18,21,3,109.50021,18.25861,1511
236154,56F4A25A0E603B5B2CF39EF89A2DE812,31611,22,23,1,109.63076,18.34944,2026
236159,C45AE1932A145D3CA4B8A65E78F9575D,38291,1,9,8,109.51618,18.24313,1558
236160,C45AE1932A145D3CA4B8A65E78F9575D,60311,11,12,1,109.52097,18.24319,1558
236161,C45AE1932A145D3CA4B8A65E78F9575D,31261,12,13,1,109.51174,18.2466,1559
236162,C45AE1932A145D3CA4B8A65E78F9575D,38291,14,16,2,109.51618,18.24313,1558
236163,C45AE1932A145D3CA4B8A65E78F9575D,30421,18,20,2,109.50021,18.25861,1511
236181,E65658506C2BF9C993BA69EE6D38B3C6,31951,1,13,12,109.52174,18.30299,1568
236182,E65658506C2BF9C993BA69EE6D38B3C6,60361,14,16,2,109.51938,18.29681,1567
236183,E65658506C2BF9C993BA69EE6D38B3C6,31951,16,20,4,109.52174,18.30299,1568
236184,E65658506C2BF9C993BA69EE6D38B3C6,31561,21,22,1,109.56792,18.28479,1765
236217,1895F5980F209DD67ED920915EFD0AEA,60401,0,8,8,109.47444,18.27583,1414
236269,4EC716C6116001DCCA61DAB5E48F9371,38391,0,7,7,109.44111,18.29083,1266
236270,4EC716C6116001DCCA61DAB5E48F9371,60421,7,13,6,109.46333,18.31743,1371
236271,4EC716C6116001DCCA61DAB5E48F9371,60201,14,17,3,109.5041,18.2509,1510
236277,372BCC9E34709FCD9ED7D887E115E777,31561,1,13,12,109.56792,18.28479,1765
236278,372BCC9E34709FCD9ED7D887E115E777,30854,13,16,3,109.56889,18.27076,1763
236279,372BCC9E34709FCD9ED7D887E115E777,31561,17,18,1,109.56792,18.28479,1765
236280,372BCC9E34709FCD9ED7D887E115E777,31071,19,23,4,109.58257,18.28458,1815
236298,C93386A9D86FE22A1FD4E5116045DD8D,31561,0,5,5,109.56792,18.28479,1765
236299,C93386A9D86FE22A1FD4E5116045DD8D,39183,6,10,4,109.55542,18.28208,1715
236300,C93386A9D86FE22A1FD4E5116045DD8D,31561,11,19,8,109.56792,18.28479,1765
236301,C93386A9D86FE22A1FD4E5116045DD8D,30854,19,20,1,109.56889,18.27076,1763
236360,6587551DA47309E484D1302521C8D417,38275,10,15,5,109.62875,18.22938,2006
236361,6587551DA47309E484D1302521C8D417,38054,19,21,2,109.63479,18.23097,2006
236376,299B7BC2E95F0240F64F76032ECBC4BA,39191,0,7,7,109.51493,18.23472,1557
236377,299B7BC2E95F0240F64F76032ECBC4BA,60281,8,9,1,109.51743,18.25924,1561
236378,299B7BC2E95F0240F64F76032ECBC4BA,30181,10,13,3,109.51597,18.23313,1557
236379,299B7BC2E95F0240F64F76032ECBC4BA,30711,15,16,1,109.50271,18.25347,1510
236383,FA1A0E0BAAE42E33A894437D15AB1110,60631,2,7,5,109.57778,18.27583,1814
236384,FA1A0E0BAAE42E33A894437D15AB1110,31071,9,11,2,109.58257,18.28458,1815
236385,FA1A0E0BAAE42E33A894437D15AB1110,60631,13,15,2,109.57778,18.27583,1814
236386,FA1A0E0BAAE42E33A894437D15AB1110,39091,16,17,1,109.50097,18.25222,1510
236387,FA1A0E0BAAE42E33A894437D15AB1110,30854,19,20,1,109.56889,18.27076,1763
236388,FA1A0E0BAAE42E33A894437D15AB1110,60631,22,23,1,109.57778,18.27583,1814
236391,DA10676C4DA702E02A2C3FFFAC40ABA2,31561,0,4,4,109.56792,18.28479,1765
236392,DA10676C4DA702E02A2C3FFFAC40ABA2,39183,8,10,2,109.55542,18.28208,1715
236393,DA10676C4DA702E02A2C3FFFAC40ABA2,31561,10,18,8,109.56792,18.28479,1765
236398,17D6DB95A76434E18528B9C94350AA97,31531,0,8,8,109.49583,18.25972,1461
236399,17D6DB95A76434E18528B9C94350AA97,31471,11,15,4,109.34583,18.29563,917
236400,17D6DB95A76434E18528B9C94350AA97,31531,20,23,3,109.49583,18.25972,1461
236406,3977578BE56276DA0700B04B81DC1356,30851,1,6,5,109.5616,18.27396,1713
236407,3977578BE56276DA0700B04B81DC1356,31561,7,8,1,109.56792,18.28479,1765
236408,3977578BE56276DA0700B04B81DC1356,31071,11,14,3,109.58257,18.28458,1815
236409,3977578BE56276DA0700B04B81DC1356,31561,14,17,3,109.56792,18.28479,1765
236410,3977578BE56276DA0700B04B81DC1356,30851,19,20,1,109.5616,18.27396,1713
236411,3977578BE56276DA0700B04B81DC1356,31561,21,22,1,109.56792,18.28479,1765
236416,5205655EC583F6392BC68C8BB9865108,30854,14,20,6,109.56889,18.27076,1763
236417,5205655EC583F6392BC68C8BB9865108,31171,22,23,1,109.50938,18.24917,1559
236467,B7E330D15F4B46614A332696B5F7027D,31561,0,4,4,109.56792,18.28479,1765
236468,B7E330D15F4B46614A332696B5F7027D,31931,7,23,16,109.54771,18.29403,1667
236499,F2DDFA8B80CE24F358EB38920C9A6AA9,31571,15,16,1,109.61563,18.23326,1957
236500,F2DDFA8B80CE24F358EB38920C9A6AA9,38017,19,20,1,109.49729,18.21424,1504
236501,F2DDFA8B80CE24F358EB38920C9A6AA9,30441,21,22,1,109.64021,18.25424,2010
236527,9272327B359F9A8CB4E9C533C10E8BE6,30681,0,18,18,109.48493,18.26917,1463
236528,9272327B359F9A8CB4E9C533C10E8BE6,60401,19,21,2,109.47444,18.27583,1414
236562,90E761563218966BF6DD1FD6E24DA0E3,60321,0,9,9,109.63611,18.24306,2008
236563,90E761563218966BF6DD1FD6E24DA0E3,31571,10,12,2,109.61563,18.23326,1957
236564,90E761563218966BF6DD1FD6E24DA0E3,31101,15,17,2,109.65389,18.23403,2057
236567,7C085508C36749F188C75B401CBDAD91,31521,0,8,8,109.51458,18.22542,1555
236569,7C085508C36749F188C75B401CBDAD91,31471,13,15,2,109.34583,18.29563,917
236570,7C085508C36749F188C75B401CBDAD91,60221,18,21,3,109.52569,18.29188,1616
236573,5F8A4BDCC5D1941BEB6DBBEA7E0B606A,38826,4,7,3,109.50326,18.25514,1510
236574,5F8A4BDCC5D1941BEB6DBBEA7E0B606A,30911,9,11,2,109.50493,18.26181,1511
236575,5F8A4BDCC5D1941BEB6DBBEA7E0B606A,60214,13,14,1,109.63104,18.24493,2009
236576,5F8A4BDCC5D1941BEB6DBBEA7E0B606A,31031,19,21,2,109.49979,18.25382,1510
236577,5F8A4BDCC5D1941BEB6DBBEA7E0B606A,60214,22,23,1,109.63104,18.24493,2009
236587,C709D01469E0800AF998DFAF42105CDC,30854,1,5,4,109.56889,18.27076,1763
236588,C709D01469E0800AF998DFAF42105CDC,31561,6,18,12,109.56792,18.28479,1765
236589,C709D01469E0800AF998DFAF42105CDC,30854,19,23,4,109.56889,18.27076,1763
236590,6917A8E1AE4CE33049FC189B3388DF85,60261,0,6,6,109.44326,18.3075,1319
236591,6917A8E1AE4CE33049FC189B3388DF85,60201,8,10,2,109.5041,18.2509,1510
236592,6917A8E1AE4CE33049FC189B3388DF85,60171,11,13,2,109.51292,18.30694,1569
236593,6917A8E1AE4CE33049FC189B3388DF85,31461,14,16,2,109.5091,18.25389,1510
236594,6917A8E1AE4CE33049FC189B3388DF85,38127,19,20,1,109.50833,18.27222,1513
236595,6917A8E1AE4CE33049FC189B3388DF85,60261,21,23,2,109.44326,18.3075,1319
236614,451E2BF48CD7B253EB0892324E679BCC,38297,1,6,5,109.52576,18.24965,1609
236615,451E2BF48CD7B253EB0892324E679BCC,60281,7,11,4,109.51743,18.25924,1561
236616,451E2BF48CD7B253EB0892324E679BCC,38297,11,13,2,109.52576,18.24965,1609
236617,451E2BF48CD7B253EB0892324E679BCC,60281,13,15,2,109.51743,18.25924,1561
236618,451E2BF48CD7B253EB0892324E679BCC,60671,15,17,2,109.52979,18.31757,1621
236619,451E2BF48CD7B253EB0892324E679BCC,38297,17,18,1,109.52576,18.24965,1609
236639,8A0382A2385C362EFE2664E8795F133E,39183,0,4,4,109.55542,18.28208,1715
236640,8A0382A2385C362EFE2664E8795F133E,31561,4,5,1,109.56792,18.28479,1765
236641,8A0382A2385C362EFE2664E8795F133E,39183,9,13,4,109.55542,18.28208,1715
236642,8A0382A2385C362EFE2664E8795F133E,31561,14,15,1,109.56792,18.28479,1765
236643,3160CBE2F0CDCB610575CDC881D9968C,38297,0,7,7,109.52576,18.24965,1609
236644,3160CBE2F0CDCB610575CDC881D9968C,38261,8,9,1,109.50361,18.28153,1515
236645,3160CBE2F0CDCB610575CDC881D9968C,38297,11,14,3,109.52576,18.24965,1609
236676,05C6A2C14509DD9617D330FE89E3643D,30891,0,2,2,109.59431,18.28389,1865
236677,05C6A2C14509DD9617D330FE89E3643D,31071,3,5,2,109.58257,18.28458,1815
236678,05C6A2C14509DD9617D330FE89E3643D,60631,6,7,1,109.57778,18.27583,1814
236679,05C6A2C14509DD9617D330FE89E3643D,60381,8,9,1,109.5241,18.22458,1605
236680,05C6A2C14509DD9617D330FE89E3643D,31781,12,14,2,109.19847,18.2975,367
236728,86E10BC3307CFF28C676C9C7B0F51200,60552,19,20,1,109.41729,18.30014,1218
236729,86E10BC3307CFF28C676C9C7B0F51200,38361,21,23,2,109.43667,18.29201,1267
236752,529A14F498129B0238F7B12A9FC7F6F7,31205,0,1,1,109.51111,18.23736,1557
236753,529A14F498129B0238F7B12A9FC7F6F7,31671,3,17,14,109.38965,18.29813,1068
236754,529A14F498129B0238F7B12A9FC7F6F7,30324,18,20,2,109.50326,18.29257,1517
236755,529A14F498129B0238F7B12A9FC7F6F7,30711,21,23,2,109.50271,18.25347,1510
236760,C5190185E6A850F6CC88937542E0EA31,31071,3,4,1,109.58257,18.28458,1815
236761,C5190185E6A850F6CC88937542E0EA31,31071,5,6,1,109.58257,18.28458,1815
236762,C5190185E6A850F6CC88937542E0EA31,39371,8,9,1,109.56627,18.2646,1762
236763,C5190185E6A850F6CC88937542E0EA31,30854,9,16,7,109.56889,18.27076,1763
236768,5E8FF49D1CCDA711846608608C7FAE0D,31071,0,11,11,109.58257,18.28458,1815
236769,5E8FF49D1CCDA711846608608C7FAE0D,30854,16,19,3,109.56889,18.27076,1763
236770,2C3BD53A8702A47FB82F05FB4993B683,39183,15,16,1,109.55542,18.28208,1715
236771,2C3BD53A8702A47FB82F05FB4993B683,31561,21,22,1,109.56792,18.28479,1765
236786,866460FA5062A635337B6369BB2AADDA,31071,3,5,2,109.58257,18.28458,1815
236787,866460FA5062A635337B6369BB2AADDA,30854,9,23,14,109.56889,18.27076,1763
236807,999F394CBA35AFBAE3B26337712A5850,30854,16,22,6,109.56889,18.27076,1763
236808,999F394CBA35AFBAE3B26337712A5850,31071,22,23,1,109.58257,18.28458,1815
236878,D42D82F7F77C55013F0EAB7E35E2211F,30854,2,3,1,109.56889,18.27076,1763
236879,D42D82F7F77C55013F0EAB7E35E2211F,31071,6,10,4,109.58257,18.28458,1815
236880,D42D82F7F77C55013F0EAB7E35E2211F,30531,14,22,8,109.53271,18.21472,1604
236895,D39D64452E6BBEF7B3056CA239E1B86E,30854,0,6,6,109.56889,18.27076,1763
236896,D39D64452E6BBEF7B3056CA239E1B86E,31561,6,7,1,109.56792,18.28479,1765
236897,D39D64452E6BBEF7B3056CA239E1B86E,30854,8,9,1,109.56889,18.27076,1763
236898,D39D64452E6BBEF7B3056CA239E1B86E,31561,9,11,2,109.56792,18.28479,1765
236899,D39D64452E6BBEF7B3056CA239E1B86E,30854,12,13,1,109.56889,18.27076,1763
236900,D39D64452E6BBEF7B3056CA239E1B86E,31561,14,19,5,109.56792,18.28479,1765
236901,D39D64452E6BBEF7B3056CA239E1B86E,30854,19,23,4,109.56889,18.27076,1763
236907,40C57F24FE0409ABB752B2031C349577,38951,0,7,7,109.48097,18.28868,1416
236908,40C57F24FE0409ABB752B2031C349577,38073,11,12,1,109.40813,18.30958,1169
236909,40C57F24FE0409ABB752B2031C349577,38951,17,22,5,109.48097,18.28868,1416
236950,50C497E938D256053EDA53A1DE0E2147,31931,0,18,18,109.54771,18.29403,1667
236951,50C497E938D256053EDA53A1DE0E2147,60371,20,21,1,109.53063,18.30056,1618
236952,50C497E938D256053EDA53A1DE0E2147,31931,22,23,1,109.54771,18.29403,1667
237000,B0C6DED232762D9BAF78468BD2731104,60041,13,14,1,109.39889,18.31944,1121
237001,B0C6DED232762D9BAF78468BD2731104,30581,18,23,5,109.62257,18.24951,1959
237038,D41B754FD260B71E1D8B72C191605B3D,60114,13,14,1,109.73028,18.33847,2374
237042,CD576F1C1CDFB89E6A99A20E65927346,31561,2,8,6,109.56792,18.28479,1765
237043,CD576F1C1CDFB89E6A99A20E65927346,30854,9,23,14,109.56889,18.27076,1763
237049,2E4974DC6B5DC914D4BEF4B8CF2CC13B,60391,13,16,3,109.47667,18.28757,1416
237050,2E4974DC6B5DC914D4BEF4B8CF2CC13B,31081,21,23,2,109.44639,18.30181,1318
237064,0AD99509D112B17EDC0942E5CD8E86E4,30071,0,6,6,109.52819,18.30472,1619
237065,0AD99509D112B17EDC0942E5CD8E86E4,30921,8,14,6,109.53903,18.29451,1667
237066,0AD99509D112B17EDC0942E5CD8E86E4,31931,16,18,2,109.54771,18.29403,1667
237067,0AD99509D112B17EDC0942E5CD8E86E4,30071,19,23,4,109.52819,18.30472,1619
237073,0695D4E7B3E726CA09D841B87798B560,60354,1,5,4,109.58701,18.28521,1815
237074,0695D4E7B3E726CA09D841B87798B560,30854,9,16,7,109.56889,18.27076,1763
237075,0695D4E7B3E726CA09D841B87798B560,31071,16,18,2,109.58257,18.28458,1815
237076,0695D4E7B3E726CA09D841B87798B560,30854,22,23,1,109.56889,18.27076,1763
237087,B712327B6033C61F37801CFD6DAC08AD,30561,1,2,1,109.52778,18.31938,1621
237088,B712327B6033C61F37801CFD6DAC08AD,31951,3,5,2,109.52174,18.30299,1568
237089,B712327B6033C61F37801CFD6DAC08AD,38484,6,9,3,109.53028,18.31528,1620
237090,B712327B6033C61F37801CFD6DAC08AD,30561,10,13,3,109.52778,18.31938,1621
237091,B712327B6033C61F37801CFD6DAC08AD,38484,13,16,3,109.53028,18.31528,1620
237092,B712327B6033C61F37801CFD6DAC08AD,38484,16,18,2,109.53028,18.31528,1620
237093,B712327B6033C61F37801CFD6DAC08AD,30561,18,19,1,109.52778,18.31938,1621
237094,B712327B6033C61F37801CFD6DAC08AD,30771,20,21,1,109.49938,18.26042,1511
237095,B712327B6033C61F37801CFD6DAC08AD,30561,22,23,1,109.52778,18.31938,1621
237118,63FBAC0202144B00077561285E6A7F87,30821,0,7,7,109.43681,18.33639,1274
237119,63FBAC0202144B00077561285E6A7F87,30651,7,10,3,109.42611,18.385,1232
237120,63FBAC0202144B00077561285E6A7F87,30821,10,23,13,109.43681,18.33639,1274
237132,DF296B63A64E364FCDA4C38B0935EEEE,30511,0,20,20,109.51069,18.24208,1558
237133,DF296B63A64E364FCDA4C38B0935EEEE,31201,21,23,2,109.51042,18.23819,1558
237135,070ADE02B3AE6F1159A3DDFA12578616,30361,10,23,13,109.50347,18.24,1508
237159,225EDE82328108AFB3E7EE610CA3F074,60371,4,5,1,109.53063,18.30056,1618
237160,225EDE82328108AFB3E7EE610CA3F074,31931,7,23,16,109.54771,18.29403,1667
237193,89362A3CA3AE6F5B75871F2110924F99,31551,12,14,2,109.55868,18.24222,1708
237194,89362A3CA3AE6F5B75871F2110924F99,39371,14,16,2,109.56627,18.2646,1762
237195,89362A3CA3AE6F5B75871F2110924F99,30851,19,23,4,109.5616,18.27396,1713
237217,1593E13193A160EF9BE2323C5CE79FFF,30071,0,9,9,109.52819,18.30472,1619
237218,1593E13193A160EF9BE2323C5CE79FFF,30084,10,12,2,109.50118,18.26972,1513
237219,1593E13193A160EF9BE2323C5CE79FFF,38241,13,19,6,109.54111,18.30542,1669
237263,7FF3C6569A3990C03CAF6C52D3C8BC6C,30921,0,6,6,109.53903,18.29451,1667
237264,7FF3C6569A3990C03CAF6C52D3C8BC6C,31931,7,11,4,109.54771,18.29403,1667
237265,7FF3C6569A3990C03CAF6C52D3C8BC6C,30921,12,13,1,109.53903,18.29451,1667
237266,7FF3C6569A3990C03CAF6C52D3C8BC6C,31931,14,15,1,109.54771,18.29403,1667
237267,7FF3C6569A3990C03CAF6C52D3C8BC6C,30921,17,23,6,109.53903,18.29451,1667
237276,BA9F8903EC2A1C9DFCBB7CC5DE07DE50,30021,0,5,5,109.12014,18.40986,86
237277,BA9F8903EC2A1C9DFCBB7CC5DE07DE50,30854,9,11,2,109.56889,18.27076,1763
237278,BA9F8903EC2A1C9DFCBB7CC5DE07DE50,31071,15,16,1,109.58257,18.28458,1815
237279,BA9F8903EC2A1C9DFCBB7CC5DE07DE50,30854,16,18,2,109.56889,18.27076,1763
237296,066E3B290AAC556F650E56DD0F693AB2,38251,0,8,8,109.49618,18.25493,1510
237297,066E3B290AAC556F650E56DD0F693AB2,30601,10,12,2,109.66521,18.3875,2132
237298,066E3B290AAC556F650E56DD0F693AB2,30581,14,18,4,109.62257,18.24951,1959
237305,AA2A5396AD753E9245AC53C94BAEDECD,61011,9,17,8,109.60653,18.19076,1900
237327,182D5101D28D51096306D4EF5FDD4501,60084,0,6,6,109.4984,18.2334,1507
237328,182D5101D28D51096306D4EF5FDD4501,30271,8,10,2,109.49132,18.23153,1456
237338,64EA917EAAD3EB55DA2ABB227203C131,60631,15,16,1,109.57778,18.27583,1814
237347,5C88F2693E57AFE9DC179450D039A684,39181,0,8,8,109.55153,18.28035,1715
237348,5C88F2693E57AFE9DC179450D039A684,38271,10,15,5,109.62632,18.23049,1956
237349,5C88F2693E57AFE9DC179450D039A684,39181,19,23,4,109.55153,18.28035,1715
237383,3738BCD5F22BB841A8E524306ADFE0A0,38261,0,7,7,109.50361,18.28153,1515
237384,3738BCD5F22BB841A8E524306ADFE0A0,38751,8,13,5,109.74903,18.37639,2481
237385,3738BCD5F22BB841A8E524306ADFE0A0,38261,14,18,4,109.50361,18.28153,1515
237386,3738BCD5F22BB841A8E524306ADFE0A0,31031,19,20,1,109.49979,18.25382,1510
237387,3738BCD5F22BB841A8E524306ADFE0A0,38261,21,22,1,109.50361,18.28153,1515
237403,0302A2EBE6E506DC381134D2966F2AA4,38951,6,8,2,109.48097,18.28868,1416
237404,0302A2EBE6E506DC381134D2966F2AA4,31471,13,14,1,109.34583,18.29563,917
237405,0302A2EBE6E506DC381134D2966F2AA4,30821,16,18,2,109.43681,18.33639,1274
237406,0302A2EBE6E506DC381134D2966F2AA4,60504,22,23,1,109.47917,18.28903,1416
237414,30F5D42A1A8F1CF26F5C9617FCB06C4F,31561,1,3,2,109.56792,18.28479,1765
237415,30F5D42A1A8F1CF26F5C9617FCB06C4F,39183,5,15,10,109.55542,18.28208,1715
237416,30F5D42A1A8F1CF26F5C9617FCB06C4F,30071,16,17,1,109.52819,18.30472,1619
237417,30F5D42A1A8F1CF26F5C9617FCB06C4F,39183,18,20,2,109.55542,18.28208,1715
237458,686A151A10363ED54A6F439954DA26E0,31761,0,2,2,109.60521,18.27965,1914
237459,686A151A10363ED54A6F439954DA26E0,60594,2,13,11,109.62694,18.22799,1956
237460,686A151A10363ED54A6F439954DA26E0,60221,15,17,2,109.52569,18.29188,1616
237461,686A151A10363ED54A6F439954DA26E0,31221,19,21,2,109.61333,18.26833,1913
237462,686A151A10363ED54A6F439954DA26E0,60594,21,22,1,109.62694,18.22799,1956
237463,A928E9F6C796FE1A60807BA003DE87BB,30234,2,7,5,109.60681,18.29979,1918
237464,A928E9F6C796FE1A60807BA003DE87BB,31071,11,13,2,109.58257,18.28458,1815
237465,A928E9F6C796FE1A60807BA003DE87BB,30854,16,19,3,109.56889,18.27076,1763
237466,A928E9F6C796FE1A60807BA003DE87BB,31071,22,23,1,109.58257,18.28458,1815
237475,367FEEED2C09304141141F7892D4FBC2,30291,0,7,7,109.50403,18.27028,1513
237476,367FEEED2C09304141141F7892D4FBC2,30084,8,21,13,109.50118,18.26972,1513
237477,975CB35586D2D95A387E2AA86A5AB719,31351,0,6,6,109.4959,18.28417,1465
237478,975CB35586D2D95A387E2AA86A5AB719,30671,8,17,9,109.43611,18.30139,1268
237522,3F320FCC97654DBDACE66BB1BF09E301,30341,14,16,2,109.3625,18.29167,966
237550,807332CEC38772FA8DF98C48FBD8DD1E,31561,1,6,5,109.56792,18.28479,1765
237551,807332CEC38772FA8DF98C48FBD8DD1E,39183,6,9,3,109.55542,18.28208,1715
237552,807332CEC38772FA8DF98C48FBD8DD1E,31561,11,21,10,109.56792,18.28479,1765
237553,E6D4DFF479624FE5A6D32ED2123EE444,60291,0,1,1,109.50826,18.24639,1509
237554,E6D4DFF479624FE5A6D32ED2123EE444,30511,4,5,1,109.51069,18.24208,1558
237555,E6D4DFF479624FE5A6D32ED2123EE444,30731,6,7,1,109.50944,18.22306,1555
237556,E6D4DFF479624FE5A6D32ED2123EE444,60291,10,13,3,109.50826,18.24639,1509
237557,E6D4DFF479624FE5A6D32ED2123EE444,60541,13,15,2,109.4084,18.29208,1167
237558,97C31877CA4226D0F1BA1C0E12066B56,60331,0,6,6,109.505,18.26507,1512
237559,97C31877CA4226D0F1BA1C0E12066B56,30854,8,9,1,109.56889,18.27076,1763
237560,97C31877CA4226D0F1BA1C0E12066B56,31071,12,13,1,109.58257,18.28458,1815
237561,97C31877CA4226D0F1BA1C0E12066B56,30854,13,18,5,109.56889,18.27076,1763
237562,97C31877CA4226D0F1BA1C0E12066B56,60331,19,23,4,109.505,18.26507,1512
237587,A7D344B7B6FA604F8D0B73C56E3BBEF1,60371,19,21,2,109.53063,18.30056,1618
237588,A7D344B7B6FA604F8D0B73C56E3BBEF1,60241,21,23,2,109.53319,18.28667,1616
237593,A549C024E6F63EDBD3DC866F10DB11CE,31945,2,3,1,109.58021,18.29403,1817
237594,A549C024E6F63EDBD3DC866F10DB11CE,30854,7,9,2,109.56889,18.27076,1763
237595,A549C024E6F63EDBD3DC866F10DB11CE,31071,10,12,2,109.58257,18.28458,1815
237596,A549C024E6F63EDBD3DC866F10DB11CE,30854,14,20,6,109.56889,18.27076,1763
237600,BDFAC327288611EBD473916D4CB9B192,60411,0,10,10,109.32514,18.30854,869
237601,BDFAC327288611EBD473916D4CB9B192,38251,13,14,1,109.49618,18.25493,1510
237602,BDFAC327288611EBD473916D4CB9B192,30711,18,20,2,109.50271,18.25347,1510
237603,BDFAC327288611EBD473916D4CB9B192,60411,21,23,2,109.32514,18.30854,869
237629,A749E400BFD3B5908671E939EC104DEE,30854,1,13,12,109.56889,18.27076,1763
237630,A749E400BFD3B5908671E939EC104DEE,31071,17,19,2,109.58257,18.28458,1815
237631,A749E400BFD3B5908671E939EC104DEE,30854,21,23,2,109.56889,18.27076,1763
237636,9AF351B3CC27394DFED45513F0E32162,31421,8,10,2,109.55382,18.22347,1705
237637,9AF351B3CC27394DFED45513F0E32162,30951,13,17,4,109.56208,18.25667,1761
237638,9AF351B3CC27394DFED45513F0E32162,31761,18,21,3,109.60521,18.27965,1914
237639,9AF351B3CC27394DFED45513F0E32162,60351,22,23,1,109.58403,18.28958,1816
237673,608A55C14BAB2A5B627ACC1F39B89FB6,31945,0,7,7,109.58021,18.29403,1817
237674,608A55C14BAB2A5B627ACC1F39B89FB6,30854,7,9,2,109.56889,18.27076,1763
237675,608A55C14BAB2A5B627ACC1F39B89FB6,31945,12,13,1,109.58021,18.29403,1817
237676,608A55C14BAB2A5B627ACC1F39B89FB6,30854,13,16,3,109.56889,18.27076,1763
237677,608A55C14BAB2A5B627ACC1F39B89FB6,31945,21,23,2,109.58021,18.29403,1817
237725,D75F3D28EEDDC3AAB22F587F99A79102,30854,0,10,10,109.56889,18.27076,1763
237726,D75F3D28EEDDC3AAB22F587F99A79102,30851,11,14,3,109.5616,18.27396,1713
237727,D75F3D28EEDDC3AAB22F587F99A79102,31071,18,20,2,109.58257,18.28458,1815
237750,85586D73EA48B4F4D520D899B0BE0554,30291,0,5,5,109.50403,18.27028,1513
237751,85586D73EA48B4F4D520D899B0BE0554,30854,6,8,2,109.56889,18.27076,1763
237752,85586D73EA48B4F4D520D899B0BE0554,31071,13,15,2,109.58257,18.28458,1815
237753,85586D73EA48B4F4D520D899B0BE0554,30854,16,17,1,109.56889,18.27076,1763
237754,85586D73EA48B4F4D520D899B0BE0554,30291,19,23,4,109.50403,18.27028,1513
237761,10EBF762D28520B09848288F7052CFDE,39101,8,16,8,109.50132,18.24931,1509
237762,10EBF762D28520B09848288F7052CFDE,30854,20,22,2,109.56889,18.27076,1763
237769,C30EF1A03F3ACD87114629BE5EBA14E8,31091,19,20,1,109.41201,18.31222,1170
237770,C30EF1A03F3ACD87114629BE5EBA14E8,60552,21,23,2,109.41729,18.30014,1218
237789,546C572FC49C780F9A9AF62ED98666DF,30351,0,8,8,109.41701,18.29292,1217
237790,546C572FC49C780F9A9AF62ED98666DF,30681,9,10,1,109.48493,18.26917,1463
237791,546C572FC49C780F9A9AF62ED98666DF,30351,12,19,7,109.41701,18.29292,1217
237792,546C572FC49C780F9A9AF62ED98666DF,30681,21,22,1,109.48493,18.26917,1463
237811,5E6F81A7DA23F57413C15AC7514275E5,31561,1,2,1,109.56792,18.28479,1765
237812,5E6F81A7DA23F57413C15AC7514275E5,31071,5,8,3,109.58257,18.28458,1815
237813,5E6F81A7DA23F57413C15AC7514275E5,31945,12,23,11,109.58021,18.29403,1817
237861,DF5348A8E25901EBB63BBF3F6126BB02,31071,2,9,7,109.58257,18.28458,1815
237862,DF5348A8E25901EBB63BBF3F6126BB02,30854,9,21,12,109.56889,18.27076,1763
237878,E605B26D53F08A0D3360A4541E09F4E2,38283,0,12,12,109.62229,18.22618,1956
237879,E605B26D53F08A0D3360A4541E09F4E2,38283,12,13,1,109.62229,18.22618,1956
237884,B621E9075674E792CCB217233825F9D1,30851,1,5,4,109.5616,18.27396,1713
237885,B621E9075674E792CCB217233825F9D1,30232,5,6,1,109.6191,18.31701,1971
237902,985A2EA61E10E912EF275486E93274F1,60161,0,5,5,109.49174,18.26181,1461
237903,985A2EA61E10E912EF275486E93274F1,60201,7,10,3,109.5041,18.2509,1510
237904,985A2EA61E10E912EF275486E93274F1,38754,11,16,5,109.74667,18.37382,2430
237905,985A2EA61E10E912EF275486E93274F1,30711,21,23,2,109.50271,18.25347,1510
237911,187E4246482015B90D2FCF3E336B729B,30854,12,13,1,109.56889,18.27076,1763
237912,187E4246482015B90D2FCF3E336B729B,31561,15,17,2,109.56792,18.28479,1765
237928,F34F0762CFAEDFE0B6E04516A3061D6D,38484,15,16,1,109.53028,18.31528,1620
237981,0F558B6653C655C7F0BAEA9D66B33F57,31761,5,6,1,109.60521,18.27965,1914
237982,0F558B6653C655C7F0BAEA9D66B33F57,31071,11,12,1,109.58257,18.28458,1815
237983,0F558B6653C655C7F0BAEA9D66B33F57,30854,13,16,3,109.56889,18.27076,1763
237984,1026894DC5FF9A7FAF3A2EE28B95E239,30232,12,14,2,109.6191,18.31701,1971
237985,1026894DC5FF9A7FAF3A2EE28B95E239,30854,18,19,1,109.56889,18.27076,1763
237986,43F5AB52A0AF3FEB5880C6DCD16BBA02,31041,14,17,3,109.50278,18.23701,1507
237987,43F5AB52A0AF3FEB5880C6DCD16BBA02,60011,19,20,1,109.48965,18.30222,1468
237988,43F5AB52A0AF3FEB5880C6DCD16BBA02,38017,21,22,1,109.49729,18.21424,1504
238003,7421066246AAD1C230E7E2A7ADF06E9D,30854,13,16,3,109.56889,18.27076,1763
238004,7421066246AAD1C230E7E2A7ADF06E9D,31071,18,19,1,109.58257,18.28458,1815
238005,7421066246AAD1C230E7E2A7ADF06E9D,30854,19,21,2,109.56889,18.27076,1763
238018,6D9FA4DCEF58F1F06A04A77E6B79A7E0,31124,2,5,3,109.17069,18.35,276
238019,6D9FA4DCEF58F1F06A04A77E6B79A7E0,30434,5,9,4,109.17083,18.35861,278
238020,6D9FA4DCEF58F1F06A04A77E6B79A7E0,31031,11,13,2,109.49979,18.25382,1510
238021,6D9FA4DCEF58F1F06A04A77E6B79A7E0,31271,13,15,2,109.48958,18.26257,1462
238022,6D9FA4DCEF58F1F06A04A77E6B79A7E0,60641,18,20,2,109.53854,18.2359,1657
238023,6D9FA4DCEF58F1F06A04A77E6B79A7E0,31271,21,23,2,109.48958,18.26257,1462
238024,A01B4012B619D942E7CC3AC9B78722B4,31561,11,16,5,109.56792,18.28479,1765
238025,A01B4012B619D942E7CC3AC9B78722B4,30854,17,18,1,109.56889,18.27076,1763
238026,A01B4012B619D942E7CC3AC9B78722B4,31561,20,21,1,109.56792,18.28479,1765
238036,7A2366BD23884470C887501F5D242DE3,60221,19,20,1,109.52569,18.29188,1616
238037,7A2366BD23884470C887501F5D242DE3,31521,22,23,1,109.51458,18.22542,1555
238040,0A48A76A646C70DF6B9924881BA2168A,60241,14,15,1,109.53319,18.28667,1616
238041,0A48A76A646C70DF6B9924881BA2168A,30071,19,23,4,109.52819,18.30472,1619
238046,417408FFDA93B177641D270D3A5C4B2D,31071,0,5,5,109.58257,18.28458,1815
238047,417408FFDA93B177641D270D3A5C4B2D,30854,6,10,4,109.56889,18.27076,1763
238048,417408FFDA93B177641D270D3A5C4B2D,31071,12,13,1,109.58257,18.28458,1815
238049,417408FFDA93B177641D270D3A5C4B2D,30854,15,16,1,109.56889,18.27076,1763
238050,417408FFDA93B177641D270D3A5C4B2D,31071,21,23,2,109.58257,18.28458,1815
238098,2F5414222852C38E31C908162F37072A,38754,16,17,1,109.74667,18.37382,2430
238099,2F5414222852C38E31C908162F37072A,60231,19,22,3,109.49903,18.21972,1504
238102,2A3E5205AC8230AFA039AD71C1DA60B8,31421,19,21,2,109.55382,18.22347,1705
238103,2A3E5205AC8230AFA039AD71C1DA60B8,60661,21,23,2,109.548,18.2377,1657
238104,D29579433637905809D9DF6839E94DB4,31071,0,5,5,109.58257,18.28458,1815
238105,D29579433637905809D9DF6839E94DB4,30854,6,9,3,109.56889,18.27076,1763
238126,E484FD222AE68252EABA732103338917,31071,0,6,6,109.58257,18.28458,1815
238127,E484FD222AE68252EABA732103338917,30854,10,11,1,109.56889,18.27076,1763
238128,6E3295BE038630AA5C3C9528B9405511,31101,0,12,12,109.65389,18.23403,2057
238129,6E3295BE038630AA5C3C9528B9405511,60381,13,15,2,109.5241,18.22458,1605
238130,6E3295BE038630AA5C3C9528B9405511,31521,19,22,3,109.51458,18.22542,1555
238134,3499E731A877B5132E572C7056EDDA83,31261,0,5,5,109.51174,18.2466,1559
238135,3499E731A877B5132E572C7056EDDA83,38911,5,7,2,109.51674,18.24965,1559
238136,3499E731A877B5132E572C7056EDDA83,31261,7,9,2,109.51174,18.2466,1559
238137,3499E731A877B5132E572C7056EDDA83,31261,10,13,3,109.51174,18.2466,1559
238138,3499E731A877B5132E572C7056EDDA83,31261,15,18,3,109.51174,18.2466,1559
238139,3499E731A877B5132E572C7056EDDA83,30421,18,19,1,109.50021,18.25861,1511
238140,3499E731A877B5132E572C7056EDDA83,31261,20,22,2,109.51174,18.2466,1559
238143,AAD294F97E8F953422B544ED61B36D13,31071,0,6,6,109.58257,18.28458,1815
238144,AAD294F97E8F953422B544ED61B36D13,31551,8,10,2,109.55868,18.24222,1708
238145,AAD294F97E8F953422B544ED61B36D13,31554,15,16,1,109.55521,18.2459,1709
238148,A11F3A10732BFDE382AECA973824C570,60614,0,1,1,109.48799,18.29521,1467
238149,A11F3A10732BFDE382AECA973824C570,30111,2,3,1,109.47583,18.30542,1419
238150,A11F3A10732BFDE382AECA973824C570,30821,5,6,1,109.43681,18.33639,1274
238161,EFFEF00C078D502D6D0D1D469ACBA466,30421,0,7,7,109.50021,18.25861,1511
238162,EFFEF00C078D502D6D0D1D469ACBA466,31031,9,10,1,109.49979,18.25382,1510
238163,EFFEF00C078D502D6D0D1D469ACBA466,39041,12,15,3,109.40021,18.29278,1117
238164,EFFEF00C078D502D6D0D1D469ACBA466,31471,15,17,2,109.34583,18.29563,917
238165,EFFEF00C078D502D6D0D1D469ACBA466,30421,19,23,4,109.50021,18.25861,1511
238192,DA5E6B13E9B86E6A18C6646FBB376A74,31251,19,22,3,109.18528,18.2975,317
238204,D2A5F87218CF25385163A2F3C4229CB8,30851,0,8,8,109.5616,18.27396,1713
238205,D2A5F87218CF25385163A2F3C4229CB8,31561,8,9,1,109.56792,18.28479,1765
238206,D2A5F87218CF25385163A2F3C4229CB8,30851,14,23,9,109.5616,18.27396,1713
238235,8DD23AA43C0F7967C45F7488D66F9159,31945,1,3,2,109.58021,18.29403,1817
238236,8DD23AA43C0F7967C45F7488D66F9159,30854,5,17,12,109.56889,18.27076,1763
238237,8DD23AA43C0F7967C45F7488D66F9159,31821,18,20,2,109.51181,18.24924,1559
238238,8DD23AA43C0F7967C45F7488D66F9159,31071,22,23,1,109.58257,18.28458,1815
238247,BD4652414D5C17466BA36FD4BD943A94,30721,0,3,3,109.51597,18.28257,1565
238248,BD4652414D5C17466BA36FD4BD943A94,60221,3,4,1,109.52569,18.29188,1616
238249,BD4652414D5C17466BA36FD4BD943A94,30721,5,6,1,109.51597,18.28257,1565
238250,BD4652414D5C17466BA36FD4BD943A94,31931,9,17,8,109.54771,18.29403,1667
238251,BD4652414D5C17466BA36FD4BD943A94,30281,21,23,2,109.50597,18.27583,1514
238252,DF49F834C08C7E8FA6D78272EE1FB651,60361,0,6,6,109.51938,18.29681,1567
238253,DF49F834C08C7E8FA6D78272EE1FB651,30951,7,12,5,109.56208,18.25667,1761
238254,DF49F834C08C7E8FA6D78272EE1FB651,39371,13,14,1,109.56627,18.2646,1762
238255,DF49F834C08C7E8FA6D78272EE1FB651,31551,15,17,2,109.55868,18.24222,1708
238256,DF49F834C08C7E8FA6D78272EE1FB651,60361,19,23,4,109.51938,18.29681,1567
238257,20A86C2AFD3DB5CCAEE5E583E8659561,60411,15,16,1,109.32514,18.30854,869
238258,20A86C2AFD3DB5CCAEE5E583E8659561,31471,17,18,1,109.34583,18.29563,917
238282,598A3D86FECCB6897F5914EE10CDED04,30051,0,1,1,109.48917,18.21215,1453
238283,598A3D86FECCB6897F5914EE10CDED04,31031,2,6,4,109.49979,18.25382,1510
238284,598A3D86FECCB6897F5914EE10CDED04,30051,7,22,15,109.48917,18.21215,1453
238318,6D2D20F4D67580FE7309C23DCCA820C3,39371,12,15,3,109.56627,18.2646,1762
238319,6D2D20F4D67580FE7309C23DCCA820C3,31071,18,23,5,109.58257,18.28458,1815
238320,6129383099E3ED1C56067EF35AD26C00,30191,0,10,10,109.50361,18.22701,1506
238321,6129383099E3ED1C56067EF35AD26C00,31206,12,13,1,109.50819,18.23549,1507
238322,6129383099E3ED1C56067EF35AD26C00,31521,18,22,4,109.51458,18.22542,1555
238331,4257B02173BB27432EB8329AFD2B7099,31461,0,7,7,109.5091,18.25389,1510
238332,4257B02173BB27432EB8329AFD2B7099,60641,8,9,1,109.53854,18.2359,1657
238335,4257B02173BB27432EB8329AFD2B7099,30711,20,21,1,109.50271,18.25347,1510
238336,4257B02173BB27432EB8329AFD2B7099,31461,21,23,2,109.5091,18.25389,1510
238345,CCA3BC1D276A172225FD62BE51B3EFF1,30071,0,8,8,109.52819,18.30472,1619
238346,CCA3BC1D276A172225FD62BE51B3EFF1,30854,10,22,12,109.56889,18.27076,1763
238363,BC2EDF4DF9C7FAD55BDEABA03DFA7284,31561,0,5,5,109.56792,18.28479,1765
238364,BC2EDF4DF9C7FAD55BDEABA03DFA7284,30854,6,7,1,109.56889,18.27076,1763
238365,BC2EDF4DF9C7FAD55BDEABA03DFA7284,31561,11,23,12,109.56792,18.28479,1765
238366,C85D0B931BEF54F05B9ABBBB03212DB7,31561,17,20,3,109.56792,18.28479,1765
238367,C85D0B931BEF54F05B9ABBBB03212DB7,30854,20,22,2,109.56889,18.27076,1763
238377,91B67A451BCA48674F80C454F3D349F4,39181,5,8,3,109.55153,18.28035,1715
238378,91B67A451BCA48674F80C454F3D349F4,31931,9,15,6,109.54771,18.29403,1667
238379,91B67A451BCA48674F80C454F3D349F4,39181,19,23,4,109.55153,18.28035,1715
238393,DCA1D430D03AF7D60DA281B113343E54,31181,12,16,4,109.50382,18.24813,1509
238394,DCA1D430D03AF7D60DA281B113343E54,31181,20,23,3,109.50382,18.24813,1509
238395,484EFAC2C861BC20EAA5F2A8AB0F5DBE,31851,0,9,9,109.71736,18.29007,2316
238396,484EFAC2C861BC20EAA5F2A8AB0F5DBE,38023,13,15,2,109.37132,18.28993,1016
238397,484EFAC2C861BC20EAA5F2A8AB0F5DBE,30361,19,21,2,109.50347,18.24,1508
238431,7B2AEE2086698683607EDDDB4B678234,38154,0,6,6,109.5266,18.28278,1615
238432,7B2AEE2086698683607EDDDB4B678234,60221,6,8,2,109.52569,18.29188,1616
238433,7B2AEE2086698683607EDDDB4B678234,38154,10,12,2,109.5266,18.28278,1615
238434,7B2AEE2086698683607EDDDB4B678234,60221,16,18,2,109.52569,18.29188,1616
238478,25B4C854981734ED59D516788F928C4F,30651,0,1,1,109.42611,18.385,1232
238479,25B4C854981734ED59D516788F928C4F,60524,1,4,3,109.42951,18.28993,1216
238480,25B4C854981734ED59D516788F928C4F,60491,5,6,1,109.43354,18.30847,1269
238481,25B4C854981734ED59D516788F928C4F,31101,12,17,5,109.65389,18.23403,2057
238482,25B4C854981734ED59D516788F928C4F,60381,19,20,1,109.5241,18.22458,1605
238487,2A6BA0678DDF16AF08BAC9E3FA3C9391,31561,0,1,1,109.56792,18.28479,1765
238488,2A6BA0678DDF16AF08BAC9E3FA3C9391,30854,1,21,20,109.56889,18.27076,1763
238500,928DF0385E8541CFD2F5858501C04155,60631,14,15,1,109.57778,18.27583,1814
238501,928DF0385E8541CFD2F5858501C04155,30854,17,18,1,109.56889,18.27076,1763
238516,796508A45D039A2F5E7DA411A8474D31,30234,0,7,7,109.60681,18.29979,1918
238517,796508A45D039A2F5E7DA411A8474D31,30854,12,16,4,109.56889,18.27076,1763
238518,796508A45D039A2F5E7DA411A8474D31,30234,17,21,4,109.60681,18.29979,1918
238519,EA4D123112CD0AE32B6D1280D2074CF8,30921,0,7,7,109.53903,18.29451,1667
238520,EA4D123112CD0AE32B6D1280D2074CF8,31931,7,12,5,109.54771,18.29403,1667
238521,EA4D123112CD0AE32B6D1280D2074CF8,30921,14,23,9,109.53903,18.29451,1667
238538,75817DB682187A07461734D66E1E6492,60631,0,4,4,109.57778,18.27583,1814
238539,75817DB682187A07461734D66E1E6492,30854,4,15,11,109.56889,18.27076,1763
238540,75817DB682187A07461734D66E1E6492,31061,19,20,1,109.53333,18.23257,1607
238541,75817DB682187A07461734D66E1E6492,60631,21,23,2,109.57778,18.27583,1814
238557,E16204D131FCD957D5ADB9592C1DD0ED,31071,15,16,1,109.58257,18.28458,1815
238558,E16204D131FCD957D5ADB9592C1DD0ED,30151,18,20,2,109.50986,18.25083,1560
238559,E16204D131FCD957D5ADB9592C1DD0ED,30854,22,23,1,109.56889,18.27076,1763
238562,005F3AEFE6DBF371ED1FD57736434098,31071,0,7,7,109.58257,18.28458,1815
238563,005F3AEFE6DBF371ED1FD57736434098,30854,7,16,9,109.56889,18.27076,1763
238571,A0044447FA8420B2798FCE6C61B6C8EC,60221,18,21,3,109.52569,18.29188,1616
238572,A0044447FA8420B2798FCE6C61B6C8EC,30821,21,22,1,109.43681,18.33639,1274
238582,0BC29A1A1F07D7BE709DDB240D6FBF8E,38261,0,8,8,109.50361,18.28153,1515
238583,0BC29A1A1F07D7BE709DDB240D6FBF8E,38171,10,16,6,109.50799,18.28139,1515
238584,0BC29A1A1F07D7BE709DDB240D6FBF8E,31521,17,18,1,109.51458,18.22542,1555
238585,0BC29A1A1F07D7BE709DDB240D6FBF8E,30084,21,23,2,109.50118,18.26972,1513
238598,21C679D1B9FF307EA1AC2A89744209FE,38291,0,19,19,109.51618,18.24313,1558
238599,21C679D1B9FF307EA1AC2A89744209FE,60281,20,21,1,109.51743,18.25924,1561
238628,BAB9B8A3D1E7FB96DB94A06687C464B3,60504,12,14,2,109.47917,18.28903,1416
238629,BAB9B8A3D1E7FB96DB94A06687C464B3,60281,18,21,3,109.51743,18.25924,1561
238630,BAB9B8A3D1E7FB96DB94A06687C464B3,60504,21,23,2,109.47917,18.28903,1416
238633,4DA47CA7E0DF1887A4FCFA8DEF75F8FC,31761,0,7,7,109.60521,18.27965,1914
238634,4DA47CA7E0DF1887A4FCFA8DEF75F8FC,31421,8,11,3,109.55382,18.22347,1705
238635,4DA47CA7E0DF1887A4FCFA8DEF75F8FC,30951,12,15,3,109.56208,18.25667,1761
238636,4DA47CA7E0DF1887A4FCFA8DEF75F8FC,31421,15,17,2,109.55382,18.22347,1705
238637,4DA47CA7E0DF1887A4FCFA8DEF75F8FC,31761,19,23,4,109.60521,18.27965,1914
238656,BD1C8CAB0CA377D9350002A865081450,30251,0,7,7,109.50611,18.26653,1512
238657,BD1C8CAB0CA377D9350002A865081450,30251,8,12,4,109.50611,18.26653,1512
238658,BD1C8CAB0CA377D9350002A865081450,31021,13,14,1,109.49021,18.27,1463
238660,0E8806AF5B9D2CE792CB9EAFD9A3F05B,31471,13,15,2,109.34583,18.29563,917
238661,0E8806AF5B9D2CE792CB9EAFD9A3F05B,31031,18,19,1,109.49979,18.25382,1510
238662,0E8806AF5B9D2CE792CB9EAFD9A3F05B,60131,19,23,4,109.49819,18.24778,1509
238669,C19430CE8DF26BDEF43903E57E682236,31561,0,14,14,109.56792,18.28479,1765
238670,C19430CE8DF26BDEF43903E57E682236,30854,18,19,1,109.56889,18.27076,1763
238671,C19430CE8DF26BDEF43903E57E682236,31561,20,23,3,109.56792,18.28479,1765
238678,17A4545370685D172A08774EFEF86DD3,31071,0,2,2,109.58257,18.28458,1815
238679,17A4545370685D172A08774EFEF86DD3,30851,4,5,1,109.5616,18.27396,1713
238680,17A4545370685D172A08774EFEF86DD3,39181,7,16,9,109.55153,18.28035,1715
238681,E9B9BA7767032FDC0F26CEC5BEDEFC07,30721,0,7,7,109.51597,18.28257,1565
238682,E9B9BA7767032FDC0F26CEC5BEDEFC07,30181,7,14,7,109.51597,18.23313,1557
238683,E9B9BA7767032FDC0F26CEC5BEDEFC07,30854,14,17,3,109.56889,18.27076,1763
238684,E9B9BA7767032FDC0F26CEC5BEDEFC07,60221,20,21,1,109.52569,18.29188,1616
238689,E6541B4F346982101D887BAAF0315541,30854,0,7,7,109.56889,18.27076,1763
238690,E6541B4F346982101D887BAAF0315541,30851,8,9,1,109.5616,18.27396,1713
238691,E6541B4F346982101D887BAAF0315541,30854,10,18,8,109.56889,18.27076,1763
238713,A578E4F421C7FF132B9DFBF29E0D4AA7,31206,18,20,2,109.50819,18.23549,1507
238714,A578E4F421C7FF132B9DFBF29E0D4AA7,30111,21,23,2,109.47583,18.30542,1419
238732,9C59465A99C2310EA18900FDBD540F4D,60221,15,17,2,109.52569,18.29188,1616
238733,9C59465A99C2310EA18900FDBD540F4D,30211,19,20,1,109.49882,18.23931,1508
238742,7252A0F90E29EC78621699C082578EF7,31361,0,6,6,109.47417,18.28292,1415
238743,7252A0F90E29EC78621699C082578EF7,60504,8,9,1,109.47917,18.28903,1416
238744,7252A0F90E29EC78621699C082578EF7,31201,14,15,1,109.51042,18.23819,1558
238745,7252A0F90E29EC78621699C082578EF7,38971,17,19,2,109.50743,18.25125,1510
238748,CE70D3AAC3EF6B01DB8A5F34BD94E77D,30651,2,3,1,109.42611,18.385,1232
238749,CE70D3AAC3EF6B01DB8A5F34BD94E77D,30821,7,8,1,109.43681,18.33639,1274
238750,CE70D3AAC3EF6B01DB8A5F34BD94E77D,30651,8,11,3,109.42611,18.385,1232
238751,CE70D3AAC3EF6B01DB8A5F34BD94E77D,30821,12,21,9,109.43681,18.33639,1274
238764,DF5EBFA9D0614A60E8475DE83F0E910D,30151,0,8,8,109.50986,18.25083,1560
238765,DF5EBFA9D0614A60E8475DE83F0E910D,30711,12,16,4,109.50271,18.25347,1510
238766,DF5EBFA9D0614A60E8475DE83F0E910D,30421,16,18,2,109.50021,18.25861,1511
238767,DF5EBFA9D0614A60E8475DE83F0E910D,30711,18,20,2,109.50271,18.25347,1510
238768,DF5EBFA9D0614A60E8475DE83F0E910D,30151,21,23,2,109.50986,18.25083,1560
238814,27BCEF3137923B84211F08830816C810,30851,0,8,8,109.5616,18.27396,1713
238816,B90755FA392DFA726BB1851A64C95B6A,60661,3,5,2,109.548,18.2377,1657
238817,B90755FA392DFA726BB1851A64C95B6A,60381,7,15,8,109.5241,18.22458,1605
238818,B90755FA392DFA726BB1851A64C95B6A,31421,15,22,7,109.55382,18.22347,1705
238819,B8CB04B5978E578E24238F20101B548F,31521,0,7,7,109.51458,18.22542,1555
238820,B8CB04B5978E578E24238F20101B548F,33051,11,13,2,109.6475,18.46618,2096
238822,B8CB04B5978E578E24238F20101B548F,60221,19,21,2,109.52569,18.29188,1616
238833,5426296000364EE32711CD0E73D782C8,31071,1,6,5,109.58257,18.28458,1815
238834,5426296000364EE32711CD0E73D782C8,31561,9,15,6,109.56792,18.28479,1765
238835,5426296000364EE32711CD0E73D782C8,30854,19,23,4,109.56889,18.27076,1763
238892,4995463B780282C9C030A19D9F49AEAC,31561,3,4,1,109.56792,18.28479,1765
238893,4995463B780282C9C030A19D9F49AEAC,30854,8,19,11,109.56889,18.27076,1763
238925,C46F5343DCC792762EF674294DA84608,31471,9,12,3,109.34583,18.29563,917
238926,C46F5343DCC792762EF674294DA84608,30731,15,16,1,109.50944,18.22306,1555
238927,C46F5343DCC792762EF674294DA84608,31521,17,18,1,109.51458,18.22542,1555
238928,C46F5343DCC792762EF674294DA84608,60524,20,21,1,109.42951,18.28993,1216
238929,C46F5343DCC792762EF674294DA84608,30731,22,23,1,109.50944,18.22306,1555
238971,4CA9DD8009173FEDF1859DA7E6FBCAB5,38271,10,11,1,109.62632,18.23049,1956
238972,4CA9DD8009173FEDF1859DA7E6FBCAB5,31101,12,16,4,109.65389,18.23403,2057
238973,4CA9DD8009173FEDF1859DA7E6FBCAB5,60011,19,20,1,109.48965,18.30222,1468
238990,5D50FA1646C1483F562F3711A49AB3EA,31021,2,4,2,109.49021,18.27,1463
238991,5D50FA1646C1483F562F3711A49AB3EA,30201,4,6,2,109.4909,18.26465,1462
238992,5D50FA1646C1483F562F3711A49AB3EA,31021,7,10,3,109.49021,18.27,1463
238993,5D50FA1646C1483F562F3711A49AB3EA,31471,13,14,1,109.34583,18.29563,917
238994,5D50FA1646C1483F562F3711A49AB3EA,31021,16,22,6,109.49021,18.27,1463
239013,6FBDDF7419820F8908B8A8CE3C81E7C3,60621,16,17,1,109.48354,18.27451,1464
239014,6FBDDF7419820F8908B8A8CE3C81E7C3,60401,19,22,3,109.47444,18.27583,1414
239018,8C8DB7A18864109B823771C405E00B29,60351,0,6,6,109.58403,18.28958,1816
239019,8C8DB7A18864109B823771C405E00B29,30851,11,12,1,109.5616,18.27396,1713
239020,8C8DB7A18864109B823771C405E00B29,30951,13,14,1,109.56208,18.25667,1761
239021,8C8DB7A18864109B823771C405E00B29,31421,17,23,6,109.55382,18.22347,1705
239033,B340EDEF4A878E8DF5CBEC25E465EACE,30191,0,1,1,109.50361,18.22701,1506
239034,B340EDEF4A878E8DF5CBEC25E465EACE,30854,2,10,8,109.56889,18.27076,1763
239035,B340EDEF4A878E8DF5CBEC25E465EACE,31071,12,14,2,109.58257,18.28458,1815
239036,B340EDEF4A878E8DF5CBEC25E465EACE,30854,15,17,2,109.56889,18.27076,1763
239037,B340EDEF4A878E8DF5CBEC25E465EACE,31551,20,21,1,109.55868,18.24222,1708
239083,BD5AAE5CF6AC8F1E6005714E36EC9220,30161,0,9,9,109.50042,18.24389,1508
239084,BD5AAE5CF6AC8F1E6005714E36EC9220,60131,11,20,9,109.49819,18.24778,1509
239096,1D2F8DB1F8B6A2081E1A43DDF558491D,31951,0,14,14,109.52174,18.30299,1568
239097,1D2F8DB1F8B6A2081E1A43DDF558491D,38484,15,17,2,109.53028,18.31528,1620
239098,1D2F8DB1F8B6A2081E1A43DDF558491D,31951,18,22,4,109.52174,18.30299,1568
239102,662D882A6A10D0E6C3566690F0A40636,31071,1,8,7,109.58257,18.28458,1815
239103,662D882A6A10D0E6C3566690F0A40636,30854,8,9,1,109.56889,18.27076,1763
239104,662D882A6A10D0E6C3566690F0A40636,31071,11,20,9,109.58257,18.28458,1815
239105,662D882A6A10D0E6C3566690F0A40636,30191,21,23,2,109.50361,18.22701,1506
239114,0526FBDD03CECB7E3925506B4441EC17,31041,0,8,8,109.50278,18.23701,1507
239115,0526FBDD03CECB7E3925506B4441EC17,30511,8,17,9,109.51069,18.24208,1558
239116,0526FBDD03CECB7E3925506B4441EC17,31443,17,23,6,109.5116,18.24438,1559
239148,292F7AA5A13D44513985CC059AB0B0E9,60641,19,21,2,109.53854,18.2359,1657
239149,292F7AA5A13D44513985CC059AB0B0E9,60354,21,22,1,109.58701,18.28521,1815
239185,D1EBD1A5A8A922DEF994C933F10DD8DB,30161,0,5,5,109.50042,18.24389,1508
239186,D1EBD1A5A8A922DEF994C933F10DD8DB,39151,7,8,1,109.49875,18.25097,1510
239187,D1EBD1A5A8A922DEF994C933F10DD8DB,60381,11,15,4,109.5241,18.22458,1605
239188,D1EBD1A5A8A922DEF994C933F10DD8DB,30721,17,19,2,109.51597,18.28257,1565
239189,D1EBD1A5A8A922DEF994C933F10DD8DB,60131,21,23,2,109.49819,18.24778,1509
239202,F71405344B971967BDA24B8D31704EA3,30854,1,5,4,109.56889,18.27076,1763
239203,F71405344B971967BDA24B8D31704EA3,39331,9,16,7,109.62125,18.22708,1956
239204,F71405344B971967BDA24B8D31704EA3,30854,18,20,2,109.56889,18.27076,1763
239205,F71405344B971967BDA24B8D31704EA3,31071,22,23,1,109.58257,18.28458,1815
239221,0E0D6E55BB1995EBF85F6B7AA8765E55,30854,0,10,10,109.56889,18.27076,1763
239222,0E0D6E55BB1995EBF85F6B7AA8765E55,38271,15,22,7,109.62632,18.23049,1956
239237,2D39AE6120F2674000C6DBB8A6E572A0,31945,1,7,6,109.58021,18.29403,1817
239238,2D39AE6120F2674000C6DBB8A6E572A0,30854,7,12,5,109.56889,18.27076,1763
239239,2D39AE6120F2674000C6DBB8A6E572A0,31945,12,13,1,109.58021,18.29403,1817
239240,2D39AE6120F2674000C6DBB8A6E572A0,31071,14,15,1,109.58257,18.28458,1815
239241,2D39AE6120F2674000C6DBB8A6E572A0,30854,16,17,1,109.56889,18.27076,1763
239242,2D39AE6120F2674000C6DBB8A6E572A0,31071,21,22,1,109.58257,18.28458,1815
239261,770A00BDAFE9BCA8C9E9FA68066EED7D,31071,0,6,6,109.58257,18.28458,1815
239262,770A00BDAFE9BCA8C9E9FA68066EED7D,31561,7,20,13,109.56792,18.28479,1765
239263,770A00BDAFE9BCA8C9E9FA68066EED7D,31071,21,23,2,109.58257,18.28458,1815
239266,8E26BB9FD64561D71CF8747E8BA22405,60441,15,17,2,109.46792,18.28604,1366
239267,8E26BB9FD64561D71CF8747E8BA22405,30354,18,20,2,109.42813,18.29076,1216
239268,8E26BB9FD64561D71CF8747E8BA22405,31231,21,23,2,109.42597,18.29292,1217
239281,A6CCB3B38301DFF4978B708468E178C6,38291,1,12,11,109.51618,18.24313,1558
239282,A6CCB3B38301DFF4978B708468E178C6,38291,14,16,2,109.51618,18.24313,1558
239283,A6CCB3B38301DFF4978B708468E178C6,30271,16,18,2,109.49132,18.23153,1456
239284,A6CCB3B38301DFF4978B708468E178C6,31461,19,23,4,109.5091,18.25389,1510
239296,CAD1873E143F5B0D99D502636D066F27,33051,13,14,1,109.6475,18.46618,2096
239297,CAD1873E143F5B0D99D502636D066F27,60401,18,23,5,109.47444,18.27583,1414
239301,F5FE23BF42FC224C310CD42E08B0B950,31431,0,7,7,109.44639,18.29042,1316
239302,F5FE23BF42FC224C310CD42E08B0B950,30764,7,11,4,109.45806,18.29486,1367
239303,F5FE23BF42FC224C310CD42E08B0B950,38094,12,14,2,109.45403,18.28778,1316
239304,F5FE23BF42FC224C310CD42E08B0B950,60441,14,16,2,109.46792,18.28604,1366
239305,F5FE23BF42FC224C310CD42E08B0B950,31431,18,22,4,109.44639,18.29042,1316
239369,FFFC0994E5C15BDB165344716912442C,31554,0,1,1,109.55521,18.2459,1709
239370,FFFC0994E5C15BDB165344716912442C,30854,2,6,4,109.56889,18.27076,1763
239371,FFFC0994E5C15BDB165344716912442C,31554,6,17,11,109.55521,18.2459,1709
239372,FFFC0994E5C15BDB165344716912442C,31551,19,20,1,109.55868,18.24222,1708
239373,FFFC0994E5C15BDB165344716912442C,30854,21,23,2,109.56889,18.27076,1763
239374,1236E803BFC9C4343D57A1C8A6EC03E5,30441,18,20,2,109.64021,18.25424,2010
239375,1236E803BFC9C4343D57A1C8A6EC03E5,38271,20,23,3,109.62632,18.23049,1956
239379,9FEA4B85EAE4FAEE1CAF0EABFF2FAEA1,30854,0,5,5,109.56889,18.27076,1763
239380,9FEA4B85EAE4FAEE1CAF0EABFF2FAEA1,39183,7,17,10,109.55542,18.28208,1715
239381,9FEA4B85EAE4FAEE1CAF0EABFF2FAEA1,31561,18,20,2,109.56792,18.28479,1765
239444,C01D7F4C525517694A04D5EAA5AD2420,31071,0,8,8,109.58257,18.28458,1815
239445,C01D7F4C525517694A04D5EAA5AD2420,39183,8,9,1,109.55542,18.28208,1715
239446,C01D7F4C525517694A04D5EAA5AD2420,31071,12,14,2,109.58257,18.28458,1815
239466,94C4D5691F7DFC1AB38806AFFAC1389E,31931,0,3,3,109.54771,18.29403,1667
239467,94C4D5691F7DFC1AB38806AFFAC1389E,30921,3,8,5,109.53903,18.29451,1667
239468,94C4D5691F7DFC1AB38806AFFAC1389E,31931,10,19,9,109.54771,18.29403,1667
239474,C3EF49B0098C6C3C4B26CC8869DE86AF,30854,0,6,6,109.56889,18.27076,1763
239475,C3EF49B0098C6C3C4B26CC8869DE86AF,38271,8,15,7,109.62632,18.23049,1956
239476,C3EF49B0098C6C3C4B26CC8869DE86AF,30854,19,23,4,109.56889,18.27076,1763
239509,9FC721E86703223349C05C95FE4BBB6F,60081,0,10,10,109.51097,18.22639,1556
239510,9FC721E86703223349C05C95FE4BBB6F,31521,11,13,2,109.51458,18.22542,1555
239511,9FC721E86703223349C05C95FE4BBB6F,60381,13,16,3,109.5241,18.22458,1605
239512,9FC721E86703223349C05C95FE4BBB6F,31521,19,20,1,109.51458,18.22542,1555
239513,9FC721E86703223349C05C95FE4BBB6F,60087,21,23,2,109.50688,18.22299,1505
239525,B81DEDE33B0853E35D97557F334A4861,60361,0,6,6,109.51938,18.29681,1567
239526,B81DEDE33B0853E35D97557F334A4861,60371,7,11,4,109.53063,18.30056,1618
239527,B81DEDE33B0853E35D97557F334A4861,31931,12,15,3,109.54771,18.29403,1667
239528,B81DEDE33B0853E35D97557F334A4861,60361,19,23,4,109.51938,18.29681,1567
239564,A68637AA89BD62624E677D9E66C32FAD,30161,16,18,2,109.50042,18.24389,1508
239565,A68637AA89BD62624E677D9E66C32FAD,30161,18,20,2,109.50042,18.24389,1508
239566,A68637AA89BD62624E677D9E66C32FAD,30361,20,23,3,109.50347,18.24,1508
239579,E8D51F8B53F290BFD73338AD2AD8C728,30851,6,11,5,109.5616,18.27396,1713
239580,E8D51F8B53F290BFD73338AD2AD8C728,31561,14,22,8,109.56792,18.28479,1765
239594,B5EEA30F2FFAABF51AE99311CDE9203E,39111,13,16,3,109.5191,18.22597,1555
239595,B5EEA30F2FFAABF51AE99311CDE9203E,31851,20,23,3,109.71736,18.29007,2316
239596,D77A5C2E97A74D805A87772560CE2BFF,60381,0,1,1,109.5241,18.22458,1605
239597,D77A5C2E97A74D805A87772560CE2BFF,60661,4,14,10,109.548,18.2377,1657
239598,D77A5C2E97A74D805A87772560CE2BFF,60381,14,15,1,109.5241,18.22458,1605
239599,D77A5C2E97A74D805A87772560CE2BFF,31421,15,19,4,109.55382,18.22347,1705
239600,D77A5C2E97A74D805A87772560CE2BFF,60381,21,23,2,109.5241,18.22458,1605
239652,B17D654C0C5F0BF2FDFE2DB8B9C0B83F,60201,1,12,11,109.5041,18.2509,1510
239653,B17D654C0C5F0BF2FDFE2DB8B9C0B83F,31551,14,23,9,109.55868,18.24222,1708
239656,0CB59E8D868A989F35AA087C24245C30,31145,12,14,2,109.20431,18.30479,369
239657,0CB59E8D868A989F35AA087C24245C30,31531,16,22,6,109.49583,18.25972,1461
239685,F592C1A402E42DAA2D50FA0B88EFA69E,31781,12,13,1,109.19847,18.2975,367
239686,F592C1A402E42DAA2D50FA0B88EFA69E,31471,15,16,1,109.34583,18.29563,917
239687,F592C1A402E42DAA2D50FA0B88EFA69E,31473,16,17,1,109.34792,18.29465,917
239688,F592C1A402E42DAA2D50FA0B88EFA69E,60621,20,23,3,109.48354,18.27451,1464
239695,41BFDF202AA15C7D0EC7487840A4D094,30854,4,16,12,109.56889,18.27076,1763
239696,41BFDF202AA15C7D0EC7487840A4D094,30851,19,23,4,109.5616,18.27396,1713
239708,C4438C562FDBCEB6780A30DCF3B1E6F9,38361,0,7,7,109.43667,18.29201,1267
239709,C4438C562FDBCEB6780A30DCF3B1E6F9,31781,10,12,2,109.19847,18.2975,367
239710,C4438C562FDBCEB6780A30DCF3B1E6F9,38754,14,15,1,109.74667,18.37382,2430
239711,C4438C562FDBCEB6780A30DCF3B1E6F9,31701,19,21,2,109.44132,18.28833,1266
239712,C4438C562FDBCEB6780A30DCF3B1E6F9,30671,21,23,2,109.43611,18.30139,1268
239770,0D3DA8126B134D203BB35373EAFFB116,31071,1,7,6,109.58257,18.28458,1815
239771,0D3DA8126B134D203BB35373EAFFB116,30854,7,19,12,109.56889,18.27076,1763
239775,D334753E33AD01D79142036B3D85543F,31561,0,5,5,109.56792,18.28479,1765
239776,D334753E33AD01D79142036B3D85543F,39183,7,9,2,109.55542,18.28208,1715
239777,D334753E33AD01D79142036B3D85543F,31561,11,13,2,109.56792,18.28479,1765
239778,D334753E33AD01D79142036B3D85543F,39183,13,14,1,109.55542,18.28208,1715
239784,00145806BBF2F60A963743509F901155,30251,13,14,1,109.50611,18.26653,1512
239785,00145806BBF2F60A963743509F901155,38127,14,17,3,109.50833,18.27222,1513
239786,00145806BBF2F60A963743509F901155,30291,20,23,3,109.50403,18.27028,1513
239860,A4AA22255ADB44C4AEE3D0925A88CC85,33481,11,12,1,109.67278,18.41278,2187
239861,A4AA22255ADB44C4AEE3D0925A88CC85,60631,16,19,3,109.57778,18.27583,1814
239862,A4AA22255ADB44C4AEE3D0925A88CC85,39371,21,23,2,109.56627,18.2646,1762
239863,1F299DFBDC4CE2BBEA4B3C7942B5689A,30111,0,5,5,109.47583,18.30542,1419
239864,1F299DFBDC4CE2BBEA4B3C7942B5689A,30761,6,7,1,109.45201,18.3,1318
239884,A9FCE0049DB44FE004EAFBF5B783F4A5,31945,0,7,7,109.58021,18.29403,1817
239885,A9FCE0049DB44FE004EAFBF5B783F4A5,30854,9,16,7,109.56889,18.27076,1763
239886,A9FCE0049DB44FE004EAFBF5B783F4A5,31945,20,23,3,109.58021,18.29403,1817
239905,E21BDA79D452CC6D5F26BA60A43939EC,38911,0,3,3,109.51674,18.24965,1559
239906,E21BDA79D452CC6D5F26BA60A43939EC,60291,5,6,1,109.50826,18.24639,1509
239907,E21BDA79D452CC6D5F26BA60A43939EC,38911,7,8,1,109.51674,18.24965,1559
239921,A0A64B9DC3ED1CC036ADF6A1DF77C5F0,60111,7,9,2,109.72556,18.31924,2371
239941,57F32DEB2DABC348C903B63D4D932E2A,33481,14,15,1,109.67278,18.41278,2187
239942,57F32DEB2DABC348C903B63D4D932E2A,31521,19,21,2,109.51458,18.22542,1555
239943,8E06EAC16B0EF776FA1BAAC5B9747325,30511,0,5,5,109.51069,18.24208,1558
239944,8E06EAC16B0EF776FA1BAAC5B9747325,60114,7,15,8,109.73028,18.33847,2374
239952,201045A9C980BD8E53B16B9129DFE596,31071,0,6,6,109.58257,18.28458,1815
239953,201045A9C980BD8E53B16B9129DFE596,30854,10,12,2,109.56889,18.27076,1763
239954,201045A9C980BD8E53B16B9129DFE596,31071,12,16,4,109.58257,18.28458,1815
239955,201045A9C980BD8E53B16B9129DFE596,30854,18,19,1,109.56889,18.27076,1763
239956,201045A9C980BD8E53B16B9129DFE596,31071,19,21,2,109.58257,18.28458,1815
239963,7235BA08EE35A76A07D4EF6E9B8C7C54,38251,15,18,3,109.49618,18.25493,1510
239964,7235BA08EE35A76A07D4EF6E9B8C7C54,60131,20,22,2,109.49819,18.24778,1509
239965,7235BA08EE35A76A07D4EF6E9B8C7C54,38251,22,23,1,109.49618,18.25493,1510
239977,84DF4A7C208235D171EF56473BCCF210,30851,0,3,3,109.5616,18.27396,1713
239978,84DF4A7C208235D171EF56473BCCF210,31561,4,7,3,109.56792,18.28479,1765
239979,84DF4A7C208235D171EF56473BCCF210,60631,7,17,10,109.57778,18.27583,1814
239980,A01700F052FB9835E044C88292490989,60631,0,8,8,109.57778,18.27583,1814
239981,A01700F052FB9835E044C88292490989,30854,10,15,5,109.56889,18.27076,1763
239988,1411F9F89E8C658605CC1C5E821DCFD9,31071,1,7,6,109.58257,18.28458,1815
239989,1411F9F89E8C658605CC1C5E821DCFD9,30854,9,15,6,109.56889,18.27076,1763
239990,1411F9F89E8C658605CC1C5E821DCFD9,31071,15,21,6,109.58257,18.28458,1815
239991,1411F9F89E8C658605CC1C5E821DCFD9,30854,22,23,1,109.56889,18.27076,1763
239995,015CDEB9169BCE5537ABAE49B6A63F2B,31071,0,7,7,109.58257,18.28458,1815
239996,015CDEB9169BCE5537ABAE49B6A63F2B,30854,8,15,7,109.56889,18.27076,1763
240003,DC9A97A54E5D5ED65CCD9F39FA1D137B,31521,0,8,8,109.51458,18.22542,1555
240004,DC9A97A54E5D5ED65CCD9F39FA1D137B,31781,11,12,1,109.19847,18.2975,367
240010,EC721F8259E3B17F432086B3F60AECE1,31554,0,5,5,109.55521,18.2459,1709
240011,EC721F8259E3B17F432086B3F60AECE1,30051,6,17,11,109.48917,18.21215,1453
240012,EC721F8259E3B17F432086B3F60AECE1,31554,19,22,3,109.55521,18.2459,1709
240013,41815364176C8443FB68908501751D76,39091,0,10,10,109.50097,18.25222,1510
240017,A94F66C88B84FF0658441320CD9F667C,60631,0,5,5,109.57778,18.27583,1814
240018,A94F66C88B84FF0658441320CD9F667C,31071,5,6,1,109.58257,18.28458,1815
240019,A94F66C88B84FF0658441320CD9F667C,30854,8,17,9,109.56889,18.27076,1763
240023,1C18ED6F5D8A7E272B4C124E5AF1F041,38871,2,3,1,109.44681,18.28625,1316
240024,1C18ED6F5D8A7E272B4C124E5AF1F041,38251,4,6,2,109.49618,18.25493,1510
240025,1C18ED6F5D8A7E272B4C124E5AF1F041,31781,9,11,2,109.19847,18.2975,367
240026,1C18ED6F5D8A7E272B4C124E5AF1F041,31471,14,16,2,109.34583,18.29563,917
240027,1C18ED6F5D8A7E272B4C124E5AF1F041,38251,18,21,3,109.49618,18.25493,1510
240043,9905C3E423D151CCE1280F3A1732CE90,30854,0,6,6,109.56889,18.27076,1763
240044,9905C3E423D151CCE1280F3A1732CE90,30851,7,13,6,109.5616,18.27396,1713
240045,9905C3E423D151CCE1280F3A1732CE90,31071,14,15,1,109.58257,18.28458,1815
240046,9905C3E423D151CCE1280F3A1732CE90,30851,17,18,1,109.5616,18.27396,1713
240047,9905C3E423D151CCE1280F3A1732CE90,30854,19,23,4,109.56889,18.27076,1763
240075,D6A345956751BA2ACC5430EDF68A104F,31931,13,14,1,109.54771,18.29403,1667
240076,D6A345956751BA2ACC5430EDF68A104F,39181,17,19,2,109.55153,18.28035,1715
240077,D6A345956751BA2ACC5430EDF68A104F,39181,21,23,2,109.55153,18.28035,1715
240137,4DE3E9C2C0E7F48C3178063DD53BC336,39091,0,8,8,109.50097,18.25222,1510
240138,4DE3E9C2C0E7F48C3178063DD53BC336,31941,13,17,4,109.62451,18.31222,1970
240155,8C0E6B51FAFE21C31FB9AE08C36DF0A2,30921,0,17,17,109.53903,18.29451,1667
240156,8C0E6B51FAFE21C31FB9AE08C36DF0A2,31931,19,22,3,109.54771,18.29403,1667
240165,934029FB5F97BCE114EDCE88F0393A63,30854,13,18,5,109.56889,18.27076,1763
240166,934029FB5F97BCE114EDCE88F0393A63,39371,22,23,1,109.56627,18.2646,1762
240178,96F98526707B06BE1263CCD4F72E07A1,30854,14,17,3,109.56889,18.27076,1763
240179,96F98526707B06BE1263CCD4F72E07A1,31071,22,23,1,109.58257,18.28458,1815
240183,335A7B1DE8538918FDA774EE3E402A76,60087,0,6,6,109.50688,18.22299,1505
240184,335A7B1DE8538918FDA774EE3E402A76,31521,8,10,2,109.51458,18.22542,1555
240185,335A7B1DE8538918FDA774EE3E402A76,60381,10,12,2,109.5241,18.22458,1605
240186,335A7B1DE8538918FDA774EE3E402A76,30191,13,23,10,109.50361,18.22701,1506
240191,E082FB5BD091C5B334EC1176FF352EE0,60131,15,16,1,109.49819,18.24778,1509
240192,E082FB5BD091C5B334EC1176FF352EE0,30071,19,21,2,109.52819,18.30472,1619
240198,9676D231632C729F79D05034B4DCEB1F,38484,2,11,9,109.53028,18.31528,1620
240199,9676D231632C729F79D05034B4DCEB1F,30561,12,14,2,109.52778,18.31938,1621
240200,9676D231632C729F79D05034B4DCEB1F,38484,15,16,1,109.53028,18.31528,1620
240201,9676D231632C729F79D05034B4DCEB1F,30561,19,23,4,109.52778,18.31938,1621
240216,AA17C9279A63248D7DCDF49F93EB8817,30854,3,5,2,109.56889,18.27076,1763
240217,AA17C9279A63248D7DCDF49F93EB8817,38275,9,18,9,109.62875,18.22938,2006
240218,AA17C9279A63248D7DCDF49F93EB8817,60371,19,21,2,109.53063,18.30056,1618
240219,AA17C9279A63248D7DCDF49F93EB8817,30854,21,23,2,109.56889,18.27076,1763
240247,7050D1E0A5553A00BB03B768ACFBCA8F,31461,19,20,1,109.5091,18.25389,1510
240274,4B0C0C6341A3C2E5744F0897553B14A8,31345,0,9,9,109.39,18.29,1066
240275,4B0C0C6341A3C2E5744F0897553B14A8,31145,10,12,2,109.20431,18.30479,369
240276,4B0C0C6341A3C2E5744F0897553B14A8,38754,14,17,3,109.74667,18.37382,2430
240277,4B0C0C6341A3C2E5744F0897553B14A8,31345,22,23,1,109.39,18.29,1066
240291,6EF68F35CE79552C1164E70C67C72C02,30121,0,8,8,109.52861,18.27222,1613
240292,6EF68F35CE79552C1164E70C67C72C02,30854,10,19,9,109.56889,18.27076,1763
240293,6EF68F35CE79552C1164E70C67C72C02,38251,20,22,2,109.49618,18.25493,1510
240346,6E2021B014C4D0B652A2E4FE8D2CF038,31071,0,7,7,109.58257,18.28458,1815
240347,6E2021B014C4D0B652A2E4FE8D2CF038,30854,8,15,7,109.56889,18.27076,1763
240348,6E2021B014C4D0B652A2E4FE8D2CF038,60221,19,21,2,109.52569,18.29188,1616
240349,6E2021B014C4D0B652A2E4FE8D2CF038,30721,22,23,1,109.51597,18.28257,1565
240367,9C1407835BC54BEBDB541F52E1DA1820,61011,13,20,7,109.60653,18.19076,1900
240403,FBCD6DE6EFAEE2EEF57FF44D1B832782,31081,0,6,6,109.44639,18.30181,1318
240404,FBCD6DE6EFAEE2EEF57FF44D1B832782,60631,9,10,1,109.57778,18.27583,1814
240465,D9689370CD6256E9753C2B0B13067E2B,30854,17,18,1,109.56889,18.27076,1763
240466,D9689370CD6256E9753C2B0B13067E2B,31071,21,23,2,109.58257,18.28458,1815
240487,C82725A09C032EE9BFF2088FCCC60D1D,30854,3,10,7,109.56889,18.27076,1763
240488,C82725A09C032EE9BFF2088FCCC60D1D,60631,12,14,2,109.57778,18.27583,1814
240489,C82725A09C032EE9BFF2088FCCC60D1D,30854,18,19,1,109.56889,18.27076,1763
240490,C82725A09C032EE9BFF2088FCCC60D1D,60631,19,20,1,109.57778,18.27583,1814
240495,DBB710D279E76C79F1E4B0766F579F8A,31071,0,7,7,109.58257,18.28458,1815
240496,DBB710D279E76C79F1E4B0766F579F8A,30854,8,10,2,109.56889,18.27076,1763
240497,DBB710D279E76C79F1E4B0766F579F8A,31071,12,14,2,109.58257,18.28458,1815
240498,DBB710D279E76C79F1E4B0766F579F8A,30854,15,21,6,109.56889,18.27076,1763
240520,8799356B7181F28146A203E5F86C52F0,31351,0,7,7,109.4959,18.28417,1465
240521,8799356B7181F28146A203E5F86C52F0,60231,8,12,4,109.49903,18.21972,1504
240538,DC29C676832347947F366933ECB88090,31561,0,13,13,109.56792,18.28479,1765
240539,DC29C676832347947F366933ECB88090,39183,16,18,2,109.55542,18.28208,1715
240540,DC29C676832347947F366933ECB88090,31561,21,23,2,109.56792,18.28479,1765
240541,C9C1294C451697C4C43F0735BF6751F8,60381,0,8,8,109.5241,18.22458,1605
240542,C9C1294C451697C4C43F0735BF6751F8,60311,9,10,1,109.52097,18.24319,1558
240543,C9C1294C451697C4C43F0735BF6751F8,38754,12,13,1,109.74667,18.37382,2430
240544,C9C1294C451697C4C43F0735BF6751F8,60381,15,18,3,109.5241,18.22458,1605
240545,C9C1294C451697C4C43F0735BF6751F8,60381,20,23,3,109.5241,18.22458,1605
240564,2FE0F3A82C27452F04A6B927F514EFA7,39111,0,1,1,109.5191,18.22597,1555
240565,2FE0F3A82C27452F04A6B927F514EFA7,31551,1,8,7,109.55868,18.24222,1708
240566,2FE0F3A82C27452F04A6B927F514EFA7,31554,13,23,10,109.55521,18.2459,1709
240569,A2DBFF4E352E7B7C1EE25431C02FC741,31931,0,15,15,109.54771,18.29403,1667
240570,A2DBFF4E352E7B7C1EE25431C02FC741,38127,19,21,2,109.50833,18.27222,1513
240575,0BABF9C6516F437130A3DD3C99553A57,31206,0,2,2,109.50819,18.23549,1507
240576,0BABF9C6516F437130A3DD3C99553A57,39191,3,7,4,109.51493,18.23472,1557
240577,0BABF9C6516F437130A3DD3C99553A57,30421,9,11,2,109.50021,18.25861,1511
240578,0BABF9C6516F437130A3DD3C99553A57,31205,11,12,1,109.51111,18.23736,1557
240579,0BABF9C6516F437130A3DD3C99553A57,38157,16,17,1,109.51483,18.26958,1563
240580,0BABF9C6516F437130A3DD3C99553A57,31206,19,23,4,109.50819,18.23549,1507
240627,49970562AFC9FC24214EC6AA61F5B801,60131,0,7,7,109.49819,18.24778,1509
240628,49970562AFC9FC24214EC6AA61F5B801,60381,9,13,4,109.5241,18.22458,1605
240629,49970562AFC9FC24214EC6AA61F5B801,60131,16,18,2,109.49819,18.24778,1509
240630,49970562AFC9FC24214EC6AA61F5B801,38251,20,21,1,109.49618,18.25493,1510
240631,49970562AFC9FC24214EC6AA61F5B801,60131,21,23,2,109.49819,18.24778,1509
240676,1A64C98E678C33D33EBB9AF4943063A2,31071,0,12,12,109.58257,18.28458,1815
240677,1A64C98E678C33D33EBB9AF4943063A2,30854,12,13,1,109.56889,18.27076,1763
240678,1A64C98E678C33D33EBB9AF4943063A2,31071,15,16,1,109.58257,18.28458,1815
240679,1A64C98E678C33D33EBB9AF4943063A2,30201,19,21,2,109.4909,18.26465,1462
240683,94F0184D0BA3E27BCB47A57DA614F9FC,30661,0,8,8,109.37028,18.24361,1008
240684,94F0184D0BA3E27BCB47A57DA614F9FC,60411,8,19,11,109.32514,18.30854,869
240685,94F0184D0BA3E27BCB47A57DA614F9FC,30661,19,22,3,109.37028,18.24361,1008
240686,94F0184D0BA3E27BCB47A57DA614F9FC,60411,22,23,1,109.32514,18.30854,869
240697,EF24901D99384F703B20FE07F2784FA0,30101,0,11,11,109.57299,18.33333,1773
240698,EF24901D99384F703B20FE07F2784FA0,31631,11,18,7,109.59542,18.36826,1879
240699,EF24901D99384F703B20FE07F2784FA0,30101,18,23,5,109.57299,18.33333,1773
240743,BAE056E8B3936B2115FBE7D3C75BEB1E,31031,16,17,1,109.49979,18.25382,1510
240744,BAE056E8B3936B2115FBE7D3C75BEB1E,60551,18,22,4,109.42722,18.30111,1218
240746,208924560927AE5872A8D9BB3F5EF3B6,38171,12,13,1,109.50799,18.28139,1515
240747,208924560927AE5872A8D9BB3F5EF3B6,38261,14,17,3,109.50361,18.28153,1515
240748,208924560927AE5872A8D9BB3F5EF3B6,38171,19,20,1,109.50799,18.28139,1515
240749,208924560927AE5872A8D9BB3F5EF3B6,38171,22,23,1,109.50799,18.28139,1515
240768,1AE87A1A31A67C66BE8B0545FB82EAD0,31561,20,22,2,109.56792,18.28479,1765
240769,1AE87A1A31A67C66BE8B0545FB82EAD0,30851,22,23,1,109.5616,18.27396,1713
240770,1122041491C04B199A15F6E1E401D68F,30461,1,7,6,109.5116,18.26313,1562
240771,1122041491C04B199A15F6E1E401D68F,60281,10,14,4,109.51743,18.25924,1561
240772,1122041491C04B199A15F6E1E401D68F,31821,15,17,2,109.51181,18.24924,1559
240773,1122041491C04B199A15F6E1E401D68F,60281,17,18,1,109.51743,18.25924,1561
240774,1122041491C04B199A15F6E1E401D68F,30461,18,19,1,109.5116,18.26313,1562
240798,821F9E394C1481084AC8949BB7C843D9,30201,0,9,9,109.4909,18.26465,1462
240799,821F9E394C1481084AC8949BB7C843D9,30361,11,12,1,109.50347,18.24,1508
240800,821F9E394C1481084AC8949BB7C843D9,60381,15,17,2,109.5241,18.22458,1605
240801,821F9E394C1481084AC8949BB7C843D9,30161,18,19,1,109.50042,18.24389,1508
240802,821F9E394C1481084AC8949BB7C843D9,30201,20,23,3,109.4909,18.26465,1462
240827,17AA4FA64FF251DAD8C0604E6DEFD71D,30891,0,11,11,109.59431,18.28389,1865
240828,17AA4FA64FF251DAD8C0604E6DEFD71D,30201,13,15,2,109.4909,18.26465,1462
240871,C823928BF46762FC84E04CF2DE7DD0A2,30181,18,19,1,109.51597,18.23313,1557
240872,C823928BF46762FC84E04CF2DE7DD0A2,31061,21,23,2,109.53333,18.23257,1607
240892,012ABD06F231728C214A4BA917E75B1C,31561,0,3,3,109.56792,18.28479,1765
240893,012ABD06F231728C214A4BA917E75B1C,30851,5,11,6,109.5616,18.27396,1713
240894,012ABD06F231728C214A4BA917E75B1C,31561,12,14,2,109.56792,18.28479,1765
240895,012ABD06F231728C214A4BA917E75B1C,30851,14,21,7,109.5616,18.27396,1713
240896,012ABD06F231728C214A4BA917E75B1C,31561,22,23,1,109.56792,18.28479,1765
240903,825AF4749EA05C462EA3CA6A1D524BEA,31101,17,18,1,109.65389,18.23403,2057
240904,825AF4749EA05C462EA3CA6A1D524BEA,30421,19,21,2,109.50021,18.25861,1511
240905,51061B3DE820AF1C1C713EF684728003,30854,1,16,15,109.56889,18.27076,1763
240906,51061B3DE820AF1C1C713EF684728003,31071,20,23,3,109.58257,18.28458,1815
240933,1980C8D409DE9551539224B3D393CDAA,30071,0,2,2,109.52819,18.30472,1619
240934,1980C8D409DE9551539224B3D393CDAA,31951,3,4,1,109.52174,18.30299,1568
240935,1980C8D409DE9551539224B3D393CDAA,30071,5,15,10,109.52819,18.30472,1619
240936,1980C8D409DE9551539224B3D393CDAA,31951,15,19,4,109.52174,18.30299,1568
240948,73FC49A89676FB4107071248ADBDF948,39183,12,14,2,109.55542,18.28208,1715
240949,73FC49A89676FB4107071248ADBDF948,31561,19,23,4,109.56792,18.28479,1765
240955,3042523F837593809C64E77150AECD92,30721,0,7,7,109.51597,18.28257,1565
240956,3042523F837593809C64E77150AECD92,30771,8,9,1,109.49938,18.26042,1511
240957,3042523F837593809C64E77150AECD92,30771,10,14,4,109.49938,18.26042,1511
240958,3042523F837593809C64E77150AECD92,30531,15,17,2,109.53271,18.21472,1604
240959,3042523F837593809C64E77150AECD92,38154,18,20,2,109.5266,18.28278,1615
240968,D9AE11CD16B231308C3F0FB3F53BC3E9,30854,0,12,12,109.56889,18.27076,1763
240969,D9AE11CD16B231308C3F0FB3F53BC3E9,31071,12,14,2,109.58257,18.28458,1815
240970,D9AE11CD16B231308C3F0FB3F53BC3E9,30854,18,23,5,109.56889,18.27076,1763
240971,2133BBAAAA8DED2520884D436D70440D,30391,18,20,2,109.4975,18.27118,1513
240972,2133BBAAAA8DED2520884D436D70440D,30741,20,23,3,109.49833,18.28681,1516
241010,8B9A9BFD1ACAD480EB101A91DBF2024D,38291,0,15,15,109.51618,18.24313,1558
241011,8B9A9BFD1ACAD480EB101A91DBF2024D,30371,17,20,3,109.51,18.24771,1559
241012,8B9A9BFD1ACAD480EB101A91DBF2024D,30711,21,22,1,109.50271,18.25347,1510
241018,F22E2350B3BBD3E296D591A1B269AAD3,38754,10,13,3,109.74667,18.37382,2430
241139,9DB1F2EC09C49DCC6FAB72F1F7C09C78,39053,2,10,8,109.511,18.2771,1564
241140,9DB1F2EC09C49DCC6FAB72F1F7C09C78,60381,12,14,2,109.5241,18.22458,1605
241141,9DB1F2EC09C49DCC6FAB72F1F7C09C78,60371,18,20,2,109.53063,18.30056,1618
241142,9DB1F2EC09C49DCC6FAB72F1F7C09C78,60381,21,22,1,109.5241,18.22458,1605
241169,189633BA4D39EBA8A203BC9E364D4B1F,30051,11,14,3,109.48917,18.21215,1453
241170,189633BA4D39EBA8A203BC9E364D4B1F,60231,14,17,3,109.49903,18.21972,1504
241171,189633BA4D39EBA8A203BC9E364D4B1F,31261,21,23,2,109.51174,18.2466,1559
241178,C983E73D646629A775690ECA8920EB29,31631,0,5,5,109.59542,18.36826,1879
241179,C983E73D646629A775690ECA8920EB29,30101,7,9,2,109.57299,18.33333,1773
241180,C983E73D646629A775690ECA8920EB29,31631,9,11,2,109.59542,18.36826,1879
241181,C983E73D646629A775690ECA8920EB29,30101,11,13,2,109.57299,18.33333,1773
241182,C983E73D646629A775690ECA8920EB29,31631,15,20,5,109.59542,18.36826,1879
241245,23073B802C909D3D46ECEB73A8309E22,38291,19,20,1,109.51618,18.24313,1558
241246,23073B802C909D3D46ECEB73A8309E22,30854,22,23,1,109.56889,18.27076,1763
241267,ACAB8C7B92298FFCEC0006246A6D65D6,39183,0,6,6,109.55542,18.28208,1715
241268,ACAB8C7B92298FFCEC0006246A6D65D6,31931,7,9,2,109.54771,18.29403,1667
241269,ACAB8C7B92298FFCEC0006246A6D65D6,39183,11,22,11,109.55542,18.28208,1715
241291,6422CB87ACC55DDEF6EBE8946593C808,31351,0,7,7,109.4959,18.28417,1465
241292,6422CB87ACC55DDEF6EBE8946593C808,30051,9,10,1,109.48917,18.21215,1453
241293,6422CB87ACC55DDEF6EBE8946593C808,60231,11,17,6,109.49903,18.21972,1504
241294,6422CB87ACC55DDEF6EBE8946593C808,60235,18,21,3,109.49269,18.2253,1455
241295,6422CB87ACC55DDEF6EBE8946593C808,31351,21,22,1,109.4959,18.28417,1465
241341,53453D8B736810206EC5A6632D159BE6,31931,0,8,8,109.54771,18.29403,1667
241342,53453D8B736810206EC5A6632D159BE6,60371,8,10,2,109.53063,18.30056,1618
241343,53453D8B736810206EC5A6632D159BE6,31931,12,23,11,109.54771,18.29403,1667
241346,1BAA4EB92824E45EC2E36C90288F6A84,31031,0,1,1,109.49979,18.25382,1510
241347,1BAA4EB92824E45EC2E36C90288F6A84,60401,2,9,7,109.47444,18.27583,1414
241348,1BAA4EB92824E45EC2E36C90288F6A84,31031,9,11,2,109.49979,18.25382,1510
241349,1BAA4EB92824E45EC2E36C90288F6A84,30711,17,20,3,109.50271,18.25347,1510
241350,1BAA4EB92824E45EC2E36C90288F6A84,31031,21,23,2,109.49979,18.25382,1510
241362,9AA959ED87D1ECC3053DED17290EFCBD,30854,14,15,1,109.56889,18.27076,1763
241363,9AA959ED87D1ECC3053DED17290EFCBD,31561,15,19,4,109.56792,18.28479,1765
241384,EBF551BDD30B7EEB2F877A91C244C4A5,30681,14,15,1,109.48493,18.26917,1463
241385,EBF551BDD30B7EEB2F877A91C244C4A5,30161,19,21,2,109.50042,18.24389,1508
241410,D96E01B8E0F0DE9C160C9FEAFDCFDB6D,31071,0,7,7,109.58257,18.28458,1815
241411,D96E01B8E0F0DE9C160C9FEAFDCFDB6D,30854,9,22,13,109.56889,18.27076,1763
241419,3C1A2536A78CF30193CED5E3EEACBE7E,30851,0,12,12,109.5616,18.27396,1713
241420,3C1A2536A78CF30193CED5E3EEACBE7E,31561,13,16,3,109.56792,18.28479,1765
241421,3C1A2536A78CF30193CED5E3EEACBE7E,30854,17,18,1,109.56889,18.27076,1763
241422,3C1A2536A78CF30193CED5E3EEACBE7E,30851,21,22,1,109.5616,18.27396,1713
241433,9E45264EC835227EA5B2232A2B85D7B9,31521,0,10,10,109.51458,18.22542,1555
241434,9E45264EC835227EA5B2232A2B85D7B9,60381,10,12,2,109.5241,18.22458,1605
241435,9E45264EC835227EA5B2232A2B85D7B9,31521,13,19,6,109.51458,18.22542,1555
241436,9E45264EC835227EA5B2232A2B85D7B9,30731,19,21,2,109.50944,18.22306,1555
241472,826EBD07021610B18F3D38A2C6C13D56,30771,19,21,2,109.49938,18.26042,1511
241473,826EBD07021610B18F3D38A2C6C13D56,31271,22,23,1,109.48958,18.26257,1462
241510,40285EE8CCE25C38988EC087545664EC,30854,2,4,2,109.56889,18.27076,1763
241511,40285EE8CCE25C38988EC087545664EC,31071,4,7,3,109.58257,18.28458,1815
241512,40285EE8CCE25C38988EC087545664EC,30854,7,9,2,109.56889,18.27076,1763
241568,3B46764DEE9C1A14D1C3F1D56B4284FD,31931,0,3,3,109.54771,18.29403,1667
241569,3B46764DEE9C1A14D1C3F1D56B4284FD,60361,4,16,12,109.51938,18.29681,1567
241570,3B46764DEE9C1A14D1C3F1D56B4284FD,60241,17,18,1,109.53319,18.28667,1616
241571,3B46764DEE9C1A14D1C3F1D56B4284FD,60361,19,22,3,109.51938,18.29681,1567
241572,03E3094FE0344513E64DAE470C33E920,39181,0,7,7,109.55153,18.28035,1715
241573,03E3094FE0344513E64DAE470C33E920,31931,7,8,1,109.54771,18.29403,1667
241574,03E3094FE0344513E64DAE470C33E920,39181,13,14,1,109.55153,18.28035,1715
241575,03E3094FE0344513E64DAE470C33E920,31931,14,16,2,109.54771,18.29403,1667
241576,03E3094FE0344513E64DAE470C33E920,39181,19,23,4,109.55153,18.28035,1715
241608,C8922FAF66F21ECAECB6B717FCD5A53B,60614,0,14,14,109.48799,18.29521,1467
241609,C8922FAF66F21ECAECB6B717FCD5A53B,60391,18,20,2,109.47667,18.28757,1416
241630,7D1ED6067ECBD941EFC43CE0A6ADAE71,31071,15,16,1,109.58257,18.28458,1815
241631,7D1ED6067ECBD941EFC43CE0A6ADAE71,30854,17,23,6,109.56889,18.27076,1763
241651,85BD5DFF2A9B6AA28BAAC8993DD4D426,31531,0,9,9,109.49583,18.25972,1461
241652,85BD5DFF2A9B6AA28BAAC8993DD4D426,60054,13,15,2,109.3016,18.31229,770
241653,85BD5DFF2A9B6AA28BAAC8993DD4D426,31531,16,23,7,109.49583,18.25972,1461
241663,85E3E19546A8845252074D0B609723D5,39371,0,14,14,109.56627,18.2646,1762
241664,85E3E19546A8845252074D0B609723D5,30891,14,15,1,109.59431,18.28389,1865
241665,85E3E19546A8845252074D0B609723D5,39371,19,23,4,109.56627,18.2646,1762
241675,5605B5FEA58FE66425ABEFD16E75AB1F,60614,0,10,10,109.48799,18.29521,1467
241679,8A19D38C67DEBBE2072401E23B2467C5,31161,0,10,10,109.70229,18.31361,2270
241680,8A19D38C67DEBBE2072401E23B2467C5,60114,15,16,1,109.73028,18.33847,2374
241681,8A19D38C67DEBBE2072401E23B2467C5,31161,19,23,4,109.70229,18.31361,2270
241682,D709A996A64F98F0D634C81CB0E94EF4,38951,0,8,8,109.48097,18.28868,1416
241683,D709A996A64F98F0D634C81CB0E94EF4,31471,13,14,1,109.34583,18.29563,917
241684,D709A996A64F98F0D634C81CB0E94EF4,30821,15,18,3,109.43681,18.33639,1274
241685,D709A996A64F98F0D634C81CB0E94EF4,31431,19,20,1,109.44639,18.29042,1316
241686,D709A996A64F98F0D634C81CB0E94EF4,38951,20,23,3,109.48097,18.28868,1416
241687,CB3A5B3354EA507D300C9FEBE9F524E3,39181,0,16,16,109.55153,18.28035,1715
241688,CB3A5B3354EA507D300C9FEBE9F524E3,30711,20,21,1,109.50271,18.25347,1510
241689,CB3A5B3354EA507D300C9FEBE9F524E3,30911,21,23,2,109.50493,18.26181,1511
241717,033CEEC20746801745CF4A53CD517C31,31821,0,8,8,109.51181,18.24924,1559
241718,033CEEC20746801745CF4A53CD517C31,31181,10,11,1,109.50382,18.24813,1509
241719,033CEEC20746801745CF4A53CD517C31,31821,12,17,5,109.51181,18.24924,1559
241720,033CEEC20746801745CF4A53CD517C31,30281,20,23,3,109.50597,18.27583,1514
241734,1419F2503130508E06D5FA0D4A5CF329,31461,11,13,2,109.5091,18.25389,1510
241735,1419F2503130508E06D5FA0D4A5CF329,31031,14,18,4,109.49979,18.25382,1510
241736,1419F2503130508E06D5FA0D4A5CF329,38891,19,20,1,109.51486,18.24118,1558
241737,1419F2503130508E06D5FA0D4A5CF329,31031,21,22,1,109.49979,18.25382,1510
241765,E9E473F09C342630187345312F4A31D8,39181,0,8,8,109.55153,18.28035,1715
241766,E9E473F09C342630187345312F4A31D8,39181,10,18,8,109.55153,18.28035,1715
241767,E9E473F09C342630187345312F4A31D8,39181,19,23,4,109.55153,18.28035,1715
241809,B1715BAACD2551A031737B51F74CE832,30371,0,9,9,109.51,18.24771,1559
241810,B1715BAACD2551A031737B51F74CE832,30711,9,11,2,109.50271,18.25347,1510
241811,B1715BAACD2551A031737B51F74CE832,30421,12,15,3,109.50021,18.25861,1511
241812,B1715BAACD2551A031737B51F74CE832,30711,19,21,2,109.50271,18.25347,1510
241813,B1715BAACD2551A031737B51F74CE832,30371,21,23,2,109.51,18.24771,1559
241836,00FC332040A284DA251A8D0705989FE9,31071,1,11,10,109.58257,18.28458,1815
241837,00FC332040A284DA251A8D0705989FE9,30854,14,15,1,109.56889,18.27076,1763
241838,00FC332040A284DA251A8D0705989FE9,31071,18,20,2,109.58257,18.28458,1815
241861,81946AFE1D298F3B40176C804AE3EF84,60171,1,3,2,109.51292,18.30694,1569
241862,81946AFE1D298F3B40176C804AE3EF84,31931,7,16,9,109.54771,18.29403,1667
241863,81946AFE1D298F3B40176C804AE3EF84,60171,18,20,2,109.51292,18.30694,1569
241864,81946AFE1D298F3B40176C804AE3EF84,38484,21,22,1,109.53028,18.31528,1620
241865,176C6455055846C83CDA64CD9B071B7A,38134,2,3,1,109.63931,18.23451,2007
241866,176C6455055846C83CDA64CD9B071B7A,31571,4,5,1,109.61563,18.23326,1957
241867,176C6455055846C83CDA64CD9B071B7A,30581,6,8,2,109.62257,18.24951,1959
241868,176C6455055846C83CDA64CD9B071B7A,31071,11,13,2,109.58257,18.28458,1815
241895,6FF08122E48AB794FE75A66E236D4C05,31521,0,17,17,109.51458,18.22542,1555
241896,6FF08122E48AB794FE75A66E236D4C05,60381,19,20,1,109.5241,18.22458,1605
241897,6FF08122E48AB794FE75A66E236D4C05,31521,21,23,2,109.51458,18.22542,1555
241907,D46DE9169E4BACF1D272EA5E0FDEF68F,39183,0,15,15,109.55542,18.28208,1715
241908,D46DE9169E4BACF1D272EA5E0FDEF68F,31561,18,23,5,109.56792,18.28479,1765
241938,2AE38FAF341950B0B91404FFCE5A0F3E,30921,6,15,9,109.53903,18.29451,1667
241939,2AE38FAF341950B0B91404FFCE5A0F3E,31931,19,20,1,109.54771,18.29403,1667
241947,39F25FE146A03325C93C111F2A943B6C,31945,0,6,6,109.58021,18.29403,1817
241948,39F25FE146A03325C93C111F2A943B6C,31071,10,12,2,109.58257,18.28458,1815
241949,39F25FE146A03325C93C111F2A943B6C,31945,12,13,1,109.58021,18.29403,1817
241950,39F25FE146A03325C93C111F2A943B6C,30854,17,18,1,109.56889,18.27076,1763
241951,58418A9EA4A7DC03127CB79C039A5185,60354,0,13,13,109.58701,18.28521,1815
241952,58418A9EA4A7DC03127CB79C039A5185,30854,15,17,2,109.56889,18.27076,1763
241953,58418A9EA4A7DC03127CB79C039A5185,60354,18,23,5,109.58701,18.28521,1815
242023,1E36640BE395A4EE8CCB2697222419A5,60631,0,2,2,109.57778,18.27583,1814
242024,1E36640BE395A4EE8CCB2697222419A5,31071,2,6,4,109.58257,18.28458,1815
242025,1E36640BE395A4EE8CCB2697222419A5,30854,8,17,9,109.56889,18.27076,1763
242026,1E36640BE395A4EE8CCB2697222419A5,39091,19,21,2,109.50097,18.25222,1510
242027,1E36640BE395A4EE8CCB2697222419A5,30191,21,22,1,109.50361,18.22701,1506
242028,14AE6C820CE45F96077630992CABD33D,39371,0,7,7,109.56627,18.2646,1762
242029,14AE6C820CE45F96077630992CABD33D,31421,9,11,2,109.55382,18.22347,1705
242030,14AE6C820CE45F96077630992CABD33D,30951,13,21,8,109.56208,18.25667,1761
242031,14AE6C820CE45F96077630992CABD33D,30851,21,23,2,109.5616,18.27396,1713
242044,DFFF17B7FE30E79B8AABBB5CE171272F,31561,0,13,13,109.56792,18.28479,1765
242045,DFFF17B7FE30E79B8AABBB5CE171272F,39183,14,18,4,109.55542,18.28208,1715
242046,DFFF17B7FE30E79B8AABBB5CE171272F,31561,20,22,2,109.56792,18.28479,1765
242076,D5A941B7629B76426207AF63E861B5B0,31071,0,7,7,109.58257,18.28458,1815
242077,D5A941B7629B76426207AF63E861B5B0,30854,7,9,2,109.56889,18.27076,1763
242078,D5A941B7629B76426207AF63E861B5B0,31071,9,12,3,109.58257,18.28458,1815
242079,D5A941B7629B76426207AF63E861B5B0,30854,12,13,1,109.56889,18.27076,1763
242106,EC4B90EDBF35256FDB4D4F8B87DB8A04,31071,0,17,17,109.58257,18.28458,1815
242107,EC4B90EDBF35256FDB4D4F8B87DB8A04,30854,19,20,1,109.56889,18.27076,1763
242111,8CD15CF6B5FB4821940FF9AFE6D6CB84,31931,0,20,20,109.54771,18.29403,1667
242112,8CD15CF6B5FB4821940FF9AFE6D6CB84,30921,21,23,2,109.53903,18.29451,1667
242113,DD386856863F7E131E32C81950505B78,31031,0,8,8,109.49979,18.25382,1510
242115,DD386856863F7E131E32C81950505B78,31031,18,19,1,109.49979,18.25382,1510
242116,DD386856863F7E131E32C81950505B78,60131,21,22,1,109.49819,18.24778,1509
242117,EE2B9FA1FE5C77473C44003104939CD4,30211,0,2,2,109.49882,18.23931,1508
242146,AE01F02800A46BE78317CCA6998E50DC,30271,12,13,1,109.49132,18.23153,1456
242149,10E6DCB22C04D9E1B01193CDA87B3193,30721,19,21,2,109.51597,18.28257,1565
242150,10E6DCB22C04D9E1B01193CDA87B3193,38154,21,23,2,109.5266,18.28278,1615
242189,8C54F679DD59F109DAF19BDB41D1658A,30441,0,9,9,109.64021,18.25424,2010
242190,8C54F679DD59F109DAF19BDB41D1658A,31473,10,12,2,109.34792,18.29465,917
242191,8C54F679DD59F109DAF19BDB41D1658A,30611,13,14,1,109.74958,18.40188,2485
242262,69998C60A6E00459C2EA67259A550AAF,31071,0,7,7,109.58257,18.28458,1815
242263,69998C60A6E00459C2EA67259A550AAF,30851,9,10,1,109.5616,18.27396,1713
242264,69998C60A6E00459C2EA67259A550AAF,60381,14,16,2,109.5241,18.22458,1605
242265,69998C60A6E00459C2EA67259A550AAF,30221,19,21,2,109.57833,18.20222,1802
242279,04C0729B38628739B5D19433D7909981,30211,0,4,4,109.49882,18.23931,1508
242280,04C0729B38628739B5D19433D7909981,30191,5,8,3,109.50361,18.22701,1506
242281,04C0729B38628739B5D19433D7909981,31301,10,13,3,109.14493,18.31222,170
242282,04C0729B38628739B5D19433D7909981,60054,14,15,1,109.3016,18.31229,770
242283,04C0729B38628739B5D19433D7909981,30191,19,23,4,109.50361,18.22701,1506
242286,03CEC0FDDD5484124514C6D24A63D4DD,30854,0,2,2,109.56889,18.27076,1763
242287,03CEC0FDDD5484124514C6D24A63D4DD,31561,3,19,16,109.56792,18.28479,1765
242288,03CEC0FDDD5484124514C6D24A63D4DD,30854,20,21,1,109.56889,18.27076,1763
242371,D01D236B816B958BA0840FB83B5A7890,31861,1,7,6,109.49042,18.27549,1464
242372,D01D236B816B958BA0840FB83B5A7890,30171,11,12,1,109.48458,18.27139,1463
242373,D01D236B816B958BA0840FB83B5A7890,31861,13,14,1,109.49042,18.27549,1464
242383,14F1CC63CDA098F9694EAC8584B9C7A5,31071,3,4,1,109.58257,18.28458,1815
242384,14F1CC63CDA098F9694EAC8584B9C7A5,30811,8,9,1,109.65188,18.26257,2062
242385,14F1CC63CDA098F9694EAC8584B9C7A5,31071,13,15,2,109.58257,18.28458,1815
242386,14F1CC63CDA098F9694EAC8584B9C7A5,30854,16,19,3,109.56889,18.27076,1763
242397,93C8A9BFC982F63705EDC3214DA05AC8,30721,21,23,2,109.51597,18.28257,1565
242412,B824B22132E063AA0786E40144CD7E97,31571,13,14,1,109.61563,18.23326,1957
242413,B824B22132E063AA0786E40144CD7E97,30711,16,19,3,109.50271,18.25347,1510
242414,B824B22132E063AA0786E40144CD7E97,31461,19,23,4,109.5091,18.25389,1510
242454,1D8B814EC83D52D7C5F3FED99C129EE0,30854,3,8,5,109.56889,18.27076,1763
242455,1D8B814EC83D52D7C5F3FED99C129EE0,38271,10,19,9,109.62632,18.23049,1956
242513,02BA1B28C28D4C4E10AA258EED00ADF2,60261,3,5,2,109.44326,18.3075,1319
242514,02BA1B28C28D4C4E10AA258EED00ADF2,30241,8,9,1,109.26174,18.3275,622
242595,6BF671BC76B2463D72102139E4EB1018,38241,9,16,7,109.54111,18.30542,1669
242596,6BF671BC76B2463D72102139E4EB1018,31931,18,20,2,109.54771,18.29403,1667
242648,2F64FEF19C86AA0A8AA3E3FA37CC4F2D,39371,18,19,1,109.56627,18.2646,1762
242649,2F64FEF19C86AA0A8AA3E3FA37CC4F2D,60631,20,22,2,109.57778,18.27583,1814
242650,5C4B759B8D2905A494B81A3EB710A8F3,60631,0,17,17,109.57778,18.27583,1814
242651,5C4B759B8D2905A494B81A3EB710A8F3,31231,19,20,1,109.42597,18.29292,1217
242658,23019CE071DC0B0CEC6E78ADA422CE57,38973,1,4,3,109.51097,18.25389,1560
242659,23019CE071DC0B0CEC6E78ADA422CE57,31381,7,10,3,109.1375,18.36833,129
242660,23019CE071DC0B0CEC6E78ADA422CE57,30711,13,15,2,109.50271,18.25347,1510
242661,23019CE071DC0B0CEC6E78ADA422CE57,38291,19,20,1,109.51618,18.24313,1558
242691,DE91F768E6CCDB78867FF54F078574C9,30854,2,12,10,109.56889,18.27076,1763
242692,DE91F768E6CCDB78867FF54F078574C9,60631,15,17,2,109.57778,18.27583,1814
242693,DE91F768E6CCDB78867FF54F078574C9,31421,18,20,2,109.55382,18.22347,1705
242694,F8D799D9161B0143E0D71C40472A357E,30071,0,12,12,109.52819,18.30472,1619
242695,F8D799D9161B0143E0D71C40472A357E,30071,12,18,6,109.52819,18.30472,1619
242696,F8D799D9161B0143E0D71C40472A357E,31951,18,22,4,109.52174,18.30299,1568
242725,4027759DA4AA4E8EAD8331A27147F405,31071,0,17,17,109.58257,18.28458,1815
242726,4027759DA4AA4E8EAD8331A27147F405,39091,19,20,1,109.50097,18.25222,1510
242734,7BF65E5054DA81A230AB5423620158E1,60631,2,6,4,109.57778,18.27583,1814
242735,7BF65E5054DA81A230AB5423620158E1,31071,9,10,1,109.58257,18.28458,1815
242736,7BF65E5054DA81A230AB5423620158E1,30854,11,22,11,109.56889,18.27076,1763
242763,BE22E1F27552B309245231CD4F4B6422,38027,14,15,1,109.38833,18.2909,1066
242764,BE22E1F27552B309245231CD4F4B6422,30421,20,21,1,109.50021,18.25861,1511
242809,D9E60CECBCF3335BA62A418C133E83E2,38117,0,6,6,109.51611,18.22354,1555
242810,D9E60CECBCF3335BA62A418C133E83E2,60381,7,8,1,109.5241,18.22458,1605
242811,D9E60CECBCF3335BA62A418C133E83E2,30731,10,11,1,109.50944,18.22306,1555
242812,D9E60CECBCF3335BA62A418C133E83E2,39321,13,15,2,109.529,18.2167,1604
242813,D9E60CECBCF3335BA62A418C133E83E2,31521,16,17,1,109.51458,18.22542,1555
242814,D9E60CECBCF3335BA62A418C133E83E2,31521,19,22,3,109.51458,18.22542,1555
242833,AAC7E9546787DDB508C41969C1E453E7,30711,0,8,8,109.50271,18.25347,1510
242834,AAC7E9546787DDB508C41969C1E453E7,60381,13,14,1,109.5241,18.22458,1605
242835,AAC7E9546787DDB508C41969C1E453E7,39154,15,16,1,109.50201,18.25681,1511
242836,AAC7E9546787DDB508C41969C1E453E7,30421,19,21,2,109.50021,18.25861,1511
242882,B84B247FA61A8C12DFCCCF3C2D72006D,31945,2,7,5,109.58021,18.29403,1817
242883,B84B247FA61A8C12DFCCCF3C2D72006D,30854,10,11,1,109.56889,18.27076,1763
242884,B84B247FA61A8C12DFCCCF3C2D72006D,31071,12,14,2,109.58257,18.28458,1815
242903,D17842D1E850E617B4B15889C460D1C5,31931,1,14,13,109.54771,18.29403,1667
242904,D17842D1E850E617B4B15889C460D1C5,30921,17,19,2,109.53903,18.29451,1667
242905,D17842D1E850E617B4B15889C460D1C5,31931,22,23,1,109.54771,18.29403,1667
242918,E429EA352745E371AD6E9A2D803C68B6,60424,0,5,5,109.44611,18.31736,1321
242919,E429EA352745E371AD6E9A2D803C68B6,30821,6,7,1,109.43681,18.33639,1274
242920,E429EA352745E371AD6E9A2D803C68B6,31931,8,10,2,109.54771,18.29403,1667
242921,E429EA352745E371AD6E9A2D803C68B6,30921,15,17,2,109.53903,18.29451,1667
242922,E429EA352745E371AD6E9A2D803C68B6,30821,20,21,1,109.43681,18.33639,1274
242929,6C0260646767B781577B5B8CE2471E51,38484,0,7,7,109.53028,18.31528,1620
242930,6C0260646767B781577B5B8CE2471E51,30071,11,13,2,109.52819,18.30472,1619
242931,6C0260646767B781577B5B8CE2471E51,38484,14,16,2,109.53028,18.31528,1620
242932,6C0260646767B781577B5B8CE2471E51,30321,17,19,2,109.49563,18.29611,1467
242933,6C0260646767B781577B5B8CE2471E51,30071,20,22,2,109.52819,18.30472,1619
242934,6C0260646767B781577B5B8CE2471E51,38484,22,23,1,109.53028,18.31528,1620
242935,20C15B76A1E0DF79D86EDEAC7BC3D7B7,30854,2,7,5,109.56889,18.27076,1763
242936,20C15B76A1E0DF79D86EDEAC7BC3D7B7,31945,9,11,2,109.58021,18.29403,1817
242937,20C15B76A1E0DF79D86EDEAC7BC3D7B7,60631,12,14,2,109.57778,18.27583,1814
242938,20C15B76A1E0DF79D86EDEAC7BC3D7B7,60381,19,20,1,109.5241,18.22458,1605
242939,20C15B76A1E0DF79D86EDEAC7BC3D7B7,31071,21,23,2,109.58257,18.28458,1815
242943,52626520133C58C019E9712FB19D3224,38171,0,7,7,109.50799,18.28139,1515
242944,52626520133C58C019E9712FB19D3224,30711,10,16,6,109.50271,18.25347,1510
242945,52626520133C58C019E9712FB19D3224,38171,20,23,3,109.50799,18.28139,1515
242946,8F6EA1C108FADA76A214A7ED71ECE3D1,30232,1,2,1,109.6191,18.31701,1971
242947,8F6EA1C108FADA76A214A7ED71ECE3D1,30891,3,4,1,109.59431,18.28389,1865
242948,8F6EA1C108FADA76A214A7ED71ECE3D1,30854,8,17,9,109.56889,18.27076,1763
243015,A2C55049671AD4BF47BD49086A12C13F,30421,0,19,19,109.50021,18.25861,1511
243016,A2C55049671AD4BF47BD49086A12C13F,60381,19,21,2,109.5241,18.22458,1605
243017,A2C55049671AD4BF47BD49086A12C13F,30421,21,23,2,109.50021,18.25861,1511
243075,8AABF5FDF2B06EB445749240A3894969,30854,8,9,1,109.56889,18.27076,1763
243076,8AABF5FDF2B06EB445749240A3894969,31851,12,16,4,109.71736,18.29007,2316
243077,8AABF5FDF2B06EB445749240A3894969,31071,17,18,1,109.58257,18.28458,1815
243113,B2035C0684FF9CA861B7EB217CE5A160,60524,1,7,6,109.42951,18.28993,1216
243114,B2035C0684FF9CA861B7EB217CE5A160,30351,8,18,10,109.41701,18.29292,1217
243115,B2035C0684FF9CA861B7EB217CE5A160,31236,20,21,1,109.42965,18.29111,1216
243116,B2035C0684FF9CA861B7EB217CE5A160,60041,22,23,1,109.39889,18.31944,1121
243124,FD8E83DD7FF39A687AC2462EEEA479A1,30171,0,6,6,109.48458,18.27139,1463
243125,FD8E83DD7FF39A687AC2462EEEA479A1,60401,6,9,3,109.47444,18.27583,1414
243126,FD8E83DD7FF39A687AC2462EEEA479A1,30171,9,11,2,109.48458,18.27139,1463
243141,FE95B3A32EFBC2838F293DF38F55FDD1,39181,2,3,1,109.55153,18.28035,1715
243142,FE95B3A32EFBC2838F293DF38F55FDD1,39183,4,5,1,109.55542,18.28208,1715
243143,FE95B3A32EFBC2838F293DF38F55FDD1,30071,7,8,1,109.52819,18.30472,1619
243144,FE95B3A32EFBC2838F293DF38F55FDD1,39183,13,19,6,109.55542,18.28208,1715
243145,FE95B3A32EFBC2838F293DF38F55FDD1,31931,20,23,3,109.54771,18.29403,1667
243146,7B832C4EEA998F0828995CEC1FF24330,30854,19,21,2,109.56889,18.27076,1763
243147,7B832C4EEA998F0828995CEC1FF24330,30371,22,23,1,109.51,18.24771,1559
243184,FC8552628F8A5A5219C1C30314657039,60661,0,8,8,109.548,18.2377,1657
243185,FC8552628F8A5A5219C1C30314657039,38111,10,11,1,109.52007,18.22403,1555
243188,91A4B18B10CFB3885EEC99A3CDDB8545,30971,15,17,2,109.48708,18.29319,1467
243228,E8BAAF476E8FE57075BAB1A8D4FF1780,60631,1,5,4,109.57778,18.27583,1814
243229,E8BAAF476E8FE57075BAB1A8D4FF1780,39371,7,23,16,109.56627,18.2646,1762
243282,82FFBAA5929CD368E9B5AC0A4DEDBC26,60241,15,17,2,109.53319,18.28667,1616
243283,82FFBAA5929CD368E9B5AC0A4DEDBC26,30051,19,23,4,109.48917,18.21215,1453
243305,408C4FED868686E7B96333835F4C4205,31206,0,2,2,109.50819,18.23549,1507
243306,408C4FED868686E7B96333835F4C4205,31071,4,8,4,109.58257,18.28458,1815
243307,408C4FED868686E7B96333835F4C4205,31145,9,10,1,109.20431,18.30479,369
243308,408C4FED868686E7B96333835F4C4205,31301,11,13,2,109.14493,18.31222,170
243309,408C4FED868686E7B96333835F4C4205,60381,18,20,2,109.5241,18.22458,1605
243310,BAF784C90E903A1C0CEDF594F05C3F50,60361,0,8,8,109.51938,18.29681,1567
243311,BAF784C90E903A1C0CEDF594F05C3F50,30711,9,10,1,109.50271,18.25347,1510
243312,BAF784C90E903A1C0CEDF594F05C3F50,30731,13,15,2,109.50944,18.22306,1555
243313,BAF784C90E903A1C0CEDF594F05C3F50,30181,15,20,5,109.51597,18.23313,1557
243327,6532548CEFFF043086FECA37F4D65565,31071,10,15,5,109.58257,18.28458,1815
243328,6532548CEFFF043086FECA37F4D65565,30854,15,17,2,109.56889,18.27076,1763
243342,F7035E4742EE25797FD00CAEBC81D218,31251,0,9,9,109.18528,18.2975,317
243343,F7035E4742EE25797FD00CAEBC81D218,30441,9,11,2,109.64021,18.25424,2010
243344,F7035E4742EE25797FD00CAEBC81D218,31251,13,23,10,109.18528,18.2975,317
243346,798BF3B08F72A16A6DEAAA235F1899BB,61011,4,5,1,109.60653,18.19076,1900
243348,798BF3B08F72A16A6DEAAA235F1899BB,61011,18,21,3,109.60653,18.19076,1900
243366,6C09CE755C8436D31143C1E3AA51623D,30854,15,16,1,109.56889,18.27076,1763
243367,6C09CE755C8436D31143C1E3AA51623D,31071,17,18,1,109.58257,18.28458,1815
243368,6C09CE755C8436D31143C1E3AA51623D,30854,19,21,2,109.56889,18.27076,1763
243404,8173BA5756C17B85ED9415F619E926FB,31021,0,8,8,109.49021,18.27,1463
243405,8173BA5756C17B85ED9415F619E926FB,31161,10,12,2,109.70229,18.31361,2270
243406,8173BA5756C17B85ED9415F619E926FB,60171,13,19,6,109.51292,18.30694,1569
243407,8173BA5756C17B85ED9415F619E926FB,30201,22,23,1,109.4909,18.26465,1462
243488,E4C7AB656E412C7E33554D18277C9478,30371,12,14,2,109.51,18.24771,1559
243489,E4C7AB656E412C7E33554D18277C9478,60331,16,17,1,109.505,18.26507,1512
243490,E4C7AB656E412C7E33554D18277C9478,30911,17,18,1,109.50493,18.26181,1511
243491,E4C7AB656E412C7E33554D18277C9478,31461,21,22,1,109.5091,18.25389,1510
243526,66E9B7976F1EC626FEB04A97A1EEA045,30721,0,6,6,109.51597,18.28257,1565
243527,66E9B7976F1EC626FEB04A97A1EEA045,31821,8,9,1,109.51181,18.24924,1559
243562,D64B32EAC84F970E1B2B563AF70BEA64,60281,17,18,1,109.51743,18.25924,1561
243577,6751CEC3CF9B2AE78246C7287443D2B4,31945,5,7,2,109.58021,18.29403,1817
243578,6751CEC3CF9B2AE78246C7287443D2B4,30854,7,23,16,109.56889,18.27076,1763
243598,1B6EBBFF3B9D8A3E18753343B6A29EAE,31071,0,6,6,109.58257,18.28458,1815
243599,1B6EBBFF3B9D8A3E18753343B6A29EAE,31561,8,10,2,109.56792,18.28479,1765
243600,1B6EBBFF3B9D8A3E18753343B6A29EAE,31071,12,14,2,109.58257,18.28458,1815
243601,1B6EBBFF3B9D8A3E18753343B6A29EAE,31561,17,18,1,109.56792,18.28479,1765
243607,EC89B2FFE00F967E6D0A3B697A6D636D,30191,19,21,2,109.50361,18.22701,1506
243608,EC89B2FFE00F967E6D0A3B697A6D636D,31521,21,23,2,109.51458,18.22542,1555
243629,616C1CD7DAC998574082232ED7666D81,30181,8,10,2,109.51597,18.23313,1557
243630,616C1CD7DAC998574082232ED7666D81,31521,10,14,4,109.51458,18.22542,1555
243631,616C1CD7DAC998574082232ED7666D81,30181,15,17,2,109.51597,18.23313,1557
243632,616C1CD7DAC998574082232ED7666D81,31534,18,22,4,109.49368,18.25806,1461
243638,4D4289AE0DFBF4B5C79A47559DC2EBDD,39371,1,3,2,109.56627,18.2646,1762
243639,4D4289AE0DFBF4B5C79A47559DC2EBDD,30854,8,23,15,109.56889,18.27076,1763
243640,59F29435D748531F416A4F1636997ECF,31071,0,7,7,109.58257,18.28458,1815
243641,59F29435D748531F416A4F1636997ECF,33101,10,11,1,109.68438,18.44368,2242
243642,59F29435D748531F416A4F1636997ECF,33481,13,14,1,109.67278,18.41278,2187
243643,59F29435D748531F416A4F1636997ECF,30731,19,20,1,109.50944,18.22306,1555
243644,68DBE0B52FD0AB95F1DD47068FD7847F,60311,0,14,14,109.52097,18.24319,1558
243645,68DBE0B52FD0AB95F1DD47068FD7847F,30181,15,17,2,109.51597,18.23313,1557
243646,68DBE0B52FD0AB95F1DD47068FD7847F,38291,18,20,2,109.51618,18.24313,1558
243647,68DBE0B52FD0AB95F1DD47068FD7847F,30181,20,21,1,109.51597,18.23313,1557
243657,A8ABE4987042D12DD458C81CFD9663F5,38127,0,7,7,109.50833,18.27222,1513
243658,A8ABE4987042D12DD458C81CFD9663F5,30421,8,13,5,109.50021,18.25861,1511
243659,A8ABE4987042D12DD458C81CFD9663F5,30771,18,20,2,109.49938,18.26042,1511
243660,A8ABE4987042D12DD458C81CFD9663F5,30771,22,23,1,109.49938,18.26042,1511
243724,369C26B411BBFC36DC6FE3529EBBC042,31071,2,7,5,109.58257,18.28458,1815
243725,369C26B411BBFC36DC6FE3529EBBC042,30854,7,8,1,109.56889,18.27076,1763
243726,369C26B411BBFC36DC6FE3529EBBC042,39371,11,13,2,109.56627,18.2646,1762
243727,369C26B411BBFC36DC6FE3529EBBC042,30891,13,15,2,109.59431,18.28389,1865
243728,369C26B411BBFC36DC6FE3529EBBC042,30854,15,16,1,109.56889,18.27076,1763
243729,369C26B411BBFC36DC6FE3529EBBC042,39371,19,20,1,109.56627,18.2646,1762
243754,7E95AEA91A37473FF71C625BDD54FD92,60274,0,6,6,109.514,18.2933,1567
243755,7E95AEA91A37473FF71C625BDD54FD92,60361,6,20,14,109.51938,18.29681,1567
243756,7E95AEA91A37473FF71C625BDD54FD92,60274,20,23,3,109.514,18.2933,1567
243804,F104684B0D453E1772CF3FC2E8F8DFBE,60201,10,11,1,109.5041,18.2509,1510
243805,F104684B0D453E1772CF3FC2E8F8DFBE,60161,13,14,1,109.49174,18.26181,1461
243806,F104684B0D453E1772CF3FC2E8F8DFBE,31041,18,20,2,109.50278,18.23701,1507
243807,F104684B0D453E1772CF3FC2E8F8DFBE,30191,21,23,2,109.50361,18.22701,1506
243886,2CF83F5125C6075E2ACA9C17C2979C64,31945,0,1,1,109.58021,18.29403,1817
243887,2CF83F5125C6075E2ACA9C17C2979C64,31071,5,9,4,109.58257,18.28458,1815
243888,2CF83F5125C6075E2ACA9C17C2979C64,30854,10,12,2,109.56889,18.27076,1763
243889,2CF83F5125C6075E2ACA9C17C2979C64,31071,14,17,3,109.58257,18.28458,1815
243890,2CF83F5125C6075E2ACA9C17C2979C64,30854,18,20,2,109.56889,18.27076,1763
243900,16CCFF81838B15A70A44E8C4B6CCB914,30171,15,17,2,109.48458,18.27139,1463
243901,16CCFF81838B15A70A44E8C4B6CCB914,60661,21,22,1,109.548,18.2377,1657
243902,222E0B6922623CE9FBB280F81068D40E,60614,14,16,2,109.48799,18.29521,1467
243903,222E0B6922623CE9FBB280F81068D40E,31071,19,21,2,109.58257,18.28458,1815
243937,A795428793D2273B4ACFDADC5E61AEC2,31421,8,9,1,109.55382,18.22347,1705
243938,A795428793D2273B4ACFDADC5E61AEC2,60661,12,15,3,109.548,18.2377,1657
243939,A795428793D2273B4ACFDADC5E61AEC2,31421,15,18,3,109.55382,18.22347,1705
243957,14DD9E5DCCEFE8BE7425556E4E04FC9A,30854,15,17,2,109.56889,18.27076,1763
243958,14DD9E5DCCEFE8BE7425556E4E04FC9A,31561,20,23,3,109.56792,18.28479,1765
243975,0534435998BA85FF6F729B13993555F5,31071,6,7,1,109.58257,18.28458,1815
243976,0534435998BA85FF6F729B13993555F5,31931,8,10,2,109.54771,18.29403,1667
243977,0534435998BA85FF6F729B13993555F5,31561,12,13,1,109.56792,18.28479,1765
243990,15195C578D4A8081B069C4B518039EFC,30421,16,18,2,109.50021,18.25861,1511
243991,15195C578D4A8081B069C4B518039EFC,31201,21,23,2,109.51042,18.23819,1558
244019,7F6E66BC10419161F6457A6D79258EDB,31361,0,8,8,109.47417,18.28292,1415
244020,7F6E66BC10419161F6457A6D79258EDB,60401,8,10,2,109.47444,18.27583,1414
244021,7F6E66BC10419161F6457A6D79258EDB,38251,12,14,2,109.49618,18.25493,1510
244022,7F6E66BC10419161F6457A6D79258EDB,38094,14,15,1,109.45403,18.28778,1316
244037,F941446F9B0207C03AB7C20D9AC6A7F4,31931,0,16,16,109.54771,18.29403,1667
244038,F941446F9B0207C03AB7C20D9AC6A7F4,60371,17,18,1,109.53063,18.30056,1618
244039,F941446F9B0207C03AB7C20D9AC6A7F4,31931,18,23,5,109.54771,18.29403,1667
244042,372A5433078073EAD18922D679CE0A73,30661,2,4,2,109.37028,18.24361,1008
244043,372A5433078073EAD18922D679CE0A73,60411,6,16,10,109.32514,18.30854,869
244094,185085A773728237A34663A038E61890,31471,13,15,2,109.34583,18.29563,917
244095,185085A773728237A34663A038E61890,31231,18,19,1,109.42597,18.29292,1217
244119,B023927CBEC0A8053CBDF64A5B76E367,60231,0,2,2,109.49903,18.21972,1504
244120,B023927CBEC0A8053CBDF64A5B76E367,30051,4,5,1,109.48917,18.21215,1453
244121,B023927CBEC0A8053CBDF64A5B76E367,31931,7,9,2,109.54771,18.29403,1667
244122,B023927CBEC0A8053CBDF64A5B76E367,30071,10,12,2,109.52819,18.30472,1619
244123,B023927CBEC0A8053CBDF64A5B76E367,31931,12,15,3,109.54771,18.29403,1667
244124,B023927CBEC0A8053CBDF64A5B76E367,60231,19,23,4,109.49903,18.21972,1504
244143,7D9FE20353178BD0E18334ADA0227839,31671,11,13,2,109.38965,18.29813,1068
244144,7D9FE20353178BD0E18334ADA0227839,38903,13,15,2,109.39229,18.29243,1117
244145,7D9FE20353178BD0E18334ADA0227839,60541,16,17,1,109.4084,18.29208,1167
244146,7D9FE20353178BD0E18334ADA0227839,38325,18,20,2,109.39792,18.2909,1116
244147,7D9FE20353178BD0E18334ADA0227839,38903,22,23,1,109.39229,18.29243,1117
244155,2402F47602CE5EB75F62A444E17991D1,31561,14,15,1,109.56792,18.28479,1765
244156,2402F47602CE5EB75F62A444E17991D1,30851,17,18,1,109.5616,18.27396,1713
244210,7BDC7962058E5B3507F7C37155585188,38881,2,5,3,109.51618,18.26431,1562
244211,7BDC7962058E5B3507F7C37155585188,60131,9,12,3,109.49819,18.24778,1509
244217,D4EE8E1A4C04A1FF0596E4221D0B8B42,31071,3,11,8,109.58257,18.28458,1815
244218,D4EE8E1A4C04A1FF0596E4221D0B8B42,30854,11,14,3,109.56889,18.27076,1763
244219,D4EE8E1A4C04A1FF0596E4221D0B8B42,31071,15,16,1,109.58257,18.28458,1815
244220,D4EE8E1A4C04A1FF0596E4221D0B8B42,30854,17,23,6,109.56889,18.27076,1763
244221,50B65AC8D2C37EA95C5135CC7670F4EA,39181,0,8,8,109.55153,18.28035,1715
244222,50B65AC8D2C37EA95C5135CC7670F4EA,31021,10,11,1,109.49021,18.27,1463
244235,570FC5697D4CEEA6951BDA07BB9D84E2,30031,12,13,1,109.53681,18.33313,1673
244287,F715F8942B68CC23C9F5DCA00F01A0F8,60131,0,7,7,109.49819,18.24778,1509
244288,F715F8942B68CC23C9F5DCA00F01A0F8,31471,9,10,1,109.34583,18.29563,917
244289,F715F8942B68CC23C9F5DCA00F01A0F8,31471,13,14,1,109.34583,18.29563,917
244290,F715F8942B68CC23C9F5DCA00F01A0F8,31471,14,16,2,109.34583,18.29563,917
244291,F715F8942B68CC23C9F5DCA00F01A0F8,60131,20,23,3,109.49819,18.24778,1509
244309,2EC9A01B9F6379C2C079528EAEB98D6B,31181,13,14,1,109.50382,18.24813,1509
244310,2EC9A01B9F6379C2C079528EAEB98D6B,30861,16,19,3,109.52722,18.22743,1606
244311,2EC9A01B9F6379C2C079528EAEB98D6B,31421,20,23,3,109.55382,18.22347,1705
244312,1A6EAA2168CC835EA94CCB88CD588780,60551,2,6,4,109.42722,18.30111,1218
244313,1A6EAA2168CC835EA94CCB88CD588780,31781,10,11,1,109.19847,18.2975,367
244314,D2D609608AA1D4DD8E18DD3745793D0D,30854,0,1,1,109.56889,18.27076,1763
244315,D2D609608AA1D4DD8E18DD3745793D0D,31071,1,6,5,109.58257,18.28458,1815
244316,D2D609608AA1D4DD8E18DD3745793D0D,30854,7,17,10,109.56889,18.27076,1763
244317,D2D609608AA1D4DD8E18DD3745793D0D,31071,17,18,1,109.58257,18.28458,1815
244318,D2D609608AA1D4DD8E18DD3745793D0D,30854,20,21,1,109.56889,18.27076,1763
244330,EAB13D8DCF040DFD77DED2DC4F282C5E,31071,4,5,1,109.58257,18.28458,1815
244331,EAB13D8DCF040DFD77DED2DC4F282C5E,30531,6,16,10,109.53271,18.21472,1604
244332,EAB13D8DCF040DFD77DED2DC4F282C5E,31071,18,19,1,109.58257,18.28458,1815
244338,9B389AE8E9B004176803CCEAFF69104A,39371,0,5,5,109.56627,18.2646,1762
244339,9B389AE8E9B004176803CCEAFF69104A,30951,7,15,8,109.56208,18.25667,1761
244340,9B389AE8E9B004176803CCEAFF69104A,60631,16,18,2,109.57778,18.27583,1814
244341,9B389AE8E9B004176803CCEAFF69104A,39371,22,23,1,109.56627,18.2646,1762
244364,A8E229AD359BAFAD8DE94B2EA508C4AD,38291,1,8,7,109.51618,18.24313,1558
244365,A8E229AD359BAFAD8DE94B2EA508C4AD,60087,9,15,6,109.50688,18.22299,1505
244366,A8E229AD359BAFAD8DE94B2EA508C4AD,31201,16,18,2,109.51042,18.23819,1558
244367,A8E229AD359BAFAD8DE94B2EA508C4AD,30421,18,20,2,109.50021,18.25861,1511
244368,A8E229AD359BAFAD8DE94B2EA508C4AD,30191,21,23,2,109.50361,18.22701,1506
244398,C4637BB33A8AE1046D9835B859742468,30854,9,12,3,109.56889,18.27076,1763
244399,C4637BB33A8AE1046D9835B859742468,31071,13,15,2,109.58257,18.28458,1815
244400,C4637BB33A8AE1046D9835B859742468,30854,15,21,6,109.56889,18.27076,1763
244406,C17F2EF1DEA79C8C951E3013EE071B2C,31945,15,16,1,109.58021,18.29403,1817
244407,C17F2EF1DEA79C8C951E3013EE071B2C,60381,19,20,1,109.5241,18.22458,1605
244438,BCA001FBB8FD352D450AB5BA721CDF88,31431,0,6,6,109.44639,18.29042,1316
244444,0442B38E8824E569B00E80CCEFC70940,39183,0,1,1,109.55542,18.28208,1715
244445,0442B38E8824E569B00E80CCEFC70940,31561,1,4,3,109.56792,18.28479,1765
244446,0442B38E8824E569B00E80CCEFC70940,39183,7,9,2,109.55542,18.28208,1715
244447,0442B38E8824E569B00E80CCEFC70940,30854,18,20,2,109.56889,18.27076,1763
244448,0442B38E8824E569B00E80CCEFC70940,31951,21,23,2,109.52174,18.30299,1568
244449,90F3300D143E0362CC2D61396D0D92D9,30661,0,4,4,109.37028,18.24361,1008
244450,90F3300D143E0362CC2D61396D0D92D9,38834,4,6,2,109.47639,18.21146,1403
244451,90F3300D143E0362CC2D61396D0D92D9,31781,11,12,1,109.19847,18.2975,367
244452,90F3300D143E0362CC2D61396D0D92D9,31471,14,16,2,109.34583,18.29563,917
244457,17D13F6A66037B54FAB5668CDC734401,30721,0,7,7,109.51597,18.28257,1565
244458,17D13F6A66037B54FAB5668CDC734401,31931,7,18,11,109.54771,18.29403,1667
244459,17D13F6A66037B54FAB5668CDC734401,30721,20,22,2,109.51597,18.28257,1565
244466,E8360EC7045D7533E018C0DD4BA3F683,31851,16,22,6,109.71736,18.29007,2316
244502,0207E1FFE1F4E812F7B60ECDB11A3A32,31531,0,10,10,109.49583,18.25972,1461
244505,66864E1E8AC0EC5BDABE36A6259E7E95,31811,0,6,6,109.54201,18.31806,1671
244506,66864E1E8AC0EC5BDABE36A6259E7E95,60501,7,8,1,109.48701,18.29021,1466
244507,66864E1E8AC0EC5BDABE36A6259E7E95,38251,9,11,2,109.49618,18.25493,1510
244508,66864E1E8AC0EC5BDABE36A6259E7E95,30211,11,12,1,109.49882,18.23931,1508
244565,B686D3B43D34677518993C0625C36D62,31561,15,17,2,109.56792,18.28479,1765
244566,B686D3B43D34677518993C0625C36D62,30851,17,18,1,109.5616,18.27396,1713
244572,16D0D368FD3BC47081E9D9081C1E1F90,30854,7,8,1,109.56889,18.27076,1763
244573,16D0D368FD3BC47081E9D9081C1E1F90,31071,10,12,2,109.58257,18.28458,1815
244574,16D0D368FD3BC47081E9D9081C1E1F90,30854,14,21,7,109.56889,18.27076,1763
244585,1E1181D91A7FDEE2449092386CA6A77C,60041,0,6,6,109.39889,18.31944,1121
244586,1E1181D91A7FDEE2449092386CA6A77C,60552,6,8,2,109.41729,18.30014,1218
244587,1E1181D91A7FDEE2449092386CA6A77C,60041,11,13,2,109.39889,18.31944,1121
244600,8621CFDF1B89A83351494618C53D033F,39181,1,6,5,109.55153,18.28035,1715
244601,8621CFDF1B89A83351494618C53D033F,31071,9,18,9,109.58257,18.28458,1815
244602,8621CFDF1B89A83351494618C53D033F,30851,20,22,2,109.5616,18.27396,1713
244603,3E0CC1F431A959DE24ABB41EC7702F6D,60524,3,8,5,109.42951,18.28993,1216
244604,3E0CC1F431A959DE24ABB41EC7702F6D,30351,12,13,1,109.41701,18.29292,1217
244605,3E0CC1F431A959DE24ABB41EC7702F6D,31231,15,18,3,109.42597,18.29292,1217
244606,3E0CC1F431A959DE24ABB41EC7702F6D,30351,22,23,1,109.41701,18.29292,1217
244643,3E244234D69B8A1AEE01C39E0BA72446,30851,10,11,1,109.5616,18.27396,1713
244644,3E244234D69B8A1AEE01C39E0BA72446,31145,13,15,2,109.20431,18.30479,369
244645,14F257919D1F3A7CE4674DF72BE93FA3,60084,0,7,7,109.4984,18.2334,1507
244646,14F257919D1F3A7CE4674DF72BE93FA3,31781,10,11,1,109.19847,18.2975,367
244647,14F257919D1F3A7CE4674DF72BE93FA3,60054,15,16,1,109.3016,18.31229,770
244648,14F257919D1F3A7CE4674DF72BE93FA3,60221,18,20,2,109.52569,18.29188,1616
244649,14F257919D1F3A7CE4674DF72BE93FA3,60084,22,23,1,109.4984,18.2334,1507
244664,6208C975549EEEB8D4C55F71CEB62229,30854,10,12,2,109.56889,18.27076,1763
244665,6208C975549EEEB8D4C55F71CEB62229,31071,13,16,3,109.58257,18.28458,1815
244666,6208C975549EEEB8D4C55F71CEB62229,30854,20,21,1,109.56889,18.27076,1763
244671,BE7763F8096EB5A037146E1CC4190538,30854,0,2,2,109.56889,18.27076,1763
244672,BE7763F8096EB5A037146E1CC4190538,31561,3,5,2,109.56792,18.28479,1765
244673,BE7763F8096EB5A037146E1CC4190538,39183,9,10,1,109.55542,18.28208,1715
244674,BE7763F8096EB5A037146E1CC4190538,30854,12,13,1,109.56889,18.27076,1763
244675,BE7763F8096EB5A037146E1CC4190538,30851,14,16,2,109.5616,18.27396,1713
244682,63CB222117AB8A54673799718246EF46,30084,2,9,7,109.50118,18.26972,1513
244683,63CB222117AB8A54673799718246EF46,30081,12,15,3,109.50243,18.26632,1512
244684,63CB222117AB8A54673799718246EF46,30711,16,18,2,109.50271,18.25347,1510
244685,63CB222117AB8A54673799718246EF46,30084,20,21,1,109.50118,18.26972,1513
244698,703AD9701692A79156581C270F9F1324,31221,0,5,5,109.61333,18.26833,1913
244700,703AD9701692A79156581C270F9F1324,31221,10,15,5,109.61333,18.26833,1913
244701,703AD9701692A79156581C270F9F1324,60594,18,19,1,109.62694,18.22799,1956
244702,703AD9701692A79156581C270F9F1324,30581,20,21,1,109.62257,18.24951,1959
244710,332A868849E47177376F9755C981E1C1,60391,6,7,1,109.47667,18.28757,1416
244711,332A868849E47177376F9755C981E1C1,31931,8,16,8,109.54771,18.29403,1667
244721,AE1D2CB811A45E9D0BA691392CEA1100,31071,1,10,9,109.58257,18.28458,1815
244722,AE1D2CB811A45E9D0BA691392CEA1100,31071,14,16,2,109.58257,18.28458,1815
244850,754661A1CBF0E640F6CB66845B93104E,60661,0,6,6,109.548,18.2377,1657
244851,754661A1CBF0E640F6CB66845B93104E,60641,7,8,1,109.53854,18.2359,1657
244852,754661A1CBF0E640F6CB66845B93104E,60661,13,23,10,109.548,18.2377,1657
244858,EB316856896788EC8FD871E122E95728,31811,12,13,1,109.54201,18.31806,1671
244859,EB316856896788EC8FD871E122E95728,30701,13,19,6,109.59313,18.32007,1871
244890,4E8A1FFC680701A862F9A60D8BF0780C,38162,0,8,8,109.43944,18.28889,1266
244891,4E8A1FFC680701A862F9A60D8BF0780C,31701,9,18,9,109.44132,18.28833,1266
244892,4E8A1FFC680701A862F9A60D8BF0780C,38162,20,21,1,109.43944,18.28889,1266
244893,4E8A1FFC680701A862F9A60D8BF0780C,60472,22,23,1,109.46625,18.29542,1367
244897,878FC5EBB1B28FAABA6E6BFD01664318,30251,0,7,7,109.50611,18.26653,1512
244898,878FC5EBB1B28FAABA6E6BFD01664318,30711,8,10,2,109.50271,18.25347,1510
244899,878FC5EBB1B28FAABA6E6BFD01664318,30251,12,17,5,109.50611,18.26653,1512
244900,878FC5EBB1B28FAABA6E6BFD01664318,31031,20,21,1,109.49979,18.25382,1510
244915,CD3BCBAB8571FB81953C842A434E5DB8,31071,0,6,6,109.58257,18.28458,1815
244916,CD3BCBAB8571FB81953C842A434E5DB8,30854,6,13,7,109.56889,18.27076,1763
244917,CD3BCBAB8571FB81953C842A434E5DB8,31071,14,16,2,109.58257,18.28458,1815
244918,CD3BCBAB8571FB81953C842A434E5DB8,30854,16,20,4,109.56889,18.27076,1763
244962,4B004637D3CFBCA65EA00FFD3F1EF7A6,31561,0,1,1,109.56792,18.28479,1765
244963,4B004637D3CFBCA65EA00FFD3F1EF7A6,30854,3,5,2,109.56889,18.27076,1763
244964,4B004637D3CFBCA65EA00FFD3F1EF7A6,39183,7,10,3,109.55542,18.28208,1715
244965,4B004637D3CFBCA65EA00FFD3F1EF7A6,60371,14,16,2,109.53063,18.30056,1618
244966,4B004637D3CFBCA65EA00FFD3F1EF7A6,30854,18,19,1,109.56889,18.27076,1763
245000,92387D10E48410A653E7FED699DEDE76,39183,0,6,6,109.55542,18.28208,1715
245001,92387D10E48410A653E7FED699DEDE76,31071,7,8,1,109.58257,18.28458,1815
245002,92387D10E48410A653E7FED699DEDE76,30851,12,13,1,109.5616,18.27396,1713
245010,3018A59307B3FCF174C9259743A17A51,31071,15,16,1,109.58257,18.28458,1815
245011,3018A59307B3FCF174C9259743A17A51,31071,20,22,2,109.58257,18.28458,1815
245052,E27729CF5C68766C958C34CEBE1241B2,30351,0,1,1,109.41701,18.29292,1217
245053,E27729CF5C68766C958C34CEBE1241B2,60552,2,7,5,109.41729,18.30014,1218
245054,E27729CF5C68766C958C34CEBE1241B2,60054,11,13,2,109.3016,18.31229,770
245068,CD83F2F70DCDDC76ED162E9187E37A88,39183,0,9,9,109.55542,18.28208,1715
245069,CD83F2F70DCDDC76ED162E9187E37A88,31931,11,17,6,109.54771,18.29403,1667
245070,CD83F2F70DCDDC76ED162E9187E37A88,31561,21,23,2,109.56792,18.28479,1765
245071,909FBB0C84910641E7440FBAD40E8C52,39183,0,8,8,109.55542,18.28208,1715
245072,909FBB0C84910641E7440FBAD40E8C52,31071,11,14,3,109.58257,18.28458,1815
245073,909FBB0C84910641E7440FBAD40E8C52,30851,15,17,2,109.5616,18.27396,1713
245076,B164B8C0AEC0E295C9ED3DBE75B5D547,30084,19,20,1,109.50118,18.26972,1513
245077,B164B8C0AEC0E295C9ED3DBE75B5D547,31031,20,22,2,109.49979,18.25382,1510
245124,5264833F0013AE6B294396000613EF89,31041,0,17,17,109.50278,18.23701,1507
245125,5264833F0013AE6B294396000613EF89,30721,22,23,1,109.51597,18.28257,1565
245126,AE6DC7ACB81DB5F351E45AC25E5F5A3B,31206,0,2,2,109.50819,18.23549,1507
245127,AE6DC7ACB81DB5F351E45AC25E5F5A3B,38297,4,7,3,109.52576,18.24965,1609
245128,AE6DC7ACB81DB5F351E45AC25E5F5A3B,30771,8,10,2,109.49938,18.26042,1511
245129,AE6DC7ACB81DB5F351E45AC25E5F5A3B,38297,12,23,11,109.52576,18.24965,1609
245137,54EA5A03224802DD904B7C6F69D9E71B,38951,0,7,7,109.48097,18.28868,1416
245138,54EA5A03224802DD904B7C6F69D9E71B,31231,10,11,1,109.42597,18.29292,1217
245139,54EA5A03224802DD904B7C6F69D9E71B,30661,13,16,3,109.37028,18.24361,1008
245140,54EA5A03224802DD904B7C6F69D9E71B,60381,18,19,1,109.5241,18.22458,1605
245141,54EA5A03224802DD904B7C6F69D9E71B,38951,21,23,2,109.48097,18.28868,1416
245157,993300654839821E7CBC0B1D6C1A4599,61011,1,12,11,109.60653,18.19076,1900
245159,2F440A235E684ECEDD042B3100A4AE95,31561,12,14,2,109.56792,18.28479,1765
245160,2F440A235E684ECEDD042B3100A4AE95,30854,14,18,4,109.56889,18.27076,1763
245163,0402BD114B7D5E20705E302B756CD062,60631,0,7,7,109.57778,18.27583,1814
245164,0402BD114B7D5E20705E302B756CD062,31071,8,9,1,109.58257,18.28458,1815
245165,0402BD114B7D5E20705E302B756CD062,30854,11,20,9,109.56889,18.27076,1763
245167,3E507BA86FBA703DAF19C68A80411CA5,30854,22,23,1,109.56889,18.27076,1763
245168,282786EFD7BB2C684B51EB83D9362631,30971,0,8,8,109.48708,18.29319,1467
245169,282786EFD7BB2C684B51EB83D9362631,30971,12,15,3,109.48708,18.29319,1467
245170,282786EFD7BB2C684B51EB83D9362631,30791,16,17,1,109.72333,18.40889,2386
245177,5EBEA276FCB4A19AC5C987F5C7CC8908,60524,0,5,5,109.42951,18.28993,1216
245178,5EBEA276FCB4A19AC5C987F5C7CC8908,60401,6,8,2,109.47444,18.27583,1414
245179,5EBEA276FCB4A19AC5C987F5C7CC8908,60621,8,10,2,109.48354,18.27451,1464
245180,5EBEA276FCB4A19AC5C987F5C7CC8908,60524,13,14,1,109.42951,18.28993,1216
245181,5EBEA276FCB4A19AC5C987F5C7CC8908,60621,14,16,2,109.48354,18.27451,1464
245182,5EBEA276FCB4A19AC5C987F5C7CC8908,60552,20,23,3,109.41729,18.30014,1218
245186,3B6FF1F8D896A0A62DC7E65967011999,39183,0,10,10,109.55542,18.28208,1715
245187,3B6FF1F8D896A0A62DC7E65967011999,31561,15,22,7,109.56792,18.28479,1765
245200,8D381F127A95193D387DCE543867137E,39091,21,22,1,109.50097,18.25222,1510
245241,0312B43ACF9ED1D8304E325E851AEE29,31561,3,13,10,109.56792,18.28479,1765
245242,0312B43ACF9ED1D8304E325E851AEE29,30851,15,16,1,109.5616,18.27396,1713
245243,0312B43ACF9ED1D8304E325E851AEE29,31561,16,17,1,109.56792,18.28479,1765
245244,0312B43ACF9ED1D8304E325E851AEE29,30851,21,23,2,109.5616,18.27396,1713
245250,1B4CC2DF3534E139B7BDB2BC1E7BA919,30861,0,6,6,109.52722,18.22743,1606
245251,1B4CC2DF3534E139B7BDB2BC1E7BA919,31145,10,12,2,109.20431,18.30479,369
245252,1B4CC2DF3534E139B7BDB2BC1E7BA919,31471,14,15,1,109.34583,18.29563,917
245253,59B48C7DD533E36B4AA6ADABEB53F8C6,60631,0,5,5,109.57778,18.27583,1814
245254,59B48C7DD533E36B4AA6ADABEB53F8C6,31571,7,8,1,109.61563,18.23326,1957
245283,043146C5CE5F8CF55A3C39C0EBF4DEF0,31471,14,16,2,109.34583,18.29563,917
245284,043146C5CE5F8CF55A3C39C0EBF4DEF0,30421,19,21,2,109.50021,18.25861,1511
245332,C8135D3E403B7CC96352A41CBCD291A7,31171,16,17,1,109.50938,18.24917,1559
245333,C8135D3E403B7CC96352A41CBCD291A7,31931,20,21,1,109.54771,18.29403,1667
245358,179FD4660C817BD29234A518F00339D3,60231,6,20,14,109.49903,18.21972,1504
245359,179FD4660C817BD29234A518F00339D3,60084,22,23,1,109.4984,18.2334,1507
245374,4EEB87EFD2F33BBAF42BE530271C40CA,31161,0,8,8,109.70229,18.31361,2270
245375,4EEB87EFD2F33BBAF42BE530271C40CA,31881,12,14,2,109.7441,18.40785,2436
245383,D40486BFA9AC720A5137C9EAFB418BFA,30854,13,15,2,109.56889,18.27076,1763
245384,D40486BFA9AC720A5137C9EAFB418BFA,31931,15,16,1,109.54771,18.29403,1667
245385,D40486BFA9AC720A5137C9EAFB418BFA,60361,19,23,4,109.51938,18.29681,1567
245409,7EB4F76900011DECC835981CBE847D5E,31561,0,1,1,109.56792,18.28479,1765
245410,7EB4F76900011DECC835981CBE847D5E,30854,2,5,3,109.56889,18.27076,1763
245411,7EB4F76900011DECC835981CBE847D5E,31561,6,16,10,109.56792,18.28479,1765
245420,B7A2800FDF738E1064EAD2A5E58F7A3C,61011,0,14,14,109.60653,18.19076,1900
245422,B7A2800FDF738E1064EAD2A5E58F7A3C,61011,20,22,2,109.60653,18.19076,1900
245446,8265A029C672FE0377EF574CC3ADF2A8,30854,0,6,6,109.56889,18.27076,1763
245447,8265A029C672FE0377EF574CC3ADF2A8,39181,7,8,1,109.55153,18.28035,1715
245448,8265A029C672FE0377EF574CC3ADF2A8,39183,8,10,2,109.55542,18.28208,1715
245449,8265A029C672FE0377EF574CC3ADF2A8,30854,11,14,3,109.56889,18.27076,1763
245488,64F4CDF664AA04E7B79DE93C57128CF6,30851,14,16,2,109.5616,18.27396,1713
245489,64F4CDF664AA04E7B79DE93C57128CF6,31931,20,21,1,109.54771,18.29403,1667
245507,478D8ECA4D0ED449A4B0B8758C69C071,30084,14,15,1,109.50118,18.26972,1513
245508,478D8ECA4D0ED449A4B0B8758C69C071,30741,17,19,2,109.49833,18.28681,1516
245509,478D8ECA4D0ED449A4B0B8758C69C071,30741,21,23,2,109.49833,18.28681,1516
245533,348364DAC537A5A7729C356B64D64B52,39183,0,6,6,109.55542,18.28208,1715
245534,348364DAC537A5A7729C356B64D64B52,39181,6,10,4,109.55153,18.28035,1715
245535,348364DAC537A5A7729C356B64D64B52,31931,11,13,2,109.54771,18.29403,1667
245536,348364DAC537A5A7729C356B64D64B52,31561,15,16,1,109.56792,18.28479,1765
245539,542AC211E6240BA31C29EF3A8CB800AF,31421,0,9,9,109.55382,18.22347,1705
245540,542AC211E6240BA31C29EF3A8CB800AF,31461,11,12,1,109.5091,18.25389,1510
245541,542AC211E6240BA31C29EF3A8CB800AF,60111,13,17,4,109.72556,18.31924,2371
245542,542AC211E6240BA31C29EF3A8CB800AF,60201,19,22,3,109.5041,18.2509,1510
245543,A8B250EB4B4FCB9AA28B7DB7DA08558B,38157,3,4,1,109.51483,18.26958,1563
245544,A8B250EB4B4FCB9AA28B7DB7DA08558B,31931,8,9,1,109.54771,18.29403,1667
245545,A8B250EB4B4FCB9AA28B7DB7DA08558B,30854,14,15,1,109.56889,18.27076,1763
245577,E292D83051830D054E89D209EEABA4B9,31071,0,9,9,109.58257,18.28458,1815
245578,E292D83051830D054E89D209EEABA4B9,31561,11,19,8,109.56792,18.28479,1765
245579,E292D83051830D054E89D209EEABA4B9,30854,22,23,1,109.56889,18.27076,1763
245600,2045F87259C3396ECF12D73ACA58A5D3,31071,3,10,7,109.58257,18.28458,1815
245601,2045F87259C3396ECF12D73ACA58A5D3,30854,11,23,12,109.56889,18.27076,1763
245619,372BCC9E34709FCD9ED7D887E115E777,31561,1,6,5,109.56792,18.28479,1765
245620,372BCC9E34709FCD9ED7D887E115E777,30854,7,10,3,109.56889,18.27076,1763
245621,372BCC9E34709FCD9ED7D887E115E777,31561,12,22,10,109.56792,18.28479,1765
245646,C93386A9D86FE22A1FD4E5116045DD8D,30851,13,17,4,109.5616,18.27396,1713
245647,C93386A9D86FE22A1FD4E5116045DD8D,31561,21,23,2,109.56792,18.28479,1765
245673,BAFDD3A022A674BA6CCC93E365FAFC36,30084,17,18,1,109.50118,18.26972,1513
245674,BAFDD3A022A674BA6CCC93E365FAFC36,31461,18,20,2,109.5091,18.25389,1510
245722,EFDE35289FEC1E13D6F34EFEE66A8AD2,60631,0,7,7,109.57778,18.27583,1814
245723,EFDE35289FEC1E13D6F34EFEE66A8AD2,30854,7,17,10,109.56889,18.27076,1763
245724,EFDE35289FEC1E13D6F34EFEE66A8AD2,60631,19,23,4,109.57778,18.27583,1814
245734,7A02B47CA444ED227E88DEEC4D609540,31781,12,15,3,109.19847,18.2975,367
245735,7A02B47CA444ED227E88DEEC4D609540,31471,15,17,2,109.34583,18.29563,917
245736,7A02B47CA444ED227E88DEEC4D609540,30361,19,20,1,109.50347,18.24,1508
245737,DA10676C4DA702E02A2C3FFFAC40ABA2,31561,0,7,7,109.56792,18.28479,1765
245738,DA10676C4DA702E02A2C3FFFAC40ABA2,39371,11,12,1,109.56627,18.2646,1762
245739,DA10676C4DA702E02A2C3FFFAC40ABA2,31561,13,23,10,109.56792,18.28479,1765
245746,3977578BE56276DA0700B04B81DC1356,30851,11,14,3,109.5616,18.27396,1713
245747,3977578BE56276DA0700B04B81DC1356,31561,14,16,2,109.56792,18.28479,1765
245748,3977578BE56276DA0700B04B81DC1356,30851,16,20,4,109.5616,18.27396,1713
245765,E185F7F6F36381B5DE13870782051008,60381,19,20,1,109.5241,18.22458,1605
245807,B7E330D15F4B46614A332696B5F7027D,30854,14,15,1,109.56889,18.27076,1763
245808,B7E330D15F4B46614A332696B5F7027D,31931,18,23,5,109.54771,18.29403,1667
245850,0E129C09250C0D46273B4BD7E5225556,31471,13,16,3,109.34583,18.29563,917
245851,0E129C09250C0D46273B4BD7E5225556,60201,18,20,2,109.5041,18.2509,1510
245852,0E129C09250C0D46273B4BD7E5225556,30151,20,23,3,109.50986,18.25083,1560
245920,C709D01469E0800AF998DFAF42105CDC,30854,0,6,6,109.56889,18.27076,1763
245921,C709D01469E0800AF998DFAF42105CDC,31561,6,15,9,109.56792,18.28479,1765
245922,C709D01469E0800AF998DFAF42105CDC,30854,18,21,3,109.56889,18.27076,1763
245943,FA14B010F60C7FB3B13194FAA13740E8,31561,0,13,13,109.56792,18.28479,1765
245944,FA14B010F60C7FB3B13194FAA13740E8,30851,14,16,2,109.5616,18.27396,1713
245945,FA14B010F60C7FB3B13194FAA13740E8,31561,16,17,1,109.56792,18.28479,1765
245946,FA14B010F60C7FB3B13194FAA13740E8,30854,21,22,1,109.56889,18.27076,1763
245954,451E2BF48CD7B253EB0892324E679BCC,38291,3,5,2,109.51618,18.24313,1558
245955,451E2BF48CD7B253EB0892324E679BCC,60281,9,19,10,109.51743,18.25924,1561
245956,451E2BF48CD7B253EB0892324E679BCC,38297,20,21,1,109.52576,18.24965,1609
245974,7D700D7B939DF0B50E1623297FA9AE05,31931,14,19,5,109.54771,18.29403,1667
245975,7D700D7B939DF0B50E1623297FA9AE05,60241,21,22,1,109.53319,18.28667,1616
245976,8A0382A2385C362EFE2664E8795F133E,30854,19,20,1,109.56889,18.27076,1763
245977,8A0382A2385C362EFE2664E8795F133E,31561,20,23,3,109.56792,18.28479,1765
245997,B0EA82CA44F2A5DBEC337F9E5C778FEC,39183,0,8,8,109.55542,18.28208,1715
245998,B0EA82CA44F2A5DBEC337F9E5C778FEC,39181,8,10,2,109.55153,18.28035,1715
245999,B0EA82CA44F2A5DBEC337F9E5C778FEC,31931,14,15,1,109.54771,18.29403,1667
246017,FF44A01712CEF692A20866E24012EF28,31561,17,20,3,109.56792,18.28479,1765
246053,FE119DB57322892B4DF62B443B992BDF,38871,0,6,6,109.44681,18.28625,1316
246054,FE119DB57322892B4DF62B443B992BDF,31701,6,10,4,109.44132,18.28833,1266
246055,FE119DB57322892B4DF62B443B992BDF,33051,13,14,1,109.6475,18.46618,2096
246056,FE119DB57322892B4DF62B443B992BDF,60221,16,18,2,109.52569,18.29188,1616
246057,FE119DB57322892B4DF62B443B992BDF,30051,20,21,1,109.48917,18.21215,1453
246110,2C3BD53A8702A47FB82F05FB4993B683,31561,0,13,13,109.56792,18.28479,1765
246111,2C3BD53A8702A47FB82F05FB4993B683,30854,16,17,1,109.56889,18.27076,1763
246112,2C3BD53A8702A47FB82F05FB4993B683,31561,18,23,5,109.56792,18.28479,1765
246126,807F73DE76DFE56E472FA61396F0887C,30711,11,14,3,109.50271,18.25347,1510
246127,807F73DE76DFE56E472FA61396F0887C,30711,17,18,1,109.50271,18.25347,1510
246128,807F73DE76DFE56E472FA61396F0887C,30321,20,22,2,109.49563,18.29611,1467
246143,866460FA5062A635337B6369BB2AADDA,30441,13,18,5,109.64021,18.25424,2010
246144,866460FA5062A635337B6369BB2AADDA,30854,22,23,1,109.56889,18.27076,1763
246153,F6A1EBB84FE583E84185C423218578F5,31561,0,5,5,109.56792,18.28479,1765
246154,F6A1EBB84FE583E84185C423218578F5,31931,7,9,2,109.54771,18.29403,1667
246164,860D8FD1FD466E2189F245D42B766A0C,30271,0,8,8,109.49132,18.23153,1456
246165,860D8FD1FD466E2189F245D42B766A0C,30671,10,11,1,109.43611,18.30139,1268
246166,860D8FD1FD466E2189F245D42B766A0C,30271,14,15,1,109.49132,18.23153,1456
246167,860D8FD1FD466E2189F245D42B766A0C,60381,17,18,1,109.5241,18.22458,1605
246168,860D8FD1FD466E2189F245D42B766A0C,30271,21,23,2,109.49132,18.23153,1456
246179,EAD0F857A028E27AEC5E665129C31CC4,38706,0,5,5,109.74625,18.37097,2430
246180,EAD0F857A028E27AEC5E665129C31CC4,30961,7,10,3,109.74042,18.37903,2431
246182,5202825DF51CA068C8B204422480230F,31071,3,7,4,109.58257,18.28458,1815
246183,5202825DF51CA068C8B204422480230F,31761,7,10,3,109.60521,18.27965,1914
246229,D39D64452E6BBEF7B3056CA239E1B86E,31561,14,15,1,109.56792,18.28479,1765
246230,D39D64452E6BBEF7B3056CA239E1B86E,30854,16,23,7,109.56889,18.27076,1763
246236,40C57F24FE0409ABB752B2031C349577,38951,16,18,2,109.48097,18.28868,1416
246237,40C57F24FE0409ABB752B2031C349577,39091,20,21,1,109.50097,18.25222,1510
246238,40C57F24FE0409ABB752B2031C349577,38951,21,23,2,109.48097,18.28868,1416
246246,810CE53DFCE3F9F9B1D54C13B89D4921,30504,0,7,7,109.705,18.35368,2277
246248,810CE53DFCE3F9F9B1D54C13B89D4921,30504,15,18,3,109.705,18.35368,2277
246249,810CE53DFCE3F9F9B1D54C13B89D4921,60117,18,23,5,109.73604,18.35681,2427
246257,767325C9C51C25E76A4781E7E66DE8D0,38023,0,7,7,109.37132,18.28993,1016
246258,767325C9C51C25E76A4781E7E66DE8D0,30341,7,8,1,109.3625,18.29167,966
246260,A7D270EF8C74F66D966F17A0E3BC8BC9,33481,12,14,2,109.67278,18.41278,2187
246261,A7D270EF8C74F66D966F17A0E3BC8BC9,30854,15,22,7,109.56889,18.27076,1763
246301,34AB502A442AA8EA4A7FB30471B204DB,60621,0,2,2,109.48354,18.27451,1464
246302,34AB502A442AA8EA4A7FB30471B204DB,38325,4,7,3,109.39792,18.2909,1116
246303,34AB502A442AA8EA4A7FB30471B204DB,60401,8,11,3,109.47444,18.27583,1414
246304,34AB502A442AA8EA4A7FB30471B204DB,38251,11,13,2,109.49618,18.25493,1510
246305,34AB502A442AA8EA4A7FB30471B204DB,30341,13,17,4,109.3625,18.29167,966
246316,1A3EA2E067124B6FFA24EC348CDAFF81,30051,0,3,3,109.48917,18.21215,1453
246317,1A3EA2E067124B6FFA24EC348CDAFF81,30661,3,7,4,109.37028,18.24361,1008
246318,1A3EA2E067124B6FFA24EC348CDAFF81,31781,9,12,3,109.19847,18.2975,367
246319,1A3EA2E067124B6FFA24EC348CDAFF81,60231,19,21,2,109.49903,18.21972,1504
246320,1A3EA2E067124B6FFA24EC348CDAFF81,30051,22,23,1,109.48917,18.21215,1453
246329,4BCFB9B7DA47F954D069C9FF9050BF88,31071,0,2,2,109.58257,18.28458,1815
246330,4BCFB9B7DA47F954D069C9FF9050BF88,30854,4,22,18,109.56889,18.27076,1763
246361,CD576F1C1CDFB89E6A99A20E65927346,30854,0,13,13,109.56889,18.27076,1763
246362,CD576F1C1CDFB89E6A99A20E65927346,31071,15,17,2,109.58257,18.28458,1815
246363,CD576F1C1CDFB89E6A99A20E65927346,30854,17,23,6,109.56889,18.27076,1763
246370,2E4974DC6B5DC914D4BEF4B8CF2CC13B,31081,0,7,7,109.44639,18.30181,1318
246371,2E4974DC6B5DC914D4BEF4B8CF2CC13B,60391,7,15,8,109.47667,18.28757,1416
246372,2E4974DC6B5DC914D4BEF4B8CF2CC13B,31081,18,23,5,109.44639,18.30181,1318
246382,0695D4E7B3E726CA09D841B87798B560,30854,2,17,15,109.56889,18.27076,1763
246383,0695D4E7B3E726CA09D841B87798B560,31071,19,21,2,109.58257,18.28458,1815
246401,B712327B6033C61F37801CFD6DAC08AD,38484,0,11,11,109.53028,18.31528,1620
246402,B712327B6033C61F37801CFD6DAC08AD,38484,14,16,2,109.53028,18.31528,1620
246403,B712327B6033C61F37801CFD6DAC08AD,38484,19,23,4,109.53028,18.31528,1620
246421,A7B3BDD8DC79485BA41EC7F220A41345,60631,0,9,9,109.57778,18.27583,1814
246422,A7B3BDD8DC79485BA41EC7F220A41345,30891,10,11,1,109.59431,18.28389,1865
246433,DF296B63A64E364FCDA4C38B0935EEEE,30511,0,1,1,109.51069,18.24208,1558
246434,DF296B63A64E364FCDA4C38B0935EEEE,30151,4,10,6,109.50986,18.25083,1560
246435,DF296B63A64E364FCDA4C38B0935EEEE,30511,11,23,12,109.51069,18.24208,1558
246513,CBF71892C67A397772665402624216C5,39183,0,10,10,109.55542,18.28208,1715
246514,CBF71892C67A397772665402624216C5,31931,14,19,5,109.54771,18.29403,1667
246521,09605A95AE7BE30FC92DC699DB3FCBD0,31861,0,2,2,109.49042,18.27549,1464
246522,09605A95AE7BE30FC92DC699DB3FCBD0,30711,2,12,10,109.50271,18.25347,1510
246523,09605A95AE7BE30FC92DC699DB3FCBD0,31461,15,16,1,109.5091,18.25389,1510
246524,09605A95AE7BE30FC92DC699DB3FCBD0,31181,19,23,4,109.50382,18.24813,1509
246527,21572EF63648BA9F4120E83EB6995193,60211,0,9,9,109.63549,18.26049,2011
246528,21572EF63648BA9F4120E83EB6995193,31161,9,17,8,109.70229,18.31361,2270
246584,B78E7295CB13532B4E2C30EF158E297F,30854,0,3,3,109.56889,18.27076,1763
246585,B78E7295CB13532B4E2C30EF158E297F,31931,4,14,10,109.54771,18.29403,1667
246586,B78E7295CB13532B4E2C30EF158E297F,30854,16,18,2,109.56889,18.27076,1763
246587,B78E7295CB13532B4E2C30EF158E297F,31561,19,20,1,109.56792,18.28479,1765
246624,A5F3D2AD273A8099B929F81757B36465,30861,18,20,2,109.52722,18.22743,1606
246625,A5F3D2AD273A8099B929F81757B36465,60311,21,23,2,109.52097,18.24319,1558
246653,30F5D42A1A8F1CF26F5C9617FCB06C4F,31561,0,5,5,109.56792,18.28479,1765
246654,30F5D42A1A8F1CF26F5C9617FCB06C4F,39183,9,10,1,109.55542,18.28208,1715
246655,30F5D42A1A8F1CF26F5C9617FCB06C4F,30854,11,12,1,109.56889,18.27076,1763
246656,30F5D42A1A8F1CF26F5C9617FCB06C4F,31931,14,15,1,109.54771,18.29403,1667
246657,30F5D42A1A8F1CF26F5C9617FCB06C4F,31561,15,22,7,109.56792,18.28479,1765
246714,686A151A10363ED54A6F439954DA26E0,31761,0,3,3,109.60521,18.27965,1914
246716,686A151A10363ED54A6F439954DA26E0,38052,8,9,1,109.62618,18.23042,1956
246717,686A151A10363ED54A6F439954DA26E0,30441,14,21,7,109.64021,18.25424,2010
246718,686A151A10363ED54A6F439954DA26E0,60594,22,23,1,109.62694,18.22799,1956
246779,97C31877CA4226D0F1BA1C0E12066B56,60331,2,6,4,109.505,18.26507,1512
246780,97C31877CA4226D0F1BA1C0E12066B56,30854,7,8,1,109.56889,18.27076,1763
246781,97C31877CA4226D0F1BA1C0E12066B56,31561,8,10,2,109.56792,18.28479,1765
246782,97C31877CA4226D0F1BA1C0E12066B56,30854,15,18,3,109.56889,18.27076,1763
246783,97C31877CA4226D0F1BA1C0E12066B56,30251,20,23,3,109.50611,18.26653,1512
246811,0F09C2BE6A190F4BF3D635D6A9F19FD3,60661,0,7,7,109.548,18.2377,1657
246812,0F09C2BE6A190F4BF3D635D6A9F19FD3,30121,11,16,5,109.52861,18.27222,1613
246813,0F09C2BE6A190F4BF3D635D6A9F19FD3,38291,21,23,2,109.51618,18.24313,1558
246834,3C77BAC9CB4768E90972AC2C164CBD19,60631,0,14,14,109.57778,18.27583,1814
246835,3C77BAC9CB4768E90972AC2C164CBD19,30854,15,16,1,109.56889,18.27076,1763
246836,3C77BAC9CB4768E90972AC2C164CBD19,31181,18,20,2,109.50382,18.24813,1509
246837,8C2A72A3EA8DBE7544B4A433B2BC3FE0,38291,12,16,4,109.51618,18.24313,1558
246838,8C2A72A3EA8DBE7544B4A433B2BC3FE0,60491,19,22,3,109.43354,18.30847,1269
246851,560794A44CA17A43FA34D0FA6C339747,30854,0,6,6,109.56889,18.27076,1763
246852,560794A44CA17A43FA34D0FA6C339747,39104,10,12,2,109.50104,18.2525,1510
246853,560794A44CA17A43FA34D0FA6C339747,31071,15,16,1,109.58257,18.28458,1815
246854,560794A44CA17A43FA34D0FA6C339747,30854,16,17,1,109.56889,18.27076,1763
246866,A2CBC4EC9AE7595B393C856E6E6033FF,31521,0,9,9,109.51458,18.22542,1555
246867,A2CBC4EC9AE7595B393C856E6E6033FF,31781,11,14,3,109.19847,18.2975,367
246868,A2CBC4EC9AE7595B393C856E6E6033FF,31021,18,20,2,109.49021,18.27,1463
246869,A2CBC4EC9AE7595B393C856E6E6033FF,60381,20,23,3,109.5241,18.22458,1605
246870,608A55C14BAB2A5B627ACC1F39B89FB6,31945,0,7,7,109.58021,18.29403,1817
246871,608A55C14BAB2A5B627ACC1F39B89FB6,30854,9,19,10,109.56889,18.27076,1763
246872,608A55C14BAB2A5B627ACC1F39B89FB6,31071,21,22,1,109.58257,18.28458,1815
246951,10EBF762D28520B09848288F7052CFDE,30854,5,7,2,109.56889,18.27076,1763
246952,10EBF762D28520B09848288F7052CFDE,30711,7,8,1,109.50271,18.25347,1510
246953,10EBF762D28520B09848288F7052CFDE,39101,9,23,14,109.50132,18.24931,1509
247005,39B496BBEDAF80FAB2852AC3F417A930,30391,11,16,5,109.4975,18.27118,1513
247015,7C44F60024D8983C8531DB7CE2E3A44C,38961,1,2,1,109.50847,18.23514,1507
247016,7C44F60024D8983C8531DB7CE2E3A44C,30181,2,4,2,109.51597,18.23313,1557
247017,7C44F60024D8983C8531DB7CE2E3A44C,39191,5,7,2,109.51493,18.23472,1557
247021,3066D3BA0EF6F55E10FAD924A6ADDDEF,60201,0,1,1,109.5041,18.2509,1510
247022,3066D3BA0EF6F55E10FAD924A6ADDDEF,60291,1,6,5,109.50826,18.24639,1509
247023,3066D3BA0EF6F55E10FAD924A6ADDDEF,30151,7,12,5,109.50986,18.25083,1560
247024,3066D3BA0EF6F55E10FAD924A6ADDDEF,30151,14,18,4,109.50986,18.25083,1560
247025,3066D3BA0EF6F55E10FAD924A6ADDDEF,60201,21,23,2,109.5041,18.2509,1510
247032,DF5348A8E25901EBB63BBF3F6126BB02,31761,1,2,1,109.60521,18.27965,1914
247033,DF5348A8E25901EBB63BBF3F6126BB02,31071,4,15,11,109.58257,18.28458,1815
247034,DF5348A8E25901EBB63BBF3F6126BB02,30854,18,23,5,109.56889,18.27076,1763
247067,7E72E50B4F301EDC5663E8EF46336DB9,39061,2,3,1,109.38222,18.28958,1066
247068,7E72E50B4F301EDC5663E8EF46336DB9,30341,4,6,2,109.3625,18.29167,966
247077,CF73D0D52A41EE420FB8269A6F6AF679,30854,2,4,2,109.56889,18.27076,1763
247078,CF73D0D52A41EE420FB8269A6F6AF679,30441,4,6,2,109.64021,18.25424,2010
247079,CF73D0D52A41EE420FB8269A6F6AF679,30854,6,7,1,109.56889,18.27076,1763
247080,13A373BC775CFA4B513754EBD5FDCB11,31021,0,8,8,109.49021,18.27,1463
247081,13A373BC775CFA4B513754EBD5FDCB11,60311,12,14,2,109.52097,18.24319,1558
247082,13A373BC775CFA4B513754EBD5FDCB11,38297,15,18,3,109.52576,18.24965,1609
247083,13A373BC775CFA4B513754EBD5FDCB11,31021,20,23,3,109.49021,18.27,1463
247110,FD383D619F571E97F6F509FAB965E5A5,60571,0,15,15,109.50722,18.25056,1510
247111,FD383D619F571E97F6F509FAB965E5A5,31171,16,17,1,109.50938,18.24917,1559
247112,FD383D619F571E97F6F509FAB965E5A5,60641,19,21,2,109.53854,18.2359,1657
247116,89A01963B06628A3D6B13DA41FA507D1,31164,13,15,2,109.69993,18.27215,2263
247117,89A01963B06628A3D6B13DA41FA507D1,31161,17,19,2,109.70229,18.31361,2270
247118,89A01963B06628A3D6B13DA41FA507D1,30854,20,22,2,109.56889,18.27076,1763
247119,89A01963B06628A3D6B13DA41FA507D1,31561,22,23,1,109.56792,18.28479,1765
247120,0F558B6653C655C7F0BAEA9D66B33F57,31071,1,6,5,109.58257,18.28458,1815
247121,0F558B6653C655C7F0BAEA9D66B33F57,30854,9,17,8,109.56889,18.27076,1763
247122,0F558B6653C655C7F0BAEA9D66B33F57,31071,19,20,1,109.58257,18.28458,1815
247126,1026894DC5FF9A7FAF3A2EE28B95E239,39183,2,5,3,109.55542,18.28208,1715
247127,1026894DC5FF9A7FAF3A2EE28B95E239,30854,7,8,1,109.56889,18.27076,1763
247128,1026894DC5FF9A7FAF3A2EE28B95E239,30891,12,14,2,109.59431,18.28389,1865
247129,1026894DC5FF9A7FAF3A2EE28B95E239,30854,16,22,6,109.56889,18.27076,1763
247132,209BA418BA15162F274A1DAAB6F56238,39181,0,5,5,109.55153,18.28035,1715
247133,209BA418BA15162F274A1DAAB6F56238,39181,5,10,5,109.55153,18.28035,1715
247134,209BA418BA15162F274A1DAAB6F56238,31561,14,16,2,109.56792,18.28479,1765
247135,209BA418BA15162F274A1DAAB6F56238,31931,20,22,2,109.54771,18.29403,1667
247144,7421066246AAD1C230E7E2A7ADF06E9D,31071,0,5,5,109.58257,18.28458,1815
247145,7421066246AAD1C230E7E2A7ADF06E9D,60631,6,7,1,109.57778,18.27583,1814
247146,7421066246AAD1C230E7E2A7ADF06E9D,31071,10,12,2,109.58257,18.28458,1815
247147,7421066246AAD1C230E7E2A7ADF06E9D,30854,15,19,4,109.56889,18.27076,1763
247148,7421066246AAD1C230E7E2A7ADF06E9D,30084,19,22,3,109.50118,18.26972,1513
247172,A01B4012B619D942E7CC3AC9B78722B4,31931,14,16,2,109.54771,18.29403,1667
247173,A01B4012B619D942E7CC3AC9B78722B4,30854,17,18,1,109.56889,18.27076,1763
247188,417408FFDA93B177641D270D3A5C4B2D,31071,0,6,6,109.58257,18.28458,1815
247189,417408FFDA93B177641D270D3A5C4B2D,30854,9,12,3,109.56889,18.27076,1763
247190,417408FFDA93B177641D270D3A5C4B2D,31071,12,13,1,109.58257,18.28458,1815
247191,417408FFDA93B177641D270D3A5C4B2D,30854,14,18,4,109.56889,18.27076,1763
247192,417408FFDA93B177641D270D3A5C4B2D,31071,18,20,2,109.58257,18.28458,1815
247193,417408FFDA93B177641D270D3A5C4B2D,30891,21,23,2,109.59431,18.28389,1865
247203,C39A87B1BC9DA20E7546ED50A7A8B13C,30854,7,9,2,109.56889,18.27076,1763
247207,7F83FE9CEAC12AB02197A912DB558E4C,30191,0,6,6,109.50361,18.22701,1506
247208,7F83FE9CEAC12AB02197A912DB558E4C,31781,8,13,5,109.19847,18.2975,367
247209,7F83FE9CEAC12AB02197A912DB558E4C,31521,14,15,1,109.51458,18.22542,1555
247210,7F83FE9CEAC12AB02197A912DB558E4C,31521,16,18,2,109.51458,18.22542,1555
247211,7F83FE9CEAC12AB02197A912DB558E4C,31521,19,20,1,109.51458,18.22542,1555
247212,E377A804A4E01831C27E7EA806A7C42A,31864,0,5,5,109.49014,18.28333,1465
247213,E377A804A4E01831C27E7EA806A7C42A,31361,6,19,13,109.47417,18.28292,1415
247214,E377A804A4E01831C27E7EA806A7C42A,31864,20,23,3,109.49014,18.28333,1465
247248,E484FD222AE68252EABA732103338917,31071,8,10,2,109.58257,18.28458,1815
247249,E484FD222AE68252EABA732103338917,30854,13,16,3,109.56889,18.27076,1763
247250,E484FD222AE68252EABA732103338917,31071,16,18,2,109.58257,18.28458,1815
247251,E484FD222AE68252EABA732103338917,31071,21,23,2,109.58257,18.28458,1815
247252,6E3295BE038630AA5C3C9528B9405511,60381,0,1,1,109.5241,18.22458,1605
247253,6E3295BE038630AA5C3C9528B9405511,38117,1,2,1,109.51611,18.22354,1555
247254,6E3295BE038630AA5C3C9528B9405511,39321,5,7,2,109.529,18.2167,1604
247255,6E3295BE038630AA5C3C9528B9405511,31781,11,13,2,109.19847,18.2975,367
247256,6E3295BE038630AA5C3C9528B9405511,60381,16,17,1,109.5241,18.22458,1605
247272,EFFEF00C078D502D6D0D1D469ACBA466,30421,0,7,7,109.50021,18.25861,1511
247273,EFFEF00C078D502D6D0D1D469ACBA466,39371,9,11,2,109.56627,18.2646,1762
247274,EFFEF00C078D502D6D0D1D469ACBA466,38325,13,14,1,109.39792,18.2909,1116
247275,EFFEF00C078D502D6D0D1D469ACBA466,30421,19,22,3,109.50021,18.25861,1511
247282,62893E04FCF540C6F38C23E5C7023557,31351,0,8,8,109.4959,18.28417,1465
247283,62893E04FCF540C6F38C23E5C7023557,31931,11,16,5,109.54771,18.29403,1667
247284,62893E04FCF540C6F38C23E5C7023557,31351,18,23,5,109.4959,18.28417,1465
247294,D4448A1349B0563C78F16B479359A95F,30854,14,16,2,109.56889,18.27076,1763
247295,D4448A1349B0563C78F16B479359A95F,31071,19,21,2,109.58257,18.28458,1815
247311,FD20A7AF137B3BF6EC80FAD25D4BEAFA,31206,18,20,2,109.50819,18.23549,1507
247312,FD20A7AF137B3BF6EC80FAD25D4BEAFA,30711,21,23,2,109.50271,18.25347,1510
247325,C1602FB5A20BD98313F7CC13F431D061,30271,0,7,7,109.49132,18.23153,1456
247326,C1602FB5A20BD98313F7CC13F431D061,30771,9,10,1,109.49938,18.26042,1511
247327,C1602FB5A20BD98313F7CC13F431D061,30421,11,14,3,109.50021,18.25861,1511
247328,8DD23AA43C0F7967C45F7488D66F9159,31071,0,3,3,109.58257,18.28458,1815
247329,8DD23AA43C0F7967C45F7488D66F9159,30854,3,4,1,109.56889,18.27076,1763
247330,8DD23AA43C0F7967C45F7488D66F9159,39371,5,6,1,109.56627,18.2646,1762
247331,8DD23AA43C0F7967C45F7488D66F9159,30854,7,21,14,109.56889,18.27076,1763
247332,8DD23AA43C0F7967C45F7488D66F9159,30851,22,23,1,109.5616,18.27396,1713
247337,BD4652414D5C17466BA36FD4BD943A94,60221,0,6,6,109.52569,18.29188,1616
247338,BD4652414D5C17466BA36FD4BD943A94,39183,8,9,1,109.55542,18.28208,1715
247339,BD4652414D5C17466BA36FD4BD943A94,31931,12,14,2,109.54771,18.29403,1667
247380,E4617DCF84AE9969BA971CE4779E46DF,38484,0,10,10,109.53028,18.31528,1620
247381,E4617DCF84AE9969BA971CE4779E46DF,39151,12,13,1,109.49875,18.25097,1510
247382,E4617DCF84AE9969BA971CE4779E46DF,38484,14,16,2,109.53028,18.31528,1620
247390,96F3F18E296FC5227B6BB34F58650A63,60524,0,8,8,109.42951,18.28993,1216
247391,96F3F18E296FC5227B6BB34F58650A63,31471,11,14,3,109.34583,18.29563,917
247392,96F3F18E296FC5227B6BB34F58650A63,60524,16,23,7,109.42951,18.28993,1216
247414,EBD33964FCE275C1E00E1A22DCBD8F60,30921,0,6,6,109.53903,18.29451,1667
247415,EBD33964FCE275C1E00E1A22DCBD8F60,31931,8,10,2,109.54771,18.29403,1667
247416,EBD33964FCE275C1E00E1A22DCBD8F60,60241,12,18,6,109.53319,18.28667,1616
247421,528F99F7FD8CA49B85B45B64A5D784BA,39183,2,4,2,109.55542,18.28208,1715
247422,528F99F7FD8CA49B85B45B64A5D784BA,30851,5,8,3,109.5616,18.27396,1713
247423,528F99F7FD8CA49B85B45B64A5D784BA,31561,10,16,6,109.56792,18.28479,1765
247424,528F99F7FD8CA49B85B45B64A5D784BA,30851,19,20,1,109.5616,18.27396,1713
247440,215C928B327B7E5094BF191870565A5D,39151,3,7,4,109.49875,18.25097,1510
247441,215C928B327B7E5094BF191870565A5D,60201,7,15,8,109.5041,18.2509,1510
247454,6128117B6C62D97BBF6E959D2F3E0A2E,39183,0,5,5,109.55542,18.28208,1715
247455,6128117B6C62D97BBF6E959D2F3E0A2E,31931,6,7,1,109.54771,18.29403,1667
247456,6128117B6C62D97BBF6E959D2F3E0A2E,31561,11,13,2,109.56792,18.28479,1765
247475,EE0804F129D0F96C287A44865905653C,38251,9,10,1,109.49618,18.25493,1510
247489,BC2EDF4DF9C7FAD55BDEABA03DFA7284,31561,0,5,5,109.56792,18.28479,1765
247490,BC2EDF4DF9C7FAD55BDEABA03DFA7284,30851,6,15,9,109.5616,18.27396,1713
247491,BC2EDF4DF9C7FAD55BDEABA03DFA7284,31561,19,23,4,109.56792,18.28479,1765
247500,91B67A451BCA48674F80C454F3D349F4,39181,0,6,6,109.55153,18.28035,1715
247501,91B67A451BCA48674F80C454F3D349F4,31931,7,18,11,109.54771,18.29403,1667
247502,91B67A451BCA48674F80C454F3D349F4,60361,20,22,2,109.51938,18.29681,1567
247522,A64F0864B99B42C4602C17C645042912,30921,0,10,10,109.53903,18.29451,1667
247523,A64F0864B99B42C4602C17C645042912,31931,11,20,9,109.54771,18.29403,1667
247524,3A887AE7038DEACD71C8879078F4404A,31031,0,12,12,109.49979,18.25382,1510
247525,3A887AE7038DEACD71C8879078F4404A,30351,15,17,2,109.41701,18.29292,1217
247526,3A887AE7038DEACD71C8879078F4404A,31031,19,22,3,109.49979,18.25382,1510
247527,C21D2EC796F0044DE4CA162C449C4B3B,30854,13,15,2,109.56889,18.27076,1763
247528,C21D2EC796F0044DE4CA162C449C4B3B,60631,17,18,1,109.57778,18.27583,1814
247545,8F0EF70AFA814412ECB04C3460518F08,38145,0,7,7,109.378,18.2912,1066
247546,8F0EF70AFA814412ECB04C3460518F08,38027,7,8,1,109.38833,18.2909,1066
247547,8F0EF70AFA814412ECB04C3460518F08,38027,9,10,1,109.38833,18.2909,1066
247548,8F0EF70AFA814412ECB04C3460518F08,38301,13,15,2,109.38632,18.29104,1066
247549,8F0EF70AFA814412ECB04C3460518F08,38027,15,19,4,109.38833,18.2909,1066
247550,8F0EF70AFA814412ECB04C3460518F08,31671,19,20,1,109.38965,18.29813,1068
247551,8F0EF70AFA814412ECB04C3460518F08,38027,21,23,2,109.38833,18.2909,1066
247566,88ED3F2D6DF6080D65EC7DC0BC60DC48,30854,12,16,4,109.56889,18.27076,1763
247567,88ED3F2D6DF6080D65EC7DC0BC60DC48,39151,19,20,1,109.49875,18.25097,1510
247606,928DF0385E8541CFD2F5858501C04155,30234,0,7,7,109.60681,18.29979,1918
247607,928DF0385E8541CFD2F5858501C04155,30854,8,21,13,109.56889,18.27076,1763
247627,75817DB682187A07461734D66E1E6492,60631,0,4,4,109.57778,18.27583,1814
247628,75817DB682187A07461734D66E1E6492,30854,6,17,11,109.56889,18.27076,1763
247629,75817DB682187A07461734D66E1E6492,60631,21,23,2,109.57778,18.27583,1814
247637,E16204D131FCD957D5ADB9592C1DD0ED,30151,18,19,1,109.50986,18.25083,1560
247638,E16204D131FCD957D5ADB9592C1DD0ED,31561,21,23,2,109.56792,18.28479,1765
247641,005F3AEFE6DBF371ED1FD57736434098,30854,11,19,8,109.56889,18.27076,1763
247642,005F3AEFE6DBF371ED1FD57736434098,31071,20,21,1,109.58257,18.28458,1815
247643,005F3AEFE6DBF371ED1FD57736434098,60631,21,23,2,109.57778,18.27583,1814
247654,86B53E128647666CEA9BD4D18A34AC90,60084,5,18,13,109.4984,18.2334,1507
247655,86B53E128647666CEA9BD4D18A34AC90,38127,19,20,1,109.50833,18.27222,1513
247656,86B53E128647666CEA9BD4D18A34AC90,31206,21,23,2,109.50819,18.23549,1507
247663,5FB3A2DA28B4E8800621337B3FFA5576,31671,11,12,1,109.38965,18.29813,1068
247664,5FB3A2DA28B4E8800621337B3FFA5576,31471,13,15,2,109.34583,18.29563,917
247665,5FB3A2DA28B4E8800621337B3FFA5576,31671,18,23,5,109.38965,18.29813,1068
247672,F57902A58026464B5BDED6D5CB0C8C35,39151,0,9,9,109.49875,18.25097,1510
247673,F57902A58026464B5BDED6D5CB0C8C35,31031,13,14,1,109.49979,18.25382,1510
247674,F57902A58026464B5BDED6D5CB0C8C35,30201,16,18,2,109.4909,18.26465,1462
247675,F57902A58026464B5BDED6D5CB0C8C35,60131,18,20,2,109.49819,18.24778,1509
247676,F57902A58026464B5BDED6D5CB0C8C35,30161,20,23,3,109.50042,18.24389,1508
247681,A249BB92E18839D454C438B797D69714,60311,0,4,4,109.52097,18.24319,1558
247685,34F3D64B41C252481F72E5CF931AC833,30854,1,10,9,109.56889,18.27076,1763
247686,34F3D64B41C252481F72E5CF931AC833,31071,11,12,1,109.58257,18.28458,1815
247687,34F3D64B41C252481F72E5CF931AC833,30851,17,18,1,109.5616,18.27396,1713
247688,05DA91756164E5EE566D718E5FCD0EDE,30921,0,2,2,109.53903,18.29451,1667
247689,05DA91756164E5EE566D718E5FCD0EDE,31931,2,6,4,109.54771,18.29403,1667
247690,05DA91756164E5EE566D718E5FCD0EDE,33481,9,13,4,109.67278,18.41278,2187
247691,05DA91756164E5EE566D718E5FCD0EDE,60241,16,18,2,109.53319,18.28667,1616
247706,53875E69050EC42E511A64D3211FA7B3,30851,18,20,2,109.5616,18.27396,1713
247707,53875E69050EC42E511A64D3211FA7B3,60631,21,22,1,109.57778,18.27583,1814
247727,BAB9B8A3D1E7FB96DB94A06687C464B3,60504,0,14,14,109.47917,18.28903,1416
247728,BAB9B8A3D1E7FB96DB94A06687C464B3,60524,16,19,3,109.42951,18.28993,1216
247729,BAB9B8A3D1E7FB96DB94A06687C464B3,60504,22,23,1,109.47917,18.28903,1416
247759,1DCF37EE2927C479B1032CB369D26049,30441,18,20,2,109.64021,18.25424,2010
247760,1DCF37EE2927C479B1032CB369D26049,31531,21,23,2,109.49583,18.25972,1461
247761,C19430CE8DF26BDEF43903E57E682236,31561,0,6,6,109.56792,18.28479,1765
247762,C19430CE8DF26BDEF43903E57E682236,30854,9,11,2,109.56889,18.27076,1763
247763,C19430CE8DF26BDEF43903E57E682236,31561,14,23,9,109.56792,18.28479,1765
247778,17A4545370685D172A08774EFEF86DD3,31071,0,3,3,109.58257,18.28458,1815
247779,17A4545370685D172A08774EFEF86DD3,30851,3,6,3,109.5616,18.27396,1713
247780,17A4545370685D172A08774EFEF86DD3,39181,6,10,4,109.55153,18.28035,1715
247826,B643AC77F8D8498A9694D45BA8B0F75F,31561,4,5,1,109.56792,18.28479,1765
247827,B643AC77F8D8498A9694D45BA8B0F75F,60631,6,15,9,109.57778,18.27583,1814
247828,B643AC77F8D8498A9694D45BA8B0F75F,31071,20,21,1,109.58257,18.28458,1815
247862,F73DB45474E9091AA79E623BDF11C321,39181,0,10,10,109.55153,18.28035,1715
247863,F73DB45474E9091AA79E623BDF11C321,31561,10,14,4,109.56792,18.28479,1765
247864,F73DB45474E9091AA79E623BDF11C321,30851,14,16,2,109.5616,18.27396,1713
247865,F73DB45474E9091AA79E623BDF11C321,31561,19,23,4,109.56792,18.28479,1765
247918,C51531E3BB1CF6B001516042658BD073,30361,0,7,7,109.50347,18.24,1508
247919,C51531E3BB1CF6B001516042658BD073,31411,10,22,12,109.5016,18.23576,1507
247938,5426296000364EE32711CD0E73D782C8,31561,13,16,3,109.56792,18.28479,1765
247939,5426296000364EE32711CD0E73D782C8,31071,19,20,1,109.58257,18.28458,1815
247940,5426296000364EE32711CD0E73D782C8,31561,22,23,1,109.56792,18.28479,1765
247978,4D944399BAAD1AD37CC1D68A51FA53FD,30161,0,13,13,109.50042,18.24389,1508
247980,4D944399BAAD1AD37CC1D68A51FA53FD,30161,20,23,3,109.50042,18.24389,1508
247991,4995463B780282C9C030A19D9F49AEAC,31071,0,12,12,109.58257,18.28458,1815
247992,4995463B780282C9C030A19D9F49AEAC,30854,14,16,2,109.56889,18.27076,1763
248012,C46F5343DCC792762EF674294DA84608,30731,0,7,7,109.50944,18.22306,1555
248013,C46F5343DCC792762EF674294DA84608,31521,8,9,1,109.51458,18.22542,1555
248061,6F0540B756080DEA0630ADD22B34EFCA,30371,0,8,8,109.51,18.24771,1559
248062,6F0540B756080DEA0630ADD22B34EFCA,38801,8,17,9,109.51472,18.2584,1561
248063,6F0540B756080DEA0630ADD22B34EFCA,39154,18,21,3,109.50201,18.25681,1511
248064,6F0540B756080DEA0630ADD22B34EFCA,30371,22,23,1,109.51,18.24771,1559
248068,6FBDDF7419820F8908B8A8CE3C81E7C3,60401,8,11,3,109.47444,18.27583,1414
248069,6FBDDF7419820F8908B8A8CE3C81E7C3,60621,14,18,4,109.48354,18.27451,1464
248073,B340EDEF4A878E8DF5CBEC25E465EACE,60281,0,1,1,109.51743,18.25924,1561
248074,B340EDEF4A878E8DF5CBEC25E465EACE,31071,4,6,2,109.58257,18.28458,1815
248075,B340EDEF4A878E8DF5CBEC25E465EACE,30854,8,23,15,109.56889,18.27076,1763
248099,B9E4016373F9EAECBE9B1879E1F3B739,38165,1,8,7,109.44847,18.28896,1316
248100,B9E4016373F9EAECBE9B1879E1F3B739,38361,12,13,1,109.43667,18.29201,1267
248101,B9E4016373F9EAECBE9B1879E1F3B739,38391,14,15,1,109.44111,18.29083,1266
248102,B9E4016373F9EAECBE9B1879E1F3B739,38165,18,19,1,109.44847,18.28896,1316
248103,B9E4016373F9EAECBE9B1879E1F3B739,31701,20,21,1,109.44132,18.28833,1266
248109,C860767955774E3494068CF38C009FB6,60391,0,9,9,109.47667,18.28757,1416
248110,C860767955774E3494068CF38C009FB6,38291,12,13,1,109.51618,18.24313,1558
248111,C860767955774E3494068CF38C009FB6,31061,13,19,6,109.53333,18.23257,1607
248112,C860767955774E3494068CF38C009FB6,39151,21,23,2,109.49875,18.25097,1510
248127,BD5AAE5CF6AC8F1E6005714E36EC9220,60131,0,20,20,109.49819,18.24778,1509
248128,BD5AAE5CF6AC8F1E6005714E36EC9220,30511,21,22,1,109.51069,18.24208,1558
248147,1D2F8DB1F8B6A2081E1A43DDF558491D,30071,15,18,3,109.52819,18.30472,1619
248148,1D2F8DB1F8B6A2081E1A43DDF558491D,30741,18,21,3,109.49833,18.28681,1516
248149,1D2F8DB1F8B6A2081E1A43DDF558491D,31951,22,23,1,109.52174,18.30299,1568
248150,662D882A6A10D0E6C3566690F0A40636,30191,0,4,4,109.50361,18.22701,1506
248151,662D882A6A10D0E6C3566690F0A40636,30854,8,10,2,109.56889,18.27076,1763
248152,662D882A6A10D0E6C3566690F0A40636,31071,11,13,2,109.58257,18.28458,1815
248153,35C6EDC8AAC6B5ABA770190223528BA2,60381,1,8,7,109.5241,18.22458,1605
248154,35C6EDC8AAC6B5ABA770190223528BA2,31061,9,10,1,109.53333,18.23257,1607
248189,292F7AA5A13D44513985CC059AB0B0E9,31071,0,6,6,109.58257,18.28458,1815
248190,292F7AA5A13D44513985CC059AB0B0E9,30854,10,12,2,109.56889,18.27076,1763
248191,292F7AA5A13D44513985CC059AB0B0E9,31071,13,14,1,109.58257,18.28458,1815
248192,292F7AA5A13D44513985CC059AB0B0E9,30854,18,20,2,109.56889,18.27076,1763
248229,D1EBD1A5A8A922DEF994C933F10DD8DB,31851,13,16,3,109.71736,18.29007,2316
248230,D1EBD1A5A8A922DEF994C933F10DD8DB,31164,17,18,1,109.69993,18.27215,2263
248241,77E0479537D8350123531CE1FA2E6649,60631,0,7,7,109.57778,18.27583,1814
248242,77E0479537D8350123531CE1FA2E6649,60591,11,13,2,109.61118,18.21715,1904
248243,77E0479537D8350123531CE1FA2E6649,31101,14,15,1,109.65389,18.23403,2057
248244,77E0479537D8350123531CE1FA2E6649,60591,17,18,1,109.61118,18.21715,1904
248245,77E0479537D8350123531CE1FA2E6649,30854,22,23,1,109.56889,18.27076,1763
248249,CB54BD5ACB93CE60508AFE3883399EDE,30921,0,8,8,109.53903,18.29451,1667
248250,CB54BD5ACB93CE60508AFE3883399EDE,31931,8,18,10,109.54771,18.29403,1667
248265,2D39AE6120F2674000C6DBB8A6E572A0,31945,1,6,5,109.58021,18.29403,1817
248266,2D39AE6120F2674000C6DBB8A6E572A0,30854,9,10,1,109.56889,18.27076,1763
248281,F418DE163D69F8F4F422D7CC67E3A86A,60661,0,7,7,109.548,18.2377,1657
248282,F418DE163D69F8F4F422D7CC67E3A86A,30084,9,10,1,109.50118,18.26972,1513
248283,F418DE163D69F8F4F422D7CC67E3A86A,60641,11,12,1,109.53854,18.2359,1657
248284,F418DE163D69F8F4F422D7CC67E3A86A,31061,13,15,2,109.53333,18.23257,1607
248285,F418DE163D69F8F4F422D7CC67E3A86A,60381,18,19,1,109.5241,18.22458,1605
248286,F418DE163D69F8F4F422D7CC67E3A86A,60661,20,23,3,109.548,18.2377,1657
248289,770A00BDAFE9BCA8C9E9FA68066EED7D,31071,0,6,6,109.58257,18.28458,1815
248290,770A00BDAFE9BCA8C9E9FA68066EED7D,31561,9,20,11,109.56792,18.28479,1765
248291,770A00BDAFE9BCA8C9E9FA68066EED7D,31071,21,22,1,109.58257,18.28458,1815
248307,B49997E558EBA6E6EDC3CFE777E3F80C,31931,15,16,1,109.54771,18.29403,1667
248308,B49997E558EBA6E6EDC3CFE777E3F80C,30071,16,18,2,109.52819,18.30472,1619
248309,B49997E558EBA6E6EDC3CFE777E3F80C,31561,19,21,2,109.56792,18.28479,1765
248340,F5FE23BF42FC224C310CD42E08B0B950,31431,0,9,9,109.44639,18.29042,1316
248341,F5FE23BF42FC224C310CD42E08B0B950,38094,9,14,5,109.45403,18.28778,1316
248342,F5FE23BF42FC224C310CD42E08B0B950,60441,14,16,2,109.46792,18.28604,1366
248343,F5FE23BF42FC224C310CD42E08B0B950,31431,18,22,4,109.44639,18.29042,1316
248344,47D232A92516FC961C7881B5391F911A,60221,15,18,3,109.52569,18.29188,1616
248345,47D232A92516FC961C7881B5391F911A,31031,18,20,2,109.49979,18.25382,1510
248373,DC0EB400EA24BEE9EB39D315B0E6AEF0,31701,12,15,3,109.44132,18.28833,1266
248375,DC0EB400EA24BEE9EB39D315B0E6AEF0,38316,22,23,1,109.48542,18.27424,1464
248379,FFFC0994E5C15BDB165344716912442C,30854,0,1,1,109.56889,18.27076,1763
248380,FFFC0994E5C15BDB165344716912442C,39371,2,4,2,109.56627,18.2646,1762
248381,FFFC0994E5C15BDB165344716912442C,30854,4,6,2,109.56889,18.27076,1763
248382,FFFC0994E5C15BDB165344716912442C,31554,7,18,11,109.55521,18.2459,1709
248383,FFFC0994E5C15BDB165344716912442C,30854,20,22,2,109.56889,18.27076,1763
248463,94C4D5691F7DFC1AB38806AFFAC1389E,31931,0,15,15,109.54771,18.29403,1667
248464,94C4D5691F7DFC1AB38806AFFAC1389E,60241,16,17,1,109.53319,18.28667,1616
248465,94C4D5691F7DFC1AB38806AFFAC1389E,31931,17,18,1,109.54771,18.29403,1667
248466,C3EF49B0098C6C3C4B26CC8869DE86AF,30854,0,6,6,109.56889,18.27076,1763
248467,C3EF49B0098C6C3C4B26CC8869DE86AF,31761,8,9,1,109.60521,18.27965,1914
248468,C3EF49B0098C6C3C4B26CC8869DE86AF,38271,12,15,3,109.62632,18.23049,1956
248469,C3EF49B0098C6C3C4B26CC8869DE86AF,30854,16,23,7,109.56889,18.27076,1763
248488,8AD9F37216B2D3FCE05CA77434307672,30741,0,9,9,109.49833,18.28681,1516
248489,8AD9F37216B2D3FCE05CA77434307672,31851,13,15,2,109.71736,18.29007,2316
248490,8AD9F37216B2D3FCE05CA77434307672,30711,19,21,2,109.50271,18.25347,1510
248491,8AD9F37216B2D3FCE05CA77434307672,30741,21,23,2,109.49833,18.28681,1516
248499,9FC721E86703223349C05C95FE4BBB6F,60081,0,9,9,109.51097,18.22639,1556
248500,9FC721E86703223349C05C95FE4BBB6F,60381,11,16,5,109.5241,18.22458,1605
248501,9FC721E86703223349C05C95FE4BBB6F,31521,16,20,4,109.51458,18.22542,1555
248502,9FC721E86703223349C05C95FE4BBB6F,60087,21,23,2,109.50688,18.22299,1505
248542,A68637AA89BD62624E677D9E66C32FAD,31391,0,5,5,109.50382,18.24285,1508
248543,A68637AA89BD62624E677D9E66C32FAD,30161,5,10,5,109.50042,18.24389,1508
248544,A68637AA89BD62624E677D9E66C32FAD,30161,14,16,2,109.50042,18.24389,1508
248545,A68637AA89BD62624E677D9E66C32FAD,30161,17,23,6,109.50042,18.24389,1508
248546,0989A1FA83098A129EC9A63DDE064266,31071,0,1,1,109.58257,18.28458,1815
248547,0989A1FA83098A129EC9A63DDE064266,31761,3,4,1,109.60521,18.27965,1914
248548,0989A1FA83098A129EC9A63DDE064266,31071,6,12,6,109.58257,18.28458,1815
248549,0989A1FA83098A129EC9A63DDE064266,30854,13,14,1,109.56889,18.27076,1763
248559,E8D51F8B53F290BFD73338AD2AD8C728,30854,6,9,3,109.56889,18.27076,1763
248560,E8D51F8B53F290BFD73338AD2AD8C728,31561,13,18,5,109.56792,18.28479,1765
248575,ADAF731053DBFEEA361A1E7F418AE4CE,31124,12,22,10,109.17069,18.35,276
248576,CFCFA94681CDD57855D6405C244168DD,38891,0,1,1,109.51486,18.24118,1558
248577,CFCFA94681CDD57855D6405C244168DD,31201,5,17,12,109.51042,18.23819,1558
248578,CFCFA94681CDD57855D6405C244168DD,38891,20,22,2,109.51486,18.24118,1558
248581,D77A5C2E97A74D805A87772560CE2BFF,31421,1,5,4,109.55382,18.22347,1705
248582,D77A5C2E97A74D805A87772560CE2BFF,60381,7,12,5,109.5241,18.22458,1605
248583,D77A5C2E97A74D805A87772560CE2BFF,60661,12,13,1,109.548,18.2377,1657
248584,D77A5C2E97A74D805A87772560CE2BFF,60381,14,18,4,109.5241,18.22458,1605
248585,D77A5C2E97A74D805A87772560CE2BFF,39321,19,23,4,109.529,18.2167,1604
248604,6345097D7939CBDA931E36976B04F54A,30671,0,8,8,109.43611,18.30139,1268
248605,6345097D7939CBDA931E36976B04F54A,31301,9,12,3,109.14493,18.31222,170
248626,B17D654C0C5F0BF2FDFE2DB8B9C0B83F,38153,15,16,1,109.51819,18.25736,1561
248627,B17D654C0C5F0BF2FDFE2DB8B9C0B83F,31551,19,23,4,109.55868,18.24222,1708
248679,23AF668A3BF61DB4555AFB95018A20E1,39183,0,10,10,109.55542,18.28208,1715
248680,23AF668A3BF61DB4555AFB95018A20E1,31931,14,15,1,109.54771,18.29403,1667
248686,C6DA185F5F0F58094C4390F3E9E2A3DE,31521,10,12,2,109.51458,18.22542,1555
248687,C6DA185F5F0F58094C4390F3E9E2A3DE,31521,13,14,1,109.51458,18.22542,1555
248688,C6DA185F5F0F58094C4390F3E9E2A3DE,38754,15,18,3,109.74667,18.37382,2430
248689,C6DA185F5F0F58094C4390F3E9E2A3DE,31521,21,23,2,109.51458,18.22542,1555
248761,1472501D05A1FAACE24DF762AD55D1B1,38052,5,11,6,109.62618,18.23042,1956
248762,1472501D05A1FAACE24DF762AD55D1B1,60594,15,17,2,109.62694,18.22799,1956
248763,1472501D05A1FAACE24DF762AD55D1B1,38052,18,23,5,109.62618,18.23042,1956
248776,F6C5549A66D77909CD4E9BDDA0C298A6,60381,0,8,8,109.5241,18.22458,1605
248777,F6C5549A66D77909CD4E9BDDA0C298A6,38754,11,13,2,109.74667,18.37382,2430
248778,F6C5549A66D77909CD4E9BDDA0C298A6,60381,14,23,9,109.5241,18.22458,1605
248784,97DFCEF20461204135ADC6D971200EB4,30151,11,14,3,109.50986,18.25083,1560
248811,47A18820FDA9856131F74091D44B6BCB,31071,1,5,4,109.58257,18.28458,1815
248812,47A18820FDA9856131F74091D44B6BCB,31561,7,21,14,109.56792,18.28479,1765
248875,A9FCE0049DB44FE004EAFBF5B783F4A5,31945,3,8,5,109.58021,18.29403,1817
248876,A9FCE0049DB44FE004EAFBF5B783F4A5,30854,8,14,6,109.56889,18.27076,1763
248877,A9FCE0049DB44FE004EAFBF5B783F4A5,31421,19,20,1,109.55382,18.22347,1705
248901,A64494D6F3A0AF8BF93D9FAA1169011A,38811,13,18,5,109.50875,18.2175,1504
248902,A64494D6F3A0AF8BF93D9FAA1169011A,31201,19,20,1,109.51042,18.23819,1558
248903,A64494D6F3A0AF8BF93D9FAA1169011A,39154,22,23,1,109.50201,18.25681,1511
248904,40222537E299DD1E80FAFC454D4AB30F,31071,0,1,1,109.58257,18.28458,1815
248905,40222537E299DD1E80FAFC454D4AB30F,60354,3,5,2,109.58701,18.28521,1815
248906,40222537E299DD1E80FAFC454D4AB30F,31071,6,8,2,109.58257,18.28458,1815
248907,40222537E299DD1E80FAFC454D4AB30F,30854,16,17,1,109.56889,18.27076,1763
248908,40222537E299DD1E80FAFC454D4AB30F,31071,17,19,2,109.58257,18.28458,1815
248921,AD64464DD39A90A4C30F70259EC094DF,39181,0,7,7,109.55153,18.28035,1715
248922,AD64464DD39A90A4C30F70259EC094DF,39181,8,10,2,109.55153,18.28035,1715
248923,AD64464DD39A90A4C30F70259EC094DF,31931,14,19,5,109.54771,18.29403,1667
248924,2CE19795F2549AFE8556FD3526787FA2,30851,13,15,2,109.5616,18.27396,1713
248925,2CE19795F2549AFE8556FD3526787FA2,31561,16,17,1,109.56792,18.28479,1765
248926,2CE19795F2549AFE8556FD3526787FA2,31071,20,21,1,109.58257,18.28458,1815
248927,8E06EAC16B0EF776FA1BAAC5B9747325,30511,4,5,1,109.51069,18.24208,1558
248928,8E06EAC16B0EF776FA1BAAC5B9747325,60114,7,18,11,109.73028,18.33847,2374
248929,8E06EAC16B0EF776FA1BAAC5B9747325,30511,20,23,3,109.51069,18.24208,1558
248930,201045A9C980BD8E53B16B9129DFE596,30854,0,1,1,109.56889,18.27076,1763
248931,201045A9C980BD8E53B16B9129DFE596,31071,6,15,9,109.58257,18.28458,1815
248932,201045A9C980BD8E53B16B9129DFE596,30854,16,17,1,109.56889,18.27076,1763
248933,201045A9C980BD8E53B16B9129DFE596,31071,17,18,1,109.58257,18.28458,1815
248934,7235BA08EE35A76A07D4EF6E9B8C7C54,31231,0,8,8,109.42597,18.29292,1217
248935,7235BA08EE35A76A07D4EF6E9B8C7C54,60401,8,9,1,109.47444,18.27583,1414
248936,7235BA08EE35A76A07D4EF6E9B8C7C54,60054,12,14,2,109.3016,18.31229,770
248937,7235BA08EE35A76A07D4EF6E9B8C7C54,60084,18,19,1,109.4984,18.2334,1507
248938,84DF4A7C208235D171EF56473BCCF210,30851,0,5,5,109.5616,18.27396,1713
248939,84DF4A7C208235D171EF56473BCCF210,31561,6,7,1,109.56792,18.28479,1765
248940,84DF4A7C208235D171EF56473BCCF210,60631,7,19,12,109.57778,18.27583,1814
248941,84DF4A7C208235D171EF56473BCCF210,30851,19,20,1,109.5616,18.27396,1713
248942,F01C629B7C3C6D21B5D0029F90433BD6,31181,15,17,2,109.50382,18.24813,1509
248943,F01C629B7C3C6D21B5D0029F90433BD6,30361,17,20,3,109.50347,18.24,1508
248944,F01C629B7C3C6D21B5D0029F90433BD6,31391,21,23,2,109.50382,18.24285,1508
248945,29A908E24ED92D20D54AB211989C3B7F,30151,0,11,11,109.50986,18.25083,1560
248946,29A908E24ED92D20D54AB211989C3B7F,31311,13,18,5,109.72299,18.27438,2364
248947,29A908E24ED92D20D54AB211989C3B7F,30151,22,23,1,109.50986,18.25083,1560
248954,1411F9F89E8C658605CC1C5E821DCFD9,31071,0,3,3,109.58257,18.28458,1815
248955,1411F9F89E8C658605CC1C5E821DCFD9,31071,4,8,4,109.58257,18.28458,1815
248956,1411F9F89E8C658605CC1C5E821DCFD9,30854,10,23,13,109.56889,18.27076,1763
248963,015CDEB9169BCE5537ABAE49B6A63F2B,31071,1,6,5,109.58257,18.28458,1815
248964,015CDEB9169BCE5537ABAE49B6A63F2B,30854,7,16,9,109.56889,18.27076,1763
248989,A94F66C88B84FF0658441320CD9F667C,60631,0,14,14,109.57778,18.27583,1814
248990,A94F66C88B84FF0658441320CD9F667C,30854,14,21,7,109.56889,18.27076,1763
248991,A94F66C88B84FF0658441320CD9F667C,31071,21,23,2,109.58257,18.28458,1815
248994,E4D199FCE009427481C9D06B9609AB1E,31931,1,21,20,109.54771,18.29403,1667
248995,E4D199FCE009427481C9D06B9609AB1E,60671,22,23,1,109.52979,18.31757,1621
249002,7024F3A14F6F554DC6E80063E30315F0,30854,0,4,4,109.56889,18.27076,1763
249003,7024F3A14F6F554DC6E80063E30315F0,31561,4,23,19,109.56792,18.28479,1765
249029,C316CE65034FB3C77BE459147CBF943A,60291,0,7,7,109.50826,18.24639,1509
249030,C316CE65034FB3C77BE459147CBF943A,30161,8,13,5,109.50042,18.24389,1508
249031,C316CE65034FB3C77BE459147CBF943A,30161,14,15,1,109.50042,18.24389,1508
249032,C316CE65034FB3C77BE459147CBF943A,31521,15,19,4,109.51458,18.22542,1555
249033,C316CE65034FB3C77BE459147CBF943A,60291,21,23,2,109.50826,18.24639,1509
249038,BE586ACB441383CC10D7CF3923850B73,31931,0,13,13,109.54771,18.29403,1667
249039,BE586ACB441383CC10D7CF3923850B73,30851,14,17,3,109.5616,18.27396,1713
249040,BE586ACB441383CC10D7CF3923850B73,31931,20,23,3,109.54771,18.29403,1667
249069,D6A345956751BA2ACC5430EDF68A104F,39181,0,8,8,109.55153,18.28035,1715
249070,D6A345956751BA2ACC5430EDF68A104F,31931,10,22,12,109.54771,18.29403,1667
249078,368F8386B4B30BA941A3FE088E284383,60381,0,8,8,109.5241,18.22458,1605
249079,368F8386B4B30BA941A3FE088E284383,60171,9,11,2,109.51292,18.30694,1569
249080,368F8386B4B30BA941A3FE088E284383,60381,14,23,9,109.5241,18.22458,1605
249084,C1C49DF6492ABE12D028E9E9E32B69EC,38751,13,17,4,109.74903,18.37639,2481
249085,C1C49DF6492ABE12D028E9E9E32B69EC,38751,20,23,3,109.74903,18.37639,2481
249100,480F6CB671CBAC39FE514AA75FDFC7DA,31071,0,9,9,109.58257,18.28458,1815
249101,480F6CB671CBAC39FE514AA75FDFC7DA,38751,12,17,5,109.74903,18.37639,2481
249105,4DE3E9C2C0E7F48C3178063DD53BC336,30711,1,3,2,109.50271,18.25347,1510
249106,4DE3E9C2C0E7F48C3178063DD53BC336,60241,5,14,9,109.53319,18.28667,1616
249107,4DE3E9C2C0E7F48C3178063DD53BC336,31941,16,18,2,109.62451,18.31222,1970
249108,4DE3E9C2C0E7F48C3178063DD53BC336,30191,19,20,1,109.50361,18.22701,1506
249109,F00821368F615DCDAF214035D8EC4A44,31071,0,6,6,109.58257,18.28458,1815
249110,F00821368F615DCDAF214035D8EC4A44,30854,10,16,6,109.56889,18.27076,1763
249111,F00821368F615DCDAF214035D8EC4A44,60221,16,17,1,109.52569,18.29188,1616
249143,96F98526707B06BE1263CCD4F72E07A1,31071,0,7,7,109.58257,18.28458,1815
249144,96F98526707B06BE1263CCD4F72E07A1,31071,10,11,1,109.58257,18.28458,1815
249145,96F98526707B06BE1263CCD4F72E07A1,30854,11,12,1,109.56889,18.27076,1763
249146,96F98526707B06BE1263CCD4F72E07A1,31071,17,18,1,109.58257,18.28458,1815
249149,335A7B1DE8538918FDA774EE3E402A76,30191,0,7,7,109.50361,18.22701,1506
249150,335A7B1DE8538918FDA774EE3E402A76,31521,10,13,3,109.51458,18.22542,1555
249151,335A7B1DE8538918FDA774EE3E402A76,30191,13,23,10,109.50361,18.22701,1506
249160,356E75600A8901067E9EDB6E5BE4617A,30021,9,10,1,109.12014,18.40986,86
249161,356E75600A8901067E9EDB6E5BE4617A,38185,13,14,1,109.51333,18.27347,1563
249162,E082FB5BD091C5B334EC1176FF352EE0,30071,0,13,13,109.52819,18.30472,1619
249163,E082FB5BD091C5B334EC1176FF352EE0,31931,16,17,1,109.54771,18.29403,1667
249164,E082FB5BD091C5B334EC1176FF352EE0,30071,21,23,2,109.52819,18.30472,1619
249231,6D02AB3E12E4EDF1821AFE48CDBCDAEC,38961,0,7,7,109.50847,18.23514,1507
249232,6D02AB3E12E4EDF1821AFE48CDBCDAEC,31781,10,11,1,109.19847,18.2975,367
249233,6D02AB3E12E4EDF1821AFE48CDBCDAEC,60411,12,13,1,109.32514,18.30854,869
249234,6D02AB3E12E4EDF1821AFE48CDBCDAEC,31471,13,15,2,109.34583,18.29563,917
249235,6D02AB3E12E4EDF1821AFE48CDBCDAEC,30361,19,20,1,109.50347,18.24,1508
249236,6D02AB3E12E4EDF1821AFE48CDBCDAEC,31205,21,23,2,109.51111,18.23736,1557
249237,71048DA762610C5657DD6D8242833DC9,39371,0,12,12,109.56627,18.2646,1762
249238,71048DA762610C5657DD6D8242833DC9,30854,16,17,1,109.56889,18.27076,1763
249256,54A6757CA4BF8A47C41CF1DDCA6EA505,30854,0,4,4,109.56889,18.27076,1763
249258,54A6757CA4BF8A47C41CF1DDCA6EA505,30434,8,11,3,109.17083,18.35861,278
249259,54A6757CA4BF8A47C41CF1DDCA6EA505,30854,13,17,4,109.56889,18.27076,1763
249285,6EF68F35CE79552C1164E70C67C72C02,30121,0,8,8,109.52861,18.27222,1613
249286,6EF68F35CE79552C1164E70C67C72C02,30854,13,17,4,109.56889,18.27076,1763
249287,6EF68F35CE79552C1164E70C67C72C02,30121,20,23,3,109.52861,18.27222,1613
249300,7EB52A3F4A5DBE03536C9A0833D21C62,31421,0,6,6,109.55382,18.22347,1705
249301,7EB52A3F4A5DBE03536C9A0833D21C62,60071,10,14,4,109.75674,18.31583,2470
249302,7EB52A3F4A5DBE03536C9A0833D21C62,30854,18,19,1,109.56889,18.27076,1763
249303,7EB52A3F4A5DBE03536C9A0833D21C62,31521,21,23,2,109.51458,18.22542,1555
249336,9C1407835BC54BEBDB541F52E1DA1820,61011,0,13,13,109.60653,18.19076,1900
249359,C3A94957E1E7D6DF853752575E39572E,38361,17,23,6,109.43667,18.29201,1267
249367,9051969BBCBF8B78870D88A07EF566D6,31701,15,16,1,109.44132,18.28833,1266
249394,FE4417CAF3A5150C206378A6D3A89051,30921,1,2,1,109.53903,18.29451,1667
249395,FE4417CAF3A5150C206378A6D3A89051,31931,2,6,4,109.54771,18.29403,1667
249406,45A5987C18932F268DB10593230F9A7C,60231,14,16,2,109.49903,18.21972,1504
249407,45A5987C18932F268DB10593230F9A7C,38251,17,22,5,109.49618,18.25493,1510
249444,7B9D64657CE26DF907B4C2AC87C9F431,60371,1,5,4,109.53063,18.30056,1618
249445,7B9D64657CE26DF907B4C2AC87C9F431,38241,6,11,5,109.54111,18.30542,1669
249446,7B9D64657CE26DF907B4C2AC87C9F431,60371,15,18,3,109.53063,18.30056,1618
249447,7B9D64657CE26DF907B4C2AC87C9F431,31931,21,22,1,109.54771,18.29403,1667
249465,C82725A09C032EE9BFF2088FCCC60D1D,30854,1,9,8,109.56889,18.27076,1763
249466,C82725A09C032EE9BFF2088FCCC60D1D,60631,9,19,10,109.57778,18.27583,1814
249467,C82725A09C032EE9BFF2088FCCC60D1D,30854,20,21,1,109.56889,18.27076,1763
249471,D8DA23A64562A02CC1EF1AE0493551E1,60541,12,14,2,109.4084,18.29208,1167
249472,D8DA23A64562A02CC1EF1AE0493551E1,31471,14,15,1,109.34583,18.29563,917
249473,D8DA23A64562A02CC1EF1AE0493551E1,38071,18,21,3,109.40722,18.30938,1169
249497,CCCD2290FB632A48009771412BE68ADD,31561,2,13,11,109.56792,18.28479,1765
249498,CCCD2290FB632A48009771412BE68ADD,30851,14,15,1,109.5616,18.27396,1713
249499,680970852212DD0BF6E2D40630BA722B,30861,18,20,2,109.52722,18.22743,1606
249509,DC29C676832347947F366933ECB88090,31561,0,20,20,109.56792,18.28479,1765
249510,DC29C676832347947F366933ECB88090,38484,21,23,2,109.53028,18.31528,1620
249517,71E594D6D69285F426A56C720984D655,38071,3,5,2,109.40722,18.30938,1169
249518,71E594D6D69285F426A56C720984D655,30854,6,9,3,109.56889,18.27076,1763
249519,71E594D6D69285F426A56C720984D655,60631,10,20,10,109.57778,18.27583,1814
249524,BE1BF0E0C00568838DBD1FF7CA7ADE1C,39183,2,3,1,109.55542,18.28208,1715
249525,BE1BF0E0C00568838DBD1FF7CA7ADE1C,31561,6,13,7,109.56792,18.28479,1765
249526,BE1BF0E0C00568838DBD1FF7CA7ADE1C,30854,15,23,8,109.56889,18.27076,1763
249542,2FE0F3A82C27452F04A6B927F514EFA7,31554,0,15,15,109.55521,18.2459,1709
249543,2FE0F3A82C27452F04A6B927F514EFA7,31551,18,23,5,109.55868,18.24222,1708
249600,9B49BEB65E16F10DE8E30D5D01D652E3,38154,19,20,1,109.5266,18.28278,1615
249601,9B49BEB65E16F10DE8E30D5D01D652E3,31811,20,21,1,109.54201,18.31806,1671
249602,1A64C98E678C33D33EBB9AF4943063A2,31271,20,21,1,109.48958,18.26257,1462
249603,1A64C98E678C33D33EBB9AF4943063A2,30854,22,23,1,109.56889,18.27076,1763
249612,EF24901D99384F703B20FE07F2784FA0,30101,0,7,7,109.57299,18.33333,1773
249613,EF24901D99384F703B20FE07F2784FA0,31631,7,8,1,109.59542,18.36826,1879
249614,EF24901D99384F703B20FE07F2784FA0,30101,10,11,1,109.57299,18.33333,1773
249615,EF24901D99384F703B20FE07F2784FA0,31631,12,18,6,109.59542,18.36826,1879
249616,EF24901D99384F703B20FE07F2784FA0,30101,18,23,5,109.57299,18.33333,1773
249621,FE6A1003E9A2A3F2E79DF975FEE0245E,31554,0,7,7,109.55521,18.2459,1709
249625,5262ABE790766FD3345CF84BDACCA78B,60501,10,12,2,109.48701,18.29021,1466
249641,8C8ACEC2013CE5C2D40BBAF03FC36A40,31071,3,4,1,109.58257,18.28458,1815
249642,8C8ACEC2013CE5C2D40BBAF03FC36A40,39183,7,8,1,109.55542,18.28208,1715
249643,8C8ACEC2013CE5C2D40BBAF03FC36A40,30854,9,22,13,109.56889,18.27076,1763
249651,F5E480BCE870DAE347CB60AA32F4CA1B,31071,0,5,5,109.58257,18.28458,1815
249652,F5E480BCE870DAE347CB60AA32F4CA1B,30854,7,11,4,109.56889,18.27076,1763
249653,F5E480BCE870DAE347CB60AA32F4CA1B,30421,14,15,1,109.50021,18.25861,1511
249669,020753EF78F0A0C39658113A3377EA1E,31561,0,6,6,109.56792,18.28479,1765
249670,020753EF78F0A0C39658113A3377EA1E,31931,7,8,1,109.54771,18.29403,1667
249671,020753EF78F0A0C39658113A3377EA1E,39183,8,10,2,109.55542,18.28208,1715
249672,020753EF78F0A0C39658113A3377EA1E,31561,11,14,3,109.56792,18.28479,1765
249673,020753EF78F0A0C39658113A3377EA1E,31931,14,15,1,109.54771,18.29403,1667
249674,020753EF78F0A0C39658113A3377EA1E,31561,16,20,4,109.56792,18.28479,1765
249675,89CB07D241B8B48DE23BAD11AA55AD0A,30809,1,10,9,109.4891,18.28229,1465
249676,89CB07D241B8B48DE23BAD11AA55AD0A,30421,10,12,2,109.50021,18.25861,1511
249677,89CB07D241B8B48DE23BAD11AA55AD0A,30809,12,15,3,109.4891,18.28229,1465
249683,DDE4D5D00B726E239E6B8A96A765D262,38105,0,7,7,109.40299,18.29229,1117
249684,DDE4D5D00B726E239E6B8A96A765D262,31091,8,10,2,109.41201,18.31222,1170
249685,DDE4D5D00B726E239E6B8A96A765D262,30731,11,13,2,109.50944,18.22306,1555
249686,DDE4D5D00B726E239E6B8A96A765D262,60381,16,18,2,109.5241,18.22458,1605
249702,1122041491C04B199A15F6E1E401D68F,38881,1,3,2,109.51618,18.26431,1562
249703,1122041491C04B199A15F6E1E401D68F,30461,4,5,1,109.5116,18.26313,1562
249704,1122041491C04B199A15F6E1E401D68F,60281,7,8,1,109.51743,18.25924,1561
249705,1122041491C04B199A15F6E1E401D68F,31031,9,10,1,109.49979,18.25382,1510
249706,1122041491C04B199A15F6E1E401D68F,60291,15,17,2,109.50826,18.24639,1509
249712,DF8390F1DCB42D608CF73F54089514BD,60371,0,3,3,109.53063,18.30056,1618
249713,DF8390F1DCB42D608CF73F54089514BD,30071,3,6,3,109.52819,18.30472,1619
249714,DF8390F1DCB42D608CF73F54089514BD,30851,9,10,1,109.5616,18.27396,1713
249715,DF8390F1DCB42D608CF73F54089514BD,31561,12,15,3,109.56792,18.28479,1765
249716,DF8390F1DCB42D608CF73F54089514BD,30851,17,20,3,109.5616,18.27396,1713
249787,51061B3DE820AF1C1C713EF684728003,30854,9,21,12,109.56889,18.27076,1763
249788,51061B3DE820AF1C1C713EF684728003,31071,21,23,2,109.58257,18.28458,1815
249789,012ABD06F231728C214A4BA917E75B1C,31561,0,12,12,109.56792,18.28479,1765
249790,012ABD06F231728C214A4BA917E75B1C,30851,16,17,1,109.5616,18.27396,1713
249791,012ABD06F231728C214A4BA917E75B1C,31561,20,21,1,109.56792,18.28479,1765
249851,346507E97DF433BFFC969BAE643FC14C,31061,20,21,1,109.53333,18.23257,1607
249852,346507E97DF433BFFC969BAE643FC14C,39154,22,23,1,109.50201,18.25681,1511
249879,5C3AF23B43D26582C5A8FB4D1CB9A5DB,39043,1,7,6,109.40778,18.29049,1166
249880,5C3AF23B43D26582C5A8FB4D1CB9A5DB,38102,7,9,2,109.40875,18.29111,1166
249882,5C3AF23B43D26582C5A8FB4D1CB9A5DB,38094,18,19,1,109.45403,18.28778,1316
249910,8B9A9BFD1ACAD480EB101A91DBF2024D,30371,14,16,2,109.51,18.24771,1559
249911,8B9A9BFD1ACAD480EB101A91DBF2024D,38291,17,22,5,109.51618,18.24313,1558
249916,43E035AE85036EBD9891453E9567CB81,30171,11,14,3,109.48458,18.27139,1463
249917,43E035AE85036EBD9891453E9567CB81,38316,19,20,1,109.48542,18.27424,1464
249918,43E035AE85036EBD9891453E9567CB81,30171,21,23,2,109.48458,18.27139,1463
249938,F477CD0D1BA571DFDAA4F6B37DA3B938,38903,12,14,2,109.39229,18.29243,1117
249939,F477CD0D1BA571DFDAA4F6B37DA3B938,60381,15,18,3,109.5241,18.22458,1605
249940,F477CD0D1BA571DFDAA4F6B37DA3B938,38903,20,23,3,109.39229,18.29243,1117
249965,71F956FFA2F92F0EAA3851BFD1FB3491,38162,14,15,1,109.43944,18.28889,1266
249966,71F956FFA2F92F0EAA3851BFD1FB3491,31701,16,17,1,109.44132,18.28833,1266
249989,92E14A6094471B9C1A50CE8585136EC6,30791,3,15,12,109.72333,18.40889,2386
249990,92E14A6094471B9C1A50CE8585136EC6,60087,16,18,2,109.50688,18.22299,1505
249991,92E14A6094471B9C1A50CE8585136EC6,30731,20,23,3,109.50944,18.22306,1555
249998,CC893ED1EC980A84714A8CD884DE01CB,30721,0,12,12,109.51597,18.28257,1565
249999,CC893ED1EC980A84714A8CD884DE01CB,38171,14,15,1,109.50799,18.28139,1515
250000,CC893ED1EC980A84714A8CD884DE01CB,60281,17,20,3,109.51743,18.25924,1561
250023,5B025497FF30AC7A9FE53FC20E1F1A77,31945,12,15,3,109.58021,18.29403,1817
250024,5B025497FF30AC7A9FE53FC20E1F1A77,30854,16,23,7,109.56889,18.27076,1763
250031,189633BA4D39EBA8A203BC9E364D4B1F,30381,0,1,1,109.52521,18.24507,1609
250032,189633BA4D39EBA8A203BC9E364D4B1F,38297,2,4,2,109.52576,18.24965,1609
250033,189633BA4D39EBA8A203BC9E364D4B1F,30381,4,7,3,109.52521,18.24507,1609
250034,189633BA4D39EBA8A203BC9E364D4B1F,30051,12,17,5,109.48917,18.21215,1453
250035,189633BA4D39EBA8A203BC9E364D4B1F,30281,19,20,1,109.50597,18.27583,1514
250036,189633BA4D39EBA8A203BC9E364D4B1F,30381,22,23,1,109.52521,18.24507,1609
250040,B4122A296B24739BBA040B55E12FC1E8,31271,8,11,3,109.48958,18.26257,1462
250041,B4122A296B24739BBA040B55E12FC1E8,60491,11,16,5,109.43354,18.30847,1269
250046,C983E73D646629A775690ECA8920EB29,30101,0,6,6,109.57299,18.33333,1773
250047,C983E73D646629A775690ECA8920EB29,31631,9,10,1,109.59542,18.36826,1879
250048,C983E73D646629A775690ECA8920EB29,30101,13,15,2,109.57299,18.33333,1773
250049,C983E73D646629A775690ECA8920EB29,31631,17,18,1,109.59542,18.36826,1879
250050,6C7CFF92341DACF5390B37394F2B073B,30731,1,7,6,109.50944,18.22306,1555
250051,6C7CFF92341DACF5390B37394F2B073B,39321,9,16,7,109.529,18.2167,1604
250052,6C7CFF92341DACF5390B37394F2B073B,60281,18,19,1,109.51743,18.25924,1561
250053,6C7CFF92341DACF5390B37394F2B073B,31461,20,23,3,109.5091,18.25389,1510
250127,ACAB8C7B92298FFCEC0006246A6D65D6,39183,0,10,10,109.55542,18.28208,1715
250128,ACAB8C7B92298FFCEC0006246A6D65D6,31931,12,14,2,109.54771,18.29403,1667
250129,9A0B6BA153A1BEC43BEEC25807F83E36,39181,0,8,8,109.55153,18.28035,1715
250130,9A0B6BA153A1BEC43BEEC25807F83E36,60211,12,13,1,109.63549,18.26049,2011
250153,1412BA3B65BC1A2354CCBE297098A0E1,31071,13,15,2,109.58257,18.28458,1815
250154,1412BA3B65BC1A2354CCBE297098A0E1,30854,18,20,2,109.56889,18.27076,1763
250173,74CA422FA73474DEA022E959D07273D0,31431,0,7,7,109.44639,18.29042,1316
250174,74CA422FA73474DEA022E959D07273D0,31145,8,12,4,109.20431,18.30479,369
250175,74CA422FA73474DEA022E959D07273D0,31431,17,23,6,109.44639,18.29042,1316
250178,53453D8B736810206EC5A6632D159BE6,31931,0,14,14,109.54771,18.29403,1667
250179,53453D8B736810206EC5A6632D159BE6,60371,14,15,1,109.53063,18.30056,1618
250180,53453D8B736810206EC5A6632D159BE6,31931,16,23,7,109.54771,18.29403,1667
250181,4D2B4F6ABE9B534A86E40EBE41504501,30271,0,8,8,109.49132,18.23153,1456
250182,4D2B4F6ABE9B534A86E40EBE41504501,31145,12,14,2,109.20431,18.30479,369
250183,4D2B4F6ABE9B534A86E40EBE41504501,30271,17,23,6,109.49132,18.23153,1456
250184,1BAA4EB92824E45EC2E36C90288F6A84,30361,13,14,1,109.50347,18.24,1508
250185,1BAA4EB92824E45EC2E36C90288F6A84,31201,15,16,1,109.51042,18.23819,1558
250186,1BAA4EB92824E45EC2E36C90288F6A84,30181,18,19,1,109.51597,18.23313,1557
250190,D1700FD0B8D8B8304DC420C1C5EAA5DF,31521,0,9,9,109.51458,18.22542,1555
250191,D1700FD0B8D8B8304DC420C1C5EAA5DF,31521,9,13,4,109.51458,18.22542,1555
250192,D1700FD0B8D8B8304DC420C1C5EAA5DF,60524,16,17,1,109.42951,18.28993,1216
250193,D1700FD0B8D8B8304DC420C1C5EAA5DF,31521,18,23,5,109.51458,18.22542,1555
250199,B64A5CE900AAEBADCEE980963A983652,30421,20,21,1,109.50021,18.25861,1511
250200,B64A5CE900AAEBADCEE980963A983652,39154,22,23,1,109.50201,18.25681,1511
250201,9AA959ED87D1ECC3053DED17290EFCBD,31561,20,21,1,109.56792,18.28479,1765
250202,9AA959ED87D1ECC3053DED17290EFCBD,30854,21,23,2,109.56889,18.27076,1763
250216,7890099D98AA300C5BF12527E7372DB0,30854,17,18,1,109.56889,18.27076,1763
250217,7890099D98AA300C5BF12527E7372DB0,31071,19,20,1,109.58257,18.28458,1815
250218,7890099D98AA300C5BF12527E7372DB0,30854,21,23,2,109.56889,18.27076,1763
250254,D96E01B8E0F0DE9C160C9FEAFDCFDB6D,31071,1,7,6,109.58257,18.28458,1815
250255,D96E01B8E0F0DE9C160C9FEAFDCFDB6D,30854,11,12,1,109.56889,18.27076,1763
250256,D96E01B8E0F0DE9C160C9FEAFDCFDB6D,31071,13,14,1,109.58257,18.28458,1815
250257,D96E01B8E0F0DE9C160C9FEAFDCFDB6D,30854,15,22,7,109.56889,18.27076,1763
250258,C757F371202F08FFC057C6F0916CABAF,39181,0,9,9,109.55153,18.28035,1715
250259,C757F371202F08FFC057C6F0916CABAF,30251,9,13,4,109.50611,18.26653,1512
250260,C757F371202F08FFC057C6F0916CABAF,60281,13,15,2,109.51743,18.25924,1561
250261,C757F371202F08FFC057C6F0916CABAF,31561,17,19,2,109.56792,18.28479,1765
250262,C757F371202F08FFC057C6F0916CABAF,60671,21,23,2,109.52979,18.31757,1621
250275,3C1A2536A78CF30193CED5E3EEACBE7E,30851,0,2,2,109.5616,18.27396,1713
250276,3C1A2536A78CF30193CED5E3EEACBE7E,30854,4,14,10,109.56889,18.27076,1763
250277,3C1A2536A78CF30193CED5E3EEACBE7E,31561,14,16,2,109.56792,18.28479,1765
250278,3C1A2536A78CF30193CED5E3EEACBE7E,30851,19,22,3,109.5616,18.27396,1713
250301,4995022FCBD847726F99CCAFCB44B40B,31021,19,21,2,109.49021,18.27,1463
250302,4995022FCBD847726F99CCAFCB44B40B,30171,22,23,1,109.48458,18.27139,1463
250335,5B5FB16F9BE2A1826D497C2695908410,31561,1,18,17,109.56792,18.28479,1765
250336,5B5FB16F9BE2A1826D497C2695908410,31931,19,22,3,109.54771,18.29403,1667
250337,4CC3058F56A42FB99DF66B1D4EA3395F,38251,19,20,1,109.49618,18.25493,1510
250338,4CC3058F56A42FB99DF66B1D4EA3395F,38721,22,23,1,109.50368,18.27542,1514
250372,769C1D2959A803615D424036A210FF8E,31231,0,8,8,109.42597,18.29292,1217
250373,769C1D2959A803615D424036A210FF8E,31781,9,11,2,109.19847,18.2975,367
250374,769C1D2959A803615D424036A210FF8E,31471,13,15,2,109.34583,18.29563,917
250375,769C1D2959A803615D424036A210FF8E,31231,19,22,3,109.42597,18.29292,1217
250405,3CF44FDCEEB2872CB96488ED4D42BF11,30371,18,23,5,109.51,18.24771,1559
250414,C8922FAF66F21ECAECB6B717FCD5A53B,60391,2,3,1,109.47667,18.28757,1416
250415,C8922FAF66F21ECAECB6B717FCD5A53B,60614,3,9,6,109.48799,18.29521,1467
250416,C8922FAF66F21ECAECB6B717FCD5A53B,60391,9,11,2,109.47667,18.28757,1416
250417,C8922FAF66F21ECAECB6B717FCD5A53B,60614,11,15,4,109.48799,18.29521,1467
250418,C8922FAF66F21ECAECB6B717FCD5A53B,60391,17,19,2,109.47667,18.28757,1416
250419,C8922FAF66F21ECAECB6B717FCD5A53B,60614,21,23,2,109.48799,18.29521,1467
250425,BAEF9F862D9A902CDB4B10017EC20830,60221,0,8,8,109.52569,18.29188,1616
250426,BAEF9F862D9A902CDB4B10017EC20830,30921,9,10,1,109.53903,18.29451,1667
250427,BAEF9F862D9A902CDB4B10017EC20830,31931,12,17,5,109.54771,18.29403,1667
250428,BAEF9F862D9A902CDB4B10017EC20830,60221,21,23,2,109.52569,18.29188,1616
250429,95282C4B9C9218D16517DDF120466DDD,31271,0,7,7,109.48958,18.26257,1462
250430,95282C4B9C9218D16517DDF120466DDD,39191,8,9,1,109.51493,18.23472,1557
250431,95282C4B9C9218D16517DDF120466DDD,31231,10,11,1,109.42597,18.29292,1217
250438,7D1ED6067ECBD941EFC43CE0A6ADAE71,30854,0,11,11,109.56889,18.27076,1763
250439,7D1ED6067ECBD941EFC43CE0A6ADAE71,31071,12,17,5,109.58257,18.28458,1815
250440,9E8746086915F9D4A063A74CF0B5B7AB,30854,17,18,1,109.56889,18.27076,1763
250441,9E8746086915F9D4A063A74CF0B5B7AB,31561,18,19,1,109.56792,18.28479,1765
250448,424101E7C02D0D0936011E209F4CA05E,31031,0,10,10,109.49979,18.25382,1510
250449,424101E7C02D0D0936011E209F4CA05E,31101,11,13,2,109.65389,18.23403,2057
250456,1A014D5097A523363D6AD8E40BC6F102,30161,19,20,1,109.50042,18.24389,1508
250457,1A014D5097A523363D6AD8E40BC6F102,30771,20,22,2,109.49938,18.26042,1511
250490,51DF765CB634D9549D20AD1F2C37BA18,31561,5,17,12,109.56792,18.28479,1765
250491,51DF765CB634D9549D20AD1F2C37BA18,30854,18,19,1,109.56889,18.27076,1763
250517,04ABA8BFD5D63DDF1B83BA0577C9019C,39371,0,11,11,109.56627,18.2646,1762
250518,04ABA8BFD5D63DDF1B83BA0577C9019C,31071,14,17,3,109.58257,18.28458,1815
250519,04ABA8BFD5D63DDF1B83BA0577C9019C,31761,20,21,1,109.60521,18.27965,1914
250526,40C540F65657B427986BE1CE5332D3EA,31781,14,15,1,109.19847,18.2975,367
250527,40C540F65657B427986BE1CE5332D3EA,30271,18,22,4,109.49132,18.23153,1456
250528,CD7EA899C61E04F81B7437C6D410F253,31531,1,4,3,109.49583,18.25972,1461
250529,CD7EA899C61E04F81B7437C6D410F253,31031,5,8,3,109.49979,18.25382,1510
250530,CD7EA899C61E04F81B7437C6D410F253,31781,11,12,1,109.19847,18.2975,367
250531,CD7EA899C61E04F81B7437C6D410F253,31471,13,15,2,109.34583,18.29563,917
250532,CD7EA899C61E04F81B7437C6D410F253,30771,19,21,2,109.49938,18.26042,1511
250562,E9E473F09C342630187345312F4A31D8,39181,0,8,8,109.55153,18.28035,1715
250563,E9E473F09C342630187345312F4A31D8,31931,12,23,11,109.54771,18.29403,1667
250587,79FD298D94ED606250C160861575CD8F,31554,16,19,3,109.55521,18.2459,1709
250588,79FD298D94ED606250C160861575CD8F,31551,20,21,1,109.55868,18.24222,1708
250604,166E7C87007490CCD3244B1CD8B43BF4,30854,14,18,4,109.56889,18.27076,1763
250605,166E7C87007490CCD3244B1CD8B43BF4,31071,18,19,1,109.58257,18.28458,1815
250606,166E7C87007490CCD3244B1CD8B43BF4,30854,19,21,2,109.56889,18.27076,1763
250607,E75CF54BA14775FEDD26504F9F6B7365,31945,0,6,6,109.58021,18.29403,1817
250608,E75CF54BA14775FEDD26504F9F6B7365,31561,7,8,1,109.56792,18.28479,1765
250609,E75CF54BA14775FEDD26504F9F6B7365,30854,10,12,2,109.56889,18.27076,1763
250610,E75CF54BA14775FEDD26504F9F6B7365,31561,12,17,5,109.56792,18.28479,1765
250611,E75CF54BA14775FEDD26504F9F6B7365,31071,22,23,1,109.58257,18.28458,1815
250612,00FC332040A284DA251A8D0705989FE9,31945,4,6,2,109.58021,18.29403,1817
250613,00FC332040A284DA251A8D0705989FE9,30854,9,16,7,109.56889,18.27076,1763
250616,788E7908839DB224D3AA84E576AF97F5,30921,1,6,5,109.53903,18.29451,1667
250617,788E7908839DB224D3AA84E576AF97F5,60221,10,11,1,109.52569,18.29188,1616
250625,8FFDB178B42E132A09286D0A8A4D99CA,31521,0,5,5,109.51458,18.22542,1555
250626,8FFDB178B42E132A09286D0A8A4D99CA,31521,6,9,3,109.51458,18.22542,1555
250627,8FFDB178B42E132A09286D0A8A4D99CA,60054,11,12,1,109.3016,18.31229,770
250628,8FFDB178B42E132A09286D0A8A4D99CA,31781,14,16,2,109.19847,18.2975,367
250629,8FFDB178B42E132A09286D0A8A4D99CA,31521,17,19,2,109.51458,18.22542,1555
250630,8FFDB178B42E132A09286D0A8A4D99CA,31521,20,22,2,109.51458,18.22542,1555
250638,71301D5A92E929B402E9BF477ED34700,31071,1,14,13,109.58257,18.28458,1815
250639,71301D5A92E929B402E9BF477ED34700,30854,19,20,1,109.56889,18.27076,1763
250645,5169AE4C4AE9067320D7FAAA8A39A4BE,31511,20,23,3,109.26326,18.40521,635
250648,6FF08122E48AB794FE75A66E236D4C05,31521,0,18,18,109.51458,18.22542,1555
250649,6FF08122E48AB794FE75A66E236D4C05,60381,18,20,2,109.5241,18.22458,1605
250650,6FF08122E48AB794FE75A66E236D4C05,31521,21,23,2,109.51458,18.22542,1555
250689,2AE38FAF341950B0B91404FFCE5A0F3E,39183,4,5,1,109.55542,18.28208,1715
250690,2AE38FAF341950B0B91404FFCE5A0F3E,31931,6,7,1,109.54771,18.29403,1667
250691,2AE38FAF341950B0B91404FFCE5A0F3E,30921,9,10,1,109.53903,18.29451,1667
250695,39F25FE146A03325C93C111F2A943B6C,31945,0,7,7,109.58021,18.29403,1817
250696,39F25FE146A03325C93C111F2A943B6C,30854,7,8,1,109.56889,18.27076,1763
250697,39F25FE146A03325C93C111F2A943B6C,31071,9,10,1,109.58257,18.28458,1815
250698,39F25FE146A03325C93C111F2A943B6C,30854,14,16,2,109.56889,18.27076,1763
250699,39F25FE146A03325C93C111F2A943B6C,31071,17,18,1,109.58257,18.28458,1815
250700,58418A9EA4A7DC03127CB79C039A5185,31071,0,11,11,109.58257,18.28458,1815
250701,58418A9EA4A7DC03127CB79C039A5185,30854,11,19,8,109.56889,18.27076,1763
250702,58418A9EA4A7DC03127CB79C039A5185,60354,20,23,3,109.58701,18.28521,1815
250703,523CCFE9EF18EE2D015CE7D473B58639,31931,5,14,9,109.54771,18.29403,1667
250704,523CCFE9EF18EE2D015CE7D473B58639,30071,14,16,2,109.52819,18.30472,1619
250705,523CCFE9EF18EE2D015CE7D473B58639,31931,16,22,6,109.54771,18.29403,1667
250726,4CA0AAFC0F7CF61913EEDBE418D853BD,60441,3,17,14,109.46792,18.28604,1366
250727,4CA0AAFC0F7CF61913EEDBE418D853BD,60401,17,21,4,109.47444,18.27583,1414
250762,AB8F95D841F69DCC3177A6274025E5E6,31931,14,19,5,109.54771,18.29403,1667
250763,AB8F95D841F69DCC3177A6274025E5E6,30854,21,22,1,109.56889,18.27076,1763
250767,CFA6DB42B4EA79576A8AEA8F93765E81,30721,0,7,7,109.51597,18.28257,1565
250768,CFA6DB42B4EA79576A8AEA8F93765E81,60084,8,18,10,109.4984,18.2334,1507
250769,CFA6DB42B4EA79576A8AEA8F93765E81,38251,18,19,1,109.49618,18.25493,1510
250770,CFA6DB42B4EA79576A8AEA8F93765E81,30721,19,23,4,109.51597,18.28257,1565
250783,DFFF17B7FE30E79B8AABBB5CE171272F,30854,0,5,5,109.56889,18.27076,1763
250784,DFFF17B7FE30E79B8AABBB5CE171272F,31561,10,11,1,109.56792,18.28479,1765
250785,DFFF17B7FE30E79B8AABBB5CE171272F,30854,11,13,2,109.56889,18.27076,1763
250843,EC4B90EDBF35256FDB4D4F8B87DB8A04,31071,2,5,3,109.58257,18.28458,1815
250844,EC4B90EDBF35256FDB4D4F8B87DB8A04,30854,8,21,13,109.56889,18.27076,1763
250855,BD5DE467370306D034C70B320455BE36,30161,2,12,10,109.50042,18.24389,1508
250856,BD5DE467370306D034C70B320455BE36,30161,12,14,2,109.50042,18.24389,1508
250857,BD5DE467370306D034C70B320455BE36,60131,19,23,4,109.49819,18.24778,1509
250883,0D69669D4DBC1CEB06269A084D86E853,30854,0,6,6,109.56889,18.27076,1763
250884,0D69669D4DBC1CEB06269A084D86E853,30581,9,17,8,109.62257,18.24951,1959
250920,D87CFD0B7BF12BC12310D3A55CC54E5C,38145,0,5,5,109.378,18.2912,1066
250921,D87CFD0B7BF12BC12310D3A55CC54E5C,60561,5,8,3,109.38229,18.29785,1067
250922,D87CFD0B7BF12BC12310D3A55CC54E5C,38023,9,10,1,109.37132,18.28993,1016
250923,D87CFD0B7BF12BC12310D3A55CC54E5C,60021,15,16,1,109.23174,18.30146,468
250924,D87CFD0B7BF12BC12310D3A55CC54E5C,38707,18,22,4,109.73778,18.35368,2427
250967,C6579823835B85A254880E72927E82BB,30854,3,4,1,109.56889,18.27076,1763
250968,C6579823835B85A254880E72927E82BB,30891,7,20,13,109.59431,18.28389,1865
250985,301E657A2E52A15D5305B0C9B3D5B8BC,30921,0,9,9,109.53903,18.29451,1667
250986,301E657A2E52A15D5305B0C9B3D5B8BC,31931,13,22,9,109.54771,18.29403,1667
251028,A538A8C1144013F8D5F89234B7CAA827,38291,15,16,1,109.51618,18.24313,1558
251034,1B810331266478325A9C525A64BDFAB6,30854,14,21,7,109.56889,18.27076,1763
251085,14F1CC63CDA098F9694EAC8584B9C7A5,31071,9,10,1,109.58257,18.28458,1815
251086,14F1CC63CDA098F9694EAC8584B9C7A5,30854,14,16,2,109.56889,18.27076,1763
251087,14F1CC63CDA098F9694EAC8584B9C7A5,31561,20,21,1,109.56792,18.28479,1765
251116,82FA50C876D91311B7DA8BB626927288,31761,1,6,5,109.60521,18.27965,1914
251117,82FA50C876D91311B7DA8BB626927288,31071,7,8,1,109.58257,18.28458,1815
251118,82FA50C876D91311B7DA8BB626927288,31271,12,13,1,109.48958,18.26257,1462
251119,82FA50C876D91311B7DA8BB626927288,30854,17,18,1,109.56889,18.27076,1763
251161,C8501DFE42E6954852B7593EDA5D3099,30151,14,15,1,109.50986,18.25083,1560
251162,C8501DFE42E6954852B7593EDA5D3099,31351,16,17,1,109.4959,18.28417,1465
251163,C8501DFE42E6954852B7593EDA5D3099,31421,19,20,1,109.55382,18.22347,1705
251164,C8501DFE42E6954852B7593EDA5D3099,30111,21,22,1,109.47583,18.30542,1419
251176,1D8B814EC83D52D7C5F3FED99C129EE0,30854,1,8,7,109.56889,18.27076,1763
251177,1D8B814EC83D52D7C5F3FED99C129EE0,38271,10,20,10,109.62632,18.23049,1956
251215,94809C00F2FF497D1CB05735B4C9C70D,39183,0,9,9,109.55542,18.28208,1715
251216,94809C00F2FF497D1CB05735B4C9C70D,30854,13,23,10,109.56889,18.27076,1763
251228,80D5971B84EF3A2477C3F057B855AF63,31071,0,14,14,109.58257,18.28458,1815
251229,80D5971B84EF3A2477C3F057B855AF63,30854,15,20,5,109.56889,18.27076,1763
251247,4F1F2C63B1D8098AD9ABA50013979078,60084,0,1,1,109.4984,18.2334,1507
251248,4F1F2C63B1D8098AD9ABA50013979078,31461,1,13,12,109.5091,18.25389,1510
251249,4F1F2C63B1D8098AD9ABA50013979078,30511,14,16,2,109.51069,18.24208,1558
251250,4F1F2C63B1D8098AD9ABA50013979078,31521,17,19,2,109.51458,18.22542,1555
251269,7C4B45B599684104AFE3AA992CD3924A,31761,0,6,6,109.60521,18.27965,1914
251270,7C4B45B599684104AFE3AA992CD3924A,30811,8,10,2,109.65188,18.26257,2062
251271,7C4B45B599684104AFE3AA992CD3924A,30711,12,15,3,109.50271,18.25347,1510
251272,7C4B45B599684104AFE3AA992CD3924A,30811,18,19,1,109.65188,18.26257,2062
251273,7C4B45B599684104AFE3AA992CD3924A,38127,21,23,2,109.50833,18.27222,1513
251274,EC48DC043ECC2BB1E277836344D8B9F9,31071,2,8,6,109.58257,18.28458,1815
251275,EC48DC043ECC2BB1E277836344D8B9F9,30854,10,23,13,109.56889,18.27076,1763
251298,6BF671BC76B2463D72102139E4EB1018,38241,7,9,2,109.54111,18.30542,1669
251299,6BF671BC76B2463D72102139E4EB1018,60371,10,11,1,109.53063,18.30056,1618
251300,6BF671BC76B2463D72102139E4EB1018,38241,13,15,2,109.54111,18.30542,1669
251301,6BF671BC76B2463D72102139E4EB1018,31931,18,22,4,109.54771,18.29403,1667
251328,E6F79A5F6F7C034FE4F98780B21D590B,30281,18,23,5,109.50597,18.27583,1514
251343,6D3F7AF92DDEA3B5452C1769E3304CDD,30581,3,5,2,109.62257,18.24951,1959
251344,6D3F7AF92DDEA3B5452C1769E3304CDD,60594,6,8,2,109.62694,18.22799,1956
251345,6D3F7AF92DDEA3B5452C1769E3304CDD,38052,8,12,4,109.62618,18.23042,1956
251346,6D3F7AF92DDEA3B5452C1769E3304CDD,60594,15,19,4,109.62694,18.22799,1956
251355,AB43182259122294244C13D6FC66D4A1,60631,0,6,6,109.57778,18.27583,1814
251356,AB43182259122294244C13D6FC66D4A1,31561,10,15,5,109.56792,18.28479,1765
251357,AB43182259122294244C13D6FC66D4A1,30851,16,17,1,109.5616,18.27396,1713
251358,AB43182259122294244C13D6FC66D4A1,31071,19,21,2,109.58257,18.28458,1815
251364,C462628FF36F8FF2D0B7493E6DDA38BB,30661,3,6,3,109.37028,18.24361,1008
251365,C462628FF36F8FF2D0B7493E6DDA38BB,60411,8,10,2,109.32514,18.30854,869
251366,C462628FF36F8FF2D0B7493E6DDA38BB,30661,11,12,1,109.37028,18.24361,1008
251367,C462628FF36F8FF2D0B7493E6DDA38BB,60411,12,14,2,109.32514,18.30854,869
251378,DE91F768E6CCDB78867FF54F078574C9,30854,2,17,15,109.56889,18.27076,1763
251379,DE91F768E6CCDB78867FF54F078574C9,60463,19,21,2,109.52507,18.22438,1605
251380,DE91F768E6CCDB78867FF54F078574C9,30854,22,23,1,109.56889,18.27076,1763
251381,F8D799D9161B0143E0D71C40472A357E,30071,0,15,15,109.52819,18.30472,1619
251382,F8D799D9161B0143E0D71C40472A357E,30071,16,17,1,109.52819,18.30472,1619
251383,F8D799D9161B0143E0D71C40472A357E,31951,18,20,2,109.52174,18.30299,1568
251384,5EE25A6E7DD554FFDA0C9C1A504114B7,60381,1,7,6,109.5241,18.22458,1605
251385,5EE25A6E7DD554FFDA0C9C1A504114B7,30221,12,23,11,109.57833,18.20222,1802
251397,C0CA4E58B15F58D7F48B8BEF10CEB35A,30854,4,7,3,109.56889,18.27076,1763
251398,C0CA4E58B15F58D7F48B8BEF10CEB35A,60591,12,16,4,109.61118,18.21715,1904
251403,4027759DA4AA4E8EAD8331A27147F405,31071,0,10,10,109.58257,18.28458,1815
251404,4027759DA4AA4E8EAD8331A27147F405,30854,13,23,10,109.56889,18.27076,1763
251405,01B87D483E44795571C3E4AB55CA6210,60594,0,6,6,109.62694,18.22799,1956
251406,01B87D483E44795571C3E4AB55CA6210,38331,6,8,2,109.62465,18.22736,1956
251407,01B87D483E44795571C3E4AB55CA6210,31781,11,13,2,109.19847,18.2975,367
251408,01B87D483E44795571C3E4AB55CA6210,38052,16,17,1,109.62618,18.23042,1956
251409,01B87D483E44795571C3E4AB55CA6210,38331,19,23,4,109.62465,18.22736,1956
251416,7BF65E5054DA81A230AB5423620158E1,31071,4,7,3,109.58257,18.28458,1815
251417,7BF65E5054DA81A230AB5423620158E1,30854,9,23,14,109.56889,18.27076,1763
251431,D1A5E6081E70F748BFD3C6895B141C01,31473,2,3,1,109.34792,18.29465,917
251432,D1A5E6081E70F748BFD3C6895B141C01,60411,5,7,2,109.32514,18.30854,869
251433,D1A5E6081E70F748BFD3C6895B141C01,30661,8,14,6,109.37028,18.24361,1008
251434,D1A5E6081E70F748BFD3C6895B141C01,60411,18,21,3,109.32514,18.30854,869
251465,A7B25709FE412024EFA55603332D5E9B,38951,0,1,1,109.48097,18.28868,1416
251466,A7B25709FE412024EFA55603332D5E9B,38951,2,6,4,109.48097,18.28868,1416
251467,A7B25709FE412024EFA55603332D5E9B,38951,7,8,1,109.48097,18.28868,1416
251468,A7B25709FE412024EFA55603332D5E9B,30581,13,14,1,109.62257,18.24951,1959
251469,A7B25709FE412024EFA55603332D5E9B,38951,19,21,2,109.48097,18.28868,1416
251470,A7B25709FE412024EFA55603332D5E9B,38951,21,23,2,109.48097,18.28868,1416
251479,D9E60CECBCF3335BA62A418C133E83E2,31145,10,14,4,109.20431,18.30479,369
251480,D9E60CECBCF3335BA62A418C133E83E2,30731,15,16,1,109.50944,18.22306,1555
251481,D9E60CECBCF3335BA62A418C133E83E2,31521,20,22,2,109.51458,18.22542,1555
251495,AAC7E9546787DDB508C41969C1E453E7,30711,13,15,2,109.50271,18.25347,1510
251496,AAC7E9546787DDB508C41969C1E453E7,30421,16,20,4,109.50021,18.25861,1511
251497,AAC7E9546787DDB508C41969C1E453E7,39154,22,23,1,109.50201,18.25681,1511
251542,FF898816F5AB968DB896F672436E99BE,31561,14,18,4,109.56792,18.28479,1765
251543,FF898816F5AB968DB896F672436E99BE,30854,22,23,1,109.56889,18.27076,1763
251549,C6C3BC01E542B810EF853FEEB6C81198,60361,0,6,6,109.51938,18.29681,1567
251550,C6C3BC01E542B810EF853FEEB6C81198,60274,11,12,1,109.514,18.2933,1567
251551,C6C3BC01E542B810EF853FEEB6C81198,60361,14,18,4,109.51938,18.29681,1567
251552,C6C3BC01E542B810EF853FEEB6C81198,31561,19,20,1,109.56792,18.28479,1765
251566,41E1FA52CB6486CE3AFD44197134334F,38251,19,20,1,109.49618,18.25493,1510
251567,41E1FA52CB6486CE3AFD44197134334F,30351,22,23,1,109.41701,18.29292,1217
251588,6C0260646767B781577B5B8CE2471E51,60361,4,5,1,109.51938,18.29681,1567
251589,6C0260646767B781577B5B8CE2471E51,38484,7,8,1,109.53028,18.31528,1620
251590,6C0260646767B781577B5B8CE2471E51,38484,9,10,1,109.53028,18.31528,1620
251591,6C0260646767B781577B5B8CE2471E51,38484,12,20,8,109.53028,18.31528,1620
251592,6C0260646767B781577B5B8CE2471E51,31951,21,22,1,109.52174,18.30299,1568
251611,52626520133C58C019E9712FB19D3224,38171,0,7,7,109.50799,18.28139,1515
251612,52626520133C58C019E9712FB19D3224,39091,8,10,2,109.50097,18.25222,1510
251613,52626520133C58C019E9712FB19D3224,30711,11,14,3,109.50271,18.25347,1510
251614,5C2E5594DBCFD5372253A405BCF686FC,60401,6,7,1,109.47444,18.27583,1414
251615,5C2E5594DBCFD5372253A405BCF686FC,31091,8,10,2,109.41201,18.31222,1170
251616,5C2E5594DBCFD5372253A405BCF686FC,30581,11,12,1,109.62257,18.24951,1959
251617,5C2E5594DBCFD5372253A405BCF686FC,60401,17,21,4,109.47444,18.27583,1414
251618,B85E59A5F7A67DEC44CFA6188E05977A,30051,16,17,1,109.48917,18.21215,1453
251619,B85E59A5F7A67DEC44CFA6188E05977A,38094,18,19,1,109.45403,18.28778,1316
251620,B85E59A5F7A67DEC44CFA6188E05977A,38325,20,21,1,109.39792,18.2909,1116
251621,B85E59A5F7A67DEC44CFA6188E05977A,60524,22,23,1,109.42951,18.28993,1216
251627,8F6EA1C108FADA76A214A7ED71ECE3D1,30891,3,4,1,109.59431,18.28389,1865
251628,8F6EA1C108FADA76A214A7ED71ECE3D1,30854,9,12,3,109.56889,18.27076,1763
251629,8F6EA1C108FADA76A214A7ED71ECE3D1,30232,13,14,1,109.6191,18.31701,1971
251630,8F6EA1C108FADA76A214A7ED71ECE3D1,30854,16,19,3,109.56889,18.27076,1763
251631,8F6EA1C108FADA76A214A7ED71ECE3D1,30891,19,20,1,109.59431,18.28389,1865
251715,CFFDD1BF3134B9FDD71614F40E1DE0FD,31071,7,8,1,109.58257,18.28458,1815
251716,CFFDD1BF3134B9FDD71614F40E1DE0FD,30361,13,15,2,109.50347,18.24,1508
251717,A88B35A7108477CCC954BD53412ECC82,60171,0,5,5,109.51292,18.30694,1569
251718,A88B35A7108477CCC954BD53412ECC82,38991,8,9,1,109.52681,18.30368,1618
251719,A88B35A7108477CCC954BD53412ECC82,60221,12,14,2,109.52569,18.29188,1616
251720,A88B35A7108477CCC954BD53412ECC82,30071,17,18,1,109.52819,18.30472,1619
251721,A88B35A7108477CCC954BD53412ECC82,31951,20,23,3,109.52174,18.30299,1568
251729,8AABF5FDF2B06EB445749240A3894969,31071,0,7,7,109.58257,18.28458,1815
251730,8AABF5FDF2B06EB445749240A3894969,30854,8,10,2,109.56889,18.27076,1763
251731,8AABF5FDF2B06EB445749240A3894969,31071,10,11,1,109.58257,18.28458,1815
251732,8AABF5FDF2B06EB445749240A3894969,30854,12,16,4,109.56889,18.27076,1763
251733,8AABF5FDF2B06EB445749240A3894969,31851,16,18,2,109.71736,18.29007,2316
251734,8AABF5FDF2B06EB445749240A3894969,31161,19,21,2,109.70229,18.31361,2270
251763,22A8C784120E0ECB26B7876A46A934FF,31431,15,17,2,109.44639,18.29042,1316
251764,22A8C784120E0ECB26B7876A46A934FF,30421,18,23,5,109.50021,18.25861,1511
251765,B2035C0684FF9CA861B7EB217CE5A160,60041,2,3,1,109.39889,18.31944,1121
251766,B2035C0684FF9CA861B7EB217CE5A160,60524,3,4,1,109.42951,18.28993,1216
251767,B2035C0684FF9CA861B7EB217CE5A160,60041,5,6,1,109.39889,18.31944,1121
251768,B2035C0684FF9CA861B7EB217CE5A160,31471,13,14,1,109.34583,18.29563,917
251769,B2035C0684FF9CA861B7EB217CE5A160,60552,19,21,2,109.41729,18.30014,1218
251770,B2035C0684FF9CA861B7EB217CE5A160,60331,21,23,2,109.505,18.26507,1512
251780,A81CD054527D0434AE311D6C97FF6CEE,39281,15,18,3,109.21333,18.30271,418
251781,A81CD054527D0434AE311D6C97FF6CEE,31251,18,20,2,109.18528,18.2975,317
251796,2C303B1DBEEAF6FB7E8F89545513E0AE,30081,0,7,7,109.50243,18.26632,1512
251797,2C303B1DBEEAF6FB7E8F89545513E0AE,39181,7,10,3,109.55153,18.28035,1715
251798,2C303B1DBEEAF6FB7E8F89545513E0AE,30081,11,13,2,109.50243,18.26632,1512
251799,2C303B1DBEEAF6FB7E8F89545513E0AE,31931,13,18,5,109.54771,18.29403,1667
251800,2C303B1DBEEAF6FB7E8F89545513E0AE,30081,18,19,1,109.50243,18.26632,1512
251801,2C303B1DBEEAF6FB7E8F89545513E0AE,31271,20,21,1,109.48958,18.26257,1462
251802,2C303B1DBEEAF6FB7E8F89545513E0AE,30081,22,23,1,109.50243,18.26632,1512
251821,FC8552628F8A5A5219C1C30314657039,60661,0,7,7,109.548,18.2377,1657
251822,FC8552628F8A5A5219C1C30314657039,30421,9,10,1,109.50021,18.25861,1511
251846,E8BAAF476E8FE57075BAB1A8D4FF1780,39371,0,2,2,109.56627,18.2646,1762
251847,E8BAAF476E8FE57075BAB1A8D4FF1780,30232,3,13,10,109.6191,18.31701,1971
251848,E8BAAF476E8FE57075BAB1A8D4FF1780,39371,15,18,3,109.56627,18.2646,1762
251849,E8BAAF476E8FE57075BAB1A8D4FF1780,60381,19,20,1,109.5241,18.22458,1605
251850,E8BAAF476E8FE57075BAB1A8D4FF1780,39371,21,22,1,109.56627,18.2646,1762
251889,64FF3E93355E6DCA29977E04D316EABA,30511,0,2,2,109.51069,18.24208,1558
251890,64FF3E93355E6DCA29977E04D316EABA,38973,3,8,5,109.51097,18.25389,1560
251891,64FF3E93355E6DCA29977E04D316EABA,30151,11,17,6,109.50986,18.25083,1560
251892,64FF3E93355E6DCA29977E04D316EABA,30711,21,23,2,109.50271,18.25347,1510
251906,9A1D1AA5EE2CD156CC396C667ED8C5B9,31071,1,5,4,109.58257,18.28458,1815
251907,9A1D1AA5EE2CD156CC396C667ED8C5B9,30854,8,9,1,109.56889,18.27076,1763
251913,610275798AB59486D52727134DFD1B86,31206,1,6,5,109.50819,18.23549,1507
251914,610275798AB59486D52727134DFD1B86,60084,6,8,2,109.4984,18.2334,1507
251915,610275798AB59486D52727134DFD1B86,30181,11,12,1,109.51597,18.23313,1557
251916,610275798AB59486D52727134DFD1B86,30191,14,16,2,109.50361,18.22701,1506
251917,610275798AB59486D52727134DFD1B86,30421,18,20,2,109.50021,18.25861,1511
251929,408C4FED868686E7B96333835F4C4205,60631,0,7,7,109.57778,18.27583,1814
251930,408C4FED868686E7B96333835F4C4205,33521,9,12,3,109.66313,18.45174,2143
251931,408C4FED868686E7B96333835F4C4205,30854,15,16,1,109.56889,18.27076,1763
251932,408C4FED868686E7B96333835F4C4205,60631,21,23,2,109.57778,18.27583,1814
251939,6532548CEFFF043086FECA37F4D65565,30854,10,11,1,109.56889,18.27076,1763
251940,6532548CEFFF043086FECA37F4D65565,38315,13,16,3,109.48979,18.29764,1467
251955,798BF3B08F72A16A6DEAAA235F1899BB,61011,4,20,16,109.60653,18.19076,1900
251965,6C09CE755C8436D31143C1E3AA51623D,30854,12,14,2,109.56889,18.27076,1763
251966,6C09CE755C8436D31143C1E3AA51623D,31071,17,18,1,109.58257,18.28458,1815
252074,E4C7AB656E412C7E33554D18277C9478,60201,10,12,2,109.5041,18.2509,1510
252075,E4C7AB656E412C7E33554D18277C9478,60291,12,22,10,109.50826,18.24639,1509
252099,8401B75264E9301421036C68C0E8016B,38911,2,8,6,109.51674,18.24965,1559
252100,8401B75264E9301421036C68C0E8016B,30151,10,11,1,109.50986,18.25083,1560
252101,8401B75264E9301421036C68C0E8016B,38291,11,13,2,109.51618,18.24313,1558
252102,8401B75264E9301421036C68C0E8016B,30071,17,19,2,109.52819,18.30472,1619
252131,86D3006AEF049E89938D7A9A9936BB9C,31071,1,15,14,109.58257,18.28458,1815
252132,86D3006AEF049E89938D7A9A9936BB9C,30854,19,20,1,109.56889,18.27076,1763
252146,0ECAA77148BC3CC3B9A4A65F40F94BCA,31031,12,13,1,109.49979,18.25382,1510
252147,0ECAA77148BC3CC3B9A4A65F40F94BCA,31031,15,18,3,109.49979,18.25382,1510
252169,6751CEC3CF9B2AE78246C7287443D2B4,31945,0,5,5,109.58021,18.29403,1817
252170,6751CEC3CF9B2AE78246C7287443D2B4,30854,9,18,9,109.56889,18.27076,1763
252175,6751CEC3CF9B2AE78246C7287443D2B4,31071,2,7,5,109.58257,18.28458,1815
252176,6751CEC3CF9B2AE78246C7287443D2B4,30854,7,9,2,109.56889,18.27076,1763
252177,6751CEC3CF9B2AE78246C7287443D2B4,31071,12,15,3,109.58257,18.28458,1815
252178,6751CEC3CF9B2AE78246C7287443D2B4,30854,16,18,2,109.56889,18.27076,1763
252199,DC9885AE38AE7598214BC46FD2D819A5,38991,0,6,6,109.52681,18.30368,1618
252200,DC9885AE38AE7598214BC46FD2D819A5,38171,6,9,3,109.50799,18.28139,1515
252214,4D4289AE0DFBF4B5C79A47559DC2EBDD,39371,2,9,7,109.56627,18.2646,1762
252215,4D4289AE0DFBF4B5C79A47559DC2EBDD,31071,9,11,2,109.58257,18.28458,1815
252216,4D4289AE0DFBF4B5C79A47559DC2EBDD,30854,11,12,1,109.56889,18.27076,1763
252217,4D4289AE0DFBF4B5C79A47559DC2EBDD,60381,13,19,6,109.5241,18.22458,1605
252218,4D4289AE0DFBF4B5C79A47559DC2EBDD,39371,20,22,2,109.56627,18.2646,1762
252219,59F29435D748531F416A4F1636997ECF,31071,0,1,1,109.58257,18.28458,1815
252220,59F29435D748531F416A4F1636997ECF,31071,3,7,4,109.58257,18.28458,1815
252221,68DBE0B52FD0AB95F1DD47068FD7847F,60311,1,8,7,109.52097,18.24319,1558
252222,68DBE0B52FD0AB95F1DD47068FD7847F,31201,11,13,2,109.51042,18.23819,1558
252223,68DBE0B52FD0AB95F1DD47068FD7847F,30181,14,22,8,109.51597,18.23313,1557
252250,69EA58E2C68065F45F7A1847747C7961,39191,0,5,5,109.51493,18.23472,1557
252251,69EA58E2C68065F45F7A1847747C7961,38961,6,8,2,109.50847,18.23514,1507
252252,69EA58E2C68065F45F7A1847747C7961,31781,11,13,2,109.19847,18.2975,367
252276,CBEC85B23D166297F931D8AA26FC2B44,30421,17,19,2,109.50021,18.25861,1511
252277,CBEC85B23D166297F931D8AA26FC2B44,38251,20,21,1,109.49618,18.25493,1510
252287,522E8CB42AF22D75F3E9D0FD1FDCEEA6,39371,0,1,1,109.56627,18.2646,1762
252288,522E8CB42AF22D75F3E9D0FD1FDCEEA6,30854,2,4,2,109.56889,18.27076,1763
252289,522E8CB42AF22D75F3E9D0FD1FDCEEA6,39371,5,6,1,109.56627,18.2646,1762
252290,522E8CB42AF22D75F3E9D0FD1FDCEEA6,30854,7,9,2,109.56889,18.27076,1763
252291,522E8CB42AF22D75F3E9D0FD1FDCEEA6,39371,11,14,3,109.56627,18.2646,1762
252341,5D5B29A994BBA3635D38463A75BE58F6,30201,0,7,7,109.4909,18.26465,1462
252343,5D5B29A994BBA3635D38463A75BE58F6,30201,13,15,2,109.4909,18.26465,1462
252366,2CF83F5125C6075E2ACA9C17C2979C64,30854,12,18,6,109.56889,18.27076,1763
252367,2CF83F5125C6075E2ACA9C17C2979C64,31071,22,23,1,109.58257,18.28458,1815
252378,16CCFF81838B15A70A44E8C4B6CCB914,60661,0,7,7,109.548,18.2377,1657
252379,16CCFF81838B15A70A44E8C4B6CCB914,31461,8,9,1,109.5091,18.25389,1510
252380,16CCFF81838B15A70A44E8C4B6CCB914,38171,13,14,1,109.50799,18.28139,1515
252381,222E0B6922623CE9FBB280F81068D40E,38154,0,1,1,109.5266,18.28278,1615
252382,222E0B6922623CE9FBB280F81068D40E,31521,2,8,6,109.51458,18.22542,1555
252383,222E0B6922623CE9FBB280F81068D40E,30854,9,10,1,109.56889,18.27076,1763
252384,222E0B6922623CE9FBB280F81068D40E,30321,14,15,1,109.49563,18.29611,1467
252385,222E0B6922623CE9FBB280F81068D40E,31061,18,21,3,109.53333,18.23257,1607
252407,2CDAE88307C6499C1237039C0E27A7F5,60261,0,6,6,109.44326,18.3075,1319
252408,2CDAE88307C6499C1237039C0E27A7F5,31561,9,10,1,109.56792,18.28479,1765
252409,2CDAE88307C6499C1237039C0E27A7F5,30851,12,14,2,109.5616,18.27396,1713
252410,2CDAE88307C6499C1237039C0E27A7F5,60421,18,22,4,109.46333,18.31743,1371
252417,A795428793D2273B4ACFDADC5E61AEC2,60381,14,16,2,109.5241,18.22458,1605
252418,A795428793D2273B4ACFDADC5E61AEC2,60641,20,22,2,109.53854,18.2359,1657
252430,14DD9E5DCCEFE8BE7425556E4E04FC9A,31561,0,5,5,109.56792,18.28479,1765
252431,14DD9E5DCCEFE8BE7425556E4E04FC9A,30854,6,7,1,109.56889,18.27076,1763
252432,14DD9E5DCCEFE8BE7425556E4E04FC9A,31071,10,12,2,109.58257,18.28458,1815
252433,14DD9E5DCCEFE8BE7425556E4E04FC9A,31071,13,19,6,109.58257,18.28458,1815
252434,14DD9E5DCCEFE8BE7425556E4E04FC9A,60354,20,23,3,109.58701,18.28521,1815
252474,BB817C31A3F12EE16D15A558C65FED5B,31071,1,2,1,109.58257,18.28458,1815
252475,BB817C31A3F12EE16D15A558C65FED5B,30854,5,6,1,109.56889,18.27076,1763
252476,BB817C31A3F12EE16D15A558C65FED5B,31071,6,8,2,109.58257,18.28458,1815
252477,BB817C31A3F12EE16D15A558C65FED5B,30854,11,20,9,109.56889,18.27076,1763
252478,BB817C31A3F12EE16D15A558C65FED5B,31071,20,21,1,109.58257,18.28458,1815
252480,F51750B4A76BF6CF96537CEE75AA6CF8,60161,21,22,1,109.49174,18.26181,1461
252488,372A5433078073EAD18922D679CE0A73,60054,2,4,2,109.3016,18.31229,770
252489,372A5433078073EAD18922D679CE0A73,60411,7,9,2,109.32514,18.30854,869
252490,372A5433078073EAD18922D679CE0A73,60054,12,14,2,109.3016,18.31229,770
252491,372A5433078073EAD18922D679CE0A73,60411,15,21,6,109.32514,18.30854,869
252548,65AD296DD65C9EEA3C22EA02904A768E,31561,2,4,2,109.56792,18.28479,1765
252549,65AD296DD65C9EEA3C22EA02904A768E,30854,9,15,6,109.56889,18.27076,1763
252563,4A6E6277F47F7550E2618B9C1ADC3166,31391,14,16,2,109.50382,18.24285,1508
252564,4A6E6277F47F7550E2618B9C1ADC3166,30711,17,18,1,109.50271,18.25347,1510
252565,4A6E6277F47F7550E2618B9C1ADC3166,30361,20,23,3,109.50347,18.24,1508
252580,BB31DF7CD95EBDC65D12089CF34DDE37,31521,0,6,6,109.51458,18.22542,1555
252589,FF8CB3D02361FAEBFE418108180099D8,39154,0,6,6,109.50201,18.25681,1511
252590,FF8CB3D02361FAEBFE418108180099D8,31461,10,11,1,109.5091,18.25389,1510
252591,FF8CB3D02361FAEBFE418108180099D8,30711,12,22,10,109.50271,18.25347,1510
252594,D4EE8E1A4C04A1FF0596E4221D0B8B42,30854,1,18,17,109.56889,18.27076,1763
252595,D4EE8E1A4C04A1FF0596E4221D0B8B42,31071,21,22,1,109.58257,18.28458,1815
252596,7803AECF4FFC2BF233E3B7ACD0D2E9F8,31561,0,6,6,109.56792,18.28479,1765
252597,7803AECF4FFC2BF233E3B7ACD0D2E9F8,39371,7,8,1,109.56627,18.2646,1762
252598,7803AECF4FFC2BF233E3B7ACD0D2E9F8,30851,9,11,2,109.5616,18.27396,1713
252645,803884DAE228D36B780CDE250AFE5FD1,38911,15,18,3,109.51674,18.24965,1559
252646,803884DAE228D36B780CDE250AFE5FD1,38251,21,23,2,109.49618,18.25493,1510
252667,D2D609608AA1D4DD8E18DD3745793D0D,39371,0,6,6,109.56627,18.2646,1762
252668,D2D609608AA1D4DD8E18DD3745793D0D,38251,10,12,2,109.49618,18.25493,1510
252669,D2D609608AA1D4DD8E18DD3745793D0D,30854,14,20,6,109.56889,18.27076,1763
252676,6F55ACFC3A2BD8567407A1426439CC11,60171,2,8,6,109.51292,18.30694,1569
252677,6F55ACFC3A2BD8567407A1426439CC11,30071,9,14,5,109.52819,18.30472,1619
252678,6F55ACFC3A2BD8567407A1426439CC11,60171,14,22,8,109.51292,18.30694,1569
252682,7A214C2AB4CE0E87DF8DB230B9F95561,30101,0,5,5,109.57299,18.33333,1773
252683,7A214C2AB4CE0E87DF8DB230B9F95561,31631,6,10,4,109.59542,18.36826,1879
252684,7A214C2AB4CE0E87DF8DB230B9F95561,30101,10,14,4,109.57299,18.33333,1773
252685,9B389AE8E9B004176803CCEAFF69104A,39371,0,6,6,109.56627,18.2646,1762
252686,9B389AE8E9B004176803CCEAFF69104A,60631,7,10,3,109.57778,18.27583,1814
252748,90F3300D143E0362CC2D61396D0D92D9,60054,2,4,2,109.3016,18.31229,770
252749,90F3300D143E0362CC2D61396D0D92D9,60231,4,18,14,109.49903,18.21972,1504
252750,106CA3A9375076B84A466DFC7E9F4CF9,30081,4,7,3,109.50243,18.26632,1512
252751,106CA3A9375076B84A466DFC7E9F4CF9,60591,8,10,2,109.61118,18.21715,1904
252752,106CA3A9375076B84A466DFC7E9F4CF9,38336,12,15,3,109.61111,18.21806,1904
252753,139FA6FF337FC827A4AC3BA48C6CF2AF,60291,7,9,2,109.50826,18.24639,1509
252754,139FA6FF337FC827A4AC3BA48C6CF2AF,60241,11,18,7,109.53319,18.28667,1616
252818,5977B7597B86A7D3A555436201A15FE0,30711,0,6,6,109.50271,18.25347,1510
252819,5977B7597B86A7D3A555436201A15FE0,60131,6,8,2,109.49819,18.24778,1509
252820,5977B7597B86A7D3A555436201A15FE0,30421,11,12,1,109.50021,18.25861,1511
252821,5977B7597B86A7D3A555436201A15FE0,31101,14,23,9,109.65389,18.23403,2057
252832,8D3B10FD4DBC46DB93DA60040668F697,30854,0,6,6,109.56889,18.27076,1763
252833,8D3B10FD4DBC46DB93DA60040668F697,31561,6,8,2,109.56792,18.28479,1765
252834,8D3B10FD4DBC46DB93DA60040668F697,30854,11,22,11,109.56889,18.27076,1763
252865,E43761FEBE209371C105554567258124,31321,0,6,6,109.63799,18.23201,2007
252866,E43761FEBE209371C105554567258124,31931,7,11,4,109.54771,18.29403,1667
252867,E43761FEBE209371C105554567258124,31321,12,13,1,109.63799,18.23201,2007
252868,E43761FEBE209371C105554567258124,31931,14,17,3,109.54771,18.29403,1667
252869,E43761FEBE209371C105554567258124,60241,17,18,1,109.53319,18.28667,1616
252870,E43761FEBE209371C105554567258124,31321,20,23,3,109.63799,18.23201,2007
252904,3E0CC1F431A959DE24ABB41EC7702F6D,30351,0,1,1,109.41701,18.29292,1217
252905,3E0CC1F431A959DE24ABB41EC7702F6D,60524,2,3,1,109.42951,18.28993,1216
252906,3E0CC1F431A959DE24ABB41EC7702F6D,31231,4,6,2,109.42597,18.29292,1217
252907,3E0CC1F431A959DE24ABB41EC7702F6D,60552,7,8,1,109.41729,18.30014,1218
252908,3E0CC1F431A959DE24ABB41EC7702F6D,60071,12,16,4,109.75674,18.31583,2470
252941,9DA18E32D5BC3B3B3E933A918C5F29CA,30151,0,14,14,109.50986,18.25083,1560
252942,9DA18E32D5BC3B3B3E933A918C5F29CA,31461,14,16,2,109.5091,18.25389,1510
252955,63CB222117AB8A54673799718246EF46,30391,18,19,1,109.4975,18.27118,1513
252956,63CB222117AB8A54673799718246EF46,31864,20,21,1,109.49014,18.28333,1465
252969,332A868849E47177376F9755C981E1C1,60441,0,3,3,109.46792,18.28604,1366
252970,332A868849E47177376F9755C981E1C1,60391,5,15,10,109.47667,18.28757,1416
252971,332A868849E47177376F9755C981E1C1,60391,15,18,3,109.47667,18.28757,1416
252972,332A868849E47177376F9755C981E1C1,31351,20,22,2,109.4959,18.28417,1465
252983,0CF6CC5FF24D6A6AB1B738BADBD1459E,31461,0,8,8,109.5091,18.25389,1510
252984,0CF6CC5FF24D6A6AB1B738BADBD1459E,31471,11,15,4,109.34583,18.29563,917
252985,0CF6CC5FF24D6A6AB1B738BADBD1459E,30151,16,17,1,109.50986,18.25083,1560
253028,91F494773E6D64BA1F7E2CDDDA7EB44B,30721,0,8,8,109.51597,18.28257,1565
253029,91F494773E6D64BA1F7E2CDDDA7EB44B,38127,8,11,3,109.50833,18.27222,1513
253056,EB316856896788EC8FD871E122E95728,31811,1,8,7,109.54201,18.31806,1671
253057,EB316856896788EC8FD871E122E95728,30701,10,14,4,109.59313,18.32007,1871
253058,EB316856896788EC8FD871E122E95728,31811,18,19,1,109.54201,18.31806,1671
253059,EB316856896788EC8FD871E122E95728,30701,20,23,3,109.59313,18.32007,1871
253071,CBA29FB366E4111071C95C99C696D0E6,31321,7,16,9,109.63799,18.23201,2007
253072,CBA29FB366E4111071C95C99C696D0E6,31561,19,20,1,109.56792,18.28479,1765
253085,DD406D33A3DCAF10F3838DF55666D7A6,31431,0,7,7,109.44639,18.29042,1316
253086,DD406D33A3DCAF10F3838DF55666D7A6,31181,8,10,2,109.50382,18.24813,1509
253087,DD406D33A3DCAF10F3838DF55666D7A6,60504,12,13,1,109.47917,18.28903,1416
253088,DD406D33A3DCAF10F3838DF55666D7A6,31461,17,20,3,109.5091,18.25389,1510
253089,DD406D33A3DCAF10F3838DF55666D7A6,31201,20,22,2,109.51042,18.23819,1558
253107,39B59369A593F4590BA7B46095F37DD4,30171,0,9,9,109.48458,18.27139,1463
253108,39B59369A593F4590BA7B46095F37DD4,31471,10,12,2,109.34583,18.29563,917
253109,39B59369A593F4590BA7B46095F37DD4,30661,14,16,2,109.37028,18.24361,1008
253110,39B59369A593F4590BA7B46095F37DD4,30681,19,22,3,109.48493,18.26917,1463
253123,CD3BCBAB8571FB81953C842A434E5DB8,31761,7,9,2,109.60521,18.27965,1914
253124,CD3BCBAB8571FB81953C842A434E5DB8,31071,10,15,5,109.58257,18.28458,1815
253125,CD3BCBAB8571FB81953C842A434E5DB8,31071,19,23,4,109.58257,18.28458,1815
253178,58DE8A719D3ADBEDAE163213845B460A,31071,0,7,7,109.58257,18.28458,1815
253179,58DE8A719D3ADBEDAE163213845B460A,31071,10,14,4,109.58257,18.28458,1815
253180,58DE8A719D3ADBEDAE163213845B460A,30854,18,22,4,109.56889,18.27076,1763
253196,2DDF3A993BD69F79020EB97CF3A71819,38171,0,7,7,109.50799,18.28139,1515
253197,2DDF3A993BD69F79020EB97CF3A71819,30161,8,9,1,109.50042,18.24389,1508
253198,2DDF3A993BD69F79020EB97CF3A71819,38171,13,15,2,109.50799,18.28139,1515
253199,2DDF3A993BD69F79020EB97CF3A71819,30161,16,18,2,109.50042,18.24389,1508
253200,2DDF3A993BD69F79020EB97CF3A71819,60463,20,21,1,109.52507,18.22438,1605
253240,6EC37ACBAC0C5AEE7B19344F1CE4D7FD,60401,11,12,1,109.47444,18.27583,1414
253241,6EC37ACBAC0C5AEE7B19344F1CE4D7FD,30171,15,19,4,109.48458,18.27139,1463
253242,6EC37ACBAC0C5AEE7B19344F1CE4D7FD,60621,20,23,3,109.48354,18.27451,1464
253299,5264833F0013AE6B294396000613EF89,31411,18,20,2,109.5016,18.23576,1507
253300,5264833F0013AE6B294396000613EF89,31201,21,23,2,109.51042,18.23819,1558
253312,993300654839821E7CBC0B1D6C1A4599,61011,1,4,3,109.60653,18.19076,1900
253314,993300654839821E7CBC0B1D6C1A4599,61011,17,22,5,109.60653,18.19076,1900
253330,ACDEAAF45B65DE48CF80A48DBD3C775E,30854,2,3,1,109.56889,18.27076,1763
253331,ACDEAAF45B65DE48CF80A48DBD3C775E,31071,3,5,2,109.58257,18.28458,1815
253332,ACDEAAF45B65DE48CF80A48DBD3C775E,30854,7,8,1,109.56889,18.27076,1763
253333,ACDEAAF45B65DE48CF80A48DBD3C775E,31071,18,20,2,109.58257,18.28458,1815
253334,ACDEAAF45B65DE48CF80A48DBD3C775E,30854,20,21,1,109.56889,18.27076,1763
253337,5EBEA276FCB4A19AC5C987F5C7CC8908,60552,0,2,2,109.41729,18.30014,1218
253338,5EBEA276FCB4A19AC5C987F5C7CC8908,60524,3,6,3,109.42951,18.28993,1216
253339,5EBEA276FCB4A19AC5C987F5C7CC8908,60621,8,18,10,109.48354,18.27451,1464
253340,3B6FF1F8D896A0A62DC7E65967011999,31561,0,19,19,109.56792,18.28479,1765
253341,3B6FF1F8D896A0A62DC7E65967011999,39183,20,21,1,109.55542,18.28208,1715
253356,7B1A07C39637E996C01DF0A3D287D3C6,31071,11,13,2,109.58257,18.28458,1815
253357,7B1A07C39637E996C01DF0A3D287D3C6,39371,17,18,1,109.56627,18.2646,1762
253358,7B1A07C39637E996C01DF0A3D287D3C6,30854,21,23,2,109.56889,18.27076,1763
253361,DEEF519781F9588D37AD928845C2355A,39321,13,16,3,109.529,18.2167,1604
253362,DEEF519781F9588D37AD928845C2355A,60381,19,21,2,109.5241,18.22458,1605
253363,DEEF519781F9588D37AD928845C2355A,31521,21,23,2,109.51458,18.22542,1555
253373,0312B43ACF9ED1D8304E325E851AEE29,31561,12,13,1,109.56792,18.28479,1765
253374,0312B43ACF9ED1D8304E325E851AEE29,30851,13,15,2,109.5616,18.27396,1713
253375,0312B43ACF9ED1D8304E325E851AEE29,31561,15,16,1,109.56792,18.28479,1765
253440,C8135D3E403B7CC96352A41CBCD291A7,38241,0,6,6,109.54111,18.30542,1669
253441,C8135D3E403B7CC96352A41CBCD291A7,31021,8,10,2,109.49021,18.27,1463
253460,179FD4660C817BD29234A518F00339D3,39151,3,5,2,109.49875,18.25097,1510
253461,179FD4660C817BD29234A518F00339D3,60231,5,8,3,109.49903,18.21972,1504
253462,179FD4660C817BD29234A518F00339D3,60161,11,14,3,109.49174,18.26181,1461
253463,179FD4660C817BD29234A518F00339D3,60231,14,16,2,109.49903,18.21972,1504
253464,179FD4660C817BD29234A518F00339D3,30161,20,23,3,109.50042,18.24389,1508
253481,D40486BFA9AC720A5137C9EAFB418BFA,60361,0,7,7,109.51938,18.29681,1567
253482,D40486BFA9AC720A5137C9EAFB418BFA,31561,8,9,1,109.56792,18.28479,1765
253483,D40486BFA9AC720A5137C9EAFB418BFA,30721,13,14,1,109.51597,18.28257,1565
253491,41D4EB5552A7A416EEB26FAA30F55A4B,31561,1,3,2,109.56792,18.28479,1765
253492,41D4EB5552A7A416EEB26FAA30F55A4B,39371,4,6,2,109.56627,18.2646,1762
253493,41D4EB5552A7A416EEB26FAA30F55A4B,31561,6,13,7,109.56792,18.28479,1765
253494,41D4EB5552A7A416EEB26FAA30F55A4B,30851,14,16,2,109.5616,18.27396,1713
253495,7EB4F76900011DECC835981CBE847D5E,31561,12,15,3,109.56792,18.28479,1765
253496,7EB4F76900011DECC835981CBE847D5E,30854,16,17,1,109.56889,18.27076,1763
253520,8265A029C672FE0377EF574CC3ADF2A8,39371,0,5,5,109.56627,18.2646,1762
253521,8265A029C672FE0377EF574CC3ADF2A8,30854,8,13,5,109.56889,18.27076,1763
253522,8265A029C672FE0377EF574CC3ADF2A8,31561,14,16,2,109.56792,18.28479,1765
253543,CA3896FB33E9BC68E91955EDFF5D709B,60631,0,6,6,109.57778,18.27583,1814
253544,CA3896FB33E9BC68E91955EDFF5D709B,30854,7,8,1,109.56889,18.27076,1763
253549,64F4CDF664AA04E7B79DE93C57128CF6,31931,0,7,7,109.54771,18.29403,1667
253550,64F4CDF664AA04E7B79DE93C57128CF6,31561,8,15,7,109.56792,18.28479,1765
253603,A8B250EB4B4FCB9AA28B7DB7DA08558B,38157,1,3,2,109.51483,18.26958,1563
253604,A8B250EB4B4FCB9AA28B7DB7DA08558B,38911,3,7,4,109.51674,18.24965,1559
253674,EF0AF6DFF11E792E87881ED5E6F91398,30721,0,6,6,109.51597,18.28257,1565
253675,EF0AF6DFF11E792E87881ED5E6F91398,31561,7,8,1,109.56792,18.28479,1765
253676,EF0AF6DFF11E792E87881ED5E6F91398,30854,13,15,2,109.56889,18.27076,1763
253682,C93386A9D86FE22A1FD4E5116045DD8D,31561,0,5,5,109.56792,18.28479,1765
253683,C93386A9D86FE22A1FD4E5116045DD8D,30851,8,10,2,109.5616,18.27396,1713
253684,C93386A9D86FE22A1FD4E5116045DD8D,31561,13,14,1,109.56792,18.28479,1765
253685,C93386A9D86FE22A1FD4E5116045DD8D,30851,14,17,3,109.5616,18.27396,1713
253686,C93386A9D86FE22A1FD4E5116045DD8D,31561,22,23,1,109.56792,18.28479,1765
253739,01C3A40E8C2D18FB80BE4CD2C78B4B61,39151,0,4,4,109.49875,18.25097,1510
253740,01C3A40E8C2D18FB80BE4CD2C78B4B61,30611,4,5,1,109.74958,18.40188,2485
253755,3977578BE56276DA0700B04B81DC1356,30851,0,20,20,109.5616,18.27396,1713
253756,3977578BE56276DA0700B04B81DC1356,31561,22,23,1,109.56792,18.28479,1765
253775,1A5F33BA51312ECE9B56E6B834EAB28E,31071,18,19,1,109.58257,18.28458,1815
253776,1A5F33BA51312ECE9B56E6B834EAB28E,31945,21,23,2,109.58021,18.29403,1817
253831,0E129C09250C0D46273B4BD7E5225556,30151,0,7,7,109.50986,18.25083,1560
253832,0E129C09250C0D46273B4BD7E5225556,60201,7,10,3,109.5041,18.2509,1510
253833,0E129C09250C0D46273B4BD7E5225556,60401,11,17,6,109.47444,18.27583,1414
253834,0E129C09250C0D46273B4BD7E5225556,38291,19,21,2,109.51618,18.24313,1558
253835,0E129C09250C0D46273B4BD7E5225556,30151,22,23,1,109.50986,18.25083,1560
253848,D3CC138F01596B858EB1ECAA73909436,31231,0,7,7,109.42597,18.29292,1217
253849,D3CC138F01596B858EB1ECAA73909436,31521,12,14,2,109.51458,18.22542,1555
253850,D3CC138F01596B858EB1ECAA73909436,38721,15,23,8,109.50368,18.27542,1514
253896,4AB147D8833CB4682B303AB3B1B54716,31531,0,6,6,109.49583,18.25972,1461
253897,4AB147D8833CB4682B303AB3B1B54716,30711,7,10,3,109.50271,18.25347,1510
253898,4AB147D8833CB4682B303AB3B1B54716,30421,11,15,4,109.50021,18.25861,1511
253899,4AB147D8833CB4682B303AB3B1B54716,30711,15,17,2,109.50271,18.25347,1510
253900,4AB147D8833CB4682B303AB3B1B54716,30511,21,23,2,109.51069,18.24208,1558
253903,C709D01469E0800AF998DFAF42105CDC,60631,0,1,1,109.57778,18.27583,1814
253904,C709D01469E0800AF998DFAF42105CDC,30854,1,4,3,109.56889,18.27076,1763
253905,C709D01469E0800AF998DFAF42105CDC,31561,8,20,12,109.56792,18.28479,1765
253906,C709D01469E0800AF998DFAF42105CDC,30854,20,23,3,109.56889,18.27076,1763
253919,451E2BF48CD7B253EB0892324E679BCC,60281,6,12,6,109.51743,18.25924,1561
253920,451E2BF48CD7B253EB0892324E679BCC,38291,13,14,1,109.51618,18.24313,1558
253921,451E2BF48CD7B253EB0892324E679BCC,60281,15,18,3,109.51743,18.25924,1561
253922,451E2BF48CD7B253EB0892324E679BCC,38297,22,23,1,109.52576,18.24965,1609
253927,7D700D7B939DF0B50E1623297FA9AE05,60371,0,2,2,109.53063,18.30056,1618
253928,7D700D7B939DF0B50E1623297FA9AE05,31931,2,7,5,109.54771,18.29403,1667
253929,7D700D7B939DF0B50E1623297FA9AE05,60241,7,11,4,109.53319,18.28667,1616
253935,3160CBE2F0CDCB610575CDC881D9968C,38297,0,7,7,109.52576,18.24965,1609
253936,3160CBE2F0CDCB610575CDC881D9968C,38261,8,9,1,109.50361,18.28153,1515
253937,3160CBE2F0CDCB610575CDC881D9968C,38297,12,14,2,109.52576,18.24965,1609
253944,25022AD294B6F87A9AD511C3C16A0BF7,31671,0,3,3,109.38965,18.29813,1068
253945,25022AD294B6F87A9AD511C3C16A0BF7,30341,8,9,1,109.3625,18.29167,966
253946,25022AD294B6F87A9AD511C3C16A0BF7,30661,11,13,2,109.37028,18.24361,1008
253957,46D86CDF53B012A1EE50CB271AED98F8,38903,0,7,7,109.39229,18.29243,1117
253958,46D86CDF53B012A1EE50CB271AED98F8,38325,7,10,3,109.39792,18.2909,1116
253959,46D86CDF53B012A1EE50CB271AED98F8,30771,13,14,1,109.49938,18.26042,1511
253990,0E5593A90D661690BE3DAAA17AD936E2,38157,0,7,7,109.51483,18.26958,1563
253991,0E5593A90D661690BE3DAAA17AD936E2,30711,8,10,2,109.50271,18.25347,1510
253992,0E5593A90D661690BE3DAAA17AD936E2,30281,12,14,2,109.50597,18.27583,1514
253995,DDE77D3A656666992FC3458B84010D43,30854,1,4,3,109.56889,18.27076,1763
253996,DDE77D3A656666992FC3458B84010D43,31561,5,8,3,109.56792,18.28479,1765
253997,DDE77D3A656666992FC3458B84010D43,31931,9,10,1,109.54771,18.29403,1667
254001,40667E55EDAC334B8D18CEA71CBD34F4,31031,14,16,2,109.49979,18.25382,1510
254002,40667E55EDAC334B8D18CEA71CBD34F4,30111,16,17,1,109.47583,18.30542,1419
254003,40667E55EDAC334B8D18CEA71CBD34F4,31081,17,23,6,109.44639,18.30181,1318
254007,F5CD8B129D27723E0AB5614F6CDDABBC,30671,0,7,7,109.43611,18.30139,1268
254008,F5CD8B129D27723E0AB5614F6CDDABBC,30371,11,12,1,109.51,18.24771,1559
254009,F5CD8B129D27723E0AB5614F6CDDABBC,31101,13,15,2,109.65389,18.23403,2057
254016,EB86D6046E376669621AB1CCFD0E07BA,30351,0,3,3,109.41701,18.29292,1217
254017,EB86D6046E376669621AB1CCFD0E07BA,60524,4,21,17,109.42951,18.28993,1216
254018,C5190185E6A850F6CC88937542E0EA31,31071,2,3,1,109.58257,18.28458,1815
254019,C5190185E6A850F6CC88937542E0EA31,30854,7,18,11,109.56889,18.27076,1763
254020,C5190185E6A850F6CC88937542E0EA31,39371,19,23,4,109.56627,18.2646,1762
254034,2C3BD53A8702A47FB82F05FB4993B683,31561,1,6,5,109.56792,18.28479,1765
254035,2C3BD53A8702A47FB82F05FB4993B683,30854,7,16,9,109.56889,18.27076,1763
254036,2C3BD53A8702A47FB82F05FB4993B683,30851,19,20,1,109.5616,18.27396,1713
254048,866460FA5062A635337B6369BB2AADDA,30854,5,6,1,109.56889,18.27076,1763
254049,866460FA5062A635337B6369BB2AADDA,30581,9,10,1,109.62257,18.24951,1959
254050,866460FA5062A635337B6369BB2AADDA,31321,12,14,2,109.63799,18.23201,2007
254060,F6A1EBB84FE583E84185C423218578F5,31561,0,6,6,109.56792,18.28479,1765
254061,F6A1EBB84FE583E84185C423218578F5,30854,10,18,8,109.56889,18.27076,1763
254062,F6A1EBB84FE583E84185C423218578F5,31561,21,23,2,109.56792,18.28479,1765
254102,D42D82F7F77C55013F0EAB7E35E2211F,31071,14,15,1,109.58257,18.28458,1815
254103,D42D82F7F77C55013F0EAB7E35E2211F,30851,15,18,3,109.5616,18.27396,1713
254107,8DA93D1F2D8B94217DB7D46C30E61BA4,60371,1,6,5,109.53063,18.30056,1618
254108,8DA93D1F2D8B94217DB7D46C30E61BA4,38991,7,8,1,109.52681,18.30368,1618
254109,8DA93D1F2D8B94217DB7D46C30E61BA4,31931,11,16,5,109.54771,18.29403,1667
254110,8DA93D1F2D8B94217DB7D46C30E61BA4,60371,18,23,5,109.53063,18.30056,1618
254111,348BC15248D83C0CF0D2494FAD03D52E,60084,12,13,1,109.4984,18.2334,1507
254112,348BC15248D83C0CF0D2494FAD03D52E,38185,14,15,1,109.51333,18.27347,1563
254127,40C57F24FE0409ABB752B2031C349577,38951,17,20,3,109.48097,18.28868,1416
254128,40C57F24FE0409ABB752B2031C349577,38951,21,23,2,109.48097,18.28868,1416
254142,6EE4BADDDC65BCBDC03FAC1E025EC013,31421,0,6,6,109.55382,18.22347,1705
254143,6EE4BADDDC65BCBDC03FAC1E025EC013,31021,10,11,1,109.49021,18.27,1463
254144,6EE4BADDDC65BCBDC03FAC1E025EC013,31421,12,18,6,109.55382,18.22347,1705
254175,E1B4EE5B2DAE31219B37A92CAB40AC2A,30051,2,6,4,109.48917,18.21215,1453
254176,E1B4EE5B2DAE31219B37A92CAB40AC2A,60231,6,12,6,109.49903,18.21972,1504
254177,E1B4EE5B2DAE31219B37A92CAB40AC2A,31164,17,18,1,109.69993,18.27215,2263
254178,E1B4EE5B2DAE31219B37A92CAB40AC2A,31311,19,23,4,109.72299,18.27438,2364
254192,D59CA492BEF79FDC348123BFCC88F4DD,30071,1,6,5,109.52819,18.30472,1619
254193,D59CA492BEF79FDC348123BFCC88F4DD,31931,8,13,5,109.54771,18.29403,1667
254194,D59CA492BEF79FDC348123BFCC88F4DD,60241,14,15,1,109.53319,18.28667,1616
254203,4BCFB9B7DA47F954D069C9FF9050BF88,60354,0,7,7,109.58701,18.28521,1815
254204,4BCFB9B7DA47F954D069C9FF9050BF88,30854,12,13,1,109.56889,18.27076,1763
254233,B712327B6033C61F37801CFD6DAC08AD,38484,3,7,4,109.53028,18.31528,1620
254234,B712327B6033C61F37801CFD6DAC08AD,30561,7,10,3,109.52778,18.31938,1621
254235,B712327B6033C61F37801CFD6DAC08AD,38484,14,15,1,109.53028,18.31528,1620
254240,63FBAC0202144B00077561285E6A7F87,30821,1,5,4,109.43681,18.33639,1274
254241,63FBAC0202144B00077561285E6A7F87,30651,7,10,3,109.42611,18.385,1232
254242,63FBAC0202144B00077561285E6A7F87,30821,10,23,13,109.43681,18.33639,1274
254249,070984703178D21DC5287E457C03691A,31561,0,5,5,109.56792,18.28479,1765
254250,070984703178D21DC5287E457C03691A,30851,6,7,1,109.5616,18.27396,1713
254251,070984703178D21DC5287E457C03691A,31931,7,9,2,109.54771,18.29403,1667
254252,070984703178D21DC5287E457C03691A,31561,11,14,3,109.56792,18.28479,1765
254253,070984703178D21DC5287E457C03691A,39181,18,23,5,109.55153,18.28035,1715
254298,FCC7FFA36CCAFA7D306338AD42FEB181,60401,0,5,5,109.47444,18.27583,1414
254299,FCC7FFA36CCAFA7D306338AD42FEB181,60161,5,6,1,109.49174,18.26181,1461
254343,7FF3C6569A3990C03CAF6C52D3C8BC6C,60241,1,16,15,109.53319,18.28667,1616
254344,7FF3C6569A3990C03CAF6C52D3C8BC6C,30921,18,23,5,109.53903,18.29451,1667
254361,F47C4E1E39056C43B0AD32AC994AB7C0,31931,0,18,18,109.54771,18.29403,1667
254362,F47C4E1E39056C43B0AD32AC994AB7C0,60361,22,23,1,109.51938,18.29681,1567
254415,30F5D42A1A8F1CF26F5C9617FCB06C4F,31931,14,18,4,109.54771,18.29403,1667
254416,30F5D42A1A8F1CF26F5C9617FCB06C4F,31561,21,22,1,109.56792,18.28479,1765
254441,8DE0BC5B468E9CBE441685A75439C8EB,30271,0,3,3,109.49132,18.23153,1456
254442,8DE0BC5B468E9CBE441685A75439C8EB,60231,5,7,2,109.49903,18.21972,1504
254443,8DE0BC5B468E9CBE441685A75439C8EB,60161,9,11,2,109.49174,18.26181,1461
254469,EAD13A75363C2F507BC612C5DDC48D11,31071,0,7,7,109.58257,18.28458,1815
254470,EAD13A75363C2F507BC612C5DDC48D11,30854,7,9,2,109.56889,18.27076,1763
254471,EAD13A75363C2F507BC612C5DDC48D11,30731,13,15,2,109.50944,18.22306,1555
254532,A549C024E6F63EDBD3DC866F10DB11CE,31071,1,5,4,109.58257,18.28458,1815
254533,A549C024E6F63EDBD3DC866F10DB11CE,31761,7,8,1,109.60521,18.27965,1914
254534,A549C024E6F63EDBD3DC866F10DB11CE,30854,8,17,9,109.56889,18.27076,1763
254535,A549C024E6F63EDBD3DC866F10DB11CE,31071,19,21,2,109.58257,18.28458,1815
254553,0F09C2BE6A190F4BF3D635D6A9F19FD3,60661,0,8,8,109.548,18.2377,1657
254554,0F09C2BE6A190F4BF3D635D6A9F19FD3,60241,8,10,2,109.53319,18.28667,1616
254555,0F09C2BE6A190F4BF3D635D6A9F19FD3,31391,10,11,1,109.50382,18.24285,1508
254556,0F09C2BE6A190F4BF3D635D6A9F19FD3,60661,17,19,2,109.548,18.2377,1657
254557,0F09C2BE6A190F4BF3D635D6A9F19FD3,60281,20,22,2,109.51743,18.25924,1561
254611,10EBF762D28520B09848288F7052CFDE,30854,0,6,6,109.56889,18.27076,1763
254612,10EBF762D28520B09848288F7052CFDE,39101,7,18,11,109.50132,18.24931,1509
254613,10EBF762D28520B09848288F7052CFDE,31561,21,23,2,109.56792,18.28479,1765
254648,52A2A4B81F4AA52093B9BBEA3C2A529D,30351,13,15,2,109.41701,18.29292,1217
254649,52A2A4B81F4AA52093B9BBEA3C2A529D,31236,16,17,1,109.42965,18.29111,1216
254650,52A2A4B81F4AA52093B9BBEA3C2A529D,31236,19,23,4,109.42965,18.29111,1216
254669,3066D3BA0EF6F55E10FAD924A6ADDDEF,31205,0,1,1,109.51111,18.23736,1557
254670,3066D3BA0EF6F55E10FAD924A6ADDDEF,30381,3,13,10,109.52521,18.24507,1609
254671,3066D3BA0EF6F55E10FAD924A6ADDDEF,31181,14,15,1,109.50382,18.24813,1509
254697,F36C6564687A0314919430BBFB5CDF5A,31101,0,15,15,109.65389,18.23403,2057
254698,F36C6564687A0314919430BBFB5CDF5A,31031,19,22,3,109.49979,18.25382,1510
254720,08298D6D3F79F7819C6B0F651C6D5327,31521,1,10,9,109.51458,18.22542,1555
254721,08298D6D3F79F7819C6B0F651C6D5327,30731,10,13,3,109.50944,18.22306,1555
254722,08298D6D3F79F7819C6B0F651C6D5327,31521,13,14,1,109.51458,18.22542,1555
254723,08298D6D3F79F7819C6B0F651C6D5327,31521,14,16,2,109.51458,18.22542,1555
254736,16F10E4F562E88FDBE5E3B7B9CEB3BC4,31071,1,5,4,109.58257,18.28458,1815
254737,16F10E4F562E88FDBE5E3B7B9CEB3BC4,30854,6,8,2,109.56889,18.27076,1763
254738,16F10E4F562E88FDBE5E3B7B9CEB3BC4,39371,9,11,2,109.56627,18.2646,1762
254739,16F10E4F562E88FDBE5E3B7B9CEB3BC4,31071,13,21,8,109.58257,18.28458,1815
254745,1026894DC5FF9A7FAF3A2EE28B95E239,30891,0,5,5,109.59431,18.28389,1865
254746,1026894DC5FF9A7FAF3A2EE28B95E239,31071,5,6,1,109.58257,18.28458,1815
254747,1026894DC5FF9A7FAF3A2EE28B95E239,30854,10,23,13,109.56889,18.27076,1763
254754,7421066246AAD1C230E7E2A7ADF06E9D,60631,1,6,5,109.57778,18.27583,1814
254755,7421066246AAD1C230E7E2A7ADF06E9D,30854,7,16,9,109.56889,18.27076,1763
254756,7421066246AAD1C230E7E2A7ADF06E9D,31071,18,20,2,109.58257,18.28458,1815
254757,7421066246AAD1C230E7E2A7ADF06E9D,30191,21,23,2,109.50361,18.22701,1506
254769,D70D11871FB47AB4743A9AB8A25E5AA8,38241,0,5,5,109.54111,18.30542,1669
254770,D70D11871FB47AB4743A9AB8A25E5AA8,60241,6,18,12,109.53319,18.28667,1616
254771,D70D11871FB47AB4743A9AB8A25E5AA8,38241,21,23,2,109.54111,18.30542,1669
254772,417408FFDA93B177641D270D3A5C4B2D,30891,0,4,4,109.59431,18.28389,1865
254773,417408FFDA93B177641D270D3A5C4B2D,30854,6,19,13,109.56889,18.27076,1763
254774,417408FFDA93B177641D270D3A5C4B2D,31071,21,23,2,109.58257,18.28458,1815
254781,1689A3686513311C5F0C7A0EDAD5A242,31931,18,19,1,109.54771,18.29403,1667
254782,1689A3686513311C5F0C7A0EDAD5A242,60371,19,20,1,109.53063,18.30056,1618
254783,1689A3686513311C5F0C7A0EDAD5A242,30921,22,23,1,109.53903,18.29451,1667
254861,F866B6E34CEF853A6497211DD74A607E,31071,0,7,7,109.58257,18.28458,1815
254862,F866B6E34CEF853A6497211DD74A607E,30711,7,12,5,109.50271,18.25347,1510
254908,C1602FB5A20BD98313F7CC13F431D061,30731,0,1,1,109.50944,18.22306,1555
254909,C1602FB5A20BD98313F7CC13F431D061,60084,2,7,5,109.4984,18.2334,1507
254910,C1602FB5A20BD98313F7CC13F431D061,30771,7,9,2,109.49938,18.26042,1511
254911,C1602FB5A20BD98313F7CC13F431D061,30771,10,23,13,109.49938,18.26042,1511
254912,8DD23AA43C0F7967C45F7488D66F9159,30851,2,4,2,109.5616,18.27396,1713
254913,8DD23AA43C0F7967C45F7488D66F9159,31071,5,6,1,109.58257,18.28458,1815
254914,8DD23AA43C0F7967C45F7488D66F9159,30854,9,12,3,109.56889,18.27076,1763
254915,8DD23AA43C0F7967C45F7488D66F9159,31071,18,19,1,109.58257,18.28458,1815
254916,8DD23AA43C0F7967C45F7488D66F9159,30854,20,22,2,109.56889,18.27076,1763
254923,147470AD3D3B8724582C30D5F244A8B6,60421,0,17,17,109.46333,18.31743,1371
254924,147470AD3D3B8724582C30D5F244A8B6,30111,18,19,1,109.47583,18.30542,1419
254964,EBD33964FCE275C1E00E1A22DCBD8F60,31931,13,16,3,109.54771,18.29403,1667
254965,EBD33964FCE275C1E00E1A22DCBD8F60,30921,19,21,2,109.53903,18.29451,1667
254966,528F99F7FD8CA49B85B45B64A5D784BA,30851,1,5,4,109.5616,18.27396,1713
254967,528F99F7FD8CA49B85B45B64A5D784BA,31561,6,15,9,109.56792,18.28479,1765
254968,528F99F7FD8CA49B85B45B64A5D784BA,30851,18,22,4,109.5616,18.27396,1713
254990,BC2EDF4DF9C7FAD55BDEABA03DFA7284,31561,0,5,5,109.56792,18.28479,1765
254991,BC2EDF4DF9C7FAD55BDEABA03DFA7284,30854,6,7,1,109.56889,18.27076,1763
254992,BC2EDF4DF9C7FAD55BDEABA03DFA7284,31561,11,13,2,109.56792,18.28479,1765
254993,C85D0B931BEF54F05B9ABBBB03212DB7,31561,7,9,2,109.56792,18.28479,1765
254994,C85D0B931BEF54F05B9ABBBB03212DB7,30854,10,21,11,109.56889,18.27076,1763
255032,C21D2EC796F0044DE4CA162C449C4B3B,31071,0,5,5,109.58257,18.28458,1815
255033,C21D2EC796F0044DE4CA162C449C4B3B,30854,5,8,3,109.56889,18.27076,1763
255034,C21D2EC796F0044DE4CA162C449C4B3B,30221,9,11,2,109.57833,18.20222,1802
255035,C21D2EC796F0044DE4CA162C449C4B3B,30731,15,17,2,109.50944,18.22306,1555
255054,7B2AEE2086698683607EDDDB4B678234,38154,0,13,13,109.5266,18.28278,1615
255055,7B2AEE2086698683607EDDDB4B678234,60221,13,15,2,109.52569,18.29188,1616
255062,410D55EA73A3884577B7B9B7E86B067E,30084,0,7,7,109.50118,18.26972,1513
255063,410D55EA73A3884577B7B9B7E86B067E,30084,8,10,2,109.50118,18.26972,1513
255064,410D55EA73A3884577B7B9B7E86B067E,30101,13,14,1,109.57299,18.33333,1773
255071,6846D911A5FA1223889E01CD52440A91,31071,2,7,5,109.58257,18.28458,1815
255072,6846D911A5FA1223889E01CD52440A91,30854,7,20,13,109.56889,18.27076,1763
255073,6846D911A5FA1223889E01CD52440A91,30191,21,23,2,109.50361,18.22701,1506
255079,C13C99E7ADCAE70C71F0965D0D6E9496,31931,0,13,13,109.54771,18.29403,1667
255080,C13C99E7ADCAE70C71F0965D0D6E9496,30071,15,16,1,109.52819,18.30472,1619
255081,C13C99E7ADCAE70C71F0965D0D6E9496,39181,18,21,3,109.55153,18.28035,1715
255085,8207EF3B9F6D8D19623CD7D3DDB7ECE2,38325,0,1,1,109.39792,18.2909,1116
255086,8207EF3B9F6D8D19623CD7D3DDB7ECE2,38903,1,4,3,109.39229,18.29243,1117
255087,8207EF3B9F6D8D19623CD7D3DDB7ECE2,39041,5,6,1,109.40021,18.29278,1117
255088,8207EF3B9F6D8D19623CD7D3DDB7ECE2,38903,7,8,1,109.39229,18.29243,1117
255126,75817DB682187A07461734D66E1E6492,60631,0,4,4,109.57778,18.27583,1814
255127,75817DB682187A07461734D66E1E6492,30854,4,7,3,109.56889,18.27076,1763
255128,75817DB682187A07461734D66E1E6492,31561,7,9,2,109.56792,18.28479,1765
255129,75817DB682187A07461734D66E1E6492,30854,9,14,5,109.56889,18.27076,1763
255130,75817DB682187A07461734D66E1E6492,31061,19,21,2,109.53333,18.23257,1607
255137,E16204D131FCD957D5ADB9592C1DD0ED,31561,0,7,7,109.56792,18.28479,1765
255138,E16204D131FCD957D5ADB9592C1DD0ED,31071,10,14,4,109.58257,18.28458,1815
255139,E16204D131FCD957D5ADB9592C1DD0ED,30421,16,18,2,109.50021,18.25861,1511
255140,E16204D131FCD957D5ADB9592C1DD0ED,31071,22,23,1,109.58257,18.28458,1815
255181,21C679D1B9FF307EA1AC2A89744209FE,38291,0,9,9,109.51618,18.24313,1558
255182,21C679D1B9FF307EA1AC2A89744209FE,60281,13,15,2,109.51743,18.25924,1561
255183,34F3D64B41C252481F72E5CF931AC833,31071,0,6,6,109.58257,18.28458,1815
255184,34F3D64B41C252481F72E5CF931AC833,30851,7,9,2,109.5616,18.27396,1713
255185,34F3D64B41C252481F72E5CF931AC833,31071,10,11,1,109.58257,18.28458,1815
255212,A4C98A5BCABB1C0C8728FA75C4037070,31206,0,12,12,109.50819,18.23549,1507
255213,A4C98A5BCABB1C0C8728FA75C4037070,31021,14,15,1,109.49021,18.27,1463
255214,ABCD0851CC1C78BCD7AF6DBDF2F5DE49,30211,6,11,5,109.49882,18.23931,1508
255215,ABCD0851CC1C78BCD7AF6DBDF2F5DE49,60041,11,13,2,109.39889,18.31944,1121
255262,B643AC77F8D8498A9694D45BA8B0F75F,31561,4,5,1,109.56792,18.28479,1765
255263,B643AC77F8D8498A9694D45BA8B0F75F,60631,5,16,11,109.57778,18.27583,1814
255274,7252A0F90E29EC78621699C082578EF7,31361,0,6,6,109.47417,18.28292,1415
255275,7252A0F90E29EC78621699C082578EF7,60504,8,16,8,109.47917,18.28903,1416
255278,F73DB45474E9091AA79E623BDF11C321,31561,0,5,5,109.56792,18.28479,1765
255279,F73DB45474E9091AA79E623BDF11C321,30851,6,17,11,109.5616,18.27396,1713
255359,4D5F13041F22071C2B5C93BBDF1863E3,30951,13,15,2,109.56208,18.25667,1761
255360,4D5F13041F22071C2B5C93BBDF1863E3,31421,15,17,2,109.55382,18.22347,1705
255361,4D5F13041F22071C2B5C93BBDF1863E3,30854,18,19,1,109.56889,18.27076,1763
255362,4D5F13041F22071C2B5C93BBDF1863E3,60131,20,21,1,109.49819,18.24778,1509
255368,4995463B780282C9C030A19D9F49AEAC,39371,0,1,1,109.56627,18.2646,1762
255369,4995463B780282C9C030A19D9F49AEAC,31071,1,6,5,109.58257,18.28458,1815
255370,4995463B780282C9C030A19D9F49AEAC,30854,7,23,16,109.56889,18.27076,1763
255412,BD85969D888F94131C562624432FF75B,30854,5,8,3,109.56889,18.27076,1763
255413,BD85969D888F94131C562624432FF75B,30221,10,13,3,109.57833,18.20222,1802
255414,BD85969D888F94131C562624432FF75B,31071,15,23,8,109.58257,18.28458,1815
255438,B340EDEF4A878E8DF5CBEC25E465EACE,31071,0,7,7,109.58257,18.28458,1815
255439,B340EDEF4A878E8DF5CBEC25E465EACE,60631,9,10,1,109.57778,18.27583,1814
255440,B340EDEF4A878E8DF5CBEC25E465EACE,31071,11,12,1,109.58257,18.28458,1815
255441,B340EDEF4A878E8DF5CBEC25E465EACE,30854,12,13,1,109.56889,18.27076,1763
255443,B340EDEF4A878E8DF5CBEC25E465EACE,31164,19,20,1,109.69993,18.27215,2263
255469,B9E4016373F9EAECBE9B1879E1F3B739,60291,16,17,1,109.50826,18.24639,1509
255470,B9E4016373F9EAECBE9B1879E1F3B739,31431,18,19,1,109.44639,18.29042,1316
255471,B9E4016373F9EAECBE9B1879E1F3B739,31701,19,22,3,109.44132,18.28833,1266
255495,BD5AAE5CF6AC8F1E6005714E36EC9220,39101,0,2,2,109.50132,18.24931,1509
255496,BD5AAE5CF6AC8F1E6005714E36EC9220,39101,4,7,3,109.50132,18.24931,1509
255497,BD5AAE5CF6AC8F1E6005714E36EC9220,30511,7,8,1,109.51069,18.24208,1558
255498,BD5AAE5CF6AC8F1E6005714E36EC9220,60131,13,14,1,109.49819,18.24778,1509
255499,BD5AAE5CF6AC8F1E6005714E36EC9220,60221,15,19,4,109.52569,18.29188,1616
255500,BD5AAE5CF6AC8F1E6005714E36EC9220,60131,20,23,3,109.49819,18.24778,1509
255501,7334BFE245C0E1675EC3C07645407CF3,31121,1,6,5,109.16292,18.37063,230
255502,7334BFE245C0E1675EC3C07645407CF3,60054,7,16,9,109.3016,18.31229,770
255507,8C5A16299A6D294198C90C34C25C5949,30854,12,17,5,109.56889,18.27076,1763
255508,8C5A16299A6D294198C90C34C25C5949,31561,17,19,2,109.56792,18.28479,1765
255515,3B2AB4D108FF2A2838F54611E6E21C22,60401,16,17,1,109.47444,18.27583,1414
255516,3B2AB4D108FF2A2838F54611E6E21C22,38361,18,21,3,109.43667,18.29201,1267
255517,3B2AB4D108FF2A2838F54611E6E21C22,38071,21,22,1,109.40722,18.30938,1169
255518,0526FBDD03CECB7E3925506B4441EC17,30511,0,19,19,109.51069,18.24208,1558
255519,0526FBDD03CECB7E3925506B4441EC17,31443,19,23,4,109.5116,18.24438,1559
255520,CC3204A8217F846065F3857472A7A709,60524,3,8,5,109.42951,18.28993,1216
255521,CC3204A8217F846065F3857472A7A709,30854,12,16,4,109.56889,18.27076,1763
255522,CC3204A8217F846065F3857472A7A709,31561,20,23,3,109.56792,18.28479,1765
255538,292F7AA5A13D44513985CC059AB0B0E9,30854,18,19,1,109.56889,18.27076,1763
255539,292F7AA5A13D44513985CC059AB0B0E9,31071,20,23,3,109.58257,18.28458,1815
255554,7EADF8FB347FDDDBCB094AA8D0A5E8F9,33051,15,16,1,109.6475,18.46618,2096
255555,7EADF8FB347FDDDBCB094AA8D0A5E8F9,38951,20,23,3,109.48097,18.28868,1416
255569,D1EBD1A5A8A922DEF994C933F10DD8DB,30161,14,15,1,109.50042,18.24389,1508
255570,D1EBD1A5A8A922DEF994C933F10DD8DB,60131,20,23,3,109.49819,18.24778,1509
255579,7D32C75E1D43B778466C6B80F3328830,31071,13,14,1,109.58257,18.28458,1815
255580,7D32C75E1D43B778466C6B80F3328830,30854,14,18,4,109.56889,18.27076,1763
255581,CB54BD5ACB93CE60508AFE3883399EDE,31931,2,3,1,109.54771,18.29403,1667
255582,CB54BD5ACB93CE60508AFE3883399EDE,60241,7,8,1,109.53319,18.28667,1616
255600,2D39AE6120F2674000C6DBB8A6E572A0,31071,0,7,7,109.58257,18.28458,1815
255601,2D39AE6120F2674000C6DBB8A6E572A0,30854,7,19,12,109.56889,18.27076,1763
255610,770A00BDAFE9BCA8C9E9FA68066EED7D,31561,17,19,2,109.56792,18.28479,1765
255611,770A00BDAFE9BCA8C9E9FA68066EED7D,31071,20,23,3,109.58257,18.28458,1815
255629,F7FA9EDDDD22A3605AF235C1758649A3,39321,1,8,7,109.529,18.2167,1604
255630,F7FA9EDDDD22A3605AF235C1758649A3,31521,9,11,2,109.51458,18.22542,1555
255631,F7FA9EDDDD22A3605AF235C1758649A3,60401,15,16,1,109.47444,18.27583,1414
255680,FFFC0994E5C15BDB165344716912442C,39371,0,2,2,109.56627,18.2646,1762
255681,FFFC0994E5C15BDB165344716912442C,30854,3,6,3,109.56889,18.27076,1763
255682,FFFC0994E5C15BDB165344716912442C,31554,7,17,10,109.55521,18.2459,1709
255683,FFFC0994E5C15BDB165344716912442C,31551,18,20,2,109.55868,18.24222,1708
255684,FFFC0994E5C15BDB165344716912442C,39371,21,23,2,109.56627,18.2646,1762
255708,46D3900FF4CD0CE137E6DB2E5BBC5B87,30854,0,5,5,109.56889,18.27076,1763
255709,46D3900FF4CD0CE137E6DB2E5BBC5B87,31561,7,9,2,109.56792,18.28479,1765
255710,46D3900FF4CD0CE137E6DB2E5BBC5B87,30854,10,11,1,109.56889,18.27076,1763
255711,46D3900FF4CD0CE137E6DB2E5BBC5B87,31931,13,14,1,109.54771,18.29403,1667
255712,46D3900FF4CD0CE137E6DB2E5BBC5B87,39183,19,23,4,109.55542,18.28208,1715
255719,C3EF49B0098C6C3C4B26CC8869DE86AF,38271,13,15,2,109.62632,18.23049,1956
255720,C3EF49B0098C6C3C4B26CC8869DE86AF,30854,16,17,1,109.56889,18.27076,1763
255742,9FC721E86703223349C05C95FE4BBB6F,60081,2,10,8,109.51097,18.22639,1556
255743,9FC721E86703223349C05C95FE4BBB6F,31521,11,20,9,109.51458,18.22542,1555
255744,9FC721E86703223349C05C95FE4BBB6F,60087,21,23,2,109.50688,18.22299,1505
255767,A68637AA89BD62624E677D9E66C32FAD,30161,0,6,6,109.50042,18.24389,1508
255768,A68637AA89BD62624E677D9E66C32FAD,30361,6,7,1,109.50347,18.24,1508
255769,A68637AA89BD62624E677D9E66C32FAD,30161,12,16,4,109.50042,18.24389,1508
255770,A68637AA89BD62624E677D9E66C32FAD,30161,21,23,2,109.50042,18.24389,1508
255782,E8D51F8B53F290BFD73338AD2AD8C728,30851,14,15,1,109.5616,18.27396,1713
255783,E8D51F8B53F290BFD73338AD2AD8C728,31561,18,20,2,109.56792,18.28479,1765
255795,D77A5C2E97A74D805A87772560CE2BFF,39321,0,7,7,109.529,18.2167,1604
255796,D77A5C2E97A74D805A87772560CE2BFF,60381,10,12,2,109.5241,18.22458,1605
255797,D77A5C2E97A74D805A87772560CE2BFF,60661,13,14,1,109.548,18.2377,1657
255798,D77A5C2E97A74D805A87772560CE2BFF,31421,16,17,1,109.55382,18.22347,1705
255799,D77A5C2E97A74D805A87772560CE2BFF,39321,18,23,5,109.529,18.2167,1604
255808,FACA7C472055342CB52356ECCA18D789,30771,18,20,2,109.49938,18.26042,1511
255809,FACA7C472055342CB52356ECCA18D789,31461,21,23,2,109.5091,18.25389,1510
255853,16B2859E8374D62B4663118E0A8B2252,60501,11,12,1,109.48701,18.29021,1466
255855,3D39BFF619D555933510C63A4C03CAF1,60371,2,9,7,109.53063,18.30056,1618
255856,3D39BFF619D555933510C63A4C03CAF1,30281,12,15,3,109.50597,18.27583,1514
255857,3D39BFF619D555933510C63A4C03CAF1,38127,16,22,6,109.50833,18.27222,1513
255858,23AF668A3BF61DB4555AFB95018A20E1,31931,11,12,1,109.54771,18.29403,1667
255859,23AF668A3BF61DB4555AFB95018A20E1,30851,13,14,1,109.5616,18.27396,1713
255860,23AF668A3BF61DB4555AFB95018A20E1,39183,19,23,4,109.55542,18.28208,1715
255866,E4F5CE5AA4109B668FB550C6654CBB79,30854,0,4,4,109.56889,18.27076,1763
255867,E4F5CE5AA4109B668FB550C6654CBB79,30851,4,15,11,109.5616,18.27396,1713
255868,E4F5CE5AA4109B668FB550C6654CBB79,39183,20,23,3,109.55542,18.28208,1715
255915,0D3DA8126B134D203BB35373EAFFB116,31071,0,16,16,109.58257,18.28458,1815
255916,0D3DA8126B134D203BB35373EAFFB116,31071,18,23,5,109.58257,18.28458,1815
255928,D334753E33AD01D79142036B3D85543F,31931,13,15,2,109.54771,18.29403,1667
255929,D334753E33AD01D79142036B3D85543F,31561,18,20,2,109.56792,18.28479,1765
255994,FB5187175661EC895E80982358346864,31321,10,23,13,109.63799,18.23201,2007
255997,AD64464DD39A90A4C30F70259EC094DF,30071,1,4,3,109.52819,18.30472,1619
255998,AD64464DD39A90A4C30F70259EC094DF,31931,5,15,10,109.54771,18.29403,1667
255999,AD64464DD39A90A4C30F70259EC094DF,30071,16,17,1,109.52819,18.30472,1619
256000,AD64464DD39A90A4C30F70259EC094DF,39181,20,23,3,109.55153,18.28035,1715
256005,B5CEF203D0E1B618DE0B5B0BA08CFDD8,60354,1,3,2,109.58701,18.28521,1815
256006,B5CEF203D0E1B618DE0B5B0BA08CFDD8,31071,4,6,2,109.58257,18.28458,1815
256007,B5CEF203D0E1B618DE0B5B0BA08CFDD8,30854,7,9,2,109.56889,18.27076,1763
256008,B5CEF203D0E1B618DE0B5B0BA08CFDD8,30731,12,16,4,109.50944,18.22306,1555
256013,201045A9C980BD8E53B16B9129DFE596,30854,13,17,4,109.56889,18.27076,1763
256014,201045A9C980BD8E53B16B9129DFE596,31071,17,23,6,109.58257,18.28458,1815
256015,84DF4A7C208235D171EF56473BCCF210,30851,0,3,3,109.5616,18.27396,1713
256016,84DF4A7C208235D171EF56473BCCF210,31561,4,7,3,109.56792,18.28479,1765
256017,84DF4A7C208235D171EF56473BCCF210,60631,8,16,8,109.57778,18.27583,1814
256022,015CDEB9169BCE5537ABAE49B6A63F2B,31071,1,5,4,109.58257,18.28458,1815
256023,015CDEB9169BCE5537ABAE49B6A63F2B,30854,8,21,13,109.56889,18.27076,1763
256028,A94F66C88B84FF0658441320CD9F667C,60631,1,2,1,109.57778,18.27583,1814
256029,A94F66C88B84FF0658441320CD9F667C,31071,2,7,5,109.58257,18.28458,1815
256030,A94F66C88B84FF0658441320CD9F667C,30854,8,15,7,109.56889,18.27076,1763
256031,E4D199FCE009427481C9D06B9609AB1E,60671,1,6,5,109.52979,18.31757,1621
256032,E4D199FCE009427481C9D06B9609AB1E,31931,6,7,1,109.54771,18.29403,1667
256033,E4D199FCE009427481C9D06B9609AB1E,60671,8,10,2,109.52979,18.31757,1621
256034,E4D199FCE009427481C9D06B9609AB1E,31931,11,17,6,109.54771,18.29403,1667
256035,E4D199FCE009427481C9D06B9609AB1E,39181,20,21,1,109.55153,18.28035,1715
256048,C316CE65034FB3C77BE459147CBF943A,31171,0,8,8,109.50938,18.24917,1559
256049,C316CE65034FB3C77BE459147CBF943A,30161,8,17,9,109.50042,18.24389,1508
256050,C316CE65034FB3C77BE459147CBF943A,30161,17,18,1,109.50042,18.24389,1508
256051,C316CE65034FB3C77BE459147CBF943A,60291,20,22,2,109.50826,18.24639,1509
256065,833001CDF394BB3F6E4F040C2A70AC27,31071,1,16,15,109.58257,18.28458,1815
256066,833001CDF394BB3F6E4F040C2A70AC27,30854,16,18,2,109.56889,18.27076,1763
256069,D6A345956751BA2ACC5430EDF68A104F,60671,0,5,5,109.52979,18.31757,1621
256070,D6A345956751BA2ACC5430EDF68A104F,31931,6,15,9,109.54771,18.29403,1667
256071,D6A345956751BA2ACC5430EDF68A104F,39181,19,23,4,109.55153,18.28035,1715
256076,F6B0C4B9BFBC5C0F5D704098C64B8B01,31864,11,12,1,109.49014,18.28333,1465
256077,F6B0C4B9BFBC5C0F5D704098C64B8B01,30201,14,15,1,109.4909,18.26465,1462
256078,504005D0B9E64BA26E5EEC5B5E6B3A0C,31931,0,9,9,109.54771,18.29403,1667
256079,504005D0B9E64BA26E5EEC5B5E6B3A0C,30071,9,11,2,109.52819,18.30472,1619
256080,504005D0B9E64BA26E5EEC5B5E6B3A0C,31931,12,23,11,109.54771,18.29403,1667
256088,C5536869E807B602F99387523BE0105F,38291,0,7,7,109.51618,18.24313,1558
256089,C5536869E807B602F99387523BE0105F,39191,7,12,5,109.51493,18.23472,1557
256090,C5536869E807B602F99387523BE0105F,31181,14,15,1,109.50382,18.24813,1509
256109,8C0E6B51FAFE21C31FB9AE08C36DF0A2,30371,14,15,1,109.51,18.24771,1559
256110,8C0E6B51FAFE21C31FB9AE08C36DF0A2,30921,19,23,4,109.53903,18.29451,1667
256122,934029FB5F97BCE114EDCE88F0393A63,39371,0,7,7,109.56627,18.2646,1762
256123,934029FB5F97BCE114EDCE88F0393A63,30854,9,22,13,109.56889,18.27076,1763
256131,96F98526707B06BE1263CCD4F72E07A1,31071,0,7,7,109.58257,18.28458,1815
256132,96F98526707B06BE1263CCD4F72E07A1,31071,11,13,2,109.58257,18.28458,1815
256133,96F98526707B06BE1263CCD4F72E07A1,60354,15,19,4,109.58701,18.28521,1815
256161,AA17C9279A63248D7DCDF49F93EB8817,30854,0,5,5,109.56889,18.27076,1763
256162,AA17C9279A63248D7DCDF49F93EB8817,38275,9,17,8,109.62875,18.22938,2006
256191,B93185B4820D7E0DEE74EBEA00941D15,30371,0,9,9,109.51,18.24771,1559
256192,B93185B4820D7E0DEE74EBEA00941D15,30911,10,11,1,109.50493,18.26181,1511
256193,B93185B4820D7E0DEE74EBEA00941D15,60201,11,13,2,109.5041,18.2509,1510
256194,B93185B4820D7E0DEE74EBEA00941D15,30911,13,15,2,109.50493,18.26181,1511
256195,B93185B4820D7E0DEE74EBEA00941D15,60201,18,20,2,109.5041,18.2509,1510
256207,455A82AACA188D6F7BC0FB53DB8E23C1,31161,18,23,5,109.70229,18.31361,2270
256222,6146A81FA42903D7E835D6037ED21C81,30181,0,18,18,109.51597,18.23313,1557
256223,6146A81FA42903D7E835D6037ED21C81,31521,19,20,1,109.51458,18.22542,1555
256224,6146A81FA42903D7E835D6037ED21C81,30181,21,23,2,109.51597,18.23313,1557
256306,7B9D64657CE26DF907B4C2AC87C9F431,31931,1,4,3,109.54771,18.29403,1667
256307,7B9D64657CE26DF907B4C2AC87C9F431,38241,7,15,8,109.54111,18.30542,1669
256325,DBB710D279E76C79F1E4B0766F579F8A,30441,0,1,1,109.64021,18.25424,2010
256326,DBB710D279E76C79F1E4B0766F579F8A,60211,2,4,2,109.63549,18.26049,2011
256327,DBB710D279E76C79F1E4B0766F579F8A,31071,6,7,1,109.58257,18.28458,1815
256328,DBB710D279E76C79F1E4B0766F579F8A,30854,11,12,1,109.56889,18.27076,1763
256368,2FE0F3A82C27452F04A6B927F514EFA7,31551,0,8,8,109.55868,18.24222,1708
256369,2FE0F3A82C27452F04A6B927F514EFA7,31554,9,11,2,109.55521,18.2459,1709
256371,2FE0F3A82C27452F04A6B927F514EFA7,31841,21,22,1,109.73201,18.33382,2373
256402,1A64C98E678C33D33EBB9AF4943063A2,31071,1,2,1,109.58257,18.28458,1815
256403,1A64C98E678C33D33EBB9AF4943063A2,39371,5,6,1,109.56627,18.2646,1762
256412,EF24901D99384F703B20FE07F2784FA0,30101,0,11,11,109.57299,18.33333,1773
256413,EF24901D99384F703B20FE07F2784FA0,31631,12,13,1,109.59542,18.36826,1879
256414,EF24901D99384F703B20FE07F2784FA0,30101,14,23,9,109.57299,18.33333,1773
256450,020753EF78F0A0C39658113A3377EA1E,31561,0,6,6,109.56792,18.28479,1765
256451,020753EF78F0A0C39658113A3377EA1E,31931,7,15,8,109.54771,18.29403,1667
256461,1122041491C04B199A15F6E1E401D68F,31261,15,18,3,109.51174,18.2466,1559
256462,1122041491C04B199A15F6E1E401D68F,30461,21,23,2,109.5116,18.26313,1562
256491,76F6A54588C8DF7DDADFC50CAA11D44C,31071,2,11,9,109.58257,18.28458,1815
256492,76F6A54588C8DF7DDADFC50CAA11D44C,38085,16,22,6,109.6291,18.23625,2007
256516,63F3396E81ABDC9FBFF9C1CFE997FF69,48574,9,17,8,109.48931,18.28458,1465
256517,63F3396E81ABDC9FBFF9C1CFE997FF69,31041,19,20,1,109.50278,18.23701,1507
256520,5056B3DD1B49217356D6750375F238B9,38325,0,8,8,109.39792,18.2909,1116
256553,1DC4D3E6415CD2F16BAC0F0FD6BEA638,60371,0,7,7,109.53063,18.30056,1618
256554,1DC4D3E6415CD2F16BAC0F0FD6BEA638,31461,8,13,5,109.5091,18.25389,1510
256555,1DC4D3E6415CD2F16BAC0F0FD6BEA638,38751,13,15,2,109.74903,18.37639,2481
256567,4E8D795F40D47DACACC3FDDF22027131,31931,16,17,1,109.54771,18.29403,1667
256568,4E8D795F40D47DACACC3FDDF22027131,31041,21,22,1,109.50278,18.23701,1507
256574,1980C8D409DE9551539224B3D393CDAA,30071,6,8,2,109.52819,18.30472,1619
256575,1980C8D409DE9551539224B3D393CDAA,31951,8,10,2,109.52174,18.30299,1568
256576,1980C8D409DE9551539224B3D393CDAA,30071,10,16,6,109.52819,18.30472,1619
256597,D9AE11CD16B231308C3F0FB3F53BC3E9,30854,0,8,8,109.56889,18.27076,1763
256598,D9AE11CD16B231308C3F0FB3F53BC3E9,31071,13,14,1,109.58257,18.28458,1815
256599,D9AE11CD16B231308C3F0FB3F53BC3E9,30854,17,20,3,109.56889,18.27076,1763
256607,CE9457D3E3C1E3CCC08B3BEEFAB57B0C,30391,0,8,8,109.4975,18.27118,1513
256616,5C3AF23B43D26582C5A8FB4D1CB9A5DB,60281,19,21,2,109.51743,18.25924,1561
256617,5C3AF23B43D26582C5A8FB4D1CB9A5DB,38105,21,23,2,109.40299,18.29229,1117
256627,8848858055E44B41A644E297337DB5B6,39111,1,7,6,109.5191,18.22597,1555
256628,8848858055E44B41A644E297337DB5B6,38111,12,15,3,109.52007,18.22403,1555
256629,8848858055E44B41A644E297337DB5B6,31521,16,17,1,109.51458,18.22542,1555
256630,8848858055E44B41A644E297337DB5B6,30361,18,20,2,109.50347,18.24,1508
256634,8B9A9BFD1ACAD480EB101A91DBF2024D,38291,1,17,16,109.51618,18.24313,1558
256635,8B9A9BFD1ACAD480EB101A91DBF2024D,30371,18,19,1,109.51,18.24771,1559
256636,8B9A9BFD1ACAD480EB101A91DBF2024D,38291,20,23,3,109.51618,18.24313,1558
256657,71F956FFA2F92F0EAA3851BFD1FB3491,31701,19,21,2,109.44132,18.28833,1266
256658,71F956FFA2F92F0EAA3851BFD1FB3491,38162,21,22,1,109.43944,18.28889,1266
256735,189633BA4D39EBA8A203BC9E364D4B1F,60231,13,17,4,109.49903,18.21972,1504
256736,189633BA4D39EBA8A203BC9E364D4B1F,30151,21,23,2,109.50986,18.25083,1560
256789,9A0B6BA153A1BEC43BEEC25807F83E36,60671,5,7,2,109.52979,18.31757,1621
256790,9A0B6BA153A1BEC43BEEC25807F83E36,31931,12,18,6,109.54771,18.29403,1667
256791,9A0B6BA153A1BEC43BEEC25807F83E36,39181,19,23,4,109.55153,18.28035,1715
256809,F1114751990E9EE36CDB7660EAA9CD6F,31071,0,4,4,109.58257,18.28458,1815
256810,F1114751990E9EE36CDB7660EAA9CD6F,30854,4,5,1,109.56889,18.27076,1763
256811,F1114751990E9EE36CDB7660EAA9CD6F,31071,6,7,1,109.58257,18.28458,1815
256812,F1114751990E9EE36CDB7660EAA9CD6F,30854,7,15,8,109.56889,18.27076,1763
256813,ACAB8C7B92298FFCEC0006246A6D65D6,30854,1,5,4,109.56889,18.27076,1763
256814,ACAB8C7B92298FFCEC0006246A6D65D6,30851,8,11,3,109.5616,18.27396,1713
256815,ACAB8C7B92298FFCEC0006246A6D65D6,30854,13,14,1,109.56889,18.27076,1763
256816,ACAB8C7B92298FFCEC0006246A6D65D6,39183,19,23,4,109.55542,18.28208,1715
256829,6422CB87ACC55DDEF6EBE8946593C808,60231,12,17,5,109.49903,18.21972,1504
256830,6422CB87ACC55DDEF6EBE8946593C808,31351,19,23,4,109.4959,18.28417,1465
256851,A60AFDDB15A742DA3A715B1BA7F8BDC8,60081,0,6,6,109.51097,18.22639,1556
256852,A60AFDDB15A742DA3A715B1BA7F8BDC8,30181,7,8,1,109.51597,18.23313,1557
256853,A60AFDDB15A742DA3A715B1BA7F8BDC8,30661,10,13,3,109.37028,18.24361,1008
256854,A60AFDDB15A742DA3A715B1BA7F8BDC8,30421,18,20,2,109.50021,18.25861,1511
256855,A60AFDDB15A742DA3A715B1BA7F8BDC8,31031,21,22,1,109.49979,18.25382,1510
256864,9AA959ED87D1ECC3053DED17290EFCBD,30854,0,4,4,109.56889,18.27076,1763
256865,9AA959ED87D1ECC3053DED17290EFCBD,31561,6,17,11,109.56792,18.28479,1765
256866,9AA959ED87D1ECC3053DED17290EFCBD,30854,17,18,1,109.56889,18.27076,1763
256867,9AA959ED87D1ECC3053DED17290EFCBD,31561,21,23,2,109.56792,18.28479,1765
256882,9EBFE19AEC38C3A6F47AE2D903294BAE,31071,0,6,6,109.58257,18.28458,1815
256883,9EBFE19AEC38C3A6F47AE2D903294BAE,30854,6,12,6,109.56889,18.27076,1763
256903,D292C6B85C9FA2C551E460BECA0F6A0D,31321,3,12,9,109.63799,18.23201,2007
256904,D292C6B85C9FA2C551E460BECA0F6A0D,30441,13,14,1,109.64021,18.25424,2010
256905,D292C6B85C9FA2C551E460BECA0F6A0D,31321,14,17,3,109.63799,18.23201,2007
256932,5B5FB16F9BE2A1826D497C2695908410,31561,2,3,1,109.56792,18.28479,1765
256933,5B5FB16F9BE2A1826D497C2695908410,31071,6,7,1,109.58257,18.28458,1815
256934,5B5FB16F9BE2A1826D497C2695908410,30854,7,8,1,109.56889,18.27076,1763
256935,5B5FB16F9BE2A1826D497C2695908410,31561,12,14,2,109.56792,18.28479,1765
256949,40285EE8CCE25C38988EC087545664EC,31071,3,7,4,109.58257,18.28458,1815
256950,40285EE8CCE25C38988EC087545664EC,30854,10,11,1,109.56889,18.27076,1763
256951,40285EE8CCE25C38988EC087545664EC,31071,14,16,2,109.58257,18.28458,1815
256952,40285EE8CCE25C38988EC087545664EC,30854,18,19,1,109.56889,18.27076,1763
256981,03E3094FE0344513E64DAE470C33E920,31931,1,2,1,109.54771,18.29403,1667
256982,03E3094FE0344513E64DAE470C33E920,60671,4,6,2,109.52979,18.31757,1621
256983,03E3094FE0344513E64DAE470C33E920,31931,7,15,8,109.54771,18.29403,1667
256984,03E3094FE0344513E64DAE470C33E920,39181,20,23,3,109.55153,18.28035,1715
256991,69F4307E378774E8E49F5A5A6F5C64A6,60241,0,15,15,109.53319,18.28667,1616
256992,69F4307E378774E8E49F5A5A6F5C64A6,30921,19,22,3,109.53903,18.29451,1667
257022,BAEF9F862D9A902CDB4B10017EC20830,60241,0,7,7,109.53319,18.28667,1616
257023,BAEF9F862D9A902CDB4B10017EC20830,31931,7,18,11,109.54771,18.29403,1667
257024,BAEF9F862D9A902CDB4B10017EC20830,48631,19,21,2,109.52903,18.31743,1621
257025,BAEF9F862D9A902CDB4B10017EC20830,60241,22,23,1,109.53319,18.28667,1616
257038,9E8746086915F9D4A063A74CF0B5B7AB,39183,19,20,1,109.55542,18.28208,1715
257039,9E8746086915F9D4A063A74CF0B5B7AB,31561,21,23,2,109.56792,18.28479,1765
257127,6FD88D74D66E8FAB66A93CB5D0609C41,30854,11,15,4,109.56889,18.27076,1763
257128,6FD88D74D66E8FAB66A93CB5D0609C41,39371,18,21,3,109.56627,18.2646,1762
257154,52D077B19C6C1BD347E6DC20309A3DC3,31561,0,4,4,109.56792,18.28479,1765
257155,52D077B19C6C1BD347E6DC20309A3DC3,30854,5,9,4,109.56889,18.27076,1763
257156,52D077B19C6C1BD347E6DC20309A3DC3,31071,12,23,11,109.58257,18.28458,1815
257159,166E7C87007490CCD3244B1CD8B43BF4,30854,0,2,2,109.56889,18.27076,1763
257160,166E7C87007490CCD3244B1CD8B43BF4,31071,3,5,2,109.58257,18.28458,1815
257161,166E7C87007490CCD3244B1CD8B43BF4,30854,5,9,4,109.56889,18.27076,1763
257162,166E7C87007490CCD3244B1CD8B43BF4,31071,11,13,2,109.58257,18.28458,1815
257163,166E7C87007490CCD3244B1CD8B43BF4,31071,13,15,2,109.58257,18.28458,1815
257164,166E7C87007490CCD3244B1CD8B43BF4,60354,16,17,1,109.58701,18.28521,1815
257165,166E7C87007490CCD3244B1CD8B43BF4,31071,22,23,1,109.58257,18.28458,1815
257175,8FFDB178B42E132A09286D0A8A4D99CA,31521,0,8,8,109.51458,18.22542,1555
257177,8FFDB178B42E132A09286D0A8A4D99CA,31521,16,18,2,109.51458,18.22542,1555
257178,8FFDB178B42E132A09286D0A8A4D99CA,31521,19,20,1,109.51458,18.22542,1555
257179,8FFDB178B42E132A09286D0A8A4D99CA,31521,21,23,2,109.51458,18.22542,1555
257188,71301D5A92E929B402E9BF477ED34700,30854,4,8,4,109.56889,18.27076,1763
257189,71301D5A92E929B402E9BF477ED34700,30731,9,16,7,109.50944,18.22306,1555
257192,81946AFE1D298F3B40176C804AE3EF84,31951,0,3,3,109.52174,18.30299,1568
257193,81946AFE1D298F3B40176C804AE3EF84,31931,6,14,8,109.54771,18.29403,1667
257194,81946AFE1D298F3B40176C804AE3EF84,60241,15,17,2,109.53319,18.28667,1616
257195,81946AFE1D298F3B40176C804AE3EF84,31951,19,22,3,109.52174,18.30299,1568
257217,31A35D1F4FE97CCC4436EF0B61B8BAAF,60411,1,3,2,109.32514,18.30854,869
257218,31A35D1F4FE97CCC4436EF0B61B8BAAF,30511,4,7,3,109.51069,18.24208,1558
257219,31A35D1F4FE97CCC4436EF0B61B8BAAF,30711,7,12,5,109.50271,18.25347,1510
257220,31A35D1F4FE97CCC4436EF0B61B8BAAF,30511,15,17,2,109.51069,18.24208,1558
257221,31A35D1F4FE97CCC4436EF0B61B8BAAF,31031,18,23,5,109.49979,18.25382,1510
257235,2AE38FAF341950B0B91404FFCE5A0F3E,31931,4,6,2,109.54771,18.29403,1667
257236,2AE38FAF341950B0B91404FFCE5A0F3E,60241,9,15,6,109.53319,18.28667,1616
257240,39F25FE146A03325C93C111F2A943B6C,31071,1,15,14,109.58257,18.28458,1815
257241,39F25FE146A03325C93C111F2A943B6C,30854,17,18,1,109.56889,18.27076,1763
257242,39F25FE146A03325C93C111F2A943B6C,31945,22,23,1,109.58021,18.29403,1817
257243,58418A9EA4A7DC03127CB79C039A5185,60354,0,10,10,109.58701,18.28521,1815
257244,58418A9EA4A7DC03127CB79C039A5185,30854,12,14,2,109.56889,18.27076,1763
257245,58418A9EA4A7DC03127CB79C039A5185,30421,19,21,2,109.50021,18.25861,1511
257246,58418A9EA4A7DC03127CB79C039A5185,30771,22,23,1,109.49938,18.26042,1511
257249,F3ADE38A6219C04719D8BAB38E16EC80,31701,18,22,4,109.44132,18.28833,1266
257298,B34415F599F0ED7D1A073EE314A60B9B,31671,0,6,6,109.38965,18.29813,1068
257299,B34415F599F0ED7D1A073EE314A60B9B,60041,6,8,2,109.39889,18.31944,1121
257300,B34415F599F0ED7D1A073EE314A60B9B,31671,8,18,10,109.38965,18.29813,1068
257343,10E6DCB22C04D9E1B01193CDA87B3193,30721,0,7,7,109.51597,18.28257,1565
257344,10E6DCB22C04D9E1B01193CDA87B3193,31931,7,8,1,109.54771,18.29403,1667
257345,10E6DCB22C04D9E1B01193CDA87B3193,30854,9,10,1,109.56889,18.27076,1763
257363,FDEFD8CE6000F3540C5597EAB2B625A9,30391,0,9,9,109.4975,18.27118,1513
257372,F25C237DB3948CAE74585CD60FBB2501,30854,10,11,1,109.56889,18.27076,1763
257373,F25C237DB3948CAE74585CD60FBB2501,31561,15,16,1,109.56792,18.28479,1765
257374,F25C237DB3948CAE74585CD60FBB2501,39183,19,23,4,109.55542,18.28208,1715
257405,C6579823835B85A254880E72927E82BB,31531,11,13,2,109.49583,18.25972,1461
257406,C6579823835B85A254880E72927E82BB,39371,15,18,3,109.56627,18.2646,1762
257407,C6579823835B85A254880E72927E82BB,60381,20,22,2,109.5241,18.22458,1605
257436,2C7DB696A14A5E061C2912E5376233C9,31071,0,5,5,109.58257,18.28458,1815
257437,2C7DB696A14A5E061C2912E5376233C9,30854,5,9,4,109.56889,18.27076,1763
257438,2C7DB696A14A5E061C2912E5376233C9,31071,11,12,1,109.58257,18.28458,1815
257439,2C7DB696A14A5E061C2912E5376233C9,31071,12,16,4,109.58257,18.28458,1815
257440,2C7DB696A14A5E061C2912E5376233C9,39371,16,23,7,109.56627,18.2646,1762
257457,03CEC0FDDD5484124514C6D24A63D4DD,31561,0,13,13,109.56792,18.28479,1765
257458,03CEC0FDDD5484124514C6D24A63D4DD,30854,15,17,2,109.56889,18.27076,1763
257459,03CEC0FDDD5484124514C6D24A63D4DD,31561,22,23,1,109.56792,18.28479,1765
257478,994DC93B9722A2091C776CECB337EA56,30181,15,16,1,109.51597,18.23313,1557
257479,994DC93B9722A2091C776CECB337EA56,31421,17,23,6,109.55382,18.22347,1705
257547,14F1CC63CDA098F9694EAC8584B9C7A5,31561,5,7,2,109.56792,18.28479,1765
257548,14F1CC63CDA098F9694EAC8584B9C7A5,30854,7,21,14,109.56889,18.27076,1763
257564,1BC010F6BA936B1BC6461BB11F6A6D07,31261,0,7,7,109.51174,18.2466,1559
257565,1BC010F6BA936B1BC6461BB11F6A6D07,38185,7,12,5,109.51333,18.27347,1563
257566,1BC010F6BA936B1BC6461BB11F6A6D07,31261,13,15,2,109.51174,18.2466,1559
257596,59BBE0E26F333D0DEE0C9B342559408B,30071,0,7,7,109.52819,18.30472,1619
257597,59BBE0E26F333D0DEE0C9B342559408B,30371,8,10,2,109.51,18.24771,1559
257598,59BBE0E26F333D0DEE0C9B342559408B,31471,15,16,1,109.34583,18.29563,917
257599,59BBE0E26F333D0DEE0C9B342559408B,38484,21,23,2,109.53028,18.31528,1620
257600,5C90AB97E54FA5E1554549C9409AC61B,30851,9,16,7,109.5616,18.27396,1713
257601,5C90AB97E54FA5E1554549C9409AC61B,39183,18,23,5,109.55542,18.28208,1715
257613,1D8B814EC83D52D7C5F3FED99C129EE0,30854,0,19,19,109.56889,18.27076,1763
257614,1D8B814EC83D52D7C5F3FED99C129EE0,31071,22,23,1,109.58257,18.28458,1815
257648,80D5971B84EF3A2477C3F057B855AF63,31071,0,7,7,109.58257,18.28458,1815
257649,80D5971B84EF3A2477C3F057B855AF63,30854,8,10,2,109.56889,18.27076,1763
257650,80D5971B84EF3A2477C3F057B855AF63,31071,11,15,4,109.58257,18.28458,1815
257657,A3F1517845C5D84C612625B9AE2F7500,30854,0,2,2,109.56889,18.27076,1763
257658,A3F1517845C5D84C612625B9AE2F7500,31071,3,7,4,109.58257,18.28458,1815
257659,A3F1517845C5D84C612625B9AE2F7500,30854,7,9,2,109.56889,18.27076,1763
257660,A3F1517845C5D84C612625B9AE2F7500,31071,14,15,1,109.58257,18.28458,1815
257761,F8D799D9161B0143E0D71C40472A357E,30071,0,19,19,109.52819,18.30472,1619
257762,F8D799D9161B0143E0D71C40472A357E,31951,19,21,2,109.52174,18.30299,1568
257763,F8D799D9161B0143E0D71C40472A357E,30071,21,23,2,109.52819,18.30472,1619
257775,4027759DA4AA4E8EAD8331A27147F405,30854,7,8,1,109.56889,18.27076,1763
257776,4027759DA4AA4E8EAD8331A27147F405,30731,12,13,1,109.50944,18.22306,1555
257779,E7DB0F55EDE33BB4C08C98B80B7173BF,60371,0,6,6,109.53063,18.30056,1618
257780,E7DB0F55EDE33BB4C08C98B80B7173BF,31811,7,8,1,109.54201,18.31806,1671
257781,E7DB0F55EDE33BB4C08C98B80B7173BF,31071,11,13,2,109.58257,18.28458,1815
257782,E7DB0F55EDE33BB4C08C98B80B7173BF,30711,14,15,1,109.50271,18.25347,1510
257783,E7DB0F55EDE33BB4C08C98B80B7173BF,60371,20,23,3,109.53063,18.30056,1618
257787,7BF65E5054DA81A230AB5423620158E1,60631,0,5,5,109.57778,18.27583,1814
257788,7BF65E5054DA81A230AB5423620158E1,30854,7,10,3,109.56889,18.27076,1763
257789,7BF65E5054DA81A230AB5423620158E1,31071,11,12,1,109.58257,18.28458,1815
257792,565E7A3B20C63D384DB57315C3ED30CC,30371,0,2,2,109.51,18.24771,1559
257793,565E7A3B20C63D384DB57315C3ED30CC,30371,2,9,7,109.51,18.24771,1559
257794,565E7A3B20C63D384DB57315C3ED30CC,38971,11,13,2,109.50743,18.25125,1510
257795,565E7A3B20C63D384DB57315C3ED30CC,31811,18,19,1,109.54201,18.31806,1671
257796,565E7A3B20C63D384DB57315C3ED30CC,60571,19,21,2,109.50722,18.25056,1510
257797,565E7A3B20C63D384DB57315C3ED30CC,30151,21,23,2,109.50986,18.25083,1560
257814,FF374776E6D44861C88B04D75BCDE244,30181,0,14,14,109.51597,18.23313,1557
257815,FF374776E6D44861C88B04D75BCDE244,31201,14,19,5,109.51042,18.23819,1558
257816,FF374776E6D44861C88B04D75BCDE244,31206,19,23,4,109.50819,18.23549,1507
257823,9352766CE000C006A9C46226806783DB,31561,0,1,1,109.56792,18.28479,1765
257824,9352766CE000C006A9C46226806783DB,31071,2,7,5,109.58257,18.28458,1815
257825,9352766CE000C006A9C46226806783DB,60541,10,23,13,109.4084,18.29208,1167
257841,D9E60CECBCF3335BA62A418C133E83E2,39321,0,3,3,109.529,18.2167,1604
257842,D9E60CECBCF3335BA62A418C133E83E2,38117,3,7,4,109.51611,18.22354,1555
257843,D9E60CECBCF3335BA62A418C133E83E2,30731,8,14,6,109.50944,18.22306,1555
257844,D9E60CECBCF3335BA62A418C133E83E2,60381,14,16,2,109.5241,18.22458,1605
257845,D9E60CECBCF3335BA62A418C133E83E2,30731,18,19,1,109.50944,18.22306,1555
257875,E2E58CCB11EC6D0A9D6583CCE0AE87DB,31931,12,13,1,109.54771,18.29403,1667
257876,E2E58CCB11EC6D0A9D6583CCE0AE87DB,30071,18,23,5,109.52819,18.30472,1619
257891,D330F554F47597493CAFD08520A037E1,30854,5,9,4,109.56889,18.27076,1763
257892,D330F554F47597493CAFD08520A037E1,31101,10,23,13,109.65389,18.23403,2057
257899,D11413926A77900569DEBC57CAD49AB3,60131,0,6,6,109.49819,18.24778,1509
257900,D11413926A77900569DEBC57CAD49AB3,31411,6,9,3,109.5016,18.23576,1507
257901,D11413926A77900569DEBC57CAD49AB3,31781,12,14,2,109.19847,18.2975,367
257921,6C0260646767B781577B5B8CE2471E51,38484,8,11,3,109.53028,18.31528,1620
257922,6C0260646767B781577B5B8CE2471E51,38484,14,17,3,109.53028,18.31528,1620
257944,8F6EA1C108FADA76A214A7ED71ECE3D1,30891,0,4,4,109.59431,18.28389,1865
257945,8F6EA1C108FADA76A214A7ED71ECE3D1,30854,6,12,6,109.56889,18.27076,1763
257954,C1C69C0EAD4ABEFD1467543102429D9B,30854,0,6,6,109.56889,18.27076,1763
257955,C1C69C0EAD4ABEFD1467543102429D9B,31561,11,12,1,109.56792,18.28479,1765
257956,C1C69C0EAD4ABEFD1467543102429D9B,30854,15,16,1,109.56889,18.27076,1763
257957,63B5E489F3503F8EC6E40A38F9D2117C,60241,3,4,1,109.53319,18.28667,1616
257958,63B5E489F3503F8EC6E40A38F9D2117C,60361,9,10,1,109.51938,18.29681,1567
257959,63B5E489F3503F8EC6E40A38F9D2117C,60171,10,13,3,109.51292,18.30694,1569
257980,EF7DCA5602FCDF14AF156D676A8ED902,31561,4,8,4,109.56792,18.28479,1765
257981,EF7DCA5602FCDF14AF156D676A8ED902,30854,11,13,2,109.56889,18.27076,1763
257982,EF7DCA5602FCDF14AF156D676A8ED902,31561,14,20,6,109.56792,18.28479,1765
257999,CFFDD1BF3134B9FDD71614F40E1DE0FD,31561,0,3,3,109.56792,18.28479,1765
258000,CFFDD1BF3134B9FDD71614F40E1DE0FD,31071,4,7,3,109.58257,18.28458,1815
258001,CFFDD1BF3134B9FDD71614F40E1DE0FD,30851,7,8,1,109.5616,18.27396,1713
258002,CFFDD1BF3134B9FDD71614F40E1DE0FD,31071,10,12,2,109.58257,18.28458,1815
258036,A4D782DD7C0CB1B25E56BFC209FED42C,60241,0,10,10,109.53319,18.28667,1616
258037,A4D782DD7C0CB1B25E56BFC209FED42C,31931,11,13,2,109.54771,18.29403,1667
258038,A4D782DD7C0CB1B25E56BFC209FED42C,60241,13,16,3,109.53319,18.28667,1616
258039,FE95B3A32EFBC2838F293DF38F55FDD1,31561,16,18,2,109.56792,18.28479,1765
258040,FE95B3A32EFBC2838F293DF38F55FDD1,39183,19,23,4,109.55542,18.28208,1715
258041,7B832C4EEA998F0828995CEC1FF24330,30854,0,9,9,109.56889,18.27076,1763
258042,7B832C4EEA998F0828995CEC1FF24330,39091,10,11,1,109.50097,18.25222,1510
258043,7B832C4EEA998F0828995CEC1FF24330,60631,15,16,1,109.57778,18.27583,1814
258044,7B832C4EEA998F0828995CEC1FF24330,30854,19,21,2,109.56889,18.27076,1763
258059,6129539226098723AEE329F9D345089D,31071,0,4,4,109.58257,18.28458,1815
258060,6129539226098723AEE329F9D345089D,30854,4,6,2,109.56889,18.27076,1763
258061,6129539226098723AEE329F9D345089D,30681,8,10,2,109.48493,18.26917,1463
258062,6129539226098723AEE329F9D345089D,31071,15,16,1,109.58257,18.28458,1815
258063,6129539226098723AEE329F9D345089D,30854,16,17,1,109.56889,18.27076,1763
258064,6129539226098723AEE329F9D345089D,31945,22,23,1,109.58021,18.29403,1817
258099,30CE72A519D49881F23B8123486E3A02,60411,0,6,6,109.32514,18.30854,869
258100,30CE72A519D49881F23B8123486E3A02,31471,10,12,2,109.34583,18.29563,917
258101,30CE72A519D49881F23B8123486E3A02,60411,14,16,2,109.32514,18.30854,869
258124,9A1D1AA5EE2CD156CC396C667ED8C5B9,31071,14,16,2,109.58257,18.28458,1815
258125,9A1D1AA5EE2CD156CC396C667ED8C5B9,30854,20,22,2,109.56889,18.27076,1763
258126,610275798AB59486D52727134DFD1B86,31206,0,9,9,109.50819,18.23549,1507
258127,610275798AB59486D52727134DFD1B86,30191,12,13,1,109.50361,18.22701,1506
258128,610275798AB59486D52727134DFD1B86,60081,15,16,1,109.51097,18.22639,1556
258133,408C4FED868686E7B96333835F4C4205,60631,0,2,2,109.57778,18.27583,1814
258134,408C4FED868686E7B96333835F4C4205,30854,2,3,1,109.56889,18.27076,1763
258135,408C4FED868686E7B96333835F4C4205,60631,4,6,2,109.57778,18.27583,1814
258158,43A422D32148E3FF9BC0EC7D857AA8BB,60214,0,8,8,109.63104,18.24493,2009
258159,43A422D32148E3FF9BC0EC7D857AA8BB,31521,12,15,3,109.51458,18.22542,1555
258160,43A422D32148E3FF9BC0EC7D857AA8BB,31521,15,17,2,109.51458,18.22542,1555
258161,43A422D32148E3FF9BC0EC7D857AA8BB,31521,18,23,5,109.51458,18.22542,1555
258229,9B979E9430BCD0DDB6C78BBE525EBD2D,60631,1,3,2,109.57778,18.27583,1814
258230,9B979E9430BCD0DDB6C78BBE525EBD2D,30854,7,22,15,109.56889,18.27076,1763
258257,C91F430AC30B55A21F7C58F74A11754B,31421,12,13,1,109.55382,18.22347,1705
258258,C91F430AC30B55A21F7C58F74A11754B,30731,13,15,2,109.50944,18.22306,1555
258286,C1F100A79C441D3FFDBAE922D32DC8D2,30854,0,22,22,109.56889,18.27076,1763
258287,C1F100A79C441D3FFDBAE922D32DC8D2,31945,22,23,1,109.58021,18.29403,1817
258359,4D4289AE0DFBF4B5C79A47559DC2EBDD,30854,0,11,11,109.56889,18.27076,1763
258360,4D4289AE0DFBF4B5C79A47559DC2EBDD,31071,13,14,1,109.58257,18.28458,1815
258363,68DBE0B52FD0AB95F1DD47068FD7847F,31521,0,3,3,109.51458,18.22542,1555
258364,68DBE0B52FD0AB95F1DD47068FD7847F,30181,3,15,12,109.51597,18.23313,1557
258365,68DBE0B52FD0AB95F1DD47068FD7847F,31521,20,21,1,109.51458,18.22542,1555
258366,68DBE0B52FD0AB95F1DD47068FD7847F,30181,21,23,2,109.51597,18.23313,1557
258388,86141D8542832B6339FFC177369DDE6C,38094,1,10,9,109.45403,18.28778,1316
258389,86141D8542832B6339FFC177369DDE6C,60054,12,14,2,109.3016,18.31229,770
258390,86141D8542832B6339FFC177369DDE6C,31391,18,21,3,109.50382,18.24285,1508
258442,7F377D9BD4A6752A92F213BA9B3E59E5,30281,0,9,9,109.50597,18.27583,1514
258443,7F377D9BD4A6752A92F213BA9B3E59E5,30421,11,22,11,109.50021,18.25861,1511
258444,CBEC85B23D166297F931D8AA26FC2B44,31231,1,4,3,109.42597,18.29292,1217
258445,CBEC85B23D166297F931D8AA26FC2B44,30351,4,6,2,109.41701,18.29292,1217
258463,522E8CB42AF22D75F3E9D0FD1FDCEEA6,30854,0,1,1,109.56889,18.27076,1763
258464,522E8CB42AF22D75F3E9D0FD1FDCEEA6,39371,4,7,3,109.56627,18.2646,1762
258465,522E8CB42AF22D75F3E9D0FD1FDCEEA6,30854,8,9,1,109.56889,18.27076,1763
258466,522E8CB42AF22D75F3E9D0FD1FDCEEA6,31071,9,11,2,109.58257,18.28458,1815
258467,522E8CB42AF22D75F3E9D0FD1FDCEEA6,30854,11,13,2,109.56889,18.27076,1763
258468,522E8CB42AF22D75F3E9D0FD1FDCEEA6,31071,17,19,2,109.58257,18.28458,1815
258469,522E8CB42AF22D75F3E9D0FD1FDCEEA6,30854,19,22,3,109.56889,18.27076,1763
258475,772A9B492969611EE6751A5B3AA967DA,39321,0,5,5,109.529,18.2167,1604
258476,772A9B492969611EE6751A5B3AA967DA,31521,5,7,2,109.51458,18.22542,1555
258477,772A9B492969611EE6751A5B3AA967DA,33051,11,14,3,109.6475,18.46618,2096
258478,772A9B492969611EE6751A5B3AA967DA,31521,19,22,3,109.51458,18.22542,1555
258496,066CC6CBB5ADF978A93AF5D0C3292806,31931,14,15,1,109.54771,18.29403,1667
258497,066CC6CBB5ADF978A93AF5D0C3292806,60581,18,20,2,109.59785,18.29931,1868
258498,B2EAF2370DACE0D2E981BAA0267B94BE,39183,0,8,8,109.55542,18.28208,1715
258503,F104684B0D453E1772CF3FC2E8F8DFBE,60231,17,18,1,109.49903,18.21972,1504
258504,F104684B0D453E1772CF3FC2E8F8DFBE,60161,19,20,1,109.49174,18.26181,1461
258505,F104684B0D453E1772CF3FC2E8F8DFBE,39151,21,22,1,109.49875,18.25097,1510
258543,2CF83F5125C6075E2ACA9C17C2979C64,31071,0,9,9,109.58257,18.28458,1815
258544,2CF83F5125C6075E2ACA9C17C2979C64,30854,12,18,6,109.56889,18.27076,1763
258572,46D10B971C10D2856504DC61068F66E7,31821,0,10,10,109.51181,18.24924,1559
258581,3C8AF8540BA6F9080D5A38C029FF5CF0,30661,11,12,1,109.37028,18.24361,1008
258582,3C8AF8540BA6F9080D5A38C029FF5CF0,31471,12,16,4,109.34583,18.29563,917
258583,3C8AF8540BA6F9080D5A38C029FF5CF0,60081,20,21,1,109.51097,18.22639,1556
258590,926FBA523DAEDABC03774AE3ED899479,30511,15,17,2,109.51069,18.24208,1558
258591,926FBA523DAEDABC03774AE3ED899479,38316,19,20,1,109.48542,18.27424,1464
258592,926FBA523DAEDABC03774AE3ED899479,38127,22,23,1,109.50833,18.27222,1513
258604,14DD9E5DCCEFE8BE7425556E4E04FC9A,31071,4,5,1,109.58257,18.28458,1815
258605,14DD9E5DCCEFE8BE7425556E4E04FC9A,31071,9,11,2,109.58257,18.28458,1815
258606,14DD9E5DCCEFE8BE7425556E4E04FC9A,39371,12,14,2,109.56627,18.2646,1762
258607,14DD9E5DCCEFE8BE7425556E4E04FC9A,31071,14,15,1,109.58257,18.28458,1815
258608,7C68E1F4B8B2F3CBBD5427BF66BF9C2E,30891,3,5,2,109.59431,18.28389,1865
258609,7C68E1F4B8B2F3CBBD5427BF66BF9C2E,31571,9,10,1,109.61563,18.23326,1957
258610,7C68E1F4B8B2F3CBBD5427BF66BF9C2E,31471,13,15,2,109.34583,18.29563,917
258619,9264B3ED3A6BDC081378DA6F2A7F2371,30921,17,18,1,109.53903,18.29451,1667
258620,9264B3ED3A6BDC081378DA6F2A7F2371,31071,18,19,1,109.58257,18.28458,1815
258621,9264B3ED3A6BDC081378DA6F2A7F2371,31931,21,23,2,109.54771,18.29403,1667
258671,7F6E66BC10419161F6457A6D79258EDB,60401,8,9,1,109.47444,18.27583,1414
258672,7F6E66BC10419161F6457A6D79258EDB,38094,10,11,1,109.45403,18.28778,1316
258673,7F6E66BC10419161F6457A6D79258EDB,31431,14,16,2,109.44639,18.29042,1316
258674,29F0AB18AE2C2E1FE6E9AA7900F465E3,38013,0,1,1,109.49514,18.21951,1454
258675,29F0AB18AE2C2E1FE6E9AA7900F465E3,30051,4,5,1,109.48917,18.21215,1453
258676,29F0AB18AE2C2E1FE6E9AA7900F465E3,38013,6,8,2,109.49514,18.21951,1454
258684,080247CC19405F981D4BEFE1A1E9D339,31931,0,1,1,109.54771,18.29403,1667
258685,080247CC19405F981D4BEFE1A1E9D339,39181,1,14,13,109.55153,18.28035,1715
258686,080247CC19405F981D4BEFE1A1E9D339,31931,18,20,2,109.54771,18.29403,1667
258690,1E2DBE5C967C66E080BAF11FED240B2A,39071,11,15,4,109.19917,18.29472,367
258691,1E2DBE5C967C66E080BAF11FED240B2A,30711,16,19,3,109.50271,18.25347,1510
258760,65AD296DD65C9EEA3C22EA02904A768E,30854,9,18,9,109.56889,18.27076,1763
258761,65AD296DD65C9EEA3C22EA02904A768E,31561,20,22,2,109.56792,18.28479,1765
258785,45FA8AF959A216E06C82392E21728E7F,31561,0,10,10,109.56792,18.28479,1765
258786,45FA8AF959A216E06C82392E21728E7F,31071,13,17,4,109.58257,18.28458,1815
258796,B172E1B17A92EA23226EC822FB6F7B82,30181,1,7,6,109.51597,18.23313,1557
258797,B172E1B17A92EA23226EC822FB6F7B82,30181,9,12,3,109.51597,18.23313,1557
258798,B172E1B17A92EA23226EC822FB6F7B82,60131,12,14,2,109.49819,18.24778,1509
258799,B172E1B17A92EA23226EC822FB6F7B82,30281,15,17,2,109.50597,18.27583,1514
258800,B172E1B17A92EA23226EC822FB6F7B82,31021,19,21,2,109.49021,18.27,1463
258801,B172E1B17A92EA23226EC822FB6F7B82,30181,22,23,1,109.51597,18.23313,1557
258802,E962057A533C6B0B9B10FCC6C7E429E6,30181,0,16,16,109.51597,18.23313,1557
258803,E962057A533C6B0B9B10FCC6C7E429E6,38251,17,21,4,109.49618,18.25493,1510
258804,E962057A533C6B0B9B10FCC6C7E429E6,30181,22,23,1,109.51597,18.23313,1557
258829,1906A29FB327E3B92177040E39162827,30854,14,16,2,109.56889,18.27076,1763
258830,1906A29FB327E3B92177040E39162827,31071,20,21,1,109.58257,18.28458,1815
258849,5C0000CB27D689AADC6B456D8ACCA631,31321,13,14,1,109.63799,18.23201,2007
258850,5C0000CB27D689AADC6B456D8ACCA631,38201,15,19,4,109.63729,18.23194,2006
258851,5C0000CB27D689AADC6B456D8ACCA631,30711,21,22,1,109.50271,18.25347,1510
258944,56B310842D84169C664B7D5E5FA918BC,60661,7,10,3,109.548,18.2377,1657
258945,56B310842D84169C664B7D5E5FA918BC,31551,10,12,2,109.55868,18.24222,1708
258946,56B310842D84169C664B7D5E5FA918BC,38111,18,19,1,109.52007,18.22403,1555
258947,56B310842D84169C664B7D5E5FA918BC,31551,19,23,4,109.55868,18.24222,1708
258956,92D84094136F2FB8B7D41AECD69A79AD,31201,0,8,8,109.51042,18.23819,1558
258957,92D84094136F2FB8B7D41AECD69A79AD,30711,10,11,1,109.50271,18.25347,1510
258958,92D84094136F2FB8B7D41AECD69A79AD,31201,11,12,1,109.51042,18.23819,1558
258987,C17F2EF1DEA79C8C951E3013EE071B2C,31071,0,6,6,109.58257,18.28458,1815
258988,C17F2EF1DEA79C8C951E3013EE071B2C,60631,7,8,1,109.57778,18.27583,1814
258989,C17F2EF1DEA79C8C951E3013EE071B2C,30854,10,11,1,109.56889,18.27076,1763
258990,CCD868165AA895E9C13DD53FF32CC3A8,38241,0,2,2,109.54111,18.30542,1669
258991,CCD868165AA895E9C13DD53FF32CC3A8,60671,3,7,4,109.52979,18.31757,1621
258992,CCD868165AA895E9C13DD53FF32CC3A8,30561,9,11,2,109.52778,18.31938,1621
258993,CCD868165AA895E9C13DD53FF32CC3A8,38241,12,13,1,109.54111,18.30542,1669
258994,CCD868165AA895E9C13DD53FF32CC3A8,30561,18,21,3,109.52778,18.31938,1621
258995,CCD868165AA895E9C13DD53FF32CC3A8,38241,21,23,2,109.54111,18.30542,1669
259009,106CA3A9375076B84A466DFC7E9F4CF9,30081,0,6,6,109.50243,18.26632,1512
259010,106CA3A9375076B84A466DFC7E9F4CF9,38336,7,9,2,109.61111,18.21806,1904
259011,106CA3A9375076B84A466DFC7E9F4CF9,30581,9,11,2,109.62257,18.24951,1959
259012,106CA3A9375076B84A466DFC7E9F4CF9,38336,12,15,3,109.61111,18.21806,1904
259033,3E64B806539E880054DA9285CD72C502,39321,0,5,5,109.529,18.2167,1604
259034,3E64B806539E880054DA9285CD72C502,31521,5,7,2,109.51458,18.22542,1555
259035,3E64B806539E880054DA9285CD72C502,31521,8,9,1,109.51458,18.22542,1555
259036,3E64B806539E880054DA9285CD72C502,31521,14,17,3,109.51458,18.22542,1555
259037,3E64B806539E880054DA9285CD72C502,31521,18,21,3,109.51458,18.22542,1555
259038,3A145BF69DF902E1EF820C356086EF54,30731,6,8,2,109.50944,18.22306,1555
259039,3A145BF69DF902E1EF820C356086EF54,30854,12,15,3,109.56889,18.27076,1763
259040,A950B25B10B5260D4693DCD3A4C6281C,31931,0,6,6,109.54771,18.29403,1667
259041,A950B25B10B5260D4693DCD3A4C6281C,39181,8,10,2,109.55153,18.28035,1715
259042,A950B25B10B5260D4693DCD3A4C6281C,31931,10,23,13,109.54771,18.29403,1667
259056,74CF56553C56FC34941FD45214B7C747,31761,3,4,1,109.60521,18.27965,1914
259057,74CF56553C56FC34941FD45214B7C747,31071,4,16,12,109.58257,18.28458,1815
259058,74CF56553C56FC34941FD45214B7C747,30854,19,20,1,109.56889,18.27076,1763
259062,8D3B10FD4DBC46DB93DA60040668F697,30854,0,6,6,109.56889,18.27076,1763
259063,8D3B10FD4DBC46DB93DA60040668F697,39183,7,9,2,109.55542,18.28208,1715
259064,8D3B10FD4DBC46DB93DA60040668F697,30854,11,13,2,109.56889,18.27076,1763
259065,8D3B10FD4DBC46DB93DA60040668F697,30071,15,16,1,109.52819,18.30472,1619
259066,8D3B10FD4DBC46DB93DA60040668F697,30854,18,23,5,109.56889,18.27076,1763
259072,DE841C2C767041F00D7DAF75FFC633F6,31561,0,1,1,109.56792,18.28479,1765
259073,DE841C2C767041F00D7DAF75FFC633F6,30421,3,22,19,109.50021,18.25861,1511
259074,DE841C2C767041F00D7DAF75FFC633F6,31561,22,23,1,109.56792,18.28479,1765
259111,E43761FEBE209371C105554567258124,31321,0,6,6,109.63799,18.23201,2007
259112,E43761FEBE209371C105554567258124,31931,7,8,1,109.54771,18.29403,1667
259113,E43761FEBE209371C105554567258124,60241,8,10,2,109.53319,18.28667,1616
259114,E43761FEBE209371C105554567258124,31931,10,15,5,109.54771,18.29403,1667
259115,1E1181D91A7FDEE2449092386CA6A77C,60041,0,5,5,109.39889,18.31944,1121
259116,1E1181D91A7FDEE2449092386CA6A77C,60552,7,9,2,109.41729,18.30014,1218
259117,1E1181D91A7FDEE2449092386CA6A77C,60041,12,14,2,109.39889,18.31944,1121
259118,A7003B7BCC0077E98CD8FD4D16862BCA,30721,19,20,1,109.51597,18.28257,1565
259119,A7003B7BCC0077E98CD8FD4D16862BCA,30201,20,22,2,109.4909,18.26465,1462
259132,981FF39DB0050476FC5E5BA7D49F90F5,31951,0,7,7,109.52174,18.30299,1568
259134,3E0CC1F431A959DE24ABB41EC7702F6D,60524,2,9,7,109.42951,18.28993,1216
259135,3E0CC1F431A959DE24ABB41EC7702F6D,30351,10,12,2,109.41701,18.29292,1217
259136,3E0CC1F431A959DE24ABB41EC7702F6D,60524,13,14,1,109.42951,18.28993,1216
259137,3E0CC1F431A959DE24ABB41EC7702F6D,30351,17,18,1,109.41701,18.29292,1217
259174,22B987DE38F8C4435934FE5E6190C4A2,30854,4,6,2,109.56889,18.27076,1763
259175,22B987DE38F8C4435934FE5E6190C4A2,30581,8,18,10,109.62257,18.24951,1959
259176,22B987DE38F8C4435934FE5E6190C4A2,30854,20,22,2,109.56889,18.27076,1763
259177,EE3BF893B663DDE86AC1FCAF91C64AC6,60371,0,8,8,109.53063,18.30056,1618
259178,EE3BF893B663DDE86AC1FCAF91C64AC6,30921,9,10,1,109.53903,18.29451,1667
259179,EE3BF893B663DDE86AC1FCAF91C64AC6,31931,12,14,2,109.54771,18.29403,1667
259183,BE7763F8096EB5A037146E1CC4190538,30854,1,3,2,109.56889,18.27076,1763
259184,BE7763F8096EB5A037146E1CC4190538,39181,8,11,3,109.55153,18.28035,1715
259185,BE7763F8096EB5A037146E1CC4190538,31561,15,16,1,109.56792,18.28479,1765
259186,BE7763F8096EB5A037146E1CC4190538,39183,17,20,3,109.55542,18.28208,1715
259213,332A868849E47177376F9755C981E1C1,60441,2,4,2,109.46792,18.28604,1366
259214,332A868849E47177376F9755C981E1C1,60391,4,6,2,109.47667,18.28757,1416
259215,332A868849E47177376F9755C981E1C1,60441,7,8,1,109.46792,18.28604,1366
259216,332A868849E47177376F9755C981E1C1,60391,9,10,1,109.47667,18.28757,1416
259217,332A868849E47177376F9755C981E1C1,60441,10,14,4,109.46792,18.28604,1366
259246,4D190727D19452A2A511EC780EEEE090,31271,1,2,1,109.48958,18.26257,1462
259247,4D190727D19452A2A511EC780EEEE090,60274,3,4,1,109.514,18.2933,1567
259248,4D190727D19452A2A511EC780EEEE090,30921,6,13,7,109.53903,18.29451,1667
259276,2191B2AD5C915B8862D4C345F0A13CFB,31071,0,1,1,109.58257,18.28458,1815
259277,2191B2AD5C915B8862D4C345F0A13CFB,60354,2,3,1,109.58701,18.28521,1815
259278,2191B2AD5C915B8862D4C345F0A13CFB,31071,4,7,3,109.58257,18.28458,1815
259279,2191B2AD5C915B8862D4C345F0A13CFB,30851,8,11,3,109.5616,18.27396,1713
259296,BBB180103068E98D503C4D3D2B6186F0,30451,13,19,6,109.1791,18.36229,278
259297,BBB180103068E98D503C4D3D2B6186F0,30711,21,22,1,109.50271,18.25347,1510
259317,EB316856896788EC8FD871E122E95728,31811,15,16,1,109.54201,18.31806,1671
259318,EB316856896788EC8FD871E122E95728,30701,17,18,1,109.59313,18.32007,1871
259319,EB316856896788EC8FD871E122E95728,31811,19,22,3,109.54201,18.31806,1671
259320,EB316856896788EC8FD871E122E95728,30701,22,23,1,109.59313,18.32007,1871
259337,878FC5EBB1B28FAABA6E6BFD01664318,30251,0,17,17,109.50611,18.26653,1512
259338,878FC5EBB1B28FAABA6E6BFD01664318,30711,17,18,1,109.50271,18.25347,1510
259361,CD3BCBAB8571FB81953C842A434E5DB8,31071,0,5,5,109.58257,18.28458,1815
259362,CD3BCBAB8571FB81953C842A434E5DB8,30854,6,9,3,109.56889,18.27076,1763
259363,CD3BCBAB8571FB81953C842A434E5DB8,31071,12,21,9,109.58257,18.28458,1815
259398,8FEEC16C9D6ED01472328535C36E8269,38141,0,9,9,109.39479,18.2916,1116
259401,8FEEC16C9D6ED01472328535C36E8269,38141,18,23,5,109.39479,18.2916,1116
259402,384EBE8B0466F623B706DB371094FC98,31471,15,16,1,109.34583,18.29563,917
259403,384EBE8B0466F623B706DB371094FC98,31471,18,23,5,109.34583,18.29563,917
259414,62CBF94D737D513D371567F698917827,31561,4,9,5,109.56792,18.28479,1765
259415,62CBF94D737D513D371567F698917827,30854,11,15,4,109.56889,18.27076,1763
259416,58DE8A719D3ADBEDAE163213845B460A,31071,0,14,14,109.58257,18.28458,1815
259417,58DE8A719D3ADBEDAE163213845B460A,30854,16,18,2,109.56889,18.27076,1763
259418,58DE8A719D3ADBEDAE163213845B460A,31071,21,23,2,109.58257,18.28458,1815
259442,3C6B416FA80A7A03E14FC0317D60CB00,30854,6,13,7,109.56889,18.27076,1763
259443,3C6B416FA80A7A03E14FC0317D60CB00,31101,15,16,1,109.65389,18.23403,2057
259444,3C6B416FA80A7A03E14FC0317D60CB00,31164,18,19,1,109.69993,18.27215,2263
259445,3C6B416FA80A7A03E14FC0317D60CB00,39371,22,23,1,109.56627,18.2646,1762
259446,F8D81869027CCFD6139762C81772F076,39321,14,19,5,109.529,18.2167,1604
259447,F8D81869027CCFD6139762C81772F076,31271,21,23,2,109.48958,18.26257,1462
259451,9B43F93397D8AD2193F77AAD4D6186E5,30721,0,9,9,109.51597,18.28257,1565
259453,9B43F93397D8AD2193F77AAD4D6186E5,30721,17,23,6,109.51597,18.28257,1565
259458,019EB913544B8855829875D27D9C85B6,60131,17,18,1,109.49819,18.24778,1509
259459,019EB913544B8855829875D27D9C85B6,30071,21,23,2,109.52819,18.30472,1619
259467,5E4A74B5A77D08CB1929834DB6645E3F,30431,12,13,1,109.16931,18.37486,280
259468,5E4A74B5A77D08CB1929834DB6645E3F,31121,14,16,2,109.16292,18.37063,230
259469,5E4A74B5A77D08CB1929834DB6645E3F,30771,18,20,2,109.49938,18.26042,1511
259470,5E4A74B5A77D08CB1929834DB6645E3F,60201,21,23,2,109.5041,18.2509,1510
259481,A2D2E4451F37992A08A5A50B06EE68ED,31181,1,6,5,109.50382,18.24813,1509
259482,A2D2E4451F37992A08A5A50B06EE68ED,30711,7,9,2,109.50271,18.25347,1510
259483,A2D2E4451F37992A08A5A50B06EE68ED,30431,10,12,2,109.16931,18.37486,280
259484,A2D2E4451F37992A08A5A50B06EE68ED,31181,14,15,1,109.50382,18.24813,1509
259510,AE6DC7ACB81DB5F351E45AC25E5F5A3B,31206,0,1,1,109.50819,18.23549,1507
259511,AE6DC7ACB81DB5F351E45AC25E5F5A3B,38297,3,15,12,109.52576,18.24965,1609
259512,AE6DC7ACB81DB5F351E45AC25E5F5A3B,31181,17,18,1,109.50382,18.24813,1509
259513,AE6DC7ACB81DB5F351E45AC25E5F5A3B,38297,18,20,2,109.52576,18.24965,1609
259514,AE6DC7ACB81DB5F351E45AC25E5F5A3B,60281,21,23,2,109.51743,18.25924,1561
259523,2F440A235E684ECEDD042B3100A4AE95,31071,0,7,7,109.58257,18.28458,1815
259524,2F440A235E684ECEDD042B3100A4AE95,30854,10,19,9,109.56889,18.27076,1763
259525,2F440A235E684ECEDD042B3100A4AE95,60331,21,23,2,109.505,18.26507,1512
259536,ACDEAAF45B65DE48CF80A48DBD3C775E,31071,14,15,1,109.58257,18.28458,1815
259537,ACDEAAF45B65DE48CF80A48DBD3C775E,30854,16,22,6,109.56889,18.27076,1763
259549,5EBEA276FCB4A19AC5C987F5C7CC8908,60401,11,13,2,109.47444,18.27583,1414
259550,5EBEA276FCB4A19AC5C987F5C7CC8908,60621,15,16,1,109.48354,18.27451,1464
259551,3B6FF1F8D896A0A62DC7E65967011999,39183,0,8,8,109.55542,18.28208,1715
259552,3B6FF1F8D896A0A62DC7E65967011999,30854,11,13,2,109.56889,18.27076,1763
259553,3B6FF1F8D896A0A62DC7E65967011999,39183,14,16,2,109.55542,18.28208,1715
259554,3B6FF1F8D896A0A62DC7E65967011999,31561,20,21,1,109.56792,18.28479,1765
259579,7B1A07C39637E996C01DF0A3D287D3C6,30854,0,2,2,109.56889,18.27076,1763
259580,7B1A07C39637E996C01DF0A3D287D3C6,39371,3,5,2,109.56627,18.2646,1762
259581,7B1A07C39637E996C01DF0A3D287D3C6,31071,6,10,4,109.58257,18.28458,1815
259582,7B1A07C39637E996C01DF0A3D287D3C6,39371,11,12,1,109.56627,18.2646,1762
259583,7B1A07C39637E996C01DF0A3D287D3C6,30854,13,17,4,109.56889,18.27076,1763
259584,7B1A07C39637E996C01DF0A3D287D3C6,39371,18,20,2,109.56627,18.2646,1762
259592,F945D1EC910CAA5B207559CC99738BE6,60354,0,9,9,109.58701,18.28521,1815
259593,F945D1EC910CAA5B207559CC99738BE6,31561,12,14,2,109.56792,18.28479,1765
259594,F945D1EC910CAA5B207559CC99738BE6,30361,18,23,5,109.50347,18.24,1508
259603,DB4DF566D4757FF3BB488F82DE126248,31561,13,15,2,109.56792,18.28479,1765
259604,DB4DF566D4757FF3BB488F82DE126248,30851,17,18,1,109.5616,18.27396,1713
259605,DB4DF566D4757FF3BB488F82DE126248,31561,22,23,1,109.56792,18.28479,1765
259616,FBC323A047041F71D8997C22FDE88F17,38153,0,9,9,109.51819,18.25736,1561
259617,FBC323A047041F71D8997C22FDE88F17,30151,13,14,1,109.50986,18.25083,1560
259720,7DE63B500AAA8596FED98730536D4512,30351,0,11,11,109.41701,18.29292,1217
259721,7DE63B500AAA8596FED98730536D4512,31561,12,13,1,109.56792,18.28479,1765
259722,7DE63B500AAA8596FED98730536D4512,38071,15,16,1,109.40722,18.30938,1169
259815,6B806948BC9187A91D033B4096721B00,30854,0,1,1,109.56889,18.27076,1763
259816,6B806948BC9187A91D033B4096721B00,31561,5,7,2,109.56792,18.28479,1765
259817,6B806948BC9187A91D033B4096721B00,31071,11,17,6,109.58257,18.28458,1815
259818,6B806948BC9187A91D033B4096721B00,31561,21,22,1,109.56792,18.28479,1765
259821,F621296F333E8058687ACD884B135C6E,30504,3,8,5,109.705,18.35368,2277
259822,F621296F333E8058687ACD884B135C6E,31031,9,11,2,109.49979,18.25382,1510
259823,F621296F333E8058687ACD884B135C6E,31841,11,14,3,109.73201,18.33382,2373
259824,F621296F333E8058687ACD884B135C6E,31351,15,21,6,109.4959,18.28417,1465
259825,39ED38B7840BCFA7D4C7F932FCDCF5D8,30361,12,13,1,109.50347,18.24,1508
259826,39ED38B7840BCFA7D4C7F932FCDCF5D8,31031,15,16,1,109.49979,18.25382,1510
259827,39ED38B7840BCFA7D4C7F932FCDCF5D8,60161,19,21,2,109.49174,18.26181,1461
259828,39ED38B7840BCFA7D4C7F932FCDCF5D8,60201,21,22,1,109.5041,18.2509,1510
259829,5ACB2494699EB2F10AA3427B417842C4,38251,14,16,2,109.49618,18.25493,1510
259866,C608AF81E00885FA602816017BA139C9,39183,12,16,4,109.55542,18.28208,1715
259867,C608AF81E00885FA602816017BA139C9,30854,17,23,6,109.56889,18.27076,1763
259878,D38EA5391364D89D3829E3A8AAB18EB4,39301,0,7,7,109.48361,18.21153,1453
259879,D38EA5391364D89D3829E3A8AAB18EB4,31781,10,12,2,109.19847,18.2975,367
259880,D38EA5391364D89D3829E3A8AAB18EB4,30351,17,18,1,109.41701,18.29292,1217
259898,E292D83051830D054E89D209EEABA4B9,31561,3,19,16,109.56792,18.28479,1765
259899,E292D83051830D054E89D209EEABA4B9,30161,21,22,1,109.50042,18.24389,1508
259900,149F44702DEC8C73589BE6524F0A1FFD,30854,2,8,6,109.56889,18.27076,1763
259901,149F44702DEC8C73589BE6524F0A1FFD,60631,9,12,3,109.57778,18.27583,1814
259902,149F44702DEC8C73589BE6524F0A1FFD,30854,12,13,1,109.56889,18.27076,1763
259903,3D65D225F4333E0EF5D32AA289735091,30511,0,17,17,109.51069,18.24208,1558
259904,3D65D225F4333E0EF5D32AA289735091,30361,18,19,1,109.50347,18.24,1508
259905,3D65D225F4333E0EF5D32AA289735091,30511,20,23,3,109.51069,18.24208,1558
259949,EF0AF6DFF11E792E87881ED5E6F91398,30854,12,14,2,109.56889,18.27076,1763
259950,EF0AF6DFF11E792E87881ED5E6F91398,31561,16,17,1,109.56792,18.28479,1765
259980,DCF02478AC5ACC5C3190CEB09210F280,31351,19,23,4,109.4959,18.28417,1465
260010,EFDE35289FEC1E13D6F34EFEE66A8AD2,60631,1,14,13,109.57778,18.27583,1814
260011,EFDE35289FEC1E13D6F34EFEE66A8AD2,30854,15,22,7,109.56889,18.27076,1763
260026,BE74D5A2C373F8231889AF03B59762B2,30232,15,18,3,109.6191,18.31701,1971
260027,BE74D5A2C373F8231889AF03B59762B2,60301,19,23,4,109.60715,18.30993,1919
260030,DA10676C4DA702E02A2C3FFFAC40ABA2,39183,3,5,2,109.55542,18.28208,1715
260031,DA10676C4DA702E02A2C3FFFAC40ABA2,31561,6,21,15,109.56792,18.28479,1765
260036,5205655EC583F6392BC68C8BB9865108,31071,0,2,2,109.58257,18.28458,1815
260037,5205655EC583F6392BC68C8BB9865108,30854,4,21,17,109.56889,18.27076,1763
260064,B7E330D15F4B46614A332696B5F7027D,31931,0,20,20,109.54771,18.29403,1667
260065,B7E330D15F4B46614A332696B5F7027D,31561,20,21,1,109.56792,18.28479,1765
260066,B7E330D15F4B46614A332696B5F7027D,31931,22,23,1,109.54771,18.29403,1667
260140,537CA9C3FED012868AB5E4DF92AD232C,38127,14,15,1,109.50833,18.27222,1513
260141,537CA9C3FED012868AB5E4DF92AD232C,30861,16,17,1,109.52722,18.22743,1606
260142,537CA9C3FED012868AB5E4DF92AD232C,31351,18,20,2,109.4959,18.28417,1465
260143,537CA9C3FED012868AB5E4DF92AD232C,30861,21,23,2,109.52722,18.22743,1606
260169,C709D01469E0800AF998DFAF42105CDC,31561,10,17,7,109.56792,18.28479,1765
260170,C709D01469E0800AF998DFAF42105CDC,30854,21,23,2,109.56889,18.27076,1763
260178,451E2BF48CD7B253EB0892324E679BCC,38297,0,5,5,109.52576,18.24965,1609
260179,451E2BF48CD7B253EB0892324E679BCC,60281,6,18,12,109.51743,18.25924,1561
260180,451E2BF48CD7B253EB0892324E679BCC,38297,18,22,4,109.52576,18.24965,1609
260214,8883DF5E66B5FC284A8EF97DE8EAAAB3,30854,8,13,5,109.56889,18.27076,1763
260215,8883DF5E66B5FC284A8EF97DE8EAAAB3,60631,13,23,10,109.57778,18.27583,1814
260266,0E5593A90D661690BE3DAAA17AD936E2,38127,0,4,4,109.50833,18.27222,1513
260267,0E5593A90D661690BE3DAAA17AD936E2,60504,7,8,1,109.47917,18.28903,1416
260268,0E5593A90D661690BE3DAAA17AD936E2,38127,12,14,2,109.50833,18.27222,1513
260275,DDE77D3A656666992FC3458B84010D43,39183,0,13,13,109.55542,18.28208,1715
260276,DDE77D3A656666992FC3458B84010D43,31561,14,20,6,109.56792,18.28479,1765
260277,DDE77D3A656666992FC3458B84010D43,39183,20,21,1,109.55542,18.28208,1715
260278,40667E55EDAC334B8D18CEA71CBD34F4,30111,1,3,2,109.47583,18.30542,1419
260279,40667E55EDAC334B8D18CEA71CBD34F4,31081,3,5,2,109.44639,18.30181,1318
260280,40667E55EDAC334B8D18CEA71CBD34F4,60504,6,7,1,109.47917,18.28903,1416
260281,40667E55EDAC334B8D18CEA71CBD34F4,31081,11,12,1,109.44639,18.30181,1318
260297,C5190185E6A850F6CC88937542E0EA31,39371,0,6,6,109.56627,18.2646,1762
260298,C5190185E6A850F6CC88937542E0EA31,30854,9,18,9,109.56889,18.27076,1763
260299,C5190185E6A850F6CC88937542E0EA31,38071,21,22,1,109.40722,18.30938,1169
260305,529A14F498129B0238F7B12A9FC7F6F7,60381,0,2,2,109.5241,18.22458,1605
260306,529A14F498129B0238F7B12A9FC7F6F7,31671,3,9,6,109.38965,18.29813,1068
260307,529A14F498129B0238F7B12A9FC7F6F7,30341,10,11,1,109.3625,18.29167,966
260308,529A14F498129B0238F7B12A9FC7F6F7,31671,15,20,5,109.38965,18.29813,1068
260314,5E8FF49D1CCDA711846608608C7FAE0D,30854,17,21,4,109.56889,18.27076,1763
260315,5E8FF49D1CCDA711846608608C7FAE0D,31071,22,23,1,109.58257,18.28458,1815
260323,2C3BD53A8702A47FB82F05FB4993B683,31561,0,6,6,109.56792,18.28479,1765
260324,2C3BD53A8702A47FB82F05FB4993B683,30854,6,8,2,109.56889,18.27076,1763
260325,2C3BD53A8702A47FB82F05FB4993B683,39181,8,10,2,109.55153,18.28035,1715
260326,2C3BD53A8702A47FB82F05FB4993B683,31561,11,13,2,109.56792,18.28479,1765
260327,2C3BD53A8702A47FB82F05FB4993B683,39183,14,16,2,109.55542,18.28208,1715
260328,2C3BD53A8702A47FB82F05FB4993B683,31561,17,19,2,109.56792,18.28479,1765
260345,866460FA5062A635337B6369BB2AADDA,60631,21,22,1,109.57778,18.27583,1814
260346,866460FA5062A635337B6369BB2AADDA,30854,22,23,1,109.56889,18.27076,1763
260353,F6A1EBB84FE583E84185C423218578F5,31561,0,5,5,109.56792,18.28479,1765
260354,F6A1EBB84FE583E84185C423218578F5,39183,6,7,1,109.55542,18.28208,1715
260355,F6A1EBB84FE583E84185C423218578F5,31561,12,22,10,109.56792,18.28479,1765
260372,283001ED673D8EDBEF7EEB00BDB31533,31231,1,3,2,109.42597,18.29292,1217
260373,283001ED673D8EDBEF7EEB00BDB31533,30351,3,6,3,109.41701,18.29292,1217
260374,283001ED673D8EDBEF7EEB00BDB31533,60552,6,11,5,109.41729,18.30014,1218
260375,283001ED673D8EDBEF7EEB00BDB31533,31231,12,13,1,109.42597,18.29292,1217
260376,283001ED673D8EDBEF7EEB00BDB31533,60552,13,15,2,109.41729,18.30014,1218
260416,B40196DEC9296D47DEAFEA139FA4FED8,38961,19,20,1,109.50847,18.23514,1507
260417,B40196DEC9296D47DEAFEA139FA4FED8,30371,20,23,3,109.51,18.24771,1559
260422,D42D82F7F77C55013F0EAB7E35E2211F,30531,0,6,6,109.53271,18.21472,1604
260423,D42D82F7F77C55013F0EAB7E35E2211F,31071,8,14,6,109.58257,18.28458,1815
260437,B35A1B5FE0A9EDD216862BACC2A50CDF,30661,19,20,1,109.37028,18.24361,1008
260438,B35A1B5FE0A9EDD216862BACC2A50CDF,60411,21,23,2,109.32514,18.30854,869
260439,40C57F24FE0409ABB752B2031C349577,38951,0,13,13,109.48097,18.28868,1416
260440,40C57F24FE0409ABB752B2031C349577,30711,15,19,4,109.50271,18.25347,1510
260441,40C57F24FE0409ABB752B2031C349577,60463,20,21,1,109.52507,18.22438,1605
260444,DECFC49E54B6810E60D19758307AF1CD,60594,12,13,1,109.62694,18.22799,1956
260445,DECFC49E54B6810E60D19758307AF1CD,38052,14,15,1,109.62618,18.23042,1956
260446,DECFC49E54B6810E60D19758307AF1CD,38052,16,18,2,109.62618,18.23042,1956
260447,DECFC49E54B6810E60D19758307AF1CD,39331,19,21,2,109.62125,18.22708,1956
260460,A7D270EF8C74F66D966F17A0E3BC8BC9,30854,10,11,1,109.56889,18.27076,1763
260461,A7D270EF8C74F66D966F17A0E3BC8BC9,31071,13,16,3,109.58257,18.28458,1815
260462,A7D270EF8C74F66D966F17A0E3BC8BC9,30854,17,18,1,109.56889,18.27076,1763
260463,A7D270EF8C74F66D966F17A0E3BC8BC9,31071,18,22,4,109.58257,18.28458,1815
260466,1B28D49AE0589113EE30D593B5B6F95E,31931,8,9,1,109.54771,18.29403,1667
260467,1B28D49AE0589113EE30D593B5B6F95E,60371,9,10,1,109.53063,18.30056,1618
260472,6355DB26EDDE6874FD7A9DB8EAA41564,30854,2,8,6,109.56889,18.27076,1763
260473,6355DB26EDDE6874FD7A9DB8EAA41564,31071,9,10,1,109.58257,18.28458,1815
260474,6355DB26EDDE6874FD7A9DB8EAA41564,30854,10,12,2,109.56889,18.27076,1763
260475,D6B54C643B88B86782DC30A38AD291FD,31561,4,19,15,109.56792,18.28479,1765
260476,D6B54C643B88B86782DC30A38AD291FD,30854,20,21,1,109.56889,18.27076,1763
260527,4BCFB9B7DA47F954D069C9FF9050BF88,31071,0,8,8,109.58257,18.28458,1815
260528,4BCFB9B7DA47F954D069C9FF9050BF88,30854,10,12,2,109.56889,18.27076,1763
260529,4BCFB9B7DA47F954D069C9FF9050BF88,31071,16,17,1,109.58257,18.28458,1815
260530,4BCFB9B7DA47F954D069C9FF9050BF88,31071,21,23,2,109.58257,18.28458,1815
260531,B0C6DED232762D9BAF78468BD2731104,30051,12,14,2,109.48917,18.21215,1453
260533,6FDD8510FC3FD17D36965B0963BD7329,30854,0,3,3,109.56889,18.27076,1763
260534,6FDD8510FC3FD17D36965B0963BD7329,31561,3,6,3,109.56792,18.28479,1765
260535,6FDD8510FC3FD17D36965B0963BD7329,39183,6,8,2,109.55542,18.28208,1715
260536,6FDD8510FC3FD17D36965B0963BD7329,30854,9,16,7,109.56889,18.27076,1763
260537,6FDD8510FC3FD17D36965B0963BD7329,31561,20,22,2,109.56792,18.28479,1765
260562,CD576F1C1CDFB89E6A99A20E65927346,31071,1,5,4,109.58257,18.28458,1815
260563,CD576F1C1CDFB89E6A99A20E65927346,31561,7,18,11,109.56792,18.28479,1765
260580,B712327B6033C61F37801CFD6DAC08AD,38484,0,7,7,109.53028,18.31528,1620
260581,B712327B6033C61F37801CFD6DAC08AD,30561,7,8,1,109.52778,18.31938,1621
260582,B712327B6033C61F37801CFD6DAC08AD,38484,13,16,3,109.53028,18.31528,1620
260583,B712327B6033C61F37801CFD6DAC08AD,31951,16,17,1,109.52174,18.30299,1568
260584,B712327B6033C61F37801CFD6DAC08AD,30561,19,23,4,109.52778,18.31938,1621
260598,A7B3BDD8DC79485BA41EC7F220A41345,60631,3,8,5,109.57778,18.27583,1814
260599,A7B3BDD8DC79485BA41EC7F220A41345,30854,11,12,1,109.56889,18.27076,1763
260600,63FBAC0202144B00077561285E6A7F87,30821,0,13,13,109.43681,18.33639,1274
260601,63FBAC0202144B00077561285E6A7F87,30651,14,15,1,109.42611,18.385,1232
260602,63FBAC0202144B00077561285E6A7F87,30821,16,21,5,109.43681,18.33639,1274
260612,DF296B63A64E364FCDA4C38B0935EEEE,30711,2,3,1,109.50271,18.25347,1510
260613,DF296B63A64E364FCDA4C38B0935EEEE,30151,3,16,13,109.50986,18.25083,1560
260614,DF296B63A64E364FCDA4C38B0935EEEE,30511,17,23,6,109.51069,18.24208,1558
260636,8EF00336DF81276A821E166696CFF524,60291,0,8,8,109.50826,18.24639,1509
260637,8EF00336DF81276A821E166696CFF524,38754,10,13,3,109.74667,18.37382,2430
260638,8EF00336DF81276A821E166696CFF524,31931,16,18,2,109.54771,18.29403,1667
260639,8EF00336DF81276A821E166696CFF524,60501,18,20,2,109.48701,18.29021,1466
260640,8EF00336DF81276A821E166696CFF524,30921,20,22,2,109.53903,18.29451,1667
260666,9E2CAA912E7C38B3460AB2C8B985CA0D,31071,0,6,6,109.58257,18.28458,1815
260667,9E2CAA912E7C38B3460AB2C8B985CA0D,30854,7,16,9,109.56889,18.27076,1763
260668,9E2CAA912E7C38B3460AB2C8B985CA0D,31071,20,23,3,109.58257,18.28458,1815
260688,FCC7FFA36CCAFA7D306338AD42FEB181,31231,0,4,4,109.42597,18.29292,1217
260689,FCC7FFA36CCAFA7D306338AD42FEB181,60161,5,6,1,109.49174,18.26181,1461
260690,FCC7FFA36CCAFA7D306338AD42FEB181,31021,11,12,1,109.49021,18.27,1463
260739,7FF3C6569A3990C03CAF6C52D3C8BC6C,30921,0,6,6,109.53903,18.29451,1667
260740,7FF3C6569A3990C03CAF6C52D3C8BC6C,31931,7,10,3,109.54771,18.29403,1667
260741,7FF3C6569A3990C03CAF6C52D3C8BC6C,60221,11,12,1,109.52569,18.29188,1616
260742,7FF3C6569A3990C03CAF6C52D3C8BC6C,31931,14,16,2,109.54771,18.29403,1667
260743,7FF3C6569A3990C03CAF6C52D3C8BC6C,30921,16,23,7,109.53903,18.29451,1667
260766,F47C4E1E39056C43B0AD32AC994AB7C0,31931,5,8,3,109.54771,18.29403,1667
260767,F47C4E1E39056C43B0AD32AC994AB7C0,30921,9,10,1,109.53903,18.29451,1667
260768,F47C4E1E39056C43B0AD32AC994AB7C0,31931,11,22,11,109.54771,18.29403,1667
260813,BE6692F33DB9008EB8798E9F18021EDA,39183,0,5,5,109.55542,18.28208,1715
260814,BE6692F33DB9008EB8798E9F18021EDA,39181,6,14,8,109.55153,18.28035,1715
260815,BE6692F33DB9008EB8798E9F18021EDA,39181,15,17,2,109.55153,18.28035,1715
260820,5291560AC3CA28497E4CB7832DDE2A8C,31761,0,9,9,109.60521,18.27965,1914
260838,30F5D42A1A8F1CF26F5C9617FCB06C4F,31561,1,8,7,109.56792,18.28479,1765
260839,30F5D42A1A8F1CF26F5C9617FCB06C4F,30071,10,11,1,109.52819,18.30472,1619
260840,30F5D42A1A8F1CF26F5C9617FCB06C4F,31561,14,23,9,109.56792,18.28479,1765
260886,A585E60286B0A8AE3B57F133CE8318C1,31461,11,14,3,109.5091,18.25389,1510
260887,A585E60286B0A8AE3B57F133CE8318C1,60221,15,18,3,109.52569,18.29188,1616
260906,423E2A7AD06C927EE0BD23EE3AB605E3,30854,1,6,5,109.56889,18.27076,1763
260907,423E2A7AD06C927EE0BD23EE3AB605E3,31071,10,12,2,109.58257,18.28458,1815
260908,423E2A7AD06C927EE0BD23EE3AB605E3,30854,15,16,1,109.56889,18.27076,1763
260928,42158B50A96F4BB50162AD5AAF8D7E2D,31201,0,8,8,109.51042,18.23819,1558
260929,42158B50A96F4BB50162AD5AAF8D7E2D,30251,13,14,1,109.50611,18.26653,1512
260930,17044E2739C9A19F4DCFEBDB273C9F8A,31521,0,12,12,109.51458,18.22542,1555
260931,17044E2739C9A19F4DCFEBDB273C9F8A,30731,13,14,1,109.50944,18.22306,1555
260932,17044E2739C9A19F4DCFEBDB273C9F8A,39321,14,18,4,109.529,18.2167,1604
260933,17044E2739C9A19F4DCFEBDB273C9F8A,31521,19,23,4,109.51458,18.22542,1555
260941,97C31877CA4226D0F1BA1C0E12066B56,30854,11,18,7,109.56889,18.27076,1763
260942,97C31877CA4226D0F1BA1C0E12066B56,30251,19,21,2,109.50611,18.26653,1512
260966,0F09C2BE6A190F4BF3D635D6A9F19FD3,31071,0,6,6,109.58257,18.28458,1815
260967,0F09C2BE6A190F4BF3D635D6A9F19FD3,60661,8,12,4,109.548,18.2377,1657
260968,0F09C2BE6A190F4BF3D635D6A9F19FD3,31951,16,23,7,109.52174,18.30299,1568
260986,E4B522EF4348156010E5C578EC13D60F,30854,15,18,3,109.56889,18.27076,1763
260987,560794A44CA17A43FA34D0FA6C339747,30731,14,15,1,109.50944,18.22306,1555
260988,560794A44CA17A43FA34D0FA6C339747,60361,17,19,2,109.51938,18.29681,1567
260989,560794A44CA17A43FA34D0FA6C339747,31351,20,21,1,109.4959,18.28417,1465
260990,560794A44CA17A43FA34D0FA6C339747,60361,22,23,1,109.51938,18.29681,1567
260994,86435198F57620D5DAC23B4A4DA78009,39183,0,4,4,109.55542,18.28208,1715
260995,86435198F57620D5DAC23B4A4DA78009,31931,9,12,3,109.54771,18.29403,1667
260996,86435198F57620D5DAC23B4A4DA78009,39183,14,20,6,109.55542,18.28208,1715
261010,608A55C14BAB2A5B627ACC1F39B89FB6,31945,0,7,7,109.58021,18.29403,1817
261011,608A55C14BAB2A5B627ACC1F39B89FB6,30854,11,14,3,109.56889,18.27076,1763
261012,608A55C14BAB2A5B627ACC1F39B89FB6,31164,15,21,6,109.69993,18.27215,2263
261013,608A55C14BAB2A5B627ACC1F39B89FB6,31945,22,23,1,109.58021,18.29403,1817
261035,85586D73EA48B4F4D520D899B0BE0554,30291,0,5,5,109.50403,18.27028,1513
261036,85586D73EA48B4F4D520D899B0BE0554,30854,7,8,1,109.56889,18.27076,1763
261037,85586D73EA48B4F4D520D899B0BE0554,39181,10,17,7,109.55153,18.28035,1715
261038,85586D73EA48B4F4D520D899B0BE0554,30291,20,23,3,109.50403,18.27028,1513
261049,10EBF762D28520B09848288F7052CFDE,30854,0,1,1,109.56889,18.27076,1763
261050,10EBF762D28520B09848288F7052CFDE,31561,3,4,1,109.56792,18.28479,1765
261051,10EBF762D28520B09848288F7052CFDE,39101,7,17,10,109.50132,18.24931,1509
261052,10EBF762D28520B09848288F7052CFDE,30854,19,22,3,109.56889,18.27076,1763
261073,A786C2DB315949831D3D4F5064647FEF,31531,0,7,7,109.49583,18.25972,1461
261074,A786C2DB315949831D3D4F5064647FEF,31145,9,10,1,109.20431,18.30479,369
261075,A786C2DB315949831D3D4F5064647FEF,60054,13,15,2,109.3016,18.31229,770
261098,546C572FC49C780F9A9AF62ED98666DF,30351,0,8,8,109.41701,18.29292,1217
261099,546C572FC49C780F9A9AF62ED98666DF,30681,8,10,2,109.48493,18.26917,1463
261100,546C572FC49C780F9A9AF62ED98666DF,30351,10,12,2,109.41701,18.29292,1217
261101,546C572FC49C780F9A9AF62ED98666DF,30681,12,13,1,109.48493,18.26917,1463
261102,546C572FC49C780F9A9AF62ED98666DF,30351,15,18,3,109.41701,18.29292,1217
261103,546C572FC49C780F9A9AF62ED98666DF,30171,18,21,3,109.48458,18.27139,1463
261104,546C572FC49C780F9A9AF62ED98666DF,30351,21,23,2,109.41701,18.29292,1217
261136,DF5348A8E25901EBB63BBF3F6126BB02,31071,0,8,8,109.58257,18.28458,1815
261137,DF5348A8E25901EBB63BBF3F6126BB02,30854,10,22,12,109.56889,18.27076,1763
261145,6D0CBC29417959EBDF12F1FD604A5C61,31521,20,21,1,109.51458,18.22542,1555
261146,6D0CBC29417959EBDF12F1FD604A5C61,39321,22,23,1,109.529,18.2167,1604
261156,2C5F898948A2B7909519666936FBF333,38707,0,12,12,109.73778,18.35368,2427
261157,2C5F898948A2B7909519666936FBF333,38707,17,18,1,109.73778,18.35368,2427
261169,08298D6D3F79F7819C6B0F651C6D5327,31521,3,10,7,109.51458,18.22542,1555
261170,08298D6D3F79F7819C6B0F651C6D5327,30361,12,14,2,109.50347,18.24,1508
261171,08298D6D3F79F7819C6B0F651C6D5327,31521,14,20,6,109.51458,18.22542,1555
261172,08298D6D3F79F7819C6B0F651C6D5327,60381,21,23,2,109.5241,18.22458,1605
261222,0F558B6653C655C7F0BAEA9D66B33F57,31071,2,8,6,109.58257,18.28458,1815
261223,0F558B6653C655C7F0BAEA9D66B33F57,30854,11,14,3,109.56889,18.27076,1763
261224,0F558B6653C655C7F0BAEA9D66B33F57,31071,14,15,1,109.58257,18.28458,1815
261225,0F558B6653C655C7F0BAEA9D66B33F57,60211,16,18,2,109.63549,18.26049,2011
261226,0F558B6653C655C7F0BAEA9D66B33F57,30191,22,23,1,109.50361,18.22701,1506
261229,1026894DC5FF9A7FAF3A2EE28B95E239,39183,1,5,4,109.55542,18.28208,1715
261230,1026894DC5FF9A7FAF3A2EE28B95E239,30854,10,23,13,109.56889,18.27076,1763
261236,F9F2694056D54C70B8E94D439CF649C0,38331,16,18,2,109.62465,18.22736,1956
261237,F9F2694056D54C70B8E94D439CF649C0,30161,20,22,2,109.50042,18.24389,1508
261251,7421066246AAD1C230E7E2A7ADF06E9D,60631,3,6,3,109.57778,18.27583,1814
261252,7421066246AAD1C230E7E2A7ADF06E9D,30854,8,9,1,109.56889,18.27076,1763
261253,7421066246AAD1C230E7E2A7ADF06E9D,60631,11,13,2,109.57778,18.27583,1814
261254,7421066246AAD1C230E7E2A7ADF06E9D,30854,14,15,1,109.56889,18.27076,1763
261255,7421066246AAD1C230E7E2A7ADF06E9D,60211,18,21,3,109.63549,18.26049,2011
261270,D70D11871FB47AB4743A9AB8A25E5AA8,38241,0,2,2,109.54111,18.30542,1669
261271,D70D11871FB47AB4743A9AB8A25E5AA8,60671,3,4,1,109.52979,18.31757,1621
261272,D70D11871FB47AB4743A9AB8A25E5AA8,38241,5,6,1,109.54111,18.30542,1669
261273,D70D11871FB47AB4743A9AB8A25E5AA8,60241,9,16,7,109.53319,18.28667,1616
261274,D70D11871FB47AB4743A9AB8A25E5AA8,60671,20,21,1,109.52979,18.31757,1621
261275,D70D11871FB47AB4743A9AB8A25E5AA8,38241,22,23,1,109.54111,18.30542,1669
261280,417408FFDA93B177641D270D3A5C4B2D,31071,0,6,6,109.58257,18.28458,1815
261281,417408FFDA93B177641D270D3A5C4B2D,30854,6,21,15,109.56889,18.27076,1763
261282,417408FFDA93B177641D270D3A5C4B2D,31071,22,23,1,109.58257,18.28458,1815
261288,304C30E2FC5C661AED14B0A3EC5AD4C3,31931,0,13,13,109.54771,18.29403,1667
261308,79F9F95B3990F4F0729635A63B021CCE,60661,0,6,6,109.548,18.2377,1657
261309,79F9F95B3990F4F0729635A63B021CCE,60381,8,10,2,109.5241,18.22458,1605
261310,79F9F95B3990F4F0729635A63B021CCE,60641,10,18,8,109.53854,18.2359,1657
261311,79F9F95B3990F4F0729635A63B021CCE,60381,19,20,1,109.5241,18.22458,1605
261312,79F9F95B3990F4F0729635A63B021CCE,60381,21,23,2,109.5241,18.22458,1605
261337,A4743972EC2FC58546DD11935BDC0E1A,31521,0,2,2,109.51458,18.22542,1555
261338,A4743972EC2FC58546DD11935BDC0E1A,39091,2,14,12,109.50097,18.25222,1510
261390,D4448A1349B0563C78F16B479359A95F,31071,6,12,6,109.58257,18.28458,1815
261391,D4448A1349B0563C78F16B479359A95F,30854,13,14,1,109.56889,18.27076,1763
261417,8DD23AA43C0F7967C45F7488D66F9159,39371,0,7,7,109.56627,18.2646,1762
261418,8DD23AA43C0F7967C45F7488D66F9159,30854,7,11,4,109.56889,18.27076,1763
261419,8DD23AA43C0F7967C45F7488D66F9159,31945,12,13,1,109.58021,18.29403,1817
261420,8DD23AA43C0F7967C45F7488D66F9159,30854,14,16,2,109.56889,18.27076,1763
261421,8DD23AA43C0F7967C45F7488D66F9159,31071,18,22,4,109.58257,18.28458,1815
261436,147470AD3D3B8724582C30D5F244A8B6,60421,0,2,2,109.46333,18.31743,1371
261437,147470AD3D3B8724582C30D5F244A8B6,30111,5,10,5,109.47583,18.30542,1419
261438,147470AD3D3B8724582C30D5F244A8B6,60421,11,16,5,109.46333,18.31743,1371
261439,147470AD3D3B8724582C30D5F244A8B6,30111,17,18,1,109.47583,18.30542,1419
261440,147470AD3D3B8724582C30D5F244A8B6,60421,20,22,2,109.46333,18.31743,1371
261460,D6B14C7387647D8C883334DAFB518257,31071,0,7,7,109.58257,18.28458,1815
261461,D6B14C7387647D8C883334DAFB518257,39183,10,16,6,109.55542,18.28208,1715
261462,D6B14C7387647D8C883334DAFB518257,39053,20,22,2,109.511,18.2771,1564
261470,9B56C9E8F296BB0BD3749C5E72B4BBD9,60631,8,13,5,109.57778,18.27583,1814
261471,9B56C9E8F296BB0BD3749C5E72B4BBD9,30511,17,19,2,109.51069,18.24208,1558
261472,9B56C9E8F296BB0BD3749C5E72B4BBD9,60631,21,23,2,109.57778,18.27583,1814
261570,D6CC1FC0E328F94E96D4D1F260DF9F7F,31071,12,14,2,109.58257,18.28458,1815
261571,D6CC1FC0E328F94E96D4D1F260DF9F7F,31071,18,23,5,109.58257,18.28458,1815
261579,FC3A0E75CA2AB7A7F2493FF9F12595DC,31171,0,8,8,109.50938,18.24917,1559
261593,B3F4E43DA3C4E855A3ED684A6CB97F36,31931,1,8,7,109.54771,18.29403,1667
261594,B3F4E43DA3C4E855A3ED684A6CB97F36,30921,10,11,1,109.53903,18.29451,1667
261595,B3F4E43DA3C4E855A3ED684A6CB97F36,31931,12,14,2,109.54771,18.29403,1667
261596,B3F4E43DA3C4E855A3ED684A6CB97F36,31071,18,20,2,109.58257,18.28458,1815
261597,B3F4E43DA3C4E855A3ED684A6CB97F36,31931,21,23,2,109.54771,18.29403,1667
261598,7B2AEE2086698683607EDDDB4B678234,31461,14,15,1,109.5091,18.25389,1510
261599,7B2AEE2086698683607EDDDB4B678234,38154,18,22,4,109.5266,18.28278,1615
261607,6846D911A5FA1223889E01CD52440A91,31071,3,6,3,109.58257,18.28458,1815
261608,6846D911A5FA1223889E01CD52440A91,30854,8,9,1,109.56889,18.27076,1763
261611,EBF906C5498076BCFA3E97DF6001B4F3,30854,0,5,5,109.56889,18.27076,1763
261612,EBF906C5498076BCFA3E97DF6001B4F3,60631,7,15,8,109.57778,18.27583,1814
261613,EBF906C5498076BCFA3E97DF6001B4F3,30854,16,17,1,109.56889,18.27076,1763
261627,2A6BA0678DDF16AF08BAC9E3FA3C9391,31561,0,2,2,109.56792,18.28479,1765
261628,2A6BA0678DDF16AF08BAC9E3FA3C9391,30854,3,20,17,109.56889,18.27076,1763
261639,AD66901AE8DA9E70C69F33D262CADCE7,31521,10,12,2,109.51458,18.22542,1555
261640,AD66901AE8DA9E70C69F33D262CADCE7,39321,12,13,1,109.529,18.2167,1604
261641,AD66901AE8DA9E70C69F33D262CADCE7,38111,17,18,1,109.52007,18.22403,1555
261642,AD66901AE8DA9E70C69F33D262CADCE7,31521,20,21,1,109.51458,18.22542,1555
261663,8BB15E7C959475309A269AAF24FD7109,30421,20,21,1,109.50021,18.25861,1511
261664,8BB15E7C959475309A269AAF24FD7109,60291,22,23,1,109.50826,18.24639,1509
261665,75817DB682187A07461734D66E1E6492,60631,0,4,4,109.57778,18.27583,1814
261666,75817DB682187A07461734D66E1E6492,30854,5,17,12,109.56889,18.27076,1763
261667,75817DB682187A07461734D66E1E6492,60631,22,23,1,109.57778,18.27583,1814
261681,E16204D131FCD957D5ADB9592C1DD0ED,38291,14,16,2,109.51618,18.24313,1558
261682,E16204D131FCD957D5ADB9592C1DD0ED,31821,18,20,2,109.51181,18.24924,1559
261683,E16204D131FCD957D5ADB9592C1DD0ED,31071,21,23,2,109.58257,18.28458,1815
261690,005F3AEFE6DBF371ED1FD57736434098,31071,1,2,1,109.58257,18.28458,1815
261691,005F3AEFE6DBF371ED1FD57736434098,60211,3,6,3,109.63549,18.26049,2011
261692,005F3AEFE6DBF371ED1FD57736434098,30854,7,17,10,109.56889,18.27076,1763
261693,005F3AEFE6DBF371ED1FD57736434098,31071,21,23,2,109.58257,18.28458,1815
261694,D9993ECC22BF2983B88088E38AF85C01,30854,14,16,2,109.56889,18.27076,1763
261695,D9993ECC22BF2983B88088E38AF85C01,60631,18,21,3,109.57778,18.27583,1814
261696,D9993ECC22BF2983B88088E38AF85C01,60354,22,23,1,109.58701,18.28521,1815
261708,86B53E128647666CEA9BD4D18A34AC90,60084,1,5,4,109.4984,18.2334,1507
261709,86B53E128647666CEA9BD4D18A34AC90,31391,8,9,1,109.50382,18.24285,1508
261710,86B53E128647666CEA9BD4D18A34AC90,60084,11,13,2,109.4984,18.2334,1507
261711,86B53E128647666CEA9BD4D18A34AC90,31206,17,20,3,109.50819,18.23549,1507
261737,34F3D64B41C252481F72E5CF931AC833,30854,7,10,3,109.56889,18.27076,1763
261738,34F3D64B41C252481F72E5CF931AC833,30851,13,16,3,109.5616,18.27396,1713
261739,34F3D64B41C252481F72E5CF931AC833,30854,16,18,2,109.56889,18.27076,1763
261751,8176D8142708363A5FC68B07CA2CF3DF,60081,0,5,5,109.51097,18.22639,1556
261752,8176D8142708363A5FC68B07CA2CF3DF,39191,6,9,3,109.51493,18.23472,1557
261753,8176D8142708363A5FC68B07CA2CF3DF,60381,11,12,1,109.5241,18.22458,1605
261757,8D8AA41210FC9E2D5DD4D81CF4DB18D7,60361,0,5,5,109.51938,18.29681,1567
261758,8D8AA41210FC9E2D5DD4D81CF4DB18D7,30071,5,8,3,109.52819,18.30472,1619
261759,8D8AA41210FC9E2D5DD4D81CF4DB18D7,30084,12,13,1,109.50118,18.26972,1513
261779,ABCD0851CC1C78BCD7AF6DBDF2F5DE49,60552,5,8,3,109.41729,18.30014,1218
261780,ABCD0851CC1C78BCD7AF6DBDF2F5DE49,60551,9,11,2,109.42722,18.30111,1218
261781,ABCD0851CC1C78BCD7AF6DBDF2F5DE49,60552,11,19,8,109.41729,18.30014,1218
261786,5E97A4561E11AAC4FBC53FD068EAA52B,30891,0,2,2,109.59431,18.28389,1865
261787,5E97A4561E11AAC4FBC53FD068EAA52B,60631,2,10,8,109.57778,18.27583,1814
261788,5E97A4561E11AAC4FBC53FD068EAA52B,30854,11,12,1,109.56889,18.27076,1763
261789,5E97A4561E11AAC4FBC53FD068EAA52B,38251,17,18,1,109.49618,18.25493,1510
261790,5E97A4561E11AAC4FBC53FD068EAA52B,30854,22,23,1,109.56889,18.27076,1763
261793,1DCF37EE2927C479B1032CB369D26049,31571,0,5,5,109.61563,18.23326,1957
261794,1DCF37EE2927C479B1032CB369D26049,60421,5,6,1,109.46333,18.31743,1371
261795,1DCF37EE2927C479B1032CB369D26049,38052,7,8,1,109.62618,18.23042,1956
261803,C19430CE8DF26BDEF43903E57E682236,31561,0,8,8,109.56792,18.28479,1765
261804,C19430CE8DF26BDEF43903E57E682236,30854,8,9,1,109.56889,18.27076,1763
261805,C19430CE8DF26BDEF43903E57E682236,31561,13,23,10,109.56792,18.28479,1765
261810,9F708CFC0857E7A2A3B7B0FC8BC7087D,30181,0,9,9,109.51597,18.23313,1557
261811,9F708CFC0857E7A2A3B7B0FC8BC7087D,31471,12,14,2,109.34583,18.29563,917
261812,9F708CFC0857E7A2A3B7B0FC8BC7087D,31521,18,19,1,109.51458,18.22542,1555
261816,69674649043EDB81804188C1D4601ECF,38023,14,17,3,109.37132,18.28993,1016
261817,69674649043EDB81804188C1D4601ECF,38027,20,22,2,109.38833,18.2909,1066
261818,E6541B4F346982101D887BAAF0315541,30854,0,6,6,109.56889,18.27076,1763
261819,E6541B4F346982101D887BAAF0315541,31561,7,9,2,109.56792,18.28479,1765
261820,E6541B4F346982101D887BAAF0315541,30854,12,14,2,109.56889,18.27076,1763
261894,C6B911445627E1FADD20639DE87ABED6,31431,19,22,3,109.44639,18.29042,1316
261912,5426296000364EE32711CD0E73D782C8,31071,1,8,7,109.58257,18.28458,1815
261913,5426296000364EE32711CD0E73D782C8,30854,11,12,1,109.56889,18.27076,1763
261914,5426296000364EE32711CD0E73D782C8,31071,15,21,6,109.58257,18.28458,1815
261915,5426296000364EE32711CD0E73D782C8,30854,22,23,1,109.56889,18.27076,1763
261942,4E94ADAE7ABEB20EEFAF67519DFCC1BE,31081,0,9,9,109.44639,18.30181,1318
261943,4E94ADAE7ABEB20EEFAF67519DFCC1BE,31031,9,21,12,109.49979,18.25382,1510
261955,5513A4EBEB51AF5647B29C75D8B8CC2C,30421,19,20,1,109.50021,18.25861,1511
261956,5513A4EBEB51AF5647B29C75D8B8CC2C,31345,22,23,1,109.39,18.29,1066
262012,B340EDEF4A878E8DF5CBEC25E465EACE,31071,12,14,2,109.58257,18.28458,1815
262013,B340EDEF4A878E8DF5CBEC25E465EACE,30854,15,16,1,109.56889,18.27076,1763
262025,F198CAA1F49ACA5D003FD8F8473B3798,30854,1,8,7,109.56889,18.27076,1763
262026,F198CAA1F49ACA5D003FD8F8473B3798,31071,10,12,2,109.58257,18.28458,1815
262070,DAB08D254D49BF150533311BD904D49C,30854,0,9,9,109.56889,18.27076,1763
262071,DAB08D254D49BF150533311BD904D49C,31071,12,13,1,109.58257,18.28458,1815
262072,DAB08D254D49BF150533311BD904D49C,30854,14,16,2,109.56889,18.27076,1763
262073,DAB08D254D49BF150533311BD904D49C,60463,16,18,2,109.52507,18.22438,1605
262074,DAB08D254D49BF150533311BD904D49C,39321,19,20,1,109.529,18.2167,1604
262077,1D2F8DB1F8B6A2081E1A43DDF558491D,31951,1,12,11,109.52174,18.30299,1568
262078,1D2F8DB1F8B6A2081E1A43DDF558491D,30071,13,15,2,109.52819,18.30472,1619
262079,1D2F8DB1F8B6A2081E1A43DDF558491D,30561,19,21,2,109.52778,18.31938,1621
262080,8C5A16299A6D294198C90C34C25C5949,31561,0,2,2,109.56792,18.28479,1765
262081,8C5A16299A6D294198C90C34C25C5949,39183,5,6,1,109.55542,18.28208,1715
262082,662D882A6A10D0E6C3566690F0A40636,30854,0,17,17,109.56889,18.27076,1763
262083,662D882A6A10D0E6C3566690F0A40636,31071,19,20,1,109.58257,18.28458,1815
262093,ECC87D4B92C9C8DFEF66B8ADE6C84FBA,38541,0,9,9,109.73715,18.34875,2426
262094,ECC87D4B92C9C8DFEF66B8ADE6C84FBA,38291,12,14,2,109.51618,18.24313,1558
262095,ECC87D4B92C9C8DFEF66B8ADE6C84FBA,38017,15,17,2,109.49729,18.21424,1504
262096,ECC87D4B92C9C8DFEF66B8ADE6C84FBA,38541,22,23,1,109.73715,18.34875,2426
262107,292F7AA5A13D44513985CC059AB0B0E9,31071,0,5,5,109.58257,18.28458,1815
262108,292F7AA5A13D44513985CC059AB0B0E9,30854,9,19,10,109.56889,18.27076,1763
262155,77E0479537D8350123531CE1FA2E6649,60631,0,12,12,109.57778,18.27583,1814
262156,77E0479537D8350123531CE1FA2E6649,30854,16,23,7,109.56889,18.27076,1763
262157,1FC1EE9261830F63E0A5F4681C41D592,30711,13,15,2,109.50271,18.25347,1510
262158,1FC1EE9261830F63E0A5F4681C41D592,31031,18,19,1,109.49979,18.25382,1510
262166,EEA9FE6C36184B76E616449954E6C55B,30201,14,15,1,109.4909,18.26465,1462
262167,EEA9FE6C36184B76E616449954E6C55B,38212,18,23,5,109.48889,18.26306,1462
262190,BF77B653864ED8DD6CB6952D60F33BB5,30171,0,6,6,109.48458,18.27139,1463
262197,2D39AE6120F2674000C6DBB8A6E572A0,31945,0,15,15,109.58021,18.29403,1817
262198,2D39AE6120F2674000C6DBB8A6E572A0,30854,17,18,1,109.56889,18.27076,1763
262222,770A00BDAFE9BCA8C9E9FA68066EED7D,31071,0,6,6,109.58257,18.28458,1815
262223,770A00BDAFE9BCA8C9E9FA68066EED7D,31561,7,21,14,109.56792,18.28479,1765
262224,770A00BDAFE9BCA8C9E9FA68066EED7D,31071,21,23,2,109.58257,18.28458,1815
262253,F7FA9EDDDD22A3605AF235C1758649A3,60401,0,6,6,109.47444,18.27583,1414
262254,F7FA9EDDDD22A3605AF235C1758649A3,31781,11,12,1,109.19847,18.2975,367
262255,F7FA9EDDDD22A3605AF235C1758649A3,31471,13,14,1,109.34583,18.29563,917
262256,F7FA9EDDDD22A3605AF235C1758649A3,30361,15,17,2,109.50347,18.24,1508
262307,DC0EB400EA24BEE9EB39D315B0E6AEF0,30171,18,21,3,109.48458,18.27139,1463
262308,DC0EB400EA24BEE9EB39D315B0E6AEF0,60041,21,23,2,109.39889,18.31944,1121
262315,FFFC0994E5C15BDB165344716912442C,39371,0,3,3,109.56627,18.2646,1762
262316,FFFC0994E5C15BDB165344716912442C,30854,4,6,2,109.56889,18.27076,1763
262317,FFFC0994E5C15BDB165344716912442C,31554,7,17,10,109.55521,18.2459,1709
262318,FFFC0994E5C15BDB165344716912442C,31551,19,21,2,109.55868,18.24222,1708
262350,E34C10F1C8BC04C7EF99531DA4E2FBE8,60281,19,20,1,109.51743,18.25924,1561
262351,E34C10F1C8BC04C7EF99531DA4E2FBE8,30211,21,23,2,109.49882,18.23931,1508
262363,EF428BA2D8FF285B80F14CDB1F80FC95,60211,0,9,9,109.63549,18.26049,2011
262364,EF428BA2D8FF285B80F14CDB1F80FC95,30711,10,13,3,109.50271,18.25347,1510
262365,EF428BA2D8FF285B80F14CDB1F80FC95,38283,13,23,10,109.62229,18.22618,1956
262366,B128AECFAC76B09AA7B5F873BBC97F1F,31061,0,6,6,109.53333,18.23257,1607
262367,B128AECFAC76B09AA7B5F873BBC97F1F,31301,10,12,2,109.14493,18.31222,170
262368,B128AECFAC76B09AA7B5F873BBC97F1F,60054,14,15,1,109.3016,18.31229,770
262376,46D3900FF4CD0CE137E6DB2E5BBC5B87,39183,0,14,14,109.55542,18.28208,1715
262377,46D3900FF4CD0CE137E6DB2E5BBC5B87,30854,14,16,2,109.56889,18.27076,1763
262378,46D3900FF4CD0CE137E6DB2E5BBC5B87,39183,20,22,2,109.55542,18.28208,1715
262424,34CDE58722D425921983509B878EB515,30181,15,22,7,109.51597,18.23313,1557
262456,A68637AA89BD62624E677D9E66C32FAD,30361,2,6,4,109.50347,18.24,1508
262457,A68637AA89BD62624E677D9E66C32FAD,30161,6,9,3,109.50042,18.24389,1508
262458,A68637AA89BD62624E677D9E66C32FAD,30361,9,11,2,109.50347,18.24,1508
262459,A68637AA89BD62624E677D9E66C32FAD,30161,11,14,3,109.50042,18.24389,1508
262460,A68637AA89BD62624E677D9E66C32FAD,60261,16,23,7,109.44326,18.3075,1319
262489,E8D51F8B53F290BFD73338AD2AD8C728,30854,14,17,3,109.56889,18.27076,1763
262490,E8D51F8B53F290BFD73338AD2AD8C728,31561,20,21,1,109.56792,18.28479,1765
262526,135B81D7EF945BBFA54C0C2F91CFFDD8,38261,0,7,7,109.50361,18.28153,1515
262575,41BFDF202AA15C7D0EC7487840A4D094,30854,0,17,17,109.56889,18.27076,1763
262576,41BFDF202AA15C7D0EC7487840A4D094,60631,20,22,2,109.57778,18.27583,1814
262616,0D3DA8126B134D203BB35373EAFFB116,31071,2,7,5,109.58257,18.28458,1815
262617,0D3DA8126B134D203BB35373EAFFB116,30854,10,17,7,109.56889,18.27076,1763
262639,47A18820FDA9856131F74091D44B6BCB,31071,0,7,7,109.58257,18.28458,1815
262640,47A18820FDA9856131F74091D44B6BCB,31561,7,16,9,109.56792,18.28479,1765
262641,85D2E0E28FB58C7F8A0D7BC94160D3DD,31561,2,3,1,109.56792,18.28479,1765
262642,85D2E0E28FB58C7F8A0D7BC94160D3DD,30854,5,8,3,109.56889,18.27076,1763
262643,85D2E0E28FB58C7F8A0D7BC94160D3DD,30851,12,14,2,109.5616,18.27396,1713
262644,85D2E0E28FB58C7F8A0D7BC94160D3DD,30854,15,17,2,109.56889,18.27076,1763
262684,DD04F693D1086357462FD164DAD08818,31931,8,10,2,109.54771,18.29403,1667
262685,DD04F693D1086357462FD164DAD08818,30921,10,11,1,109.53903,18.29451,1667
262686,DD04F693D1086357462FD164DAD08818,31931,11,13,2,109.54771,18.29403,1667
262710,A9FCE0049DB44FE004EAFBF5B783F4A5,31071,0,6,6,109.58257,18.28458,1815
262711,A9FCE0049DB44FE004EAFBF5B783F4A5,30854,10,17,7,109.56889,18.27076,1763
262731,DD45185853A1666007498BC4DFEF5242,30681,0,4,4,109.48493,18.26917,1463
262732,DD45185853A1666007498BC4DFEF5242,31561,4,6,2,109.56792,18.28479,1765
262733,DD45185853A1666007498BC4DFEF5242,30681,10,12,2,109.48493,18.26917,1463
262752,84DF4A7C208235D171EF56473BCCF210,60631,13,18,5,109.57778,18.27583,1814
262753,84DF4A7C208235D171EF56473BCCF210,30851,20,23,3,109.5616,18.27396,1713
262762,015CDEB9169BCE5537ABAE49B6A63F2B,31071,0,7,7,109.58257,18.28458,1815
262763,015CDEB9169BCE5537ABAE49B6A63F2B,30854,11,14,3,109.56889,18.27076,1763
262764,015CDEB9169BCE5537ABAE49B6A63F2B,30421,15,16,1,109.50021,18.25861,1511
262765,015CDEB9169BCE5537ABAE49B6A63F2B,30371,20,22,2,109.51,18.24771,1559
262771,EC721F8259E3B17F432086B3F60AECE1,31554,0,15,15,109.55521,18.2459,1709
262772,EC721F8259E3B17F432086B3F60AECE1,31551,15,16,1,109.55868,18.24222,1708
262773,E4D199FCE009427481C9D06B9609AB1E,31931,1,10,9,109.54771,18.29403,1667
262774,E4D199FCE009427481C9D06B9609AB1E,39181,10,17,7,109.55153,18.28035,1715
262775,E4D199FCE009427481C9D06B9609AB1E,31931,19,21,2,109.54771,18.29403,1667
262776,E4D199FCE009427481C9D06B9609AB1E,39181,21,23,2,109.55153,18.28035,1715
262801,BE586ACB441383CC10D7CF3923850B73,31931,2,8,6,109.54771,18.29403,1667
262802,BE586ACB441383CC10D7CF3923850B73,30921,8,9,1,109.53903,18.29451,1667
262803,BE586ACB441383CC10D7CF3923850B73,31931,12,14,2,109.54771,18.29403,1667
262804,BE586ACB441383CC10D7CF3923850B73,60371,15,16,1,109.53063,18.30056,1618
262805,BE586ACB441383CC10D7CF3923850B73,31271,20,21,1,109.48958,18.26257,1462
262821,833001CDF394BB3F6E4F040C2A70AC27,31071,1,7,6,109.58257,18.28458,1815
262822,833001CDF394BB3F6E4F040C2A70AC27,30854,10,12,2,109.56889,18.27076,1763
262863,15C58AA4098F7C3C06247EBC0EBAF235,31521,14,17,3,109.51458,18.22542,1555
262864,15C58AA4098F7C3C06247EBC0EBAF235,60381,19,20,1,109.5241,18.22458,1605
262865,15C58AA4098F7C3C06247EBC0EBAF235,31031,20,21,1,109.49979,18.25382,1510
262866,15C58AA4098F7C3C06247EBC0EBAF235,39321,22,23,1,109.529,18.2167,1604
262885,567BF1868FBA42FA9B3B29F2CA13F65D,60371,1,3,2,109.53063,18.30056,1618
262886,567BF1868FBA42FA9B3B29F2CA13F65D,60361,4,8,4,109.51938,18.29681,1567
262887,567BF1868FBA42FA9B3B29F2CA13F65D,31931,11,23,12,109.54771,18.29403,1667
262923,934029FB5F97BCE114EDCE88F0393A63,30421,8,14,6,109.50021,18.25861,1511
262924,934029FB5F97BCE114EDCE88F0393A63,31071,16,17,1,109.58257,18.28458,1815
262925,934029FB5F97BCE114EDCE88F0393A63,30711,18,20,2,109.50271,18.25347,1510
262934,96F98526707B06BE1263CCD4F72E07A1,30854,15,17,2,109.56889,18.27076,1763
262935,96F98526707B06BE1263CCD4F72E07A1,31071,17,18,1,109.58257,18.28458,1815
262936,96F98526707B06BE1263CCD4F72E07A1,30854,19,21,2,109.56889,18.27076,1763
262937,335A7B1DE8538918FDA774EE3E402A76,30191,0,6,6,109.50361,18.22701,1506
262938,335A7B1DE8538918FDA774EE3E402A76,31521,10,12,2,109.51458,18.22542,1555
262939,335A7B1DE8538918FDA774EE3E402A76,30191,17,23,6,109.50361,18.22701,1506
262951,E082FB5BD091C5B334EC1176FF352EE0,30071,0,13,13,109.52819,18.30472,1619
262952,E082FB5BD091C5B334EC1176FF352EE0,31931,17,19,2,109.54771,18.29403,1667
262990,7D5E9CAF0010A9154C77C17BC4001BF8,31231,1,7,6,109.42597,18.29292,1217
262991,7D5E9CAF0010A9154C77C17BC4001BF8,38102,11,13,2,109.40875,18.29111,1166
262995,7050D1E0A5553A00BB03B768ACFBCA8F,31551,10,12,2,109.55868,18.24222,1708
262998,B93185B4820D7E0DEE74EBEA00941D15,38291,0,1,1,109.51618,18.24313,1558
262999,B93185B4820D7E0DEE74EBEA00941D15,31461,1,2,1,109.5091,18.25389,1510
263000,B93185B4820D7E0DEE74EBEA00941D15,30911,3,19,16,109.50493,18.26181,1511
263001,B93185B4820D7E0DEE74EBEA00941D15,38291,21,23,2,109.51618,18.24313,1558
263011,209E8D959023269E16675F9705586E6A,38071,22,23,1,109.40722,18.30938,1169
263039,6E2021B014C4D0B652A2E4FE8D2CF038,31071,0,8,8,109.58257,18.28458,1815
263040,6E2021B014C4D0B652A2E4FE8D2CF038,30854,8,9,1,109.56889,18.27076,1763
263041,6E2021B014C4D0B652A2E4FE8D2CF038,31071,13,14,1,109.58257,18.28458,1815
263042,6E2021B014C4D0B652A2E4FE8D2CF038,30854,16,17,1,109.56889,18.27076,1763
263048,75BB5F056A285E641293B913E6CE7C17,30741,12,13,1,109.49833,18.28681,1516
263049,75BB5F056A285E641293B913E6CE7C17,31431,14,17,3,109.44639,18.29042,1316
263050,75BB5F056A285E641293B913E6CE7C17,31411,19,22,3,109.5016,18.23576,1507
263096,CD77A45360FB53F816FCE62F008EEE28,30071,0,7,7,109.52819,18.30472,1619
263097,CD77A45360FB53F816FCE62F008EEE28,31931,7,10,3,109.54771,18.29403,1667
263098,121138E269BBF0B506FA8CE6CEB3BF52,31931,0,13,13,109.54771,18.29403,1667
263099,121138E269BBF0B506FA8CE6CEB3BF52,39181,16,17,1,109.55153,18.28035,1715
263100,121138E269BBF0B506FA8CE6CEB3BF52,31931,18,23,5,109.54771,18.29403,1667
263130,3520FED22A4D572CBFE1B08BD2743E22,30511,0,4,4,109.51069,18.24208,1558
263131,3520FED22A4D572CBFE1B08BD2743E22,31391,7,19,12,109.50382,18.24285,1508
263132,3520FED22A4D572CBFE1B08BD2743E22,60291,21,23,2,109.50826,18.24639,1509
263147,EE40D0798B945060F5E3D3F0B9F1FF61,60381,0,7,7,109.5241,18.22458,1605
263148,EE40D0798B945060F5E3D3F0B9F1FF61,30661,10,12,2,109.37028,18.24361,1008
263149,EE40D0798B945060F5E3D3F0B9F1FF61,31471,14,15,1,109.34583,18.29563,917
263150,EE40D0798B945060F5E3D3F0B9F1FF61,31021,18,19,1,109.49021,18.27,1463
263151,EE40D0798B945060F5E3D3F0B9F1FF61,60381,20,23,3,109.5241,18.22458,1605
263193,D5BEC8AF00E93F31B9CBBFA811022B26,31031,19,20,1,109.49979,18.25382,1510
263194,D5BEC8AF00E93F31B9CBBFA811022B26,60161,21,22,1,109.49174,18.26181,1461
263200,7B9D64657CE26DF907B4C2AC87C9F431,38241,8,18,10,109.54111,18.30542,1669
263201,7B9D64657CE26DF907B4C2AC87C9F431,31931,18,20,2,109.54771,18.29403,1667
263219,92A852F4802D3D92C195A90A9645A57F,38325,16,17,1,109.39792,18.2909,1116
263220,92A852F4802D3D92C195A90A9645A57F,38903,21,22,1,109.39229,18.29243,1117
263221,C82725A09C032EE9BFF2088FCCC60D1D,30854,1,11,10,109.56889,18.27076,1763
263222,C82725A09C032EE9BFF2088FCCC60D1D,31071,13,15,2,109.58257,18.28458,1815
263223,C82725A09C032EE9BFF2088FCCC60D1D,30854,16,18,2,109.56889,18.27076,1763
263224,DBB710D279E76C79F1E4B0766F579F8A,30854,14,17,3,109.56889,18.27076,1763
263225,DBB710D279E76C79F1E4B0766F579F8A,31931,17,19,2,109.54771,18.29403,1667
263226,DBB710D279E76C79F1E4B0766F579F8A,30854,21,22,1,109.56889,18.27076,1763
263235,8799356B7181F28146A203E5F86C52F0,31351,0,19,19,109.4959,18.28417,1465
263236,8799356B7181F28146A203E5F86C52F0,30741,20,23,3,109.49833,18.28681,1516
263257,73EAC1341C5005A58B26B1A52457F38B,31181,0,4,4,109.50382,18.24813,1509
263258,73EAC1341C5005A58B26B1A52457F38B,31181,5,14,9,109.50382,18.24813,1509
263259,73EAC1341C5005A58B26B1A52457F38B,30121,15,18,3,109.52861,18.27222,1613
263268,3DF04EEBD52CECF1C5996BD8607451EE,60084,14,15,1,109.4984,18.2334,1507
263269,3DF04EEBD52CECF1C5996BD8607451EE,30441,19,20,1,109.64021,18.25424,2010
263286,66A68DF7322984DDFD4069A80816FA0D,38052,13,14,1,109.62618,18.23042,1956
263287,66A68DF7322984DDFD4069A80816FA0D,31221,18,19,1,109.61333,18.26833,1913
263288,A2DBFF4E352E7B7C1EE25431C02FC741,30921,2,4,2,109.53903,18.29451,1667
263289,A2DBFF4E352E7B7C1EE25431C02FC741,31931,5,19,14,109.54771,18.29403,1667
263313,000584B3023702F3E9DDF521B1C35B1A,31945,1,2,1,109.58021,18.29403,1817
263314,000584B3023702F3E9DDF521B1C35B1A,60354,3,5,2,109.58701,18.28521,1815
263315,000584B3023702F3E9DDF521B1C35B1A,31945,6,7,1,109.58021,18.29403,1817
263316,000584B3023702F3E9DDF521B1C35B1A,30221,15,17,2,109.57833,18.20222,1802
263317,000584B3023702F3E9DDF521B1C35B1A,30854,18,20,2,109.56889,18.27076,1763
263318,7EBC20D0E5F0FBA046CA1D08E7FF47C1,31071,6,8,2,109.58257,18.28458,1815
263319,7EBC20D0E5F0FBA046CA1D08E7FF47C1,30854,12,13,1,109.56889,18.27076,1763
263346,3C5AEA306E8A69C707195C4150E77D90,31931,1,6,5,109.54771,18.29403,1667
263347,3C5AEA306E8A69C707195C4150E77D90,39181,7,9,2,109.55153,18.28035,1715
263348,3C5AEA306E8A69C707195C4150E77D90,31931,13,20,7,109.54771,18.29403,1667
263365,116946A75ECB7D461042B4C21CF61908,30111,3,8,5,109.47583,18.30542,1419
263366,116946A75ECB7D461042B4C21CF61908,31181,10,11,1,109.50382,18.24813,1509
263367,116946A75ECB7D461042B4C21CF61908,30111,13,14,1,109.47583,18.30542,1419
263399,F5E480BCE870DAE347CB60AA32F4CA1B,31071,0,4,4,109.58257,18.28458,1815
263400,F5E480BCE870DAE347CB60AA32F4CA1B,30854,7,8,1,109.56889,18.27076,1763
263401,F5E480BCE870DAE347CB60AA32F4CA1B,31071,12,13,1,109.58257,18.28458,1815
263417,020753EF78F0A0C39658113A3377EA1E,31931,14,17,3,109.54771,18.29403,1667
263418,020753EF78F0A0C39658113A3377EA1E,31561,19,20,1,109.56792,18.28479,1765
263419,78F41A3C97446FDE39A7BB3208341D35,31021,2,6,4,109.49021,18.27,1463
263420,78F41A3C97446FDE39A7BB3208341D35,31271,6,8,2,109.48958,18.26257,1462
263421,78F41A3C97446FDE39A7BB3208341D35,31021,8,9,1,109.49021,18.27,1463
263422,78F41A3C97446FDE39A7BB3208341D35,30201,11,16,5,109.4909,18.26465,1462
263423,78F41A3C97446FDE39A7BB3208341D35,31021,17,20,3,109.49021,18.27,1463
263424,78F41A3C97446FDE39A7BB3208341D35,39061,22,23,1,109.38222,18.28958,1066
263433,06FE0B1385071A4A7D315725DC72CBEB,38754,18,19,1,109.74667,18.37382,2430
263434,06FE0B1385071A4A7D315725DC72CBEB,60201,21,23,2,109.5041,18.2509,1510
263435,1122041491C04B199A15F6E1E401D68F,60281,0,9,9,109.51743,18.25924,1561
263436,1122041491C04B199A15F6E1E401D68F,30461,12,19,7,109.5116,18.26313,1562
263437,1122041491C04B199A15F6E1E401D68F,60291,20,22,2,109.50826,18.24639,1509
263441,855A60A5BCB36D799943E99FBF88EAD0,31864,0,8,8,109.49014,18.28333,1465
263442,855A60A5BCB36D799943E99FBF88EAD0,60551,9,10,1,109.42722,18.30111,1218
263443,855A60A5BCB36D799943E99FBF88EAD0,31781,11,13,2,109.19847,18.2975,367
263444,855A60A5BCB36D799943E99FBF88EAD0,60054,14,16,2,109.3016,18.31229,770
263501,A0D3E6D96C80E44901F7F9B3B58D5A1A,30421,10,13,3,109.50021,18.25861,1511
263502,A0D3E6D96C80E44901F7F9B3B58D5A1A,31121,16,17,1,109.16292,18.37063,230
263520,2F578B567AB440CCCFAE4543FB5BCFD7,30421,14,16,2,109.50021,18.25861,1511
263521,2F578B567AB440CCCFAE4543FB5BCFD7,60201,16,18,2,109.5041,18.2509,1510
263522,2F578B567AB440CCCFAE4543FB5BCFD7,60161,18,19,1,109.49174,18.26181,1461
263523,51061B3DE820AF1C1C713EF684728003,31071,1,7,6,109.58257,18.28458,1815
263524,51061B3DE820AF1C1C713EF684728003,30854,9,19,10,109.56889,18.27076,1763
263525,51061B3DE820AF1C1C713EF684728003,60354,20,23,3,109.58701,18.28521,1815
263530,213AF2099653A4ADAEF799CCC144B279,30021,3,10,7,109.12014,18.40986,86
263544,4C677DC1CDBE32E026FB887DD09EFEC7,60201,0,7,7,109.5041,18.2509,1510
263545,4C677DC1CDBE32E026FB887DD09EFEC7,31781,10,13,3,109.19847,18.2975,367
263546,4C677DC1CDBE32E026FB887DD09EFEC7,31471,16,17,1,109.34583,18.29563,917
263573,1980C8D409DE9551539224B3D393CDAA,30071,0,8,8,109.52819,18.30472,1619
263574,1980C8D409DE9551539224B3D393CDAA,31951,8,13,5,109.52174,18.30299,1568
263575,1980C8D409DE9551539224B3D393CDAA,30071,13,23,10,109.52819,18.30472,1619
263595,D9AE11CD16B231308C3F0FB3F53BC3E9,30854,0,17,17,109.56889,18.27076,1763
263596,D9AE11CD16B231308C3F0FB3F53BC3E9,31931,18,21,3,109.54771,18.29403,1667
263642,8B9A9BFD1ACAD480EB101A91DBF2024D,38291,4,15,11,109.51618,18.24313,1558
263643,8B9A9BFD1ACAD480EB101A91DBF2024D,30371,16,18,2,109.51,18.24771,1559
263711,D618A6C3100C9BD1930907167F1B2D2D,31251,18,23,5,109.18528,18.2975,317
263756,C983E73D646629A775690ECA8920EB29,30101,0,6,6,109.57299,18.33333,1773
263757,C983E73D646629A775690ECA8920EB29,31631,7,16,9,109.59542,18.36826,1879
263758,C983E73D646629A775690ECA8920EB29,30101,17,18,1,109.57299,18.33333,1773
263796,DECFA2425C3F22CB4A82B4145E73203B,60524,0,3,3,109.42951,18.28993,1216
263797,DECFA2425C3F22CB4A82B4145E73203B,60552,3,5,2,109.41729,18.30014,1218
263798,DECFA2425C3F22CB4A82B4145E73203B,60041,8,9,1,109.39889,18.31944,1121
263799,DECFA2425C3F22CB4A82B4145E73203B,60552,13,19,6,109.41729,18.30014,1218
263802,BA661398B83717FCC0BF595ECF74D89D,30561,0,9,9,109.52778,18.31938,1621
263803,BA661398B83717FCC0BF595ECF74D89D,31031,10,12,2,109.49979,18.25382,1510
263804,BA661398B83717FCC0BF595ECF74D89D,60361,13,17,4,109.51938,18.29681,1567
263805,BA661398B83717FCC0BF595ECF74D89D,60381,18,21,3,109.5241,18.22458,1605
263806,BA661398B83717FCC0BF595ECF74D89D,30561,22,23,1,109.52778,18.31938,1621
263852,FA724E83D7D22E41E07D0D2550D22166,30854,0,10,10,109.56889,18.27076,1763
263853,FA724E83D7D22E41E07D0D2550D22166,39371,11,13,2,109.56627,18.2646,1762
263854,FA724E83D7D22E41E07D0D2550D22166,30854,16,23,7,109.56889,18.27076,1763
263861,9EBFE19AEC38C3A6F47AE2D903294BAE,30854,0,2,2,109.56889,18.27076,1763
263862,9EBFE19AEC38C3A6F47AE2D903294BAE,31561,3,5,2,109.56792,18.28479,1765
263863,9EBFE19AEC38C3A6F47AE2D903294BAE,30854,6,10,4,109.56889,18.27076,1763
263864,9EBFE19AEC38C3A6F47AE2D903294BAE,31761,13,14,1,109.60521,18.27965,1914
263865,9EBFE19AEC38C3A6F47AE2D903294BAE,30854,14,16,2,109.56889,18.27076,1763
263866,9EBFE19AEC38C3A6F47AE2D903294BAE,31164,17,20,3,109.69993,18.27215,2263
263867,7890099D98AA300C5BF12527E7372DB0,31071,13,17,4,109.58257,18.28458,1815
263868,7890099D98AA300C5BF12527E7372DB0,60631,19,23,4,109.57778,18.27583,1814
263908,C5062DBE2A03371DC4B3A666E439E273,60077,14,16,2,109.75764,18.31424,2470
263910,C5062DBE2A03371DC4B3A666E439E273,60077,19,23,4,109.75764,18.31424,2470
263929,C0D13B38478FDA6E2CD0CFA376A29EAB,30721,0,15,15,109.51597,18.28257,1565
263930,C0D13B38478FDA6E2CD0CFA376A29EAB,38251,17,19,2,109.49618,18.25493,1510
263931,C0D13B38478FDA6E2CD0CFA376A29EAB,30721,21,23,2,109.51597,18.28257,1565
263941,4CC3058F56A42FB99DF66B1D4EA3395F,30421,0,8,8,109.50021,18.25861,1511
263942,4CC3058F56A42FB99DF66B1D4EA3395F,30771,10,11,1,109.49938,18.26042,1511
263943,4CC3058F56A42FB99DF66B1D4EA3395F,30771,16,23,7,109.49938,18.26042,1511
263960,40285EE8CCE25C38988EC087545664EC,31071,2,7,5,109.58257,18.28458,1815
263961,40285EE8CCE25C38988EC087545664EC,30854,7,15,8,109.56889,18.27076,1763
264037,C8922FAF66F21ECAECB6B717FCD5A53B,60614,0,16,16,109.48799,18.29521,1467
264038,C8922FAF66F21ECAECB6B717FCD5A53B,60391,17,18,1,109.47667,18.28757,1416
264039,C8922FAF66F21ECAECB6B717FCD5A53B,60614,18,21,3,109.48799,18.29521,1467
264040,7D1ED6067ECBD941EFC43CE0A6ADAE71,31071,13,17,4,109.58257,18.28458,1815
264041,7D1ED6067ECBD941EFC43CE0A6ADAE71,31071,19,21,2,109.58257,18.28458,1815
264046,9E8746086915F9D4A063A74CF0B5B7AB,31561,0,6,6,109.56792,18.28479,1765
264047,9E8746086915F9D4A063A74CF0B5B7AB,39183,9,10,1,109.55542,18.28208,1715
264064,83F5F6CBF2A63352524671B510BBFB08,30281,20,21,1,109.50597,18.27583,1514
264065,83F5F6CBF2A63352524671B510BBFB08,30191,21,22,1,109.50361,18.22701,1506
264090,51DF765CB634D9549D20AD1F2C37BA18,31561,5,6,1,109.56792,18.28479,1765
264091,51DF765CB634D9549D20AD1F2C37BA18,30854,11,12,1,109.56889,18.27076,1763
264092,51DF765CB634D9549D20AD1F2C37BA18,31561,12,13,1,109.56792,18.28479,1765
264093,51DF765CB634D9549D20AD1F2C37BA18,30854,14,20,6,109.56889,18.27076,1763
264094,51DF765CB634D9549D20AD1F2C37BA18,31561,20,23,3,109.56792,18.28479,1765
264095,487521C796C9B83A04D2BF725345DF16,33481,15,17,2,109.67278,18.41278,2187
264096,487521C796C9B83A04D2BF725345DF16,38754,18,19,1,109.74667,18.37382,2430
264133,1419F2503130508E06D5FA0D4A5CF329,31031,0,9,9,109.49979,18.25382,1510
264134,1419F2503130508E06D5FA0D4A5CF329,31261,13,20,7,109.51174,18.2466,1559
264135,1419F2503130508E06D5FA0D4A5CF329,60291,22,23,1,109.50826,18.24639,1509
264161,31C925B9876FE9FFC3F673B5040150FB,31521,0,6,6,109.51458,18.22542,1555
264162,31C925B9876FE9FFC3F673B5040150FB,31521,7,9,2,109.51458,18.22542,1555
264163,31C925B9876FE9FFC3F673B5040150FB,31781,11,13,2,109.19847,18.2975,367
264164,31C925B9876FE9FFC3F673B5040150FB,31521,15,22,7,109.51458,18.22542,1555
264167,968E09217B26E1E21B124536BDB6DBAA,31931,0,9,9,109.54771,18.29403,1667
264168,968E09217B26E1E21B124536BDB6DBAA,30921,12,13,1,109.53903,18.29451,1667
264173,6FD88D74D66E8FAB66A93CB5D0609C41,31071,13,15,2,109.58257,18.28458,1815
264174,6FD88D74D66E8FAB66A93CB5D0609C41,30854,17,19,2,109.56889,18.27076,1763
264175,6FD88D74D66E8FAB66A93CB5D0609C41,31071,20,22,2,109.58257,18.28458,1815
264181,08A066736557478B1013C0CF834491DF,30921,0,7,7,109.53903,18.29451,1667
264182,08A066736557478B1013C0CF834491DF,31931,10,20,10,109.54771,18.29403,1667
264183,08A066736557478B1013C0CF834491DF,30921,20,21,1,109.53903,18.29451,1667
264184,F3C7AE04A75E030C03A36AADCEE442EA,38321,10,14,4,109.39854,18.29132,1116
264185,F3C7AE04A75E030C03A36AADCEE442EA,38321,19,23,4,109.39854,18.29132,1116
264212,52D077B19C6C1BD347E6DC20309A3DC3,31071,0,13,13,109.58257,18.28458,1815
264213,52D077B19C6C1BD347E6DC20309A3DC3,30854,16,17,1,109.56889,18.27076,1763
264214,52D077B19C6C1BD347E6DC20309A3DC3,31071,20,23,3,109.58257,18.28458,1815
264227,E75CF54BA14775FEDD26504F9F6B7365,31945,1,5,4,109.58021,18.29403,1817
264228,E75CF54BA14775FEDD26504F9F6B7365,31561,7,14,7,109.56792,18.28479,1765
264229,E75CF54BA14775FEDD26504F9F6B7365,30854,17,19,2,109.56889,18.27076,1763
264230,00FC332040A284DA251A8D0705989FE9,31071,1,2,1,109.58257,18.28458,1815
264231,00FC332040A284DA251A8D0705989FE9,31945,2,4,2,109.58021,18.29403,1817
264232,00FC332040A284DA251A8D0705989FE9,31071,4,5,1,109.58257,18.28458,1815
264233,00FC332040A284DA251A8D0705989FE9,30854,10,15,5,109.56889,18.27076,1763
264244,8FFDB178B42E132A09286D0A8A4D99CA,31521,0,1,1,109.51458,18.22542,1555
264245,8FFDB178B42E132A09286D0A8A4D99CA,39321,1,5,4,109.529,18.2167,1604
264246,8FFDB178B42E132A09286D0A8A4D99CA,31521,10,16,6,109.51458,18.22542,1555
264247,8FFDB178B42E132A09286D0A8A4D99CA,31521,19,22,3,109.51458,18.22542,1555
264276,6FF08122E48AB794FE75A66E236D4C05,31521,0,13,13,109.51458,18.22542,1555
264277,6FF08122E48AB794FE75A66E236D4C05,60381,13,14,1,109.5241,18.22458,1605
264278,6FF08122E48AB794FE75A66E236D4C05,31521,14,17,3,109.51458,18.22542,1555
264279,6FF08122E48AB794FE75A66E236D4C05,39111,22,23,1,109.5191,18.22597,1555
264295,140E49D84073576933F5061FC541290E,31321,0,7,7,109.63799,18.23201,2007
264296,140E49D84073576933F5061FC541290E,60381,8,9,1,109.5241,18.22458,1605
264297,140E49D84073576933F5061FC541290E,31781,11,14,3,109.19847,18.2975,367
264298,140E49D84073576933F5061FC541290E,31471,15,17,2,109.34583,18.29563,917
264299,140E49D84073576933F5061FC541290E,30581,20,21,1,109.62257,18.24951,1959
264315,58418A9EA4A7DC03127CB79C039A5185,31851,7,10,3,109.71736,18.29007,2316
264316,58418A9EA4A7DC03127CB79C039A5185,30854,13,17,4,109.56889,18.27076,1763
264394,DFFF17B7FE30E79B8AABBB5CE171272F,31561,3,9,6,109.56792,18.28479,1765
264395,DFFF17B7FE30E79B8AABBB5CE171272F,39183,9,11,2,109.55542,18.28208,1715
264396,DFFF17B7FE30E79B8AABBB5CE171272F,31561,15,16,1,109.56792,18.28479,1765
264409,B34415F599F0ED7D1A073EE314A60B9B,31671,0,11,11,109.38965,18.29813,1068
264410,B34415F599F0ED7D1A073EE314A60B9B,60041,12,13,1,109.39889,18.31944,1121
264411,B34415F599F0ED7D1A073EE314A60B9B,31671,16,19,3,109.38965,18.29813,1068
264412,B34415F599F0ED7D1A073EE314A60B9B,31031,20,21,1,109.49979,18.25382,1510
264421,31B5749A66C854438247EB4202810257,39321,12,14,2,109.529,18.2167,1604
264422,31B5749A66C854438247EB4202810257,60381,14,17,3,109.5241,18.22458,1605
264423,31B5749A66C854438247EB4202810257,30161,18,19,1,109.50042,18.24389,1508
264424,31B5749A66C854438247EB4202810257,60381,20,21,1,109.5241,18.22458,1605
264454,70655AD92B06CDB42EC8BC912F906F64,60231,13,16,3,109.49903,18.21972,1504
264455,70655AD92B06CDB42EC8BC912F906F64,39091,20,21,1,109.50097,18.25222,1510
264461,EC4B90EDBF35256FDB4D4F8B87DB8A04,30854,15,16,1,109.56889,18.27076,1763
264462,EC4B90EDBF35256FDB4D4F8B87DB8A04,30271,19,21,2,109.49132,18.23153,1456
264543,90AC20E6CC0B4ABA3A4EAC5C3086C030,31351,18,19,1,109.4959,18.28417,1465
264544,90AC20E6CC0B4ABA3A4EAC5C3086C030,30391,21,23,2,109.4975,18.27118,1513
264597,2C7DB696A14A5E061C2912E5376233C9,31071,6,12,6,109.58257,18.28458,1815
264598,2C7DB696A14A5E061C2912E5376233C9,30854,14,16,2,109.56889,18.27076,1763
264599,2C7DB696A14A5E061C2912E5376233C9,31071,19,23,4,109.58257,18.28458,1815
264618,0509306A3FC9EC5D9E03F62CADA412D1,31471,15,17,2,109.34583,18.29563,917
264619,0509306A3FC9EC5D9E03F62CADA412D1,31061,21,23,2,109.53333,18.23257,1607
264624,03CEC0FDDD5484124514C6D24A63D4DD,39183,14,16,2,109.55542,18.28208,1715
264625,03CEC0FDDD5484124514C6D24A63D4DD,31561,18,19,1,109.56792,18.28479,1765
264676,5F5C4FD8AEBF5C6D1106F430084E66FA,31931,6,11,5,109.54771,18.29403,1667
264677,5F5C4FD8AEBF5C6D1106F430084E66FA,30921,11,13,2,109.53903,18.29451,1667
264690,AF125EFCC483E24833CBDDBC7248BDF1,38721,0,8,8,109.50368,18.27542,1514
264691,AF125EFCC483E24833CBDDBC7248BDF1,30281,11,16,5,109.50597,18.27583,1514
264714,14F1CC63CDA098F9694EAC8584B9C7A5,31071,4,7,3,109.58257,18.28458,1815
264715,14F1CC63CDA098F9694EAC8584B9C7A5,30854,11,13,2,109.56889,18.27076,1763
264739,E218C587552A5DADC05C4E69685FE374,30854,0,2,2,109.56889,18.27076,1763
264740,E218C587552A5DADC05C4E69685FE374,39183,5,19,14,109.55542,18.28208,1715
264741,E218C587552A5DADC05C4E69685FE374,38071,21,22,1,109.40722,18.30938,1169
264742,82FA50C876D91311B7DA8BB626927288,31945,9,10,1,109.58021,18.29403,1817
264743,82FA50C876D91311B7DA8BB626927288,30854,11,16,5,109.56889,18.27076,1763
264744,82FA50C876D91311B7DA8BB626927288,38141,17,23,6,109.39479,18.2916,1116
264788,1D8B814EC83D52D7C5F3FED99C129EE0,30854,0,10,10,109.56889,18.27076,1763
264789,1D8B814EC83D52D7C5F3FED99C129EE0,31071,10,13,3,109.58257,18.28458,1815
264790,1D8B814EC83D52D7C5F3FED99C129EE0,38271,14,18,4,109.62632,18.23049,1956
264791,1D8B814EC83D52D7C5F3FED99C129EE0,31861,20,23,3,109.49042,18.27549,1464
264797,0CBDBB0FD86E41225B8F6BD8B7F216EA,38541,19,21,2,109.73715,18.34875,2426
264893,7C4B45B599684104AFE3AA992CD3924A,60211,2,15,13,109.63549,18.26049,2011
264894,7C4B45B599684104AFE3AA992CD3924A,30811,17,20,3,109.65188,18.26257,2062
264895,7C4B45B599684104AFE3AA992CD3924A,60211,21,23,2,109.63549,18.26049,2011
264975,2F64FEF19C86AA0A8AA3E3FA37CC4F2D,30851,0,2,2,109.5616,18.27396,1713
264976,2F64FEF19C86AA0A8AA3E3FA37CC4F2D,60631,2,23,21,109.57778,18.27583,1814
265000,5BC86F424BAF4B877A98262DEDE87053,38154,2,12,10,109.5266,18.28278,1615
265001,5BC86F424BAF4B877A98262DEDE87053,60201,13,15,2,109.5041,18.2509,1510
265002,C17A8098B013F904BD9DA05D90234A30,30581,0,8,8,109.62257,18.24951,1959
265003,C17A8098B013F904BD9DA05D90234A30,31221,11,15,4,109.61333,18.26833,1913
265011,DE91F768E6CCDB78867FF54F078574C9,30854,13,17,4,109.56889,18.27076,1763
265012,DE91F768E6CCDB78867FF54F078574C9,60381,19,21,2,109.5241,18.22458,1605
265039,7BF65E5054DA81A230AB5423620158E1,30854,11,15,4,109.56889,18.27076,1763
265040,7BF65E5054DA81A230AB5423620158E1,31164,17,19,2,109.69993,18.27215,2263
265041,7BF65E5054DA81A230AB5423620158E1,30191,22,23,1,109.50361,18.22701,1506
265042,ED3CB0620A65788A56B29EB6491965A0,30461,0,12,12,109.5116,18.26313,1562
265043,ED3CB0620A65788A56B29EB6491965A0,31461,12,14,2,109.5091,18.25389,1510
265044,ED3CB0620A65788A56B29EB6491965A0,60281,14,15,1,109.51743,18.25924,1561
265045,ED3CB0620A65788A56B29EB6491965A0,38881,18,23,5,109.51618,18.26431,1562
265070,440F19E22CD489CB40DEAEB72E820CF6,31421,0,6,6,109.55382,18.22347,1705
265071,440F19E22CD489CB40DEAEB72E820CF6,31561,9,10,1,109.56792,18.28479,1765
265072,440F19E22CD489CB40DEAEB72E820CF6,30221,14,15,1,109.57833,18.20222,1802
265096,21EC4C8BDFA621F6D49F50C6AB1C3F22,30821,16,17,1,109.43681,18.33639,1274
265097,21EC4C8BDFA621F6D49F50C6AB1C3F22,38951,19,23,4,109.48097,18.28868,1416
265098,FF374776E6D44861C88B04D75BCDE244,30181,0,14,14,109.51597,18.23313,1557
265099,FF374776E6D44861C88B04D75BCDE244,31201,14,23,9,109.51042,18.23819,1558
265116,9352766CE000C006A9C46226806783DB,31561,6,7,1,109.56792,18.28479,1765
265117,9352766CE000C006A9C46226806783DB,60541,10,12,2,109.4084,18.29208,1167
265118,9352766CE000C006A9C46226806783DB,31561,14,15,1,109.56792,18.28479,1765
265119,9352766CE000C006A9C46226806783DB,30854,16,18,2,109.56889,18.27076,1763
265236,6C0260646767B781577B5B8CE2471E51,38484,0,11,11,109.53028,18.31528,1620
265237,6C0260646767B781577B5B8CE2471E51,38484,11,13,2,109.53028,18.31528,1620
265238,6C0260646767B781577B5B8CE2471E51,38484,13,15,2,109.53028,18.31528,1620
265239,6C0260646767B781577B5B8CE2471E51,30561,19,21,2,109.52778,18.31938,1621
265240,20C15B76A1E0DF79D86EDEAC7BC3D7B7,31945,1,5,4,109.58021,18.29403,1817
265241,20C15B76A1E0DF79D86EDEAC7BC3D7B7,30854,5,8,3,109.56889,18.27076,1763
265242,20C15B76A1E0DF79D86EDEAC7BC3D7B7,31071,10,23,13,109.58257,18.28458,1815
265249,28A67AC0647BDCD2E98A0545DD1F804F,30854,12,13,1,109.56889,18.27076,1763
265250,28A67AC0647BDCD2E98A0545DD1F804F,60361,17,19,2,109.51938,18.29681,1567
265251,28A67AC0647BDCD2E98A0545DD1F804F,30741,19,21,2,109.49833,18.28681,1516
265260,8F6EA1C108FADA76A214A7ED71ECE3D1,30891,4,5,1,109.59431,18.28389,1865
265261,8F6EA1C108FADA76A214A7ED71ECE3D1,30854,7,14,7,109.56889,18.27076,1763
265289,D3CAC84BD13A9221A0C5DFD0311E5931,31151,0,8,8,109.75549,18.4191,2488
265290,D3CAC84BD13A9221A0C5DFD0311E5931,60117,9,11,2,109.73604,18.35681,2427
265291,D3CAC84BD13A9221A0C5DFD0311E5931,31151,12,14,2,109.75549,18.4191,2488
265292,D3CAC84BD13A9221A0C5DFD0311E5931,60381,15,16,1,109.5241,18.22458,1605
265293,D3CAC84BD13A9221A0C5DFD0311E5931,31031,17,21,4,109.49979,18.25382,1510
265294,D3CAC84BD13A9221A0C5DFD0311E5931,60571,21,22,1,109.50722,18.25056,1510
265301,7E6785B0140786E78D38CB13406ECE42,60054,14,16,2,109.3016,18.31229,770
265302,7E6785B0140786E78D38CB13406ECE42,30861,18,23,5,109.52722,18.22743,1606
265319,74B59B7AC338E4BD1734CAA94AEFECB9,39321,2,12,10,109.529,18.2167,1604
265320,74B59B7AC338E4BD1734CAA94AEFECB9,31041,13,15,2,109.50278,18.23701,1507
265327,FC538491B51012B0C69C7B5B7058D494,48571,15,17,2,109.48368,18.28854,1466
265328,FC538491B51012B0C69C7B5B7058D494,48571,21,23,2,109.48368,18.28854,1466
265329,EF7DCA5602FCDF14AF156D676A8ED902,30851,0,1,1,109.5616,18.27396,1713
265330,EF7DCA5602FCDF14AF156D676A8ED902,31561,4,19,15,109.56792,18.28479,1765
265371,99B228F0AF2782D11BEEBEDCE5C3BC46,30421,11,13,2,109.50021,18.25861,1511
265372,99B228F0AF2782D11BEEBEDCE5C3BC46,60084,13,16,3,109.4984,18.2334,1507
265381,FC4E540B07DB36C2A24C73051E1FA6C0,30171,0,5,5,109.48458,18.27139,1463
265382,FC4E540B07DB36C2A24C73051E1FA6C0,60621,6,9,3,109.48354,18.27451,1464
265383,FC4E540B07DB36C2A24C73051E1FA6C0,60401,9,16,7,109.47444,18.27583,1414
265384,FC4E540B07DB36C2A24C73051E1FA6C0,30171,17,23,6,109.48458,18.27139,1463
265397,162C9DF38B34BB5029840E39407B0BD5,39191,0,7,7,109.51493,18.23472,1557
265398,162C9DF38B34BB5029840E39407B0BD5,31041,8,22,14,109.50278,18.23701,1507
265487,30CE72A519D49881F23B8123486E3A02,60411,0,9,9,109.32514,18.30854,869
265488,30CE72A519D49881F23B8123486E3A02,31471,10,11,1,109.34583,18.29563,917
265489,30CE72A519D49881F23B8123486E3A02,60411,12,18,6,109.32514,18.30854,869
265508,64FF3E93355E6DCA29977E04D316EABA,31381,1,10,9,109.1375,18.36833,129
265510,64FF3E93355E6DCA29977E04D316EABA,30151,16,21,5,109.50986,18.25083,1560
265511,64FF3E93355E6DCA29977E04D316EABA,60131,21,22,1,109.49819,18.24778,1509
265528,408C4FED868686E7B96333835F4C4205,31071,0,5,5,109.58257,18.28458,1815
265529,408C4FED868686E7B96333835F4C4205,30854,9,10,1,109.56889,18.27076,1763
265530,408C4FED868686E7B96333835F4C4205,31071,10,15,5,109.58257,18.28458,1815
265531,408C4FED868686E7B96333835F4C4205,30854,16,22,6,109.56889,18.27076,1763
265550,798BF3B08F72A16A6DEAAA235F1899BB,61011,0,3,3,109.60653,18.19076,1900
265552,798BF3B08F72A16A6DEAAA235F1899BB,61011,11,13,2,109.60653,18.19076,1900
265554,798BF3B08F72A16A6DEAAA235F1899BB,61011,16,18,2,109.60653,18.19076,1900
265580,4DACD9C7A334B4FC26114503CE8EB0EA,60551,0,4,4,109.42722,18.30111,1218
265581,4DACD9C7A334B4FC26114503CE8EB0EA,60524,4,6,2,109.42951,18.28993,1216
265582,4DACD9C7A334B4FC26114503CE8EB0EA,30351,7,8,1,109.41701,18.29292,1217
265583,4DACD9C7A334B4FC26114503CE8EB0EA,31301,10,12,2,109.14493,18.31222,170
265584,4DACD9C7A334B4FC26114503CE8EB0EA,60054,13,14,1,109.3016,18.31229,770
265585,4DACD9C7A334B4FC26114503CE8EB0EA,31201,16,18,2,109.51042,18.23819,1558
265586,4DACD9C7A334B4FC26114503CE8EB0EA,60551,21,23,2,109.42722,18.30111,1218
265656,9B979E9430BCD0DDB6C78BBE525EBD2D,60631,0,2,2,109.57778,18.27583,1814
265657,9B979E9430BCD0DDB6C78BBE525EBD2D,30854,6,12,6,109.56889,18.27076,1763
265658,9B979E9430BCD0DDB6C78BBE525EBD2D,39371,16,22,6,109.56627,18.2646,1762
265741,C1F100A79C441D3FFDBAE922D32DC8D2,39371,3,4,1,109.56627,18.2646,1762
265742,C1F100A79C441D3FFDBAE922D32DC8D2,30854,6,23,17,109.56889,18.27076,1763
265743,6751CEC3CF9B2AE78246C7287443D2B4,30854,10,19,9,109.56889,18.27076,1763
265744,6751CEC3CF9B2AE78246C7287443D2B4,31945,20,21,1,109.58021,18.29403,1817
265745,FE25DC2B1C76400A045638C7D9F97891,30851,0,6,6,109.5616,18.27396,1713
265746,FE25DC2B1C76400A045638C7D9F97891,60631,7,16,9,109.57778,18.27583,1814
265806,4D4289AE0DFBF4B5C79A47559DC2EBDD,31071,0,11,11,109.58257,18.28458,1815
265807,4D4289AE0DFBF4B5C79A47559DC2EBDD,30854,11,15,4,109.56889,18.27076,1763
265808,4D4289AE0DFBF4B5C79A47559DC2EBDD,60463,17,18,1,109.52507,18.22438,1605
265809,59F29435D748531F416A4F1636997ECF,31071,0,7,7,109.58257,18.28458,1815
265810,59F29435D748531F416A4F1636997ECF,30854,7,9,2,109.56889,18.27076,1763
265811,68DBE0B52FD0AB95F1DD47068FD7847F,30181,0,10,10,109.51597,18.23313,1557
265812,68DBE0B52FD0AB95F1DD47068FD7847F,39111,12,14,2,109.5191,18.22597,1555
265813,68DBE0B52FD0AB95F1DD47068FD7847F,30181,14,17,3,109.51597,18.23313,1557
265814,68DBE0B52FD0AB95F1DD47068FD7847F,30181,17,23,6,109.51597,18.23313,1557
265843,C031035D6C98ABF453B46DABD1995154,30201,0,8,8,109.4909,18.26465,1462
265844,C031035D6C98ABF453B46DABD1995154,31301,9,11,2,109.14493,18.31222,170
265845,C031035D6C98ABF453B46DABD1995154,30371,15,16,1,109.51,18.24771,1559
265846,C031035D6C98ABF453B46DABD1995154,31431,17,18,1,109.44639,18.29042,1316
265847,C031035D6C98ABF453B46DABD1995154,31271,19,23,4,109.48958,18.26257,1462
265853,5C58BF30923366F68B9E9B57492E4E6A,30201,0,6,6,109.4909,18.26465,1462
265854,5C58BF30923366F68B9E9B57492E4E6A,31781,10,12,2,109.19847,18.2975,367
265855,5C58BF30923366F68B9E9B57492E4E6A,30201,17,23,6,109.4909,18.26465,1462
265867,7F377D9BD4A6752A92F213BA9B3E59E5,38251,0,10,10,109.49618,18.25493,1510
265868,7F377D9BD4A6752A92F213BA9B3E59E5,30421,10,12,2,109.50021,18.25861,1511
265869,7F377D9BD4A6752A92F213BA9B3E59E5,38251,12,14,2,109.49618,18.25493,1510
265870,7F377D9BD4A6752A92F213BA9B3E59E5,30421,15,16,1,109.50021,18.25861,1511
265871,7F377D9BD4A6752A92F213BA9B3E59E5,38251,17,18,1,109.49618,18.25493,1510
265872,7F377D9BD4A6752A92F213BA9B3E59E5,30421,20,23,3,109.50021,18.25861,1511
265891,522E8CB42AF22D75F3E9D0FD1FDCEEA6,30854,12,14,2,109.56889,18.27076,1763
265892,522E8CB42AF22D75F3E9D0FD1FDCEEA6,31521,18,20,2,109.51458,18.22542,1555
265909,066CC6CBB5ADF978A93AF5D0C3292806,31931,0,3,3,109.54771,18.29403,1667
265910,066CC6CBB5ADF978A93AF5D0C3292806,30071,3,7,4,109.52819,18.30472,1619
265911,066CC6CBB5ADF978A93AF5D0C3292806,60091,9,11,2,109.59729,18.30431,1869
265912,24C0932BD5754CA1476755EEBD27CEBD,31811,0,13,13,109.54201,18.31806,1671
265913,24C0932BD5754CA1476755EEBD27CEBD,30741,13,15,2,109.49833,18.28681,1516
265914,24C0932BD5754CA1476755EEBD27CEBD,38251,16,17,1,109.49618,18.25493,1510
265915,24C0932BD5754CA1476755EEBD27CEBD,60361,21,23,2,109.51938,18.29681,1567
265918,B2EAF2370DACE0D2E981BAA0267B94BE,39183,22,23,1,109.55542,18.28208,1715
265945,0EA31DC24D5B7028E03AA286B0DB11EF,31071,0,1,1,109.58257,18.28458,1815
265946,0EA31DC24D5B7028E03AA286B0DB11EF,30854,2,14,12,109.56889,18.27076,1763
265947,0EA31DC24D5B7028E03AA286B0DB11EF,60661,17,18,1,109.548,18.2377,1657
265948,0EA31DC24D5B7028E03AA286B0DB11EF,30854,19,22,3,109.56889,18.27076,1763
265980,2CF83F5125C6075E2ACA9C17C2979C64,31071,1,2,1,109.58257,18.28458,1815
265981,2CF83F5125C6075E2ACA9C17C2979C64,31071,2,3,1,109.58257,18.28458,1815
265982,2CF83F5125C6075E2ACA9C17C2979C64,30854,8,20,12,109.56889,18.27076,1763
265983,2CF83F5125C6075E2ACA9C17C2979C64,31071,20,21,1,109.58257,18.28458,1815
266042,EA4EEEA6F324C3F08DBAE63BA2B33BB6,30084,0,7,7,109.50118,18.26972,1513
266043,EA4EEEA6F324C3F08DBAE63BA2B33BB6,31391,7,9,2,109.50382,18.24285,1508
266044,EA4EEEA6F324C3F08DBAE63BA2B33BB6,30511,13,14,1,109.51069,18.24208,1558
266045,EA4EEEA6F324C3F08DBAE63BA2B33BB6,31181,17,19,2,109.50382,18.24813,1509
266046,EA4EEEA6F324C3F08DBAE63BA2B33BB6,30084,22,23,1,109.50118,18.26972,1513
266050,B19D039FEBAFACB75FE183A18A8FD559,30854,0,6,6,109.56889,18.27076,1763
266051,B19D039FEBAFACB75FE183A18A8FD559,33481,9,13,4,109.67278,18.41278,2187
266121,372A5433078073EAD18922D679CE0A73,60054,4,8,4,109.3016,18.31229,770
266122,372A5433078073EAD18922D679CE0A73,30661,9,10,1,109.37028,18.24361,1008
266123,372A5433078073EAD18922D679CE0A73,60054,10,11,1,109.3016,18.31229,770
266124,372A5433078073EAD18922D679CE0A73,30661,12,13,1,109.37028,18.24361,1008
266125,372A5433078073EAD18922D679CE0A73,60054,14,23,9,109.3016,18.31229,770
266133,2B52FA76118CEF84900876F721F81416,31351,19,22,3,109.4959,18.28417,1465
266213,65AD296DD65C9EEA3C22EA02904A768E,31561,1,7,6,109.56792,18.28479,1765
266214,65AD296DD65C9EEA3C22EA02904A768E,30854,8,18,10,109.56889,18.27076,1763
266215,65AD296DD65C9EEA3C22EA02904A768E,31561,18,19,1,109.56792,18.28479,1765
266216,D2112FF97338A1691790D531295A7953,30201,0,9,9,109.4909,18.26465,1462
266217,D2112FF97338A1691790D531295A7953,31781,11,12,1,109.19847,18.2975,367
266218,D2112FF97338A1691790D531295A7953,60054,15,16,1,109.3016,18.31229,770
266219,D2112FF97338A1691790D531295A7953,30201,17,18,1,109.4909,18.26465,1462
266220,D2112FF97338A1691790D531295A7953,30361,19,20,1,109.50347,18.24,1508
266249,45FA8AF959A216E06C82392E21728E7F,31071,0,8,8,109.58257,18.28458,1815
266250,45FA8AF959A216E06C82392E21728E7F,31561,9,11,2,109.56792,18.28479,1765
266251,45FA8AF959A216E06C82392E21728E7F,31071,13,14,1,109.58257,18.28458,1815
266252,45FA8AF959A216E06C82392E21728E7F,31561,16,17,1,109.56792,18.28479,1765
266312,875F4B80762D0E664890361D764F907D,60081,0,7,7,109.51097,18.22639,1556
266313,875F4B80762D0E664890361D764F907D,60231,7,17,10,109.49903,18.21972,1504
266314,875F4B80762D0E664890361D764F907D,60081,18,23,5,109.51097,18.22639,1556
266353,09C160BFB128F08F5906511FF56340F0,38023,0,10,10,109.37132,18.28993,1016
266354,09C160BFB128F08F5906511FF56340F0,60054,13,15,2,109.3016,18.31229,770
266355,09C160BFB128F08F5906511FF56340F0,38023,16,23,7,109.37132,18.28993,1016
266359,96664497BF518F17E0695975FE9417F5,31421,15,17,2,109.55382,18.22347,1705
266360,96664497BF518F17E0695975FE9417F5,30861,19,23,4,109.52722,18.22743,1606
266383,D2D609608AA1D4DD8E18DD3745793D0D,30854,0,3,3,109.56889,18.27076,1763
266384,D2D609608AA1D4DD8E18DD3745793D0D,31071,4,11,7,109.58257,18.28458,1815
266385,D2D609608AA1D4DD8E18DD3745793D0D,30854,12,13,1,109.56889,18.27076,1763
266386,D2D609608AA1D4DD8E18DD3745793D0D,39371,14,15,1,109.56627,18.2646,1762
266387,5561961A41FEBE8B8B0A897BFF076F9F,31121,0,2,2,109.16292,18.37063,230
266388,5561961A41FEBE8B8B0A897BFF076F9F,31301,2,10,8,109.14493,18.31222,170
266389,5561961A41FEBE8B8B0A897BFF076F9F,30854,11,16,5,109.56889,18.27076,1763
266390,5561961A41FEBE8B8B0A897BFF076F9F,31071,19,23,4,109.58257,18.28458,1815
266391,92AE5D206344DB3ADEF2488FC532EBB9,30854,8,10,2,109.56889,18.27076,1763
266392,92AE5D206344DB3ADEF2488FC532EBB9,31411,11,13,2,109.5016,18.23576,1507
266393,92AE5D206344DB3ADEF2488FC532EBB9,30361,13,15,2,109.50347,18.24,1508
266394,92AE5D206344DB3ADEF2488FC532EBB9,31071,18,20,2,109.58257,18.28458,1815
266395,92AE5D206344DB3ADEF2488FC532EBB9,30854,20,22,2,109.56889,18.27076,1763
266396,1DA88ED70B6ADE8EAE3D8F549B029C10,30511,1,6,5,109.51069,18.24208,1558
266397,1DA88ED70B6ADE8EAE3D8F549B029C10,60131,7,8,1,109.49819,18.24778,1509
266400,1DA88ED70B6ADE8EAE3D8F549B029C10,31031,17,23,6,109.49979,18.25382,1510
266403,D7D9352263CF977FD0E7820F34F6CA72,39101,0,1,1,109.50132,18.24931,1509
266404,D7D9352263CF977FD0E7820F34F6CA72,30151,2,11,9,109.50986,18.25083,1560
266405,D7D9352263CF977FD0E7820F34F6CA72,30151,12,14,2,109.50986,18.25083,1560
266411,81BB8442D113627FA1326BEB8BF192ED,60631,0,5,5,109.57778,18.27583,1814
266412,81BB8442D113627FA1326BEB8BF192ED,30854,6,8,2,109.56889,18.27076,1763
266413,81BB8442D113627FA1326BEB8BF192ED,31071,11,12,1,109.58257,18.28458,1815
266414,9B389AE8E9B004176803CCEAFF69104A,39101,12,13,1,109.50132,18.24931,1509
266415,9B389AE8E9B004176803CCEAFF69104A,60631,17,18,1,109.57778,18.27583,1814
266416,56B310842D84169C664B7D5E5FA918BC,60661,0,6,6,109.548,18.2377,1657
266417,56B310842D84169C664B7D5E5FA918BC,60641,6,10,4,109.53854,18.2359,1657
266418,56B310842D84169C664B7D5E5FA918BC,60661,10,12,2,109.548,18.2377,1657
266419,56B310842D84169C664B7D5E5FA918BC,60381,12,14,2,109.5241,18.22458,1605
266420,56B310842D84169C664B7D5E5FA918BC,31554,14,16,2,109.55521,18.2459,1709
266421,56B310842D84169C664B7D5E5FA918BC,38017,20,21,1,109.49729,18.21424,1504
266422,56B310842D84169C664B7D5E5FA918BC,31554,22,23,1,109.55521,18.2459,1709
266495,3D8ADE80304FD3207128013D43F1118A,60421,0,12,12,109.46333,18.31743,1371
266496,3D8ADE80304FD3207128013D43F1118A,60274,13,15,2,109.514,18.2933,1567
266508,8E244E94833DBF281BCBFE2F4A36E102,30581,11,19,8,109.62257,18.24951,1959
266509,8E244E94833DBF281BCBFE2F4A36E102,60641,21,23,2,109.53854,18.2359,1657
266513,29ECA8B496C1247488B5C7D877F65A99,30191,3,16,13,109.50361,18.22701,1506
266514,29ECA8B496C1247488B5C7D877F65A99,31521,20,23,3,109.51458,18.22542,1555
266515,1319E1E416A553CAED80375F3946B3EF,31521,0,3,3,109.51458,18.22542,1555
266516,1319E1E416A553CAED80375F3946B3EF,60381,3,8,5,109.5241,18.22458,1605
266517,1319E1E416A553CAED80375F3946B3EF,31521,9,10,1,109.51458,18.22542,1555
266518,1319E1E416A553CAED80375F3946B3EF,31521,13,16,3,109.51458,18.22542,1555
266519,1319E1E416A553CAED80375F3946B3EF,60381,18,23,5,109.5241,18.22458,1605
266520,2BCE896904CBDBCAF567B2CFB43BBDA9,30681,0,8,8,109.48493,18.26917,1463
266521,2BCE896904CBDBCAF567B2CFB43BBDA9,60291,12,13,1,109.50826,18.24639,1509
266522,2BCE896904CBDBCAF567B2CFB43BBDA9,60614,14,15,1,109.48799,18.29521,1467
266530,D2CD25D7A8500787C486CAD0AAC0DD3D,38134,0,8,8,109.63931,18.23451,2007
266531,D2CD25D7A8500787C486CAD0AAC0DD3D,31101,8,9,1,109.65389,18.23403,2057
266532,D2CD25D7A8500787C486CAD0AAC0DD3D,31411,13,14,1,109.5016,18.23576,1507
266533,D2CD25D7A8500787C486CAD0AAC0DD3D,31471,16,18,2,109.34583,18.29563,917
266552,3456594AEC9E6FDA19A05A8636C616BD,30854,15,17,2,109.56889,18.27076,1763
266553,3456594AEC9E6FDA19A05A8636C616BD,31071,19,21,2,109.58257,18.28458,1815
266554,3456594AEC9E6FDA19A05A8636C616BD,30854,21,23,2,109.56889,18.27076,1763
266597,2FCF6CC7813BBC7D82090A44235F4CA9,39111,0,6,6,109.5191,18.22597,1555
266598,2FCF6CC7813BBC7D82090A44235F4CA9,38291,6,8,2,109.51618,18.24313,1558
266599,2FCF6CC7813BBC7D82090A44235F4CA9,31521,12,14,2,109.51458,18.22542,1555
266600,2FCF6CC7813BBC7D82090A44235F4CA9,60231,14,16,2,109.49903,18.21972,1504
266601,2FCF6CC7813BBC7D82090A44235F4CA9,31521,17,20,3,109.51458,18.22542,1555
266602,2FCF6CC7813BBC7D82090A44235F4CA9,60381,21,23,2,109.5241,18.22458,1605
266647,8621CFDF1B89A83351494618C53D033F,39181,0,1,1,109.55153,18.28035,1715
266648,8621CFDF1B89A83351494618C53D033F,31071,1,5,4,109.58257,18.28458,1815
266649,8621CFDF1B89A83351494618C53D033F,39181,8,14,6,109.55153,18.28035,1715
266650,8621CFDF1B89A83351494618C53D033F,31931,15,17,2,109.54771,18.29403,1667
266701,5664C5FF6B352F96C7620F94430DAC4F,31391,0,8,8,109.50382,18.24285,1508
266702,5664C5FF6B352F96C7620F94430DAC4F,31521,9,11,2,109.51458,18.22542,1555
266703,5664C5FF6B352F96C7620F94430DAC4F,31521,11,14,3,109.51458,18.22542,1555
266704,5664C5FF6B352F96C7620F94430DAC4F,31521,15,16,1,109.51458,18.22542,1555
266705,5664C5FF6B352F96C7620F94430DAC4F,31521,17,22,5,109.51458,18.22542,1555
266714,5A52D514A004C406B3CAF14D74C40F10,31206,0,7,7,109.50819,18.23549,1507
266715,5A52D514A004C406B3CAF14D74C40F10,31145,9,11,2,109.20431,18.30479,369
266716,5A52D514A004C406B3CAF14D74C40F10,31206,14,16,2,109.50819,18.23549,1507
266717,5A52D514A004C406B3CAF14D74C40F10,60241,17,21,4,109.53319,18.28667,1616
266718,5A52D514A004C406B3CAF14D74C40F10,31201,21,23,2,109.51042,18.23819,1558
266730,F7F33BB1C68494D5DA2069CBA2A8F745,31071,11,17,6,109.58257,18.28458,1815
266731,F7F33BB1C68494D5DA2069CBA2A8F745,60381,20,21,1,109.5241,18.22458,1605
266752,550F79FAD9D15F325A21DE6477758CB2,31071,0,10,10,109.58257,18.28458,1815
266753,550F79FAD9D15F325A21DE6477758CB2,30854,12,18,6,109.56889,18.27076,1763
266759,4A25CB3E62B66E3D1E498BE9F1B6F120,60291,12,13,1,109.50826,18.24639,1509
266760,4A25CB3E62B66E3D1E498BE9F1B6F120,31521,16,18,2,109.51458,18.22542,1555
266761,4A25CB3E62B66E3D1E498BE9F1B6F120,31041,20,21,1,109.50278,18.23701,1507
266770,4540D133CCD3F1F52D06D03C8E81B25F,60201,17,19,2,109.5041,18.2509,1510
266771,4540D133CCD3F1F52D06D03C8E81B25F,60381,20,23,3,109.5241,18.22458,1605
266778,6BC6C104B718F24B54085D1A3B005DEC,38951,0,7,7,109.48097,18.28868,1416
266779,6BC6C104B718F24B54085D1A3B005DEC,33481,10,11,1,109.67278,18.41278,2187
266787,B64A184E0F7798F21B07EE969AEA1D55,60621,0,8,8,109.48354,18.27451,1464
266788,B64A184E0F7798F21B07EE969AEA1D55,30171,8,11,3,109.48458,18.27139,1463
266789,B64A184E0F7798F21B07EE969AEA1D55,31521,12,19,7,109.51458,18.22542,1555
266790,571CEC7BB90FE0F62C63BE8E8DBB7663,30351,16,17,1,109.41701,18.29292,1217
266791,571CEC7BB90FE0F62C63BE8E8DBB7663,60551,19,21,2,109.42722,18.30111,1218
266792,571CEC7BB90FE0F62C63BE8E8DBB7663,30351,21,23,2,109.41701,18.29292,1217
266830,A8D0FB018199C38EC19D3E276F96B59B,60614,0,7,7,109.48799,18.29521,1467
266831,A8D0FB018199C38EC19D3E276F96B59B,38297,8,9,1,109.52576,18.24965,1609
266832,A8D0FB018199C38EC19D3E276F96B59B,30741,11,13,2,109.49833,18.28681,1516
266833,A8D0FB018199C38EC19D3E276F96B59B,60381,14,16,2,109.5241,18.22458,1605
266834,A8D0FB018199C38EC19D3E276F96B59B,30171,18,20,2,109.48458,18.27139,1463
266835,A8D0FB018199C38EC19D3E276F96B59B,30741,21,22,1,109.49833,18.28681,1516
266845,A88EC491B6BCB711E1CE9190F711D4DE,38291,0,8,8,109.51618,18.24313,1558
266846,A88EC491B6BCB711E1CE9190F711D4DE,60131,9,10,1,109.49819,18.24778,1509
266847,A88EC491B6BCB711E1CE9190F711D4DE,38291,13,21,8,109.51618,18.24313,1558
266851,30CA9F654BC78FDC50E8DFCBBF7F78A4,60291,15,16,1,109.50826,18.24639,1509
266852,30CA9F654BC78FDC50E8DFCBBF7F78A4,30211,18,19,1,109.49882,18.23931,1508
266856,EB316856896788EC8FD871E122E95728,31811,0,8,8,109.54201,18.31806,1671
266857,EB316856896788EC8FD871E122E95728,30701,12,23,11,109.59313,18.32007,1871
266863,CBA29FB366E4111071C95C99C696D0E6,31561,1,20,19,109.56792,18.28479,1765
266864,CBA29FB366E4111071C95C99C696D0E6,30854,21,22,1,109.56889,18.27076,1763
266865,262E046EBFA868FC382B93913F636846,31431,0,7,7,109.44639,18.29042,1316
266866,262E046EBFA868FC382B93913F636846,31701,8,23,15,109.44132,18.28833,1266
266879,4E251813AD45491A420BC7D07E468163,30421,10,14,4,109.50021,18.25861,1511
266880,4E251813AD45491A420BC7D07E468163,30421,16,23,7,109.50021,18.25861,1511
266909,CD3BCBAB8571FB81953C842A434E5DB8,30854,8,11,3,109.56889,18.27076,1763
266910,CD3BCBAB8571FB81953C842A434E5DB8,31071,13,15,2,109.58257,18.28458,1815
266911,CD3BCBAB8571FB81953C842A434E5DB8,30854,16,17,1,109.56889,18.27076,1763
266912,CD3BCBAB8571FB81953C842A434E5DB8,31071,18,21,3,109.58257,18.28458,1815
266971,31C2FEDE332FAF9474479CF6CA42337C,38073,0,7,7,109.40813,18.30958,1169
266972,31C2FEDE332FAF9474479CF6CA42337C,60551,8,9,1,109.42722,18.30111,1218
266973,31C2FEDE332FAF9474479CF6CA42337C,30661,12,13,1,109.37028,18.24361,1008
266974,31C2FEDE332FAF9474479CF6CA42337C,60551,17,18,1,109.42722,18.30111,1218
266975,31C2FEDE332FAF9474479CF6CA42337C,31231,18,20,2,109.42597,18.29292,1217
266976,31C2FEDE332FAF9474479CF6CA42337C,60551,20,22,2,109.42722,18.30111,1218
266977,58DE8A719D3ADBEDAE163213845B460A,60211,0,6,6,109.63549,18.26049,2011
266978,58DE8A719D3ADBEDAE163213845B460A,30854,10,18,8,109.56889,18.27076,1763
266979,58DE8A719D3ADBEDAE163213845B460A,31071,18,21,3,109.58257,18.28458,1815
266980,58DE8A719D3ADBEDAE163213845B460A,30854,21,22,1,109.56889,18.27076,1763
266988,9DE8C13901CC7D63E2F1A6CC92603604,30854,7,16,9,109.56889,18.27076,1763
266989,9DE8C13901CC7D63E2F1A6CC92603604,31071,19,21,2,109.58257,18.28458,1815
266999,2DDF3A993BD69F79020EB97CF3A71819,38171,0,8,8,109.50799,18.28139,1515
267000,2DDF3A993BD69F79020EB97CF3A71819,30161,8,10,2,109.50042,18.24389,1508
267001,2DDF3A993BD69F79020EB97CF3A71819,30161,14,17,3,109.50042,18.24389,1508
267002,2DDF3A993BD69F79020EB97CF3A71819,38171,17,19,2,109.50799,18.28139,1515
267003,2DDF3A993BD69F79020EB97CF3A71819,38171,21,23,2,109.50799,18.28139,1515
267015,B816B8FE4A901BFADB45B598DE8D9EF0,60161,4,8,4,109.49174,18.26181,1461
267016,B816B8FE4A901BFADB45B598DE8D9EF0,38754,12,16,4,109.74667,18.37382,2430
267017,B816B8FE4A901BFADB45B598DE8D9EF0,31271,20,22,2,109.48958,18.26257,1462
267035,74A8DA1A239BA74C3424A36505B6E3A6,31945,0,7,7,109.58021,18.29403,1817
267036,74A8DA1A239BA74C3424A36505B6E3A6,31561,8,9,1,109.56792,18.28479,1765
267037,74A8DA1A239BA74C3424A36505B6E3A6,30854,11,18,7,109.56889,18.27076,1763
267038,74A8DA1A239BA74C3424A36505B6E3A6,60381,21,23,2,109.5241,18.22458,1605
267041,019EB913544B8855829875D27D9C85B6,31201,3,11,8,109.51042,18.23819,1558
267042,019EB913544B8855829875D27D9C85B6,60614,12,14,2,109.48799,18.29521,1467
267043,018C2271047AC8D414777DBC331B95FD,30111,0,2,2,109.47583,18.30542,1419
267044,018C2271047AC8D414777DBC331B95FD,60391,5,7,2,109.47667,18.28757,1416
267045,018C2271047AC8D414777DBC331B95FD,31541,11,13,2,109.1809,18.36722,329
267046,018C2271047AC8D414777DBC331B95FD,30434,14,18,4,109.17083,18.35861,278
267084,580E03A111E839B85E7FD8688310DCFE,30851,0,13,13,109.5616,18.27396,1713
267085,580E03A111E839B85E7FD8688310DCFE,30854,17,18,1,109.56889,18.27076,1763
267109,B9E554958CF29F9447541E7C1F71C9EF,60011,0,3,3,109.48965,18.30222,1468
267110,B9E554958CF29F9447541E7C1F71C9EF,60614,3,8,5,109.48799,18.29521,1467
267118,0402BD114B7D5E20705E302B756CD062,31071,0,5,5,109.58257,18.28458,1815
267119,0402BD114B7D5E20705E302B756CD062,60631,6,7,1,109.57778,18.27583,1814
267120,0402BD114B7D5E20705E302B756CD062,30854,8,10,2,109.56889,18.27076,1763
267121,0402BD114B7D5E20705E302B756CD062,60381,17,19,2,109.5241,18.22458,1605
267122,0402BD114B7D5E20705E302B756CD062,31071,20,23,3,109.58257,18.28458,1815
267140,ACDEAAF45B65DE48CF80A48DBD3C775E,31071,3,6,3,109.58257,18.28458,1815
267141,ACDEAAF45B65DE48CF80A48DBD3C775E,30854,9,16,7,109.56889,18.27076,1763
267142,ACDEAAF45B65DE48CF80A48DBD3C775E,31071,16,19,3,109.58257,18.28458,1815
267156,5EBEA276FCB4A19AC5C987F5C7CC8908,60621,0,5,5,109.48354,18.27451,1464
267157,5EBEA276FCB4A19AC5C987F5C7CC8908,60401,6,12,6,109.47444,18.27583,1414
267158,5EBEA276FCB4A19AC5C987F5C7CC8908,60524,12,14,2,109.42951,18.28993,1216
267159,5EBEA276FCB4A19AC5C987F5C7CC8908,60621,15,17,2,109.48354,18.27451,1464
267160,5EBEA276FCB4A19AC5C987F5C7CC8908,60524,20,22,2,109.42951,18.28993,1216
267165,3B6FF1F8D896A0A62DC7E65967011999,39183,0,6,6,109.55542,18.28208,1715
267166,3B6FF1F8D896A0A62DC7E65967011999,31931,6,7,1,109.54771,18.29403,1667
267167,3B6FF1F8D896A0A62DC7E65967011999,39183,10,11,1,109.55542,18.28208,1715
267168,3B6FF1F8D896A0A62DC7E65967011999,31561,12,15,3,109.56792,18.28479,1765
267169,3B6FF1F8D896A0A62DC7E65967011999,30854,17,19,2,109.56889,18.27076,1763
267170,3B6FF1F8D896A0A62DC7E65967011999,30711,19,21,2,109.50271,18.25347,1510
267184,DB4DF566D4757FF3BB488F82DE126248,30851,0,3,3,109.5616,18.27396,1713
267185,DB4DF566D4757FF3BB488F82DE126248,31561,4,16,12,109.56792,18.28479,1765
267186,DB4DF566D4757FF3BB488F82DE126248,60351,17,18,1,109.58403,18.28958,1816
267187,EF1BB24884CAA5A60101DD1EB36004EC,60621,3,6,3,109.48354,18.27451,1464
267188,EF1BB24884CAA5A60101DD1EB36004EC,60401,7,9,2,109.47444,18.27583,1414
267189,EF1BB24884CAA5A60101DD1EB36004EC,31461,12,13,1,109.5091,18.25389,1510
267190,EF1BB24884CAA5A60101DD1EB36004EC,38157,13,14,1,109.51483,18.26958,1563
267195,0312B43ACF9ED1D8304E325E851AEE29,30851,0,8,8,109.5616,18.27396,1713
267196,0312B43ACF9ED1D8304E325E851AEE29,31561,12,15,3,109.56792,18.28479,1765
267197,0312B43ACF9ED1D8304E325E851AEE29,30851,15,20,5,109.5616,18.27396,1713
267211,7E136DFDE7B8F9A2B858AC3F2A5E145B,30854,11,17,6,109.56889,18.27076,1763
267212,7E136DFDE7B8F9A2B858AC3F2A5E145B,31561,18,19,1,109.56792,18.28479,1765
267213,7E136DFDE7B8F9A2B858AC3F2A5E145B,30854,19,20,1,109.56889,18.27076,1763
267216,16E640D9FA5593E85AD54BDFBAF952D8,31561,0,4,4,109.56792,18.28479,1765
267217,16E640D9FA5593E85AD54BDFBAF952D8,31071,8,16,8,109.58257,18.28458,1815
267229,8F7FB30507503E99C612B652ADC863DC,60381,0,6,6,109.5241,18.22458,1605
267230,8F7FB30507503E99C612B652ADC863DC,31421,7,16,9,109.55382,18.22347,1705
267231,8F7FB30507503E99C612B652ADC863DC,60381,16,18,2,109.5241,18.22458,1605
267285,E0223036572082E83876AFB7D72B2DD2,31931,0,8,8,109.54771,18.29403,1667
267286,E0223036572082E83876AFB7D72B2DD2,30921,9,10,1,109.53903,18.29451,1667
267287,E0223036572082E83876AFB7D72B2DD2,31931,11,20,9,109.54771,18.29403,1667
267295,179FD4660C817BD29234A518F00339D3,60231,3,8,5,109.49903,18.21972,1504
267296,179FD4660C817BD29234A518F00339D3,60161,12,16,4,109.49174,18.26181,1461
267297,179FD4660C817BD29234A518F00339D3,60231,16,18,2,109.49903,18.21972,1504
267300,BA6378F71A53EDA04060B74ABD747D3D,30661,1,2,1,109.37028,18.24361,1008
267301,BA6378F71A53EDA04060B74ABD747D3D,60524,4,12,8,109.42951,18.28993,1216
267302,BA6378F71A53EDA04060B74ABD747D3D,31471,13,15,2,109.34583,18.29563,917
267303,BA6378F71A53EDA04060B74ABD747D3D,60524,17,22,5,109.42951,18.28993,1216
267309,BFBD6F9C556CC332740750D0B1B81265,38951,15,16,1,109.48097,18.28868,1416
267310,BFBD6F9C556CC332740750D0B1B81265,60504,21,23,2,109.47917,18.28903,1416
267321,41D4EB5552A7A416EEB26FAA30F55A4B,39183,0,7,7,109.55542,18.28208,1715
267322,41D4EB5552A7A416EEB26FAA30F55A4B,39181,9,21,12,109.55153,18.28035,1715
267328,7EB4F76900011DECC835981CBE847D5E,30854,0,11,11,109.56889,18.27076,1763
267329,7EB4F76900011DECC835981CBE847D5E,31561,12,14,2,109.56792,18.28479,1765
267362,8265A029C672FE0377EF574CC3ADF2A8,31561,11,16,5,109.56792,18.28479,1765
267363,8265A029C672FE0377EF574CC3ADF2A8,39181,17,18,1,109.55153,18.28035,1715
267411,6B806948BC9187A91D033B4096721B00,30854,0,8,8,109.56889,18.27076,1763
267412,6B806948BC9187A91D033B4096721B00,31071,9,18,9,109.58257,18.28458,1815
267460,56F4A25A0E603B5B2CF39EF89A2DE812,31611,0,5,5,109.63076,18.34944,2026
267461,56F4A25A0E603B5B2CF39EF89A2DE812,60231,7,15,8,109.49903,18.21972,1504
267462,56F4A25A0E603B5B2CF39EF89A2DE812,31611,15,23,8,109.63076,18.34944,2026
267463,7D995CB95F238B8B307F54EE2D50BDB6,30221,4,8,4,109.57833,18.20222,1802
267464,7D995CB95F238B8B307F54EE2D50BDB6,31421,9,10,1,109.55382,18.22347,1705
267465,7D995CB95F238B8B307F54EE2D50BDB6,31561,14,15,1,109.56792,18.28479,1765
267466,7D995CB95F238B8B307F54EE2D50BDB6,31421,19,21,2,109.55382,18.22347,1705
267467,7D995CB95F238B8B307F54EE2D50BDB6,30221,21,23,2,109.57833,18.20222,1802
267500,E65658506C2BF9C993BA69EE6D38B3C6,31951,2,8,6,109.52174,18.30299,1568
267501,E65658506C2BF9C993BA69EE6D38B3C6,60361,10,16,6,109.51938,18.29681,1567
267532,149F44702DEC8C73589BE6524F0A1FFD,30854,3,12,9,109.56889,18.27076,1763
267533,149F44702DEC8C73589BE6524F0A1FFD,38085,15,16,1,109.6291,18.23625,2007
267534,149F44702DEC8C73589BE6524F0A1FFD,31571,17,20,3,109.61563,18.23326,1957
267548,B4188FCF77E77B10794A61864ECCAF69,31521,12,15,3,109.51458,18.22542,1555
267549,B4188FCF77E77B10794A61864ECCAF69,31521,18,23,5,109.51458,18.22542,1555
267565,BD36B617B5735ECF01B192DD8C734880,31421,0,10,10,109.55382,18.22347,1705
267566,BD36B617B5735ECF01B192DD8C734880,60381,14,17,3,109.5241,18.22458,1605
267567,BD36B617B5735ECF01B192DD8C734880,31421,18,20,2,109.55382,18.22347,1705
267594,C93386A9D86FE22A1FD4E5116045DD8D,31561,0,5,5,109.56792,18.28479,1765
267595,C93386A9D86FE22A1FD4E5116045DD8D,39183,6,8,2,109.55542,18.28208,1715
267596,C93386A9D86FE22A1FD4E5116045DD8D,31561,8,10,2,109.56792,18.28479,1765
267597,C93386A9D86FE22A1FD4E5116045DD8D,30711,15,16,1,109.50271,18.25347,1510
267598,C93386A9D86FE22A1FD4E5116045DD8D,30854,19,20,1,109.56889,18.27076,1763
267599,C93386A9D86FE22A1FD4E5116045DD8D,31561,22,23,1,109.56792,18.28479,1765
267650,01C3A40E8C2D18FB80BE4CD2C78B4B61,30771,0,8,8,109.49938,18.26042,1511
267651,01C3A40E8C2D18FB80BE4CD2C78B4B61,39091,13,16,3,109.50097,18.25222,1510
267652,01C3A40E8C2D18FB80BE4CD2C78B4B61,30071,19,22,3,109.52819,18.30472,1619
267669,BE74D5A2C373F8231889AF03B59762B2,60301,2,5,3,109.60715,18.30993,1919
267670,BE74D5A2C373F8231889AF03B59762B2,30232,6,7,1,109.6191,18.31701,1971
267671,BE74D5A2C373F8231889AF03B59762B2,60301,8,9,1,109.60715,18.30993,1919
267672,BE74D5A2C373F8231889AF03B59762B2,60241,13,14,1,109.53319,18.28667,1616
267673,BE74D5A2C373F8231889AF03B59762B2,30854,16,17,1,109.56889,18.27076,1763
267674,BE74D5A2C373F8231889AF03B59762B2,30851,19,20,1,109.5616,18.27396,1713
267691,5205655EC583F6392BC68C8BB9865108,31071,2,7,5,109.58257,18.28458,1815
267692,5205655EC583F6392BC68C8BB9865108,30854,7,11,4,109.56889,18.27076,1763
267693,5205655EC583F6392BC68C8BB9865108,31071,15,16,1,109.58257,18.28458,1815
267722,10D0DA0CDE594144AD7B0AF9906F5575,31561,8,20,12,109.56792,18.28479,1765
267723,10D0DA0CDE594144AD7B0AF9906F5575,30854,21,22,1,109.56889,18.27076,1763
267737,834384AB36BC69B3ECBD6E385DAC921F,31071,0,2,2,109.58257,18.28458,1815
267738,834384AB36BC69B3ECBD6E385DAC921F,30441,3,7,4,109.64021,18.25424,2010
267739,834384AB36BC69B3ECBD6E385DAC921F,30854,7,12,5,109.56889,18.27076,1763
267740,834384AB36BC69B3ECBD6E385DAC921F,38754,15,16,1,109.74667,18.37382,2430
267745,24892DF473AC6ED4692FBD552CF21D37,60381,0,11,11,109.5241,18.22458,1605
267746,24892DF473AC6ED4692FBD552CF21D37,39321,14,16,2,109.529,18.2167,1604
267747,24892DF473AC6ED4692FBD552CF21D37,60381,20,23,3,109.5241,18.22458,1605
267827,3F80F6C7ECC59E36D89C8EF1746C8724,38157,3,14,11,109.51483,18.26958,1563
267828,3F80F6C7ECC59E36D89C8EF1746C8724,31181,14,16,2,109.50382,18.24813,1509
267834,56C8C781972E8BFAF8A768A19AD7F590,30281,0,6,6,109.50597,18.27583,1514
267836,56C8C781972E8BFAF8A768A19AD7F590,31531,20,22,2,109.49583,18.25972,1461
267844,C709D01469E0800AF998DFAF42105CDC,30854,0,5,5,109.56889,18.27076,1763
267845,C709D01469E0800AF998DFAF42105CDC,31561,7,16,9,109.56792,18.28479,1765
267846,C709D01469E0800AF998DFAF42105CDC,30854,18,21,3,109.56889,18.27076,1763
267850,FA14B010F60C7FB3B13194FAA13740E8,31561,1,5,4,109.56792,18.28479,1765
267851,FA14B010F60C7FB3B13194FAA13740E8,39183,9,11,2,109.55542,18.28208,1715
267852,FA14B010F60C7FB3B13194FAA13740E8,31561,11,13,2,109.56792,18.28479,1765
267853,451E2BF48CD7B253EB0892324E679BCC,38297,3,4,1,109.52576,18.24965,1609
267854,451E2BF48CD7B253EB0892324E679BCC,38291,7,10,3,109.51618,18.24313,1558
267855,451E2BF48CD7B253EB0892324E679BCC,38297,10,15,5,109.52576,18.24965,1609
267856,451E2BF48CD7B253EB0892324E679BCC,38291,15,17,2,109.51618,18.24313,1558
267857,451E2BF48CD7B253EB0892324E679BCC,38297,20,22,2,109.52576,18.24965,1609
267874,85DE989B49E37442443C5A3C8C9B6ECA,31231,0,6,6,109.42597,18.29292,1217
267875,85DE989B49E37442443C5A3C8C9B6ECA,31431,7,9,2,109.44639,18.29042,1316
267876,85DE989B49E37442443C5A3C8C9B6ECA,30671,12,17,5,109.43611,18.30139,1268
267877,85DE989B49E37442443C5A3C8C9B6ECA,31231,19,23,4,109.42597,18.29292,1217
267935,0E5593A90D661690BE3DAAA17AD936E2,38127,0,10,10,109.50833,18.27222,1513
267936,0E5593A90D661690BE3DAAA17AD936E2,38073,11,14,3,109.40813,18.30958,1169
267937,DDE77D3A656666992FC3458B84010D43,39183,0,3,3,109.55542,18.28208,1715
267938,DDE77D3A656666992FC3458B84010D43,31561,6,9,3,109.56792,18.28479,1765
267939,DDE77D3A656666992FC3458B84010D43,39183,10,12,2,109.55542,18.28208,1715
267940,DDE77D3A656666992FC3458B84010D43,30854,14,15,1,109.56889,18.27076,1763
267941,DDE77D3A656666992FC3458B84010D43,39183,18,19,1,109.55542,18.28208,1715
267959,529A14F498129B0238F7B12A9FC7F6F7,31205,0,1,1,109.51111,18.23736,1557
267960,529A14F498129B0238F7B12A9FC7F6F7,31671,2,23,21,109.38965,18.29813,1068
267967,2C3BD53A8702A47FB82F05FB4993B683,31561,0,6,6,109.56792,18.28479,1765
267968,2C3BD53A8702A47FB82F05FB4993B683,39183,9,10,1,109.55542,18.28208,1715
267969,2C3BD53A8702A47FB82F05FB4993B683,39321,14,15,1,109.529,18.2167,1604
267970,2C3BD53A8702A47FB82F05FB4993B683,31561,19,23,4,109.56792,18.28479,1765
267995,7FE8039F0B43D97751DD03EAC1234AA8,31521,2,11,9,109.51458,18.22542,1555
267996,7FE8039F0B43D97751DD03EAC1234AA8,60071,13,15,2,109.75674,18.31583,2470
267997,7FE8039F0B43D97751DD03EAC1234AA8,31521,19,23,4,109.51458,18.22542,1555
267998,283001ED673D8EDBEF7EEB00BDB31533,30351,0,5,5,109.41701,18.29292,1217
267999,283001ED673D8EDBEF7EEB00BDB31533,31671,6,15,9,109.38965,18.29813,1068
268000,283001ED673D8EDBEF7EEB00BDB31533,31231,17,21,4,109.42597,18.29292,1217
268016,5202825DF51CA068C8B204422480230F,31071,1,5,4,109.58257,18.28458,1815
268017,5202825DF51CA068C8B204422480230F,31945,7,9,2,109.58021,18.29403,1817
268018,5202825DF51CA068C8B204422480230F,30854,10,11,1,109.56889,18.27076,1763
268019,5202825DF51CA068C8B204422480230F,31071,12,15,3,109.58257,18.28458,1815
268020,5202825DF51CA068C8B204422480230F,31561,15,16,1,109.56792,18.28479,1765
268021,5202825DF51CA068C8B204422480230F,60381,21,22,1,109.5241,18.22458,1605
268052,74D362264AC1D256D4D64FB1B1D480D1,31521,0,9,9,109.51458,18.22542,1555
268053,74D362264AC1D256D4D64FB1B1D480D1,31521,11,12,1,109.51458,18.22542,1555
268054,74D362264AC1D256D4D64FB1B1D480D1,60381,12,14,2,109.5241,18.22458,1605
268055,74D362264AC1D256D4D64FB1B1D480D1,31521,14,16,2,109.51458,18.22542,1555
268056,74D362264AC1D256D4D64FB1B1D480D1,60221,16,18,2,109.52569,18.29188,1616
268057,74D362264AC1D256D4D64FB1B1D480D1,31521,19,20,1,109.51458,18.22542,1555
268064,C3EC43179E51E2CA8AF203A259981D18,31071,17,18,1,109.58257,18.28458,1815
268068,CB1C8502149DACE0B32B2F7416279EF2,31071,1,7,6,109.58257,18.28458,1815
268069,CB1C8502149DACE0B32B2F7416279EF2,30854,7,10,3,109.56889,18.27076,1763
268070,CB1C8502149DACE0B32B2F7416279EF2,31945,12,13,1,109.58021,18.29403,1817
268078,5100BDEFDFF3241811C94A14D7D61508,60661,17,18,1,109.548,18.2377,1657
268079,5100BDEFDFF3241811C94A14D7D61508,30854,20,22,2,109.56889,18.27076,1763
268080,C83989AE2DFF8530CB3DF7DC45038FE9,38094,11,12,1,109.45403,18.28778,1316
268081,C83989AE2DFF8530CB3DF7DC45038FE9,60441,14,15,1,109.46792,18.28604,1366
268082,C83989AE2DFF8530CB3DF7DC45038FE9,38094,17,18,1,109.45403,18.28778,1316
268093,D39D64452E6BBEF7B3056CA239E1B86E,30854,0,2,2,109.56889,18.27076,1763
268094,D39D64452E6BBEF7B3056CA239E1B86E,30851,3,4,1,109.5616,18.27396,1713
268095,D39D64452E6BBEF7B3056CA239E1B86E,30854,6,8,2,109.56889,18.27076,1763
268096,D39D64452E6BBEF7B3056CA239E1B86E,31561,9,11,2,109.56792,18.28479,1765
268097,D39D64452E6BBEF7B3056CA239E1B86E,30854,12,14,2,109.56889,18.27076,1763
268098,D39D64452E6BBEF7B3056CA239E1B86E,31561,15,17,2,109.56792,18.28479,1765
268099,D39D64452E6BBEF7B3056CA239E1B86E,30854,17,19,2,109.56889,18.27076,1763
268129,970D6BC437EA1378FAE0DFD7B07AAE0B,60221,8,9,1,109.52569,18.29188,1616
268130,970D6BC437EA1378FAE0DFD7B07AAE0B,30171,11,21,10,109.48458,18.27139,1463
268134,43E6B9C1B72B40FA7B91611D276BDEC1,31231,0,16,16,109.42597,18.29292,1217
268135,43E6B9C1B72B40FA7B91611D276BDEC1,30354,20,23,3,109.42813,18.29076,1216
268140,CFF5BE3C5C109C874F96B9E9841D39B0,30171,0,9,9,109.48458,18.27139,1463
268141,CFF5BE3C5C109C874F96B9E9841D39B0,30171,13,17,4,109.48458,18.27139,1463
268142,CFF5BE3C5C109C874F96B9E9841D39B0,30171,17,23,6,109.48458,18.27139,1463
268143,812FF2AD7CDC56800927AA5D19BA4232,38991,0,7,7,109.52681,18.30368,1618
268176,34AB502A442AA8EA4A7FB30471B204DB,60621,1,6,5,109.48354,18.27451,1464
268177,34AB502A442AA8EA4A7FB30471B204DB,60401,8,10,2,109.47444,18.27583,1414
268178,34AB502A442AA8EA4A7FB30471B204DB,38094,10,11,1,109.45403,18.28778,1316
268179,34AB502A442AA8EA4A7FB30471B204DB,31031,11,13,2,109.49979,18.25382,1510
268180,34AB502A442AA8EA4A7FB30471B204DB,38325,13,15,2,109.39792,18.2909,1116
268196,6FDD8510FC3FD17D36965B0963BD7329,31561,4,6,2,109.56792,18.28479,1765
268197,6FDD8510FC3FD17D36965B0963BD7329,30854,6,18,12,109.56889,18.27076,1763
268226,CD576F1C1CDFB89E6A99A20E65927346,31561,0,19,19,109.56792,18.28479,1765
268227,CD576F1C1CDFB89E6A99A20E65927346,30854,20,22,2,109.56889,18.27076,1763
268244,0695D4E7B3E726CA09D841B87798B560,30854,0,16,16,109.56889,18.27076,1763
268245,0695D4E7B3E726CA09D841B87798B560,31071,20,21,1,109.58257,18.28458,1815
268246,914EFDE50A6F5785153D97029FF6400E,39183,0,12,12,109.55542,18.28208,1715
268247,914EFDE50A6F5785153D97029FF6400E,30071,12,14,2,109.52819,18.30472,1619
268248,914EFDE50A6F5785153D97029FF6400E,39183,17,18,1,109.55542,18.28208,1715
268249,914EFDE50A6F5785153D97029FF6400E,31931,18,23,5,109.54771,18.29403,1667
268255,B712327B6033C61F37801CFD6DAC08AD,30561,10,14,4,109.52778,18.31938,1621
268256,B712327B6033C61F37801CFD6DAC08AD,31951,16,17,1,109.52174,18.30299,1568
268257,B712327B6033C61F37801CFD6DAC08AD,38484,17,19,2,109.53028,18.31528,1620
268258,B712327B6033C61F37801CFD6DAC08AD,38484,20,23,3,109.53028,18.31528,1620
268264,5032297453241F06691AD56818B16DB5,60524,2,3,1,109.42951,18.28993,1216
268265,5032297453241F06691AD56818B16DB5,30651,7,9,2,109.42611,18.385,1232
268273,DE105C397F26A3ACFAEB1809DD2E4C8C,30971,0,6,6,109.48708,18.29319,1467
268274,DE105C397F26A3ACFAEB1809DD2E4C8C,30971,7,8,1,109.48708,18.29319,1467
268275,DE105C397F26A3ACFAEB1809DD2E4C8C,38484,9,10,1,109.53028,18.31528,1620
268276,DE105C397F26A3ACFAEB1809DD2E4C8C,30421,10,12,2,109.50021,18.25861,1511
268277,DE105C397F26A3ACFAEB1809DD2E4C8C,30971,13,23,10,109.48708,18.29319,1467
268289,A7B3BDD8DC79485BA41EC7F220A41345,60631,1,8,7,109.57778,18.27583,1814
268290,A7B3BDD8DC79485BA41EC7F220A41345,30854,12,19,7,109.56889,18.27076,1763
268291,A7B3BDD8DC79485BA41EC7F220A41345,30421,22,23,1,109.50021,18.25861,1511
268292,276CA6638E360F26911F834ACA3BF972,30151,0,8,8,109.50986,18.25083,1560
268293,276CA6638E360F26911F834ACA3BF972,31461,10,12,2,109.5091,18.25389,1510
268297,B7911D9D9A3AB9DF64A3B23E6A7B118E,60201,0,2,2,109.5041,18.2509,1510
268298,B7911D9D9A3AB9DF64A3B23E6A7B118E,30711,6,10,4,109.50271,18.25347,1510
268299,B7911D9D9A3AB9DF64A3B23E6A7B118E,30711,10,14,4,109.50271,18.25347,1510
268300,B7911D9D9A3AB9DF64A3B23E6A7B118E,31471,16,17,1,109.34583,18.29563,917
268301,B7911D9D9A3AB9DF64A3B23E6A7B118E,31431,18,19,1,109.44639,18.29042,1316
268302,B7911D9D9A3AB9DF64A3B23E6A7B118E,30711,20,21,1,109.50271,18.25347,1510
268303,B7911D9D9A3AB9DF64A3B23E6A7B118E,30711,22,23,1,109.50271,18.25347,1510
268325,530F0AE3A2D48DD91CDC3A17D13BA70F,38707,0,9,9,109.73778,18.35368,2427
268326,530F0AE3A2D48DD91CDC3A17D13BA70F,38707,12,17,5,109.73778,18.35368,2427
268360,47C8C71AB8A291B23C6D0393C8109E46,38171,0,8,8,109.50799,18.28139,1515
268361,47C8C71AB8A291B23C6D0393C8109E46,38261,11,15,4,109.50361,18.28153,1515
268362,47C8C71AB8A291B23C6D0393C8109E46,31781,16,17,1,109.19847,18.2975,367
268363,47C8C71AB8A291B23C6D0393C8109E46,38171,20,23,3,109.50799,18.28139,1515
268364,FCC7FFA36CCAFA7D306338AD42FEB181,60161,0,5,5,109.49174,18.26181,1461
268365,FCC7FFA36CCAFA7D306338AD42FEB181,60401,6,8,2,109.47444,18.27583,1414
268387,EDECB31C6334C9294412C6687241266D,39151,19,20,1,109.49875,18.25097,1510
268388,EDECB31C6334C9294412C6687241266D,30271,22,23,1,109.49132,18.23153,1456
268397,CBF71892C67A397772665402624216C5,39183,0,11,11,109.55542,18.28208,1715
268398,CBF71892C67A397772665402624216C5,31931,13,14,1,109.54771,18.29403,1667
268399,CBF71892C67A397772665402624216C5,39183,17,22,5,109.55542,18.28208,1715
268428,E46795A590C643FCDE6B993B35621D2F,31861,12,13,1,109.49042,18.27549,1464
268429,E46795A590C643FCDE6B993B35621D2F,38027,18,19,1,109.38833,18.2909,1066
268548,A02F58F4D887D8C7AFCC5C3BF1733917,31061,0,6,6,109.53333,18.23257,1607
268574,557A975BF2F1D3135462224F08758153,38154,1,2,1,109.5266,18.28278,1615
268575,557A975BF2F1D3135462224F08758153,31951,3,14,11,109.52174,18.30299,1568
268576,557A975BF2F1D3135462224F08758153,60221,15,17,2,109.52569,18.29188,1616
268577,557A975BF2F1D3135462224F08758153,31951,18,20,2,109.52174,18.30299,1568
268598,CFBECCF1033E4C2AF15DC8693C77CEB1,31471,12,13,1,109.34583,18.29563,917
268599,CFBECCF1033E4C2AF15DC8693C77CEB1,30661,15,17,2,109.37028,18.24361,1008
268600,CFBECCF1033E4C2AF15DC8693C77CEB1,60391,18,19,1,109.47667,18.28757,1416
268601,CFBECCF1033E4C2AF15DC8693C77CEB1,30111,21,23,2,109.47583,18.30542,1419
268608,491A112CD81B9085F752897809919691,31261,9,11,2,109.51174,18.2466,1559
268609,491A112CD81B9085F752897809919691,30511,15,19,4,109.51069,18.24208,1558
268610,491A112CD81B9085F752897809919691,60381,20,21,1,109.5241,18.22458,1605
268611,491A112CD81B9085F752897809919691,31201,21,23,2,109.51042,18.23819,1558
268616,8B08E339C0353F4553A7E5299B8AD99A,38241,0,9,9,109.54111,18.30542,1669
268617,8B08E339C0353F4553A7E5299B8AD99A,60054,13,15,2,109.3016,18.31229,770
268631,E18C3F4B9E8C48C1B46EB6B7E96BEFCA,31681,1,7,6,109.40396,18.29979,1168
268632,E18C3F4B9E8C48C1B46EB6B7E96BEFCA,38105,7,9,2,109.40299,18.29229,1117
268633,E18C3F4B9E8C48C1B46EB6B7E96BEFCA,31681,13,16,3,109.40396,18.29979,1168
268634,E18C3F4B9E8C48C1B46EB6B7E96BEFCA,38102,19,21,2,109.40875,18.29111,1166
268658,A549C024E6F63EDBD3DC866F10DB11CE,30234,0,5,5,109.60681,18.29979,1918
268659,A549C024E6F63EDBD3DC866F10DB11CE,30854,9,14,5,109.56889,18.27076,1763
268660,A549C024E6F63EDBD3DC866F10DB11CE,31071,17,19,2,109.58257,18.28458,1815
268696,A749E400BFD3B5908671E939EC104DEE,30854,11,15,4,109.56889,18.27076,1763
268697,A749E400BFD3B5908671E939EC104DEE,31071,15,17,2,109.58257,18.28458,1815
268698,A749E400BFD3B5908671E939EC104DEE,30854,19,21,2,109.56889,18.27076,1763
268699,A749E400BFD3B5908671E939EC104DEE,31071,21,23,2,109.58257,18.28458,1815
268704,E4B522EF4348156010E5C578EC13D60F,30854,0,7,7,109.56889,18.27076,1763
268705,E4B522EF4348156010E5C578EC13D60F,31945,7,8,1,109.58021,18.29403,1817
268706,E4B522EF4348156010E5C578EC13D60F,30854,10,11,1,109.56889,18.27076,1763
268707,E4B522EF4348156010E5C578EC13D60F,31071,18,19,1,109.58257,18.28458,1815
268708,E4B522EF4348156010E5C578EC13D60F,30854,22,23,1,109.56889,18.27076,1763
268713,C5B2C146A715B405C4C002F4F3423FFB,31181,1,8,7,109.50382,18.24813,1509
268714,C5B2C146A715B405C4C002F4F3423FFB,39091,8,9,1,109.50097,18.25222,1510
268715,C5B2C146A715B405C4C002F4F3423FFB,60291,10,13,3,109.50826,18.24639,1509
268728,86435198F57620D5DAC23B4A4DA78009,39183,1,7,6,109.55542,18.28208,1715
268729,86435198F57620D5DAC23B4A4DA78009,31931,8,16,8,109.54771,18.29403,1667
268730,86435198F57620D5DAC23B4A4DA78009,39183,18,20,2,109.55542,18.28208,1715
268731,D984F4ED609CD4BB7417303EF42B896E,38361,0,8,8,109.43667,18.29201,1267
268732,D984F4ED609CD4BB7417303EF42B896E,30711,11,12,1,109.50271,18.25347,1510
268733,D984F4ED609CD4BB7417303EF42B896E,30854,13,14,1,109.56889,18.27076,1763
268734,D984F4ED609CD4BB7417303EF42B896E,31041,18,19,1,109.50278,18.23701,1507
268735,D984F4ED609CD4BB7417303EF42B896E,31345,21,23,2,109.39,18.29,1066
268742,D090D23BEAB243AAF74CB3648E81F65B,30854,0,7,7,109.56889,18.27076,1763
268743,D090D23BEAB243AAF74CB3648E81F65B,31561,8,23,15,109.56792,18.28479,1765
268764,2913724A9957EDEB24A0554F9C389C52,31521,0,1,1,109.51458,18.22542,1555
268779,D75F3D28EEDDC3AAB22F587F99A79102,31071,1,4,3,109.58257,18.28458,1815
268780,D75F3D28EEDDC3AAB22F587F99A79102,30854,5,9,4,109.56889,18.27076,1763
268781,D75F3D28EEDDC3AAB22F587F99A79102,31071,11,17,6,109.58257,18.28458,1815
268782,D75F3D28EEDDC3AAB22F587F99A79102,30854,19,23,4,109.56889,18.27076,1763
268791,10EBF762D28520B09848288F7052CFDE,30854,0,6,6,109.56889,18.27076,1763
268792,10EBF762D28520B09848288F7052CFDE,31561,6,12,6,109.56792,18.28479,1765
268793,10EBF762D28520B09848288F7052CFDE,31071,12,15,3,109.58257,18.28458,1815
268794,10EBF762D28520B09848288F7052CFDE,30854,16,23,7,109.56889,18.27076,1763
268824,546C572FC49C780F9A9AF62ED98666DF,30351,4,8,4,109.41701,18.29292,1217
268825,546C572FC49C780F9A9AF62ED98666DF,30681,8,10,2,109.48493,18.26917,1463
268826,546C572FC49C780F9A9AF62ED98666DF,30351,10,18,8,109.41701,18.29292,1217
268827,546C572FC49C780F9A9AF62ED98666DF,30681,18,21,3,109.48493,18.26917,1463
268828,546C572FC49C780F9A9AF62ED98666DF,30351,21,23,2,109.41701,18.29292,1217
268836,3AC7F2DEECA5F36461EF3FD31BBBC1FC,30661,12,13,1,109.37028,18.24361,1008
268837,3AC7F2DEECA5F36461EF3FD31BBBC1FC,31471,14,15,1,109.34583,18.29563,917
268838,3AC7F2DEECA5F36461EF3FD31BBBC1FC,39181,19,23,4,109.55153,18.28035,1715
268853,E6BFF9D5149779739DDE4340D165B642,31351,16,19,3,109.4959,18.28417,1465
268854,E6BFF9D5149779739DDE4340D165B642,60161,20,21,1,109.49174,18.26181,1461
268855,E6BFF9D5149779739DDE4340D165B642,31861,22,23,1,109.49042,18.27549,1464
268856,B09F6CB43F7BB3E6391589239BFB1120,38951,0,17,17,109.48097,18.28868,1416
268857,B09F6CB43F7BB3E6391589239BFB1120,38261,19,20,1,109.50361,18.28153,1515
268858,B09F6CB43F7BB3E6391589239BFB1120,39053,21,23,2,109.511,18.2771,1564
268859,66B36EAB2804138C84FF096B3B06E748,31031,12,18,6,109.49979,18.25382,1510
268860,66B36EAB2804138C84FF096B3B06E748,30421,18,23,5,109.50021,18.25861,1511
268874,8953AAE870A5455B1CCDFF6A18139D8A,38054,15,23,8,109.63479,18.23097,2006
268893,065F1687C35F3C827A2EA4A378A0E2C6,60354,0,3,3,109.58701,18.28521,1815
268894,065F1687C35F3C827A2EA4A378A0E2C6,39371,4,22,18,109.56627,18.2646,1762
268900,DF5348A8E25901EBB63BBF3F6126BB02,31071,0,7,7,109.58257,18.28458,1815
268901,DF5348A8E25901EBB63BBF3F6126BB02,30854,9,13,4,109.56889,18.27076,1763
268902,DF5348A8E25901EBB63BBF3F6126BB02,31071,14,15,1,109.58257,18.28458,1815
268903,DF5348A8E25901EBB63BBF3F6126BB02,31345,18,19,1,109.39,18.29,1066
268904,DF5348A8E25901EBB63BBF3F6126BB02,30854,22,23,1,109.56889,18.27076,1763
268916,502F5C6B66964DC1CB5492352683E4F7,38111,7,9,2,109.52007,18.22403,1555
268917,502F5C6B66964DC1CB5492352683E4F7,30771,11,13,2,109.49938,18.26042,1511
268918,502F5C6B66964DC1CB5492352683E4F7,38271,15,16,1,109.62632,18.23049,1956
268926,6D0CBC29417959EBDF12F1FD604A5C61,38754,14,16,2,109.74667,18.37382,2430
268927,6D0CBC29417959EBDF12F1FD604A5C61,60661,20,23,3,109.548,18.2377,1657
268942,08298D6D3F79F7819C6B0F651C6D5327,31521,0,2,2,109.51458,18.22542,1555
268943,08298D6D3F79F7819C6B0F651C6D5327,30731,2,6,4,109.50944,18.22306,1555
268944,08298D6D3F79F7819C6B0F651C6D5327,31521,6,9,3,109.51458,18.22542,1555
268945,08298D6D3F79F7819C6B0F651C6D5327,30731,9,10,1,109.50944,18.22306,1555
268946,08298D6D3F79F7819C6B0F651C6D5327,30421,11,14,3,109.50021,18.25861,1511
268950,08560778CB8997D42461ACE816D78234,39151,0,2,2,109.49875,18.25097,1510
268951,08560778CB8997D42461ACE816D78234,60401,3,4,1,109.47444,18.27583,1414
268952,08560778CB8997D42461ACE816D78234,60161,7,8,1,109.49174,18.26181,1461
268953,08560778CB8997D42461ACE816D78234,38315,12,13,1,109.48979,18.29764,1467
268976,77F5A37783010C53E376197FE3F1043D,31421,18,19,1,109.55382,18.22347,1705
268977,77F5A37783010C53E376197FE3F1043D,38111,20,21,1,109.52007,18.22403,1555
269003,43F5AB52A0AF3FEB5880C6DCD16BBA02,39101,14,20,6,109.50132,18.24931,1509
269004,43F5AB52A0AF3FEB5880C6DCD16BBA02,60011,20,23,3,109.48965,18.30222,1468
269032,9AE74F5A5B1B66625275FB429D7BDF53,30771,19,21,2,109.49938,18.26042,1511
269033,9AE74F5A5B1B66625275FB429D7BDF53,31081,22,23,1,109.44639,18.30181,1318
269034,A01B4012B619D942E7CC3AC9B78722B4,31561,1,2,1,109.56792,18.28479,1765
269035,A01B4012B619D942E7CC3AC9B78722B4,30854,2,3,1,109.56889,18.27076,1763
269036,A01B4012B619D942E7CC3AC9B78722B4,31561,4,8,4,109.56792,18.28479,1765
269037,A01B4012B619D942E7CC3AC9B78722B4,60381,13,17,4,109.5241,18.22458,1605
269038,A01B4012B619D942E7CC3AC9B78722B4,31561,20,22,2,109.56792,18.28479,1765
269058,417408FFDA93B177641D270D3A5C4B2D,31071,0,6,6,109.58257,18.28458,1815
269059,417408FFDA93B177641D270D3A5C4B2D,30854,6,20,14,109.56889,18.27076,1763
269060,417408FFDA93B177641D270D3A5C4B2D,31071,21,23,2,109.58257,18.28458,1815
269067,DE323AA9A239491ADDE7A783A5799ADA,30681,17,18,1,109.48493,18.26917,1463
269068,DE323AA9A239491ADDE7A783A5799ADA,30211,21,23,2,109.49882,18.23931,1508
269116,A4743972EC2FC58546DD11935BDC0E1A,39091,1,5,4,109.50097,18.25222,1510
269117,A4743972EC2FC58546DD11935BDC0E1A,30711,9,14,5,109.50271,18.25347,1510
269118,A4743972EC2FC58546DD11935BDC0E1A,31091,15,18,3,109.41201,18.31222,1170
269119,A4743972EC2FC58546DD11935BDC0E1A,39091,21,23,2,109.50097,18.25222,1510
269126,3499E731A877B5132E572C7056EDDA83,31261,13,15,2,109.51174,18.2466,1559
269127,3499E731A877B5132E572C7056EDDA83,31181,16,18,2,109.50382,18.24813,1509
269128,3499E731A877B5132E572C7056EDDA83,39151,18,19,1,109.49875,18.25097,1510
269129,3499E731A877B5132E572C7056EDDA83,60311,21,23,2,109.52097,18.24319,1558
269138,F866B6E34CEF853A6497211DD74A607E,60631,0,9,9,109.57778,18.27583,1814
269139,F866B6E34CEF853A6497211DD74A607E,60501,9,12,3,109.48701,18.29021,1466
269140,F866B6E34CEF853A6497211DD74A607E,30791,16,18,2,109.72333,18.40889,2386
269141,F866B6E34CEF853A6497211DD74A607E,30891,21,23,2,109.59431,18.28389,1865
269180,D4448A1349B0563C78F16B479359A95F,31071,3,7,4,109.58257,18.28458,1815
269181,D4448A1349B0563C78F16B479359A95F,30854,10,23,13,109.56889,18.27076,1763
269192,D2A5F87218CF25385163A2F3C4229CB8,31561,0,13,13,109.56792,18.28479,1765
269193,D2A5F87218CF25385163A2F3C4229CB8,60381,14,17,3,109.5241,18.22458,1605
269199,DD335423604E66F8128DEC8F07467E33,31521,0,7,7,109.51458,18.22542,1555
269200,DD335423604E66F8128DEC8F07467E33,31781,10,12,2,109.19847,18.2975,367
269201,DD335423604E66F8128DEC8F07467E33,31471,14,15,1,109.34583,18.29563,917
269202,DD335423604E66F8128DEC8F07467E33,30191,18,23,5,109.50361,18.22701,1506
269215,8438CC455C7563000E5EA4C29E329C92,31781,15,16,1,109.19847,18.2975,367
269216,8438CC455C7563000E5EA4C29E329C92,39131,19,23,4,109.2066,18.29639,417
269233,8DD23AA43C0F7967C45F7488D66F9159,30854,1,16,15,109.56889,18.27076,1763
269234,8DD23AA43C0F7967C45F7488D66F9159,31071,17,19,2,109.58257,18.28458,1815
269240,147470AD3D3B8724582C30D5F244A8B6,60421,0,16,16,109.46333,18.31743,1371
269241,147470AD3D3B8724582C30D5F244A8B6,30111,17,19,2,109.47583,18.30542,1419
269242,147470AD3D3B8724582C30D5F244A8B6,60421,20,22,2,109.46333,18.31743,1371
269256,8839938E8B61375A5BD6E99D0F7E2901,60221,0,7,7,109.52569,18.29188,1616
269257,8839938E8B61375A5BD6E99D0F7E2901,60381,11,12,1,109.5241,18.22458,1605
269258,8839938E8B61375A5BD6E99D0F7E2901,60421,14,16,2,109.46333,18.31743,1371
269259,8839938E8B61375A5BD6E99D0F7E2901,31061,17,19,2,109.53333,18.23257,1607
269317,BC2EDF4DF9C7FAD55BDEABA03DFA7284,31561,0,5,5,109.56792,18.28479,1765
269318,BC2EDF4DF9C7FAD55BDEABA03DFA7284,39183,8,11,3,109.55542,18.28208,1715
269319,BC2EDF4DF9C7FAD55BDEABA03DFA7284,31561,11,13,2,109.56792,18.28479,1765
269320,BC2EDF4DF9C7FAD55BDEABA03DFA7284,30851,14,15,1,109.5616,18.27396,1713
269321,BC2EDF4DF9C7FAD55BDEABA03DFA7284,30711,17,19,2,109.50271,18.25347,1510
269322,BC2EDF4DF9C7FAD55BDEABA03DFA7284,31561,21,23,2,109.56792,18.28479,1765
269375,D6CC1FC0E328F94E96D4D1F260DF9F7F,31071,0,2,2,109.58257,18.28458,1815
269376,D6CC1FC0E328F94E96D4D1F260DF9F7F,31071,2,5,3,109.58257,18.28458,1815
269377,D6CC1FC0E328F94E96D4D1F260DF9F7F,31071,7,8,1,109.58257,18.28458,1815
269378,D6CC1FC0E328F94E96D4D1F260DF9F7F,39371,14,15,1,109.56627,18.2646,1762
269379,D6CC1FC0E328F94E96D4D1F260DF9F7F,31071,16,23,7,109.58257,18.28458,1815
269391,FC3A0E75CA2AB7A7F2493FF9F12595DC,31171,11,13,2,109.50938,18.24917,1559
269393,FC3A0E75CA2AB7A7F2493FF9F12595DC,60291,19,23,4,109.50826,18.24639,1509
269402,B3F4E43DA3C4E855A3ED684A6CB97F36,31931,2,15,13,109.54771,18.29403,1667
269403,B3F4E43DA3C4E855A3ED684A6CB97F36,60221,16,19,3,109.52569,18.29188,1616
269413,7B2AEE2086698683607EDDDB4B678234,60241,17,19,2,109.53319,18.28667,1616
269414,7B2AEE2086698683607EDDDB4B678234,38154,20,22,2,109.5266,18.28278,1615
269471,CBC8159D1FCA35AFB9DA003A5F4078C2,31861,12,13,1,109.49042,18.27549,1464
269472,CBC8159D1FCA35AFB9DA003A5F4078C2,60501,14,16,2,109.48701,18.29021,1466
269490,5551596F41F816D6747C858927EE7E59,39181,16,18,2,109.55153,18.28035,1715
269491,5551596F41F816D6747C858927EE7E59,39183,21,23,2,109.55542,18.28208,1715
269513,B60C324D7CDB0C0FB6C857406F6733E1,30771,19,21,2,109.49938,18.26042,1511
269514,B60C324D7CDB0C0FB6C857406F6733E1,31081,22,23,1,109.44639,18.30181,1318
269515,75817DB682187A07461734D66E1E6492,60631,0,4,4,109.57778,18.27583,1814
269516,75817DB682187A07461734D66E1E6492,30854,5,13,8,109.56889,18.27076,1763
269517,28AD4F4A057EAD61FC013015642C4D8F,60081,1,5,4,109.51097,18.22639,1556
269518,28AD4F4A057EAD61FC013015642C4D8F,30191,5,7,2,109.50361,18.22701,1506
269519,28AD4F4A057EAD61FC013015642C4D8F,39183,10,11,1,109.55542,18.28208,1715
269520,28AD4F4A057EAD61FC013015642C4D8F,60081,12,13,1,109.51097,18.22639,1556
269521,28AD4F4A057EAD61FC013015642C4D8F,30191,15,23,8,109.50361,18.22701,1506
269522,2D3A7C5FA7BB9EA13D3B1F294EF7FCC8,60381,0,8,8,109.5241,18.22458,1605
269523,2D3A7C5FA7BB9EA13D3B1F294EF7FCC8,60381,10,13,3,109.5241,18.22458,1605
269524,2D3A7C5FA7BB9EA13D3B1F294EF7FCC8,30161,15,18,3,109.50042,18.24389,1508
269530,E16204D131FCD957D5ADB9592C1DD0ED,30854,0,8,8,109.56889,18.27076,1763
269531,E16204D131FCD957D5ADB9592C1DD0ED,31071,13,14,1,109.58257,18.28458,1815
269532,E16204D131FCD957D5ADB9592C1DD0ED,31071,15,19,4,109.58257,18.28458,1815
269533,95F6D81D9D517084554E43C715595D83,30661,14,16,2,109.37028,18.24361,1008
269534,95F6D81D9D517084554E43C715595D83,31471,16,22,6,109.34583,18.29563,917
269535,005F3AEFE6DBF371ED1FD57736434098,31071,0,7,7,109.58257,18.28458,1815
269536,005F3AEFE6DBF371ED1FD57736434098,30854,7,21,14,109.56889,18.27076,1763
269537,005F3AEFE6DBF371ED1FD57736434098,31071,22,23,1,109.58257,18.28458,1815
269561,34F3D64B41C252481F72E5CF931AC833,31071,0,1,1,109.58257,18.28458,1815
269562,34F3D64B41C252481F72E5CF931AC833,30851,3,5,2,109.5616,18.27396,1713
269563,34F3D64B41C252481F72E5CF931AC833,30854,6,20,14,109.56889,18.27076,1763
269564,32BB9E509788D1658D578FE7E9B0A887,30121,1,12,11,109.52861,18.27222,1613
269565,32BB9E509788D1658D578FE7E9B0A887,38017,13,22,9,109.49729,18.21424,1504
269572,69AA5F0353755F3C9E2FFDDC62335D4F,31521,0,6,6,109.51458,18.22542,1555
269573,69AA5F0353755F3C9E2FFDDC62335D4F,33051,11,14,3,109.6475,18.46618,2096
269574,69AA5F0353755F3C9E2FFDDC62335D4F,31521,16,18,2,109.51458,18.22542,1555
269575,69AA5F0353755F3C9E2FFDDC62335D4F,60381,20,22,2,109.5241,18.22458,1605
269597,F84D88C8F576C165CF03207AB14A530C,30771,19,21,2,109.49938,18.26042,1511
269598,F84D88C8F576C165CF03207AB14A530C,31081,22,23,1,109.44639,18.30181,1318
269603,ABCD0851CC1C78BCD7AF6DBDF2F5DE49,60524,1,5,4,109.42951,18.28993,1216
269604,ABCD0851CC1C78BCD7AF6DBDF2F5DE49,30211,5,7,2,109.49882,18.23931,1508
269605,ABCD0851CC1C78BCD7AF6DBDF2F5DE49,60552,9,17,8,109.41729,18.30014,1218
269606,ABCD0851CC1C78BCD7AF6DBDF2F5DE49,60524,18,19,1,109.42951,18.28993,1216
269607,ABCD0851CC1C78BCD7AF6DBDF2F5DE49,60552,20,22,2,109.41729,18.30014,1218
269608,B93D357AAB05700B15F775F104378052,38141,0,8,8,109.39479,18.2916,1116
269609,B93D357AAB05700B15F775F104378052,38271,13,18,5,109.62632,18.23049,1956
269624,17A4545370685D172A08774EFEF86DD3,31071,3,4,1,109.58257,18.28458,1815
269625,17A4545370685D172A08774EFEF86DD3,30851,4,6,2,109.5616,18.27396,1713
269626,17A4545370685D172A08774EFEF86DD3,31071,6,9,3,109.58257,18.28458,1815
269660,B643AC77F8D8498A9694D45BA8B0F75F,30854,6,7,1,109.56889,18.27076,1763
269661,B643AC77F8D8498A9694D45BA8B0F75F,60631,8,16,8,109.57778,18.27583,1814
269662,B643AC77F8D8498A9694D45BA8B0F75F,30854,17,21,4,109.56889,18.27076,1763
269678,7252A0F90E29EC78621699C082578EF7,31361,16,23,7,109.47417,18.28292,1415
269722,ABC75A24C8B7485C35E87659D236B1BA,60401,0,9,9,109.47444,18.27583,1414
269723,ABC75A24C8B7485C35E87659D236B1BA,60411,13,15,2,109.32514,18.30854,869
269724,ABC75A24C8B7485C35E87659D236B1BA,60054,16,17,1,109.3016,18.31229,770
269725,ABC75A24C8B7485C35E87659D236B1BA,31471,17,18,1,109.34583,18.29563,917
269726,ABC75A24C8B7485C35E87659D236B1BA,60411,19,21,2,109.32514,18.30854,869
269748,27BCEF3137923B84211F08830816C810,30851,19,21,2,109.5616,18.27396,1713
269767,5426296000364EE32711CD0E73D782C8,30854,3,13,10,109.56889,18.27076,1763
269768,5426296000364EE32711CD0E73D782C8,31071,14,15,1,109.58257,18.28458,1815
269769,5426296000364EE32711CD0E73D782C8,30854,17,18,1,109.56889,18.27076,1763
269788,91EC74D2B208A10BECBB101C6735C578,38171,0,1,1,109.50799,18.28139,1515
269789,91EC74D2B208A10BECBB101C6735C578,31864,1,7,6,109.49014,18.28333,1465
269790,91EC74D2B208A10BECBB101C6735C578,60171,7,13,6,109.51292,18.30694,1569
269834,22DF08AB8625FB5CE36A655BC50A3649,60501,15,16,1,109.48701,18.29021,1466
269835,22DF08AB8625FB5CE36A655BC50A3649,30711,19,23,4,109.50271,18.25347,1510
269846,D6CEBF9F3036F9FB69CD0D53FE57EFC2,39131,17,23,6,109.2066,18.29639,417
269861,9E1D23B2A9B6A11EA4641E27DBFA4B82,60381,0,13,13,109.5241,18.22458,1605
269862,9E1D23B2A9B6A11EA4641E27DBFA4B82,30161,15,17,2,109.50042,18.24389,1508
269873,EB30E1F8D2A0B8547D27259B11A72616,38271,0,8,8,109.62632,18.23049,1956
269874,EB30E1F8D2A0B8547D27259B11A72616,31391,13,14,1,109.50382,18.24285,1508
269875,EB30E1F8D2A0B8547D27259B11A72616,31041,14,16,2,109.50278,18.23701,1507
269876,EB30E1F8D2A0B8547D27259B11A72616,38271,20,23,3,109.62632,18.23049,1956
269886,6FBDDF7419820F8908B8A8CE3C81E7C3,30171,1,3,2,109.48458,18.27139,1463
269887,6FBDDF7419820F8908B8A8CE3C81E7C3,60621,4,19,15,109.48354,18.27451,1464
269888,6FBDDF7419820F8908B8A8CE3C81E7C3,60401,20,21,1,109.47444,18.27583,1414
269889,6FBDDF7419820F8908B8A8CE3C81E7C3,60621,22,23,1,109.48354,18.27451,1464
269890,40D6808616C3B61093B96D47DEDB77AD,30511,0,9,9,109.51069,18.24208,1558
269891,40D6808616C3B61093B96D47DEDB77AD,30201,12,13,1,109.4909,18.26465,1462
269894,F94EBB0B32E924A93A488CBC5BF180F4,31701,18,19,1,109.44132,18.28833,1266
269895,F94EBB0B32E924A93A488CBC5BF180F4,38105,20,22,2,109.40299,18.29229,1117
269913,F198CAA1F49ACA5D003FD8F8473B3798,31071,1,4,3,109.58257,18.28458,1815
269914,F198CAA1F49ACA5D003FD8F8473B3798,30854,8,9,1,109.56889,18.27076,1763
269967,C810233D58458ECBDA6B41A0E080954F,30771,16,17,1,109.49938,18.26042,1511
269968,C810233D58458ECBDA6B41A0E080954F,39151,19,23,4,109.49875,18.25097,1510
269987,1D2F8DB1F8B6A2081E1A43DDF558491D,31951,0,9,9,109.52174,18.30299,1568
269988,1D2F8DB1F8B6A2081E1A43DDF558491D,30071,10,11,1,109.52819,18.30472,1619
269989,1D2F8DB1F8B6A2081E1A43DDF558491D,31951,11,19,8,109.52174,18.30299,1568
269990,8C5A16299A6D294198C90C34C25C5949,39183,0,2,2,109.55542,18.28208,1715
269991,8C5A16299A6D294198C90C34C25C5949,30851,3,5,2,109.5616,18.27396,1713
269992,8C5A16299A6D294198C90C34C25C5949,30854,9,11,2,109.56889,18.27076,1763
269993,8C5A16299A6D294198C90C34C25C5949,30851,14,16,2,109.5616,18.27396,1713
269994,8C5A16299A6D294198C90C34C25C5949,30854,17,19,2,109.56889,18.27076,1763
269995,8C5A16299A6D294198C90C34C25C5949,39183,21,23,2,109.55542,18.28208,1715
269996,0526FBDD03CECB7E3925506B4441EC17,31443,0,9,9,109.5116,18.24438,1559
269997,0526FBDD03CECB7E3925506B4441EC17,60361,9,11,2,109.51938,18.29681,1567
269998,0526FBDD03CECB7E3925506B4441EC17,31443,12,20,8,109.5116,18.24438,1559
270021,58CDDF83DCFC1E60490503CB846BF15A,30854,14,16,2,109.56889,18.27076,1763
270022,58CDDF83DCFC1E60490503CB846BF15A,31561,21,23,2,109.56792,18.28479,1765
270092,C711EA8F4B039EAC279F7CFC24309A8A,30071,0,10,10,109.52819,18.30472,1619
270093,C711EA8F4B039EAC279F7CFC24309A8A,30071,11,13,2,109.52819,18.30472,1619
270094,C711EA8F4B039EAC279F7CFC24309A8A,30071,16,18,2,109.52819,18.30472,1619
270095,C711EA8F4B039EAC279F7CFC24309A8A,38484,20,22,2,109.53028,18.31528,1620
270096,2D39AE6120F2674000C6DBB8A6E572A0,31945,1,6,5,109.58021,18.29403,1817
270097,2D39AE6120F2674000C6DBB8A6E572A0,30854,8,20,12,109.56889,18.27076,1763
270111,49780829974BE414545DBC0680DF8A28,30854,11,18,7,109.56889,18.27076,1763
270112,49780829974BE414545DBC0680DF8A28,31071,21,23,2,109.58257,18.28458,1815
270128,770A00BDAFE9BCA8C9E9FA68066EED7D,31561,12,13,1,109.56792,18.28479,1765
270129,770A00BDAFE9BCA8C9E9FA68066EED7D,30854,16,18,2,109.56889,18.27076,1763
270130,770A00BDAFE9BCA8C9E9FA68066EED7D,31071,21,23,2,109.58257,18.28458,1815
270163,F7CECA14E444D79FC66F453D0CDB5754,31321,15,23,8,109.63799,18.23201,2007
270206,FFFC0994E5C15BDB165344716912442C,31554,0,2,2,109.55521,18.2459,1709
270207,FFFC0994E5C15BDB165344716912442C,39371,3,6,3,109.56627,18.2646,1762
270208,FFFC0994E5C15BDB165344716912442C,31554,7,10,3,109.55521,18.2459,1709
270209,FFFC0994E5C15BDB165344716912442C,31421,10,12,2,109.55382,18.22347,1705
270210,FFFC0994E5C15BDB165344716912442C,31554,12,23,11,109.55521,18.2459,1709
270216,B6A8225D84CC06865D19854E19C5D3FF,30561,0,11,11,109.52778,18.31938,1621
270217,B6A8225D84CC06865D19854E19C5D3FF,30711,11,14,3,109.50271,18.25347,1510
270218,B6A8225D84CC06865D19854E19C5D3FF,30911,14,17,3,109.50493,18.26181,1511
270219,B6A8225D84CC06865D19854E19C5D3FF,30711,17,19,2,109.50271,18.25347,1510
270220,B6A8225D84CC06865D19854E19C5D3FF,38484,20,23,3,109.53028,18.31528,1620
270280,46D3900FF4CD0CE137E6DB2E5BBC5B87,39183,0,12,12,109.55542,18.28208,1715
270281,46D3900FF4CD0CE137E6DB2E5BBC5B87,31561,15,17,2,109.56792,18.28479,1765
270282,46D3900FF4CD0CE137E6DB2E5BBC5B87,39183,17,23,6,109.55542,18.28208,1715
270305,2F4C1C91886E87D50AD517FFA0255365,60381,18,21,3,109.5241,18.22458,1605
270306,2F4C1C91886E87D50AD517FFA0255365,38951,22,23,1,109.48097,18.28868,1416
270318,E191BF114A3C2277CB7C3323BAA13F43,30854,10,13,3,109.56889,18.27076,1763
270319,E191BF114A3C2277CB7C3323BAA13F43,38154,17,20,3,109.5266,18.28278,1615
270323,9FC721E86703223349C05C95FE4BBB6F,30731,0,10,10,109.50944,18.22306,1555
270324,9FC721E86703223349C05C95FE4BBB6F,60381,11,14,3,109.5241,18.22458,1605
270325,9FC721E86703223349C05C95FE4BBB6F,31521,14,16,2,109.51458,18.22542,1555
270326,9FC721E86703223349C05C95FE4BBB6F,60381,18,20,2,109.5241,18.22458,1605
270327,9FC721E86703223349C05C95FE4BBB6F,60081,21,23,2,109.51097,18.22639,1556
270359,0A4F42A6BEA3B55EB10690E35CCB86A0,38361,0,8,8,109.43667,18.29201,1267
270360,0A4F42A6BEA3B55EB10690E35CCB86A0,31301,12,13,1,109.14493,18.31222,170
270361,0A4F42A6BEA3B55EB10690E35CCB86A0,31471,14,16,2,109.34583,18.29563,917
270362,0A4F42A6BEA3B55EB10690E35CCB86A0,38361,19,23,4,109.43667,18.29201,1267
270368,E8D51F8B53F290BFD73338AD2AD8C728,31561,15,16,1,109.56792,18.28479,1765
270369,E8D51F8B53F290BFD73338AD2AD8C728,30711,18,19,1,109.50271,18.25347,1510
270370,E8D51F8B53F290BFD73338AD2AD8C728,31561,20,22,2,109.56792,18.28479,1765
270375,1FC565965746807D5CEEE5746DEC2EDB,31061,1,5,4,109.53333,18.23257,1607
270376,1FC565965746807D5CEEE5746DEC2EDB,60211,5,6,1,109.63549,18.26049,2011
270377,1FC565965746807D5CEEE5746DEC2EDB,31061,6,10,4,109.53333,18.23257,1607
270378,1FC565965746807D5CEEE5746DEC2EDB,60381,10,11,1,109.5241,18.22458,1605
270379,1FC565965746807D5CEEE5746DEC2EDB,31061,13,23,10,109.53333,18.23257,1607
270387,FACA7C472055342CB52356ECCA18D789,60281,0,1,1,109.51743,18.25924,1561
270388,FACA7C472055342CB52356ECCA18D789,31461,1,12,11,109.5091,18.25389,1510
270389,FACA7C472055342CB52356ECCA18D789,30421,12,13,1,109.50021,18.25861,1511
270390,FACA7C472055342CB52356ECCA18D789,60281,14,20,6,109.51743,18.25924,1561
270391,FACA7C472055342CB52356ECCA18D789,30421,20,22,2,109.50021,18.25861,1511
270443,B3314CC1A9932E46ABE32B43A9CE4E61,31521,14,16,2,109.51458,18.22542,1555
270444,B3314CC1A9932E46ABE32B43A9CE4E61,60221,19,23,4,109.52569,18.29188,1616
270445,837D6F2B70308AF8E153EC6E3EB7BC0F,30861,0,2,2,109.52722,18.22743,1606
270446,837D6F2B70308AF8E153EC6E3EB7BC0F,30854,3,7,4,109.56889,18.27076,1763
270462,27F8982923E7FB8E96EFC86B9D9B43A5,31031,10,15,5,109.49979,18.25382,1510
270467,30B65052F35DDEF849EA88BF5D44AAAC,30324,11,12,1,109.50326,18.29257,1517
270468,30B65052F35DDEF849EA88BF5D44AAAC,31621,13,17,4,109.51035,18.29826,1568
270525,D334753E33AD01D79142036B3D85543F,31561,0,5,5,109.56792,18.28479,1765
270526,D334753E33AD01D79142036B3D85543F,39183,6,11,5,109.55542,18.28208,1715
270527,D334753E33AD01D79142036B3D85543F,31561,15,16,1,109.56792,18.28479,1765
270563,47A18820FDA9856131F74091D44B6BCB,31071,0,6,6,109.58257,18.28458,1815
270564,47A18820FDA9856131F74091D44B6BCB,31561,7,10,3,109.56792,18.28479,1765
270565,47A18820FDA9856131F74091D44B6BCB,31071,12,13,1,109.58257,18.28458,1815
270566,47A18820FDA9856131F74091D44B6BCB,31561,14,21,7,109.56792,18.28479,1765
270603,783BD28003E162AB1A89D7CEEED7100D,30421,18,20,2,109.50021,18.25861,1511
270605,48F96D4A7859D993A1FE7B58F8723D73,38951,19,22,3,109.48097,18.28868,1416
270630,A9FCE0049DB44FE004EAFBF5B783F4A5,31945,2,7,5,109.58021,18.29403,1817
270631,A9FCE0049DB44FE004EAFBF5B783F4A5,30854,7,16,9,109.56889,18.27076,1763
270679,A64494D6F3A0AF8BF93D9FAA1169011A,31351,16,19,3,109.4959,18.28417,1465
270680,A64494D6F3A0AF8BF93D9FAA1169011A,38811,20,23,3,109.50875,18.2175,1504
270707,8E06EAC16B0EF776FA1BAAC5B9747325,30911,0,8,8,109.50493,18.26181,1511
270708,8E06EAC16B0EF776FA1BAAC5B9747325,30511,11,13,2,109.51069,18.24208,1558
270709,8E06EAC16B0EF776FA1BAAC5B9747325,30511,15,18,3,109.51069,18.24208,1558
270710,8E06EAC16B0EF776FA1BAAC5B9747325,60331,18,23,5,109.505,18.26507,1512
270713,201045A9C980BD8E53B16B9129DFE596,31071,0,6,6,109.58257,18.28458,1815
270714,201045A9C980BD8E53B16B9129DFE596,30854,6,10,4,109.56889,18.27076,1763
270715,201045A9C980BD8E53B16B9129DFE596,31071,10,12,2,109.58257,18.28458,1815
270716,201045A9C980BD8E53B16B9129DFE596,30854,14,16,2,109.56889,18.27076,1763
270717,201045A9C980BD8E53B16B9129DFE596,31071,16,23,7,109.58257,18.28458,1815
270718,84DF4A7C208235D171EF56473BCCF210,30851,0,3,3,109.5616,18.27396,1713
270719,84DF4A7C208235D171EF56473BCCF210,31561,3,6,3,109.56792,18.28479,1765
270720,84DF4A7C208235D171EF56473BCCF210,60631,7,16,9,109.57778,18.27583,1814
270724,2873D39E7EAE4EB9FF7882E90907EED7,30764,0,12,12,109.45806,18.29486,1367
270725,2873D39E7EAE4EB9FF7882E90907EED7,60054,15,16,1,109.3016,18.31229,770
270726,2873D39E7EAE4EB9FF7882E90907EED7,31471,17,18,1,109.34583,18.29563,917
270727,2873D39E7EAE4EB9FF7882E90907EED7,31231,19,20,1,109.42597,18.29292,1217
270728,2873D39E7EAE4EB9FF7882E90907EED7,30764,21,23,2,109.45806,18.29486,1367
270738,015CDEB9169BCE5537ABAE49B6A63F2B,31071,1,7,6,109.58257,18.28458,1815
270739,015CDEB9169BCE5537ABAE49B6A63F2B,30854,7,10,3,109.56889,18.27076,1763
270740,015CDEB9169BCE5537ABAE49B6A63F2B,60463,12,16,4,109.52507,18.22438,1605
270741,015CDEB9169BCE5537ABAE49B6A63F2B,31071,17,19,2,109.58257,18.28458,1815
270750,3B7F4B71C655A8575FEAE798DEE249A5,31473,13,14,1,109.34792,18.29465,917
270751,3B7F4B71C655A8575FEAE798DEE249A5,39111,19,23,4,109.5191,18.22597,1555
270756,83F8DEFB45E9970F803B6E01CF53475C,30681,3,4,1,109.48493,18.26917,1463
270757,83F8DEFB45E9970F803B6E01CF53475C,38871,5,6,1,109.44681,18.28625,1316
270758,83F8DEFB45E9970F803B6E01CF53475C,30681,8,12,4,109.48493,18.26917,1463
270759,83F8DEFB45E9970F803B6E01CF53475C,30171,17,18,1,109.48458,18.27139,1463
270760,83F8DEFB45E9970F803B6E01CF53475C,31021,19,21,2,109.49021,18.27,1463
270770,E4D199FCE009427481C9D06B9609AB1E,31931,1,8,7,109.54771,18.29403,1667
270771,E4D199FCE009427481C9D06B9609AB1E,39181,8,10,2,109.55153,18.28035,1715
270772,E4D199FCE009427481C9D06B9609AB1E,31931,11,12,1,109.54771,18.29403,1667
270773,E4D199FCE009427481C9D06B9609AB1E,39181,12,21,9,109.55153,18.28035,1715
270774,E4D199FCE009427481C9D06B9609AB1E,31931,22,23,1,109.54771,18.29403,1667
270777,0EDCFC899F380C41F9A2EE3D4C482F01,39151,0,1,1,109.49875,18.25097,1510
270778,0EDCFC899F380C41F9A2EE3D4C482F01,31231,3,6,3,109.42597,18.29292,1217
270789,7024F3A14F6F554DC6E80063E30315F0,31561,2,14,12,109.56792,18.28479,1765
270790,7024F3A14F6F554DC6E80063E30315F0,30854,15,16,1,109.56889,18.27076,1763
270791,7024F3A14F6F554DC6E80063E30315F0,31561,21,23,2,109.56792,18.28479,1765
270863,CEE029BCE37FDC8F7F38CBD43D03FD52,31561,1,19,18,109.56792,18.28479,1765
270864,CEE029BCE37FDC8F7F38CBD43D03FD52,30851,22,23,1,109.5616,18.27396,1713
270865,15C58AA4098F7C3C06247EBC0EBAF235,31145,15,16,1,109.20431,18.30479,369
270866,15C58AA4098F7C3C06247EBC0EBAF235,31521,18,19,1,109.51458,18.22542,1555
270867,15C58AA4098F7C3C06247EBC0EBAF235,60381,19,22,3,109.5241,18.22458,1605
270868,8B167331F8E78254A4CBA6A89A1236BC,60524,0,7,7,109.42951,18.28993,1216
270869,8B167331F8E78254A4CBA6A89A1236BC,60401,12,13,1,109.47444,18.27583,1414
270870,8B167331F8E78254A4CBA6A89A1236BC,60524,14,15,1,109.42951,18.28993,1216
270871,8B167331F8E78254A4CBA6A89A1236BC,60551,16,17,1,109.42722,18.30111,1218
270874,0D00E0CA974DDA00224ACCD00B993468,30851,18,19,1,109.5616,18.27396,1713
270875,0D00E0CA974DDA00224ACCD00B993468,31071,19,22,3,109.58257,18.28458,1815
270888,C5536869E807B602F99387523BE0105F,38291,17,22,5,109.51618,18.24313,1558
270889,4F19CF91A90D82A7A316A166A92A1B65,31021,1,7,6,109.49021,18.27,1463
270890,4F19CF91A90D82A7A316A166A92A1B65,31471,11,12,1,109.34583,18.29563,917
270891,4F19CF91A90D82A7A316A166A92A1B65,60054,15,16,1,109.3016,18.31229,770
270898,F00821368F615DCDAF214035D8EC4A44,31071,1,2,1,109.58257,18.28458,1815
270899,F00821368F615DCDAF214035D8EC4A44,30854,2,11,9,109.56889,18.27076,1763
270900,F00821368F615DCDAF214035D8EC4A44,60354,15,16,1,109.58701,18.28521,1815
270920,96F98526707B06BE1263CCD4F72E07A1,31071,0,8,8,109.58257,18.28458,1815
270921,96F98526707B06BE1263CCD4F72E07A1,30854,9,10,1,109.56889,18.27076,1763
270922,96F98526707B06BE1263CCD4F72E07A1,31071,11,13,2,109.58257,18.28458,1815
270923,335A7B1DE8538918FDA774EE3E402A76,30191,0,7,7,109.50361,18.22701,1506
270924,335A7B1DE8538918FDA774EE3E402A76,31521,9,13,4,109.51458,18.22542,1555
270925,335A7B1DE8538918FDA774EE3E402A76,30191,13,23,10,109.50361,18.22701,1506
270963,71048DA762610C5657DD6D8242833DC9,30854,16,17,1,109.56889,18.27076,1763
270964,71048DA762610C5657DD6D8242833DC9,30234,18,19,1,109.60681,18.29979,1918
270965,71048DA762610C5657DD6D8242833DC9,30854,20,22,2,109.56889,18.27076,1763
270971,B93185B4820D7E0DEE74EBEA00941D15,31261,0,2,2,109.51174,18.2466,1559
270972,B93185B4820D7E0DEE74EBEA00941D15,30911,3,17,14,109.50493,18.26181,1511
270989,B53BDB0E641543CDF2C1AD769CF0243E,48574,15,17,2,109.48931,18.28458,1465
270990,B53BDB0E641543CDF2C1AD769CF0243E,60381,19,20,1,109.5241,18.22458,1605
270991,B53BDB0E641543CDF2C1AD769CF0243E,48574,21,23,2,109.48931,18.28458,1465
271006,409F5E8F01172D32BBE91132149C037E,38376,0,9,9,109.50924,18.24,1558
271007,409F5E8F01172D32BBE91132149C037E,30171,10,12,2,109.48458,18.27139,1463
271008,409F5E8F01172D32BBE91132149C037E,30361,12,14,2,109.50347,18.24,1508
271009,409F5E8F01172D32BBE91132149C037E,31271,19,20,1,109.48958,18.26257,1462
271010,6E2021B014C4D0B652A2E4FE8D2CF038,31071,0,8,8,109.58257,18.28458,1815
271011,6E2021B014C4D0B652A2E4FE8D2CF038,30854,9,11,2,109.56889,18.27076,1763
271012,6E2021B014C4D0B652A2E4FE8D2CF038,31071,15,17,2,109.58257,18.28458,1815
271013,6E2021B014C4D0B652A2E4FE8D2CF038,30854,18,19,1,109.56889,18.27076,1763
271014,6E2021B014C4D0B652A2E4FE8D2CF038,60354,19,21,2,109.58701,18.28521,1815
271021,75BB5F056A285E641293B913E6CE7C17,38291,0,8,8,109.51618,18.24313,1558
271022,75BB5F056A285E641293B913E6CE7C17,60311,8,11,3,109.52097,18.24319,1558
271023,75BB5F056A285E641293B913E6CE7C17,31864,12,14,2,109.49014,18.28333,1465
271041,95BE48C021B50D6A6455D1E388D02603,30661,0,7,7,109.37028,18.24361,1008
271042,95BE48C021B50D6A6455D1E388D02603,60411,8,9,1,109.32514,18.30854,869
271043,95BE48C021B50D6A6455D1E388D02603,30661,14,16,2,109.37028,18.24361,1008
271044,95BE48C021B50D6A6455D1E388D02603,31471,20,22,2,109.34583,18.29563,917
271062,CD77A45360FB53F816FCE62F008EEE28,39131,10,11,1,109.2066,18.29639,417
271063,CD77A45360FB53F816FCE62F008EEE28,60241,13,19,6,109.53319,18.28667,1616
271064,CD77A45360FB53F816FCE62F008EEE28,39154,20,22,2,109.50201,18.25681,1511
271080,5CA55CD8D4F566164B5FC97C1F60F037,60381,1,12,11,109.5241,18.22458,1605
271081,5CA55CD8D4F566164B5FC97C1F60F037,31471,15,16,1,109.34583,18.29563,917
271097,C70F13EBED98CEA95256B69B55849D14,39111,0,10,10,109.5191,18.22597,1555
271098,C70F13EBED98CEA95256B69B55849D14,39321,10,13,3,109.529,18.2167,1604
271099,C70F13EBED98CEA95256B69B55849D14,39111,14,17,3,109.5191,18.22597,1555
271100,C70F13EBED98CEA95256B69B55849D14,39321,19,20,1,109.529,18.2167,1604
271101,C70F13EBED98CEA95256B69B55849D14,30731,20,23,3,109.50944,18.22306,1555
271102,52C15F07544D9CC60D46BD6BA2551891,31945,18,20,2,109.58021,18.29403,1817
271103,52C15F07544D9CC60D46BD6BA2551891,31181,22,23,1,109.50382,18.24813,1509
271111,C162E20472DBB598395501A28AA53C86,31351,0,1,1,109.4959,18.28417,1465
271112,C162E20472DBB598395501A28AA53C86,31671,2,7,5,109.38965,18.29813,1068
271113,C162E20472DBB598395501A28AA53C86,38185,9,12,3,109.51333,18.27347,1563
271114,C162E20472DBB598395501A28AA53C86,31671,12,15,3,109.38965,18.29813,1068
271155,48C572DE45F47C4C9AC9760072E5355D,31781,13,15,2,109.19847,18.2975,367
271156,48C572DE45F47C4C9AC9760072E5355D,60401,16,18,2,109.47444,18.27583,1414
271157,48C572DE45F47C4C9AC9760072E5355D,31521,21,23,2,109.51458,18.22542,1555
271166,92A852F4802D3D92C195A90A9645A57F,31471,13,14,1,109.34583,18.29563,917
271167,92A852F4802D3D92C195A90A9645A57F,38325,18,20,2,109.39792,18.2909,1116
271168,92A852F4802D3D92C195A90A9645A57F,38903,21,22,1,109.39229,18.29243,1117
271178,DBB710D279E76C79F1E4B0766F579F8A,31071,1,7,6,109.58257,18.28458,1815
271179,DBB710D279E76C79F1E4B0766F579F8A,30854,9,10,1,109.56889,18.27076,1763
271180,DBB710D279E76C79F1E4B0766F579F8A,31945,14,15,1,109.58021,18.29403,1817
271184,59127DC6B0F65E35F1A06151B98097C8,31521,12,15,3,109.51458,18.22542,1555
271185,59127DC6B0F65E35F1A06151B98097C8,31521,17,23,6,109.51458,18.22542,1555
271224,78DA7A4E680FDAB27461B8DE1108145A,31071,1,3,2,109.58257,18.28458,1815
271225,78DA7A4E680FDAB27461B8DE1108145A,30854,3,20,17,109.56889,18.27076,1763
271226,99CBAA6A65A50998F0A10B72B36210E4,60231,1,12,11,109.49903,18.21972,1504
271227,99CBAA6A65A50998F0A10B72B36210E4,38251,12,15,3,109.49618,18.25493,1510
271228,99CBAA6A65A50998F0A10B72B36210E4,31091,18,19,1,109.41201,18.31222,1170
271229,99CBAA6A65A50998F0A10B72B36210E4,38251,19,21,2,109.49618,18.25493,1510
271234,F0A193984741E1FF945C798D00267316,38251,0,11,11,109.49618,18.25493,1510
271235,F0A193984741E1FF945C798D00267316,31471,15,16,1,109.34583,18.29563,917
271236,F0A193984741E1FF945C798D00267316,38251,20,23,3,109.49618,18.25493,1510
271244,66A68DF7322984DDFD4069A80816FA0D,38052,8,9,1,109.62618,18.23042,1956
271245,66A68DF7322984DDFD4069A80816FA0D,38331,10,14,4,109.62465,18.22736,1956
271246,66A68DF7322984DDFD4069A80816FA0D,60594,15,16,1,109.62694,18.22799,1956
271259,000584B3023702F3E9DDF521B1C35B1A,31071,1,6,5,109.58257,18.28458,1815
271260,000584B3023702F3E9DDF521B1C35B1A,30854,8,10,2,109.56889,18.27076,1763
271261,000584B3023702F3E9DDF521B1C35B1A,31945,12,23,11,109.58021,18.29403,1817
271267,7EBC20D0E5F0FBA046CA1D08E7FF47C1,31071,19,21,2,109.58257,18.28458,1815
271268,7EBC20D0E5F0FBA046CA1D08E7FF47C1,30854,21,23,2,109.56889,18.27076,1763
271290,A35D2DDD81A64779F2A13924D85B1FB0,38315,12,13,1,109.48979,18.29764,1467
271298,37D38EF0062E64D55C94EB554B76F9EE,31071,0,6,6,109.58257,18.28458,1815
271299,37D38EF0062E64D55C94EB554B76F9EE,30854,10,15,5,109.56889,18.27076,1763
271302,4E2E832AE9D054F6D1F41FA6FCE0E148,30851,18,19,1,109.5616,18.27396,1713
271303,4E2E832AE9D054F6D1F41FA6FCE0E148,31561,19,22,3,109.56792,18.28479,1765
271310,3C5AEA306E8A69C707195C4150E77D90,31931,1,2,1,109.54771,18.29403,1667
271311,3C5AEA306E8A69C707195C4150E77D90,39181,5,6,1,109.55153,18.28035,1715
271312,3C5AEA306E8A69C707195C4150E77D90,31931,9,11,2,109.54771,18.29403,1667
271313,3C5AEA306E8A69C707195C4150E77D90,60371,15,16,1,109.53063,18.30056,1618
271314,3C5AEA306E8A69C707195C4150E77D90,31931,20,23,3,109.54771,18.29403,1667
271348,116946A75ECB7D461042B4C21CF61908,30111,1,11,10,109.47583,18.30542,1419
271349,116946A75ECB7D461042B4C21CF61908,30361,13,15,2,109.50347,18.24,1508
271350,116946A75ECB7D461042B4C21CF61908,38094,16,17,1,109.45403,18.28778,1316
271363,F5E480BCE870DAE347CB60AA32F4CA1B,60281,13,14,1,109.51743,18.25924,1561
271364,F5E480BCE870DAE347CB60AA32F4CA1B,31206,18,20,2,109.50819,18.23549,1507
271365,F5E480BCE870DAE347CB60AA32F4CA1B,31461,20,23,3,109.5091,18.25389,1510
271377,020753EF78F0A0C39658113A3377EA1E,30854,1,2,1,109.56889,18.27076,1763
271378,020753EF78F0A0C39658113A3377EA1E,31561,3,19,16,109.56792,18.28479,1765
271382,3971E288F0FB50DDE06A11C534E966DA,39151,19,20,1,109.49875,18.25097,1510
271383,3971E288F0FB50DDE06A11C534E966DA,30191,21,22,1,109.50361,18.22701,1506
271411,76F6A54588C8DF7DDADFC50CAA11D44C,30854,4,15,11,109.56889,18.27076,1763
271412,76F6A54588C8DF7DDADFC50CAA11D44C,38085,15,23,8,109.6291,18.23625,2007
271462,2F578B567AB440CCCFAE4543FB5BCFD7,30361,12,14,2,109.50347,18.24,1508
271463,2F578B567AB440CCCFAE4543FB5BCFD7,60401,14,16,2,109.47444,18.27583,1414
271464,012ABD06F231728C214A4BA917E75B1C,31561,0,5,5,109.56792,18.28479,1765
271465,012ABD06F231728C214A4BA917E75B1C,30854,7,8,1,109.56889,18.27076,1763
271466,012ABD06F231728C214A4BA917E75B1C,31561,9,10,1,109.56792,18.28479,1765
271467,012ABD06F231728C214A4BA917E75B1C,30851,11,13,2,109.5616,18.27396,1713
271468,012ABD06F231728C214A4BA917E75B1C,31561,14,15,1,109.56792,18.28479,1765
271469,012ABD06F231728C214A4BA917E75B1C,30851,15,16,1,109.5616,18.27396,1713
271470,51061B3DE820AF1C1C713EF684728003,31071,2,6,4,109.58257,18.28458,1815
271471,51061B3DE820AF1C1C713EF684728003,30854,9,10,1,109.56889,18.27076,1763
271472,51061B3DE820AF1C1C713EF684728003,31071,13,14,1,109.58257,18.28458,1815
271473,51061B3DE820AF1C1C713EF684728003,30854,14,21,7,109.56889,18.27076,1763
271474,213AF2099653A4ADAEF799CCC144B279,30021,1,21,20,109.12014,18.40986,86
271476,A8E9C7BB918ADAD29A3EA7ACDDCD32D7,31261,0,7,7,109.51174,18.2466,1559
271477,A8E9C7BB918ADAD29A3EA7ACDDCD32D7,38951,7,19,12,109.48097,18.28868,1416
271478,A8E9C7BB918ADAD29A3EA7ACDDCD32D7,38951,19,23,4,109.48097,18.28868,1416
271509,BC9379F60A71CB59CD8F3A1655FC51C1,30161,20,21,1,109.50042,18.24389,1508
271510,BC9379F60A71CB59CD8F3A1655FC51C1,30361,21,23,2,109.50347,18.24,1508
271529,8468419E5C597B7D73CBDE87F8FF8BC8,38171,14,23,9,109.50799,18.28139,1515
271551,9D6121CD6282CA9FECC2A1981BC306C6,31071,5,15,10,109.58257,18.28458,1815
271552,9D6121CD6282CA9FECC2A1981BC306C6,31561,19,22,3,109.56792,18.28479,1765
271556,A0CFD24F8D50ABCF6002C5FC96CEAB76,39183,0,12,12,109.55542,18.28208,1715
271557,A0CFD24F8D50ABCF6002C5FC96CEAB76,39181,16,21,5,109.55153,18.28035,1715
271562,304893F9D89FE7F975345BDEC6DE10AD,39131,17,23,6,109.2066,18.29639,417
271563,73FC49A89676FB4107071248ADBDF948,31561,0,2,2,109.56792,18.28479,1765
271564,73FC49A89676FB4107071248ADBDF948,39183,6,9,3,109.55542,18.28208,1715
271565,73FC49A89676FB4107071248ADBDF948,30851,9,15,6,109.5616,18.27396,1713
271566,73FC49A89676FB4107071248ADBDF948,39183,17,18,1,109.55542,18.28208,1715
271571,BEE3A0C9BB09D7F210E3490BED90A1BE,30791,0,16,16,109.72333,18.40889,2386
271572,BEE3A0C9BB09D7F210E3490BED90A1BE,30071,19,21,2,109.52819,18.30472,1619
271573,D9AE11CD16B231308C3F0FB3F53BC3E9,31071,13,14,1,109.58257,18.28458,1815
271574,D9AE11CD16B231308C3F0FB3F53BC3E9,30854,19,23,4,109.56889,18.27076,1763
271582,E2D4D9AB60C01F4DDBFF32F06C5B8E99,30854,9,10,1,109.56889,18.27076,1763
271584,59C8F522837794F40F5181683B9A3A94,31271,0,7,7,109.48958,18.26257,1462
271647,D61883A9E0C7F2103C981F95E51C66DA,38291,0,1,1,109.51618,18.24313,1558
271648,D61883A9E0C7F2103C981F95E51C66DA,31821,3,4,1,109.51181,18.24924,1559
271649,D61883A9E0C7F2103C981F95E51C66DA,31931,5,8,3,109.54771,18.29403,1667
271650,D61883A9E0C7F2103C981F95E51C66DA,60241,10,11,1,109.53319,18.28667,1616
271663,68CEAA977F13F8E6482609B7352C0B52,30921,0,13,13,109.53903,18.29451,1667
271664,68CEAA977F13F8E6482609B7352C0B52,30361,17,19,2,109.50347,18.24,1508
271665,68CEAA977F13F8E6482609B7352C0B52,30921,21,23,2,109.53903,18.29451,1667
271668,F477CD0D1BA571DFDAA4F6B37DA3B938,60117,0,11,11,109.73604,18.35681,2427
271671,F3EA4B3DF8A619A30272A53ECD9E968F,30461,0,11,11,109.5116,18.26313,1562
271672,F3EA4B3DF8A619A30272A53ECD9E968F,30711,11,14,3,109.50271,18.25347,1510
271673,F3EA4B3DF8A619A30272A53ECD9E968F,31351,19,20,1,109.4959,18.28417,1465
271727,92E14A6094471B9C1A50CE8585136EC6,30211,0,2,2,109.49882,18.23931,1508
271728,92E14A6094471B9C1A50CE8585136EC6,60087,5,7,2,109.50688,18.22299,1505
271730,92E14A6094471B9C1A50CE8585136EC6,30731,16,23,7,109.50944,18.22306,1555
271771,DC9973204E62AA99FA79F0696CF6C0F6,30854,1,10,9,109.56889,18.27076,1763
271772,DC9973204E62AA99FA79F0696CF6C0F6,31945,15,16,1,109.58021,18.29403,1817
271773,DC9973204E62AA99FA79F0696CF6C0F6,30854,19,23,4,109.56889,18.27076,1763
271778,C983E73D646629A775690ECA8920EB29,31631,0,2,2,109.59542,18.36826,1879
271779,C983E73D646629A775690ECA8920EB29,30101,2,21,19,109.57299,18.33333,1773
271835,3C41A72AB684AF05AAF7A1837796966D,30361,17,19,2,109.50347,18.24,1508
271836,3C41A72AB684AF05AAF7A1837796966D,38961,20,23,3,109.50847,18.23514,1507
271840,B67077454AD8A4D5B7466F7FC75A23B9,60411,0,15,15,109.32514,18.30854,869
271841,B67077454AD8A4D5B7466F7FC75A23B9,30661,17,20,3,109.37028,18.24361,1008
271842,B67077454AD8A4D5B7466F7FC75A23B9,60411,22,23,1,109.32514,18.30854,869
271843,23073B802C909D3D46ECEB73A8309E22,30961,4,6,2,109.74042,18.37903,2431
271844,23073B802C909D3D46ECEB73A8309E22,60631,11,12,1,109.57778,18.27583,1814
271845,23073B802C909D3D46ECEB73A8309E22,30854,12,14,2,109.56889,18.27076,1763
271860,37657A593A7A700C5ECCE5BB0AAAABA7,31931,0,6,6,109.54771,18.29403,1667
271861,37657A593A7A700C5ECCE5BB0AAAABA7,39181,7,8,1,109.55153,18.28035,1715
271862,37657A593A7A700C5ECCE5BB0AAAABA7,31931,9,19,10,109.54771,18.29403,1667
271863,36B4A30042EDB6D7667588D6680D6E56,30234,16,17,1,109.60681,18.29979,1918
271874,F1114751990E9EE36CDB7660EAA9CD6F,31071,0,6,6,109.58257,18.28458,1815
271875,F1114751990E9EE36CDB7660EAA9CD6F,30854,6,7,1,109.56889,18.27076,1763
271876,F1114751990E9EE36CDB7660EAA9CD6F,31071,9,13,4,109.58257,18.28458,1815
271877,F1114751990E9EE36CDB7660EAA9CD6F,30854,14,16,2,109.56889,18.27076,1763
271878,F1114751990E9EE36CDB7660EAA9CD6F,31071,16,20,4,109.58257,18.28458,1815
271882,5310F66B3196EF90D8CF1E7831B3063C,38132,0,9,9,109.64632,18.23417,2057
271883,5310F66B3196EF90D8CF1E7831B3063C,31471,14,15,1,109.34583,18.29563,917
271884,5310F66B3196EF90D8CF1E7831B3063C,30771,18,19,1,109.49938,18.26042,1511
271905,117CDF2D41FFFF099F62724091D8605A,60631,0,1,1,109.57778,18.27583,1814
271906,117CDF2D41FFFF099F62724091D8605A,30854,5,9,4,109.56889,18.27076,1763
271909,9AA959ED87D1ECC3053DED17290EFCBD,31561,0,4,4,109.56792,18.28479,1765
271910,9AA959ED87D1ECC3053DED17290EFCBD,39183,7,8,1,109.55542,18.28208,1715
271911,9AA959ED87D1ECC3053DED17290EFCBD,31561,9,22,13,109.56792,18.28479,1765
271936,FA724E83D7D22E41E07D0D2550D22166,30854,0,5,5,109.56889,18.27076,1763
271937,FA724E83D7D22E41E07D0D2550D22166,31031,7,8,1,109.49979,18.25382,1510
271938,FA724E83D7D22E41E07D0D2550D22166,30854,12,21,9,109.56889,18.27076,1763
271939,9EBFE19AEC38C3A6F47AE2D903294BAE,30854,2,6,4,109.56889,18.27076,1763
271940,9EBFE19AEC38C3A6F47AE2D903294BAE,31164,10,14,4,109.69993,18.27215,2263
271941,7890099D98AA300C5BF12527E7372DB0,60631,0,7,7,109.57778,18.27583,1814
271942,7890099D98AA300C5BF12527E7372DB0,30854,9,10,1,109.56889,18.27076,1763
271943,7890099D98AA300C5BF12527E7372DB0,31071,12,13,1,109.58257,18.28458,1815
271944,7890099D98AA300C5BF12527E7372DB0,30854,15,17,2,109.56889,18.27076,1763
271945,7890099D98AA300C5BF12527E7372DB0,60631,21,23,2,109.57778,18.27583,1814
271962,D96E01B8E0F0DE9C160C9FEAFDCFDB6D,31071,0,7,7,109.58257,18.28458,1815
271963,D96E01B8E0F0DE9C160C9FEAFDCFDB6D,30854,11,13,2,109.56889,18.27076,1763
271986,9E45264EC835227EA5B2232A2B85D7B9,31521,14,16,2,109.51458,18.22542,1555
271987,9E45264EC835227EA5B2232A2B85D7B9,60381,18,19,1,109.5241,18.22458,1605
272005,2261FA59C58CA1DB4ED476451BEA0AD4,60361,19,20,1,109.51938,18.29681,1567
272006,2261FA59C58CA1DB4ED476451BEA0AD4,31021,21,22,1,109.49021,18.27,1463
272032,40285EE8CCE25C38988EC087545664EC,30854,10,12,2,109.56889,18.27076,1763
272033,40285EE8CCE25C38988EC087545664EC,31071,14,17,3,109.58257,18.28458,1815
272034,40285EE8CCE25C38988EC087545664EC,30854,21,23,2,109.56889,18.27076,1763
272095,C8922FAF66F21ECAECB6B717FCD5A53B,60614,0,2,2,109.48799,18.29521,1467
272096,C8922FAF66F21ECAECB6B717FCD5A53B,60504,2,6,4,109.47917,18.28903,1416
272097,C8922FAF66F21ECAECB6B717FCD5A53B,60614,6,15,9,109.48799,18.29521,1467
272098,C8922FAF66F21ECAECB6B717FCD5A53B,60504,17,18,1,109.47917,18.28903,1416
272099,C8922FAF66F21ECAECB6B717FCD5A53B,31031,20,21,1,109.49979,18.25382,1510
272119,9E8746086915F9D4A063A74CF0B5B7AB,31561,1,14,13,109.56792,18.28479,1765
272120,9E8746086915F9D4A063A74CF0B5B7AB,31931,14,15,1,109.54771,18.29403,1667
272121,9E8746086915F9D4A063A74CF0B5B7AB,30854,18,19,1,109.56889,18.27076,1763
272131,601485EE1975CD21F8AEB362220395E5,31231,17,18,1,109.42597,18.29292,1217
272132,601485EE1975CD21F8AEB362220395E5,30361,19,20,1,109.50347,18.24,1508
272139,20113F117BF3A764361CF4D37F432D52,48574,0,8,8,109.48931,18.28458,1465
272151,89E718E5F535407ABE60C96AFD69F690,30421,1,7,6,109.50021,18.25861,1511
272152,89E718E5F535407ABE60C96AFD69F690,30911,11,12,1,109.50493,18.26181,1511
272153,89E718E5F535407ABE60C96AFD69F690,30421,13,14,1,109.50021,18.25861,1511
272154,89E718E5F535407ABE60C96AFD69F690,30211,14,16,2,109.49882,18.23931,1508
272155,89E718E5F535407ABE60C96AFD69F690,30361,18,20,2,109.50347,18.24,1508
272173,8A19D38C67DEBBE2072401E23B2467C5,31161,0,4,4,109.70229,18.31361,2270
272174,8A19D38C67DEBBE2072401E23B2467C5,60211,6,8,2,109.63549,18.26049,2011
272176,8A19D38C67DEBBE2072401E23B2467C5,31161,14,23,9,109.70229,18.31361,2270
272181,FA867EC4A75F48065A30E6C5CB1A5293,30771,19,21,2,109.49938,18.26042,1511
272186,51DF765CB634D9549D20AD1F2C37BA18,30854,10,12,2,109.56889,18.27076,1763
272187,51DF765CB634D9549D20AD1F2C37BA18,31071,13,16,3,109.58257,18.28458,1815
272201,04ABA8BFD5D63DDF1B83BA0577C9019C,39371,1,8,7,109.56627,18.2646,1762
272202,04ABA8BFD5D63DDF1B83BA0577C9019C,31071,12,15,3,109.58257,18.28458,1815
272245,1419F2503130508E06D5FA0D4A5CF329,31261,0,1,1,109.51174,18.2466,1559
272246,1419F2503130508E06D5FA0D4A5CF329,31031,1,18,17,109.49979,18.25382,1510
272247,1419F2503130508E06D5FA0D4A5CF329,31461,18,20,2,109.5091,18.25389,1510
272248,1419F2503130508E06D5FA0D4A5CF329,31031,21,22,1,109.49979,18.25382,1510
272249,31C925B9876FE9FFC3F673B5040150FB,39111,0,4,4,109.5191,18.22597,1555
272250,31C925B9876FE9FFC3F673B5040150FB,31521,5,18,13,109.51458,18.22542,1555
272251,31C925B9876FE9FFC3F673B5040150FB,31521,20,21,1,109.51458,18.22542,1555
272252,31C925B9876FE9FFC3F673B5040150FB,31521,22,23,1,109.51458,18.22542,1555
272262,6FD88D74D66E8FAB66A93CB5D0609C41,30711,7,9,2,109.50271,18.25347,1510
272263,6FD88D74D66E8FAB66A93CB5D0609C41,30854,13,23,10,109.56889,18.27076,1763
272264,6D8E3C1E96FE4721446F9F86A4DCFD4B,30324,17,19,2,109.50326,18.29257,1517
272265,6D8E3C1E96FE4721446F9F86A4DCFD4B,30051,21,23,2,109.48917,18.21215,1453
272277,79FD298D94ED606250C160861575CD8F,31551,7,9,2,109.55868,18.24222,1708
272278,79FD298D94ED606250C160861575CD8F,31554,10,21,11,109.55521,18.2459,1709
272294,52D077B19C6C1BD347E6DC20309A3DC3,31071,0,14,14,109.58257,18.28458,1815
272295,52D077B19C6C1BD347E6DC20309A3DC3,31071,16,21,5,109.58257,18.28458,1815
272296,52D077B19C6C1BD347E6DC20309A3DC3,30854,21,23,2,109.56889,18.27076,1763
272306,E75CF54BA14775FEDD26504F9F6B7365,31945,0,6,6,109.58021,18.29403,1817
272307,E75CF54BA14775FEDD26504F9F6B7365,31561,6,16,10,109.56792,18.28479,1765
272308,E75CF54BA14775FEDD26504F9F6B7365,30854,17,18,1,109.56889,18.27076,1763
272316,96C474E5BFF92BC21432A4ADDD7A543D,30854,0,17,17,109.56889,18.27076,1763
272317,96C474E5BFF92BC21432A4ADDD7A543D,30861,18,19,1,109.52722,18.22743,1606
272348,D46DE9169E4BACF1D272EA5E0FDEF68F,30711,19,20,1,109.50271,18.25347,1510
272349,D46DE9169E4BACF1D272EA5E0FDEF68F,31561,20,23,3,109.56792,18.28479,1765
272374,2AE38FAF341950B0B91404FFCE5A0F3E,30921,7,16,9,109.53903,18.29451,1667
272375,2AE38FAF341950B0B91404FFCE5A0F3E,39183,19,21,2,109.55542,18.28208,1715
272388,39F25FE146A03325C93C111F2A943B6C,31945,0,17,17,109.58021,18.29403,1817
272389,39F25FE146A03325C93C111F2A943B6C,31071,19,20,1,109.58257,18.28458,1815
272390,39F25FE146A03325C93C111F2A943B6C,31945,21,22,1,109.58021,18.29403,1817
272393,F3ADE38A6219C04719D8BAB38E16EC80,31701,0,5,5,109.44132,18.28833,1266
272394,F3ADE38A6219C04719D8BAB38E16EC80,39043,5,8,3,109.40778,18.29049,1166
272409,D8917A2A43EA8070EEC2FA46A7C72FE1,30504,0,8,8,109.705,18.35368,2277
272410,D8917A2A43EA8070EEC2FA46A7C72FE1,30711,9,12,3,109.50271,18.25347,1510
272411,D8917A2A43EA8070EEC2FA46A7C72FE1,39091,15,23,8,109.50097,18.25222,1510
272444,ECD0945121CF92E8C5C4049D02E0987F,38871,0,6,6,109.44681,18.28625,1316
272445,ECD0945121CF92E8C5C4049D02E0987F,30661,8,9,1,109.37028,18.24361,1008
272446,ECD0945121CF92E8C5C4049D02E0987F,31471,10,13,3,109.34583,18.29563,917
272447,ECD0945121CF92E8C5C4049D02E0987F,60054,13,14,1,109.3016,18.31229,770
272448,DFFF17B7FE30E79B8AABBB5CE171272F,31561,2,9,7,109.56792,18.28479,1765
272449,DFFF17B7FE30E79B8AABBB5CE171272F,30854,12,14,2,109.56889,18.27076,1763
272450,DFFF17B7FE30E79B8AABBB5CE171272F,31561,15,16,1,109.56792,18.28479,1765
272451,DFFF17B7FE30E79B8AABBB5CE171272F,39183,17,19,2,109.55542,18.28208,1715
272452,DFFF17B7FE30E79B8AABBB5CE171272F,30854,20,21,1,109.56889,18.27076,1763
272453,0874ECC8591FCEC6749163A25CC3B800,39091,16,18,2,109.50097,18.25222,1510
272454,0874ECC8591FCEC6749163A25CC3B800,31471,22,23,1,109.34583,18.29563,917
272480,B34415F599F0ED7D1A073EE314A60B9B,31671,0,6,6,109.38965,18.29813,1068
272481,B34415F599F0ED7D1A073EE314A60B9B,60041,6,9,3,109.39889,18.31944,1121
272482,B34415F599F0ED7D1A073EE314A60B9B,31671,11,17,6,109.38965,18.29813,1068
272483,B34415F599F0ED7D1A073EE314A60B9B,60041,17,19,2,109.39889,18.31944,1121
272496,31B5749A66C854438247EB4202810257,31781,11,13,2,109.19847,18.2975,367
272497,31B5749A66C854438247EB4202810257,60054,15,16,1,109.3016,18.31229,770
272498,31B5749A66C854438247EB4202810257,30361,18,19,1,109.50347,18.24,1508
272526,70655AD92B06CDB42EC8BC912F906F64,39091,1,5,4,109.50097,18.25222,1510
272527,70655AD92B06CDB42EC8BC912F906F64,60131,8,9,1,109.49819,18.24778,1509
272528,70655AD92B06CDB42EC8BC912F906F64,60231,9,12,3,109.49903,18.21972,1504
272529,70655AD92B06CDB42EC8BC912F906F64,30051,13,18,5,109.48917,18.21215,1453
272533,EC4B90EDBF35256FDB4D4F8B87DB8A04,30854,0,6,6,109.56889,18.27076,1763
272534,EC4B90EDBF35256FDB4D4F8B87DB8A04,31071,9,13,4,109.58257,18.28458,1815
272590,0D69669D4DBC1CEB06269A084D86E853,60631,0,8,8,109.57778,18.27583,1814
272591,0D69669D4DBC1CEB06269A084D86E853,30854,8,9,1,109.56889,18.27076,1763
272592,0D69669D4DBC1CEB06269A084D86E853,31571,13,15,2,109.61563,18.23326,1957
272595,F41EE3B813183A9F30BD8332EE4C4650,60054,12,14,2,109.3016,18.31229,770
272596,F41EE3B813183A9F30BD8332EE4C4650,30181,18,20,2,109.51597,18.23313,1557
272597,F41EE3B813183A9F30BD8332EE4C4650,30191,21,23,2,109.50361,18.22701,1506
272602,F25C237DB3948CAE74585CD60FBB2501,39183,0,11,11,109.55542,18.28208,1715
272603,F25C237DB3948CAE74585CD60FBB2501,39181,13,15,2,109.55153,18.28035,1715
272604,F25C237DB3948CAE74585CD60FBB2501,31561,15,16,1,109.56792,18.28479,1765
272620,1D60D001EBDC67D77E1C6037DB507422,31561,0,7,7,109.56792,18.28479,1765
272621,1D60D001EBDC67D77E1C6037DB507422,30854,8,16,8,109.56889,18.27076,1763
272622,1D60D001EBDC67D77E1C6037DB507422,31561,21,23,2,109.56792,18.28479,1765
272649,67CDBD95CEB6CBFC8E0EE012353E074B,31071,14,15,1,109.58257,18.28458,1815
272650,67CDBD95CEB6CBFC8E0EE012353E074B,30854,18,20,2,109.56889,18.27076,1763
272652,C6579823835B85A254880E72927E82BB,33354,8,10,2,109.67465,18.44583,2192
272653,C6579823835B85A254880E72927E82BB,33051,12,14,2,109.6475,18.46618,2096
272654,C6579823835B85A254880E72927E82BB,30854,17,18,1,109.56889,18.27076,1763
272655,C6579823835B85A254880E72927E82BB,39321,19,21,2,109.529,18.2167,1604
272686,2C7DB696A14A5E061C2912E5376233C9,31945,14,16,2,109.58021,18.29403,1817
272687,2C7DB696A14A5E061C2912E5376233C9,31071,21,23,2,109.58257,18.28458,1815
272692,A5E7142EDB2C00D2F56F81D099876FCF,31951,11,14,3,109.52174,18.30299,1568
272736,03CEC0FDDD5484124514C6D24A63D4DD,31561,0,7,7,109.56792,18.28479,1765
272737,03CEC0FDDD5484124514C6D24A63D4DD,39183,9,11,2,109.55542,18.28208,1715
272738,03CEC0FDDD5484124514C6D24A63D4DD,31561,13,15,2,109.56792,18.28479,1765
272792,870387A96F6C285C25ED9B74BEB3EF82,38283,0,10,10,109.62229,18.22618,1956
272793,870387A96F6C285C25ED9B74BEB3EF82,30711,13,17,4,109.50271,18.25347,1510
272794,870387A96F6C285C25ED9B74BEB3EF82,38283,19,23,4,109.62229,18.22618,1956
272798,967E548F53382C36FB0D7FF12F6A99E7,31531,0,6,6,109.49583,18.25972,1461
272799,967E548F53382C36FB0D7FF12F6A99E7,60131,7,9,2,109.49819,18.24778,1509
272800,967E548F53382C36FB0D7FF12F6A99E7,31531,9,23,14,109.49583,18.25972,1461
272801,7F220C28A0C617E581A7723B6384F4CD,31471,17,19,2,109.34583,18.29563,917
272802,7F220C28A0C617E581A7723B6384F4CD,38094,21,23,2,109.45403,18.28778,1316
272808,AF125EFCC483E24833CBDDBC7248BDF1,30511,0,7,7,109.51069,18.24208,1558
272809,AF125EFCC483E24833CBDDBC7248BDF1,38973,8,9,1,109.51097,18.25389,1560
272810,AF125EFCC483E24833CBDDBC7248BDF1,31781,11,13,2,109.19847,18.2975,367
272811,AF125EFCC483E24833CBDDBC7248BDF1,60121,14,15,1,109.74507,18.37472,2430
272812,AF125EFCC483E24833CBDDBC7248BDF1,30271,16,23,7,109.49132,18.23153,1456
272852,3FB32E010B50E0771D17FFE0A2CC7BCE,30854,0,14,14,109.56889,18.27076,1763
272853,3FB32E010B50E0771D17FFE0A2CC7BCE,60221,15,18,3,109.52569,18.29188,1616
272854,3FB32E010B50E0771D17FFE0A2CC7BCE,31071,18,19,1,109.58257,18.28458,1815
272855,3FB32E010B50E0771D17FFE0A2CC7BCE,30854,20,21,1,109.56889,18.27076,1763
272856,C0C46420E86FE7104EAC83C027355F32,31071,14,16,2,109.58257,18.28458,1815
272857,C0C46420E86FE7104EAC83C027355F32,38336,20,23,3,109.61111,18.21806,1904
272876,269D3761ED337530C37A42787A175B92,31304,0,7,7,109.15903,18.32854,223
272877,269D3761ED337530C37A42787A175B92,31031,9,12,3,109.49979,18.25382,1510
272878,269D3761ED337530C37A42787A175B92,31031,14,16,2,109.49979,18.25382,1510
272879,269D3761ED337530C37A42787A175B92,31304,18,23,5,109.15903,18.32854,223
272902,1D8B814EC83D52D7C5F3FED99C129EE0,30854,3,8,5,109.56889,18.27076,1763
272903,1D8B814EC83D52D7C5F3FED99C129EE0,38271,11,17,6,109.62632,18.23049,1956
272904,1D8B814EC83D52D7C5F3FED99C129EE0,39151,19,21,2,109.49875,18.25097,1510
272909,0CBDBB0FD86E41225B8F6BD8B7F216EA,38541,0,9,9,109.73715,18.34875,2426
272910,0CBDBB0FD86E41225B8F6BD8B7F216EA,38315,11,14,3,109.48979,18.29764,1467
272977,80D5971B84EF3A2477C3F057B855AF63,31071,0,16,16,109.58257,18.28458,1815
272978,80D5971B84EF3A2477C3F057B855AF63,30854,21,22,1,109.56889,18.27076,1763
273005,D6AECE3F7AEF17FDDE30DB3B3A230B91,38315,12,13,1,109.48979,18.29764,1467
273030,FCA0E154B092D503D8EAECB44B44540F,31081,0,6,6,109.44639,18.30181,1318
273048,6BF671BC76B2463D72102139E4EB1018,31931,11,12,1,109.54771,18.29403,1667
273049,6BF671BC76B2463D72102139E4EB1018,38241,13,15,2,109.54111,18.30542,1669
273050,6BF671BC76B2463D72102139E4EB1018,60371,18,19,1,109.53063,18.30056,1618
273051,6BF671BC76B2463D72102139E4EB1018,30071,21,23,2,109.52819,18.30472,1619
273086,850F414E89CB3AC3E862CBFA17778006,30581,15,16,1,109.62257,18.24951,1959
273087,850F414E89CB3AC3E862CBFA17778006,30271,17,20,3,109.49132,18.23153,1456
273116,AB43182259122294244C13D6FC66D4A1,30851,19,21,2,109.5616,18.27396,1713
273117,AB43182259122294244C13D6FC66D4A1,60631,21,22,1,109.57778,18.27583,1814
273136,5BC86F424BAF4B877A98262DEDE87053,39154,14,15,1,109.50201,18.25681,1511
273137,5BC86F424BAF4B877A98262DEDE87053,38251,17,20,3,109.49618,18.25493,1510
273138,5BC86F424BAF4B877A98262DEDE87053,30421,21,22,1,109.50021,18.25861,1511
273160,DE91F768E6CCDB78867FF54F078574C9,31761,1,3,2,109.60521,18.27965,1914
273161,DE91F768E6CCDB78867FF54F078574C9,30854,4,18,14,109.56889,18.27076,1763
273162,DE91F768E6CCDB78867FF54F078574C9,60381,21,22,1,109.5241,18.22458,1605
273163,DE91F768E6CCDB78867FF54F078574C9,30854,22,23,1,109.56889,18.27076,1763
273165,5EE25A6E7DD554FFDA0C9C1A504114B7,30221,0,18,18,109.57833,18.20222,1802
273166,5EE25A6E7DD554FFDA0C9C1A504114B7,60291,21,23,2,109.50826,18.24639,1509
273172,676172DB52801CBBE1ACD798ACBB4F3C,60541,0,7,7,109.4084,18.29208,1167
273173,676172DB52801CBBE1ACD798ACBB4F3C,31301,10,13,3,109.14493,18.31222,170
273174,676172DB52801CBBE1ACD798ACBB4F3C,31471,14,16,2,109.34583,18.29563,917
273175,676172DB52801CBBE1ACD798ACBB4F3C,60541,19,20,1,109.4084,18.29208,1167
273202,81626C5D93A3C503283ABF8594E54615,31521,10,12,2,109.51458,18.22542,1555
273203,81626C5D93A3C503283ABF8594E54615,60381,13,14,1,109.5241,18.22458,1605
273204,81626C5D93A3C503283ABF8594E54615,39321,14,16,2,109.529,18.2167,1604
273205,81626C5D93A3C503283ABF8594E54615,31521,16,21,5,109.51458,18.22542,1555
273240,728159D623DE360E7CBC8AEEC345E2FF,60381,19,21,2,109.5241,18.22458,1605
273241,728159D623DE360E7CBC8AEEC345E2FF,60661,21,23,2,109.548,18.2377,1657
273252,217CC2642DC5F459F756E8E9CAA9A63A,31071,11,13,2,109.58257,18.28458,1815
273253,217CC2642DC5F459F756E8E9CAA9A63A,30854,18,19,1,109.56889,18.27076,1763
273254,217CC2642DC5F459F756E8E9CAA9A63A,60631,20,22,2,109.57778,18.27583,1814
273281,D313F95AC05082149211CB8CD175B418,31071,0,6,6,109.58257,18.28458,1815
273282,D313F95AC05082149211CB8CD175B418,30854,7,8,1,109.56889,18.27076,1763
273283,D313F95AC05082149211CB8CD175B418,31071,12,22,10,109.58257,18.28458,1815
273343,D17842D1E850E617B4B15889C460D1C5,30921,17,18,1,109.53903,18.29451,1667
273344,D17842D1E850E617B4B15889C460D1C5,31931,20,23,3,109.54771,18.29403,1667
273368,8153BB62691548A16A2644B188DEA105,31561,0,9,9,109.56792,18.28479,1765
273369,8153BB62691548A16A2644B188DEA105,31071,9,12,3,109.58257,18.28458,1815
273370,8153BB62691548A16A2644B188DEA105,30854,13,17,4,109.56889,18.27076,1763
273371,8153BB62691548A16A2644B188DEA105,31561,22,23,1,109.56792,18.28479,1765
273386,6C0260646767B781577B5B8CE2471E51,31521,15,16,1,109.51458,18.22542,1555
273387,6C0260646767B781577B5B8CE2471E51,30711,19,21,2,109.50271,18.25347,1510
273391,52626520133C58C019E9712FB19D3224,38171,0,8,8,109.50799,18.28139,1515
273392,52626520133C58C019E9712FB19D3224,38376,9,10,1,109.50924,18.24,1558
273393,52626520133C58C019E9712FB19D3224,30711,11,13,2,109.50271,18.25347,1510
273394,52626520133C58C019E9712FB19D3224,60201,15,17,2,109.5041,18.2509,1510
273395,52626520133C58C019E9712FB19D3224,30271,19,20,1,109.49132,18.23153,1456
273396,52626520133C58C019E9712FB19D3224,38171,21,22,1,109.50799,18.28139,1515
273402,8F6EA1C108FADA76A214A7ED71ECE3D1,30891,4,5,1,109.59431,18.28389,1865
273403,8F6EA1C108FADA76A214A7ED71ECE3D1,30851,6,7,1,109.5616,18.27396,1713
273404,8F6EA1C108FADA76A214A7ED71ECE3D1,30854,10,18,8,109.56889,18.27076,1763
273405,39D4F14340B4650E084697607335F122,30161,0,9,9,109.50042,18.24389,1508
273406,39D4F14340B4650E084697607335F122,30281,13,17,4,109.50597,18.27583,1514
273407,39D4F14340B4650E084697607335F122,30911,19,20,1,109.50493,18.26181,1511
273491,EF7DCA5602FCDF14AF156D676A8ED902,31561,0,13,13,109.56792,18.28479,1765
273492,EF7DCA5602FCDF14AF156D676A8ED902,31931,14,17,3,109.54771,18.29403,1667
273517,CFFDD1BF3134B9FDD71614F40E1DE0FD,31071,0,2,2,109.58257,18.28458,1815
273518,CFFDD1BF3134B9FDD71614F40E1DE0FD,31561,4,6,2,109.56792,18.28479,1765
273519,CFFDD1BF3134B9FDD71614F40E1DE0FD,31071,7,21,14,109.58257,18.28458,1815
273531,8AABF5FDF2B06EB445749240A3894969,31561,1,9,8,109.56792,18.28479,1765
273532,8AABF5FDF2B06EB445749240A3894969,30854,11,18,7,109.56889,18.27076,1763
273583,7B832C4EEA998F0828995CEC1FF24330,30854,0,9,9,109.56889,18.27076,1763
273584,7B832C4EEA998F0828995CEC1FF24330,31071,12,15,3,109.58257,18.28458,1815
273591,CC674AAAC7C027C8C72DEA73AA338EF1,38094,0,8,8,109.45403,18.28778,1316
273592,CC674AAAC7C027C8C72DEA73AA338EF1,30111,8,10,2,109.47583,18.30542,1419
273593,CC674AAAC7C027C8C72DEA73AA338EF1,30151,11,13,2,109.50986,18.25083,1560
273594,CC674AAAC7C027C8C72DEA73AA338EF1,30111,17,23,6,109.47583,18.30542,1419
273641,30CE72A519D49881F23B8123486E3A02,60411,0,7,7,109.32514,18.30854,869
273642,30CE72A519D49881F23B8123486E3A02,31471,8,19,11,109.34583,18.29563,917
273658,64FF3E93355E6DCA29977E04D316EABA,30151,0,2,2,109.50986,18.25083,1560
273659,64FF3E93355E6DCA29977E04D316EABA,38973,2,7,5,109.51097,18.25389,1560
273660,64FF3E93355E6DCA29977E04D316EABA,31781,8,10,2,109.19847,18.2975,367
273661,64FF3E93355E6DCA29977E04D316EABA,60551,12,13,1,109.42722,18.30111,1218
273662,64FF3E93355E6DCA29977E04D316EABA,31461,18,21,3,109.5091,18.25389,1510
273663,64FF3E93355E6DCA29977E04D316EABA,30771,21,23,2,109.49938,18.26042,1511
273690,F48ACD2CDFF9D1E4C0B8EBCB12428C64,30531,0,11,11,109.53271,18.21472,1604
273691,F48ACD2CDFF9D1E4C0B8EBCB12428C64,38283,15,23,8,109.62229,18.22618,1956
273709,798BF3B08F72A16A6DEAAA235F1899BB,61011,8,11,3,109.60653,18.19076,1900
273711,798BF3B08F72A16A6DEAAA235F1899BB,61011,18,23,5,109.60653,18.19076,1900
273735,43A422D32148E3FF9BC0EC7D857AA8BB,31521,3,13,10,109.51458,18.22542,1555
273736,43A422D32148E3FF9BC0EC7D857AA8BB,38071,14,15,1,109.40722,18.30938,1169
273806,E4C7AB656E412C7E33554D18277C9478,60201,13,14,1,109.5041,18.2509,1510
273807,E4C7AB656E412C7E33554D18277C9478,30151,14,15,1,109.50986,18.25083,1560
273808,E4C7AB656E412C7E33554D18277C9478,60201,19,20,1,109.5041,18.2509,1510
273824,2BE6133C5E44424C388243054653B4C5,60631,15,16,1,109.57778,18.27583,1814
273919,EC89B2FFE00F967E6D0A3B697A6D636D,31071,0,17,17,109.58257,18.28458,1815
273920,EC89B2FFE00F967E6D0A3B697A6D636D,39181,19,21,2,109.55153,18.28035,1715
273921,EC89B2FFE00F967E6D0A3B697A6D636D,60631,21,23,2,109.57778,18.27583,1814
273923,AA76F8E942B052AF1B0A5FE357B32C6F,30711,11,13,2,109.50271,18.25347,1510
273924,AA76F8E942B052AF1B0A5FE357B32C6F,31145,14,17,3,109.20431,18.30479,369
273939,3BB24F8BCA3E0C99C850EC3AEEBC46A9,38251,12,22,10,109.49618,18.25493,1510
273945,DC9885AE38AE7598214BC46FD2D819A5,30071,0,7,7,109.52819,18.30472,1619
273946,DC9885AE38AE7598214BC46FD2D819A5,30911,12,13,1,109.50493,18.26181,1511
273947,DC9885AE38AE7598214BC46FD2D819A5,60171,15,17,2,109.51292,18.30694,1569
273948,DC9885AE38AE7598214BC46FD2D819A5,60501,18,20,2,109.48701,18.29021,1466
273962,59F29435D748531F416A4F1636997ECF,60631,20,21,1,109.57778,18.27583,1814
273963,59F29435D748531F416A4F1636997ECF,30854,21,22,1,109.56889,18.27076,1763
273964,68DBE0B52FD0AB95F1DD47068FD7847F,38891,3,7,4,109.51486,18.24118,1558
273965,68DBE0B52FD0AB95F1DD47068FD7847F,30181,7,17,10,109.51597,18.23313,1557
274018,22CF7007721E0F1D863F25E4633BE1AD,38291,13,15,2,109.51618,18.24313,1558
274019,22CF7007721E0F1D863F25E4633BE1AD,30771,16,17,1,109.49938,18.26042,1511
274020,22CF7007721E0F1D863F25E4633BE1AD,60311,21,23,2,109.52097,18.24319,1558
274026,BCBE041A7FC025F9D2DFD86A6CB75E1D,60011,5,7,2,109.48965,18.30222,1468
274027,BCBE041A7FC025F9D2DFD86A6CB75E1D,30821,9,20,11,109.43681,18.33639,1274
274039,369C26B411BBFC36DC6FE3529EBBC042,30854,0,7,7,109.56889,18.27076,1763
274040,369C26B411BBFC36DC6FE3529EBBC042,39371,9,11,2,109.56627,18.2646,1762
274046,D26D846AA198D3C0B38C165F40258F61,30381,13,15,2,109.52521,18.24507,1609
274047,D26D846AA198D3C0B38C165F40258F61,30351,19,21,2,109.41701,18.29292,1217
274054,7F377D9BD4A6752A92F213BA9B3E59E5,30421,3,5,2,109.50021,18.25861,1511
274055,7F377D9BD4A6752A92F213BA9B3E59E5,30421,9,10,1,109.50021,18.25861,1511
274056,7F377D9BD4A6752A92F213BA9B3E59E5,30421,12,13,1,109.50021,18.25861,1511
274057,7F377D9BD4A6752A92F213BA9B3E59E5,31271,18,19,1,109.48958,18.26257,1462
274058,7F377D9BD4A6752A92F213BA9B3E59E5,30421,22,23,1,109.50021,18.25861,1511
274066,CCC8AB814E8164924F705C45AD546C57,31101,15,16,1,109.65389,18.23403,2057
274067,CCC8AB814E8164924F705C45AD546C57,60221,19,20,1,109.52569,18.29188,1616
274068,CCC8AB814E8164924F705C45AD546C57,60381,22,23,1,109.5241,18.22458,1605
274115,66928E2A4C22C07B7C91AA14FCE9B6E4,31071,0,8,8,109.58257,18.28458,1815
274116,66928E2A4C22C07B7C91AA14FCE9B6E4,30854,12,16,4,109.56889,18.27076,1763
274124,14BFE46EEAB2E234698393270A62605D,30661,14,16,2,109.37028,18.24361,1008
274125,14BFE46EEAB2E234698393270A62605D,60411,19,21,2,109.32514,18.30854,869
274145,2CF83F5125C6075E2ACA9C17C2979C64,31945,1,6,5,109.58021,18.29403,1817
274146,2CF83F5125C6075E2ACA9C17C2979C64,31071,8,10,2,109.58257,18.28458,1815
274147,2CF83F5125C6075E2ACA9C17C2979C64,30854,12,13,1,109.56889,18.27076,1763
274148,2CF83F5125C6075E2ACA9C17C2979C64,31071,13,14,1,109.58257,18.28458,1815
274149,2CF83F5125C6075E2ACA9C17C2979C64,31945,18,20,2,109.58021,18.29403,1817
274150,2CF83F5125C6075E2ACA9C17C2979C64,30854,21,23,2,109.56889,18.27076,1763
274171,222E0B6922623CE9FBB280F81068D40E,60381,15,17,2,109.5241,18.22458,1605
274172,222E0B6922623CE9FBB280F81068D40E,31521,20,21,1,109.51458,18.22542,1555
274173,EFEDECB139A304BF1949D208B2A10BCC,31521,1,9,8,109.51458,18.22542,1555
274174,EFEDECB139A304BF1949D208B2A10BCC,30731,14,16,2,109.50944,18.22306,1555
274175,EFEDECB139A304BF1949D208B2A10BCC,31521,18,19,1,109.51458,18.22542,1555
274176,EFEDECB139A304BF1949D208B2A10BCC,31031,20,21,1,109.49979,18.25382,1510
274177,EFEDECB139A304BF1949D208B2A10BCC,31521,21,22,1,109.51458,18.22542,1555
274198,656B9E927798C6351C23CE193C829143,30681,9,11,2,109.48493,18.26917,1463
274209,A795428793D2273B4ACFDADC5E61AEC2,60661,0,5,5,109.548,18.2377,1657
274210,A795428793D2273B4ACFDADC5E61AEC2,31421,6,8,2,109.55382,18.22347,1705
274211,A795428793D2273B4ACFDADC5E61AEC2,60641,12,13,1,109.53854,18.2359,1657
274212,A795428793D2273B4ACFDADC5E61AEC2,60381,16,17,1,109.5241,18.22458,1605
274213,DF0D684B9CE420DB70643C05E5C6EDD7,38141,0,2,2,109.39479,18.2916,1116
274214,DF0D684B9CE420DB70643C05E5C6EDD7,31671,3,5,2,109.38965,18.29813,1068
274215,DF0D684B9CE420DB70643C05E5C6EDD7,38141,6,8,2,109.39479,18.2916,1116
274216,DF0D684B9CE420DB70643C05E5C6EDD7,30661,11,13,2,109.37028,18.24361,1008
274217,DF0D684B9CE420DB70643C05E5C6EDD7,31471,14,16,2,109.34583,18.29563,917
274218,DF0D684B9CE420DB70643C05E5C6EDD7,38141,19,23,4,109.39479,18.2916,1116
274238,EA4EEEA6F324C3F08DBAE63BA2B33BB6,30084,0,7,7,109.50118,18.26972,1513
274239,EA4EEEA6F324C3F08DBAE63BA2B33BB6,31391,8,9,1,109.50382,18.24285,1508
274240,EA4EEEA6F324C3F08DBAE63BA2B33BB6,30084,10,17,7,109.50118,18.26972,1513
274241,EA4EEEA6F324C3F08DBAE63BA2B33BB6,60291,20,22,2,109.50826,18.24639,1509
274244,B19D039FEBAFACB75FE183A18A8FD559,60631,2,7,5,109.57778,18.27583,1814
274246,B19D039FEBAFACB75FE183A18A8FD559,38071,15,17,2,109.40722,18.30938,1169
274247,14DD9E5DCCEFE8BE7425556E4E04FC9A,31071,0,4,4,109.58257,18.28458,1815
274248,14DD9E5DCCEFE8BE7425556E4E04FC9A,30681,8,9,1,109.48493,18.26917,1463
274249,14DD9E5DCCEFE8BE7425556E4E04FC9A,31071,11,12,1,109.58257,18.28458,1815
274305,7171A8398911756415ECFCDCF96F249B,30121,0,6,6,109.52861,18.27222,1613
274306,7171A8398911756415ECFCDCF96F249B,39371,8,23,15,109.56627,18.2646,1762
274315,7F6E66BC10419161F6457A6D79258EDB,31361,6,8,2,109.47417,18.28292,1415
274316,7F6E66BC10419161F6457A6D79258EDB,60401,8,9,1,109.47444,18.27583,1414
274317,7F6E66BC10419161F6457A6D79258EDB,30341,14,16,2,109.3625,18.29167,966
274318,7F6E66BC10419161F6457A6D79258EDB,60621,19,23,4,109.48354,18.27451,1464
274325,30CCDA3A282DA68630C9C45738B256B1,60631,1,2,1,109.57778,18.27583,1814
274326,30CCDA3A282DA68630C9C45738B256B1,39371,2,3,1,109.56627,18.2646,1762
274327,30CCDA3A282DA68630C9C45738B256B1,60631,4,5,1,109.57778,18.27583,1814
274345,ADF0A7CED2B8DFD757D8FCA8B507C37E,38283,10,12,2,109.62229,18.22618,1956
274346,ADF0A7CED2B8DFD757D8FCA8B507C37E,38283,17,18,1,109.62229,18.22618,1956
274355,372A5433078073EAD18922D679CE0A73,30661,0,1,1,109.37028,18.24361,1008
274356,372A5433078073EAD18922D679CE0A73,60054,2,11,9,109.3016,18.31229,770
274357,372A5433078073EAD18922D679CE0A73,30661,11,13,2,109.37028,18.24361,1008
274358,372A5433078073EAD18922D679CE0A73,60411,16,17,1,109.32514,18.30854,869
274378,54A73DB0CD99440F50C2E61FD5693272,30671,0,16,16,109.43611,18.30139,1268
274379,54A73DB0CD99440F50C2E61FD5693272,31251,20,22,2,109.18528,18.2975,317
274435,F568EAB7DFDD5D41E19A6F375B979656,38185,0,2,2,109.51333,18.27347,1563
274436,F568EAB7DFDD5D41E19A6F375B979656,60361,2,23,21,109.51938,18.29681,1567
274451,65AD296DD65C9EEA3C22EA02904A768E,30854,10,17,7,109.56889,18.27076,1763
274452,65AD296DD65C9EEA3C22EA02904A768E,30851,18,19,1,109.5616,18.27396,1713
274529,D4EE8E1A4C04A1FF0596E4221D0B8B42,31071,0,7,7,109.58257,18.28458,1815
274530,D4EE8E1A4C04A1FF0596E4221D0B8B42,30854,11,13,2,109.56889,18.27076,1763
274547,434E56E5CA4457C35C4648BD6B964CEF,30671,14,15,1,109.43611,18.30139,1268
274548,434E56E5CA4457C35C4648BD6B964CEF,39101,18,20,2,109.50132,18.24931,1509
274549,434E56E5CA4457C35C4648BD6B964CEF,30671,22,23,1,109.43611,18.30139,1268
274610,A06676889CF0381DA44072B2A711F6A7,60274,0,1,1,109.514,18.2933,1567
274611,A06676889CF0381DA44072B2A711F6A7,31561,2,23,21,109.56792,18.28479,1765
274651,D2D609608AA1D4DD8E18DD3745793D0D,31071,0,10,10,109.58257,18.28458,1815
274652,D2D609608AA1D4DD8E18DD3745793D0D,30854,11,12,1,109.56889,18.27076,1763
274653,D2D609608AA1D4DD8E18DD3745793D0D,31071,17,21,4,109.58257,18.28458,1815
274665,1DA88ED70B6ADE8EAE3D8F549B029C10,30511,0,6,6,109.51069,18.24208,1558
274666,1DA88ED70B6ADE8EAE3D8F549B029C10,31781,9,13,4,109.19847,18.2975,367
274667,1DA88ED70B6ADE8EAE3D8F549B029C10,30511,15,17,2,109.51069,18.24208,1558
274668,1DA88ED70B6ADE8EAE3D8F549B029C10,60381,17,20,3,109.5241,18.22458,1605
274690,81BB8442D113627FA1326BEB8BF192ED,31071,2,4,2,109.58257,18.28458,1815
274691,81BB8442D113627FA1326BEB8BF192ED,60631,5,6,1,109.57778,18.27583,1814
274692,81BB8442D113627FA1326BEB8BF192ED,60354,7,8,1,109.58701,18.28521,1815
274693,9B389AE8E9B004176803CCEAFF69104A,39371,5,6,1,109.56627,18.2646,1762
274694,9B389AE8E9B004176803CCEAFF69104A,60631,6,17,11,109.57778,18.27583,1814
274733,196A4F506A1293E0132E9D4959EE8DDA,30821,12,15,3,109.43681,18.33639,1274
274734,196A4F506A1293E0132E9D4959EE8DDA,30671,19,23,4,109.43611,18.30139,1268
274753,C17F2EF1DEA79C8C951E3013EE071B2C,31071,0,17,17,109.58257,18.28458,1815
274754,C17F2EF1DEA79C8C951E3013EE071B2C,39371,20,22,2,109.56627,18.2646,1762
274790,1319E1E416A553CAED80375F3946B3EF,60381,0,6,6,109.5241,18.22458,1605
274791,1319E1E416A553CAED80375F3946B3EF,31521,7,8,1,109.51458,18.22542,1555
274792,1319E1E416A553CAED80375F3946B3EF,31471,10,11,1,109.34583,18.29563,917
274793,1319E1E416A553CAED80375F3946B3EF,31521,13,16,3,109.51458,18.22542,1555
274794,1319E1E416A553CAED80375F3946B3EF,30361,18,19,1,109.50347,18.24,1508
274795,1319E1E416A553CAED80375F3946B3EF,31521,20,22,2,109.51458,18.22542,1555
274842,7112BF910BB8852FB892FD72D6683B89,31091,20,22,2,109.41201,18.31222,1170
274923,A7003B7BCC0077E98CD8FD4D16862BCA,30201,0,9,9,109.4909,18.26465,1462
274924,A7003B7BCC0077E98CD8FD4D16862BCA,31071,10,15,5,109.58257,18.28458,1815
274925,A7003B7BCC0077E98CD8FD4D16862BCA,30201,18,23,5,109.4909,18.26465,1462
274970,3E0CC1F431A959DE24ABB41EC7702F6D,31471,14,15,1,109.34583,18.29563,917
274971,3E0CC1F431A959DE24ABB41EC7702F6D,31521,18,20,2,109.51458,18.22542,1555
275002,5664C5FF6B352F96C7620F94430DAC4F,31391,11,13,2,109.50382,18.24285,1508
275003,5664C5FF6B352F96C7620F94430DAC4F,31521,15,19,4,109.51458,18.22542,1555
275004,5664C5FF6B352F96C7620F94430DAC4F,31521,20,22,2,109.51458,18.22542,1555
275060,B25DCC57060B670315CBEB42D31F75A6,30101,0,1,1,109.57299,18.33333,1773
275061,B25DCC57060B670315CBEB42D31F75A6,30941,2,6,4,109.5559,18.33938,1724
275062,B25DCC57060B670315CBEB42D31F75A6,30851,8,13,5,109.5616,18.27396,1713
275063,B25DCC57060B670315CBEB42D31F75A6,31561,13,14,1,109.56792,18.28479,1765
275115,D91408AC1D7CF3270D9A315854454897,30171,0,8,8,109.48458,18.27139,1463
275116,D91408AC1D7CF3270D9A315854454897,60621,12,14,2,109.48354,18.27451,1464
275117,D91408AC1D7CF3270D9A315854454897,38754,14,16,2,109.74667,18.37382,2430
275118,D91408AC1D7CF3270D9A315854454897,30171,18,23,5,109.48458,18.27139,1463
275128,EB316856896788EC8FD871E122E95728,31811,0,6,6,109.54201,18.31806,1671
275129,EB316856896788EC8FD871E122E95728,30701,9,10,1,109.59313,18.32007,1871
275130,EB316856896788EC8FD871E122E95728,30931,11,12,1,109.55653,18.32722,1722
275131,EB316856896788EC8FD871E122E95728,30701,12,14,2,109.59313,18.32007,1871
275154,4E8A1FFC680701A862F9A60D8BF0780C,38162,0,9,9,109.43944,18.28889,1266
275155,4E8A1FFC680701A862F9A60D8BF0780C,38162,10,13,3,109.43944,18.28889,1266
275156,4E8A1FFC680701A862F9A60D8BF0780C,30661,13,15,2,109.37028,18.24361,1008
275157,4E8A1FFC680701A862F9A60D8BF0780C,31701,15,17,2,109.44132,18.28833,1266
275158,4E8A1FFC680701A862F9A60D8BF0780C,31701,19,21,2,109.44132,18.28833,1266
275162,878FC5EBB1B28FAABA6E6BFD01664318,30251,0,7,7,109.50611,18.26653,1512
275163,878FC5EBB1B28FAABA6E6BFD01664318,30161,10,12,2,109.50042,18.24389,1508
275164,878FC5EBB1B28FAABA6E6BFD01664318,30251,16,23,7,109.50611,18.26653,1512
275177,108C7DFE87D071FCC11145A73F0120F3,30771,19,20,1,109.49938,18.26042,1511
275186,CD3BCBAB8571FB81953C842A434E5DB8,31071,6,18,12,109.58257,18.28458,1815
275187,CD3BCBAB8571FB81953C842A434E5DB8,30854,18,19,1,109.56889,18.27076,1763
275212,BAAEF1F815128F9C42A2F609EF6E43D2,60121,17,18,1,109.74507,18.37472,2430
275213,BAAEF1F815128F9C42A2F609EF6E43D2,30351,20,21,1,109.41701,18.29292,1217
275214,BAAEF1F815128F9C42A2F609EF6E43D2,31231,21,22,1,109.42597,18.29292,1217
275237,58DE8A719D3ADBEDAE163213845B460A,31071,1,9,8,109.58257,18.28458,1815
275238,58DE8A719D3ADBEDAE163213845B460A,30854,10,12,2,109.56889,18.27076,1763
275239,58DE8A719D3ADBEDAE163213845B460A,31071,12,21,9,109.58257,18.28458,1815
275242,9DE8C13901CC7D63E2F1A6CC92603604,30854,0,16,16,109.56889,18.27076,1763
275243,9DE8C13901CC7D63E2F1A6CC92603604,31561,19,21,2,109.56792,18.28479,1765
275244,9DE8C13901CC7D63E2F1A6CC92603604,30854,21,22,1,109.56889,18.27076,1763
275263,DE758B2869DD8ACD01DE8EB0E9588F18,30181,18,19,1,109.51597,18.23313,1557
275264,DE758B2869DD8ACD01DE8EB0E9588F18,38951,20,21,1,109.48097,18.28868,1416
275298,74A8DA1A239BA74C3424A36505B6E3A6,31561,13,15,2,109.56792,18.28479,1765
275299,74A8DA1A239BA74C3424A36505B6E3A6,31071,16,19,3,109.58257,18.28458,1815
275305,A4DA5512552D5BFC3EBB019661465C3B,31145,11,13,2,109.20431,18.30479,369
275306,A4DA5512552D5BFC3EBB019661465C3B,30354,18,19,1,109.42813,18.29076,1216
275364,AE6DC7ACB81DB5F351E45AC25E5F5A3B,60234,0,1,1,109.49577,18.2096,1453
275365,AE6DC7ACB81DB5F351E45AC25E5F5A3B,38297,3,13,10,109.52576,18.24965,1609
275366,AE6DC7ACB81DB5F351E45AC25E5F5A3B,31031,13,15,2,109.49979,18.25382,1510
275384,2F440A235E684ECEDD042B3100A4AE95,31071,0,7,7,109.58257,18.28458,1815
275385,2F440A235E684ECEDD042B3100A4AE95,30854,9,11,2,109.56889,18.27076,1763
275386,2F440A235E684ECEDD042B3100A4AE95,31561,11,13,2,109.56792,18.28479,1765
275387,2F440A235E684ECEDD042B3100A4AE95,30854,16,18,2,109.56889,18.27076,1763
275388,0402BD114B7D5E20705E302B756CD062,30854,13,14,1,109.56889,18.27076,1763
275389,0402BD114B7D5E20705E302B756CD062,31071,15,17,2,109.58257,18.28458,1815
275390,0402BD114B7D5E20705E302B756CD062,30854,17,21,4,109.56889,18.27076,1763
275391,6ACF4B90082C2CC5A9221AB0B898A561,60594,0,1,1,109.62694,18.22799,1956
275392,6ACF4B90082C2CC5A9221AB0B898A561,38205,1,6,5,109.62743,18.23139,1956
275393,6ACF4B90082C2CC5A9221AB0B898A561,38331,6,11,5,109.62465,18.22736,1956
275394,6ACF4B90082C2CC5A9221AB0B898A561,60594,14,16,2,109.62694,18.22799,1956
275395,6ACF4B90082C2CC5A9221AB0B898A561,38052,18,21,3,109.62618,18.23042,1956
275400,ACDEAAF45B65DE48CF80A48DBD3C775E,31071,3,7,4,109.58257,18.28458,1815
275401,ACDEAAF45B65DE48CF80A48DBD3C775E,30854,9,23,14,109.56889,18.27076,1763
275417,5EBEA276FCB4A19AC5C987F5C7CC8908,60621,0,6,6,109.48354,18.27451,1464
275418,5EBEA276FCB4A19AC5C987F5C7CC8908,60401,7,9,2,109.47444,18.27583,1414
275419,5EBEA276FCB4A19AC5C987F5C7CC8908,31091,11,12,1,109.41201,18.31222,1170
275420,5EBEA276FCB4A19AC5C987F5C7CC8908,60621,13,14,1,109.48354,18.27451,1464
275421,5EBEA276FCB4A19AC5C987F5C7CC8908,60552,16,19,3,109.41729,18.30014,1218
275422,5EBEA276FCB4A19AC5C987F5C7CC8908,60621,21,23,2,109.48354,18.27451,1464
275426,3B6FF1F8D896A0A62DC7E65967011999,39183,1,7,6,109.55542,18.28208,1715
275427,3B6FF1F8D896A0A62DC7E65967011999,31561,8,9,1,109.56792,18.28479,1765
275428,3B6FF1F8D896A0A62DC7E65967011999,39183,10,22,12,109.55542,18.28208,1715
275441,6B6A1D2EB88367239FCB3C8A121F0BB1,38185,11,17,6,109.51333,18.27347,1563
275448,B032E534C72FB8134F1588648D944A44,30854,6,8,2,109.56889,18.27076,1763
275449,B032E534C72FB8134F1588648D944A44,31321,9,15,6,109.63799,18.23201,2007
275450,B032E534C72FB8134F1588648D944A44,30854,17,23,6,109.56889,18.27076,1763
275451,DB4DF566D4757FF3BB488F82DE126248,30851,17,18,1,109.5616,18.27396,1713
275452,DB4DF566D4757FF3BB488F82DE126248,31561,19,21,2,109.56792,18.28479,1765
275471,16E640D9FA5593E85AD54BDFBAF952D8,60354,1,4,3,109.58701,18.28521,1815
275472,16E640D9FA5593E85AD54BDFBAF952D8,31071,8,18,10,109.58257,18.28458,1815
275473,8F7FB30507503E99C612B652ADC863DC,60381,0,17,17,109.5241,18.22458,1605
275474,8F7FB30507503E99C612B652ADC863DC,60381,19,23,4,109.5241,18.22458,1605
275485,8BA35998A9CE7C24B2B6807A6971F954,31071,0,6,6,109.58257,18.28458,1815
275486,8BA35998A9CE7C24B2B6807A6971F954,30854,8,13,5,109.56889,18.27076,1763
275487,8BA35998A9CE7C24B2B6807A6971F954,31071,18,19,1,109.58257,18.28458,1815
275544,5CC1762A5E087A77C8027D2CC6A16A88,30071,0,7,7,109.52819,18.30472,1619
275545,5CC1762A5E087A77C8027D2CC6A16A88,30741,11,14,3,109.49833,18.28681,1516
275546,5CC1762A5E087A77C8027D2CC6A16A88,30071,15,16,1,109.52819,18.30472,1619
275569,179FD4660C817BD29234A518F00339D3,60231,0,10,10,109.49903,18.21972,1504
275570,179FD4660C817BD29234A518F00339D3,60161,12,18,6,109.49174,18.26181,1461
275571,179FD4660C817BD29234A518F00339D3,60231,21,23,2,109.49903,18.21972,1504
275572,78DAB4F1681085A74E87373143D04310,60491,0,8,8,109.43354,18.30847,1269
275574,78DAB4F1681085A74E87373143D04310,31351,17,23,6,109.4959,18.28417,1465
275587,B8B750E35107FC4FAA74320964E3617F,38105,12,23,11,109.40299,18.29229,1117
275629,82D48250E89BCA3C721CD59BD44DB6FA,60524,5,7,2,109.42951,18.28993,1216
275669,8265A029C672FE0377EF574CC3ADF2A8,30851,2,4,2,109.5616,18.27396,1713
275670,8265A029C672FE0377EF574CC3ADF2A8,31561,4,6,2,109.56792,18.28479,1765
275671,8265A029C672FE0377EF574CC3ADF2A8,30854,8,10,2,109.56889,18.27076,1763
275672,8265A029C672FE0377EF574CC3ADF2A8,39183,12,15,3,109.55542,18.28208,1715
275684,96CDECCC89D571C0B9B785DBB89FDE47,60631,17,18,1,109.57778,18.27583,1814
275685,96CDECCC89D571C0B9B785DBB89FDE47,31071,19,20,1,109.58257,18.28458,1815
275686,96CDECCC89D571C0B9B785DBB89FDE47,30854,20,22,2,109.56889,18.27076,1763
275690,0C8D15C0488D521680F0DE3A28CFE111,30701,8,9,1,109.59313,18.32007,1871
275691,0C8D15C0488D521680F0DE3A28CFE111,31811,9,14,5,109.54201,18.31806,1671
275692,0C8D15C0488D521680F0DE3A28CFE111,30701,14,15,1,109.59313,18.32007,1871
275693,0C8D15C0488D521680F0DE3A28CFE111,31811,19,21,2,109.54201,18.31806,1671
275694,0C8D15C0488D521680F0DE3A28CFE111,30701,21,23,2,109.59313,18.32007,1871
275700,0F98E37DE1961685D13076F13D009CFF,31231,0,8,8,109.42597,18.29292,1217
275701,0F98E37DE1961685D13076F13D009CFF,31471,9,12,3,109.34583,18.29563,917
275702,0F98E37DE1961685D13076F13D009CFF,30354,16,23,7,109.42813,18.29076,1216
275707,F40D9EDCF61ACD3AD16762F84000E564,30171,0,4,4,109.48458,18.27139,1463
275708,F40D9EDCF61ACD3AD16762F84000E564,30171,4,7,3,109.48458,18.27139,1463
275711,F40D9EDCF61ACD3AD16762F84000E564,31031,18,21,3,109.49979,18.25382,1510
275743,F621296F333E8058687ACD884B135C6E,30504,11,17,6,109.705,18.35368,2277
275744,F621296F333E8058687ACD884B135C6E,31161,18,20,2,109.70229,18.31361,2270
275745,F621296F333E8058687ACD884B135C6E,30504,21,22,1,109.705,18.35368,2277
275773,5A7A3D5F722F0EB2695C45BF16BBC483,38157,19,21,2,109.51483,18.26958,1563
275774,5A7A3D5F722F0EB2695C45BF16BBC483,30181,21,23,2,109.51597,18.23313,1557
275794,895CD60412795FD53135C10CDBA0A9C7,38154,16,23,7,109.5266,18.28278,1615
275824,E292D83051830D054E89D209EEABA4B9,31071,0,11,11,109.58257,18.28458,1815
275825,E292D83051830D054E89D209EEABA4B9,31561,12,20,8,109.56792,18.28479,1765
275826,E292D83051830D054E89D209EEABA4B9,39091,22,23,1,109.50097,18.25222,1510
275830,011859AA130B61CD7FFEFC39AEF2B9BF,31421,0,5,5,109.55382,18.22347,1705
275831,011859AA130B61CD7FFEFC39AEF2B9BF,30821,10,17,7,109.43681,18.33639,1274
275832,011859AA130B61CD7FFEFC39AEF2B9BF,31061,19,22,3,109.53333,18.23257,1607
275844,B4188FCF77E77B10794A61864ECCAF69,60054,13,15,2,109.3016,18.31229,770
275845,B4188FCF77E77B10794A61864ECCAF69,31521,17,20,3,109.51458,18.22542,1555
275850,ABA7F4B04F636C640FBA0888724FEB64,30821,19,20,1,109.43681,18.33639,1274
275851,ABA7F4B04F636C640FBA0888724FEB64,38951,21,23,2,109.48097,18.28868,1416
275852,BD36B617B5735ECF01B192DD8C734880,60661,0,6,6,109.548,18.2377,1657
275853,BD36B617B5735ECF01B192DD8C734880,60381,11,13,2,109.5241,18.22458,1605
275854,BD36B617B5735ECF01B192DD8C734880,31061,13,15,2,109.53333,18.23257,1607
275855,BD36B617B5735ECF01B192DD8C734880,31421,19,22,3,109.55382,18.22347,1705
275867,2627BF82AC8AFCB4B1C5F45FC89B9CF3,39321,0,8,8,109.529,18.2167,1604
275868,2627BF82AC8AFCB4B1C5F45FC89B9CF3,31521,11,12,1,109.51458,18.22542,1555
275869,2627BF82AC8AFCB4B1C5F45FC89B9CF3,39321,12,16,4,109.529,18.2167,1604
275870,2627BF82AC8AFCB4B1C5F45FC89B9CF3,31521,17,19,2,109.51458,18.22542,1555
275871,2627BF82AC8AFCB4B1C5F45FC89B9CF3,60281,20,21,1,109.51743,18.25924,1561
275887,C93386A9D86FE22A1FD4E5116045DD8D,31561,0,12,12,109.56792,18.28479,1765
275888,C93386A9D86FE22A1FD4E5116045DD8D,39183,14,16,2,109.55542,18.28208,1715
275889,C93386A9D86FE22A1FD4E5116045DD8D,31561,17,19,2,109.56792,18.28479,1765
275890,C93386A9D86FE22A1FD4E5116045DD8D,30854,19,20,1,109.56889,18.27076,1763
275911,2B8C748A18FA7D08D4335AD7C9DEF01B,31761,0,6,6,109.60521,18.27965,1914
275912,2B8C748A18FA7D08D4335AD7C9DEF01B,30851,8,10,2,109.5616,18.27396,1713
275913,2B8C748A18FA7D08D4335AD7C9DEF01B,30951,12,13,1,109.56208,18.25667,1761
275920,48EC852B1939DE9DE8D67EA49BF6D736,30201,0,8,8,109.4909,18.26465,1462
275921,48EC852B1939DE9DE8D67EA49BF6D736,30251,12,13,1,109.50611,18.26653,1512
275922,48EC852B1939DE9DE8D67EA49BF6D736,30201,16,17,1,109.4909,18.26465,1462
275923,48EC852B1939DE9DE8D67EA49BF6D736,60401,21,22,1,109.47444,18.27583,1414
275928,DED64374A4602648AE7C998119F6E01F,60661,0,7,7,109.548,18.2377,1657
275929,DED64374A4602648AE7C998119F6E01F,31421,9,10,1,109.55382,18.22347,1705
275930,DED64374A4602648AE7C998119F6E01F,30921,13,15,2,109.53903,18.29451,1667
275931,DED64374A4602648AE7C998119F6E01F,38261,15,18,3,109.50361,18.28153,1515
275932,DED64374A4602648AE7C998119F6E01F,30771,19,21,2,109.49938,18.26042,1511
275933,DED64374A4602648AE7C998119F6E01F,60661,22,23,1,109.548,18.2377,1657
275968,EFDE35289FEC1E13D6F34EFEE66A8AD2,60631,0,7,7,109.57778,18.27583,1814
275969,EFDE35289FEC1E13D6F34EFEE66A8AD2,31071,11,13,2,109.58257,18.28458,1815
275970,EFDE35289FEC1E13D6F34EFEE66A8AD2,60631,18,23,5,109.57778,18.27583,1814
275989,BE74D5A2C373F8231889AF03B59762B2,30854,0,5,5,109.56889,18.27076,1763
275990,BE74D5A2C373F8231889AF03B59762B2,60631,7,8,1,109.57778,18.27583,1814
275991,BE74D5A2C373F8231889AF03B59762B2,30854,10,11,1,109.56889,18.27076,1763
276008,3977578BE56276DA0700B04B81DC1356,30851,0,1,1,109.5616,18.27396,1713
276009,3977578BE56276DA0700B04B81DC1356,31561,2,3,1,109.56792,18.28479,1765
276010,3977578BE56276DA0700B04B81DC1356,30851,3,20,17,109.5616,18.27396,1713
276011,3977578BE56276DA0700B04B81DC1356,31561,21,23,2,109.56792,18.28479,1765
276031,57CE263B40E830BB46C9423096076F75,30921,0,6,6,109.53903,18.29451,1667
276032,57CE263B40E830BB46C9423096076F75,31931,8,18,10,109.54771,18.29403,1667
276078,070A398F07C013242CC3447B66DFACBF,39183,0,7,7,109.55542,18.28208,1715
276079,070A398F07C013242CC3447B66DFACBF,31931,11,12,1,109.54771,18.29403,1667
276080,070A398F07C013242CC3447B66DFACBF,39183,12,14,2,109.55542,18.28208,1715
276081,070A398F07C013242CC3447B66DFACBF,31931,14,16,2,109.54771,18.29403,1667
276082,070A398F07C013242CC3447B66DFACBF,39183,16,22,6,109.55542,18.28208,1715
276095,24892DF473AC6ED4692FBD552CF21D37,60381,1,10,9,109.5241,18.22458,1605
276096,24892DF473AC6ED4692FBD552CF21D37,30711,14,16,2,109.50271,18.25347,1510
276097,24892DF473AC6ED4692FBD552CF21D37,60381,16,23,7,109.5241,18.22458,1605
276129,C61008F347B09908A052E575D01A92B1,31021,0,7,7,109.49021,18.27,1463
276130,C61008F347B09908A052E575D01A92B1,31471,9,18,9,109.34583,18.29563,917
276131,C61008F347B09908A052E575D01A92B1,31021,20,22,2,109.49021,18.27,1463
276162,56C8C781972E8BFAF8A768A19AD7F590,31861,0,1,1,109.49042,18.27549,1464
276163,56C8C781972E8BFAF8A768A19AD7F590,30281,2,7,5,109.50597,18.27583,1514
276165,56C8C781972E8BFAF8A768A19AD7F590,30281,19,23,4,109.50597,18.27583,1514
276185,C709D01469E0800AF998DFAF42105CDC,60631,0,5,5,109.57778,18.27583,1814
276186,C709D01469E0800AF998DFAF42105CDC,31561,5,16,11,109.56792,18.28479,1765
276187,C709D01469E0800AF998DFAF42105CDC,30854,18,20,2,109.56889,18.27076,1763
276188,C709D01469E0800AF998DFAF42105CDC,60631,21,23,2,109.57778,18.27583,1814
276192,451E2BF48CD7B253EB0892324E679BCC,38891,1,2,1,109.51486,18.24118,1558
276193,451E2BF48CD7B253EB0892324E679BCC,38297,3,5,2,109.52576,18.24965,1609
276194,451E2BF48CD7B253EB0892324E679BCC,38291,5,7,2,109.51618,18.24313,1558
276195,451E2BF48CD7B253EB0892324E679BCC,60281,7,12,5,109.51743,18.25924,1561
276196,451E2BF48CD7B253EB0892324E679BCC,38291,13,18,5,109.51618,18.24313,1558
276197,451E2BF48CD7B253EB0892324E679BCC,38297,19,21,2,109.52576,18.24965,1609
276206,8A0382A2385C362EFE2664E8795F133E,31561,0,3,3,109.56792,18.28479,1765
276207,8A0382A2385C362EFE2664E8795F133E,39183,4,5,1,109.55542,18.28208,1715
276208,8A0382A2385C362EFE2664E8795F133E,31561,7,23,16,109.56792,18.28479,1765
276209,3160CBE2F0CDCB610575CDC881D9968C,38297,0,8,8,109.52576,18.24965,1609
276210,3160CBE2F0CDCB610575CDC881D9968C,39154,10,11,1,109.50201,18.25681,1511
276211,3160CBE2F0CDCB610575CDC881D9968C,30421,12,16,4,109.50021,18.25861,1511
276293,89DAB7335E14B8123BE562C22277A7ED,38105,18,20,2,109.40299,18.29229,1117
276294,89DAB7335E14B8123BE562C22277A7ED,60541,21,23,2,109.4084,18.29208,1167
276301,EB86D6046E376669621AB1CCFD0E07BA,31231,0,7,7,109.42597,18.29292,1217
276302,EB86D6046E376669621AB1CCFD0E07BA,60551,9,12,3,109.42722,18.30111,1218
276305,529A14F498129B0238F7B12A9FC7F6F7,31671,0,13,13,109.38965,18.29813,1068
276306,529A14F498129B0238F7B12A9FC7F6F7,30161,15,16,1,109.50042,18.24389,1508
276307,529A14F498129B0238F7B12A9FC7F6F7,31671,17,20,3,109.38965,18.29813,1068
276324,1116E7823ED9EE27945BC1DB58CB088D,31431,0,9,9,109.44639,18.29042,1316
276325,1116E7823ED9EE27945BC1DB58CB088D,33521,10,14,4,109.66313,18.45174,2143
276326,1116E7823ED9EE27945BC1DB58CB088D,31431,18,23,5,109.44639,18.29042,1316
276327,5E8FF49D1CCDA711846608608C7FAE0D,31071,0,6,6,109.58257,18.28458,1815
276328,5E8FF49D1CCDA711846608608C7FAE0D,30854,7,20,13,109.56889,18.27076,1763
276329,5E8FF49D1CCDA711846608608C7FAE0D,31071,20,23,3,109.58257,18.28458,1815
276351,866460FA5062A635337B6369BB2AADDA,38054,14,18,4,109.63479,18.23097,2006
276352,866460FA5062A635337B6369BB2AADDA,30854,19,21,2,109.56889,18.27076,1763
276368,F6A1EBB84FE583E84185C423218578F5,31561,0,5,5,109.56792,18.28479,1765
276369,F6A1EBB84FE583E84185C423218578F5,30854,6,8,2,109.56889,18.27076,1763
276370,F6A1EBB84FE583E84185C423218578F5,39181,9,11,2,109.55153,18.28035,1715
276371,F6A1EBB84FE583E84185C423218578F5,31561,12,13,1,109.56792,18.28479,1765
276372,F6A1EBB84FE583E84185C423218578F5,39183,15,16,1,109.55542,18.28208,1715
276373,F6A1EBB84FE583E84185C423218578F5,30851,19,20,1,109.5616,18.27396,1713
276401,14B1099067687D5FF258F75FE5CF0917,39091,17,18,1,109.50097,18.25222,1510
276402,14B1099067687D5FF258F75FE5CF0917,30771,19,20,1,109.49938,18.26042,1511
276403,14B1099067687D5FF258F75FE5CF0917,31531,21,23,2,109.49583,18.25972,1461
276406,5202825DF51CA068C8B204422480230F,31071,1,17,16,109.58257,18.28458,1815
276407,5202825DF51CA068C8B204422480230F,30854,19,21,2,109.56889,18.27076,1763
276421,B5D5F035B558647FF9F44A76F16A1183,30741,0,13,13,109.49833,18.28681,1516
276422,B5D5F035B558647FF9F44A76F16A1183,39111,17,19,2,109.5191,18.22597,1555
276423,B5D5F035B558647FF9F44A76F16A1183,30151,19,20,1,109.50986,18.25083,1560
276424,B5D5F035B558647FF9F44A76F16A1183,31521,21,23,2,109.51458,18.22542,1555
276427,6A8C883D29A8AF90E102449F92489A64,30854,0,17,17,109.56889,18.27076,1763
276428,6A8C883D29A8AF90E102449F92489A64,60463,19,20,1,109.52507,18.22438,1605
276510,40C57F24FE0409ABB752B2031C349577,30271,0,2,2,109.49132,18.23153,1456
276511,40C57F24FE0409ABB752B2031C349577,38951,4,17,13,109.48097,18.28868,1416
276512,40C57F24FE0409ABB752B2031C349577,60463,20,21,1,109.52507,18.22438,1605
276534,970D6BC437EA1378FAE0DFD7B07AAE0B,30171,13,17,4,109.48458,18.27139,1463
276535,970D6BC437EA1378FAE0DFD7B07AAE0B,30711,20,23,3,109.50271,18.25347,1510
276546,CF90889F587C2BB558DFC8DC65DE1B88,60381,0,2,2,109.5241,18.22458,1605
276547,CF90889F587C2BB558DFC8DC65DE1B88,39331,3,4,1,109.62125,18.22708,1956
276548,CF90889F587C2BB558DFC8DC65DE1B88,31571,4,12,8,109.61563,18.23326,1957
276549,CF90889F587C2BB558DFC8DC65DE1B88,38826,18,19,1,109.50326,18.25514,1510
276550,CF90889F587C2BB558DFC8DC65DE1B88,31461,20,22,2,109.5091,18.25389,1510
276551,CFF5BE3C5C109C874F96B9E9841D39B0,30171,0,18,18,109.48458,18.27139,1463
276552,CFF5BE3C5C109C874F96B9E9841D39B0,30171,20,23,3,109.48458,18.27139,1463
276581,34AB502A442AA8EA4A7FB30471B204DB,38325,0,7,7,109.39792,18.2909,1116
276582,34AB502A442AA8EA4A7FB30471B204DB,38094,10,11,1,109.45403,18.28778,1316
276583,34AB502A442AA8EA4A7FB30471B204DB,38251,12,13,1,109.49618,18.25493,1510
276584,34AB502A442AA8EA4A7FB30471B204DB,30341,14,16,2,109.3625,18.29167,966
276606,4BCFB9B7DA47F954D069C9FF9050BF88,31071,1,2,1,109.58257,18.28458,1815
276607,4BCFB9B7DA47F954D069C9FF9050BF88,60354,3,4,1,109.58701,18.28521,1815
276608,4BCFB9B7DA47F954D069C9FF9050BF88,31071,5,9,4,109.58257,18.28458,1815
276609,4BCFB9B7DA47F954D069C9FF9050BF88,31071,13,14,1,109.58257,18.28458,1815
276610,4BCFB9B7DA47F954D069C9FF9050BF88,31071,15,16,1,109.58257,18.28458,1815
276611,4BCFB9B7DA47F954D069C9FF9050BF88,31071,19,20,1,109.58257,18.28458,1815
276612,6FDD8510FC3FD17D36965B0963BD7329,31561,6,12,6,109.56792,18.28479,1765
276613,6FDD8510FC3FD17D36965B0963BD7329,30854,14,22,8,109.56889,18.27076,1763
276663,B712327B6033C61F37801CFD6DAC08AD,38484,8,11,3,109.53028,18.31528,1620
276664,B712327B6033C61F37801CFD6DAC08AD,38484,14,23,9,109.53028,18.31528,1620
276669,498749BB2BA481D5A422CC677A8DD529,38013,0,8,8,109.49514,18.21951,1454
276670,498749BB2BA481D5A422CC677A8DD529,31301,10,13,3,109.14493,18.31222,170
276671,498749BB2BA481D5A422CC677A8DD529,31471,14,16,2,109.34583,18.29563,917
276672,498749BB2BA481D5A422CC677A8DD529,38013,19,23,4,109.49514,18.21951,1454
276679,38373FB2D234CBFB5EC902C1D6C5AD6D,31864,0,9,9,109.49014,18.28333,1465
276680,38373FB2D234CBFB5EC902C1D6C5AD6D,30361,12,14,2,109.50347,18.24,1508
276681,38373FB2D234CBFB5EC902C1D6C5AD6D,30211,16,17,1,109.49882,18.23931,1508
276682,38373FB2D234CBFB5EC902C1D6C5AD6D,31864,21,23,2,109.49014,18.28333,1465
276696,DF296B63A64E364FCDA4C38B0935EEEE,30511,0,1,1,109.51069,18.24208,1558
276697,DF296B63A64E364FCDA4C38B0935EEEE,30151,4,11,7,109.50986,18.25083,1560
276698,DF296B63A64E364FCDA4C38B0935EEEE,30511,11,23,12,109.51069,18.24208,1558
276699,8F99FBAD46040867B6C8F52DEFB54488,60541,13,16,3,109.4084,18.29208,1167
276700,8F99FBAD46040867B6C8F52DEFB54488,60621,21,23,2,109.48354,18.27451,1464
276730,6C66825FD2EB35405A0E811EC12F35C8,31101,15,16,1,109.65389,18.23403,2057
276731,6C66825FD2EB35405A0E811EC12F35C8,60221,18,21,3,109.52569,18.29188,1616
276732,6C66825FD2EB35405A0E811EC12F35C8,60381,21,23,2,109.5241,18.22458,1605
276754,06A941D50D485A4C433548955BEB89BA,31071,0,11,11,109.58257,18.28458,1815
276755,06A941D50D485A4C433548955BEB89BA,30854,11,13,2,109.56889,18.27076,1763
276818,40D7A05F2EBEDCC87229F660CD52781C,30201,7,8,1,109.4909,18.26465,1462
276917,B0E2159906E2F066EA26580E9E3FC6C5,39061,1,2,1,109.38222,18.28958,1066
276918,B0E2159906E2F066EA26580E9E3FC6C5,39281,4,5,1,109.21333,18.30271,418
276919,B0E2159906E2F066EA26580E9E3FC6C5,31231,6,8,2,109.42597,18.29292,1217
276920,B0E2159906E2F066EA26580E9E3FC6C5,60054,14,15,1,109.3016,18.31229,770
276921,B0E2159906E2F066EA26580E9E3FC6C5,31231,19,23,4,109.42597,18.29292,1217
276958,30F5D42A1A8F1CF26F5C9617FCB06C4F,31561,14,15,1,109.56792,18.28479,1765
276989,557A975BF2F1D3135462224F08758153,38154,0,5,5,109.5266,18.28278,1615
276990,557A975BF2F1D3135462224F08758153,60221,6,9,3,109.52569,18.29188,1616
276998,501EBB127F6BDBDEA4AD124F9BAA4BCF,31021,19,20,1,109.49021,18.27,1463
276999,501EBB127F6BDBDEA4AD124F9BAA4BCF,30761,21,23,2,109.45201,18.3,1318
277010,F9384ADFDEF6D5E0D88A916FD456608E,60087,2,10,8,109.50688,18.22299,1505
277011,F9384ADFDEF6D5E0D88A916FD456608E,31561,13,14,1,109.56792,18.28479,1765
277012,F9384ADFDEF6D5E0D88A916FD456608E,30341,17,18,1,109.3625,18.29167,966
277013,F9384ADFDEF6D5E0D88A916FD456608E,31091,20,21,1,109.41201,18.31222,1170
277033,DD056101D68CBFC24096E8F587CC747C,30071,1,19,18,109.52819,18.30472,1619
277034,DD056101D68CBFC24096E8F587CC747C,31931,20,22,2,109.54771,18.29403,1667
277035,DD056101D68CBFC24096E8F587CC747C,30921,22,23,1,109.53903,18.29451,1667
277040,423E2A7AD06C927EE0BD23EE3AB605E3,30854,0,6,6,109.56889,18.27076,1763
277041,423E2A7AD06C927EE0BD23EE3AB605E3,30171,9,12,3,109.48458,18.27139,1463
277042,423E2A7AD06C927EE0BD23EE3AB605E3,30854,15,23,8,109.56889,18.27076,1763
277065,42158B50A96F4BB50162AD5AAF8D7E2D,60331,13,15,2,109.505,18.26507,1512
277066,42158B50A96F4BB50162AD5AAF8D7E2D,31521,15,18,3,109.51458,18.22542,1555
277067,42158B50A96F4BB50162AD5AAF8D7E2D,38154,18,21,3,109.5266,18.28278,1615
277068,42158B50A96F4BB50162AD5AAF8D7E2D,31201,21,23,2,109.51042,18.23819,1558
277093,97C31877CA4226D0F1BA1C0E12066B56,60331,0,6,6,109.505,18.26507,1512
277094,97C31877CA4226D0F1BA1C0E12066B56,30854,10,18,8,109.56889,18.27076,1763
277095,97C31877CA4226D0F1BA1C0E12066B56,30251,19,22,3,109.50611,18.26653,1512
277129,14DC797BA214017EE45D7C82C4CE6C66,60131,16,18,2,109.49819,18.24778,1509
277130,14DC797BA214017EE45D7C82C4CE6C66,38251,18,19,1,109.49618,18.25493,1510
277131,14DC797BA214017EE45D7C82C4CE6C66,60201,20,22,2,109.5041,18.2509,1510
277141,B8D9C92BE7FD5822ED6E8DACDA16E988,38541,10,18,8,109.73715,18.34875,2426
277144,A749E400BFD3B5908671E939EC104DEE,31071,18,19,1,109.58257,18.28458,1815
277145,A749E400BFD3B5908671E939EC104DEE,30854,19,21,2,109.56889,18.27076,1763
277146,4341EB42DEED1649C5A69E1740E9E46C,31841,1,10,9,109.73201,18.33382,2373
277147,4341EB42DEED1649C5A69E1740E9E46C,60381,12,13,1,109.5241,18.22458,1605
277148,4341EB42DEED1649C5A69E1740E9E46C,31471,15,17,2,109.34583,18.29563,917
277149,4341EB42DEED1649C5A69E1740E9E46C,30711,17,19,2,109.50271,18.25347,1510
277150,4341EB42DEED1649C5A69E1740E9E46C,31841,20,23,3,109.73201,18.33382,2373
277151,E4B522EF4348156010E5C578EC13D60F,30854,0,21,21,109.56889,18.27076,1763
277152,E4B522EF4348156010E5C578EC13D60F,30234,22,23,1,109.60681,18.29979,1918
277156,F25102D4BE48A66B8AE50787215C5331,31181,0,8,8,109.50382,18.24813,1509
277157,F25102D4BE48A66B8AE50787215C5331,60291,9,10,1,109.50826,18.24639,1509
277158,F25102D4BE48A66B8AE50787215C5331,31231,14,18,4,109.42597,18.29292,1217
277159,560794A44CA17A43FA34D0FA6C339747,38361,11,13,2,109.43667,18.29201,1267
277160,560794A44CA17A43FA34D0FA6C339747,30651,15,20,5,109.42611,18.385,1232
277161,560794A44CA17A43FA34D0FA6C339747,30821,21,22,1,109.43681,18.33639,1274
277167,E1DB781A629B25793891F8EFD0B2C10F,30661,14,16,2,109.37028,18.24361,1008
277168,E1DB781A629B25793891F8EFD0B2C10F,60411,19,20,1,109.32514,18.30854,869
277169,86435198F57620D5DAC23B4A4DA78009,39183,2,4,2,109.55542,18.28208,1715
277170,86435198F57620D5DAC23B4A4DA78009,31931,4,6,2,109.54771,18.29403,1667
277171,86435198F57620D5DAC23B4A4DA78009,39183,8,14,6,109.55542,18.28208,1715
277172,86435198F57620D5DAC23B4A4DA78009,31931,16,20,4,109.54771,18.29403,1667
277179,D090D23BEAB243AAF74CB3648E81F65B,30851,0,4,4,109.5616,18.27396,1713
277180,D090D23BEAB243AAF74CB3648E81F65B,30854,4,5,1,109.56889,18.27076,1763
277181,D090D23BEAB243AAF74CB3648E81F65B,31561,8,19,11,109.56792,18.28479,1765
277184,608A55C14BAB2A5B627ACC1F39B89FB6,31945,0,7,7,109.58021,18.29403,1817
277185,608A55C14BAB2A5B627ACC1F39B89FB6,30854,7,11,4,109.56889,18.27076,1763
277186,608A55C14BAB2A5B627ACC1F39B89FB6,31945,11,13,2,109.58021,18.29403,1817
277187,608A55C14BAB2A5B627ACC1F39B89FB6,30854,18,19,1,109.56889,18.27076,1763
277188,608A55C14BAB2A5B627ACC1F39B89FB6,31945,20,23,3,109.58021,18.29403,1817
277249,10EBF762D28520B09848288F7052CFDE,30854,0,4,4,109.56889,18.27076,1763
277250,10EBF762D28520B09848288F7052CFDE,31181,6,8,2,109.50382,18.24813,1509
277251,10EBF762D28520B09848288F7052CFDE,30161,9,11,2,109.50042,18.24389,1508
277252,10EBF762D28520B09848288F7052CFDE,39101,12,14,2,109.50132,18.24931,1509
277253,10EBF762D28520B09848288F7052CFDE,30161,14,17,3,109.50042,18.24389,1508
277254,10EBF762D28520B09848288F7052CFDE,30854,19,21,2,109.56889,18.27076,1763
277285,546C572FC49C780F9A9AF62ED98666DF,30351,1,6,5,109.41701,18.29292,1217
277286,546C572FC49C780F9A9AF62ED98666DF,30681,8,20,12,109.48493,18.26917,1463
277287,546C572FC49C780F9A9AF62ED98666DF,30351,21,23,2,109.41701,18.29292,1217
277293,938D171E5EAE820A5CCCE591D1AFF213,30791,0,7,7,109.72333,18.40889,2386
277294,938D171E5EAE820A5CCCE591D1AFF213,38325,10,13,3,109.39792,18.2909,1116
277295,938D171E5EAE820A5CCCE591D1AFF213,30681,14,17,3,109.48493,18.26917,1463
277303,0581E9E739979A5820C2704457E52AEA,39321,0,8,8,109.529,18.2167,1604
277304,0581E9E739979A5820C2704457E52AEA,31471,11,13,2,109.34583,18.29563,917
277305,0581E9E739979A5820C2704457E52AEA,60221,15,17,2,109.52569,18.29188,1616
277306,0581E9E739979A5820C2704457E52AEA,30791,21,23,2,109.72333,18.40889,2386
277314,B09F6CB43F7BB3E6391589239BFB1120,38951,0,17,17,109.48097,18.28868,1416
277315,B09F6CB43F7BB3E6391589239BFB1120,30561,20,23,3,109.52778,18.31938,1621
277362,EAA65A180AE9F8A17F71F7EDB51A872E,31431,0,10,10,109.44639,18.29042,1316
277363,EAA65A180AE9F8A17F71F7EDB51A872E,60401,11,12,1,109.47444,18.27583,1414
277364,EAA65A180AE9F8A17F71F7EDB51A872E,31431,13,14,1,109.44639,18.29042,1316
277365,EAA65A180AE9F8A17F71F7EDB51A872E,60621,15,17,2,109.48354,18.27451,1464
277366,EAA65A180AE9F8A17F71F7EDB51A872E,60401,17,23,6,109.47444,18.27583,1414
277378,322BABD023220585A08D0E8C40E27D14,31061,0,5,5,109.53333,18.23257,1607
277379,322BABD023220585A08D0E8C40E27D14,31781,10,13,3,109.19847,18.2975,367
277380,322BABD023220585A08D0E8C40E27D14,30861,18,19,1,109.52722,18.22743,1606
277383,D947329382FD9474122243533197BA56,39154,0,6,6,109.50201,18.25681,1511
277385,B621E9075674E792CCB217233825F9D1,30854,6,8,2,109.56889,18.27076,1763
277386,B621E9075674E792CCB217233825F9D1,31071,11,15,4,109.58257,18.28458,1815
277387,B621E9075674E792CCB217233825F9D1,30854,18,19,1,109.56889,18.27076,1763
277388,B621E9075674E792CCB217233825F9D1,60631,22,23,1,109.57778,18.27583,1814
277455,77F5A37783010C53E376197FE3F1043D,30071,11,12,1,109.52819,18.30472,1619
277456,77F5A37783010C53E376197FE3F1043D,60371,12,13,1,109.53063,18.30056,1618
277458,77F5A37783010C53E376197FE3F1043D,60371,21,22,1,109.53063,18.30056,1618
277475,FD383D619F571E97F6F509FAB965E5A5,31461,0,7,7,109.5091,18.25389,1510
277476,FD383D619F571E97F6F509FAB965E5A5,60201,9,11,2,109.5041,18.2509,1510
277477,FD383D619F571E97F6F509FAB965E5A5,30861,13,14,1,109.52722,18.22743,1606
277480,37DC2EF674B0D61C6D10D120CF46E31D,60221,0,9,9,109.52569,18.29188,1616
277481,37DC2EF674B0D61C6D10D120CF46E31D,30151,12,17,5,109.50986,18.25083,1560
277482,37DC2EF674B0D61C6D10D120CF46E31D,60221,18,23,5,109.52569,18.29188,1616
277489,0F558B6653C655C7F0BAEA9D66B33F57,31071,1,6,5,109.58257,18.28458,1815
277490,0F558B6653C655C7F0BAEA9D66B33F57,30854,7,16,9,109.56889,18.27076,1763
277491,1026894DC5FF9A7FAF3A2EE28B95E239,30232,1,5,4,109.6191,18.31701,1971
277492,1026894DC5FF9A7FAF3A2EE28B95E239,30854,8,16,8,109.56889,18.27076,1763
277493,1026894DC5FF9A7FAF3A2EE28B95E239,60631,20,21,1,109.57778,18.27583,1814
277494,1026894DC5FF9A7FAF3A2EE28B95E239,30854,21,23,2,109.56889,18.27076,1763
277499,43F5AB52A0AF3FEB5880C6DCD16BBA02,60011,0,7,7,109.48965,18.30222,1468
277500,43F5AB52A0AF3FEB5880C6DCD16BBA02,31391,11,14,3,109.50382,18.24285,1508
277501,43F5AB52A0AF3FEB5880C6DCD16BBA02,30191,18,20,2,109.50361,18.22701,1506
277502,43F5AB52A0AF3FEB5880C6DCD16BBA02,60011,21,23,2,109.48965,18.30222,1468
277513,7421066246AAD1C230E7E2A7ADF06E9D,60631,4,7,3,109.57778,18.27583,1814
277514,7421066246AAD1C230E7E2A7ADF06E9D,31071,10,12,2,109.58257,18.28458,1815
277515,7421066246AAD1C230E7E2A7ADF06E9D,60631,12,13,1,109.57778,18.27583,1814
277516,7421066246AAD1C230E7E2A7ADF06E9D,30854,13,19,6,109.56889,18.27076,1763
277517,7421066246AAD1C230E7E2A7ADF06E9D,60631,20,22,2,109.57778,18.27583,1814
277530,A273393D96A2B92B5EC32D0B9DC69E7D,30201,0,7,7,109.4909,18.26465,1462
277531,A273393D96A2B92B5EC32D0B9DC69E7D,30711,7,9,2,109.50271,18.25347,1510
277532,A273393D96A2B92B5EC32D0B9DC69E7D,30711,10,12,2,109.50271,18.25347,1510
277533,A273393D96A2B92B5EC32D0B9DC69E7D,31021,18,19,1,109.49021,18.27,1463
277534,A273393D96A2B92B5EC32D0B9DC69E7D,30084,20,22,2,109.50118,18.26972,1513
277535,A01B4012B619D942E7CC3AC9B78722B4,31561,8,14,6,109.56792,18.28479,1765
277536,A01B4012B619D942E7CC3AC9B78722B4,30854,17,19,2,109.56889,18.27076,1763
277537,A01B4012B619D942E7CC3AC9B78722B4,31561,20,23,3,109.56792,18.28479,1765
277540,D70D11871FB47AB4743A9AB8A25E5AA8,38241,1,6,5,109.54111,18.30542,1669
277541,D70D11871FB47AB4743A9AB8A25E5AA8,60241,6,18,12,109.53319,18.28667,1616
277542,D70D11871FB47AB4743A9AB8A25E5AA8,38241,19,22,3,109.54111,18.30542,1669
277546,C8F6473891EA64CAF71114269800F90A,31521,16,18,2,109.51458,18.22542,1555
277547,C8F6473891EA64CAF71114269800F90A,60381,18,19,1,109.5241,18.22458,1605
277548,C8F6473891EA64CAF71114269800F90A,31521,20,23,3,109.51458,18.22542,1555
277549,417408FFDA93B177641D270D3A5C4B2D,31071,0,15,15,109.58257,18.28458,1815
277550,417408FFDA93B177641D270D3A5C4B2D,30854,16,21,5,109.56889,18.27076,1763
277554,A01E2FD84FFE4D782E40311D1ABC1ECB,39053,0,18,18,109.511,18.2771,1564
277555,A01E2FD84FFE4D782E40311D1ABC1ECB,30741,21,23,2,109.49833,18.28681,1516
277564,B1BCC89C2F3E15CBE4070B0B890371C7,30854,10,15,5,109.56889,18.27076,1763
277565,B1BCC89C2F3E15CBE4070B0B890371C7,31071,19,20,1,109.58257,18.28458,1815
277579,FF2A17822091567D06C9AA731D1A1F17,30901,11,13,2,109.27597,18.3134,670
277580,FF2A17822091567D06C9AA731D1A1F17,30181,16,18,2,109.51597,18.23313,1557
277581,FF2A17822091567D06C9AA731D1A1F17,30361,19,20,1,109.50347,18.24,1508
277582,FF2A17822091567D06C9AA731D1A1F17,30181,22,23,1,109.51597,18.23313,1557
277587,6DA8429267883939CEB3C36824DAAEC3,60524,19,21,2,109.42951,18.28993,1216
277629,F2ED05732C96A4909AC5A9978A02AFD1,38391,0,9,9,109.44111,18.29083,1266
277630,F2ED05732C96A4909AC5A9978A02AFD1,38094,11,12,1,109.45403,18.28778,1316
277631,F2ED05732C96A4909AC5A9978A02AFD1,30361,12,15,3,109.50347,18.24,1508
277632,F2ED05732C96A4909AC5A9978A02AFD1,38361,16,23,7,109.43667,18.29201,1267
277635,A4743972EC2FC58546DD11935BDC0E1A,30711,0,13,13,109.50271,18.25347,1510
277636,A4743972EC2FC58546DD11935BDC0E1A,30771,16,19,3,109.49938,18.26042,1511
277637,A4743972EC2FC58546DD11935BDC0E1A,31091,21,22,1,109.41201,18.31222,1170
277650,B552B11A0B5086873EE9310B7F4CC01D,38361,0,6,6,109.43667,18.29201,1267
277654,B552B11A0B5086873EE9310B7F4CC01D,38361,17,22,5,109.43667,18.29201,1267
277695,393DB76B88CE45729A6014A0A645DD99,31031,18,20,2,109.49979,18.25382,1510
277696,393DB76B88CE45729A6014A0A645DD99,38105,21,22,1,109.40299,18.29229,1117
277724,F4797B2E8271E2F8A6DC8862F6C4C6E7,60087,0,13,13,109.50688,18.22299,1505
277749,8DD23AA43C0F7967C45F7488D66F9159,30854,0,1,1,109.56889,18.27076,1763
277750,8DD23AA43C0F7967C45F7488D66F9159,31945,2,6,4,109.58021,18.29403,1817
277751,8DD23AA43C0F7967C45F7488D66F9159,30854,6,12,6,109.56889,18.27076,1763
277759,BD4652414D5C17466BA36FD4BD943A94,39183,10,11,1,109.55542,18.28208,1715
277760,BD4652414D5C17466BA36FD4BD943A94,31931,11,12,1,109.54771,18.29403,1667
277761,BD4652414D5C17466BA36FD4BD943A94,39183,13,14,1,109.55542,18.28208,1715
277762,147470AD3D3B8724582C30D5F244A8B6,60421,0,6,6,109.46333,18.31743,1371
277763,147470AD3D3B8724582C30D5F244A8B6,30111,7,14,7,109.47583,18.30542,1419
277764,147470AD3D3B8724582C30D5F244A8B6,60421,18,23,5,109.46333,18.31743,1371
277773,59F2738320001FD950F433CB128A2616,30101,0,1,1,109.57299,18.33333,1773
277774,59F2738320001FD950F433CB128A2616,30931,2,5,3,109.55653,18.32722,1722
277775,59F2738320001FD950F433CB128A2616,30809,7,9,2,109.4891,18.28229,1465
277776,59F2738320001FD950F433CB128A2616,38061,10,13,3,109.50597,18.23118,1506
277777,59F2738320001FD950F433CB128A2616,30101,15,17,2,109.57299,18.33333,1773
277778,59F2738320001FD950F433CB128A2616,38251,19,20,1,109.49618,18.25493,1510
277779,59F2738320001FD950F433CB128A2616,30941,22,23,1,109.5559,18.33938,1724
277795,D6B14C7387647D8C883334DAFB518257,30854,17,18,1,109.56889,18.27076,1763
277796,D6B14C7387647D8C883334DAFB518257,31071,19,22,3,109.58257,18.28458,1815
277830,6128117B6C62D97BBF6E959D2F3E0A2E,39181,0,6,6,109.55153,18.28035,1715
277831,6128117B6C62D97BBF6E959D2F3E0A2E,31931,8,9,1,109.54771,18.29403,1667
277832,6128117B6C62D97BBF6E959D2F3E0A2E,39181,10,23,13,109.55153,18.28035,1715
277862,C85D0B931BEF54F05B9ABBBB03212DB7,30854,0,10,10,109.56889,18.27076,1763
277863,C85D0B931BEF54F05B9ABBBB03212DB7,31561,15,16,1,109.56792,18.28479,1765
277864,C85D0B931BEF54F05B9ABBBB03212DB7,30854,16,23,7,109.56889,18.27076,1763
277915,D6CC1FC0E328F94E96D4D1F260DF9F7F,31071,0,2,2,109.58257,18.28458,1815
277916,D6CC1FC0E328F94E96D4D1F260DF9F7F,31071,2,13,11,109.58257,18.28458,1815
277917,D6CC1FC0E328F94E96D4D1F260DF9F7F,31071,13,15,2,109.58257,18.28458,1815
277918,D6CC1FC0E328F94E96D4D1F260DF9F7F,30854,19,20,1,109.56889,18.27076,1763
277919,D6CC1FC0E328F94E96D4D1F260DF9F7F,31071,21,23,2,109.58257,18.28458,1815
277952,410D55EA73A3884577B7B9B7E86B067E,39081,15,17,2,109.19382,18.29111,366
277953,410D55EA73A3884577B7B9B7E86B067E,30084,20,23,3,109.50118,18.26972,1513
277967,D758DCB0CB2E5EA2CADCED24F521A533,31071,0,13,13,109.58257,18.28458,1815
277968,D758DCB0CB2E5EA2CADCED24F521A533,30854,16,18,2,109.56889,18.27076,1763
277999,928DF0385E8541CFD2F5858501C04155,60631,8,9,1,109.57778,18.27583,1814
278000,928DF0385E8541CFD2F5858501C04155,30854,9,11,2,109.56889,18.27076,1763
278039,8BB15E7C959475309A269AAF24FD7109,31521,3,8,5,109.51458,18.22542,1555
278040,8BB15E7C959475309A269AAF24FD7109,31521,9,17,8,109.51458,18.22542,1555
278041,8BB15E7C959475309A269AAF24FD7109,60381,18,22,4,109.5241,18.22458,1605
278050,75817DB682187A07461734D66E1E6492,60631,0,5,5,109.57778,18.27583,1814
278051,75817DB682187A07461734D66E1E6492,30854,6,16,10,109.56889,18.27076,1763
278052,75817DB682187A07461734D66E1E6492,60631,18,23,5,109.57778,18.27583,1814
278071,E16204D131FCD957D5ADB9592C1DD0ED,31071,0,8,8,109.58257,18.28458,1815
278072,E16204D131FCD957D5ADB9592C1DD0ED,30854,11,13,2,109.56889,18.27076,1763
278073,E16204D131FCD957D5ADB9592C1DD0ED,30151,18,20,2,109.50986,18.25083,1560
278074,E16204D131FCD957D5ADB9592C1DD0ED,30211,20,23,3,109.49882,18.23931,1508
278086,95F6D81D9D517084554E43C715595D83,31471,0,19,19,109.34583,18.29563,917
278087,95F6D81D9D517084554E43C715595D83,60411,20,22,2,109.32514,18.30854,869
278088,005F3AEFE6DBF371ED1FD57736434098,31071,0,7,7,109.58257,18.28458,1815
278089,005F3AEFE6DBF371ED1FD57736434098,30854,8,10,2,109.56889,18.27076,1763
278090,005F3AEFE6DBF371ED1FD57736434098,31071,12,14,2,109.58257,18.28458,1815
278091,005F3AEFE6DBF371ED1FD57736434098,30854,14,16,2,109.56889,18.27076,1763
278092,005F3AEFE6DBF371ED1FD57736434098,31071,17,22,5,109.58257,18.28458,1815
278111,FC93BC6360F492734DE9BAEAEC043E73,30661,10,11,1,109.37028,18.24361,1008
278112,FC93BC6360F492734DE9BAEAEC043E73,31145,13,15,2,109.20431,18.30479,369
278113,FC93BC6360F492734DE9BAEAEC043E73,31471,16,18,2,109.34583,18.29563,917
278114,FC93BC6360F492734DE9BAEAEC043E73,38951,21,23,2,109.48097,18.28868,1416
278134,F57902A58026464B5BDED6D5CB0C8C35,30081,0,12,12,109.50243,18.26632,1512
278135,F57902A58026464B5BDED6D5CB0C8C35,31461,12,15,3,109.5091,18.25389,1510
278136,F57902A58026464B5BDED6D5CB0C8C35,30721,19,20,1,109.51597,18.28257,1565
278144,ECCCA5770AD6AA7162B63EC395B55856,39371,9,13,4,109.56627,18.2646,1762
278145,ECCCA5770AD6AA7162B63EC395B55856,30951,13,16,3,109.56208,18.25667,1761
278146,ECCCA5770AD6AA7162B63EC395B55856,60631,18,23,5,109.57778,18.27583,1814
278203,5E97A4561E11AAC4FBC53FD068EAA52B,30854,0,7,7,109.56889,18.27076,1763
278204,5E97A4561E11AAC4FBC53FD068EAA52B,30531,11,19,8,109.53271,18.21472,1604
278205,857151F1A6D20CD5D8628AB5ADDDD79D,38251,19,21,2,109.49618,18.25493,1510
278206,857151F1A6D20CD5D8628AB5ADDDD79D,60401,21,23,2,109.47444,18.27583,1414
278269,88DEAC5AA353692421954529EB8C6F32,30854,0,17,17,109.56889,18.27076,1763
278270,88DEAC5AA353692421954529EB8C6F32,60631,18,20,2,109.57778,18.27583,1814
278271,88DEAC5AA353692421954529EB8C6F32,30854,21,23,2,109.56889,18.27076,1763
278272,B643AC77F8D8498A9694D45BA8B0F75F,60631,0,17,17,109.57778,18.27583,1814
278273,B643AC77F8D8498A9694D45BA8B0F75F,31561,20,21,1,109.56792,18.28479,1765
278281,C7496056C1A6845D1B832CA26FCE640B,31521,0,9,9,109.51458,18.22542,1555
278282,C7496056C1A6845D1B832CA26FCE640B,31471,13,14,1,109.34583,18.29563,917
278283,C7496056C1A6845D1B832CA26FCE640B,31031,19,21,2,109.49979,18.25382,1510
278284,C7496056C1A6845D1B832CA26FCE640B,31521,21,23,2,109.51458,18.22542,1555
278300,CE70D3AAC3EF6B01DB8A5F34BD94E77D,30821,0,7,7,109.43681,18.33639,1274
278301,CE70D3AAC3EF6B01DB8A5F34BD94E77D,30651,8,9,1,109.42611,18.385,1232
278302,CE70D3AAC3EF6B01DB8A5F34BD94E77D,30821,11,22,11,109.43681,18.33639,1274
278339,E5839D12AB65C96EAE301BA701F1E2D0,48601,0,1,1,109.51694,18.22514,1555
278340,E5839D12AB65C96EAE301BA701F1E2D0,60291,2,7,5,109.50826,18.24639,1509
278341,E5839D12AB65C96EAE301BA701F1E2D0,31521,8,10,2,109.51458,18.22542,1555
278342,E5839D12AB65C96EAE301BA701F1E2D0,31521,11,14,3,109.51458,18.22542,1555
278343,E5839D12AB65C96EAE301BA701F1E2D0,39321,15,16,1,109.529,18.2167,1604
278344,E5839D12AB65C96EAE301BA701F1E2D0,31521,18,19,1,109.51458,18.22542,1555
278345,E5839D12AB65C96EAE301BA701F1E2D0,60291,21,23,2,109.50826,18.24639,1509
278352,9EDC789413D54BDC00C69BCE3615AF7F,60291,14,15,1,109.50826,18.24639,1509
278353,9EDC789413D54BDC00C69BCE3615AF7F,60621,17,23,6,109.48354,18.27451,1464
278370,27BCEF3137923B84211F08830816C810,30851,1,12,11,109.5616,18.27396,1713
278371,27BCEF3137923B84211F08830816C810,31561,13,21,8,109.56792,18.28479,1765
278372,27BCEF3137923B84211F08830816C810,30851,21,23,2,109.5616,18.27396,1713
278414,4995463B780282C9C030A19D9F49AEAC,31071,2,7,5,109.58257,18.28458,1815
278415,4995463B780282C9C030A19D9F49AEAC,30854,7,11,4,109.56889,18.27076,1763
278427,4E94ADAE7ABEB20EEFAF67519DFCC1BE,31081,0,9,9,109.44639,18.30181,1318
278428,4E94ADAE7ABEB20EEFAF67519DFCC1BE,31031,9,22,13,109.49979,18.25382,1510
278491,BD85969D888F94131C562624432FF75B,31071,0,6,6,109.58257,18.28458,1815
278492,BD85969D888F94131C562624432FF75B,30681,8,15,7,109.48493,18.26917,1463
278505,6FBDDF7419820F8908B8A8CE3C81E7C3,60621,0,7,7,109.48354,18.27451,1464
278506,6FBDDF7419820F8908B8A8CE3C81E7C3,31031,9,11,2,109.49979,18.25382,1510
278507,6FBDDF7419820F8908B8A8CE3C81E7C3,30711,12,13,1,109.50271,18.25347,1510
278508,6FBDDF7419820F8908B8A8CE3C81E7C3,60621,14,15,1,109.48354,18.27451,1464
278509,6FBDDF7419820F8908B8A8CE3C81E7C3,60401,16,18,2,109.47444,18.27583,1414
278510,6FBDDF7419820F8908B8A8CE3C81E7C3,60621,21,22,1,109.48354,18.27451,1464
278516,F94EBB0B32E924A93A488CBC5BF180F4,38105,8,9,1,109.40299,18.29229,1117
278517,F94EBB0B32E924A93A488CBC5BF180F4,31781,11,15,4,109.19847,18.2975,367
278518,F94EBB0B32E924A93A488CBC5BF180F4,31471,17,18,1,109.34583,18.29563,917
278519,F94EBB0B32E924A93A488CBC5BF180F4,38105,19,23,4,109.40299,18.29229,1117
278536,F198CAA1F49ACA5D003FD8F8473B3798,31071,17,18,1,109.58257,18.28458,1815
278537,F198CAA1F49ACA5D003FD8F8473B3798,30581,20,22,2,109.62257,18.24951,1959
278592,C860767955774E3494068CF38C009FB6,60391,0,10,10,109.47667,18.28757,1416
278593,C860767955774E3494068CF38C009FB6,60131,13,14,1,109.49819,18.24778,1509
278594,C860767955774E3494068CF38C009FB6,60391,14,17,3,109.47667,18.28757,1416
278595,C860767955774E3494068CF38C009FB6,39101,19,21,2,109.50132,18.24931,1509
278609,BB341BA09AFD6F1A65DDB2B3AF49B6CA,30321,14,15,1,109.49563,18.29611,1467
278613,DAB08D254D49BF150533311BD904D49C,38154,11,18,7,109.5266,18.28278,1615
278614,DAB08D254D49BF150533311BD904D49C,30861,21,23,2,109.52722,18.22743,1606
278615,7334BFE245C0E1675EC3C07645407CF3,60411,0,2,2,109.32514,18.30854,869
278616,7334BFE245C0E1675EC3C07645407CF3,30781,2,3,1,109.3275,18.37847,881
278617,7334BFE245C0E1675EC3C07645407CF3,60054,7,16,9,109.3016,18.31229,770
278618,7334BFE245C0E1675EC3C07645407CF3,31121,18,21,3,109.16292,18.37063,230
278619,7334BFE245C0E1675EC3C07645407CF3,31541,22,23,1,109.1809,18.36722,329
278634,1D2F8DB1F8B6A2081E1A43DDF558491D,60361,1,3,2,109.51938,18.29681,1567
278635,1D2F8DB1F8B6A2081E1A43DDF558491D,31951,5,7,2,109.52174,18.30299,1568
278636,1D2F8DB1F8B6A2081E1A43DDF558491D,38484,7,11,4,109.53028,18.31528,1620
278637,1D2F8DB1F8B6A2081E1A43DDF558491D,31951,12,14,2,109.52174,18.30299,1568
278638,1D2F8DB1F8B6A2081E1A43DDF558491D,38484,14,16,2,109.53028,18.31528,1620
278639,1D2F8DB1F8B6A2081E1A43DDF558491D,31951,18,19,1,109.52174,18.30299,1568
278640,1D2F8DB1F8B6A2081E1A43DDF558491D,30561,19,21,2,109.52778,18.31938,1621
278641,1D2F8DB1F8B6A2081E1A43DDF558491D,31951,21,23,2,109.52174,18.30299,1568
278642,8C5A16299A6D294198C90C34C25C5949,31561,16,21,5,109.56792,18.28479,1765
278643,8C5A16299A6D294198C90C34C25C5949,39183,22,23,1,109.55542,18.28208,1715
278651,0526FBDD03CECB7E3925506B4441EC17,30511,0,7,7,109.51069,18.24208,1558
278652,0526FBDD03CECB7E3925506B4441EC17,31443,8,23,15,109.5116,18.24438,1559
278724,0E0D6E55BB1995EBF85F6B7AA8765E55,60631,1,7,6,109.57778,18.27583,1814
278725,0E0D6E55BB1995EBF85F6B7AA8765E55,30854,11,12,1,109.56889,18.27076,1763
278726,0E0D6E55BB1995EBF85F6B7AA8765E55,38271,15,23,8,109.62632,18.23049,1956
278750,C711EA8F4B039EAC279F7CFC24309A8A,60671,10,14,4,109.52979,18.31757,1621
278751,C711EA8F4B039EAC279F7CFC24309A8A,38484,17,20,3,109.53028,18.31528,1620
278768,770A00BDAFE9BCA8C9E9FA68066EED7D,31071,0,5,5,109.58257,18.28458,1815
278769,770A00BDAFE9BCA8C9E9FA68066EED7D,30851,8,12,4,109.5616,18.27396,1713
278770,770A00BDAFE9BCA8C9E9FA68066EED7D,31561,13,20,7,109.56792,18.28479,1765
278771,770A00BDAFE9BCA8C9E9FA68066EED7D,31071,20,23,3,109.58257,18.28458,1815
278811,F5FE23BF42FC224C310CD42E08B0B950,31431,0,6,6,109.44639,18.29042,1316
278812,F5FE23BF42FC224C310CD42E08B0B950,38094,6,19,13,109.45403,18.28778,1316
278813,F5FE23BF42FC224C310CD42E08B0B950,31431,20,22,2,109.44639,18.29042,1316
278832,A1BBC37DD6A282EE85E85B258D490CE4,39111,0,5,5,109.5191,18.22597,1555
278835,A1BBC37DD6A282EE85E85B258D490CE4,31521,17,22,5,109.51458,18.22542,1555
278851,60F8D9AEE01A24B0FD311FB00FA225A2,31521,0,7,7,109.51458,18.22542,1555
278852,60F8D9AEE01A24B0FD311FB00FA225A2,31781,10,13,3,109.19847,18.2975,367
278853,60F8D9AEE01A24B0FD311FB00FA225A2,31471,14,17,3,109.34583,18.29563,917
278854,60F8D9AEE01A24B0FD311FB00FA225A2,38356,19,23,4,109.50201,18.21486,1504
278888,4587E26C00C36D3FE7633B1B02F6A233,31021,9,10,1,109.49021,18.27,1463
278889,4587E26C00C36D3FE7633B1B02F6A233,60121,14,15,1,109.74507,18.37472,2430
278900,C01D7F4C525517694A04D5EAA5AD2420,31931,9,11,2,109.54771,18.29403,1667
278901,C01D7F4C525517694A04D5EAA5AD2420,31071,12,14,2,109.58257,18.28458,1815
278902,C01D7F4C525517694A04D5EAA5AD2420,60291,15,17,2,109.50826,18.24639,1509
278925,46D3900FF4CD0CE137E6DB2E5BBC5B87,39183,0,9,9,109.55542,18.28208,1715
278926,46D3900FF4CD0CE137E6DB2E5BBC5B87,30071,10,11,1,109.52819,18.30472,1619
278927,46D3900FF4CD0CE137E6DB2E5BBC5B87,39183,12,23,11,109.55542,18.28208,1715
278956,49EACD487E1313208F8A679985381860,31554,0,7,7,109.55521,18.2459,1709
278957,49EACD487E1313208F8A679985381860,31471,9,11,2,109.34583,18.29563,917
278958,49EACD487E1313208F8A679985381860,60054,14,16,2,109.3016,18.31229,770
278959,49EACD487E1313208F8A679985381860,30361,17,19,2,109.50347,18.24,1508
278960,49EACD487E1313208F8A679985381860,31554,22,23,1,109.55521,18.2459,1709
278961,1CD4AA669B0A97C5CF3E3A003BF9AB81,31231,0,9,9,109.42597,18.29292,1217
278962,1CD4AA669B0A97C5CF3E3A003BF9AB81,31471,13,14,1,109.34583,18.29563,917
278963,1CD4AA669B0A97C5CF3E3A003BF9AB81,31021,19,21,2,109.49021,18.27,1463
278964,1CD4AA669B0A97C5CF3E3A003BF9AB81,31231,22,23,1,109.42597,18.29292,1217
278971,8AD9F37216B2D3FCE05CA77434307672,30741,0,8,8,109.49833,18.28681,1516
278972,8AD9F37216B2D3FCE05CA77434307672,31851,11,13,2,109.71736,18.29007,2316
278973,8AD9F37216B2D3FCE05CA77434307672,31201,16,17,1,109.51042,18.23819,1558
278987,D935A999C0CFBD64CC711BE744C4EC5B,30851,0,6,6,109.5616,18.27396,1713
278988,D935A999C0CFBD64CC711BE744C4EC5B,31561,7,8,1,109.56792,18.28479,1765
278989,D935A999C0CFBD64CC711BE744C4EC5B,30854,9,11,2,109.56889,18.27076,1763
278990,D935A999C0CFBD64CC711BE744C4EC5B,31561,12,13,1,109.56792,18.28479,1765
278991,D935A999C0CFBD64CC711BE744C4EC5B,30854,16,23,7,109.56889,18.27076,1763
278999,B81DEDE33B0853E35D97557F334A4861,60361,0,6,6,109.51938,18.29681,1567
279000,B81DEDE33B0853E35D97557F334A4861,31931,6,16,10,109.54771,18.29403,1667
279001,B81DEDE33B0853E35D97557F334A4861,60361,20,23,3,109.51938,18.29681,1567
279023,6E51F1617F5FF00896EFF6196F8A8F96,30854,14,16,2,109.56889,18.27076,1763
279024,6E51F1617F5FF00896EFF6196F8A8F96,39111,19,20,1,109.5191,18.22597,1555
279029,F4D649C785503C88909B23FA300C31B8,38251,0,8,8,109.49618,18.25493,1510
279030,F4D649C785503C88909B23FA300C31B8,30421,8,10,2,109.50021,18.25861,1511
279031,F4D649C785503C88909B23FA300C31B8,31471,12,15,3,109.34583,18.29563,917
279032,F4D649C785503C88909B23FA300C31B8,31471,15,16,1,109.34583,18.29563,917
279033,F4D649C785503C88909B23FA300C31B8,38251,18,23,5,109.49618,18.25493,1510
279043,E8D51F8B53F290BFD73338AD2AD8C728,31561,0,6,6,109.56792,18.28479,1765
279044,E8D51F8B53F290BFD73338AD2AD8C728,39183,9,18,9,109.55542,18.28208,1715
279045,E8D51F8B53F290BFD73338AD2AD8C728,31561,19,22,3,109.56792,18.28479,1765
279055,CFCFA94681CDD57855D6405C244168DD,31171,2,6,4,109.50938,18.24917,1559
279056,CFCFA94681CDD57855D6405C244168DD,38291,7,9,2,109.51618,18.24313,1558
279057,CFCFA94681CDD57855D6405C244168DD,31821,10,11,1,109.51181,18.24924,1559
279058,CFCFA94681CDD57855D6405C244168DD,38891,12,13,1,109.51486,18.24118,1558
279059,CFCFA94681CDD57855D6405C244168DD,31821,14,15,1,109.51181,18.24924,1559
279060,D77A5C2E97A74D805A87772560CE2BFF,39321,0,7,7,109.529,18.2167,1604
279061,D77A5C2E97A74D805A87772560CE2BFF,31421,9,11,2,109.55382,18.22347,1705
279062,D77A5C2E97A74D805A87772560CE2BFF,60381,14,16,2,109.5241,18.22458,1605
279063,D77A5C2E97A74D805A87772560CE2BFF,31421,16,22,6,109.55382,18.22347,1705
279219,D334753E33AD01D79142036B3D85543F,31561,0,5,5,109.56792,18.28479,1765
279220,D334753E33AD01D79142036B3D85543F,39183,5,11,6,109.55542,18.28208,1715
279221,D334753E33AD01D79142036B3D85543F,39181,11,13,2,109.55153,18.28035,1715
279222,D334753E33AD01D79142036B3D85543F,31931,15,16,1,109.54771,18.29403,1667
279223,D334753E33AD01D79142036B3D85543F,31561,18,20,2,109.56792,18.28479,1765
279291,B6DD27E1160E459E8CDB23CF1876B6FF,31521,0,9,9,109.51458,18.22542,1555
279292,B6DD27E1160E459E8CDB23CF1876B6FF,31145,12,15,3,109.20431,18.30479,369
279293,B6DD27E1160E459E8CDB23CF1876B6FF,31471,16,17,1,109.34583,18.29563,917
279294,B6DD27E1160E459E8CDB23CF1876B6FF,31521,18,23,5,109.51458,18.22542,1555
279301,AAD8B0E06D1E8C325CD7644E091AFB91,38951,0,1,1,109.48097,18.28868,1416
279302,AAD8B0E06D1E8C325CD7644E091AFB91,60614,1,2,1,109.48799,18.29521,1467
279303,AAD8B0E06D1E8C325CD7644E091AFB91,60501,3,4,1,109.48701,18.29021,1466
279304,AAD8B0E06D1E8C325CD7644E091AFB91,60614,5,6,1,109.48799,18.29521,1467
279305,AAD8B0E06D1E8C325CD7644E091AFB91,31471,15,17,2,109.34583,18.29563,917
279306,AAD8B0E06D1E8C325CD7644E091AFB91,38951,18,19,1,109.48097,18.28868,1416
279307,AAD8B0E06D1E8C325CD7644E091AFB91,60614,19,22,3,109.48799,18.29521,1467
279320,A9FCE0049DB44FE004EAFBF5B783F4A5,31071,16,17,1,109.58257,18.28458,1815
279321,A9FCE0049DB44FE004EAFBF5B783F4A5,30854,20,21,1,109.56889,18.27076,1763
279343,DB14C9E7FB70D7116D1FEE61561A3142,60631,15,17,2,109.57778,18.27583,1814
279344,DB14C9E7FB70D7116D1FEE61561A3142,30854,19,20,1,109.56889,18.27076,1763
279345,DB14C9E7FB70D7116D1FEE61561A3142,60354,20,21,1,109.58701,18.28521,1815
279379,84DF4A7C208235D171EF56473BCCF210,31561,3,7,4,109.56792,18.28479,1765
279380,84DF4A7C208235D171EF56473BCCF210,60631,7,9,2,109.57778,18.27583,1814
279381,84DF4A7C208235D171EF56473BCCF210,30854,9,11,2,109.56889,18.27076,1763
279382,84DF4A7C208235D171EF56473BCCF210,60631,12,18,6,109.57778,18.27583,1814
279383,84DF4A7C208235D171EF56473BCCF210,30851,19,20,1,109.5616,18.27396,1713
279384,84DF4A7C208235D171EF56473BCCF210,31561,20,21,1,109.56792,18.28479,1765
279392,3B7F4B71C655A8575FEAE798DEE249A5,39111,0,9,9,109.5191,18.22597,1555
279395,4DBE6D3EE4B80975CED7345951A18A8D,30854,11,15,4,109.56889,18.27076,1763
279396,4DBE6D3EE4B80975CED7345951A18A8D,31071,15,17,2,109.58257,18.28458,1815
279397,4DBE6D3EE4B80975CED7345951A18A8D,30854,17,19,2,109.56889,18.27076,1763
279414,E4D199FCE009427481C9D06B9609AB1E,31931,0,8,8,109.54771,18.29403,1667
279415,E4D199FCE009427481C9D06B9609AB1E,38071,11,12,1,109.40722,18.30938,1169
279497,F6B0C4B9BFBC5C0F5D704098C64B8B01,30711,8,11,3,109.50271,18.25347,1510
279499,15C58AA4098F7C3C06247EBC0EBAF235,39321,0,5,5,109.529,18.2167,1604
279500,15C58AA4098F7C3C06247EBC0EBAF235,31521,6,8,2,109.51458,18.22542,1555
279501,15C58AA4098F7C3C06247EBC0EBAF235,33521,11,12,1,109.66313,18.45174,2143
279502,15C58AA4098F7C3C06247EBC0EBAF235,33051,13,16,3,109.6475,18.46618,2096
279503,15C58AA4098F7C3C06247EBC0EBAF235,60381,21,23,2,109.5241,18.22458,1605
279511,567BF1868FBA42FA9B3B29F2CA13F65D,30921,17,18,1,109.53903,18.29451,1667
279512,567BF1868FBA42FA9B3B29F2CA13F65D,31071,18,20,2,109.58257,18.28458,1815
279524,C686C13CC75583538BBABD5B7A2CA987,39371,10,11,1,109.56627,18.2646,1762
279525,C686C13CC75583538BBABD5B7A2CA987,31071,11,23,12,109.58257,18.28458,1815
279537,FCE452D1ADC1B5F3882EFE5D0EEFA0EE,31181,11,13,2,109.50382,18.24813,1509
279538,FCE452D1ADC1B5F3882EFE5D0EEFA0EE,31145,15,17,2,109.20431,18.30479,369
279539,FCE452D1ADC1B5F3882EFE5D0EEFA0EE,31421,19,20,1,109.55382,18.22347,1705
279545,934029FB5F97BCE114EDCE88F0393A63,39371,0,6,6,109.56627,18.2646,1762
279546,934029FB5F97BCE114EDCE88F0393A63,30854,7,10,3,109.56889,18.27076,1763
279556,335A7B1DE8538918FDA774EE3E402A76,30191,0,7,7,109.50361,18.22701,1506
279557,335A7B1DE8538918FDA774EE3E402A76,60381,8,10,2,109.5241,18.22458,1605
279558,335A7B1DE8538918FDA774EE3E402A76,33481,12,14,2,109.67278,18.41278,2187
279559,335A7B1DE8538918FDA774EE3E402A76,33521,15,17,2,109.66313,18.45174,2143
279560,335A7B1DE8538918FDA774EE3E402A76,30191,19,23,4,109.50361,18.22701,1506
279565,54132720A6D7917CD1D26C61724AD075,30581,0,4,4,109.62257,18.24951,1959
279566,54132720A6D7917CD1D26C61724AD075,31571,5,8,3,109.61563,18.23326,1957
279567,54132720A6D7917CD1D26C61724AD075,30441,12,13,1,109.64021,18.25424,2010
279582,32CEFCA8095A5A58595694856C75C07A,30721,0,1,1,109.51597,18.28257,1565
279583,32CEFCA8095A5A58595694856C75C07A,30121,1,7,6,109.52861,18.27222,1613
279584,32CEFCA8095A5A58595694856C75C07A,39183,10,11,1,109.55542,18.28208,1715
279608,AA17C9279A63248D7DCDF49F93EB8817,31071,1,6,5,109.58257,18.28458,1815
279609,AA17C9279A63248D7DCDF49F93EB8817,38275,8,17,9,109.62875,18.22938,2006
279636,A10AD66CE81CDFBC974C36FAC5FE4CAA,31071,1,7,6,109.58257,18.28458,1815
279637,A10AD66CE81CDFBC974C36FAC5FE4CAA,31931,9,11,2,109.54771,18.29403,1667
279638,A10AD66CE81CDFBC974C36FAC5FE4CAA,31071,13,16,3,109.58257,18.28458,1815
279644,B93185B4820D7E0DEE74EBEA00941D15,38291,0,1,1,109.51618,18.24313,1558
279645,B93185B4820D7E0DEE74EBEA00941D15,60201,3,4,1,109.5041,18.2509,1510
279646,B93185B4820D7E0DEE74EBEA00941D15,30911,4,14,10,109.50493,18.26181,1511
279647,B93185B4820D7E0DEE74EBEA00941D15,60201,15,18,3,109.5041,18.2509,1510
279648,B93185B4820D7E0DEE74EBEA00941D15,38291,20,23,3,109.51618,18.24313,1558
279680,53490AD77ACCA93C3ED0F3DE79CA488B,31071,8,16,8,109.58257,18.28458,1815
279681,53490AD77ACCA93C3ED0F3DE79CA488B,30854,20,21,1,109.56889,18.27076,1763
279688,6E2021B014C4D0B652A2E4FE8D2CF038,30854,0,1,1,109.56889,18.27076,1763
279689,6E2021B014C4D0B652A2E4FE8D2CF038,31071,1,7,6,109.58257,18.28458,1815
279690,6E2021B014C4D0B652A2E4FE8D2CF038,30854,9,10,1,109.56889,18.27076,1763
279691,6E2021B014C4D0B652A2E4FE8D2CF038,31071,12,14,2,109.58257,18.28458,1815
279692,6E2021B014C4D0B652A2E4FE8D2CF038,30854,17,19,2,109.56889,18.27076,1763
279693,C173E680DFAEC165B5B7AE7346539D93,31391,16,17,1,109.50382,18.24285,1508
279694,C173E680DFAEC165B5B7AE7346539D93,38891,18,23,5,109.51486,18.24118,1558
279721,121138E269BBF0B506FA8CE6CEB3BF52,31931,0,12,12,109.54771,18.29403,1667
279722,121138E269BBF0B506FA8CE6CEB3BF52,39181,12,13,1,109.55153,18.28035,1715
279723,121138E269BBF0B506FA8CE6CEB3BF52,31931,18,23,5,109.54771,18.29403,1667
279726,CD77A45360FB53F816FCE62F008EEE28,30071,2,8,6,109.52819,18.30472,1619
279727,CD77A45360FB53F816FCE62F008EEE28,31931,8,21,13,109.54771,18.29403,1667
279728,CD77A45360FB53F816FCE62F008EEE28,30071,21,22,1,109.52819,18.30472,1619
279731,9C1407835BC54BEBDB541F52E1DA1820,61011,1,3,2,109.60653,18.19076,1900
279733,9C1407835BC54BEBDB541F52E1DA1820,61011,12,15,3,109.60653,18.19076,1900
279735,9C1407835BC54BEBDB541F52E1DA1820,61011,20,23,3,109.60653,18.19076,1900
279763,116A680F1141CB1D640294F052372134,60671,0,6,6,109.52979,18.31757,1621
279764,116A680F1141CB1D640294F052372134,38241,7,11,4,109.54111,18.30542,1669
279765,116A680F1141CB1D640294F052372134,38484,12,14,2,109.53028,18.31528,1620
279809,7B9D64657CE26DF907B4C2AC87C9F431,38241,8,9,1,109.54111,18.30542,1669
279810,7B9D64657CE26DF907B4C2AC87C9F431,60371,10,11,1,109.53063,18.30056,1618
279811,7B9D64657CE26DF907B4C2AC87C9F431,38241,14,16,2,109.54111,18.30542,1669
279853,C82725A09C032EE9BFF2088FCCC60D1D,30854,6,8,2,109.56889,18.27076,1763
279854,C82725A09C032EE9BFF2088FCCC60D1D,31521,8,9,1,109.51458,18.22542,1555
279855,C82725A09C032EE9BFF2088FCCC60D1D,30854,11,14,3,109.56889,18.27076,1763
279868,DBB710D279E76C79F1E4B0766F579F8A,30854,9,10,1,109.56889,18.27076,1763
279869,DBB710D279E76C79F1E4B0766F579F8A,31071,13,23,10,109.58257,18.28458,1815
279872,B80D4B4CDBD08237A9C4254F8883AEF4,39151,0,7,7,109.49875,18.25097,1510
279873,B80D4B4CDBD08237A9C4254F8883AEF4,31181,7,11,4,109.50382,18.24813,1509
279874,B80D4B4CDBD08237A9C4254F8883AEF4,30711,12,14,2,109.50271,18.25347,1510
279875,B80D4B4CDBD08237A9C4254F8883AEF4,60201,15,16,1,109.5041,18.2509,1510
279876,B80D4B4CDBD08237A9C4254F8883AEF4,39091,18,23,5,109.50097,18.25222,1510
279877,38AA3DA5E97F70E8689E8DE10EE9EB59,30854,7,12,5,109.56889,18.27076,1763
279878,38AA3DA5E97F70E8689E8DE10EE9EB59,31945,14,17,3,109.58021,18.29403,1817
279879,38AA3DA5E97F70E8689E8DE10EE9EB59,30854,20,23,3,109.56889,18.27076,1763
279911,D95857AB08B8205E4E31CF5D3302E306,30271,3,7,4,109.49132,18.23153,1456
279912,D95857AB08B8205E4E31CF5D3302E306,60084,8,9,1,109.4984,18.2334,1507
279913,D95857AB08B8205E4E31CF5D3302E306,38251,10,12,2,109.49618,18.25493,1510
279914,D95857AB08B8205E4E31CF5D3302E306,60071,15,19,4,109.75674,18.31583,2470
279918,73EAC1341C5005A58B26B1A52457F38B,31181,0,15,15,109.50382,18.24813,1509
279919,73EAC1341C5005A58B26B1A52457F38B,30361,19,21,2,109.50347,18.24,1508
279920,73EAC1341C5005A58B26B1A52457F38B,30854,21,22,1,109.56889,18.27076,1763
279939,78DA7A4E680FDAB27461B8DE1108145A,30854,0,21,21,109.56889,18.27076,1763
279940,78DA7A4E680FDAB27461B8DE1108145A,31071,21,23,2,109.58257,18.28458,1815
279948,99CBAA6A65A50998F0A10B72B36210E4,60231,7,9,2,109.49903,18.21972,1504
279949,99CBAA6A65A50998F0A10B72B36210E4,30341,10,11,1,109.3625,18.29167,966
279950,99CBAA6A65A50998F0A10B72B36210E4,60041,14,17,3,109.39889,18.31944,1121
279951,99CBAA6A65A50998F0A10B72B36210E4,60201,18,22,4,109.5041,18.2509,1510
279967,0BABF9C6516F437130A3DD3C99553A57,30191,0,1,1,109.50361,18.22701,1506
279968,0BABF9C6516F437130A3DD3C99553A57,39191,3,6,3,109.51493,18.23472,1557
279969,0BABF9C6516F437130A3DD3C99553A57,31851,7,11,4,109.71736,18.29007,2316
279970,0BABF9C6516F437130A3DD3C99553A57,30191,15,17,2,109.50361,18.22701,1506
279971,0BABF9C6516F437130A3DD3C99553A57,31206,19,20,1,109.50819,18.23549,1507
279972,0BABF9C6516F437130A3DD3C99553A57,30191,21,22,1,109.50361,18.22701,1506
279979,6D59153C60FD30D1B86A6E3DE6A2B731,30211,2,6,4,109.49882,18.23931,1508
279980,6D59153C60FD30D1B86A6E3DE6A2B731,60087,8,9,1,109.50688,18.22299,1505
279981,6D59153C60FD30D1B86A6E3DE6A2B731,31561,13,14,1,109.56792,18.28479,1765
279982,7EBC20D0E5F0FBA046CA1D08E7FF47C1,31071,0,6,6,109.58257,18.28458,1815
279983,7EBC20D0E5F0FBA046CA1D08E7FF47C1,30854,6,9,3,109.56889,18.27076,1763
279984,7EBC20D0E5F0FBA046CA1D08E7FF47C1,31071,12,14,2,109.58257,18.28458,1815
279985,7EBC20D0E5F0FBA046CA1D08E7FF47C1,30581,16,17,1,109.62257,18.24951,1959
279986,7EBC20D0E5F0FBA046CA1D08E7FF47C1,30854,19,21,2,109.56889,18.27076,1763
280018,37D38EF0062E64D55C94EB554B76F9EE,31071,0,8,8,109.58257,18.28458,1815
280019,37D38EF0062E64D55C94EB554B76F9EE,30854,8,23,15,109.56889,18.27076,1763
280028,8278E6B2BC83F1CA1F3DD55E2DC0100F,31071,0,11,11,109.58257,18.28458,1815
280029,8278E6B2BC83F1CA1F3DD55E2DC0100F,31931,13,16,3,109.54771,18.29403,1667
280030,8278E6B2BC83F1CA1F3DD55E2DC0100F,60371,16,17,1,109.53063,18.30056,1618
280166,11B810B77549CA863BF41D81AAB3E82B,60401,0,8,8,109.47444,18.27583,1414
280188,A8E9C7BB918ADAD29A3EA7ACDDCD32D7,38951,0,2,2,109.48097,18.28868,1416
280189,A8E9C7BB918ADAD29A3EA7ACDDCD32D7,38951,3,18,15,109.48097,18.28868,1416
280190,A8E9C7BB918ADAD29A3EA7ACDDCD32D7,30861,19,20,1,109.52722,18.22743,1606
280198,B94CAA0ECFBC84DF79E5B155C990F760,31271,0,9,9,109.48958,18.26257,1462
280199,B94CAA0ECFBC84DF79E5B155C990F760,31471,13,15,2,109.34583,18.29563,917
280200,B94CAA0ECFBC84DF79E5B155C990F760,31303,17,23,6,109.15826,18.29549,217
280224,E30A5D65C08FB9F85452AA0B30BB2A1B,31021,19,20,1,109.49021,18.27,1463
280230,1980C8D409DE9551539224B3D393CDAA,38991,1,5,4,109.52681,18.30368,1618
280231,1980C8D409DE9551539224B3D393CDAA,30071,5,22,17,109.52819,18.30472,1619
280275,BEE3A0C9BB09D7F210E3490BED90A1BE,30071,0,4,4,109.52819,18.30472,1619
280276,BEE3A0C9BB09D7F210E3490BED90A1BE,30071,6,8,2,109.52819,18.30472,1619
280277,BEE3A0C9BB09D7F210E3490BED90A1BE,30071,9,11,2,109.52819,18.30472,1619
280278,BEE3A0C9BB09D7F210E3490BED90A1BE,30071,14,18,4,109.52819,18.30472,1619
280279,BEE3A0C9BB09D7F210E3490BED90A1BE,60371,19,23,4,109.53063,18.30056,1618
280280,D9AE11CD16B231308C3F0FB3F53BC3E9,30854,0,8,8,109.56889,18.27076,1763
280281,D9AE11CD16B231308C3F0FB3F53BC3E9,31071,9,17,8,109.58257,18.28458,1815
280332,D61883A9E0C7F2103C981F95E51C66DA,31931,0,6,6,109.54771,18.29403,1667
280333,D61883A9E0C7F2103C981F95E51C66DA,60361,10,11,1,109.51938,18.29681,1567
280334,D61883A9E0C7F2103C981F95E51C66DA,39111,15,16,1,109.5191,18.22597,1555
280373,F71722F47AD55D7027753836DB5E58AA,38361,0,10,10,109.43667,18.29201,1267
280374,F71722F47AD55D7027753836DB5E58AA,31471,13,15,2,109.34583,18.29563,917
280375,F71722F47AD55D7027753836DB5E58AA,60054,16,17,1,109.3016,18.31229,770
280376,F71722F47AD55D7027753836DB5E58AA,38541,18,23,5,109.73715,18.34875,2426
280411,6ADBEFDC21CA46F051933BF984A8E255,31071,0,9,9,109.58257,18.28458,1815
280412,6ADBEFDC21CA46F051933BF984A8E255,30854,11,12,1,109.56889,18.27076,1763
280413,6ADBEFDC21CA46F051933BF984A8E255,31071,15,17,2,109.58257,18.28458,1815
280414,6ADBEFDC21CA46F051933BF984A8E255,30854,20,21,1,109.56889,18.27076,1763
280474,DC9973204E62AA99FA79F0696CF6C0F6,30854,0,2,2,109.56889,18.27076,1763
280475,DC9973204E62AA99FA79F0696CF6C0F6,31945,5,13,8,109.58021,18.29403,1817
280478,C983E73D646629A775690ECA8920EB29,30101,0,12,12,109.57299,18.33333,1773
280479,C983E73D646629A775690ECA8920EB29,31631,16,17,1,109.59542,18.36826,1879
280492,6ABF30CD5F14455AA21662324DAC8186,30854,12,14,2,109.56889,18.27076,1763
280493,6ABF30CD5F14455AA21662324DAC8186,31561,14,20,6,109.56792,18.28479,1765
280524,3EAE2CCEF780CC2E20C47963EA2CF3C6,30854,4,11,7,109.56889,18.27076,1763
280525,3EAE2CCEF780CC2E20C47963EA2CF3C6,31561,13,23,10,109.56792,18.28479,1765
280538,8FE97C1052D63DE830211C405D8F5442,39371,0,6,6,109.56627,18.2646,1762
280539,8FE97C1052D63DE830211C405D8F5442,31811,9,10,1,109.54201,18.31806,1671
280540,8FE97C1052D63DE830211C405D8F5442,30854,13,18,5,109.56889,18.27076,1763
280541,8FE97C1052D63DE830211C405D8F5442,39371,21,23,2,109.56627,18.2646,1762
280585,862ABFF94AA90A202FB7D5A132150A1A,31071,0,7,7,109.58257,18.28458,1815
280586,862ABFF94AA90A202FB7D5A132150A1A,30854,8,19,11,109.56889,18.27076,1763
280591,1412BA3B65BC1A2354CCBE297098A0E1,31071,0,10,10,109.58257,18.28458,1815
280592,1412BA3B65BC1A2354CCBE297098A0E1,31071,14,15,1,109.58257,18.28458,1815
280593,1412BA3B65BC1A2354CCBE297098A0E1,31071,18,20,2,109.58257,18.28458,1815
280616,9AA959ED87D1ECC3053DED17290EFCBD,30854,8,9,1,109.56889,18.27076,1763
280617,9AA959ED87D1ECC3053DED17290EFCBD,31561,10,21,11,109.56792,18.28479,1765
280622,FA724E83D7D22E41E07D0D2550D22166,30854,17,19,2,109.56889,18.27076,1763
280623,FA724E83D7D22E41E07D0D2550D22166,31071,19,23,4,109.58257,18.28458,1815
280648,D96E01B8E0F0DE9C160C9FEAFDCFDB6D,31071,0,7,7,109.58257,18.28458,1815
280649,D96E01B8E0F0DE9C160C9FEAFDCFDB6D,30854,11,19,8,109.56889,18.27076,1763
280660,CAC8A9D21C7176251B3072CE71D74BA9,30271,0,5,5,109.49132,18.23153,1456
280661,CAC8A9D21C7176251B3072CE71D74BA9,60131,7,8,1,109.49819,18.24778,1509
280662,CAC8A9D21C7176251B3072CE71D74BA9,60431,12,13,1,109.46139,18.32861,1373
280673,C6FE4CF0CD47303AD7F7EC5A71315B10,30854,2,5,3,109.56889,18.27076,1763
280674,C6FE4CF0CD47303AD7F7EC5A71315B10,30851,7,8,1,109.5616,18.27396,1713
280675,C6FE4CF0CD47303AD7F7EC5A71315B10,30854,9,10,1,109.56889,18.27076,1763
280676,9810DB6C60BA19785429412C731D49C0,30854,0,19,19,109.56889,18.27076,1763
280677,9810DB6C60BA19785429412C731D49C0,31071,21,22,1,109.58257,18.28458,1815
280678,7084657DF30063A945AAA5EF4742695F,39183,0,6,6,109.55542,18.28208,1715
280679,7084657DF30063A945AAA5EF4742695F,31931,7,8,1,109.54771,18.29403,1667
280680,7084657DF30063A945AAA5EF4742695F,39183,12,19,7,109.55542,18.28208,1715
280681,7084657DF30063A945AAA5EF4742695F,31931,20,22,2,109.54771,18.29403,1667
280755,40285EE8CCE25C38988EC087545664EC,31071,0,7,7,109.58257,18.28458,1815
280756,40285EE8CCE25C38988EC087545664EC,30854,7,9,2,109.56889,18.27076,1763
280757,40285EE8CCE25C38988EC087545664EC,31071,9,10,1,109.58257,18.28458,1815
280758,40285EE8CCE25C38988EC087545664EC,30854,10,15,5,109.56889,18.27076,1763
280759,40285EE8CCE25C38988EC087545664EC,31071,15,16,1,109.58257,18.28458,1815
280760,40285EE8CCE25C38988EC087545664EC,30854,18,21,3,109.56889,18.27076,1763
280794,249377E34AC170BF7177181444C7805B,60341,0,8,8,109.70597,18.31778,2271
280795,249377E34AC170BF7177181444C7805B,60054,9,12,3,109.3016,18.31229,770
280796,249377E34AC170BF7177181444C7805B,30901,12,13,1,109.27597,18.3134,670
280852,7D1ED6067ECBD941EFC43CE0A6ADAE71,30854,0,11,11,109.56889,18.27076,1763
280853,7D1ED6067ECBD941EFC43CE0A6ADAE71,31071,12,21,9,109.58257,18.28458,1815
280854,7D1ED6067ECBD941EFC43CE0A6ADAE71,30854,21,23,2,109.56889,18.27076,1763
280855,84599FEEE94509A3E8D44F4C45C7CC01,31671,0,15,15,109.38965,18.29813,1068
280856,84599FEEE94509A3E8D44F4C45C7CC01,60541,20,22,2,109.4084,18.29208,1167
280885,124E60C0315346A1F7A9CD897F13605E,31521,17,18,1,109.51458,18.22542,1555
280886,124E60C0315346A1F7A9CD897F13605E,31521,21,23,2,109.51458,18.22542,1555
280893,64C0BD6213CCF662EB0E37CD02355D5C,31251,0,4,4,109.18528,18.2975,317
280895,64C0BD6213CCF662EB0E37CD02355D5C,31251,11,12,1,109.18528,18.2975,317
280897,64C0BD6213CCF662EB0E37CD02355D5C,31251,17,23,6,109.18528,18.2975,317
280898,2B60907F04C29DE058B3E64B1D3B4100,31561,0,9,9,109.56792,18.28479,1765
280899,2B60907F04C29DE058B3E64B1D3B4100,39371,13,15,2,109.56627,18.2646,1762
280900,2B60907F04C29DE058B3E64B1D3B4100,38283,17,18,1,109.62229,18.22618,1956
280901,2B60907F04C29DE058B3E64B1D3B4100,31561,19,20,1,109.56792,18.28479,1765
280902,2B60907F04C29DE058B3E64B1D3B4100,30854,20,23,3,109.56889,18.27076,1763
280924,51DF765CB634D9549D20AD1F2C37BA18,31561,1,14,13,109.56792,18.28479,1765
280925,51DF765CB634D9549D20AD1F2C37BA18,30854,18,19,1,109.56889,18.27076,1763
280950,033CEEC20746801745CF4A53CD517C31,31181,0,8,8,109.50382,18.24813,1509
280951,033CEEC20746801745CF4A53CD517C31,31181,10,11,1,109.50382,18.24813,1509
280952,033CEEC20746801745CF4A53CD517C31,30251,16,18,2,109.50611,18.26653,1512
280953,033CEEC20746801745CF4A53CD517C31,60291,20,22,2,109.50826,18.24639,1509
281007,E9E473F09C342630187345312F4A31D8,39181,0,15,15,109.55153,18.28035,1715
281008,E9E473F09C342630187345312F4A31D8,31931,15,17,2,109.54771,18.29403,1667
281009,E9E473F09C342630187345312F4A31D8,39181,17,23,6,109.55153,18.28035,1715
281010,31C925B9876FE9FFC3F673B5040150FB,31521,0,8,8,109.51458,18.22542,1555
281011,31C925B9876FE9FFC3F673B5040150FB,31471,13,14,1,109.34583,18.29563,917
281012,31C925B9876FE9FFC3F673B5040150FB,31521,16,22,6,109.51458,18.22542,1555
281022,F18D277C130EC23D01064797EE5A0B58,30051,0,10,10,109.48917,18.21215,1453
281023,F18D277C130EC23D01064797EE5A0B58,31031,11,13,2,109.49979,18.25382,1510
281024,F18D277C130EC23D01064797EE5A0B58,30271,18,19,1,109.49132,18.23153,1456
281025,F18D277C130EC23D01064797EE5A0B58,30051,19,23,4,109.48917,18.21215,1453
281028,08A066736557478B1013C0CF834491DF,30921,0,11,11,109.53903,18.29451,1667
281029,08A066736557478B1013C0CF834491DF,31931,13,15,2,109.54771,18.29403,1667
281030,08A066736557478B1013C0CF834491DF,30921,17,20,3,109.53903,18.29451,1667
281052,79FD298D94ED606250C160861575CD8F,31554,7,15,8,109.55521,18.2459,1709
281053,79FD298D94ED606250C160861575CD8F,31551,18,19,1,109.55868,18.24222,1708
281068,52D077B19C6C1BD347E6DC20309A3DC3,31071,2,4,2,109.58257,18.28458,1815
281069,52D077B19C6C1BD347E6DC20309A3DC3,30681,8,10,2,109.48493,18.26917,1463
281070,52D077B19C6C1BD347E6DC20309A3DC3,30854,11,14,3,109.56889,18.27076,1763
281071,52D077B19C6C1BD347E6DC20309A3DC3,31071,14,22,8,109.58257,18.28458,1815
281090,E75CF54BA14775FEDD26504F9F6B7365,31945,0,5,5,109.58021,18.29403,1817
281091,E75CF54BA14775FEDD26504F9F6B7365,31561,6,14,8,109.56792,18.28479,1765
281092,00FC332040A284DA251A8D0705989FE9,31071,0,7,7,109.58257,18.28458,1815
281093,00FC332040A284DA251A8D0705989FE9,30854,10,15,5,109.56889,18.27076,1763
281094,00FC332040A284DA251A8D0705989FE9,31071,15,17,2,109.58257,18.28458,1815
281095,00FC332040A284DA251A8D0705989FE9,30854,21,23,2,109.56889,18.27076,1763
281096,96C474E5BFF92BC21432A4ADDD7A543D,30854,0,18,18,109.56889,18.27076,1763
281097,96C474E5BFF92BC21432A4ADDD7A543D,31071,19,20,1,109.58257,18.28458,1815
281098,96C474E5BFF92BC21432A4ADDD7A543D,30854,20,23,3,109.56889,18.27076,1763
281128,606A622509E00F87640F50B01432E04D,31521,9,10,1,109.51458,18.22542,1555
281129,606A622509E00F87640F50B01432E04D,30361,13,14,1,109.50347,18.24,1508
281130,606A622509E00F87640F50B01432E04D,31521,15,16,1,109.51458,18.22542,1555
281131,606A622509E00F87640F50B01432E04D,60381,17,18,1,109.5241,18.22458,1605
281132,606A622509E00F87640F50B01432E04D,31521,18,20,2,109.51458,18.22542,1555
281162,D46DE9169E4BACF1D272EA5E0FDEF68F,31561,2,13,11,109.56792,18.28479,1765
281163,D46DE9169E4BACF1D272EA5E0FDEF68F,30851,15,16,1,109.5616,18.27396,1713
281164,D46DE9169E4BACF1D272EA5E0FDEF68F,31561,18,23,5,109.56792,18.28479,1765
281206,2AE38FAF341950B0B91404FFCE5A0F3E,30921,11,17,6,109.53903,18.29451,1667
281207,2AE38FAF341950B0B91404FFCE5A0F3E,31931,21,23,2,109.54771,18.29403,1667
281218,39F25FE146A03325C93C111F2A943B6C,31945,2,7,5,109.58021,18.29403,1817
281219,39F25FE146A03325C93C111F2A943B6C,30854,11,19,8,109.56889,18.27076,1763
281241,D8917A2A43EA8070EEC2FA46A7C72FE1,31491,12,13,1,109.73042,18.38771,2382
281242,D8917A2A43EA8070EEC2FA46A7C72FE1,30711,15,18,3,109.50271,18.25347,1510
281243,D8917A2A43EA8070EEC2FA46A7C72FE1,30504,20,23,3,109.705,18.35368,2277
281292,4E5E7B62F697D24D87C90994BD547EC8,38271,0,1,1,109.62632,18.23049,1956
281293,4E5E7B62F697D24D87C90994BD547EC8,30281,2,9,7,109.50597,18.27583,1514
281294,4E5E7B62F697D24D87C90994BD547EC8,38171,9,14,5,109.50799,18.28139,1515
281295,4E5E7B62F697D24D87C90994BD547EC8,31321,15,18,3,109.63799,18.23201,2007
281296,4E5E7B62F697D24D87C90994BD547EC8,60114,19,21,2,109.73028,18.33847,2374
281300,CFA6DB42B4EA79576A8AEA8F93765E81,38157,15,17,2,109.51483,18.26958,1563
281301,CFA6DB42B4EA79576A8AEA8F93765E81,60087,21,23,2,109.50688,18.22299,1505
281302,DFFF17B7FE30E79B8AABBB5CE171272F,39183,1,3,2,109.55542,18.28208,1715
281303,DFFF17B7FE30E79B8AABBB5CE171272F,31561,7,16,9,109.56792,18.28479,1765
281304,DFFF17B7FE30E79B8AABBB5CE171272F,39183,17,19,2,109.55542,18.28208,1715
281305,DFFF17B7FE30E79B8AABBB5CE171272F,39091,19,21,2,109.50097,18.25222,1510
281308,0874ECC8591FCEC6749163A25CC3B800,60411,2,5,3,109.32514,18.30854,869
281309,0874ECC8591FCEC6749163A25CC3B800,31471,5,7,2,109.34583,18.29563,917
281310,0874ECC8591FCEC6749163A25CC3B800,60411,7,9,2,109.32514,18.30854,869
281311,0874ECC8591FCEC6749163A25CC3B800,31421,12,13,1,109.55382,18.22347,1705
281317,6C243B11A8093A8CA55CA33CE09BE6E2,39371,0,5,5,109.56627,18.2646,1762
281318,6C243B11A8093A8CA55CA33CE09BE6E2,30854,6,14,8,109.56889,18.27076,1763
281319,6C243B11A8093A8CA55CA33CE09BE6E2,39371,19,23,4,109.56627,18.2646,1762
281332,11B1BD8CD0E682165FFA7E6380846252,60411,0,2,2,109.32514,18.30854,869
281333,11B1BD8CD0E682165FFA7E6380846252,31471,6,10,4,109.34583,18.29563,917
281334,11B1BD8CD0E682165FFA7E6380846252,31471,13,14,1,109.34583,18.29563,917
281335,11B1BD8CD0E682165FFA7E6380846252,31471,16,17,1,109.34583,18.29563,917
281340,B8B175F9D4B3A6BE919C03568EC254A7,31723,0,6,6,109.68563,18.23701,2207
281341,B8B175F9D4B3A6BE919C03568EC254A7,30851,8,10,2,109.5616,18.27396,1713
281342,B8B175F9D4B3A6BE919C03568EC254A7,31723,11,22,11,109.68563,18.23701,2207
281354,BA78AAC2FD072EDBC38E967C688E8581,60411,19,21,2,109.32514,18.30854,869
281355,BA78AAC2FD072EDBC38E967C688E8581,30661,22,23,1,109.37028,18.24361,1008
281356,DA2F61DF800F83BE374E7E95B728C1BC,30351,15,16,1,109.41701,18.29292,1217
281357,DA2F61DF800F83BE374E7E95B728C1BC,38094,17,18,1,109.45403,18.28778,1316
281358,DA2F61DF800F83BE374E7E95B728C1BC,30711,18,20,2,109.50271,18.25347,1510
281359,DA2F61DF800F83BE374E7E95B728C1BC,38094,21,23,2,109.45403,18.28778,1316
281426,B61EF3A2FA8CFF664D5D7045557B11B7,31701,15,16,1,109.44132,18.28833,1266
281427,B61EF3A2FA8CFF664D5D7045557B11B7,30671,17,18,1,109.43611,18.30139,1268
281428,B61EF3A2FA8CFF664D5D7045557B11B7,31701,22,23,1,109.44132,18.28833,1266
281489,67CDBD95CEB6CBFC8E0EE012353E074B,30854,9,15,6,109.56889,18.27076,1763
281490,67CDBD95CEB6CBFC8E0EE012353E074B,30851,16,17,1,109.5616,18.27396,1713
281491,67CDBD95CEB6CBFC8E0EE012353E074B,31071,19,21,2,109.58257,18.28458,1815
281492,C6579823835B85A254880E72927E82BB,30891,0,6,6,109.59431,18.28389,1865
281493,C6579823835B85A254880E72927E82BB,30854,8,10,2,109.56889,18.27076,1763
281494,C6579823835B85A254880E72927E82BB,39371,11,13,2,109.56627,18.2646,1762
281503,1D60D001EBDC67D77E1C6037DB507422,31561,0,8,8,109.56792,18.28479,1765
281504,1D60D001EBDC67D77E1C6037DB507422,30854,8,22,14,109.56889,18.27076,1763
281521,2C7DB696A14A5E061C2912E5376233C9,31071,12,16,4,109.58257,18.28458,1815
281522,2C7DB696A14A5E061C2912E5376233C9,31071,16,19,3,109.58257,18.28458,1815
281527,A5E7142EDB2C00D2F56F81D099876FCF,31851,7,8,1,109.71736,18.29007,2316
281528,A5E7142EDB2C00D2F56F81D099876FCF,38754,12,13,1,109.74667,18.37382,2430
281584,08F184A038B7B2BA9AC1C33CF8004A7B,39183,0,13,13,109.55542,18.28208,1715
281585,08F184A038B7B2BA9AC1C33CF8004A7B,31561,16,17,1,109.56792,18.28479,1765
281586,08F184A038B7B2BA9AC1C33CF8004A7B,39183,19,23,4,109.55542,18.28208,1715
281625,7F220C28A0C617E581A7723B6384F4CD,38275,13,14,1,109.62875,18.22938,2006
281626,7F220C28A0C617E581A7723B6384F4CD,31101,18,23,5,109.65389,18.23403,2057
281764,1D8B814EC83D52D7C5F3FED99C129EE0,30854,2,5,3,109.56889,18.27076,1763
281765,1D8B814EC83D52D7C5F3FED99C129EE0,38271,7,8,1,109.62632,18.23049,1956
281766,1D8B814EC83D52D7C5F3FED99C129EE0,30661,10,14,4,109.37028,18.24361,1008
281767,1D8B814EC83D52D7C5F3FED99C129EE0,38271,18,21,3,109.62632,18.23049,1956
281794,50569AD2BBECFEBD2DC5B08708122D64,30051,1,2,1,109.48917,18.21215,1453
281795,50569AD2BBECFEBD2DC5B08708122D64,38361,3,6,3,109.43667,18.29201,1267
281796,50569AD2BBECFEBD2DC5B08708122D64,30111,7,8,1,109.47583,18.30542,1419
281797,50569AD2BBECFEBD2DC5B08708122D64,38361,9,13,4,109.43667,18.29201,1267
281798,50569AD2BBECFEBD2DC5B08708122D64,60054,17,18,1,109.3016,18.31229,770
281799,50569AD2BBECFEBD2DC5B08708122D64,31701,19,20,1,109.44132,18.28833,1266
281800,50569AD2BBECFEBD2DC5B08708122D64,38361,21,23,2,109.43667,18.29201,1267
281856,9904F3A575E4CB183711FA946C79D33B,30861,21,23,2,109.52722,18.22743,1606
281859,4BBF03B1E44EBA34E823E74DAE311295,31521,0,7,7,109.51458,18.22542,1555
281860,4BBF03B1E44EBA34E823E74DAE311295,31145,11,13,2,109.20431,18.30479,369
281861,4BBF03B1E44EBA34E823E74DAE311295,31471,15,17,2,109.34583,18.29563,917
281862,4BBF03B1E44EBA34E823E74DAE311295,31521,18,23,5,109.51458,18.22542,1555
281872,79CCA269D4D1544F735C077DABC1670F,31521,16,20,4,109.51458,18.22542,1555
281873,79CCA269D4D1544F735C077DABC1670F,30731,21,22,1,109.50944,18.22306,1555
281877,CD294E0B65E7686283441C2C69DAEEE1,60311,1,2,1,109.52097,18.24319,1558
281878,CD294E0B65E7686283441C2C69DAEEE1,38911,3,5,2,109.51674,18.24965,1559
281879,CD294E0B65E7686283441C2C69DAEEE1,31261,7,23,16,109.51174,18.2466,1559
281887,C4D501C387DD23DCF31DA55A1EE88121,31431,2,8,6,109.44639,18.29042,1316
281888,C4D501C387DD23DCF31DA55A1EE88121,38094,9,10,1,109.45403,18.28778,1316
281889,C4D501C387DD23DCF31DA55A1EE88121,60501,11,14,3,109.48701,18.29021,1466
281924,1CF6ABA1FBB2C53764058DE6E2005DB0,60631,0,1,1,109.57778,18.27583,1814
281925,1CF6ABA1FBB2C53764058DE6E2005DB0,30854,1,5,4,109.56889,18.27076,1763
281926,1CF6ABA1FBB2C53764058DE6E2005DB0,60631,5,7,2,109.57778,18.27583,1814
281927,1CF6ABA1FBB2C53764058DE6E2005DB0,30854,8,9,1,109.56889,18.27076,1763
281928,1CF6ABA1FBB2C53764058DE6E2005DB0,31471,12,14,2,109.34583,18.29563,917
281938,74A69A57C15238734EC4A759D6D8AD27,31261,0,7,7,109.51174,18.2466,1559
281939,74A69A57C15238734EC4A759D6D8AD27,31471,11,14,3,109.34583,18.29563,917
282005,850F414E89CB3AC3E862CBFA17778006,60121,13,15,2,109.74507,18.37472,2430
282006,850F414E89CB3AC3E862CBFA17778006,38271,19,22,3,109.62632,18.23049,1956
282027,65EB0CD383E33AFBA938FFEE6D8A6EDD,38251,13,15,2,109.49618,18.25493,1510
282028,65EB0CD383E33AFBA938FFEE6D8A6EDD,30201,17,19,2,109.4909,18.26465,1462
282029,65EB0CD383E33AFBA938FFEE6D8A6EDD,31681,20,22,2,109.40396,18.29979,1168
282032,AB43182259122294244C13D6FC66D4A1,30891,2,3,1,109.59431,18.28389,1865
282033,AB43182259122294244C13D6FC66D4A1,60631,3,6,3,109.57778,18.27583,1814
282034,AB43182259122294244C13D6FC66D4A1,31561,8,9,1,109.56792,18.28479,1765
282035,AB43182259122294244C13D6FC66D4A1,30851,15,16,1,109.5616,18.27396,1713
282036,AB43182259122294244C13D6FC66D4A1,60631,20,23,3,109.57778,18.27583,1814
282053,5BC86F424BAF4B877A98262DEDE87053,31041,2,13,11,109.50278,18.23701,1507
282073,F8D799D9161B0143E0D71C40472A357E,38991,0,7,7,109.52681,18.30368,1618
282074,F8D799D9161B0143E0D71C40472A357E,30071,8,12,4,109.52819,18.30472,1619
282075,F8D799D9161B0143E0D71C40472A357E,30071,13,15,2,109.52819,18.30472,1619
282076,F8D799D9161B0143E0D71C40472A357E,38484,15,17,2,109.53028,18.31528,1620
282077,F8D799D9161B0143E0D71C40472A357E,30071,17,21,4,109.52819,18.30472,1619
282078,F8D799D9161B0143E0D71C40472A357E,30071,21,23,2,109.52819,18.30472,1619
282086,8BDE8C6966F9C7122ABA59EA6C195945,60421,1,7,6,109.46333,18.31743,1371
282087,8BDE8C6966F9C7122ABA59EA6C195945,30741,8,9,1,109.49833,18.28681,1516
282088,8BDE8C6966F9C7122ABA59EA6C195945,31081,12,23,11,109.44639,18.30181,1318
282116,7BF65E5054DA81A230AB5423620158E1,60631,0,7,7,109.57778,18.27583,1814
282117,7BF65E5054DA81A230AB5423620158E1,30854,11,21,10,109.56889,18.27076,1763
282162,C58D0182BFC61ED113EE3B09763C30B2,38185,0,6,6,109.51333,18.27347,1563
282163,C58D0182BFC61ED113EE3B09763C30B2,38127,11,12,1,109.50833,18.27222,1513
282164,C58D0182BFC61ED113EE3B09763C30B2,38721,12,13,1,109.50368,18.27542,1514
282165,C58D0182BFC61ED113EE3B09763C30B2,39181,15,17,2,109.55153,18.28035,1715
282166,C58D0182BFC61ED113EE3B09763C30B2,38185,20,23,3,109.51333,18.27347,1563
282199,9352766CE000C006A9C46226806783DB,31951,0,1,1,109.52174,18.30299,1568
282200,9352766CE000C006A9C46226806783DB,30071,1,3,2,109.52819,18.30472,1619
282201,9352766CE000C006A9C46226806783DB,31951,3,4,1,109.52174,18.30299,1568
282202,9352766CE000C006A9C46226806783DB,30071,5,6,1,109.52819,18.30472,1619
282203,9352766CE000C006A9C46226806783DB,31561,10,16,6,109.56792,18.28479,1765
282310,6C0260646767B781577B5B8CE2471E51,38484,4,9,5,109.53028,18.31528,1620
282311,6C0260646767B781577B5B8CE2471E51,38484,12,17,5,109.53028,18.31528,1620
282312,6C0260646767B781577B5B8CE2471E51,30321,18,20,2,109.49563,18.29611,1467
282349,8F6EA1C108FADA76A214A7ED71ECE3D1,30232,1,2,1,109.6191,18.31701,1971
282350,8F6EA1C108FADA76A214A7ED71ECE3D1,30891,6,7,1,109.59431,18.28389,1865
282351,8F6EA1C108FADA76A214A7ED71ECE3D1,30854,8,21,13,109.56889,18.27076,1763
282364,4929D2853AC72A86C75CA19B6A840CCB,38132,17,18,1,109.64632,18.23417,2057
282365,4929D2853AC72A86C75CA19B6A840CCB,30271,20,23,3,109.49132,18.23153,1456
282366,C1C69C0EAD4ABEFD1467543102429D9B,31561,2,7,5,109.56792,18.28479,1765
282367,C1C69C0EAD4ABEFD1467543102429D9B,39183,8,21,13,109.55542,18.28208,1715
282368,63B5E489F3503F8EC6E40A38F9D2117C,31951,8,12,4,109.52174,18.30299,1568
282369,63B5E489F3503F8EC6E40A38F9D2117C,60171,13,23,10,109.51292,18.30694,1569
282427,65E65867D0469EB97C9CAA5984F87E13,60621,0,16,16,109.48354,18.27451,1464
282428,65E65867D0469EB97C9CAA5984F87E13,60121,18,21,3,109.74507,18.37472,2430
282429,EF7DCA5602FCDF14AF156D676A8ED902,30851,1,6,5,109.5616,18.27396,1713
282430,EF7DCA5602FCDF14AF156D676A8ED902,31561,11,21,10,109.56792,18.28479,1765
282447,852BB5540E2D1D044093F0A403D4011D,30581,15,16,1,109.62257,18.24951,1959
282448,852BB5540E2D1D044093F0A403D4011D,31321,19,20,1,109.63799,18.23201,2007
282449,852BB5540E2D1D044093F0A403D4011D,30581,22,23,1,109.62257,18.24951,1959
282495,162C9DF38B34BB5029840E39407B0BD5,31201,3,4,1,109.51042,18.23819,1558
282496,162C9DF38B34BB5029840E39407B0BD5,30181,5,7,2,109.51597,18.23313,1557
282497,162C9DF38B34BB5029840E39407B0BD5,31041,7,11,4,109.50278,18.23701,1507
282498,162C9DF38B34BB5029840E39407B0BD5,38094,14,15,1,109.45403,18.28778,1316
282499,162C9DF38B34BB5029840E39407B0BD5,31041,18,20,2,109.50278,18.23701,1507
282505,A4D782DD7C0CB1B25E56BFC209FED42C,30921,0,6,6,109.53903,18.29451,1667
282506,A4D782DD7C0CB1B25E56BFC209FED42C,31931,8,15,7,109.54771,18.29403,1667
282507,A4D782DD7C0CB1B25E56BFC209FED42C,30921,15,22,7,109.53903,18.29451,1667
282508,FE95B3A32EFBC2838F293DF38F55FDD1,39183,0,5,5,109.55542,18.28208,1715
282509,FE95B3A32EFBC2838F293DF38F55FDD1,30071,7,8,1,109.52819,18.30472,1619
282510,FE95B3A32EFBC2838F293DF38F55FDD1,31931,8,10,2,109.54771,18.29403,1667
282511,FE95B3A32EFBC2838F293DF38F55FDD1,39183,12,13,1,109.55542,18.28208,1715
282512,FE95B3A32EFBC2838F293DF38F55FDD1,31931,16,17,1,109.54771,18.29403,1667
282513,FE95B3A32EFBC2838F293DF38F55FDD1,30854,20,22,2,109.56889,18.27076,1763
282532,80510334A1C80EA4AE907E88FED9D4F9,30771,19,21,2,109.49938,18.26042,1511
282547,5A6C2C4A9B4DF43C379FCADC2CCFC5BC,30201,0,8,8,109.4909,18.26465,1462
282548,5A6C2C4A9B4DF43C379FCADC2CCFC5BC,38171,12,13,1,109.50799,18.28139,1515
282549,5A6C2C4A9B4DF43C379FCADC2CCFC5BC,38283,15,18,3,109.62229,18.22618,1956
282550,5A6C2C4A9B4DF43C379FCADC2CCFC5BC,30201,21,23,2,109.4909,18.26465,1462
282581,E8BAAF476E8FE57075BAB1A8D4FF1780,30232,1,4,3,109.6191,18.31701,1971
282582,E8BAAF476E8FE57075BAB1A8D4FF1780,39371,5,6,1,109.56627,18.2646,1762
282583,E8BAAF476E8FE57075BAB1A8D4FF1780,30181,11,12,1,109.51597,18.23313,1557
282584,E8BAAF476E8FE57075BAB1A8D4FF1780,39371,15,21,6,109.56627,18.2646,1762
282585,E8BAAF476E8FE57075BAB1A8D4FF1780,30232,21,23,2,109.6191,18.31701,1971
282621,64FF3E93355E6DCA29977E04D316EABA,30151,0,2,2,109.50986,18.25083,1560
282622,64FF3E93355E6DCA29977E04D316EABA,30151,4,14,10,109.50986,18.25083,1560
282623,64FF3E93355E6DCA29977E04D316EABA,38973,16,20,4,109.51097,18.25389,1560
282632,82FFBAA5929CD368E9B5AC0A4DEDBC26,30051,0,6,6,109.48917,18.21215,1453
282633,82FFBAA5929CD368E9B5AC0A4DEDBC26,31931,11,13,2,109.54771,18.29403,1667
282634,82FFBAA5929CD368E9B5AC0A4DEDBC26,30921,15,17,2,109.53903,18.29451,1667
282635,82FFBAA5929CD368E9B5AC0A4DEDBC26,30051,19,22,3,109.48917,18.21215,1453
282639,9A1D1AA5EE2CD156CC396C667ED8C5B9,30854,0,17,17,109.56889,18.27076,1763
282640,9A1D1AA5EE2CD156CC396C667ED8C5B9,31071,21,23,2,109.58257,18.28458,1815
282656,C6A8E1B5CB65D13AF625A1F15BC5FC3D,31071,7,12,5,109.58257,18.28458,1815
282657,C6A8E1B5CB65D13AF625A1F15BC5FC3D,30854,15,16,1,109.56889,18.27076,1763
282658,AE15DCAE42DF0D3349548C07BEAC73FD,38951,0,4,4,109.48097,18.28868,1416
282659,AE15DCAE42DF0D3349548C07BEAC73FD,60401,5,6,1,109.47444,18.27583,1414
282660,AE15DCAE42DF0D3349548C07BEAC73FD,38951,6,8,2,109.48097,18.28868,1416
282661,AE15DCAE42DF0D3349548C07BEAC73FD,38951,8,13,5,109.48097,18.28868,1416
282662,AE15DCAE42DF0D3349548C07BEAC73FD,38951,14,17,3,109.48097,18.28868,1416
282663,AE15DCAE42DF0D3349548C07BEAC73FD,60221,19,21,2,109.52569,18.29188,1616
282664,AE15DCAE42DF0D3349548C07BEAC73FD,38951,21,22,1,109.48097,18.28868,1416
282683,798BF3B08F72A16A6DEAAA235F1899BB,61011,5,10,5,109.60653,18.19076,1900
282685,798BF3B08F72A16A6DEAAA235F1899BB,61011,13,16,3,109.60653,18.19076,1900
282698,10FC24C9531FD1E7AB2542E578A0BE0B,30191,0,13,13,109.50361,18.22701,1506
282719,20A2925E2D87348010A2913B8AC052B3,30854,12,15,3,109.56889,18.27076,1763
282720,20A2925E2D87348010A2913B8AC052B3,31071,19,21,2,109.58257,18.28458,1815
282721,20A2925E2D87348010A2913B8AC052B3,30854,21,23,2,109.56889,18.27076,1763
282728,5DFEA14186E5F9BAEF52ACA19AAFC596,31101,0,8,8,109.65389,18.23403,2057
282729,5DFEA14186E5F9BAEF52ACA19AAFC596,31521,12,17,5,109.51458,18.22542,1555
282730,5DFEA14186E5F9BAEF52ACA19AAFC596,30161,18,20,2,109.50042,18.24389,1508
282731,5DFEA14186E5F9BAEF52ACA19AAFC596,30221,22,23,1,109.57833,18.20222,1802
282742,3E9BF2870165485B459CAEC9B77D2C77,30771,20,21,1,109.49938,18.26042,1511
282743,3E9BF2870165485B459CAEC9B77D2C77,30761,21,23,2,109.45201,18.3,1318
282755,843C5064DB5191DFA919592D1A4ECAC4,38321,0,7,7,109.39854,18.29132,1116
282756,843C5064DB5191DFA919592D1A4ECAC4,38105,7,11,4,109.40299,18.29229,1117
282757,843C5064DB5191DFA919592D1A4ECAC4,30341,12,13,1,109.3625,18.29167,966
282758,843C5064DB5191DFA919592D1A4ECAC4,31471,14,16,2,109.34583,18.29563,917
282759,843C5064DB5191DFA919592D1A4ECAC4,38321,18,23,5,109.39854,18.29132,1116
282821,2BE6133C5E44424C388243054653B4C5,60631,15,23,8,109.57778,18.27583,1814
282871,C1F100A79C441D3FFDBAE922D32DC8D2,30854,0,6,6,109.56889,18.27076,1763
282872,C1F100A79C441D3FFDBAE922D32DC8D2,31945,10,19,9,109.58021,18.29403,1817
282873,C1F100A79C441D3FFDBAE922D32DC8D2,30854,20,23,3,109.56889,18.27076,1763
282877,1CBC9AD5FFEDEF1A61B032FAD2F85D56,60084,0,7,7,109.4984,18.2334,1507
282878,1CBC9AD5FFEDEF1A61B032FAD2F85D56,31471,10,12,2,109.34583,18.29563,917
282879,1CBC9AD5FFEDEF1A61B032FAD2F85D56,30661,12,13,1,109.37028,18.24361,1008
282880,1CBC9AD5FFEDEF1A61B032FAD2F85D56,60084,18,23,5,109.4984,18.2334,1507
282881,7F632B4875B2736225CD6D350CD25670,31071,8,10,2,109.58257,18.28458,1815
282882,7F632B4875B2736225CD6D350CD25670,30854,13,22,9,109.56889,18.27076,1763
282907,EC89B2FFE00F967E6D0A3B697A6D636D,60631,0,1,1,109.57778,18.27583,1814
282908,EC89B2FFE00F967E6D0A3B697A6D636D,31071,5,10,5,109.58257,18.28458,1815
282909,EC89B2FFE00F967E6D0A3B697A6D636D,30854,14,15,1,109.56889,18.27076,1763
282910,EC89B2FFE00F967E6D0A3B697A6D636D,31561,20,23,3,109.56792,18.28479,1765
282920,0DCED9DD7A37F5E957C48EBF5FA9FAEE,31031,0,16,16,109.49979,18.25382,1510
282945,2D7C2B0308FF40B49F9D8D3F0878C284,39111,0,1,1,109.5191,18.22597,1555
282946,2D7C2B0308FF40B49F9D8D3F0878C284,31521,2,7,5,109.51458,18.22542,1555
282948,2D7C2B0308FF40B49F9D8D3F0878C284,31521,17,18,1,109.51458,18.22542,1555
282949,2D7C2B0308FF40B49F9D8D3F0878C284,60381,20,22,2,109.5241,18.22458,1605
282964,59F29435D748531F416A4F1636997ECF,39371,1,6,5,109.56627,18.2646,1762
282965,59F29435D748531F416A4F1636997ECF,30854,8,23,15,109.56889,18.27076,1763
282966,68DBE0B52FD0AB95F1DD47068FD7847F,30181,0,14,14,109.51597,18.23313,1557
282967,68DBE0B52FD0AB95F1DD47068FD7847F,31521,14,16,2,109.51458,18.22542,1555
282968,68DBE0B52FD0AB95F1DD47068FD7847F,30181,18,22,4,109.51597,18.23313,1557
282970,3518F5AE52D5A3181625A6C97E738310,38094,12,14,2,109.45403,18.28778,1316
282971,3518F5AE52D5A3181625A6C97E738310,31145,16,17,1,109.20431,18.30479,369
282972,3518F5AE52D5A3181625A6C97E738310,38094,19,20,1,109.45403,18.28778,1316
282973,3518F5AE52D5A3181625A6C97E738310,30201,20,22,2,109.4909,18.26465,1462
283008,C6F78220AAD296FE3F26258AAA364F5E,31164,1,8,7,109.69993,18.27215,2263
283009,C6F78220AAD296FE3F26258AAA364F5E,31671,10,11,1,109.38965,18.29813,1068
283010,C6F78220AAD296FE3F26258AAA364F5E,30281,16,18,2,109.50597,18.27583,1514
283011,C6F78220AAD296FE3F26258AAA364F5E,39151,18,20,2,109.49875,18.25097,1510
283012,C6F78220AAD296FE3F26258AAA364F5E,31521,21,23,2,109.51458,18.22542,1555
283024,A2F734AA2F32C81D03014F0CEDF1D528,30351,0,1,1,109.41701,18.29292,1217
283025,A2F734AA2F32C81D03014F0CEDF1D528,60524,2,8,6,109.42951,18.28993,1216
283026,A2F734AA2F32C81D03014F0CEDF1D528,30661,11,14,3,109.37028,18.24361,1008
283027,A2F734AA2F32C81D03014F0CEDF1D528,30351,19,23,4,109.41701,18.29292,1217
283060,7F377D9BD4A6752A92F213BA9B3E59E5,30771,0,5,5,109.49938,18.26042,1511
283061,7F377D9BD4A6752A92F213BA9B3E59E5,38251,6,9,3,109.49618,18.25493,1510
283062,7F377D9BD4A6752A92F213BA9B3E59E5,30421,10,13,3,109.50021,18.25861,1511
283063,7F377D9BD4A6752A92F213BA9B3E59E5,31031,15,17,2,109.49979,18.25382,1510
283064,7F377D9BD4A6752A92F213BA9B3E59E5,31271,18,20,2,109.48958,18.26257,1462
283065,7F377D9BD4A6752A92F213BA9B3E59E5,38251,20,21,1,109.49618,18.25493,1510
283066,7F377D9BD4A6752A92F213BA9B3E59E5,30771,22,23,1,109.49938,18.26042,1511
283095,522E8CB42AF22D75F3E9D0FD1FDCEEA6,30854,0,1,1,109.56889,18.27076,1763
283096,522E8CB42AF22D75F3E9D0FD1FDCEEA6,39371,1,7,6,109.56627,18.2646,1762
283097,522E8CB42AF22D75F3E9D0FD1FDCEEA6,30854,7,13,6,109.56889,18.27076,1763
283098,522E8CB42AF22D75F3E9D0FD1FDCEEA6,60354,16,18,2,109.58701,18.28521,1815
283099,522E8CB42AF22D75F3E9D0FD1FDCEEA6,31071,19,20,1,109.58257,18.28458,1815
283126,066CC6CBB5ADF978A93AF5D0C3292806,30071,0,7,7,109.52819,18.30472,1619
283127,066CC6CBB5ADF978A93AF5D0C3292806,31931,8,10,2,109.54771,18.29403,1667
283128,066CC6CBB5ADF978A93AF5D0C3292806,60581,12,14,2,109.59785,18.29931,1868
283129,24C0932BD5754CA1476755EEBD27CEBD,31811,0,19,19,109.54201,18.31806,1671
283130,24C0932BD5754CA1476755EEBD27CEBD,30941,19,22,3,109.5559,18.33938,1724
283143,F104684B0D453E1772CF3FC2E8F8DFBE,60401,17,19,2,109.47444,18.27583,1414
283144,F104684B0D453E1772CF3FC2E8F8DFBE,60161,21,22,1,109.49174,18.26181,1461
283162,14BFE46EEAB2E234698393270A62605D,60411,1,5,4,109.32514,18.30854,869
283163,14BFE46EEAB2E234698393270A62605D,30661,5,7,2,109.37028,18.24361,1008
283164,14BFE46EEAB2E234698393270A62605D,60411,8,23,15,109.32514,18.30854,869
283183,2CF83F5125C6075E2ACA9C17C2979C64,31071,7,8,1,109.58257,18.28458,1815
283184,2CF83F5125C6075E2ACA9C17C2979C64,30854,9,13,4,109.56889,18.27076,1763
283185,2CF83F5125C6075E2ACA9C17C2979C64,31071,15,18,3,109.58257,18.28458,1815
283186,2CF83F5125C6075E2ACA9C17C2979C64,30854,19,21,2,109.56889,18.27076,1763
283192,8C28D637CC74662A6171660AC17A06B6,38241,1,7,6,109.54111,18.30542,1669
283193,8C28D637CC74662A6171660AC17A06B6,30071,8,13,5,109.52819,18.30472,1619
283194,8C28D637CC74662A6171660AC17A06B6,30854,14,18,4,109.56889,18.27076,1763
283195,8C28D637CC74662A6171660AC17A06B6,30071,22,23,1,109.52819,18.30472,1619
283210,EFEDECB139A304BF1949D208B2A10BCC,31521,16,18,2,109.51458,18.22542,1555
283211,EFEDECB139A304BF1949D208B2A10BCC,38071,19,21,2,109.40722,18.30938,1169
283212,2D8DD824BBF69AD8F67DA5D5B6F17323,38336,0,11,11,109.61111,18.21806,1904
283213,2D8DD824BBF69AD8F67DA5D5B6F17323,30711,11,13,2,109.50271,18.25347,1510
283214,2D8DD824BBF69AD8F67DA5D5B6F17323,30151,14,15,1,109.50986,18.25083,1560
283215,2D8DD824BBF69AD8F67DA5D5B6F17323,30511,18,19,1,109.51069,18.24208,1558
283216,2D8DD824BBF69AD8F67DA5D5B6F17323,30151,20,23,3,109.50986,18.25083,1560
283289,7C68E1F4B8B2F3CBBD5427BF66BF9C2E,30854,2,5,3,109.56889,18.27076,1763
283290,7C68E1F4B8B2F3CBBD5427BF66BF9C2E,60591,10,12,2,109.61118,18.21715,1904
283295,9BD095517798346F169AD6D898CA1A42,60361,19,20,1,109.51938,18.29681,1567
283296,9BD095517798346F169AD6D898CA1A42,60274,21,22,1,109.514,18.2933,1567
283303,299AC9422F298CCC4ED16594B565B2CA,60341,0,6,6,109.70597,18.31778,2271
283307,299AC9422F298CCC4ED16594B565B2CA,60341,21,23,2,109.70597,18.31778,2271
283308,C0C1EE89F1AC35B762053FC3AB41A7AA,60361,0,8,8,109.51938,18.29681,1567
283309,C0C1EE89F1AC35B762053FC3AB41A7AA,31781,11,14,3,109.19847,18.2975,367
283335,7171A8398911756415ECFCDCF96F249B,39371,0,14,14,109.56627,18.2646,1762
283336,7171A8398911756415ECFCDCF96F249B,31421,17,20,3,109.55382,18.22347,1705
283337,7171A8398911756415ECFCDCF96F249B,30851,21,22,1,109.5616,18.27396,1713
283348,7F6E66BC10419161F6457A6D79258EDB,31361,0,7,7,109.47417,18.28292,1415
283349,7F6E66BC10419161F6457A6D79258EDB,60401,8,9,1,109.47444,18.27583,1414
283350,7F6E66BC10419161F6457A6D79258EDB,38094,11,13,2,109.45403,18.28778,1316
283351,7F6E66BC10419161F6457A6D79258EDB,38251,13,14,1,109.49618,18.25493,1510
283352,7F6E66BC10419161F6457A6D79258EDB,30171,18,19,1,109.48458,18.27139,1463
283360,25B68A5424AF12317AF7FF917D58087B,38871,0,4,4,109.44681,18.28625,1316
283361,25B68A5424AF12317AF7FF917D58087B,38391,4,5,1,109.44111,18.29083,1266
283378,372A5433078073EAD18922D679CE0A73,60054,0,2,2,109.3016,18.31229,770
283379,372A5433078073EAD18922D679CE0A73,30661,4,6,2,109.37028,18.24361,1008
283380,372A5433078073EAD18922D679CE0A73,60411,11,12,1,109.32514,18.30854,869
283381,372A5433078073EAD18922D679CE0A73,60054,12,14,2,109.3016,18.31229,770
283400,50F6E2D553B36EAFE6AA22613C3D5EDD,60401,14,16,2,109.47444,18.27583,1414
283401,50F6E2D553B36EAFE6AA22613C3D5EDD,30711,16,19,3,109.50271,18.25347,1510
283402,50F6E2D553B36EAFE6AA22613C3D5EDD,30181,20,21,1,109.51597,18.23313,1557
283468,65AD296DD65C9EEA3C22EA02904A768E,31561,4,6,2,109.56792,18.28479,1765
283469,65AD296DD65C9EEA3C22EA02904A768E,30854,9,16,7,109.56889,18.27076,1763
283499,4A6E6277F47F7550E2618B9C1ADC3166,30361,13,15,2,109.50347,18.24,1508
283500,4A6E6277F47F7550E2618B9C1ADC3166,31391,18,23,5,109.50382,18.24285,1508
283554,D4EE8E1A4C04A1FF0596E4221D0B8B42,31071,0,8,8,109.58257,18.28458,1815
283555,D4EE8E1A4C04A1FF0596E4221D0B8B42,30854,11,18,7,109.56889,18.27076,1763
283556,D4EE8E1A4C04A1FF0596E4221D0B8B42,31071,18,19,1,109.58257,18.28458,1815
283557,D4EE8E1A4C04A1FF0596E4221D0B8B42,30854,20,22,2,109.56889,18.27076,1763
283688,1DA88ED70B6ADE8EAE3D8F549B029C10,60131,15,18,3,109.49819,18.24778,1509
283689,1DA88ED70B6ADE8EAE3D8F549B029C10,31031,20,21,1,109.49979,18.25382,1510
283690,1DA88ED70B6ADE8EAE3D8F549B029C10,60131,22,23,1,109.49819,18.24778,1509
283702,7A214C2AB4CE0E87DF8DB230B9F95561,30101,0,14,14,109.57299,18.33333,1773
283703,7A214C2AB4CE0E87DF8DB230B9F95561,31631,14,15,1,109.59542,18.36826,1879
283704,7A214C2AB4CE0E87DF8DB230B9F95561,30101,15,23,8,109.57299,18.33333,1773
283705,81BB8442D113627FA1326BEB8BF192ED,60631,0,3,3,109.57778,18.27583,1814
283706,81BB8442D113627FA1326BEB8BF192ED,30854,7,9,2,109.56889,18.27076,1763
283707,81BB8442D113627FA1326BEB8BF192ED,30731,12,15,3,109.50944,18.22306,1555
283708,81BB8442D113627FA1326BEB8BF192ED,31421,16,17,1,109.55382,18.22347,1705
283710,9B389AE8E9B004176803CCEAFF69104A,60631,6,8,2,109.57778,18.27583,1814
283711,9B389AE8E9B004176803CCEAFF69104A,39371,8,10,2,109.56627,18.2646,1762
283712,9B389AE8E9B004176803CCEAFF69104A,60631,12,16,4,109.57778,18.27583,1814
283738,E5E7A1E4B2B3DFFE76B1825814C207C0,30081,0,7,7,109.50243,18.26632,1512
283739,E5E7A1E4B2B3DFFE76B1825814C207C0,31561,10,11,1,109.56792,18.28479,1765
283740,E5E7A1E4B2B3DFFE76B1825814C207C0,30851,12,13,1,109.5616,18.27396,1713
283741,E5E7A1E4B2B3DFFE76B1825814C207C0,31561,14,18,4,109.56792,18.28479,1765
283742,E5E7A1E4B2B3DFFE76B1825814C207C0,30081,19,23,4,109.50243,18.26632,1512
283745,D02ECCADCE37C9BB090B5733D16771A3,31931,14,16,2,109.54771,18.29403,1667
283755,B039FD787BBA07BD32246202CEEDE945,30051,0,17,17,109.48917,18.21215,1453
283756,B039FD787BBA07BD32246202CEEDE945,39151,20,21,1,109.49875,18.25097,1510
283782,C17F2EF1DEA79C8C951E3013EE071B2C,31071,0,17,17,109.58257,18.28458,1815
283783,C17F2EF1DEA79C8C951E3013EE071B2C,60381,18,20,2,109.5241,18.22458,1605
283784,C17F2EF1DEA79C8C951E3013EE071B2C,38061,21,22,1,109.50597,18.23118,1506
283812,70DCD7BB3675E3BE2BD25F86910CADB1,31071,2,7,5,109.58257,18.28458,1815
283813,70DCD7BB3675E3BE2BD25F86910CADB1,30854,8,9,1,109.56889,18.27076,1763
283814,70DCD7BB3675E3BE2BD25F86910CADB1,30731,10,15,5,109.50944,18.22306,1555
283881,D619F26FD3DE3212F61D98B7FC43EEC1,31521,18,21,3,109.51458,18.22542,1555
283882,D619F26FD3DE3212F61D98B7FC43EEC1,30211,22,23,1,109.49882,18.23931,1508
283885,8D3B10FD4DBC46DB93DA60040668F697,30854,0,6,6,109.56889,18.27076,1763
283886,8D3B10FD4DBC46DB93DA60040668F697,31561,6,8,2,109.56792,18.28479,1765
283887,8D3B10FD4DBC46DB93DA60040668F697,30854,12,23,11,109.56889,18.27076,1763
283929,1E1181D91A7FDEE2449092386CA6A77C,60041,0,6,6,109.39889,18.31944,1121
283930,1E1181D91A7FDEE2449092386CA6A77C,60552,8,10,2,109.41729,18.30014,1218
283931,1E1181D91A7FDEE2449092386CA6A77C,60041,11,22,11,109.39889,18.31944,1121
283937,8621CFDF1B89A83351494618C53D033F,31071,4,6,2,109.58257,18.28458,1815
283938,8621CFDF1B89A83351494618C53D033F,30711,9,11,2,109.50271,18.25347,1510
283939,8621CFDF1B89A83351494618C53D033F,39181,12,20,8,109.55153,18.28035,1715
283940,8621CFDF1B89A83351494618C53D033F,31071,21,23,2,109.58257,18.28458,1815
283944,7B280C2AC3C9F2B40941094B166E2863,38903,0,7,7,109.39229,18.29243,1117
283945,7B280C2AC3C9F2B40941094B166E2863,30661,9,13,4,109.37028,18.24361,1008
283946,7B280C2AC3C9F2B40941094B166E2863,31471,15,16,1,109.34583,18.29563,917
283960,3E0CC1F431A959DE24ABB41EC7702F6D,30661,13,14,1,109.37028,18.24361,1008
283961,3E0CC1F431A959DE24ABB41EC7702F6D,30351,19,20,1,109.41701,18.29292,1217
283962,3E0CC1F431A959DE24ABB41EC7702F6D,31231,21,22,1,109.42597,18.29292,1217
283963,3E0CC1F431A959DE24ABB41EC7702F6D,60552,22,23,1,109.41729,18.30014,1218
283991,5664C5FF6B352F96C7620F94430DAC4F,31391,4,6,2,109.50382,18.24285,1508
283992,5664C5FF6B352F96C7620F94430DAC4F,31521,6,8,2,109.51458,18.22542,1555
283993,5664C5FF6B352F96C7620F94430DAC4F,31391,8,10,2,109.50382,18.24285,1508
283994,5664C5FF6B352F96C7620F94430DAC4F,31521,11,18,7,109.51458,18.22542,1555
283995,5664C5FF6B352F96C7620F94430DAC4F,31521,18,22,4,109.51458,18.22542,1555
284023,F7F33BB1C68494D5DA2069CBA2A8F745,31071,0,1,1,109.58257,18.28458,1815
284024,F7F33BB1C68494D5DA2069CBA2A8F745,30854,2,9,7,109.56889,18.27076,1763
284025,F7F33BB1C68494D5DA2069CBA2A8F745,31071,12,23,11,109.58257,18.28458,1815
284026,4AA92C2276692190731459431C798101,31945,0,6,6,109.58021,18.29403,1817
284027,4AA92C2276692190731459431C798101,31561,8,9,1,109.56792,18.28479,1765
284028,4AA92C2276692190731459431C798101,31945,9,12,3,109.58021,18.29403,1817
284029,4AA92C2276692190731459431C798101,30711,13,15,2,109.50271,18.25347,1510
284030,4AA92C2276692190731459431C798101,31945,18,22,4,109.58021,18.29403,1817
284047,78E76A57E920142E7532CF78E58080EE,31021,1,4,3,109.49021,18.27,1463
284048,78E76A57E920142E7532CF78E58080EE,30201,6,9,3,109.4909,18.26465,1462
284049,78E76A57E920142E7532CF78E58080EE,30921,11,12,1,109.53903,18.29451,1667
284050,78E76A57E920142E7532CF78E58080EE,31931,12,23,11,109.54771,18.29403,1667
284055,1AEA44F051EC107D454C59951DC8E3E5,60311,0,8,8,109.52097,18.24319,1558
284056,1AEA44F051EC107D454C59951DC8E3E5,30711,10,11,1,109.50271,18.25347,1510
284057,1AEA44F051EC107D454C59951DC8E3E5,60311,12,13,1,109.52097,18.24319,1558
284058,1AEA44F051EC107D454C59951DC8E3E5,60371,15,17,2,109.53063,18.30056,1618
284059,1AEA44F051EC107D454C59951DC8E3E5,60311,19,22,3,109.52097,18.24319,1558
284148,EB316856896788EC8FD871E122E95728,60361,0,3,3,109.51938,18.29681,1567
284149,EB316856896788EC8FD871E122E95728,30701,4,5,1,109.59313,18.32007,1871
284150,EB316856896788EC8FD871E122E95728,31811,8,10,2,109.54201,18.31806,1671
284151,EB316856896788EC8FD871E122E95728,60361,14,16,2,109.51938,18.29681,1567
284152,EB316856896788EC8FD871E122E95728,30701,18,21,3,109.59313,18.32007,1871
284153,EB316856896788EC8FD871E122E95728,30931,21,22,1,109.55653,18.32722,1722
284174,4E8A1FFC680701A862F9A60D8BF0780C,38162,15,18,3,109.43944,18.28889,1266
284175,4E8A1FFC680701A862F9A60D8BF0780C,38162,19,22,3,109.43944,18.28889,1266
284204,CD3BCBAB8571FB81953C842A434E5DB8,31071,7,8,1,109.58257,18.28458,1815
284205,CD3BCBAB8571FB81953C842A434E5DB8,30854,8,11,3,109.56889,18.27076,1763
284206,CD3BCBAB8571FB81953C842A434E5DB8,31071,13,16,3,109.58257,18.28458,1815
284255,0505C716BCB35B5DD4016F98C220D0C2,31864,14,18,4,109.49014,18.28333,1465
284256,0505C716BCB35B5DD4016F98C220D0C2,60291,19,21,2,109.50826,18.24639,1509
284257,0505C716BCB35B5DD4016F98C220D0C2,39091,22,23,1,109.50097,18.25222,1510
284262,58DE8A719D3ADBEDAE163213845B460A,31071,1,14,13,109.58257,18.28458,1815
284263,58DE8A719D3ADBEDAE163213845B460A,30854,16,17,1,109.56889,18.27076,1763
284266,9DE8C13901CC7D63E2F1A6CC92603604,30854,3,16,13,109.56889,18.27076,1763
284267,9DE8C13901CC7D63E2F1A6CC92603604,60371,19,21,2,109.53063,18.30056,1618
284271,281A1935FADAFCA0937BB2D463A4CFAF,31471,1,4,3,109.34583,18.29563,917
284272,281A1935FADAFCA0937BB2D463A4CFAF,30661,4,5,1,109.37028,18.24361,1008
284273,281A1935FADAFCA0937BB2D463A4CFAF,60411,6,7,1,109.32514,18.30854,869
284274,281A1935FADAFCA0937BB2D463A4CFAF,30661,12,14,2,109.37028,18.24361,1008
284275,281A1935FADAFCA0937BB2D463A4CFAF,31251,14,15,1,109.18528,18.2975,317
284276,281A1935FADAFCA0937BB2D463A4CFAF,31471,17,18,1,109.34583,18.29563,917
284293,2DDF3A993BD69F79020EB97CF3A71819,38171,0,7,7,109.50799,18.28139,1515
284294,2DDF3A993BD69F79020EB97CF3A71819,30161,8,19,11,109.50042,18.24389,1508
284307,706B8E0F0F5D1C9FC2F8EBB2574EE89F,30711,0,7,7,109.50271,18.25347,1510
284308,706B8E0F0F5D1C9FC2F8EBB2574EE89F,31461,7,9,2,109.5091,18.25389,1510
284309,706B8E0F0F5D1C9FC2F8EBB2574EE89F,30711,10,13,3,109.50271,18.25347,1510
284310,706B8E0F0F5D1C9FC2F8EBB2574EE89F,30711,14,23,9,109.50271,18.25347,1510
284319,C3D97A298AB6EB8497D0CC432E6DD8A2,30421,10,13,3,109.50021,18.25861,1511
284320,C3D97A298AB6EB8497D0CC432E6DD8A2,31851,14,15,1,109.71736,18.29007,2316
284337,EBD16061EA20EE33D9344D33735E5205,38291,0,7,7,109.51618,18.24313,1558
284338,EBD16061EA20EE33D9344D33735E5205,31261,7,9,2,109.51174,18.2466,1559
284339,EBD16061EA20EE33D9344D33735E5205,38291,9,11,2,109.51618,18.24313,1558
284340,EBD16061EA20EE33D9344D33735E5205,31261,13,14,1,109.51174,18.2466,1559
284341,EBD16061EA20EE33D9344D33735E5205,38891,17,23,6,109.51486,18.24118,1558
284363,F8D81869027CCFD6139762C81772F076,31271,0,7,7,109.48958,18.26257,1462
284364,F8D81869027CCFD6139762C81772F076,31031,8,9,1,109.49979,18.25382,1510
284365,F8D81869027CCFD6139762C81772F076,39321,10,18,8,109.529,18.2167,1604
284366,F8D81869027CCFD6139762C81772F076,60381,19,20,1,109.5241,18.22458,1605
284367,F8D81869027CCFD6139762C81772F076,31271,21,23,2,109.48958,18.26257,1462
284414,3A044DC50877A7C3021BEAE1D2D64C9E,38754,19,20,1,109.74667,18.37382,2430
284415,3A044DC50877A7C3021BEAE1D2D64C9E,30961,20,21,1,109.74042,18.37903,2431
284425,AE6DC7ACB81DB5F351E45AC25E5F5A3B,31201,0,3,3,109.51042,18.23819,1558
284426,AE6DC7ACB81DB5F351E45AC25E5F5A3B,60311,6,7,1,109.52097,18.24319,1558
284427,AE6DC7ACB81DB5F351E45AC25E5F5A3B,60281,8,15,7,109.51743,18.25924,1561
284428,AE6DC7ACB81DB5F351E45AC25E5F5A3B,60311,17,18,1,109.52097,18.24319,1558
284429,AE6DC7ACB81DB5F351E45AC25E5F5A3B,38297,21,23,2,109.52576,18.24965,1609
284443,7DE5FC03BA99B22E41C5D0A9D25E3D68,30234,2,7,5,109.60681,18.29979,1918
284444,7DE5FC03BA99B22E41C5D0A9D25E3D68,31031,12,23,11,109.49979,18.25382,1510
284451,2F440A235E684ECEDD042B3100A4AE95,31071,0,7,7,109.58257,18.28458,1815
284452,2F440A235E684ECEDD042B3100A4AE95,30854,7,10,3,109.56889,18.27076,1763
284453,2F440A235E684ECEDD042B3100A4AE95,31561,11,12,1,109.56792,18.28479,1765
284454,2F440A235E684ECEDD042B3100A4AE95,30854,13,15,2,109.56889,18.27076,1763
284455,2F440A235E684ECEDD042B3100A4AE95,31561,16,18,2,109.56792,18.28479,1765
284456,2F440A235E684ECEDD042B3100A4AE95,31071,20,23,3,109.58257,18.28458,1815
284462,54B883645487D188D3AAF2ECE345CCC6,31864,0,8,8,109.49014,18.28333,1465
284463,54B883645487D188D3AAF2ECE345CCC6,31781,9,12,3,109.19847,18.2975,367
284464,54B883645487D188D3AAF2ECE345CCC6,31471,13,15,2,109.34583,18.29563,917
284465,54B883645487D188D3AAF2ECE345CCC6,48574,16,18,2,109.48931,18.28458,1465
284466,54B883645487D188D3AAF2ECE345CCC6,60501,19,20,1,109.48701,18.29021,1466
284467,54B883645487D188D3AAF2ECE345CCC6,31864,20,23,3,109.49014,18.28333,1465
284468,0402BD114B7D5E20705E302B756CD062,60631,0,5,5,109.57778,18.27583,1814
284469,0402BD114B7D5E20705E302B756CD062,30854,10,12,2,109.56889,18.27076,1763
284470,0402BD114B7D5E20705E302B756CD062,31071,16,17,1,109.58257,18.28458,1815
284471,0402BD114B7D5E20705E302B756CD062,30854,17,21,4,109.56889,18.27076,1763
284472,261915B8DB7EA33A6A8394E897EC6B41,31071,0,11,11,109.58257,18.28458,1815
284473,261915B8DB7EA33A6A8394E897EC6B41,30854,14,15,1,109.56889,18.27076,1763
284474,261915B8DB7EA33A6A8394E897EC6B41,31071,19,21,2,109.58257,18.28458,1815
284495,ACDEAAF45B65DE48CF80A48DBD3C775E,30854,1,17,16,109.56889,18.27076,1763
284496,ACDEAAF45B65DE48CF80A48DBD3C775E,31071,18,19,1,109.58257,18.28458,1815
284499,5C71CBC5C1D47FC32EDE45570D296228,30861,0,8,8,109.52722,18.22743,1606
284500,5C71CBC5C1D47FC32EDE45570D296228,60552,9,10,1,109.41729,18.30014,1218
284501,5C71CBC5C1D47FC32EDE45570D296228,31781,12,14,2,109.19847,18.2975,367
284502,5C71CBC5C1D47FC32EDE45570D296228,31471,14,17,3,109.34583,18.29563,917
284503,5C71CBC5C1D47FC32EDE45570D296228,30861,19,23,4,109.52722,18.22743,1606
284504,5EBEA276FCB4A19AC5C987F5C7CC8908,60621,0,8,8,109.48354,18.27451,1464
284505,5EBEA276FCB4A19AC5C987F5C7CC8908,60401,10,12,2,109.47444,18.27583,1414
284506,5EBEA276FCB4A19AC5C987F5C7CC8908,60552,14,16,2,109.41729,18.30014,1218
284507,5EBEA276FCB4A19AC5C987F5C7CC8908,38361,18,19,1,109.43667,18.29201,1267
284508,5EBEA276FCB4A19AC5C987F5C7CC8908,31701,20,22,2,109.44132,18.28833,1266
284534,A5678EE319F8EC08843C9F20545373D3,31205,0,1,1,109.51111,18.23736,1557
284535,A5678EE319F8EC08843C9F20545373D3,60524,1,7,6,109.42951,18.28993,1216
284536,A5678EE319F8EC08843C9F20545373D3,31561,9,12,3,109.56792,18.28479,1765
284537,A5678EE319F8EC08843C9F20545373D3,31021,14,15,1,109.49021,18.27,1463
284538,A5678EE319F8EC08843C9F20545373D3,30971,16,23,7,109.48708,18.29319,1467
284539,7B1A07C39637E996C01DF0A3D287D3C6,31071,17,18,1,109.58257,18.28458,1815
284540,7B1A07C39637E996C01DF0A3D287D3C6,39371,19,20,1,109.56627,18.2646,1762
284552,B032E534C72FB8134F1588648D944A44,30854,0,17,17,109.56889,18.27076,1763
284553,B032E534C72FB8134F1588648D944A44,30371,18,20,2,109.51,18.24771,1559
284554,DB4DF566D4757FF3BB488F82DE126248,30854,0,6,6,109.56889,18.27076,1763
284555,DB4DF566D4757FF3BB488F82DE126248,31561,6,14,8,109.56792,18.28479,1765
284556,DB4DF566D4757FF3BB488F82DE126248,30851,16,19,3,109.5616,18.27396,1713
284557,DB4DF566D4757FF3BB488F82DE126248,31561,19,22,3,109.56792,18.28479,1765
284558,2F217282255B5DE51322458E6E0E5862,38023,0,11,11,109.37132,18.28993,1016
284559,2F217282255B5DE51322458E6E0E5862,31471,12,16,4,109.34583,18.29563,917
284560,2F217282255B5DE51322458E6E0E5862,38023,19,23,4,109.37132,18.28993,1016
284565,0312B43ACF9ED1D8304E325E851AEE29,30851,0,10,10,109.5616,18.27396,1713
284566,0312B43ACF9ED1D8304E325E851AEE29,31561,12,16,4,109.56792,18.28479,1765
284567,0312B43ACF9ED1D8304E325E851AEE29,30851,16,23,7,109.5616,18.27396,1713
284570,76E12A118C330D9C1C9FA24D20FBD536,31091,1,2,1,109.41201,18.31222,1170
284571,76E12A118C330D9C1C9FA24D20FBD536,31181,3,7,4,109.50382,18.24813,1509
284572,76E12A118C330D9C1C9FA24D20FBD536,60291,7,8,1,109.50826,18.24639,1509
284573,76E12A118C330D9C1C9FA24D20FBD536,30201,16,20,4,109.4909,18.26465,1462
284574,76E12A118C330D9C1C9FA24D20FBD536,31181,21,23,2,109.50382,18.24813,1509
284597,16E640D9FA5593E85AD54BDFBAF952D8,31561,0,3,3,109.56792,18.28479,1765
284598,16E640D9FA5593E85AD54BDFBAF952D8,30854,6,8,2,109.56889,18.27076,1763
284599,16E640D9FA5593E85AD54BDFBAF952D8,31071,8,17,9,109.58257,18.28458,1815
284600,16E640D9FA5593E85AD54BDFBAF952D8,31561,18,19,1,109.56792,18.28479,1765
284646,CEF8E35C6588939BE87D1C80A6394F29,30854,11,13,2,109.56889,18.27076,1763
284653,1A1509AC6E667B603EE3773D1273B7B0,39053,20,21,1,109.511,18.2771,1564
284654,1A1509AC6E667B603EE3773D1273B7B0,31091,22,23,1,109.41201,18.31222,1170
284666,C8BEDF243DDC440B45960DDE87D3E361,39111,0,8,8,109.5191,18.22597,1555
284667,C8BEDF243DDC440B45960DDE87D3E361,38315,12,13,1,109.48979,18.29764,1467
284673,C8CF6BADFF24FAF32D041216BE4EE29D,31271,0,7,7,109.48958,18.26257,1462
284674,C8CF6BADFF24FAF32D041216BE4EE29D,31781,9,11,2,109.19847,18.2975,367
284675,C8CF6BADFF24FAF32D041216BE4EE29D,31471,12,14,2,109.34583,18.29563,917
284676,C8CF6BADFF24FAF32D041216BE4EE29D,60221,18,21,3,109.52569,18.29188,1616
284738,3DBDFAB6744EB8339A2A3FDED5B3F996,30391,19,21,2,109.4975,18.27118,1513
284739,3DBDFAB6744EB8339A2A3FDED5B3F996,30711,21,22,1,109.50271,18.25347,1510
284740,A21C21E7D793AC3E70E23C48F1F3CC85,31431,0,9,9,109.44639,18.29042,1316
284741,A21C21E7D793AC3E70E23C48F1F3CC85,31471,12,15,3,109.34583,18.29563,917
284742,A21C21E7D793AC3E70E23C48F1F3CC85,30901,15,17,2,109.27597,18.3134,670
284743,A21C21E7D793AC3E70E23C48F1F3CC85,31431,20,23,3,109.44639,18.29042,1316
284770,3227997FE4FFED311C63A72B8544879D,30071,0,5,5,109.52819,18.30472,1619
284771,3227997FE4FFED311C63A72B8544879D,31931,6,21,15,109.54771,18.29403,1667
284772,3227997FE4FFED311C63A72B8544879D,30921,22,23,1,109.53903,18.29451,1667
284784,B7A2800FDF738E1064EAD2A5E58F7A3C,61011,0,11,11,109.60653,18.19076,1900
284786,B7A2800FDF738E1064EAD2A5E58F7A3C,61011,18,23,5,109.60653,18.19076,1900
284789,8265A029C672FE0377EF574CC3ADF2A8,39183,7,11,4,109.55542,18.28208,1715
284790,8265A029C672FE0377EF574CC3ADF2A8,31561,12,16,4,109.56792,18.28479,1765
284791,8265A029C672FE0377EF574CC3ADF2A8,30854,20,22,2,109.56889,18.27076,1763
284792,8265A029C672FE0377EF574CC3ADF2A8,31561,22,23,1,109.56792,18.28479,1765
284804,0C8D15C0488D521680F0DE3A28CFE111,30701,0,22,22,109.59313,18.32007,1871
284805,0C8D15C0488D521680F0DE3A28CFE111,31811,22,23,1,109.54201,18.31806,1671
284806,DFF0D1C3CF34075FCA7723BF68E63B2F,60401,16,18,2,109.47444,18.27583,1414
284807,DFF0D1C3CF34075FCA7723BF68E63B2F,60381,20,22,2,109.5241,18.22458,1605
284819,8EBC663D9C4AAC509442DB949D2DF64F,30421,11,18,7,109.50021,18.25861,1511
284820,8EBC663D9C4AAC509442DB949D2DF64F,30084,19,23,4,109.50118,18.26972,1513
284847,6B806948BC9187A91D033B4096721B00,31561,2,4,2,109.56792,18.28479,1765
284848,6B806948BC9187A91D033B4096721B00,30854,6,8,2,109.56889,18.27076,1763
284849,6B806948BC9187A91D033B4096721B00,31071,10,19,9,109.58257,18.28458,1815
284850,DE5024DB59D5BF6AE5857A85EB7680EA,31071,0,5,5,109.58257,18.28458,1815
284851,DE5024DB59D5BF6AE5857A85EB7680EA,30854,9,11,2,109.56889,18.27076,1763
284852,DE5024DB59D5BF6AE5857A85EB7680EA,31071,12,13,1,109.58257,18.28458,1815
284857,F621296F333E8058687ACD884B135C6E,60114,12,14,2,109.73028,18.33847,2374
284858,F621296F333E8058687ACD884B135C6E,30504,15,17,2,109.705,18.35368,2277
284859,F621296F333E8058687ACD884B135C6E,30191,20,23,3,109.50361,18.22701,1506
284936,3CC3D7175C2BD0F4CB1AB4C68F59FE01,60381,0,10,10,109.5241,18.22458,1605
284937,3CC3D7175C2BD0F4CB1AB4C68F59FE01,38251,14,17,3,109.49618,18.25493,1510
285039,BD36B617B5735ECF01B192DD8C734880,60661,0,6,6,109.548,18.2377,1657
285040,BD36B617B5735ECF01B192DD8C734880,31061,6,11,5,109.53333,18.23257,1607
285041,BD36B617B5735ECF01B192DD8C734880,31421,12,14,2,109.55382,18.22347,1705
285042,BD36B617B5735ECF01B192DD8C734880,60381,17,20,3,109.5241,18.22458,1605
285043,BD36B617B5735ECF01B192DD8C734880,31421,20,21,1,109.55382,18.22347,1705
285044,BD36B617B5735ECF01B192DD8C734880,60661,22,23,1,109.548,18.2377,1657
285063,934C74BA3183C31F0ADBA8662BD90297,31321,0,8,8,109.63799,18.23201,2007
285064,934C74BA3183C31F0ADBA8662BD90297,38025,9,11,2,109.36903,18.29167,1016
285065,934C74BA3183C31F0ADBA8662BD90297,31321,16,23,7,109.63799,18.23201,2007
285094,DCF02478AC5ACC5C3190CEB09210F280,31351,0,9,9,109.4959,18.28417,1465
285101,2B8C748A18FA7D08D4335AD7C9DEF01B,31761,0,5,5,109.60521,18.27965,1914
285102,2B8C748A18FA7D08D4335AD7C9DEF01B,30951,9,11,2,109.56208,18.25667,1761
285103,2B8C748A18FA7D08D4335AD7C9DEF01B,31551,11,14,3,109.55868,18.24222,1708
285104,2B8C748A18FA7D08D4335AD7C9DEF01B,31761,19,23,4,109.60521,18.27965,1914
285149,EFDE35289FEC1E13D6F34EFEE66A8AD2,30854,14,16,2,109.56889,18.27076,1763
285150,EFDE35289FEC1E13D6F34EFEE66A8AD2,60631,18,21,3,109.57778,18.27583,1814
285186,3977578BE56276DA0700B04B81DC1356,31561,0,8,8,109.56792,18.28479,1765
285187,3977578BE56276DA0700B04B81DC1356,31061,9,11,2,109.53333,18.23257,1607
285188,3977578BE56276DA0700B04B81DC1356,30851,15,19,4,109.5616,18.27396,1713
285237,070A398F07C013242CC3447B66DFACBF,39183,0,6,6,109.55542,18.28208,1715
285238,070A398F07C013242CC3447B66DFACBF,31931,8,9,1,109.54771,18.29403,1667
285239,070A398F07C013242CC3447B66DFACBF,39183,12,13,1,109.55542,18.28208,1715
285240,070A398F07C013242CC3447B66DFACBF,31931,14,19,5,109.54771,18.29403,1667
285241,070A398F07C013242CC3447B66DFACBF,39183,19,23,4,109.55542,18.28208,1715
285244,D64758992893CFDE3F3459903D21B5EA,30761,1,5,4,109.45201,18.3,1318
285245,D64758992893CFDE3F3459903D21B5EA,30671,5,6,1,109.43611,18.30139,1268
285246,D64758992893CFDE3F3459903D21B5EA,31701,8,10,2,109.44132,18.28833,1266
285247,D64758992893CFDE3F3459903D21B5EA,31781,11,13,2,109.19847,18.2975,367
285295,C61008F347B09908A052E575D01A92B1,31021,0,13,13,109.49021,18.27,1463
285296,C61008F347B09908A052E575D01A92B1,31471,15,17,2,109.34583,18.29563,917
285302,0E129C09250C0D46273B4BD7E5225556,30151,0,6,6,109.50986,18.25083,1560
285303,0E129C09250C0D46273B4BD7E5225556,30421,6,9,3,109.50021,18.25861,1511
285304,0E129C09250C0D46273B4BD7E5225556,60441,14,15,1,109.46792,18.28604,1366
285346,C709D01469E0800AF998DFAF42105CDC,60631,0,5,5,109.57778,18.27583,1814
285347,C709D01469E0800AF998DFAF42105CDC,31561,6,15,9,109.56792,18.28479,1765
285348,C709D01469E0800AF998DFAF42105CDC,30854,19,22,3,109.56889,18.27076,1763
285366,451E2BF48CD7B253EB0892324E679BCC,60281,6,16,10,109.51743,18.25924,1561
285367,451E2BF48CD7B253EB0892324E679BCC,31461,16,18,2,109.5091,18.25389,1510
285368,451E2BF48CD7B253EB0892324E679BCC,38297,19,22,3,109.52576,18.24965,1609
285369,451E2BF48CD7B253EB0892324E679BCC,38291,22,23,1,109.51618,18.24313,1558
285385,3160CBE2F0CDCB610575CDC881D9968C,38297,12,14,2,109.52576,18.24965,1609
285386,3160CBE2F0CDCB610575CDC881D9968C,30281,15,16,1,109.50597,18.27583,1514
285387,3160CBE2F0CDCB610575CDC881D9968C,60381,18,20,2,109.5241,18.22458,1605
285388,3160CBE2F0CDCB610575CDC881D9968C,38291,21,23,2,109.51618,18.24313,1558
285412,D4EC608FEFB7E2A068D5777F091AD4C5,31345,0,10,10,109.39,18.29,1066
285413,D4EC608FEFB7E2A068D5777F091AD4C5,31471,12,14,2,109.34583,18.29563,917
285414,D4EC608FEFB7E2A068D5777F091AD4C5,31345,17,23,6,109.39,18.29,1066
285419,5ABFF3E8EB470884C270C0C936A89A00,31561,14,16,2,109.56792,18.28479,1765
285463,0E5593A90D661690BE3DAAA17AD936E2,38127,2,8,6,109.50833,18.27222,1513
285464,0E5593A90D661690BE3DAAA17AD936E2,60641,9,10,1,109.53854,18.2359,1657
285465,0E5593A90D661690BE3DAAA17AD936E2,38073,13,15,2,109.40813,18.30958,1169
285470,DDE77D3A656666992FC3458B84010D43,39183,0,1,1,109.55542,18.28208,1715
285471,DDE77D3A656666992FC3458B84010D43,31561,5,11,6,109.56792,18.28479,1765
285472,DDE77D3A656666992FC3458B84010D43,39183,11,13,2,109.55542,18.28208,1715
285473,DDE77D3A656666992FC3458B84010D43,31561,15,21,6,109.56792,18.28479,1765
285476,40667E55EDAC334B8D18CEA71CBD34F4,30671,5,6,1,109.43611,18.30139,1268
285477,40667E55EDAC334B8D18CEA71CBD34F4,30111,7,13,6,109.47583,18.30542,1419
285478,40667E55EDAC334B8D18CEA71CBD34F4,30711,15,17,2,109.50271,18.25347,1510
285479,40667E55EDAC334B8D18CEA71CBD34F4,31081,18,20,2,109.44639,18.30181,1318
285499,CD01A34A2CB88E9393C292828422A88B,31071,0,8,8,109.58257,18.28458,1815
285500,CD01A34A2CB88E9393C292828422A88B,39183,8,10,2,109.55542,18.28208,1715
285501,CD01A34A2CB88E9393C292828422A88B,31561,15,17,2,109.56792,18.28479,1765
285505,5E8FF49D1CCDA711846608608C7FAE0D,31071,0,13,13,109.58257,18.28458,1815
285506,5E8FF49D1CCDA711846608608C7FAE0D,30854,15,16,1,109.56889,18.27076,1763
285507,2C3BD53A8702A47FB82F05FB4993B683,31561,0,1,1,109.56792,18.28479,1765
285508,2C3BD53A8702A47FB82F05FB4993B683,30851,4,5,1,109.5616,18.27396,1713
285509,2C3BD53A8702A47FB82F05FB4993B683,30854,7,8,1,109.56889,18.27076,1763
285534,28116E081E8AAFD89F4929BB4937EC6F,31471,16,17,1,109.34583,18.29563,917
285535,28116E081E8AAFD89F4929BB4937EC6F,60084,18,20,2,109.4984,18.2334,1507
285536,F6A1EBB84FE583E84185C423218578F5,31561,0,5,5,109.56792,18.28479,1765
285537,F6A1EBB84FE583E84185C423218578F5,39183,8,9,1,109.55542,18.28208,1715
285538,F6A1EBB84FE583E84185C423218578F5,39181,13,17,4,109.55153,18.28035,1715
285588,B5D5F035B558647FF9F44A76F16A1183,31521,1,3,2,109.51458,18.22542,1555
285589,B5D5F035B558647FF9F44A76F16A1183,38291,4,9,5,109.51618,18.24313,1558
285590,B5D5F035B558647FF9F44A76F16A1183,38754,12,13,1,109.74667,18.37382,2430
285591,B5D5F035B558647FF9F44A76F16A1183,30741,18,23,5,109.49833,18.28681,1516
285595,6A8C883D29A8AF90E102449F92489A64,31071,0,7,7,109.58257,18.28458,1815
285596,6A8C883D29A8AF90E102449F92489A64,30854,8,23,15,109.56889,18.27076,1763
285626,C3EC43179E51E2CA8AF203A259981D18,31071,1,2,1,109.58257,18.28458,1815
285627,C3EC43179E51E2CA8AF203A259981D18,30854,3,4,1,109.56889,18.27076,1763
285628,C3EC43179E51E2CA8AF203A259981D18,31071,4,7,3,109.58257,18.28458,1815
285629,C3EC43179E51E2CA8AF203A259981D18,30854,13,14,1,109.56889,18.27076,1763
285630,C3EC43179E51E2CA8AF203A259981D18,39091,15,17,2,109.50097,18.25222,1510
285631,C3EC43179E51E2CA8AF203A259981D18,30854,19,20,1,109.56889,18.27076,1763
285635,C83989AE2DFF8530CB3DF7DC45038FE9,60501,1,3,2,109.48701,18.29021,1466
285636,C83989AE2DFF8530CB3DF7DC45038FE9,60401,3,4,1,109.47444,18.27583,1414
285637,C83989AE2DFF8530CB3DF7DC45038FE9,60501,5,6,1,109.48701,18.29021,1466
285638,C83989AE2DFF8530CB3DF7DC45038FE9,60381,9,12,3,109.5241,18.22458,1605
285639,C83989AE2DFF8530CB3DF7DC45038FE9,38094,17,20,3,109.45403,18.28778,1316
285640,D42D82F7F77C55013F0EAB7E35E2211F,31071,3,12,9,109.58257,18.28458,1815
285641,D42D82F7F77C55013F0EAB7E35E2211F,30531,14,22,8,109.53271,18.21472,1604
285652,202870BA524F8D7E9C1B66336BF1F034,30071,0,5,5,109.52819,18.30472,1619
285653,202870BA524F8D7E9C1B66336BF1F034,30854,6,14,8,109.56889,18.27076,1763
285654,202870BA524F8D7E9C1B66336BF1F034,31951,19,21,2,109.52174,18.30299,1568
285662,D39D64452E6BBEF7B3056CA239E1B86E,30854,5,6,1,109.56889,18.27076,1763
285663,D39D64452E6BBEF7B3056CA239E1B86E,31561,6,11,5,109.56792,18.28479,1765
285664,D39D64452E6BBEF7B3056CA239E1B86E,30854,12,14,2,109.56889,18.27076,1763
285665,D39D64452E6BBEF7B3056CA239E1B86E,31561,14,16,2,109.56792,18.28479,1765
285666,D39D64452E6BBEF7B3056CA239E1B86E,30854,20,21,1,109.56889,18.27076,1763
285674,DB798956536E34BEF89E44767CA861D4,38707,14,21,7,109.73778,18.35368,2427
285675,DB798956536E34BEF89E44767CA861D4,38707,22,23,1,109.73778,18.35368,2427
285683,6AB767DCB04AF3E40F2C84ECB27A5395,30421,0,6,6,109.50021,18.25861,1511
285684,6AB767DCB04AF3E40F2C84ECB27A5395,30611,6,7,1,109.74958,18.40188,2485
285709,CF90889F587C2BB558DFC8DC65DE1B88,31471,15,16,1,109.34583,18.29563,917
285710,CF90889F587C2BB558DFC8DC65DE1B88,38071,18,20,2,109.40722,18.30938,1169
285735,8B3BFB924B3B7EA2496E534FC9BE57E6,31461,0,7,7,109.5091,18.25389,1510
285736,8B3BFB924B3B7EA2496E534FC9BE57E6,30281,8,9,1,109.50597,18.27583,1514
285740,34AB502A442AA8EA4A7FB30471B204DB,39061,1,2,1,109.38222,18.28958,1066
285741,34AB502A442AA8EA4A7FB30471B204DB,60621,2,7,5,109.48354,18.27451,1464
285742,34AB502A442AA8EA4A7FB30471B204DB,60401,8,11,3,109.47444,18.27583,1414
285743,34AB502A442AA8EA4A7FB30471B204DB,60621,15,17,2,109.48354,18.27451,1464
285744,34AB502A442AA8EA4A7FB30471B204DB,60401,19,20,1,109.47444,18.27583,1414
285745,34AB502A442AA8EA4A7FB30471B204DB,60621,21,23,2,109.48354,18.27451,1464
285772,8BE0A55E9934E22BDB38595AA5D1AD74,30531,3,7,4,109.53271,18.21472,1604
285777,6FDD8510FC3FD17D36965B0963BD7329,30854,0,5,5,109.56889,18.27076,1763
285778,6FDD8510FC3FD17D36965B0963BD7329,31561,6,7,1,109.56792,18.28479,1765
285779,6FDD8510FC3FD17D36965B0963BD7329,30854,8,11,3,109.56889,18.27076,1763
285780,6FDD8510FC3FD17D36965B0963BD7329,31561,12,16,4,109.56792,18.28479,1765
285781,6FDD8510FC3FD17D36965B0963BD7329,30854,20,22,2,109.56889,18.27076,1763
285782,6FDD8510FC3FD17D36965B0963BD7329,39371,22,23,1,109.56627,18.2646,1762
285783,4BCFB9B7DA47F954D069C9FF9050BF88,31071,7,9,2,109.58257,18.28458,1815
285784,4BCFB9B7DA47F954D069C9FF9050BF88,30854,11,12,1,109.56889,18.27076,1763
285785,4BCFB9B7DA47F954D069C9FF9050BF88,31071,13,15,2,109.58257,18.28458,1815
285829,EA0A0AF0068B5147927AE92739E130DD,38951,0,8,8,109.48097,18.28868,1416
285830,EA0A0AF0068B5147927AE92739E130DD,60614,10,11,1,109.48799,18.29521,1467
285831,EA0A0AF0068B5147927AE92739E130DD,30581,12,14,2,109.62257,18.24951,1959
285832,EA0A0AF0068B5147927AE92739E130DD,38951,18,23,5,109.48097,18.28868,1416
285833,F8270512EC6061AB32BEF04D77D542E3,31531,0,11,11,109.49583,18.25972,1461
285834,F8270512EC6061AB32BEF04D77D542E3,60054,13,14,1,109.3016,18.31229,770
285835,F8270512EC6061AB32BEF04D77D542E3,31531,17,23,6,109.49583,18.25972,1461
285848,0695D4E7B3E726CA09D841B87798B560,30854,2,5,3,109.56889,18.27076,1763
285849,0695D4E7B3E726CA09D841B87798B560,60354,6,7,1,109.58701,18.28521,1815
285850,0695D4E7B3E726CA09D841B87798B560,30854,7,12,5,109.56889,18.27076,1763
285853,B712327B6033C61F37801CFD6DAC08AD,38484,5,8,3,109.53028,18.31528,1620
285854,B712327B6033C61F37801CFD6DAC08AD,38484,8,10,2,109.53028,18.31528,1620
285855,B712327B6033C61F37801CFD6DAC08AD,38484,12,22,10,109.53028,18.31528,1620
285863,498749BB2BA481D5A422CC677A8DD529,38013,16,17,1,109.49514,18.21951,1454
285864,498749BB2BA481D5A422CC677A8DD529,60201,17,22,5,109.5041,18.2509,1510
285884,B7911D9D9A3AB9DF64A3B23E6A7B118E,60201,0,3,3,109.5041,18.2509,1510
285885,B7911D9D9A3AB9DF64A3B23E6A7B118E,60291,3,6,3,109.50826,18.24639,1509
285886,B7911D9D9A3AB9DF64A3B23E6A7B118E,60201,8,10,2,109.5041,18.2509,1510
285908,351B393D9DF8729A4AFCF776A3D974C6,60054,17,18,1,109.3016,18.31229,770
285909,351B393D9DF8729A4AFCF776A3D974C6,30661,19,23,4,109.37028,18.24361,1008
285912,DF296B63A64E364FCDA4C38B0935EEEE,30511,0,15,15,109.51069,18.24208,1558
285913,DF296B63A64E364FCDA4C38B0935EEEE,30511,17,23,6,109.51069,18.24208,1558
285919,8F99FBAD46040867B6C8F52DEFB54488,60621,0,8,8,109.48354,18.27451,1464
285920,8F99FBAD46040867B6C8F52DEFB54488,31681,10,14,4,109.40396,18.29979,1168
285921,8F99FBAD46040867B6C8F52DEFB54488,60541,14,16,2,109.4084,18.29208,1167
285924,8EF00336DF81276A821E166696CFF524,30721,3,6,3,109.51597,18.28257,1565
285925,8EF00336DF81276A821E166696CFF524,31931,6,7,1,109.54771,18.29403,1667
285926,8EF00336DF81276A821E166696CFF524,30721,8,16,8,109.51597,18.28257,1565
285927,8EF00336DF81276A821E166696CFF524,30771,18,20,2,109.49938,18.26042,1511
285928,6A8BCB0608F5D72D88191DC3AF22DB09,38321,0,9,9,109.39854,18.29132,1116
285929,6A8BCB0608F5D72D88191DC3AF22DB09,38325,13,16,3,109.39792,18.2909,1116
285930,6A8BCB0608F5D72D88191DC3AF22DB09,38321,17,21,4,109.39854,18.29132,1116
285982,06A941D50D485A4C433548955BEB89BA,30854,12,17,5,109.56889,18.27076,1763
285983,06A941D50D485A4C433548955BEB89BA,31071,22,23,1,109.58257,18.28458,1815
285986,E75FA91D1B3B8DD834D1B7D77ECFF056,39321,0,7,7,109.529,18.2167,1604
285987,E75FA91D1B3B8DD834D1B7D77ECFF056,31521,8,10,2,109.51458,18.22542,1555
285988,E75FA91D1B3B8DD834D1B7D77ECFF056,30661,11,15,4,109.37028,18.24361,1008
285989,E75FA91D1B3B8DD834D1B7D77ECFF056,30361,19,20,1,109.50347,18.24,1508
286008,3577995E8CD33652301277CD38C2DCFC,60551,18,20,2,109.42722,18.30111,1218
286009,3577995E8CD33652301277CD38C2DCFC,31061,21,23,2,109.53333,18.23257,1607
286010,4E42F3C8BFACF58FB6187931BEBBDF23,30711,19,20,1,109.50271,18.25347,1510
286011,4E42F3C8BFACF58FB6187931BEBBDF23,38484,22,23,1,109.53028,18.31528,1620
286066,B78E7295CB13532B4E2C30EF158E297F,31931,0,3,3,109.54771,18.29403,1667
286067,B78E7295CB13532B4E2C30EF158E297F,30854,5,6,1,109.56889,18.27076,1763
286068,B78E7295CB13532B4E2C30EF158E297F,39183,10,11,1,109.55542,18.28208,1715
286069,B78E7295CB13532B4E2C30EF158E297F,30854,13,14,1,109.56889,18.27076,1763
286147,B0E2159906E2F066EA26580E9E3FC6C5,31031,15,17,2,109.49979,18.25382,1510
286148,B0E2159906E2F066EA26580E9E3FC6C5,30341,18,20,2,109.3625,18.29167,966
286149,B0E2159906E2F066EA26580E9E3FC6C5,39061,21,23,2,109.38222,18.28958,1066
286161,5291560AC3CA28497E4CB7832DDE2A8C,38754,14,16,2,109.74667,18.37382,2430
286165,CC6A63734928B4CD8F414AAB01241B9F,31311,14,23,9,109.72299,18.27438,2364
286191,EF5798057F15484DEF72C8FF2C7F52C1,30111,0,7,7,109.47583,18.30542,1419
286192,EF5798057F15484DEF72C8FF2C7F52C1,38361,7,8,1,109.43667,18.29201,1267
286193,EF5798057F15484DEF72C8FF2C7F52C1,31781,13,15,2,109.19847,18.2975,367
286194,EF5798057F15484DEF72C8FF2C7F52C1,30421,18,20,2,109.50021,18.25861,1511
286195,EF5798057F15484DEF72C8FF2C7F52C1,38361,21,22,1,109.43667,18.29201,1267
286224,B409DEC5C276D0BBD1EAC5AE6529019E,31101,0,8,8,109.65389,18.23403,2057
286225,B409DEC5C276D0BBD1EAC5AE6529019E,31471,11,13,2,109.34583,18.29563,917
286226,B409DEC5C276D0BBD1EAC5AE6529019E,30421,16,18,2,109.50021,18.25861,1511
286227,B409DEC5C276D0BBD1EAC5AE6529019E,31101,19,23,4,109.65389,18.23403,2057
286273,423E2A7AD06C927EE0BD23EE3AB605E3,30854,0,11,11,109.56889,18.27076,1763
286274,423E2A7AD06C927EE0BD23EE3AB605E3,30681,12,22,10,109.48493,18.26917,1463
286319,97C31877CA4226D0F1BA1C0E12066B56,60331,1,3,2,109.505,18.26507,1512
286320,97C31877CA4226D0F1BA1C0E12066B56,39053,3,6,3,109.511,18.2771,1564
286321,97C31877CA4226D0F1BA1C0E12066B56,30854,7,17,10,109.56889,18.27076,1763
286322,97C31877CA4226D0F1BA1C0E12066B56,60331,19,22,3,109.505,18.26507,1512
286335,A549C024E6F63EDBD3DC866F10DB11CE,30234,0,1,1,109.60681,18.29979,1918
286336,A549C024E6F63EDBD3DC866F10DB11CE,31945,2,5,3,109.58021,18.29403,1817
286337,A549C024E6F63EDBD3DC866F10DB11CE,30854,8,22,14,109.56889,18.27076,1763
286373,A749E400BFD3B5908671E939EC104DEE,30854,0,1,1,109.56889,18.27076,1763
286374,A749E400BFD3B5908671E939EC104DEE,31071,1,5,4,109.58257,18.28458,1815
286375,A749E400BFD3B5908671E939EC104DEE,30854,6,8,2,109.56889,18.27076,1763
286376,A749E400BFD3B5908671E939EC104DEE,31071,11,13,2,109.58257,18.28458,1815
286377,A749E400BFD3B5908671E939EC104DEE,30854,13,23,10,109.56889,18.27076,1763
286378,E4B522EF4348156010E5C578EC13D60F,30234,0,7,7,109.60681,18.29979,1918
286379,E4B522EF4348156010E5C578EC13D60F,30854,8,17,9,109.56889,18.27076,1763
286380,E4B522EF4348156010E5C578EC13D60F,60371,18,20,2,109.53063,18.30056,1618
286381,8ED1BCC2D2A319298B3669D3F81BDCBA,30071,13,15,2,109.52819,18.30472,1619
286382,8ED1BCC2D2A319298B3669D3F81BDCBA,60361,15,16,1,109.51938,18.29681,1567
286383,8ED1BCC2D2A319298B3669D3F81BDCBA,60241,20,23,3,109.53319,18.28667,1616
286384,F25102D4BE48A66B8AE50787215C5331,31231,13,14,1,109.42597,18.29292,1217
286385,F25102D4BE48A66B8AE50787215C5331,31231,15,18,3,109.42597,18.29292,1217
286386,560794A44CA17A43FA34D0FA6C339747,30854,1,11,10,109.56889,18.27076,1763
286387,560794A44CA17A43FA34D0FA6C339747,39091,14,17,3,109.50097,18.25222,1510
286388,560794A44CA17A43FA34D0FA6C339747,30854,20,21,1,109.56889,18.27076,1763
286434,608A55C14BAB2A5B627ACC1F39B89FB6,31945,0,7,7,109.58021,18.29403,1817
286435,608A55C14BAB2A5B627ACC1F39B89FB6,30854,8,12,4,109.56889,18.27076,1763
286436,608A55C14BAB2A5B627ACC1F39B89FB6,60291,15,16,1,109.50826,18.24639,1509
286437,608A55C14BAB2A5B627ACC1F39B89FB6,31945,21,23,2,109.58021,18.29403,1817
286453,DF7D05791F495697561E86BE7F56BDEA,48574,0,5,5,109.48931,18.28458,1465
286454,DF7D05791F495697561E86BE7F56BDEA,31864,7,8,1,109.49014,18.28333,1465
286455,DF7D05791F495697561E86BE7F56BDEA,31145,13,14,1,109.20431,18.30479,369
286502,10EBF762D28520B09848288F7052CFDE,30854,1,6,5,109.56889,18.27076,1763
286503,10EBF762D28520B09848288F7052CFDE,39101,7,15,8,109.50132,18.24931,1509
286504,10EBF762D28520B09848288F7052CFDE,30161,15,17,2,109.50042,18.24389,1508
286505,10EBF762D28520B09848288F7052CFDE,30854,17,20,3,109.56889,18.27076,1763
286518,6E6193514D8E876D83956A94AD4F3FB1,31931,11,13,2,109.54771,18.29403,1667
286519,6E6193514D8E876D83956A94AD4F3FB1,30921,14,16,2,109.53903,18.29451,1667
286520,6E6193514D8E876D83956A94AD4F3FB1,31931,17,22,5,109.54771,18.29403,1667
286524,F96F24B681A63D2B4D1EB8E140BFDADD,60291,0,1,1,109.50826,18.24639,1509
286525,F96F24B681A63D2B4D1EB8E140BFDADD,60371,2,13,11,109.53063,18.30056,1618
286526,F96F24B681A63D2B4D1EB8E140BFDADD,30764,16,18,2,109.45806,18.29486,1367
286527,F96F24B681A63D2B4D1EB8E140BFDADD,30391,21,23,2,109.4975,18.27118,1513
286619,B621E9075674E792CCB217233825F9D1,60591,16,17,1,109.61118,18.21715,1904
286620,B621E9075674E792CCB217233825F9D1,30854,20,21,1,109.56889,18.27076,1763
286621,0B1C0030B7865DFAE9344BEBBB9387DA,31701,20,22,2,109.44132,18.28833,1266
286622,0B1C0030B7865DFAE9344BEBBB9387DA,38871,22,23,1,109.44681,18.28625,1316
286652,4FF898565DD7944316E0D48964B03B74,60631,0,7,7,109.57778,18.27583,1814
286653,4FF898565DD7944316E0D48964B03B74,38754,11,13,2,109.74667,18.37382,2430
286661,87F903487927969F9F9804112E5F8E6C,31551,12,13,1,109.55868,18.24222,1708
286662,87F903487927969F9F9804112E5F8E6C,31554,13,15,2,109.55521,18.2459,1709
286663,87F903487927969F9F9804112E5F8E6C,31551,15,23,8,109.55868,18.24222,1708
286672,FD383D619F571E97F6F509FAB965E5A5,31945,12,13,1,109.58021,18.29403,1817
286673,FD383D619F571E97F6F509FAB965E5A5,60571,14,15,1,109.50722,18.25056,1510
286674,FD383D619F571E97F6F509FAB965E5A5,30711,18,19,1,109.50271,18.25347,1510
286675,FD383D619F571E97F6F509FAB965E5A5,60571,20,23,3,109.50722,18.25056,1510
286681,37DC2EF674B0D61C6D10D120CF46E31D,60221,0,10,10,109.52569,18.29188,1616
286682,37DC2EF674B0D61C6D10D120CF46E31D,31461,10,14,4,109.5091,18.25389,1510
286683,37DC2EF674B0D61C6D10D120CF46E31D,31461,15,17,2,109.5091,18.25389,1510
286684,37DC2EF674B0D61C6D10D120CF46E31D,31031,19,21,2,109.49979,18.25382,1510
286685,7AF4921BC4D1712A961904D0ECC91550,30071,19,20,1,109.52819,18.30472,1619
286686,7AF4921BC4D1712A961904D0ECC91550,60251,21,23,2,109.51229,18.325,1572
286687,0F558B6653C655C7F0BAEA9D66B33F57,31071,2,5,3,109.58257,18.28458,1815
286688,0F558B6653C655C7F0BAEA9D66B33F57,30854,10,14,4,109.56889,18.27076,1763
286689,1026894DC5FF9A7FAF3A2EE28B95E239,39183,0,7,7,109.55542,18.28208,1715
286690,1026894DC5FF9A7FAF3A2EE28B95E239,30854,12,22,10,109.56889,18.27076,1763
286691,F9F2694056D54C70B8E94D439CF649C0,38331,0,10,10,109.62465,18.22736,1956
286692,F9F2694056D54C70B8E94D439CF649C0,30961,12,13,1,109.74042,18.37903,2431
286693,F9F2694056D54C70B8E94D439CF649C0,38331,15,17,2,109.62465,18.22736,1956
286694,F9F2694056D54C70B8E94D439CF649C0,30421,20,21,1,109.50021,18.25861,1511
286706,7421066246AAD1C230E7E2A7ADF06E9D,30854,13,17,4,109.56889,18.27076,1763
286707,7421066246AAD1C230E7E2A7ADF06E9D,60631,19,23,4,109.57778,18.27583,1814
286721,038CFE3BAB72C52C0044D8CB5F2DC114,31271,0,7,7,109.48958,18.26257,1462
286722,038CFE3BAB72C52C0044D8CB5F2DC114,31781,9,11,2,109.19847,18.2975,367
286723,038CFE3BAB72C52C0044D8CB5F2DC114,31471,13,15,2,109.34583,18.29563,917
286732,76BE31A5F3F086E80A8D63C4F3D6881F,38241,12,23,11,109.54111,18.30542,1669
286737,A01B4012B619D942E7CC3AC9B78722B4,31561,0,1,1,109.56792,18.28479,1765
286738,A01B4012B619D942E7CC3AC9B78722B4,30854,1,2,1,109.56889,18.27076,1763
286739,A01B4012B619D942E7CC3AC9B78722B4,39181,5,7,2,109.55153,18.28035,1715
286740,A01B4012B619D942E7CC3AC9B78722B4,39183,7,8,1,109.55542,18.28208,1715
286741,A01B4012B619D942E7CC3AC9B78722B4,31561,11,12,1,109.56792,18.28479,1765
286742,A01B4012B619D942E7CC3AC9B78722B4,31931,13,16,3,109.54771,18.29403,1667
286743,A01B4012B619D942E7CC3AC9B78722B4,31561,19,23,4,109.56792,18.28479,1765
286762,417408FFDA93B177641D270D3A5C4B2D,30854,6,9,3,109.56889,18.27076,1763
286763,417408FFDA93B177641D270D3A5C4B2D,31071,12,23,11,109.58257,18.28458,1815
286768,A01E2FD84FFE4D782E40311D1ABC1ECB,39053,0,15,15,109.511,18.2771,1564
286769,A01E2FD84FFE4D782E40311D1ABC1ECB,60171,16,17,1,109.51292,18.30694,1569
286773,9B2F541E3AA85490CB47FF66EE68B366,60621,0,7,7,109.48354,18.27451,1464
286774,9B2F541E3AA85490CB47FF66EE68B366,30661,10,12,2,109.37028,18.24361,1008
286775,9B2F541E3AA85490CB47FF66EE68B366,60054,12,14,2,109.3016,18.31229,770
286829,657A4EA3E74EF96B5CC254B1107F90DF,31461,10,21,11,109.5091,18.25389,1510
286830,657A4EA3E74EF96B5CC254B1107F90DF,30721,21,22,1,109.51597,18.28257,1565
286831,A4743972EC2FC58546DD11935BDC0E1A,31091,0,1,1,109.41201,18.31222,1170
286832,A4743972EC2FC58546DD11935BDC0E1A,39091,2,5,3,109.50097,18.25222,1510
286833,A4743972EC2FC58546DD11935BDC0E1A,39091,9,19,10,109.50097,18.25222,1510
286862,AAD294F97E8F953422B544ED61B36D13,31071,0,7,7,109.58257,18.28458,1815
286863,AAD294F97E8F953422B544ED61B36D13,31551,8,9,1,109.55868,18.24222,1708
286864,AAD294F97E8F953422B544ED61B36D13,30851,12,17,5,109.5616,18.27396,1713
286865,AAD294F97E8F953422B544ED61B36D13,31071,18,22,4,109.58257,18.28458,1815
286920,D4448A1349B0563C78F16B479359A95F,30854,14,19,5,109.56889,18.27076,1763
286921,D4448A1349B0563C78F16B479359A95F,31945,22,23,1,109.58021,18.29403,1817
286932,D2A5F87218CF25385163A2F3C4229CB8,30851,0,4,4,109.5616,18.27396,1713
286933,D2A5F87218CF25385163A2F3C4229CB8,31561,5,14,9,109.56792,18.28479,1765
286944,DF49F834C08C7E8FA6D78272EE1FB651,60361,0,7,7,109.51938,18.29681,1567
286945,DF49F834C08C7E8FA6D78272EE1FB651,30951,8,14,6,109.56208,18.25667,1761
286946,DF49F834C08C7E8FA6D78272EE1FB651,60221,18,20,2,109.52569,18.29188,1616
286947,DF49F834C08C7E8FA6D78272EE1FB651,60361,21,23,2,109.51938,18.29681,1567
286948,8438CC455C7563000E5EA4C29E329C92,38105,0,1,1,109.40299,18.29229,1117
286949,8438CC455C7563000E5EA4C29E329C92,30661,1,4,3,109.37028,18.24361,1008
286950,8438CC455C7563000E5EA4C29E329C92,60301,9,10,1,109.60715,18.30993,1919
286951,8438CC455C7563000E5EA4C29E329C92,31031,13,14,1,109.49979,18.25382,1510
286952,8438CC455C7563000E5EA4C29E329C92,60541,15,18,3,109.4084,18.29208,1167
286963,C1602FB5A20BD98313F7CC13F431D061,30271,0,7,7,109.49132,18.23153,1456
286964,C1602FB5A20BD98313F7CC13F431D061,30771,8,9,1,109.49938,18.26042,1511
286965,C1602FB5A20BD98313F7CC13F431D061,30201,12,13,1,109.4909,18.26465,1462
286966,C1602FB5A20BD98313F7CC13F431D061,31271,18,22,4,109.48958,18.26257,1462
286972,5D568A6526CDB002A506317E6EBEA84B,39091,12,13,1,109.50097,18.25222,1510
286973,5D568A6526CDB002A506317E6EBEA84B,31101,16,18,2,109.65389,18.23403,2057
286974,5D568A6526CDB002A506317E6EBEA84B,38094,22,23,1,109.45403,18.28778,1316
286986,BD4652414D5C17466BA36FD4BD943A94,30721,1,5,4,109.51597,18.28257,1565
286987,BD4652414D5C17466BA36FD4BD943A94,60221,5,7,2,109.52569,18.29188,1616
286988,BD4652414D5C17466BA36FD4BD943A94,31931,9,15,6,109.54771,18.29403,1667
286989,BD4652414D5C17466BA36FD4BD943A94,39183,17,18,1,109.55542,18.28208,1715
286990,BD4652414D5C17466BA36FD4BD943A94,30421,20,22,2,109.50021,18.25861,1511
287022,D6B14C7387647D8C883334DAFB518257,31071,0,7,7,109.58257,18.28458,1815
287023,D6B14C7387647D8C883334DAFB518257,30854,8,9,1,109.56889,18.27076,1763
287024,D6B14C7387647D8C883334DAFB518257,31071,14,15,1,109.58257,18.28458,1815
287030,F6B4440E38BBCA4B2FC80E6C91E4573A,60381,18,19,1,109.5241,18.22458,1605
287031,F6B4440E38BBCA4B2FC80E6C91E4573A,38111,20,22,2,109.52007,18.22403,1555
287039,D517610C2076C41FED0ED80CB6FFB44C,31561,0,4,4,109.56792,18.28479,1765
287040,D517610C2076C41FED0ED80CB6FFB44C,30851,4,20,16,109.5616,18.27396,1713
287071,528F99F7FD8CA49B85B45B64A5D784BA,39183,0,1,1,109.55542,18.28208,1715
287072,528F99F7FD8CA49B85B45B64A5D784BA,30851,1,6,5,109.5616,18.27396,1713
287073,528F99F7FD8CA49B85B45B64A5D784BA,39183,6,9,3,109.55542,18.28208,1715
287074,528F99F7FD8CA49B85B45B64A5D784BA,30851,12,18,6,109.5616,18.27396,1713
287075,528F99F7FD8CA49B85B45B64A5D784BA,39183,20,22,2,109.55542,18.28208,1715
287080,6128117B6C62D97BBF6E959D2F3E0A2E,39181,0,5,5,109.55153,18.28035,1715
287081,6128117B6C62D97BBF6E959D2F3E0A2E,39183,7,8,1,109.55542,18.28208,1715
287082,6128117B6C62D97BBF6E959D2F3E0A2E,39181,10,13,3,109.55153,18.28035,1715
287083,6128117B6C62D97BBF6E959D2F3E0A2E,39181,14,16,2,109.55153,18.28035,1715
287084,6128117B6C62D97BBF6E959D2F3E0A2E,39181,17,23,6,109.55153,18.28035,1715
287092,9C52FC38B7F498775E1F72BEBF4C0CB1,30084,0,6,6,109.50118,18.26972,1513
287093,9C52FC38B7F498775E1F72BEBF4C0CB1,31931,7,18,11,109.54771,18.29403,1667
287094,9C52FC38B7F498775E1F72BEBF4C0CB1,30084,18,23,5,109.50118,18.26972,1513
287102,C85D0B931BEF54F05B9ABBBB03212DB7,30854,0,9,9,109.56889,18.27076,1763
287103,C85D0B931BEF54F05B9ABBBB03212DB7,31561,14,15,1,109.56792,18.28479,1765
287104,C85D0B931BEF54F05B9ABBBB03212DB7,30854,18,20,2,109.56889,18.27076,1763
287168,324899445F811D5785FB336DE18DAC0E,38251,0,5,5,109.49618,18.25493,1510
287173,B3F4E43DA3C4E855A3ED684A6CB97F36,31101,11,13,2,109.65389,18.23403,2057
287174,B3F4E43DA3C4E855A3ED684A6CB97F36,31931,16,18,2,109.54771,18.29403,1667
287175,B3F4E43DA3C4E855A3ED684A6CB97F36,30921,18,20,2,109.53903,18.29451,1667
287176,7B2AEE2086698683607EDDDB4B678234,60241,0,6,6,109.53319,18.28667,1616
287177,7B2AEE2086698683607EDDDB4B678234,38154,11,21,10,109.5266,18.28278,1615
287178,410D55EA73A3884577B7B9B7E86B067E,30081,0,7,7,109.50243,18.26632,1512
287179,410D55EA73A3884577B7B9B7E86B067E,30084,8,10,2,109.50118,18.26972,1513
287180,410D55EA73A3884577B7B9B7E86B067E,30161,12,13,1,109.50042,18.24389,1508
287181,410D55EA73A3884577B7B9B7E86B067E,31205,17,18,1,109.51111,18.23736,1557
287219,2A6BA0678DDF16AF08BAC9E3FA3C9391,30854,0,1,1,109.56889,18.27076,1763
287220,2A6BA0678DDF16AF08BAC9E3FA3C9391,31561,2,6,4,109.56792,18.28479,1765
287221,2A6BA0678DDF16AF08BAC9E3FA3C9391,30854,8,10,2,109.56889,18.27076,1763
287222,2A6BA0678DDF16AF08BAC9E3FA3C9391,60631,13,15,2,109.57778,18.27583,1814
287223,2A6BA0678DDF16AF08BAC9E3FA3C9391,30854,19,21,2,109.56889,18.27076,1763
287224,2A6BA0678DDF16AF08BAC9E3FA3C9391,31561,22,23,1,109.56792,18.28479,1765
287238,CD5E350ACE5E316FFBEE8002214CC92F,38951,0,2,2,109.48097,18.28868,1416
287239,CD5E350ACE5E316FFBEE8002214CC92F,60614,2,3,1,109.48799,18.29521,1467
287240,CD5E350ACE5E316FFBEE8002214CC92F,38951,4,7,3,109.48097,18.28868,1416
287241,CD5E350ACE5E316FFBEE8002214CC92F,33051,11,13,2,109.6475,18.46618,2096
287279,75817DB682187A07461734D66E1E6492,60631,16,17,1,109.57778,18.27583,1814
287280,75817DB682187A07461734D66E1E6492,31061,19,21,2,109.53333,18.23257,1607
287281,75817DB682187A07461734D66E1E6492,60631,22,23,1,109.57778,18.27583,1814
287288,66E3180E5EB7A1180EBED2610556A747,30854,9,13,4,109.56889,18.27076,1763
287289,66E3180E5EB7A1180EBED2610556A747,38071,15,16,1,109.40722,18.30938,1169
287307,005F3AEFE6DBF371ED1FD57736434098,31071,0,7,7,109.58257,18.28458,1815
287308,005F3AEFE6DBF371ED1FD57736434098,30854,7,16,9,109.56889,18.27076,1763
287309,005F3AEFE6DBF371ED1FD57736434098,31461,18,20,2,109.5091,18.25389,1510
287331,23F112CDAD42EDA0343C8378CD8AF33B,30071,15,19,4,109.52819,18.30472,1619
287332,23F112CDAD42EDA0343C8378CD8AF33B,30761,20,23,3,109.45201,18.3,1318
287347,05DA91756164E5EE566D718E5FCD0EDE,31021,6,8,2,109.49021,18.27,1463
287348,05DA91756164E5EE566D718E5FCD0EDE,30921,11,12,1,109.53903,18.29451,1667
287349,05DA91756164E5EE566D718E5FCD0EDE,31931,16,22,6,109.54771,18.29403,1667
287364,28CEE342E171AF6D7A347D19C045375D,31031,12,13,1,109.49979,18.25382,1510
287365,28CEE342E171AF6D7A347D19C045375D,60131,14,16,2,109.49819,18.24778,1509
287366,28CEE342E171AF6D7A347D19C045375D,38251,17,19,2,109.49618,18.25493,1510
287367,28CEE342E171AF6D7A347D19C045375D,60131,19,22,3,109.49819,18.24778,1509
287381,8D8AA41210FC9E2D5DD4D81CF4DB18D7,31261,18,20,2,109.51174,18.2466,1559
287382,8D8AA41210FC9E2D5DD4D81CF4DB18D7,60371,21,23,2,109.53063,18.30056,1618
287383,2C55471E74B61CE990E34C5B57C44227,30661,12,14,2,109.37028,18.24361,1008
287384,2C55471E74B61CE990E34C5B57C44227,31471,17,18,1,109.34583,18.29563,917
287385,2C55471E74B61CE990E34C5B57C44227,31531,21,23,2,109.49583,18.25972,1461
287390,ABCD0851CC1C78BCD7AF6DBDF2F5DE49,60552,1,16,15,109.41729,18.30014,1218
287391,ABCD0851CC1C78BCD7AF6DBDF2F5DE49,60401,17,19,2,109.47444,18.27583,1414
287392,ABCD0851CC1C78BCD7AF6DBDF2F5DE49,60552,19,20,1,109.41729,18.30014,1218
287393,5E97A4561E11AAC4FBC53FD068EAA52B,30854,0,7,7,109.56889,18.27076,1763
287394,5E97A4561E11AAC4FBC53FD068EAA52B,30531,11,18,7,109.53271,18.21472,1604
287395,5E97A4561E11AAC4FBC53FD068EAA52B,30854,21,23,2,109.56889,18.27076,1763
287404,C19430CE8DF26BDEF43903E57E682236,31561,0,6,6,109.56792,18.28479,1765
287405,C19430CE8DF26BDEF43903E57E682236,30854,9,11,2,109.56889,18.27076,1763
287406,C19430CE8DF26BDEF43903E57E682236,31561,11,23,12,109.56792,18.28479,1765
287419,E6541B4F346982101D887BAAF0315541,30854,0,7,7,109.56889,18.27076,1763
287420,E6541B4F346982101D887BAAF0315541,31561,11,17,6,109.56792,18.28479,1765
287463,B643AC77F8D8498A9694D45BA8B0F75F,60631,6,16,10,109.57778,18.27583,1814
287464,B643AC77F8D8498A9694D45BA8B0F75F,31561,20,21,1,109.56792,18.28479,1765
287473,46D654A74218E904EECC2C762753A449,30721,0,7,7,109.51597,18.28257,1565
287474,46D654A74218E904EECC2C762753A449,31471,8,20,12,109.34583,18.29563,917
287475,46D654A74218E904EECC2C762753A449,31471,20,23,3,109.34583,18.29563,917
287476,7252A0F90E29EC78621699C082578EF7,60504,17,18,1,109.47917,18.28903,1416
287477,7252A0F90E29EC78621699C082578EF7,30711,21,23,2,109.50271,18.25347,1510
287487,CE70D3AAC3EF6B01DB8A5F34BD94E77D,30821,0,5,5,109.43681,18.33639,1274
287488,CE70D3AAC3EF6B01DB8A5F34BD94E77D,30651,6,9,3,109.42611,18.385,1232
287498,DF5EBFA9D0614A60E8475DE83F0E910D,30151,0,7,7,109.50986,18.25083,1560
287499,DF5EBFA9D0614A60E8475DE83F0E910D,60201,8,9,1,109.5041,18.2509,1510
287500,DF5EBFA9D0614A60E8475DE83F0E910D,30711,12,13,1,109.50271,18.25347,1510
287501,DF5EBFA9D0614A60E8475DE83F0E910D,60201,18,19,1,109.5041,18.2509,1510
287521,40DABE6BE6CCF789940333375D2A2151,31101,14,15,1,109.65389,18.23403,2057
287522,40DABE6BE6CCF789940333375D2A2151,31431,16,18,2,109.44639,18.29042,1316
287523,40DABE6BE6CCF789940333375D2A2151,38871,19,23,4,109.44681,18.28625,1316
287533,373156888A7658CC58BA3E147DEF7EF4,30361,0,5,5,109.50347,18.24,1508
287534,373156888A7658CC58BA3E147DEF7EF4,31201,6,11,5,109.51042,18.23819,1558
287535,373156888A7658CC58BA3E147DEF7EF4,30361,11,13,2,109.50347,18.24,1508
287536,373156888A7658CC58BA3E147DEF7EF4,31201,13,17,4,109.51042,18.23819,1558
287537,373156888A7658CC58BA3E147DEF7EF4,31391,19,23,4,109.50382,18.24285,1508
287549,27BCEF3137923B84211F08830816C810,31561,20,21,1,109.56792,18.28479,1765
287598,4995463B780282C9C030A19D9F49AEAC,31071,0,7,7,109.58257,18.28458,1815
287599,4995463B780282C9C030A19D9F49AEAC,30854,7,13,6,109.56889,18.27076,1763
287600,3B291F57EEFD567A00FF0922580412BD,60054,13,14,1,109.3016,18.31229,770
287601,3B291F57EEFD567A00FF0922580412BD,31431,17,19,2,109.44639,18.29042,1316
287602,3B291F57EEFD567A00FF0922580412BD,31061,21,23,2,109.53333,18.23257,1607
287615,4E94ADAE7ABEB20EEFAF67519DFCC1BE,31081,0,8,8,109.44639,18.30181,1318
287616,4E94ADAE7ABEB20EEFAF67519DFCC1BE,31031,9,22,13,109.49979,18.25382,1510
287620,3A5B976B6C5A145A5BAEFCC99C78F339,30071,3,9,6,109.52819,18.30472,1619
287621,3A5B976B6C5A145A5BAEFCC99C78F339,31931,11,22,11,109.54771,18.29403,1667
287646,22DF08AB8625FB5CE36A655BC50A3649,30711,0,7,7,109.50271,18.25347,1510
287647,22DF08AB8625FB5CE36A655BC50A3649,60281,8,9,1,109.51743,18.25924,1561
287648,22DF08AB8625FB5CE36A655BC50A3649,38911,11,13,2,109.51674,18.24965,1559
287674,6FBDDF7419820F8908B8A8CE3C81E7C3,60401,16,21,5,109.47444,18.27583,1414
287675,6FBDDF7419820F8908B8A8CE3C81E7C3,30171,21,23,2,109.48458,18.27139,1463
287706,F198CAA1F49ACA5D003FD8F8473B3798,31071,18,19,1,109.58257,18.28458,1815
287707,F198CAA1F49ACA5D003FD8F8473B3798,30854,19,21,2,109.56889,18.27076,1763
287710,F746BB1DA8AF798983E08F7CB247A82F,38251,18,21,3,109.49618,18.25493,1510
287711,F746BB1DA8AF798983E08F7CB247A82F,60131,21,23,2,109.49819,18.24778,1509
287738,C860767955774E3494068CF38C009FB6,60391,0,9,9,109.47667,18.28757,1416
287739,C860767955774E3494068CF38C009FB6,31061,9,16,7,109.53333,18.23257,1607
287740,C860767955774E3494068CF38C009FB6,60391,17,18,1,109.47667,18.28757,1416
287741,C860767955774E3494068CF38C009FB6,31864,18,20,2,109.49014,18.28333,1465
287761,DAB08D254D49BF150533311BD904D49C,31521,0,8,8,109.51458,18.22542,1555
287762,DAB08D254D49BF150533311BD904D49C,30771,9,10,1,109.49938,18.26042,1511
287763,DAB08D254D49BF150533311BD904D49C,60381,13,16,3,109.5241,18.22458,1605
287764,DAB08D254D49BF150533311BD904D49C,38185,19,20,1,109.51333,18.27347,1563
287765,DAB08D254D49BF150533311BD904D49C,60381,22,23,1,109.5241,18.22458,1605
287791,1D2F8DB1F8B6A2081E1A43DDF558491D,31951,0,9,9,109.52174,18.30299,1568
287792,1D2F8DB1F8B6A2081E1A43DDF558491D,48631,9,11,2,109.52903,18.31743,1621
287793,1D2F8DB1F8B6A2081E1A43DDF558491D,31951,11,23,12,109.52174,18.30299,1568
287794,8C5A16299A6D294198C90C34C25C5949,39183,0,2,2,109.55542,18.28208,1715
287795,8C5A16299A6D294198C90C34C25C5949,31561,3,4,1,109.56792,18.28479,1765
287796,8C5A16299A6D294198C90C34C25C5949,39183,4,14,10,109.55542,18.28208,1715
287797,8C5A16299A6D294198C90C34C25C5949,31561,18,19,1,109.56792,18.28479,1765
287798,941A5C38F4BF0495FDCAE8C1D6E4B8DA,30854,12,15,3,109.56889,18.27076,1763
287799,941A5C38F4BF0495FDCAE8C1D6E4B8DA,39371,19,23,4,109.56627,18.2646,1762
287800,35C6EDC8AAC6B5ABA770190223528BA2,60381,16,18,2,109.5241,18.22458,1605
287801,35C6EDC8AAC6B5ABA770190223528BA2,31091,19,21,2,109.41201,18.31222,1170
287816,46EBA833B325DCE5EE258C5988AE07F0,31461,19,20,1,109.5091,18.25389,1510
287817,46EBA833B325DCE5EE258C5988AE07F0,31231,20,23,3,109.42597,18.29292,1217
287818,5CF385399776EC46A3F5DCDA63D16AEB,31701,16,18,2,109.44132,18.28833,1266
287819,5CF385399776EC46A3F5DCDA63D16AEB,31031,20,21,1,109.49979,18.25382,1510
287857,C42D2C8010DF16606218846412B7033D,31471,13,14,1,109.34583,18.29563,917
287858,C42D2C8010DF16606218846412B7033D,38903,17,23,6,109.39229,18.29243,1117
287889,77E0479537D8350123531CE1FA2E6649,60631,1,7,6,109.57778,18.27583,1814
287890,77E0479537D8350123531CE1FA2E6649,60591,10,13,3,109.61118,18.21715,1904
287899,FB69127E95B4D9EC5AF61282F8D7EEB7,31071,2,7,5,109.58257,18.28458,1815
287900,FB69127E95B4D9EC5AF61282F8D7EEB7,30854,7,22,15,109.56889,18.27076,1763
287901,A61982B5678761D61EEF61A4FD8E4247,31431,0,6,6,109.44639,18.29042,1316
287903,A61982B5678761D61EEF61A4FD8E4247,31701,17,19,2,109.44132,18.28833,1266
287904,A61982B5678761D61EEF61A4FD8E4247,31431,19,23,4,109.44639,18.29042,1316
287905,0E0D6E55BB1995EBF85F6B7AA8765E55,30854,2,15,13,109.56889,18.27076,1763
287906,0E0D6E55BB1995EBF85F6B7AA8765E55,38271,15,22,7,109.62632,18.23049,1956
287921,2D39AE6120F2674000C6DBB8A6E572A0,31945,0,7,7,109.58021,18.29403,1817
287922,2D39AE6120F2674000C6DBB8A6E572A0,30854,7,9,2,109.56889,18.27076,1763
287923,2D39AE6120F2674000C6DBB8A6E572A0,31945,12,13,1,109.58021,18.29403,1817
287925,C711EA8F4B039EAC279F7CFC24309A8A,30071,18,23,5,109.52819,18.30472,1619
287961,9E18E9F8FEDC97A4CAA2EEEA25DFDB75,38251,0,7,7,109.49618,18.25493,1510
287964,9E18E9F8FEDC97A4CAA2EEEA25DFDB75,31031,17,19,2,109.49979,18.25382,1510
287965,9E18E9F8FEDC97A4CAA2EEEA25DFDB75,31031,19,23,4,109.49979,18.25382,1510
287976,770A00BDAFE9BCA8C9E9FA68066EED7D,31071,0,6,6,109.58257,18.28458,1815
287977,770A00BDAFE9BCA8C9E9FA68066EED7D,31561,10,15,5,109.56792,18.28479,1765
287978,770A00BDAFE9BCA8C9E9FA68066EED7D,30851,15,18,3,109.5616,18.27396,1713
287979,770A00BDAFE9BCA8C9E9FA68066EED7D,31071,20,23,3,109.58257,18.28458,1815
287983,C1F9914EF577AE2A8300B1A3945A50FF,31561,0,1,1,109.56792,18.28479,1765
287984,C1F9914EF577AE2A8300B1A3945A50FF,30851,3,6,3,109.5616,18.27396,1713
287985,C1F9914EF577AE2A8300B1A3945A50FF,31561,8,10,2,109.56792,18.28479,1765
288014,241E5A09B6952F478B1503601C11534A,30361,8,9,1,109.50347,18.24,1508
288015,241E5A09B6952F478B1503601C11534A,31471,14,15,1,109.34583,18.29563,917
288016,241E5A09B6952F478B1503601C11534A,31411,19,20,1,109.5016,18.23576,1507
288017,241E5A09B6952F478B1503601C11534A,30361,20,22,2,109.50347,18.24,1508
288018,F5FE23BF42FC224C310CD42E08B0B950,31431,0,6,6,109.44639,18.29042,1316
288019,F5FE23BF42FC224C310CD42E08B0B950,38094,6,17,11,109.45403,18.28778,1316
288020,F5FE23BF42FC224C310CD42E08B0B950,31431,20,23,3,109.44639,18.29042,1316
288030,47D232A92516FC961C7881B5391F911A,30711,16,18,2,109.50271,18.25347,1510
288031,47D232A92516FC961C7881B5391F911A,30861,18,20,2,109.52722,18.22743,1606
288047,999622F1021C0E47F73CE0E79CF81156,60381,19,23,4,109.5241,18.22458,1605
288082,FFFC0994E5C15BDB165344716912442C,31554,0,1,1,109.55521,18.2459,1709
288083,FFFC0994E5C15BDB165344716912442C,30854,1,4,3,109.56889,18.27076,1763
288084,FFFC0994E5C15BDB165344716912442C,31554,7,19,12,109.55521,18.2459,1709
288085,FFFC0994E5C15BDB165344716912442C,30854,22,23,1,109.56889,18.27076,1763
288121,E34C10F1C8BC04C7EF99531DA4E2FBE8,30211,0,7,7,109.49882,18.23931,1508
288141,3604A30B97765FCF194506153EE8C0D9,30854,0,8,8,109.56889,18.27076,1763
288142,3604A30B97765FCF194506153EE8C0D9,31945,12,14,2,109.58021,18.29403,1817
288143,3604A30B97765FCF194506153EE8C0D9,39371,14,16,2,109.56627,18.2646,1762
288144,3604A30B97765FCF194506153EE8C0D9,30854,16,23,7,109.56889,18.27076,1763
288168,94C4D5691F7DFC1AB38806AFFAC1389E,31931,0,18,18,109.54771,18.29403,1667
288169,94C4D5691F7DFC1AB38806AFFAC1389E,30921,19,20,1,109.53903,18.29451,1667
288176,C3EF49B0098C6C3C4B26CC8869DE86AF,30854,0,6,6,109.56889,18.27076,1763
288177,C3EF49B0098C6C3C4B26CC8869DE86AF,38271,8,15,7,109.62632,18.23049,1956
288178,C3EF49B0098C6C3C4B26CC8869DE86AF,30854,18,23,5,109.56889,18.27076,1763
288200,8AD9F37216B2D3FCE05CA77434307672,30741,0,8,8,109.49833,18.28681,1516
288201,8AD9F37216B2D3FCE05CA77434307672,31181,9,11,2,109.50382,18.24813,1509
288202,8AD9F37216B2D3FCE05CA77434307672,30361,11,12,1,109.50347,18.24,1508
288203,8AD9F37216B2D3FCE05CA77434307672,30281,15,19,4,109.50597,18.27583,1514
288204,8AD9F37216B2D3FCE05CA77434307672,30741,19,23,4,109.49833,18.28681,1516
288214,9FC721E86703223349C05C95FE4BBB6F,31521,0,14,14,109.51458,18.22542,1555
288215,9FC721E86703223349C05C95FE4BBB6F,60381,14,19,5,109.5241,18.22458,1605
288216,9FC721E86703223349C05C95FE4BBB6F,60087,20,23,3,109.50688,18.22299,1505
288221,B81DEDE33B0853E35D97557F334A4861,60361,0,6,6,109.51938,18.29681,1567
288222,B81DEDE33B0853E35D97557F334A4861,31931,6,17,11,109.54771,18.29403,1667
288223,B81DEDE33B0853E35D97557F334A4861,60361,18,23,5,109.51938,18.29681,1567
288231,A68637AA89BD62624E677D9E66C32FAD,30361,0,1,1,109.50347,18.24,1508
288232,A68637AA89BD62624E677D9E66C32FAD,30161,3,11,8,109.50042,18.24389,1508
288233,A68637AA89BD62624E677D9E66C32FAD,30161,11,22,11,109.50042,18.24389,1508
288245,E8D51F8B53F290BFD73338AD2AD8C728,31561,4,5,1,109.56792,18.28479,1765
288246,E8D51F8B53F290BFD73338AD2AD8C728,39181,9,10,1,109.55153,18.28035,1715
288247,E8D51F8B53F290BFD73338AD2AD8C728,31561,12,13,1,109.56792,18.28479,1765
288248,E8D51F8B53F290BFD73338AD2AD8C728,39183,13,14,1,109.55542,18.28208,1715
288249,E8D51F8B53F290BFD73338AD2AD8C728,31931,17,18,1,109.54771,18.29403,1667
288250,E8D51F8B53F290BFD73338AD2AD8C728,31561,21,23,2,109.56792,18.28479,1765
288257,0D7276B6F8E1595E83AAC767A2E9D621,30201,19,20,1,109.4909,18.26465,1462
288258,0D7276B6F8E1595E83AAC767A2E9D621,31551,22,23,1,109.55868,18.24222,1708
288276,D77A5C2E97A74D805A87772560CE2BFF,31421,1,9,8,109.55382,18.22347,1705
288277,D77A5C2E97A74D805A87772560CE2BFF,60381,9,11,2,109.5241,18.22458,1605
288278,D77A5C2E97A74D805A87772560CE2BFF,31421,11,22,11,109.55382,18.22347,1705
288290,7D6FE1595F0739472239550151E87F8D,30341,15,16,1,109.3625,18.29167,966
288291,7D6FE1595F0739472239550151E87F8D,38951,17,22,5,109.48097,18.28868,1416
288314,50D00009FA050A5EC6C0853EBA6A0BB9,60524,0,9,9,109.42951,18.28993,1216
288315,50D00009FA050A5EC6C0853EBA6A0BB9,31181,14,15,1,109.50382,18.24813,1509
288316,50D00009FA050A5EC6C0853EBA6A0BB9,30361,16,18,2,109.50347,18.24,1508
288317,50D00009FA050A5EC6C0853EBA6A0BB9,30361,21,23,2,109.50347,18.24,1508
288369,EE1DC3D3663945EFC02BAB5EE6A065E9,31071,0,7,7,109.58257,18.28458,1815
288370,EE1DC3D3663945EFC02BAB5EE6A065E9,30854,9,12,3,109.56889,18.27076,1763
288371,EE1DC3D3663945EFC02BAB5EE6A065E9,31071,12,21,9,109.58257,18.28458,1815
288396,AFB3BB55A37370BD0197A84C243C3B80,31071,0,1,1,109.58257,18.28458,1815
288397,AFB3BB55A37370BD0197A84C243C3B80,31071,1,4,3,109.58257,18.28458,1815
288398,AFB3BB55A37370BD0197A84C243C3B80,39371,7,8,1,109.56627,18.2646,1762
288399,AFB3BB55A37370BD0197A84C243C3B80,30731,10,16,6,109.50944,18.22306,1555
288403,60ACD2B6657BEEA3D1B558DE71329F84,30241,13,14,1,109.26174,18.3275,622
288404,60ACD2B6657BEEA3D1B558DE71329F84,39151,16,21,5,109.49875,18.25097,1510
288451,4D0A59E05A72D6291604A4664BF78794,31181,18,20,2,109.50382,18.24813,1509
288452,4D0A59E05A72D6291604A4664BF78794,60381,20,21,1,109.5241,18.22458,1605
288464,85113926FD58DF2481DE297BC312E23D,30361,18,23,5,109.50347,18.24,1508
288473,0D3DA8126B134D203BB35373EAFFB116,31071,4,11,7,109.58257,18.28458,1815
288474,0D3DA8126B134D203BB35373EAFFB116,30854,16,17,1,109.56889,18.27076,1763
288475,0D3DA8126B134D203BB35373EAFFB116,31071,19,21,2,109.58257,18.28458,1815
288482,D334753E33AD01D79142036B3D85543F,31561,0,5,5,109.56792,18.28479,1765
288483,D334753E33AD01D79142036B3D85543F,39183,6,13,7,109.55542,18.28208,1715
288484,9F2B58AC0AA55800793A0AA2A29F8826,39181,10,15,5,109.55153,18.28035,1715
288485,9F2B58AC0AA55800793A0AA2A29F8826,30851,17,22,5,109.5616,18.27396,1713
288542,85D2E0E28FB58C7F8A0D7BC94160D3DD,30854,5,16,11,109.56889,18.27076,1763
288543,85D2E0E28FB58C7F8A0D7BC94160D3DD,31561,19,20,1,109.56792,18.28479,1765
288568,36CB9BFBE6722CF45733B1AB5C92EBF8,30854,0,7,7,109.56889,18.27076,1763
288569,36CB9BFBE6722CF45733B1AB5C92EBF8,60631,9,16,7,109.57778,18.27583,1814
288570,36CB9BFBE6722CF45733B1AB5C92EBF8,30854,16,22,6,109.56889,18.27076,1763
288587,A9FCE0049DB44FE004EAFBF5B783F4A5,31945,0,7,7,109.58021,18.29403,1817
288588,A9FCE0049DB44FE004EAFBF5B783F4A5,30854,9,16,7,109.56889,18.27076,1763
288589,A9FCE0049DB44FE004EAFBF5B783F4A5,31521,19,20,1,109.51458,18.22542,1555
288603,E21BDA79D452CC6D5F26BA60A43939EC,31261,0,1,1,109.51174,18.2466,1559
288604,E21BDA79D452CC6D5F26BA60A43939EC,38911,3,11,8,109.51674,18.24965,1559
288605,E21BDA79D452CC6D5F26BA60A43939EC,60311,12,18,6,109.52097,18.24319,1558
288606,E21BDA79D452CC6D5F26BA60A43939EC,38291,19,20,1,109.51618,18.24313,1558
288607,E21BDA79D452CC6D5F26BA60A43939EC,31261,22,23,1,109.51174,18.2466,1559
288612,43DCA4A54D551EB9E56C0160DC714BC6,31561,0,3,3,109.56792,18.28479,1765
288613,43DCA4A54D551EB9E56C0160DC714BC6,30854,3,12,9,109.56889,18.27076,1763
288615,43DCA4A54D551EB9E56C0160DC714BC6,30741,20,21,1,109.49833,18.28681,1516
288616,43DCA4A54D551EB9E56C0160DC714BC6,30854,21,23,2,109.56889,18.27076,1763
288649,201045A9C980BD8E53B16B9129DFE596,31071,0,5,5,109.58257,18.28458,1815
288650,201045A9C980BD8E53B16B9129DFE596,31561,5,7,2,109.56792,18.28479,1765
288651,201045A9C980BD8E53B16B9129DFE596,31071,9,12,3,109.58257,18.28458,1815
288652,201045A9C980BD8E53B16B9129DFE596,30854,15,17,2,109.56889,18.27076,1763
288653,201045A9C980BD8E53B16B9129DFE596,31071,21,23,2,109.58257,18.28458,1815
288686,EC721F8259E3B17F432086B3F60AECE1,31554,3,5,2,109.55521,18.2459,1709
288687,EC721F8259E3B17F432086B3F60AECE1,30051,6,18,12,109.48917,18.21215,1453
288688,EC721F8259E3B17F432086B3F60AECE1,31554,19,23,4,109.55521,18.2459,1709
288694,E8E05D2BF37E5522AAFF8446679CEF53,30921,4,5,1,109.53903,18.29451,1667
288695,E8E05D2BF37E5522AAFF8446679CEF53,31931,5,8,3,109.54771,18.29403,1667
288696,E8E05D2BF37E5522AAFF8446679CEF53,30921,8,10,2,109.53903,18.29451,1667
288697,E8E05D2BF37E5522AAFF8446679CEF53,31931,11,14,3,109.54771,18.29403,1667
288702,7024F3A14F6F554DC6E80063E30315F0,31561,0,2,2,109.56792,18.28479,1765
288703,7024F3A14F6F554DC6E80063E30315F0,39183,7,22,15,109.55542,18.28208,1715
288712,17E33F98086F9D71B1BE47BE6FC58756,60291,0,1,1,109.50826,18.24639,1509
288713,17E33F98086F9D71B1BE47BE6FC58756,39371,4,7,3,109.56627,18.2646,1762
288714,17E33F98086F9D71B1BE47BE6FC58756,30711,10,11,1,109.50271,18.25347,1510
288715,17E33F98086F9D71B1BE47BE6FC58756,60221,13,14,1,109.52569,18.29188,1616
288716,17E33F98086F9D71B1BE47BE6FC58756,39101,17,21,4,109.50132,18.24931,1509
288760,867CD177C4F4B0DA2800BA7613DC965C,31061,0,11,11,109.53333,18.23257,1607
288761,867CD177C4F4B0DA2800BA7613DC965C,30381,14,16,2,109.52521,18.24507,1609
288762,867CD177C4F4B0DA2800BA7613DC965C,30161,19,20,1,109.50042,18.24389,1508
288763,867CD177C4F4B0DA2800BA7613DC965C,31061,21,23,2,109.53333,18.23257,1607
288768,40D62DAB923B148A7A4FFB3BCA6C7343,38153,16,18,2,109.51819,18.25736,1561
288769,40D62DAB923B148A7A4FFB3BCA6C7343,31351,21,23,2,109.4959,18.28417,1465
288778,88BC97AED786D1D1055FFA17099BBDF8,30809,0,6,6,109.4891,18.28229,1465
288779,88BC97AED786D1D1055FFA17099BBDF8,31781,10,11,1,109.19847,18.2975,367
288780,88BC97AED786D1D1055FFA17099BBDF8,31471,14,17,3,109.34583,18.29563,917
288781,8B167331F8E78254A4CBA6A89A1236BC,60524,0,14,14,109.42951,18.28993,1216
288782,8B167331F8E78254A4CBA6A89A1236BC,60084,15,19,4,109.4984,18.2334,1507
288783,0D00E0CA974DDA00224ACCD00B993468,31561,12,14,2,109.56792,18.28479,1765
288784,0D00E0CA974DDA00224ACCD00B993468,30854,17,18,1,109.56889,18.27076,1763
288785,0D00E0CA974DDA00224ACCD00B993468,30851,19,21,2,109.5616,18.27396,1713
288791,567BF1868FBA42FA9B3B29F2CA13F65D,30921,1,19,18,109.53903,18.29451,1667
288792,567BF1868FBA42FA9B3B29F2CA13F65D,31931,19,22,3,109.54771,18.29403,1667
288797,4D98CC6A841E32F3CEA568916A53D5E4,31521,0,16,16,109.51458,18.22542,1555
288798,4D98CC6A841E32F3CEA568916A53D5E4,60381,16,18,2,109.5241,18.22458,1605
288799,4D98CC6A841E32F3CEA568916A53D5E4,31521,18,23,5,109.51458,18.22542,1555
288847,E76E426053D594D364E17507E09780BF,30441,0,11,11,109.64021,18.25424,2010
288906,D73D0E1690714CD7F442C709F67E4771,60361,0,7,7,109.51938,18.29681,1567
288907,D73D0E1690714CD7F442C709F67E4771,39371,11,15,4,109.56627,18.2646,1762
288908,D73D0E1690714CD7F442C709F67E4771,60221,19,20,1,109.52569,18.29188,1616
288909,D73D0E1690714CD7F442C709F67E4771,60361,21,23,2,109.51938,18.29681,1567
288922,A10AD66CE81CDFBC974C36FAC5FE4CAA,30721,15,16,1,109.51597,18.28257,1565
288923,A10AD66CE81CDFBC974C36FAC5FE4CAA,30854,20,21,1,109.56889,18.27076,1763
288937,316EB27B7555943C1D6557CD7E5A08F6,30741,11,12,1,109.49833,18.28681,1516
288960,6EF68F35CE79552C1164E70C67C72C02,30121,0,8,8,109.52861,18.27222,1613
288961,6EF68F35CE79552C1164E70C67C72C02,30854,11,15,4,109.56889,18.27076,1763
288962,6EF68F35CE79552C1164E70C67C72C02,30121,19,23,4,109.52861,18.27222,1613
288963,6E2021B014C4D0B652A2E4FE8D2CF038,30854,14,15,1,109.56889,18.27076,1763
288964,6E2021B014C4D0B652A2E4FE8D2CF038,31071,16,17,1,109.58257,18.28458,1815
288972,C173E680DFAEC165B5B7AE7346539D93,38291,0,9,9,109.51618,18.24313,1558
288973,C173E680DFAEC165B5B7AE7346539D93,30711,12,13,1,109.50271,18.25347,1510
288974,C173E680DFAEC165B5B7AE7346539D93,30511,14,16,2,109.51069,18.24208,1558
289030,7617AF5A0F29AC2D4F5DA44D6B34A94D,60121,0,9,9,109.74507,18.37472,2430
289031,7617AF5A0F29AC2D4F5DA44D6B34A94D,30961,9,10,1,109.74042,18.37903,2431
289032,7617AF5A0F29AC2D4F5DA44D6B34A94D,60121,11,12,1,109.74507,18.37472,2430
289033,7617AF5A0F29AC2D4F5DA44D6B34A94D,30711,13,17,4,109.50271,18.25347,1510
289034,7617AF5A0F29AC2D4F5DA44D6B34A94D,30961,18,20,2,109.74042,18.37903,2431
289035,7617AF5A0F29AC2D4F5DA44D6B34A94D,31841,20,22,2,109.73201,18.33382,2373
289036,CD77A45360FB53F816FCE62F008EEE28,31931,1,6,5,109.54771,18.29403,1667
289037,CD77A45360FB53F816FCE62F008EEE28,30071,6,7,1,109.52819,18.30472,1619
289038,CD77A45360FB53F816FCE62F008EEE28,31931,10,11,1,109.54771,18.29403,1667
289039,CD77A45360FB53F816FCE62F008EEE28,31461,12,13,1,109.5091,18.25389,1510
289040,CD77A45360FB53F816FCE62F008EEE28,60241,16,17,1,109.53319,18.28667,1616
289041,CD77A45360FB53F816FCE62F008EEE28,31931,19,20,1,109.54771,18.29403,1667
289067,8A15E279A515FBB85B3FA2E35BACCD57,31431,0,6,6,109.44639,18.29042,1316
289069,8A15E279A515FBB85B3FA2E35BACCD57,38094,17,19,2,109.45403,18.28778,1316
289070,8A15E279A515FBB85B3FA2E35BACCD57,31431,20,23,3,109.44639,18.29042,1316
289129,FE4417CAF3A5150C206378A6D3A89051,30201,0,10,10,109.4909,18.26465,1462
289130,FE4417CAF3A5150C206378A6D3A89051,31931,12,17,5,109.54771,18.29403,1667
289131,FE4417CAF3A5150C206378A6D3A89051,60371,18,19,1,109.53063,18.30056,1618
289132,FE4417CAF3A5150C206378A6D3A89051,31931,21,23,2,109.54771,18.29403,1667
289133,C162E20472DBB598395501A28AA53C86,31671,0,7,7,109.38965,18.29813,1068
289134,C162E20472DBB598395501A28AA53C86,31861,8,10,2,109.49042,18.27549,1464
289135,C162E20472DBB598395501A28AA53C86,38185,12,15,3,109.51333,18.27347,1563
289136,C162E20472DBB598395501A28AA53C86,30151,16,18,2,109.50986,18.25083,1560
289137,C162E20472DBB598395501A28AA53C86,31671,20,23,3,109.38965,18.29813,1068
289140,F3C7582DC0625CD0C0C3F1B9C08AEFC7,60041,0,13,13,109.39889,18.31944,1121
289141,F3C7582DC0625CD0C0C3F1B9C08AEFC7,31521,14,15,1,109.51458,18.22542,1555
289142,F3C7582DC0625CD0C0C3F1B9C08AEFC7,30361,15,16,1,109.50347,18.24,1508
289143,F3C7582DC0625CD0C0C3F1B9C08AEFC7,38754,19,21,2,109.74667,18.37382,2430
289144,9C607748C1355BBFA505845B03897CBC,60281,16,17,1,109.51743,18.25924,1561
289145,9C607748C1355BBFA505845B03897CBC,30371,18,19,1,109.51,18.24771,1559
289146,9C607748C1355BBFA505845B03897CBC,38911,22,23,1,109.51674,18.24965,1559
289187,D9689370CD6256E9753C2B0B13067E2B,30854,0,14,14,109.56889,18.27076,1763
289188,D9689370CD6256E9753C2B0B13067E2B,30581,15,16,1,109.62257,18.24951,1959
289189,D9689370CD6256E9753C2B0B13067E2B,30071,19,20,1,109.52819,18.30472,1619
289190,D9689370CD6256E9753C2B0B13067E2B,30854,22,23,1,109.56889,18.27076,1763
289199,92A852F4802D3D92C195A90A9645A57F,38141,0,13,13,109.39479,18.2916,1116
289200,92A852F4802D3D92C195A90A9645A57F,38325,18,19,1,109.39792,18.2909,1116
289201,92A852F4802D3D92C195A90A9645A57F,38903,19,23,4,109.39229,18.29243,1117
289208,DBB710D279E76C79F1E4B0766F579F8A,31071,0,8,8,109.58257,18.28458,1815
289209,DBB710D279E76C79F1E4B0766F579F8A,30854,11,12,1,109.56889,18.27076,1763
289210,DBB710D279E76C79F1E4B0766F579F8A,31071,12,13,1,109.58257,18.28458,1815
289211,DBB710D279E76C79F1E4B0766F579F8A,30854,18,19,1,109.56889,18.27076,1763
289212,B80D4B4CDBD08237A9C4254F8883AEF4,39091,0,7,7,109.50097,18.25222,1510
289213,B80D4B4CDBD08237A9C4254F8883AEF4,31181,8,11,3,109.50382,18.24813,1509
289214,B80D4B4CDBD08237A9C4254F8883AEF4,31181,15,16,1,109.50382,18.24813,1509
289215,B80D4B4CDBD08237A9C4254F8883AEF4,60381,18,19,1,109.5241,18.22458,1605
289216,B80D4B4CDBD08237A9C4254F8883AEF4,39091,20,23,3,109.50097,18.25222,1510
289217,3A484AED43EBFC77572B117C1C49420B,31081,0,6,6,109.44639,18.30181,1318
289218,3A484AED43EBFC77572B117C1C49420B,31471,7,17,10,109.34583,18.29563,917
289219,3A484AED43EBFC77572B117C1C49420B,31081,19,23,4,109.44639,18.30181,1318
289262,013993AB3B116DEE53D03FD91E423B5B,60411,20,21,1,109.32514,18.30854,869
289263,013993AB3B116DEE53D03FD91E423B5B,30661,22,23,1,109.37028,18.24361,1008
289303,A2DBFF4E352E7B7C1EE25431C02FC741,31931,0,13,13,109.54771,18.29403,1667
289304,A2DBFF4E352E7B7C1EE25431C02FC741,39181,17,18,1,109.55153,18.28035,1715
289305,A2DBFF4E352E7B7C1EE25431C02FC741,31931,21,23,2,109.54771,18.29403,1667
289306,66A68DF7322984DDFD4069A80816FA0D,38052,13,15,2,109.62618,18.23042,1956
289307,66A68DF7322984DDFD4069A80816FA0D,60594,18,20,2,109.62694,18.22799,1956
289308,66A68DF7322984DDFD4069A80816FA0D,39331,21,22,1,109.62125,18.22708,1956
289316,0BABF9C6516F437130A3DD3C99553A57,30211,0,4,4,109.49882,18.23931,1508
289317,0BABF9C6516F437130A3DD3C99553A57,31041,5,6,1,109.50278,18.23701,1507
289318,0BABF9C6516F437130A3DD3C99553A57,30854,7,8,1,109.56889,18.27076,1763
289319,0BABF9C6516F437130A3DD3C99553A57,31851,8,10,2,109.71736,18.29007,2316
289320,0BABF9C6516F437130A3DD3C99553A57,30181,11,12,1,109.51597,18.23313,1557
289321,0BABF9C6516F437130A3DD3C99553A57,60641,15,16,1,109.53854,18.2359,1657
289322,0BABF9C6516F437130A3DD3C99553A57,31201,18,23,5,109.51042,18.23819,1558
289331,000584B3023702F3E9DDF521B1C35B1A,31071,1,3,2,109.58257,18.28458,1815
289332,000584B3023702F3E9DDF521B1C35B1A,31945,4,6,2,109.58021,18.29403,1817
289333,000584B3023702F3E9DDF521B1C35B1A,31071,10,12,2,109.58257,18.28458,1815
289334,000584B3023702F3E9DDF521B1C35B1A,31945,12,13,1,109.58021,18.29403,1817
289335,000584B3023702F3E9DDF521B1C35B1A,30854,14,20,6,109.56889,18.27076,1763
289336,000584B3023702F3E9DDF521B1C35B1A,31945,21,22,1,109.58021,18.29403,1817
289340,7EBC20D0E5F0FBA046CA1D08E7FF47C1,31071,2,6,4,109.58257,18.28458,1815
289341,7EBC20D0E5F0FBA046CA1D08E7FF47C1,30854,11,12,1,109.56889,18.27076,1763
289352,D1300109B338AA3BEF146D962603C6CB,38484,0,6,6,109.53028,18.31528,1620
289353,D1300109B338AA3BEF146D962603C6CB,30071,10,11,1,109.52819,18.30472,1619
289354,D1300109B338AA3BEF146D962603C6CB,30711,12,13,1,109.50271,18.25347,1510
289355,D1300109B338AA3BEF146D962603C6CB,30421,14,17,3,109.50021,18.25861,1511
289356,D1300109B338AA3BEF146D962603C6CB,38484,17,18,1,109.53028,18.31528,1620
289378,8A321B0FBD5A72C39F28CA2535195507,60041,0,10,10,109.39889,18.31944,1121
289379,8A321B0FBD5A72C39F28CA2535195507,60114,15,18,3,109.73028,18.33847,2374
289380,8A321B0FBD5A72C39F28CA2535195507,31841,21,22,1,109.73201,18.33382,2373
289401,DF1914B7230B32BA806E8A8749CAD846,31181,15,16,1,109.50382,18.24813,1509
289402,DF1914B7230B32BA806E8A8749CAD846,60421,20,23,3,109.46333,18.31743,1371
289407,8E9CBB949C0DB377807711755B310583,30361,12,13,1,109.50347,18.24,1508
289408,8E9CBB949C0DB377807711755B310583,38094,15,23,8,109.45403,18.28778,1316
289424,7784022BDEFABB0258B32ABBB5E13027,30251,2,8,6,109.50611,18.26653,1512
289425,7784022BDEFABB0258B32ABBB5E13027,30461,8,12,4,109.5116,18.26313,1562
289426,7784022BDEFABB0258B32ABBB5E13027,30151,12,14,2,109.50986,18.25083,1560
289472,020753EF78F0A0C39658113A3377EA1E,31561,12,13,1,109.56792,18.28479,1765
289473,020753EF78F0A0C39658113A3377EA1E,39183,14,15,1,109.55542,18.28208,1715
289474,020753EF78F0A0C39658113A3377EA1E,31561,18,21,3,109.56792,18.28479,1765
289482,1122041491C04B199A15F6E1E401D68F,60281,3,6,3,109.51743,18.25924,1561
289483,1122041491C04B199A15F6E1E401D68F,30461,7,8,1,109.5116,18.26313,1562
289484,1122041491C04B199A15F6E1E401D68F,30461,10,12,2,109.5116,18.26313,1562
289485,1122041491C04B199A15F6E1E401D68F,60281,13,14,1,109.51743,18.25924,1561
289488,744908594665C830F5D7DD2D0AC61E3F,60081,0,4,4,109.51097,18.22639,1556
289489,744908594665C830F5D7DD2D0AC61E3F,60087,5,6,1,109.50688,18.22299,1505
289560,3721DD20DEF8CEDB5BD6EB56E9685A22,60301,0,3,3,109.60715,18.30993,1919
289561,3721DD20DEF8CEDB5BD6EB56E9685A22,60581,3,6,3,109.59785,18.29931,1868
289562,3721DD20DEF8CEDB5BD6EB56E9685A22,30234,7,8,1,109.60681,18.29979,1918
289563,3721DD20DEF8CEDB5BD6EB56E9685A22,31471,10,11,1,109.34583,18.29563,917
289580,56F818D0924E7BDB02CCC04065747626,38205,0,19,19,109.62743,18.23139,1956
289581,56F818D0924E7BDB02CCC04065747626,31041,22,23,1,109.50278,18.23701,1507
289584,A8E9C7BB918ADAD29A3EA7ACDDCD32D7,38951,0,2,2,109.48097,18.28868,1416
289585,A8E9C7BB918ADAD29A3EA7ACDDCD32D7,38951,2,17,15,109.48097,18.28868,1416
289586,A8E9C7BB918ADAD29A3EA7ACDDCD32D7,38951,17,22,5,109.48097,18.28868,1416
289605,689BCB46A0E58D79BF82594240942679,60371,0,3,3,109.53063,18.30056,1618
289606,689BCB46A0E58D79BF82594240942679,30071,4,8,4,109.52819,18.30472,1619
289607,689BCB46A0E58D79BF82594240942679,31781,11,13,2,109.19847,18.2975,367
289608,689BCB46A0E58D79BF82594240942679,39081,14,15,1,109.19382,18.29111,366
289609,689BCB46A0E58D79BF82594240942679,31421,18,20,2,109.55382,18.22347,1705
289622,1980C8D409DE9551539224B3D393CDAA,31951,1,2,1,109.52174,18.30299,1568
289623,1980C8D409DE9551539224B3D393CDAA,38991,2,6,4,109.52681,18.30368,1618
289624,1980C8D409DE9551539224B3D393CDAA,31951,6,8,2,109.52174,18.30299,1568
289625,1980C8D409DE9551539224B3D393CDAA,30071,8,11,3,109.52819,18.30472,1619
289626,1980C8D409DE9551539224B3D393CDAA,30071,13,21,8,109.52819,18.30472,1619
289670,BEE3A0C9BB09D7F210E3490BED90A1BE,30071,0,8,8,109.52819,18.30472,1619
289671,BEE3A0C9BB09D7F210E3490BED90A1BE,60371,9,11,2,109.53063,18.30056,1618
289672,BEE3A0C9BB09D7F210E3490BED90A1BE,30071,13,21,8,109.52819,18.30472,1619
289673,BEE3A0C9BB09D7F210E3490BED90A1BE,60371,21,23,2,109.53063,18.30056,1618
289678,D9AE11CD16B231308C3F0FB3F53BC3E9,31071,0,16,16,109.58257,18.28458,1815
289679,D9AE11CD16B231308C3F0FB3F53BC3E9,30854,16,17,1,109.56889,18.27076,1763
289680,D9AE11CD16B231308C3F0FB3F53BC3E9,31071,21,23,2,109.58257,18.28458,1815
289697,8AFD060E1E9DC727605442142067AD03,31861,15,17,2,109.49042,18.27549,1464
289698,8AFD060E1E9DC727605442142067AD03,30861,20,23,3,109.52722,18.22743,1606
289711,8B9A9BFD1ACAD480EB101A91DBF2024D,38291,0,10,10,109.51618,18.24313,1558
289712,8B9A9BFD1ACAD480EB101A91DBF2024D,30371,12,23,11,109.51,18.24771,1559
289724,43E035AE85036EBD9891453E9567CB81,60504,12,14,2,109.47917,18.28903,1416
289725,43E035AE85036EBD9891453E9567CB81,30151,16,19,3,109.50986,18.25083,1560
289726,43E035AE85036EBD9891453E9567CB81,30151,21,23,2,109.50986,18.25083,1560
289783,8752BC71725B50257436D50C6598F252,30854,18,19,1,109.56889,18.27076,1763
289784,8752BC71725B50257436D50C6598F252,60631,20,22,2,109.57778,18.27583,1814
289793,032D95980CE2A85CFBC6D1472CD793A8,39091,0,8,8,109.50097,18.25222,1510
289794,032D95980CE2A85CFBC6D1472CD793A8,38754,12,14,2,109.74667,18.37382,2430
289795,032D95980CE2A85CFBC6D1472CD793A8,39091,15,17,2,109.50097,18.25222,1510
289796,032D95980CE2A85CFBC6D1472CD793A8,60031,19,20,1,109.49694,18.31632,1521
289797,032D95980CE2A85CFBC6D1472CD793A8,39091,21,23,2,109.50097,18.25222,1510
289833,DC9973204E62AA99FA79F0696CF6C0F6,31945,0,1,1,109.58021,18.29403,1817
289834,DC9973204E62AA99FA79F0696CF6C0F6,30854,1,21,20,109.56889,18.27076,1763
289842,C983E73D646629A775690ECA8920EB29,30101,0,6,6,109.57299,18.33333,1773
289843,C983E73D646629A775690ECA8920EB29,31631,6,7,1,109.59542,18.36826,1879
289844,C983E73D646629A775690ECA8920EB29,30101,9,10,1,109.57299,18.33333,1773
289901,D343F732190993CDF15741F730CFB38E,31761,0,1,1,109.60521,18.27965,1914
289902,D343F732190993CDF15741F730CFB38E,31071,1,2,1,109.58257,18.28458,1815
289903,D343F732190993CDF15741F730CFB38E,31761,5,7,2,109.60521,18.27965,1914
289928,0C36A00B9010612DF553A128A21F45E8,31531,0,10,10,109.49583,18.25972,1461
289936,F1114751990E9EE36CDB7660EAA9CD6F,31071,0,5,5,109.58257,18.28458,1815
289937,F1114751990E9EE36CDB7660EAA9CD6F,30854,5,7,2,109.56889,18.27076,1763
289938,F1114751990E9EE36CDB7660EAA9CD6F,31071,11,15,4,109.58257,18.28458,1815
289949,6422CB87ACC55DDEF6EBE8946593C808,31351,0,7,7,109.4959,18.28417,1465
289950,6422CB87ACC55DDEF6EBE8946593C808,60231,8,9,1,109.49903,18.21972,1504
289951,6422CB87ACC55DDEF6EBE8946593C808,39053,9,10,1,109.511,18.2771,1564
289952,6422CB87ACC55DDEF6EBE8946593C808,60231,12,19,7,109.49903,18.21972,1504
289966,1412BA3B65BC1A2354CCBE297098A0E1,31071,0,8,8,109.58257,18.28458,1815
289967,1412BA3B65BC1A2354CCBE297098A0E1,30581,9,10,1,109.62257,18.24951,1959
289968,1412BA3B65BC1A2354CCBE297098A0E1,30854,14,19,5,109.56889,18.27076,1763
289969,1412BA3B65BC1A2354CCBE297098A0E1,31071,19,21,2,109.58257,18.28458,1815
289980,664AAF94F095BCD14233E5648F0324F0,60491,7,8,1,109.43354,18.30847,1269
290004,9AA959ED87D1ECC3053DED17290EFCBD,30854,1,3,2,109.56889,18.27076,1763
290005,9AA959ED87D1ECC3053DED17290EFCBD,31561,5,7,2,109.56792,18.28479,1765
290006,9AA959ED87D1ECC3053DED17290EFCBD,39181,7,10,3,109.55153,18.28035,1715
290007,9AA959ED87D1ECC3053DED17290EFCBD,31561,12,20,8,109.56792,18.28479,1765
290018,FA724E83D7D22E41E07D0D2550D22166,30854,15,20,5,109.56889,18.27076,1763
290019,FA724E83D7D22E41E07D0D2550D22166,31071,22,23,1,109.58257,18.28458,1815
290089,2261FA59C58CA1DB4ED476451BEA0AD4,60501,0,3,3,109.48701,18.29021,1466
290125,DF189E83BAB7254002D11C89D4F2D51F,31124,19,23,4,109.17069,18.35,276
290135,40285EE8CCE25C38988EC087545664EC,31071,1,10,9,109.58257,18.28458,1815
290136,40285EE8CCE25C38988EC087545664EC,30854,14,23,9,109.56889,18.27076,1763
290195,C8922FAF66F21ECAECB6B717FCD5A53B,60391,9,11,2,109.47667,18.28757,1416
290196,C8922FAF66F21ECAECB6B717FCD5A53B,60614,11,23,12,109.48799,18.29521,1467
290212,7D1ED6067ECBD941EFC43CE0A6ADAE71,30854,0,11,11,109.56889,18.27076,1763
290213,7D1ED6067ECBD941EFC43CE0A6ADAE71,31071,13,20,7,109.58257,18.28458,1815
290220,9E8746086915F9D4A063A74CF0B5B7AB,31561,12,15,3,109.56792,18.28479,1765
290221,9E8746086915F9D4A063A74CF0B5B7AB,39183,16,18,2,109.55542,18.28208,1715
290236,FB2AC3F748B104193BBB6BA243B43247,60491,0,2,2,109.43354,18.30847,1269
290237,FB2AC3F748B104193BBB6BA243B43247,31081,4,8,4,109.44639,18.30181,1318
290239,FB2AC3F748B104193BBB6BA243B43247,30854,20,22,2,109.56889,18.27076,1763
290244,124E60C0315346A1F7A9CD897F13605E,48601,0,9,9,109.51694,18.22514,1555
290245,124E60C0315346A1F7A9CD897F13605E,60231,12,14,2,109.49903,18.21972,1504
290246,124E60C0315346A1F7A9CD897F13605E,31521,17,23,6,109.51458,18.22542,1555
290250,2B60907F04C29DE058B3E64B1D3B4100,31561,1,3,2,109.56792,18.28479,1765
290251,2B60907F04C29DE058B3E64B1D3B4100,30854,6,8,2,109.56889,18.27076,1763
290252,2B60907F04C29DE058B3E64B1D3B4100,31561,11,13,2,109.56792,18.28479,1765
290253,2B60907F04C29DE058B3E64B1D3B4100,30854,18,19,1,109.56889,18.27076,1763
290278,51DF765CB634D9549D20AD1F2C37BA18,30854,4,5,1,109.56889,18.27076,1763
290279,51DF765CB634D9549D20AD1F2C37BA18,31561,7,21,14,109.56792,18.28479,1765
290280,8F7C571040232DE08ED6F6470F3AFD5D,31671,19,20,1,109.38965,18.29813,1068
290281,8F7C571040232DE08ED6F6470F3AFD5D,38301,20,23,3,109.38632,18.29104,1066
290282,7B453A5E432292BF0A91271A2EAD7AAF,60221,0,7,7,109.52569,18.29188,1616
290283,7B453A5E432292BF0A91271A2EAD7AAF,30711,8,10,2,109.50271,18.25347,1510
290284,7B453A5E432292BF0A91271A2EAD7AAF,60221,11,13,2,109.52569,18.29188,1616
290285,7B453A5E432292BF0A91271A2EAD7AAF,30324,15,17,2,109.50326,18.29257,1517
290286,7B453A5E432292BF0A91271A2EAD7AAF,60221,20,23,3,109.52569,18.29188,1616
290328,E9E473F09C342630187345312F4A31D8,39181,0,8,8,109.55153,18.28035,1715
290329,E9E473F09C342630187345312F4A31D8,39181,10,14,4,109.55153,18.28035,1715
290330,E9E473F09C342630187345312F4A31D8,39181,15,17,2,109.55153,18.28035,1715
290331,E9E473F09C342630187345312F4A31D8,39181,17,19,2,109.55153,18.28035,1715
290332,E9E473F09C342630187345312F4A31D8,39181,20,23,3,109.55153,18.28035,1715
290377,9337A90C199FC39903F500644FD0D1C4,39111,0,9,9,109.5191,18.22597,1555
290378,9337A90C199FC39903F500644FD0D1C4,60381,9,11,2,109.5241,18.22458,1605
290379,9337A90C199FC39903F500644FD0D1C4,31521,11,12,1,109.51458,18.22542,1555
290380,9337A90C199FC39903F500644FD0D1C4,30201,13,14,1,109.4909,18.26465,1462
290381,9337A90C199FC39903F500644FD0D1C4,31031,18,20,2,109.49979,18.25382,1510
290385,E75CF54BA14775FEDD26504F9F6B7365,31945,1,5,4,109.58021,18.29403,1817
290386,E75CF54BA14775FEDD26504F9F6B7365,31561,7,15,8,109.56792,18.28479,1765
290387,E75CF54BA14775FEDD26504F9F6B7365,30854,16,18,2,109.56889,18.27076,1763
290388,E75CF54BA14775FEDD26504F9F6B7365,31071,19,20,1,109.58257,18.28458,1815
290389,E75CF54BA14775FEDD26504F9F6B7365,31945,21,22,1,109.58021,18.29403,1817
290392,00FC332040A284DA251A8D0705989FE9,31071,1,10,9,109.58257,18.28458,1815
290393,00FC332040A284DA251A8D0705989FE9,30854,14,17,3,109.56889,18.27076,1763
290394,00FC332040A284DA251A8D0705989FE9,39181,18,19,1,109.55153,18.28035,1715
290395,00FC332040A284DA251A8D0705989FE9,30421,20,22,2,109.50021,18.25861,1511
290428,D04CD9DD8CE80FB000DDFF2A9F0DD83D,60131,0,6,6,109.49819,18.24778,1509
290429,D04CD9DD8CE80FB000DDFF2A9F0DD83D,30771,9,16,7,109.49938,18.26042,1511
290430,D04CD9DD8CE80FB000DDFF2A9F0DD83D,30391,18,19,1,109.4975,18.27118,1513
290448,D46DE9169E4BACF1D272EA5E0FDEF68F,39183,6,8,2,109.55542,18.28208,1715
290449,D46DE9169E4BACF1D272EA5E0FDEF68F,30851,8,10,2,109.5616,18.27396,1713
290450,D46DE9169E4BACF1D272EA5E0FDEF68F,39183,15,17,2,109.55542,18.28208,1715
290451,D46DE9169E4BACF1D272EA5E0FDEF68F,31561,21,23,2,109.56792,18.28479,1765
290468,2AE38FAF341950B0B91404FFCE5A0F3E,31931,0,5,5,109.54771,18.29403,1667
290469,2AE38FAF341950B0B91404FFCE5A0F3E,30921,6,18,12,109.53903,18.29451,1667
290481,B227D80C8626361D434850FE0C17533E,38951,0,9,9,109.48097,18.28868,1416
290482,B227D80C8626361D434850FE0C17533E,33051,10,13,3,109.6475,18.46618,2096
290544,DFFF17B7FE30E79B8AABBB5CE171272F,31561,1,6,5,109.56792,18.28479,1765
290545,DFFF17B7FE30E79B8AABBB5CE171272F,39183,10,11,1,109.55542,18.28208,1715
290546,0874ECC8591FCEC6749163A25CC3B800,60411,3,18,15,109.32514,18.30854,869
290547,0874ECC8591FCEC6749163A25CC3B800,31471,20,23,3,109.34583,18.29563,917
290555,6C243B11A8093A8CA55CA33CE09BE6E2,39371,0,6,6,109.56627,18.2646,1762
290556,6C243B11A8093A8CA55CA33CE09BE6E2,30854,7,8,1,109.56889,18.27076,1763
290557,6C243B11A8093A8CA55CA33CE09BE6E2,39371,9,14,5,109.56627,18.2646,1762
290558,6C243B11A8093A8CA55CA33CE09BE6E2,30854,15,23,8,109.56889,18.27076,1763
290574,B34415F599F0ED7D1A073EE314A60B9B,31671,0,14,14,109.38965,18.29813,1068
290575,B34415F599F0ED7D1A073EE314A60B9B,60041,16,17,1,109.39889,18.31944,1121
290576,B34415F599F0ED7D1A073EE314A60B9B,31671,20,22,2,109.38965,18.29813,1068
290589,2C9F9127F2AECFBA8069624790D23C60,31351,13,14,1,109.4959,18.28417,1465
290596,443D183C692C6C6B0CFC9BE76827D81A,31521,0,10,10,109.51458,18.22542,1555
290597,443D183C692C6C6B0CFC9BE76827D81A,31521,13,23,10,109.51458,18.22542,1555
290614,8CA86ECF9044327BBFC4911E767E554E,30851,18,20,2,109.5616,18.27396,1713
290615,8CA86ECF9044327BBFC4911E767E554E,31071,20,23,3,109.58257,18.28458,1815
290619,EC4B90EDBF35256FDB4D4F8B87DB8A04,30854,15,16,1,109.56889,18.27076,1763
290620,EC4B90EDBF35256FDB4D4F8B87DB8A04,31071,20,21,1,109.58257,18.28458,1815
290621,EC4B90EDBF35256FDB4D4F8B87DB8A04,30854,21,22,1,109.56889,18.27076,1763
290640,CB2BC2C9454DCC9EC157173C1331852D,39371,1,3,2,109.56627,18.2646,1762
290641,CB2BC2C9454DCC9EC157173C1331852D,31071,5,6,1,109.58257,18.28458,1815
290642,CB2BC2C9454DCC9EC157173C1331852D,39091,11,14,3,109.50097,18.25222,1510
290643,CB2BC2C9454DCC9EC157173C1331852D,30854,16,23,7,109.56889,18.27076,1763
290658,96CD0832BDF051FA07C4E27EBADBF179,31461,12,13,1,109.5091,18.25389,1510
290659,96CD0832BDF051FA07C4E27EBADBF179,30084,14,16,2,109.50118,18.26972,1513
290752,5232A1F9DD43FADD1ACE9CE9BD82FED1,31461,12,13,1,109.5091,18.25389,1510
290753,5232A1F9DD43FADD1ACE9CE9BD82FED1,33521,14,23,9,109.66313,18.45174,2143
290764,755FAFC0C0B49C8477B5398A1968636A,60161,15,17,2,109.49174,18.26181,1461
290765,755FAFC0C0B49C8477B5398A1968636A,30361,17,20,3,109.50347,18.24,1508
290780,689528D5C129D1703EF90D6CD5795B66,30421,0,11,11,109.50021,18.25861,1511
290781,689528D5C129D1703EF90D6CD5795B66,60441,14,16,2,109.46792,18.28604,1366
290782,689528D5C129D1703EF90D6CD5795B66,30771,18,23,5,109.49938,18.26042,1511
290797,622234A65D292D040A9E438A2770674C,30851,0,7,7,109.5616,18.27396,1713
290798,622234A65D292D040A9E438A2770674C,31561,7,9,2,109.56792,18.28479,1765
290799,622234A65D292D040A9E438A2770674C,30851,11,14,3,109.5616,18.27396,1713
290800,622234A65D292D040A9E438A2770674C,31561,15,16,1,109.56792,18.28479,1765
290828,38CF8AD578A393476F29705A4599B8B1,31201,19,20,1,109.51042,18.23819,1558
290829,38CF8AD578A393476F29705A4599B8B1,30201,22,23,1,109.4909,18.26465,1462
290897,325037F612F05AEC9AA9B5DCFCF0B4A0,38102,15,17,2,109.40875,18.29111,1166
290898,325037F612F05AEC9AA9B5DCFCF0B4A0,60401,20,21,1,109.47444,18.27583,1414
290921,41DAE981BCED4EBAFEC24CC26F862E41,31071,0,11,11,109.58257,18.28458,1815
290922,41DAE981BCED4EBAFEC24CC26F862E41,30854,13,18,5,109.56889,18.27076,1763
290923,41DAE981BCED4EBAFEC24CC26F862E41,38271,19,20,1,109.62632,18.23049,1956
290924,41DAE981BCED4EBAFEC24CC26F862E41,30854,21,22,1,109.56889,18.27076,1763
290966,61367143AF9E920D00E08697C8407C3F,38331,0,6,6,109.62465,18.22736,1956
290967,61367143AF9E920D00E08697C8407C3F,38052,6,14,8,109.62618,18.23042,1956
290968,61367143AF9E920D00E08697C8407C3F,30581,16,18,2,109.62257,18.24951,1959
290969,61367143AF9E920D00E08697C8407C3F,38052,18,20,2,109.62618,18.23042,1956
290982,028F3FB3C0C3F25357AA07CE73FBA035,31431,1,9,8,109.44639,18.29042,1316
291003,1D8B814EC83D52D7C5F3FED99C129EE0,30854,0,1,1,109.56889,18.27076,1763
291004,1D8B814EC83D52D7C5F3FED99C129EE0,30851,2,6,4,109.5616,18.27396,1713
291005,1D8B814EC83D52D7C5F3FED99C129EE0,38271,8,21,13,109.62632,18.23049,1956
291016,05E654A012214456FD658205782885D2,30581,17,18,1,109.62257,18.24951,1959
291017,05E654A012214456FD658205782885D2,38951,21,23,2,109.48097,18.28868,1416
291042,13A6EDC75AEBF90A555AE4ABEB3F9FCC,30851,1,5,4,109.5616,18.27396,1713
291043,13A6EDC75AEBF90A555AE4ABEB3F9FCC,39181,6,11,5,109.55153,18.28035,1715
291044,13A6EDC75AEBF90A555AE4ABEB3F9FCC,39181,11,17,6,109.55153,18.28035,1715
291045,13A6EDC75AEBF90A555AE4ABEB3F9FCC,39183,19,20,1,109.55542,18.28208,1715
291080,79CCA269D4D1544F735C077DABC1670F,39111,2,4,2,109.5191,18.22597,1555
291081,79CCA269D4D1544F735C077DABC1670F,31521,5,7,2,109.51458,18.22542,1555
291083,79CCA269D4D1544F735C077DABC1670F,31031,17,18,1,109.49979,18.25382,1510
291089,CD294E0B65E7686283441C2C69DAEEE1,31261,0,1,1,109.51174,18.2466,1559
291090,CD294E0B65E7686283441C2C69DAEEE1,31261,3,9,6,109.51174,18.2466,1559
291091,CD294E0B65E7686283441C2C69DAEEE1,31261,13,16,3,109.51174,18.2466,1559
291188,BCC6D1A50E04898FABDF906024A98CE5,30891,18,19,1,109.59431,18.28389,1865
291189,BCC6D1A50E04898FABDF906024A98CE5,31761,21,23,2,109.60521,18.27965,1914
291195,E2EEED9C318F2CFEB610045809877842,31261,3,10,7,109.51174,18.2466,1559
291196,E2EEED9C318F2CFEB610045809877842,30611,12,14,2,109.74958,18.40188,2485
291197,E2EEED9C318F2CFEB610045809877842,30371,14,23,9,109.51,18.24771,1559
291205,452F0FF6BC36839041DCBEF2292D6E55,30101,17,18,1,109.57299,18.33333,1773
291206,452F0FF6BC36839041DCBEF2292D6E55,60381,19,23,4,109.5241,18.22458,1605
291216,0E54E51B728435921FF462A3D9A68B3D,31231,0,7,7,109.42597,18.29292,1217
291217,0E54E51B728435921FF462A3D9A68B3D,30854,9,23,14,109.56889,18.27076,1763
291259,F8D799D9161B0143E0D71C40472A357E,30071,0,14,14,109.52819,18.30472,1619
291260,F8D799D9161B0143E0D71C40472A357E,30071,15,20,5,109.52819,18.30472,1619
291261,F8D799D9161B0143E0D71C40472A357E,30071,21,23,2,109.52819,18.30472,1619
291262,8BDE8C6966F9C7122ABA59EA6C195945,31081,0,6,6,109.44639,18.30181,1318
291263,8BDE8C6966F9C7122ABA59EA6C195945,60501,8,10,2,109.48701,18.29021,1466
291264,8BDE8C6966F9C7122ABA59EA6C195945,30671,13,14,1,109.43611,18.30139,1268
291284,7BF65E5054DA81A230AB5423620158E1,60631,0,7,7,109.57778,18.27583,1814
291285,7BF65E5054DA81A230AB5423620158E1,30854,8,21,13,109.56889,18.27076,1763
291306,C58D0182BFC61ED113EE3B09763C30B2,31931,15,16,1,109.54771,18.29403,1667
291307,C58D0182BFC61ED113EE3B09763C30B2,38127,17,18,1,109.50833,18.27222,1513
291308,C58D0182BFC61ED113EE3B09763C30B2,38185,19,23,4,109.51333,18.27347,1563
291318,728159D623DE360E7CBC8AEEC345E2FF,60661,0,7,7,109.548,18.2377,1657
291319,728159D623DE360E7CBC8AEEC345E2FF,31311,9,14,5,109.72299,18.27438,2364
291320,728159D623DE360E7CBC8AEEC345E2FF,60121,15,16,1,109.74507,18.37472,2430
291321,728159D623DE360E7CBC8AEEC345E2FF,30181,18,19,1,109.51597,18.23313,1557
291322,728159D623DE360E7CBC8AEEC345E2FF,60661,21,23,2,109.548,18.2377,1657
291359,DAF24E4EE5B080B65CEC42C4A439EACF,31071,0,7,7,109.58257,18.28458,1815
291360,DAF24E4EE5B080B65CEC42C4A439EACF,39091,11,14,3,109.50097,18.25222,1510
291361,DAF24E4EE5B080B65CEC42C4A439EACF,30854,14,16,2,109.56889,18.27076,1763
291362,DAF24E4EE5B080B65CEC42C4A439EACF,31071,20,22,2,109.58257,18.28458,1815
291427,D6887056BF9A72A0D40AFDC23854E7DB,60411,1,9,8,109.32514,18.30854,869
291428,D6887056BF9A72A0D40AFDC23854E7DB,39281,10,13,3,109.21333,18.30271,418
291429,D6887056BF9A72A0D40AFDC23854E7DB,30341,14,17,3,109.3625,18.29167,966
291472,CFE676DCCC4DE2A148E7352FA77322DF,30511,0,8,8,109.51069,18.24208,1558
291473,CFE676DCCC4DE2A148E7352FA77322DF,38891,10,13,3,109.51486,18.24118,1558
291474,CFE676DCCC4DE2A148E7352FA77322DF,30854,14,19,5,109.56889,18.27076,1763
291475,CFE676DCCC4DE2A148E7352FA77322DF,38891,20,23,3,109.51486,18.24118,1558
291483,6C0260646767B781577B5B8CE2471E51,30321,2,4,2,109.49563,18.29611,1467
291484,6C0260646767B781577B5B8CE2471E51,38484,7,9,2,109.53028,18.31528,1620
291485,6C0260646767B781577B5B8CE2471E51,30561,9,12,3,109.52778,18.31938,1621
291486,6C0260646767B781577B5B8CE2471E51,38484,12,22,10,109.53028,18.31528,1620
291487,20C15B76A1E0DF79D86EDEAC7BC3D7B7,31031,14,15,1,109.49979,18.25382,1510
291488,20C15B76A1E0DF79D86EDEAC7BC3D7B7,31071,19,20,1,109.58257,18.28458,1815
291489,20C15B76A1E0DF79D86EDEAC7BC3D7B7,30854,20,23,3,109.56889,18.27076,1763
291490,FC68C93DF477EC8988713D0985F4BE82,31561,0,8,8,109.56792,18.28479,1765
291491,FC68C93DF477EC8988713D0985F4BE82,30854,8,16,8,109.56889,18.27076,1763
291492,FC68C93DF477EC8988713D0985F4BE82,60381,19,20,1,109.5241,18.22458,1605
291511,8F6EA1C108FADA76A214A7ED71ECE3D1,60117,11,17,6,109.73604,18.35681,2427
291512,8F6EA1C108FADA76A214A7ED71ECE3D1,30891,22,23,1,109.59431,18.28389,1865
291591,A59893CF63A9A48BE0D9E2ED611A9BB2,31801,11,13,2,109.20417,18.32118,371
291627,672DD0F66F8A942C0026E65C93DBF0ED,60211,12,14,2,109.63549,18.26049,2011
291628,672DD0F66F8A942C0026E65C93DBF0ED,38754,16,17,1,109.74667,18.37382,2430
291629,672DD0F66F8A942C0026E65C93DBF0ED,60211,21,23,2,109.63549,18.26049,2011
291689,B2035C0684FF9CA861B7EB217CE5A160,60041,0,1,1,109.39889,18.31944,1121
291690,B2035C0684FF9CA861B7EB217CE5A160,60524,4,5,1,109.42951,18.28993,1216
291691,B2035C0684FF9CA861B7EB217CE5A160,31231,6,8,2,109.42597,18.29292,1217
291692,B2035C0684FF9CA861B7EB217CE5A160,30351,10,19,9,109.41701,18.29292,1217
291693,B2035C0684FF9CA861B7EB217CE5A160,60552,19,21,2,109.41729,18.30014,1218
291694,B2035C0684FF9CA861B7EB217CE5A160,60041,21,23,2,109.39889,18.31944,1121
291695,FD8E83DD7FF39A687AC2462EEEA479A1,30711,16,20,4,109.50271,18.25347,1510
291696,FD8E83DD7FF39A687AC2462EEEA479A1,31761,21,23,2,109.60521,18.27965,1914
291705,FE95B3A32EFBC2838F293DF38F55FDD1,30854,0,5,5,109.56889,18.27076,1763
291706,FE95B3A32EFBC2838F293DF38F55FDD1,39183,7,18,11,109.55542,18.28208,1715
291707,653A27B06104891651DF7B1A27B6CC51,31531,19,20,1,109.49583,18.25972,1461
291708,653A27B06104891651DF7B1A27B6CC51,31521,20,23,3,109.51458,18.22542,1555
291709,7B832C4EEA998F0828995CEC1FF24330,31945,0,6,6,109.58021,18.29403,1817
291710,7B832C4EEA998F0828995CEC1FF24330,30854,8,11,3,109.56889,18.27076,1763
291711,7B832C4EEA998F0828995CEC1FF24330,60211,13,14,1,109.63549,18.26049,2011
291712,7B832C4EEA998F0828995CEC1FF24330,30441,15,16,1,109.64021,18.25424,2010
291713,7B832C4EEA998F0828995CEC1FF24330,31945,20,23,3,109.58021,18.29403,1817
291725,80510334A1C80EA4AE907E88FED9D4F9,60011,0,6,6,109.48965,18.30222,1468
291726,80510334A1C80EA4AE907E88FED9D4F9,30761,6,8,2,109.45201,18.3,1318
291727,80510334A1C80EA4AE907E88FED9D4F9,31781,9,11,2,109.19847,18.2975,367
291728,80510334A1C80EA4AE907E88FED9D4F9,30661,13,14,1,109.37028,18.24361,1008
291804,30CE72A519D49881F23B8123486E3A02,60411,0,9,9,109.32514,18.30854,869
291805,30CE72A519D49881F23B8123486E3A02,31471,9,11,2,109.34583,18.29563,917
291806,30CE72A519D49881F23B8123486E3A02,60411,15,22,7,109.32514,18.30854,869
291823,BD9C21E94538AA6D21377B9EF57647D7,31071,1,6,5,109.58257,18.28458,1815
291824,BD9C21E94538AA6D21377B9EF57647D7,30854,7,8,1,109.56889,18.27076,1763
291825,BD9C21E94538AA6D21377B9EF57647D7,31071,8,10,2,109.58257,18.28458,1815
291826,BD9C21E94538AA6D21377B9EF57647D7,30854,11,17,6,109.56889,18.27076,1763
291847,82FFBAA5929CD368E9B5AC0A4DEDBC26,30051,0,7,7,109.48917,18.21215,1453
291848,82FFBAA5929CD368E9B5AC0A4DEDBC26,31931,7,16,9,109.54771,18.29403,1667
291849,82FFBAA5929CD368E9B5AC0A4DEDBC26,30051,19,23,4,109.48917,18.21215,1453
291852,9A1D1AA5EE2CD156CC396C667ED8C5B9,31071,0,8,8,109.58257,18.28458,1815
291853,9A1D1AA5EE2CD156CC396C667ED8C5B9,60631,9,11,2,109.57778,18.27583,1814
291854,9A1D1AA5EE2CD156CC396C667ED8C5B9,30854,11,12,1,109.56889,18.27076,1763
291855,9A1D1AA5EE2CD156CC396C667ED8C5B9,31071,13,14,1,109.58257,18.28458,1815
291856,9A1D1AA5EE2CD156CC396C667ED8C5B9,30854,15,16,1,109.56889,18.27076,1763
291857,9A1D1AA5EE2CD156CC396C667ED8C5B9,60354,19,20,1,109.58701,18.28521,1815
291858,9A1D1AA5EE2CD156CC396C667ED8C5B9,30854,20,23,3,109.56889,18.27076,1763
291877,AB61D00E5DA3B96E08D6A2F49438046E,60054,12,13,1,109.3016,18.31229,770
291898,B9C5276261A22B75469FB2D15656E67A,31781,13,15,2,109.19847,18.2975,367
291899,B9C5276261A22B75469FB2D15656E67A,31861,20,23,3,109.49042,18.27549,1464
291903,F7035E4742EE25797FD00CAEBC81D218,31251,0,3,3,109.18528,18.2975,317
291904,F7035E4742EE25797FD00CAEBC81D218,30441,4,5,1,109.64021,18.25424,2010
291905,F7035E4742EE25797FD00CAEBC81D218,31251,6,20,14,109.18528,18.2975,317
291906,F7035E4742EE25797FD00CAEBC81D218,30441,22,23,1,109.64021,18.25424,2010
291907,798BF3B08F72A16A6DEAAA235F1899BB,61011,0,1,1,109.60653,18.19076,1900
291909,798BF3B08F72A16A6DEAAA235F1899BB,61011,8,13,5,109.60653,18.19076,1900
291911,798BF3B08F72A16A6DEAAA235F1899BB,61011,15,17,2,109.60653,18.19076,1900
291929,306C6C6EB560D035853CD87DDFB51F50,31071,0,5,5,109.58257,18.28458,1815
291930,306C6C6EB560D035853CD87DDFB51F50,30681,7,9,2,109.48493,18.26917,1463
291931,306C6C6EB560D035853CD87DDFB51F50,31271,13,15,2,109.48958,18.26257,1462
291932,306C6C6EB560D035853CD87DDFB51F50,31071,20,21,1,109.58257,18.28458,1815
291945,1F0A56540E2B5CE086CFC4F7E4349D63,31345,0,10,10,109.39,18.29,1066
291946,1F0A56540E2B5CE086CFC4F7E4349D63,31471,11,15,4,109.34583,18.29563,917
291947,1F0A56540E2B5CE086CFC4F7E4349D63,31345,17,23,6,109.39,18.29,1066
291978,CEB7EA5D037E7DFD2A157DEECC6ACC53,38291,0,1,1,109.51618,18.24313,1558
291979,CEB7EA5D037E7DFD2A157DEECC6ACC53,30371,2,7,5,109.51,18.24771,1559
291980,CEB7EA5D037E7DFD2A157DEECC6ACC53,31021,10,14,4,109.49021,18.27,1463
291981,CEB7EA5D037E7DFD2A157DEECC6ACC53,38251,15,17,2,109.49618,18.25493,1510
291982,CEB7EA5D037E7DFD2A157DEECC6ACC53,31121,20,23,3,109.16292,18.37063,230
291983,3E2666314F611E0AC08D1A2388C8030A,31145,9,12,3,109.20431,18.30479,369
291984,3E2666314F611E0AC08D1A2388C8030A,31471,13,17,4,109.34583,18.29563,917
291985,3E2666314F611E0AC08D1A2388C8030A,31521,18,23,5,109.51458,18.22542,1555
292039,66E09649FC3AF1CDA80FFE7B203B7004,31071,0,5,5,109.58257,18.28458,1815
292040,66E09649FC3AF1CDA80FFE7B203B7004,31931,8,10,2,109.54771,18.29403,1667
292041,66E09649FC3AF1CDA80FFE7B203B7004,60371,10,11,1,109.53063,18.30056,1618
292042,66E09649FC3AF1CDA80FFE7B203B7004,31071,12,14,2,109.58257,18.28458,1815
292043,66E09649FC3AF1CDA80FFE7B203B7004,31931,15,17,2,109.54771,18.29403,1667
292044,66E09649FC3AF1CDA80FFE7B203B7004,31071,18,23,5,109.58257,18.28458,1815
292068,99FF1530B139D386F8C2FFCE4C803DD4,30661,14,15,1,109.37028,18.24361,1008
292069,99FF1530B139D386F8C2FFCE4C803DD4,31471,17,18,1,109.34583,18.29563,917
292070,99FF1530B139D386F8C2FFCE4C803DD4,30661,20,21,1,109.37028,18.24361,1008
292080,21AAB354EDCC66ADEEAE4A93BDCB3306,31031,0,9,9,109.49979,18.25382,1510
292081,21AAB354EDCC66ADEEAE4A93BDCB3306,30711,10,12,2,109.50271,18.25347,1510
292082,21AAB354EDCC66ADEEAE4A93BDCB3306,30421,13,14,1,109.50021,18.25861,1511
292083,21AAB354EDCC66ADEEAE4A93BDCB3306,39321,15,17,2,109.529,18.2167,1604
292084,21AAB354EDCC66ADEEAE4A93BDCB3306,31521,17,20,3,109.51458,18.22542,1555
292085,21AAB354EDCC66ADEEAE4A93BDCB3306,30421,20,22,2,109.50021,18.25861,1511
292117,6751CEC3CF9B2AE78246C7287443D2B4,30854,0,1,1,109.56889,18.27076,1763
292118,6751CEC3CF9B2AE78246C7287443D2B4,31071,6,7,1,109.58257,18.28458,1815
292154,2D7C2B0308FF40B49F9D8D3F0878C284,39111,3,4,1,109.5191,18.22597,1555
292155,2D7C2B0308FF40B49F9D8D3F0878C284,31521,5,7,2,109.51458,18.22542,1555
292156,2D7C2B0308FF40B49F9D8D3F0878C284,39321,7,8,1,109.529,18.2167,1604
292157,2D7C2B0308FF40B49F9D8D3F0878C284,31781,12,13,1,109.19847,18.2975,367
292171,4D4289AE0DFBF4B5C79A47559DC2EBDD,31071,0,8,8,109.58257,18.28458,1815
292172,4D4289AE0DFBF4B5C79A47559DC2EBDD,30854,13,15,2,109.56889,18.27076,1763
292173,4D4289AE0DFBF4B5C79A47559DC2EBDD,31071,15,18,3,109.58257,18.28458,1815
292174,59F29435D748531F416A4F1636997ECF,31071,12,13,1,109.58257,18.28458,1815
292175,59F29435D748531F416A4F1636997ECF,30854,14,17,3,109.56889,18.27076,1763
292176,59F29435D748531F416A4F1636997ECF,31071,19,20,1,109.58257,18.28458,1815
292177,68DBE0B52FD0AB95F1DD47068FD7847F,30181,0,15,15,109.51597,18.23313,1557
292178,68DBE0B52FD0AB95F1DD47068FD7847F,31521,15,16,1,109.51458,18.22542,1555
292179,68DBE0B52FD0AB95F1DD47068FD7847F,30181,17,19,2,109.51597,18.23313,1557
292226,22CF7007721E0F1D863F25E4633BE1AD,60311,4,7,3,109.52097,18.24319,1558
292227,22CF7007721E0F1D863F25E4633BE1AD,60501,8,9,1,109.48701,18.29021,1466
292228,22CF7007721E0F1D863F25E4633BE1AD,31881,12,14,2,109.7441,18.40785,2436
292229,22CF7007721E0F1D863F25E4633BE1AD,30084,19,21,2,109.50118,18.26972,1513
292230,A2F734AA2F32C81D03014F0CEDF1D528,60552,0,1,1,109.41729,18.30014,1218
292231,A2F734AA2F32C81D03014F0CEDF1D528,60524,2,8,6,109.42951,18.28993,1216
292232,A2F734AA2F32C81D03014F0CEDF1D528,30351,11,15,4,109.41701,18.29292,1217
292233,A2F734AA2F32C81D03014F0CEDF1D528,60552,16,17,1,109.41729,18.30014,1218
292234,A2F734AA2F32C81D03014F0CEDF1D528,30361,21,22,1,109.50347,18.24,1508
292252,369C26B411BBFC36DC6FE3529EBBC042,31071,0,5,5,109.58257,18.28458,1815
292253,369C26B411BBFC36DC6FE3529EBBC042,31781,9,12,3,109.19847,18.2975,367
292254,369C26B411BBFC36DC6FE3529EBBC042,30854,13,15,2,109.56889,18.27076,1763
292265,18F9E44609F85394688E1F961680A135,31421,0,2,2,109.55382,18.22347,1705
292266,18F9E44609F85394688E1F961680A135,60381,2,6,4,109.5241,18.22458,1605
292267,18F9E44609F85394688E1F961680A135,60551,10,11,1,109.42722,18.30111,1218
292282,522E8CB42AF22D75F3E9D0FD1FDCEEA6,30854,0,1,1,109.56889,18.27076,1763
292283,522E8CB42AF22D75F3E9D0FD1FDCEEA6,39371,2,7,5,109.56627,18.2646,1762
292284,522E8CB42AF22D75F3E9D0FD1FDCEEA6,30854,7,10,3,109.56889,18.27076,1763
292285,522E8CB42AF22D75F3E9D0FD1FDCEEA6,39371,12,13,1,109.56627,18.2646,1762
292286,522E8CB42AF22D75F3E9D0FD1FDCEEA6,30854,16,22,6,109.56889,18.27076,1763
292304,2B9007AC1CBDC651833FDA7CC1A6B306,39321,19,21,2,109.529,18.2167,1604
292305,2B9007AC1CBDC651833FDA7CC1A6B306,30211,21,23,2,109.49882,18.23931,1508
292311,F104684B0D453E1772CF3FC2E8F8DFBE,60231,11,12,1,109.49903,18.21972,1504
292312,F104684B0D453E1772CF3FC2E8F8DFBE,30051,12,14,2,109.48917,18.21215,1453
292313,F104684B0D453E1772CF3FC2E8F8DFBE,30271,15,16,1,109.49132,18.23153,1456
292314,F104684B0D453E1772CF3FC2E8F8DFBE,60201,18,20,2,109.5041,18.2509,1510
292315,F104684B0D453E1772CF3FC2E8F8DFBE,60084,20,22,2,109.4984,18.2334,1507
292337,14BFE46EEAB2E234698393270A62605D,30661,11,12,1,109.37028,18.24361,1008
292338,14BFE46EEAB2E234698393270A62605D,60411,13,14,1,109.32514,18.30854,869
292339,14BFE46EEAB2E234698393270A62605D,30661,15,17,2,109.37028,18.24361,1008
292340,14BFE46EEAB2E234698393270A62605D,60411,22,23,1,109.32514,18.30854,869
292398,FF0D8F0BC597142978F09C4BE01381AF,60291,0,3,3,109.50826,18.24639,1509
292399,FF0D8F0BC597142978F09C4BE01381AF,30511,3,5,2,109.51069,18.24208,1558
292400,FF0D8F0BC597142978F09C4BE01381AF,30281,5,7,2,109.50597,18.27583,1514
292401,FF0D8F0BC597142978F09C4BE01381AF,30511,7,18,11,109.51069,18.24208,1558
292402,FF0D8F0BC597142978F09C4BE01381AF,60381,18,20,2,109.5241,18.22458,1605
292403,A795428793D2273B4ACFDADC5E61AEC2,60661,0,6,6,109.548,18.2377,1657
292404,A795428793D2273B4ACFDADC5E61AEC2,31421,6,8,2,109.55382,18.22347,1705
292405,A795428793D2273B4ACFDADC5E61AEC2,60381,8,10,2,109.5241,18.22458,1605
292430,7C68E1F4B8B2F3CBBD5427BF66BF9C2E,30891,0,4,4,109.59431,18.28389,1865
292431,7C68E1F4B8B2F3CBBD5427BF66BF9C2E,30854,6,11,5,109.56889,18.27076,1763
292468,30CCDA3A282DA68630C9C45738B256B1,31821,19,20,1,109.51181,18.24924,1559
292469,30CCDA3A282DA68630C9C45738B256B1,30854,21,23,2,109.56889,18.27076,1763
292470,AAD6CC23C5CDBF026C42805D3EA95680,60552,0,1,1,109.41729,18.30014,1218
292471,AAD6CC23C5CDBF026C42805D3EA95680,30351,2,4,2,109.41701,18.29292,1217
292472,AAD6CC23C5CDBF026C42805D3EA95680,39041,4,5,1,109.40021,18.29278,1117
292473,AAD6CC23C5CDBF026C42805D3EA95680,60552,7,11,4,109.41729,18.30014,1218
292474,AAD6CC23C5CDBF026C42805D3EA95680,39041,13,14,1,109.40021,18.29278,1117
292475,AAD6CC23C5CDBF026C42805D3EA95680,60552,15,21,6,109.41729,18.30014,1218
292482,C58B2D758E557F71813EE954DB9BA52F,31521,1,10,9,109.51458,18.22542,1555
292483,C58B2D758E557F71813EE954DB9BA52F,31521,12,17,5,109.51458,18.22542,1555
292484,C58B2D758E557F71813EE954DB9BA52F,30711,18,19,1,109.50271,18.25347,1510
292485,C58B2D758E557F71813EE954DB9BA52F,30731,20,21,1,109.50944,18.22306,1555
292494,372A5433078073EAD18922D679CE0A73,30661,2,4,2,109.37028,18.24361,1008
292495,372A5433078073EAD18922D679CE0A73,60411,4,5,1,109.32514,18.30854,869
292496,372A5433078073EAD18922D679CE0A73,60054,5,12,7,109.3016,18.31229,770
292497,372A5433078073EAD18922D679CE0A73,60411,14,18,4,109.32514,18.30854,869
292516,5780A06EB6BF6F352EB7920D095F7D55,30854,0,3,3,109.56889,18.27076,1763
292517,5780A06EB6BF6F352EB7920D095F7D55,60331,5,9,4,109.505,18.26507,1512
292518,5780A06EB6BF6F352EB7920D095F7D55,60201,10,20,10,109.5041,18.2509,1510
292519,5780A06EB6BF6F352EB7920D095F7D55,60291,21,22,1,109.50826,18.24639,1509
292528,50F6E2D553B36EAFE6AA22613C3D5EDD,31521,18,19,1,109.51458,18.22542,1555
292529,50F6E2D553B36EAFE6AA22613C3D5EDD,30191,21,22,1,109.50361,18.22701,1506
292573,B28B7AC1F3FE640DB97CA0FE887F5331,31431,17,18,1,109.44639,18.29042,1316
292574,B28B7AC1F3FE640DB97CA0FE887F5331,60401,20,23,3,109.47444,18.27583,1414
292584,65AD296DD65C9EEA3C22EA02904A768E,31561,0,8,8,109.56792,18.28479,1765
292585,65AD296DD65C9EEA3C22EA02904A768E,30854,10,18,8,109.56889,18.27076,1763
292586,65AD296DD65C9EEA3C22EA02904A768E,31561,21,23,2,109.56792,18.28479,1765
292626,7787090BDC7F8BDD60446754BDF84D74,30711,18,22,4,109.50271,18.25347,1510
292627,4A6E6277F47F7550E2618B9C1ADC3166,31391,13,14,1,109.50382,18.24285,1508
292628,4A6E6277F47F7550E2618B9C1ADC3166,30361,19,23,4,109.50347,18.24,1508
292629,C925EDC1C2C39BAEC75090090BF059D6,30741,0,13,13,109.49833,18.28681,1516
292630,C925EDC1C2C39BAEC75090090BF059D6,60201,15,17,2,109.5041,18.2509,1510
292631,C925EDC1C2C39BAEC75090090BF059D6,30741,21,23,2,109.49833,18.28681,1516
292659,D4EE8E1A4C04A1FF0596E4221D0B8B42,31071,12,14,2,109.58257,18.28458,1815
292660,D4EE8E1A4C04A1FF0596E4221D0B8B42,30854,14,15,1,109.56889,18.27076,1763
292661,D4EE8E1A4C04A1FF0596E4221D0B8B42,31071,19,20,1,109.58257,18.28458,1815
292662,D4EE8E1A4C04A1FF0596E4221D0B8B42,30854,20,23,3,109.56889,18.27076,1763
292670,C6A8E88AF4FAB8E3B900B709C1644500,30051,11,13,2,109.48917,18.21215,1453
292671,C6A8E88AF4FAB8E3B900B709C1644500,38831,13,16,3,109.4916,18.20938,1453
292765,1DA88ED70B6ADE8EAE3D8F549B029C10,31031,19,21,2,109.49979,18.25382,1510
292766,1DA88ED70B6ADE8EAE3D8F549B029C10,30511,22,23,1,109.51069,18.24208,1558
292767,26D16255CFD5E27173D1487C4D561ADC,30731,0,10,10,109.50944,18.22306,1555
292768,26D16255CFD5E27173D1487C4D561ADC,31521,13,15,2,109.51458,18.22542,1555
292769,26D16255CFD5E27173D1487C4D561ADC,30731,16,22,6,109.50944,18.22306,1555
292781,7A214C2AB4CE0E87DF8DB230B9F95561,30101,0,6,6,109.57299,18.33333,1773
292782,7A214C2AB4CE0E87DF8DB230B9F95561,31631,8,10,2,109.59542,18.36826,1879
292783,7A214C2AB4CE0E87DF8DB230B9F95561,30101,11,14,3,109.57299,18.33333,1773
292784,7A214C2AB4CE0E87DF8DB230B9F95561,31631,14,15,1,109.59542,18.36826,1879
292785,7A214C2AB4CE0E87DF8DB230B9F95561,30101,16,22,6,109.57299,18.33333,1773
292820,E5E7A1E4B2B3DFFE76B1825814C207C0,30201,0,2,2,109.4909,18.26465,1462
292821,E5E7A1E4B2B3DFFE76B1825814C207C0,30081,3,7,4,109.50243,18.26632,1512
292822,E5E7A1E4B2B3DFFE76B1825814C207C0,31561,8,15,7,109.56792,18.28479,1765
292823,E5E7A1E4B2B3DFFE76B1825814C207C0,30851,15,16,1,109.5616,18.27396,1713
292824,E5E7A1E4B2B3DFFE76B1825814C207C0,30081,18,23,5,109.50243,18.26632,1512
292841,C95F1B819829970A07CEDAA21DBD2FD7,60381,16,18,2,109.5241,18.22458,1605
292842,C95F1B819829970A07CEDAA21DBD2FD7,31461,18,20,2,109.5091,18.25389,1510
292845,C17F2EF1DEA79C8C951E3013EE071B2C,31071,0,8,8,109.58257,18.28458,1815
292856,17D13F6A66037B54FAB5668CDC734401,30721,0,10,10,109.51597,18.28257,1565
292857,17D13F6A66037B54FAB5668CDC734401,31931,15,16,1,109.54771,18.29403,1667
292858,17D13F6A66037B54FAB5668CDC734401,30721,19,23,4,109.51597,18.28257,1565
292893,FC9AD8EA090AECE5560DCF6C767B74D1,38706,0,8,8,109.74625,18.37097,2430
292894,FC9AD8EA090AECE5560DCF6C767B74D1,60117,9,10,1,109.73604,18.35681,2427
292895,FC9AD8EA090AECE5560DCF6C767B74D1,30581,12,22,10,109.62257,18.24951,1959
292900,C358285726113434A30FBBA8DED710E7,60371,0,6,6,109.53063,18.30056,1618
292901,C358285726113434A30FBBA8DED710E7,30921,6,8,2,109.53903,18.29451,1667
292902,C358285726113434A30FBBA8DED710E7,60371,8,10,2,109.53063,18.30056,1618
292903,C358285726113434A30FBBA8DED710E7,60171,15,16,1,109.51292,18.30694,1569
292904,C358285726113434A30FBBA8DED710E7,31621,20,22,2,109.51035,18.29826,1568
292907,8D3B10FD4DBC46DB93DA60040668F697,31561,16,17,1,109.56792,18.28479,1765
292908,8D3B10FD4DBC46DB93DA60040668F697,30854,18,22,4,109.56889,18.27076,1763
292911,19BFA3B1A13A0460E074AEFDAEDA87E2,30361,19,20,1,109.50347,18.24,1508
292912,19BFA3B1A13A0460E074AEFDAEDA87E2,31231,21,23,2,109.42597,18.29292,1217
292939,1E1181D91A7FDEE2449092386CA6A77C,60041,0,6,6,109.39889,18.31944,1121
292940,1E1181D91A7FDEE2449092386CA6A77C,31671,6,8,2,109.38965,18.29813,1068
292941,1E1181D91A7FDEE2449092386CA6A77C,60041,11,14,3,109.39889,18.31944,1121
292942,1E1181D91A7FDEE2449092386CA6A77C,60552,19,20,1,109.41729,18.30014,1218
292948,8621CFDF1B89A83351494618C53D033F,39181,11,16,5,109.55153,18.28035,1715
292949,8621CFDF1B89A83351494618C53D033F,31071,16,17,1,109.58257,18.28458,1815
292950,8621CFDF1B89A83351494618C53D033F,39181,17,23,6,109.55153,18.28035,1715
292955,3E0CC1F431A959DE24ABB41EC7702F6D,30351,0,1,1,109.41701,18.29292,1217
292956,3E0CC1F431A959DE24ABB41EC7702F6D,60524,2,8,6,109.42951,18.28993,1216
292957,3E0CC1F431A959DE24ABB41EC7702F6D,30351,8,15,7,109.41701,18.29292,1217
292958,3E0CC1F431A959DE24ABB41EC7702F6D,60552,16,17,1,109.41729,18.30014,1218
292959,3E0CC1F431A959DE24ABB41EC7702F6D,30361,20,22,2,109.50347,18.24,1508
292986,BE7763F8096EB5A037146E1CC4190538,30854,0,1,1,109.56889,18.27076,1763
292987,BE7763F8096EB5A037146E1CC4190538,31561,5,8,3,109.56792,18.28479,1765
292988,BE7763F8096EB5A037146E1CC4190538,31931,10,15,5,109.54771,18.29403,1667
292994,65DCC597AECA35C4AE4D4EA8A3F39D90,31561,0,7,7,109.56792,18.28479,1765
292995,65DCC597AECA35C4AE4D4EA8A3F39D90,39183,7,10,3,109.55542,18.28208,1715
292996,65DCC597AECA35C4AE4D4EA8A3F39D90,31561,12,14,2,109.56792,18.28479,1765
292997,65DCC597AECA35C4AE4D4EA8A3F39D90,39183,16,18,2,109.55542,18.28208,1715
293050,3B37E4844A39E6F1818E1379BCCB47C1,38951,0,9,9,109.48097,18.28868,1416
293051,3B37E4844A39E6F1818E1379BCCB47C1,38951,9,14,5,109.48097,18.28868,1416
293052,3B37E4844A39E6F1818E1379BCCB47C1,38951,18,19,1,109.48097,18.28868,1416
293053,3B37E4844A39E6F1818E1379BCCB47C1,38071,21,22,1,109.40722,18.30938,1169
293094,C3A14EA60E889BD61EB20D6BC5B6F46F,39321,1,5,4,109.529,18.2167,1604
293095,C3A14EA60E889BD61EB20D6BC5B6F46F,31521,6,7,1,109.51458,18.22542,1555
293097,C3A14EA60E889BD61EB20D6BC5B6F46F,60221,19,20,1,109.52569,18.29188,1616
293125,CD3BCBAB8571FB81953C842A434E5DB8,30854,7,10,3,109.56889,18.27076,1763
293126,CD3BCBAB8571FB81953C842A434E5DB8,31071,12,17,5,109.58257,18.28458,1815
293156,BAAEF1F815128F9C42A2F609EF6E43D2,31231,0,7,7,109.42597,18.29292,1217
293157,BAAEF1F815128F9C42A2F609EF6E43D2,31311,8,15,7,109.72299,18.27438,2364
293175,CB693B0353784C5EB4126F1C3868BEF8,33051,12,14,2,109.6475,18.46618,2096
293177,CB693B0353784C5EB4126F1C3868BEF8,30201,19,20,1,109.4909,18.26465,1462
293178,CB693B0353784C5EB4126F1C3868BEF8,31521,21,23,2,109.51458,18.22542,1555
293179,62CBF94D737D513D371567F698917827,31561,0,2,2,109.56792,18.28479,1765
293180,62CBF94D737D513D371567F698917827,30854,3,17,14,109.56889,18.27076,1763
293181,62CBF94D737D513D371567F698917827,31561,18,19,1,109.56792,18.28479,1765
293182,9DE8C13901CC7D63E2F1A6CC92603604,30851,0,1,1,109.5616,18.27396,1713
293183,9DE8C13901CC7D63E2F1A6CC92603604,30854,1,15,14,109.56889,18.27076,1763
293197,2DDF3A993BD69F79020EB97CF3A71819,38171,0,8,8,109.50799,18.28139,1515
293198,2DDF3A993BD69F79020EB97CF3A71819,30161,12,13,1,109.50042,18.24389,1508
293199,2DDF3A993BD69F79020EB97CF3A71819,39091,14,16,2,109.50097,18.25222,1510
293200,2DDF3A993BD69F79020EB97CF3A71819,30161,18,20,2,109.50042,18.24389,1508
293201,2DDF3A993BD69F79020EB97CF3A71819,38171,21,22,1,109.50799,18.28139,1515
293209,706B8E0F0F5D1C9FC2F8EBB2574EE89F,31461,0,10,10,109.5091,18.25389,1510
293210,706B8E0F0F5D1C9FC2F8EBB2574EE89F,30711,10,11,1,109.50271,18.25347,1510
293211,706B8E0F0F5D1C9FC2F8EBB2574EE89F,60201,12,14,2,109.5041,18.2509,1510
293212,706B8E0F0F5D1C9FC2F8EBB2574EE89F,31461,14,16,2,109.5091,18.25389,1510
293213,706B8E0F0F5D1C9FC2F8EBB2574EE89F,60201,17,20,3,109.5041,18.2509,1510
293214,706B8E0F0F5D1C9FC2F8EBB2574EE89F,30711,21,23,2,109.50271,18.25347,1510
293239,3C6B416FA80A7A03E14FC0317D60CB00,30854,7,8,1,109.56889,18.27076,1763
293240,3C6B416FA80A7A03E14FC0317D60CB00,31071,11,12,1,109.58257,18.28458,1815
293241,3C6B416FA80A7A03E14FC0317D60CB00,30854,13,18,5,109.56889,18.27076,1763
293258,12C98BDC1142E557FD566FD430E0D786,60131,1,7,6,109.49819,18.24778,1509
293304,DF85579B74AF19DE64EEDB1BF221CB5F,30191,0,10,10,109.50361,18.22701,1506
293307,0402BD114B7D5E20705E302B756CD062,31071,0,6,6,109.58257,18.28458,1815
293308,0402BD114B7D5E20705E302B756CD062,30854,7,8,1,109.56889,18.27076,1763
293309,0402BD114B7D5E20705E302B756CD062,60631,13,14,1,109.57778,18.27583,1814
293310,0402BD114B7D5E20705E302B756CD062,31071,15,16,1,109.58257,18.28458,1815
293311,0402BD114B7D5E20705E302B756CD062,30854,18,19,1,109.56889,18.27076,1763
293320,ACDEAAF45B65DE48CF80A48DBD3C775E,31071,3,17,14,109.58257,18.28458,1815
293321,ACDEAAF45B65DE48CF80A48DBD3C775E,30854,18,20,2,109.56889,18.27076,1763
293327,5EBEA276FCB4A19AC5C987F5C7CC8908,60621,0,7,7,109.48354,18.27451,1464
293328,5EBEA276FCB4A19AC5C987F5C7CC8908,38361,10,12,2,109.43667,18.29201,1267
293329,5EBEA276FCB4A19AC5C987F5C7CC8908,60401,12,13,1,109.47444,18.27583,1414
293330,5EBEA276FCB4A19AC5C987F5C7CC8908,60524,15,18,3,109.42951,18.28993,1216
293331,5EBEA276FCB4A19AC5C987F5C7CC8908,38391,20,21,1,109.44111,18.29083,1266
293332,5EBEA276FCB4A19AC5C987F5C7CC8908,60524,22,23,1,109.42951,18.28993,1216
293333,3B6FF1F8D896A0A62DC7E65967011999,39183,0,14,14,109.55542,18.28208,1715
293334,3B6FF1F8D896A0A62DC7E65967011999,31931,14,16,2,109.54771,18.29403,1667
293335,3B6FF1F8D896A0A62DC7E65967011999,30854,18,19,1,109.56889,18.27076,1763
293347,171A294CD4CE2D2C4D692BA99F9AA8C8,38134,0,9,9,109.63931,18.23451,2007
293348,171A294CD4CE2D2C4D692BA99F9AA8C8,31471,13,15,2,109.34583,18.29563,917
293349,171A294CD4CE2D2C4D692BA99F9AA8C8,31701,16,21,5,109.44132,18.28833,1266
293357,A5678EE319F8EC08843C9F20545373D3,60524,0,7,7,109.42951,18.28993,1216
293358,A5678EE319F8EC08843C9F20545373D3,31145,9,13,4,109.20431,18.30479,369
293359,A5678EE319F8EC08843C9F20545373D3,60524,18,21,3,109.42951,18.28993,1216
293364,DB4DF566D4757FF3BB488F82DE126248,31561,1,6,5,109.56792,18.28479,1765
293365,DB4DF566D4757FF3BB488F82DE126248,30851,8,10,2,109.5616,18.27396,1713
293366,DB4DF566D4757FF3BB488F82DE126248,31561,13,22,9,109.56792,18.28479,1765
293381,B55959B64746A18ECF5077B5F7359221,31561,11,12,1,109.56792,18.28479,1765
293382,B55959B64746A18ECF5077B5F7359221,39183,17,18,1,109.55542,18.28208,1715
293383,B55959B64746A18ECF5077B5F7359221,30741,21,22,1,109.49833,18.28681,1516
293391,16E640D9FA5593E85AD54BDFBAF952D8,31561,1,4,3,109.56792,18.28479,1765
293392,16E640D9FA5593E85AD54BDFBAF952D8,30854,6,8,2,109.56889,18.27076,1763
293393,16E640D9FA5593E85AD54BDFBAF952D8,60354,9,16,7,109.58701,18.28521,1815
293461,C8135D3E403B7CC96352A41CBCD291A7,38241,0,22,22,109.54111,18.30542,1669
293462,C8135D3E403B7CC96352A41CBCD291A7,31931,22,23,1,109.54771,18.29403,1667
293490,179FD4660C817BD29234A518F00339D3,60231,1,2,1,109.49903,18.21972,1504
293491,179FD4660C817BD29234A518F00339D3,39151,5,6,1,109.49875,18.25097,1510
293492,179FD4660C817BD29234A518F00339D3,60231,9,22,13,109.49903,18.21972,1504
293496,A0D7B7417A5826131879207628D9C43A,38157,15,16,1,109.51483,18.26958,1563
293497,A0D7B7417A5826131879207628D9C43A,30171,21,23,2,109.48458,18.27139,1463
293498,78DAB4F1681085A74E87373143D04310,30151,2,4,2,109.50986,18.25083,1560
293499,78DAB4F1681085A74E87373143D04310,30421,4,6,2,109.50021,18.25861,1511
293500,78DAB4F1681085A74E87373143D04310,31145,8,9,1,109.20431,18.30479,369
293501,78DAB4F1681085A74E87373143D04310,30421,14,16,2,109.50021,18.25861,1511
293502,78DAB4F1681085A74E87373143D04310,30151,20,23,3,109.50986,18.25083,1560
293520,5C77DC326C703C809C6D0E34E93F8F91,39371,11,14,3,109.56627,18.2646,1762
293526,7EB4F76900011DECC835981CBE847D5E,31561,3,11,8,109.56792,18.28479,1765
293527,7EB4F76900011DECC835981CBE847D5E,30281,14,17,3,109.50597,18.27583,1514
293528,41D4EB5552A7A416EEB26FAA30F55A4B,39183,0,14,14,109.55542,18.28208,1715
293529,41D4EB5552A7A416EEB26FAA30F55A4B,31561,16,17,1,109.56792,18.28479,1765
293530,41D4EB5552A7A416EEB26FAA30F55A4B,39183,17,19,2,109.55542,18.28208,1715
293603,6B806948BC9187A91D033B4096721B00,31071,7,15,8,109.58257,18.28458,1815
293604,6B806948BC9187A91D033B4096721B00,30854,18,20,2,109.56889,18.27076,1763
293605,DE5024DB59D5BF6AE5857A85EB7680EA,60631,16,17,1,109.57778,18.27583,1814
293606,DE5024DB59D5BF6AE5857A85EB7680EA,30181,20,21,1,109.51597,18.23313,1557
293612,9A78A2403CB27ECF6A4CA8077813C798,39151,9,16,7,109.49875,18.25097,1510
293695,E292D83051830D054E89D209EEABA4B9,31071,0,8,8,109.58257,18.28458,1815
293696,E292D83051830D054E89D209EEABA4B9,31561,9,11,2,109.56792,18.28479,1765
293697,E292D83051830D054E89D209EEABA4B9,31931,14,15,1,109.54771,18.29403,1667
293698,E292D83051830D054E89D209EEABA4B9,31561,19,20,1,109.56792,18.28479,1765
293755,C93386A9D86FE22A1FD4E5116045DD8D,30854,20,21,1,109.56889,18.27076,1763
293756,C93386A9D86FE22A1FD4E5116045DD8D,31561,21,23,2,109.56792,18.28479,1765
293766,2B8C748A18FA7D08D4335AD7C9DEF01B,31761,0,5,5,109.60521,18.27965,1914
293767,2B8C748A18FA7D08D4335AD7C9DEF01B,30851,8,10,2,109.5616,18.27396,1713
293768,2B8C748A18FA7D08D4335AD7C9DEF01B,31551,12,16,4,109.55868,18.24222,1708
293769,2B8C748A18FA7D08D4335AD7C9DEF01B,31761,18,22,4,109.60521,18.27965,1914
293811,F254D46EBC62915475CCD82A2F213AB7,60131,19,20,1,109.49819,18.24778,1509
293812,F254D46EBC62915475CCD82A2F213AB7,38251,22,23,1,109.49618,18.25493,1510
293816,BCF7902B3144684D44567B20BDAA780E,48647,0,12,12,109.48701,18.29042,1466
293819,37A308BBFD680DBD57B76B7C99CCD184,31931,5,6,1,109.54771,18.29403,1667
293820,37A308BBFD680DBD57B76B7C99CCD184,39101,10,15,5,109.50132,18.24931,1509
293821,37A308BBFD680DBD57B76B7C99CCD184,60221,18,23,5,109.52569,18.29188,1616
293827,19D15D3F765DDFCECEA9906D7BF44977,60291,0,7,7,109.50826,18.24639,1509
293828,19D15D3F765DDFCECEA9906D7BF44977,38891,9,12,3,109.51486,18.24118,1558
293829,19D15D3F765DDFCECEA9906D7BF44977,31201,16,18,2,109.51042,18.23819,1558
293837,3977578BE56276DA0700B04B81DC1356,30851,0,6,6,109.5616,18.27396,1713
293838,3977578BE56276DA0700B04B81DC1356,31561,6,9,3,109.56792,18.28479,1765
293839,3977578BE56276DA0700B04B81DC1356,30851,11,14,3,109.5616,18.27396,1713
293847,5205655EC583F6392BC68C8BB9865108,30854,15,16,1,109.56889,18.27076,1763
293848,5205655EC583F6392BC68C8BB9865108,31171,19,21,2,109.50938,18.24917,1559
293849,5205655EC583F6392BC68C8BB9865108,30854,21,23,2,109.56889,18.27076,1763
293877,B7E330D15F4B46614A332696B5F7027D,31071,15,16,1,109.58257,18.28458,1815
293878,B7E330D15F4B46614A332696B5F7027D,30854,17,18,1,109.56889,18.27076,1763
293879,B7E330D15F4B46614A332696B5F7027D,31931,18,23,5,109.54771,18.29403,1667
293883,070A398F07C013242CC3447B66DFACBF,39183,0,5,5,109.55542,18.28208,1715
293884,070A398F07C013242CC3447B66DFACBF,30071,8,9,1,109.52819,18.30472,1619
293885,070A398F07C013242CC3447B66DFACBF,31931,9,11,2,109.54771,18.29403,1667
293886,070A398F07C013242CC3447B66DFACBF,39183,11,23,12,109.55542,18.28208,1715
293916,13BA40EE4EE70A720415FEDCD3CD7B5F,31101,15,17,2,109.65389,18.23403,2057
293917,13BA40EE4EE70A720415FEDCD3CD7B5F,38361,21,22,1,109.43667,18.29201,1267
293932,0E129C09250C0D46273B4BD7E5225556,30151,0,6,6,109.50986,18.25083,1560
293933,0E129C09250C0D46273B4BD7E5225556,60201,6,10,4,109.5041,18.2509,1510
293934,0E129C09250C0D46273B4BD7E5225556,31251,11,13,2,109.18528,18.2975,317
293965,65DB2325B6E1E7A0D88A5D2D920F9EA1,31431,0,9,9,109.44639,18.29042,1316
293966,65DB2325B6E1E7A0D88A5D2D920F9EA1,60472,10,11,1,109.46625,18.29542,1367
293967,65DB2325B6E1E7A0D88A5D2D920F9EA1,31271,11,12,1,109.48958,18.26257,1462
293968,7EDB058C3EF2698839110C1DCC8B63DD,31311,0,9,9,109.72299,18.27438,2364
293971,7EDB058C3EF2698839110C1DCC8B63DD,60661,22,23,1,109.548,18.2377,1657
293972,56C8C781972E8BFAF8A768A19AD7F590,30281,0,7,7,109.50597,18.27583,1514
293995,C709D01469E0800AF998DFAF42105CDC,60631,3,5,2,109.57778,18.27583,1814
293996,C709D01469E0800AF998DFAF42105CDC,31561,6,15,9,109.56792,18.28479,1765
293997,C709D01469E0800AF998DFAF42105CDC,30854,15,22,7,109.56889,18.27076,1763
294010,FA14B010F60C7FB3B13194FAA13740E8,31561,0,4,4,109.56792,18.28479,1765
294011,FA14B010F60C7FB3B13194FAA13740E8,39183,9,13,4,109.55542,18.28208,1715
294012,FA14B010F60C7FB3B13194FAA13740E8,31561,14,15,1,109.56792,18.28479,1765
294013,FA14B010F60C7FB3B13194FAA13740E8,39183,16,17,1,109.55542,18.28208,1715
294014,FA14B010F60C7FB3B13194FAA13740E8,31561,21,23,2,109.56792,18.28479,1765
294015,451E2BF48CD7B253EB0892324E679BCC,31461,3,6,3,109.5091,18.25389,1510
294016,451E2BF48CD7B253EB0892324E679BCC,38291,6,12,6,109.51618,18.24313,1558
294017,451E2BF48CD7B253EB0892324E679BCC,60281,13,18,5,109.51743,18.25924,1561
294018,451E2BF48CD7B253EB0892324E679BCC,38291,18,21,3,109.51618,18.24313,1558
294019,451E2BF48CD7B253EB0892324E679BCC,38297,21,23,2,109.52576,18.24965,1609
294051,8883DF5E66B5FC284A8EF97DE8EAAAB3,31041,0,1,1,109.50278,18.23701,1507
294052,8883DF5E66B5FC284A8EF97DE8EAAAB3,30854,2,6,4,109.56889,18.27076,1763
294053,8883DF5E66B5FC284A8EF97DE8EAAAB3,31571,10,12,2,109.61563,18.23326,1957
294071,2C4460320CA36DFBF289BCF74C69B0D0,38903,0,7,7,109.39229,18.29243,1117
294072,2C4460320CA36DFBF289BCF74C69B0D0,38162,8,10,2,109.43944,18.28889,1266
294073,2C4460320CA36DFBF289BCF74C69B0D0,31701,12,18,6,109.44132,18.28833,1266
294089,DDE77D3A656666992FC3458B84010D43,39181,0,4,4,109.55153,18.28035,1715
294090,DDE77D3A656666992FC3458B84010D43,31561,5,8,3,109.56792,18.28479,1765
294091,DDE77D3A656666992FC3458B84010D43,39183,11,13,2,109.55542,18.28208,1715
294092,DDE77D3A656666992FC3458B84010D43,31561,14,15,1,109.56792,18.28479,1765
294105,E65B17C657BA16C2533DB76C0BC3AB34,30671,0,9,9,109.43611,18.30139,1268
294106,E65B17C657BA16C2533DB76C0BC3AB34,31351,9,11,2,109.4959,18.28417,1465
294107,E65B17C657BA16C2533DB76C0BC3AB34,30671,15,19,4,109.43611,18.30139,1268
294108,9D6320D3B3867D2B81B39F405CFAA76C,60054,12,14,2,109.3016,18.31229,770
294109,9D6320D3B3867D2B81B39F405CFAA76C,31781,15,16,1,109.19847,18.2975,367
294110,9D6320D3B3867D2B81B39F405CFAA76C,60281,18,20,2,109.51743,18.25924,1561
294125,2C3BD53A8702A47FB82F05FB4993B683,31561,0,5,5,109.56792,18.28479,1765
294126,2C3BD53A8702A47FB82F05FB4993B683,39183,6,16,10,109.55542,18.28208,1715
294134,807F73DE76DFE56E472FA61396F0887C,30361,16,17,1,109.50347,18.24,1508
294137,BA14385880EBEC70B287EA16B1B82E42,30854,13,21,8,109.56889,18.27076,1763
294138,BA14385880EBEC70B287EA16B1B82E42,31071,22,23,1,109.58257,18.28458,1815
294152,F6A1EBB84FE583E84185C423218578F5,39183,1,3,2,109.55542,18.28208,1715
294153,F6A1EBB84FE583E84185C423218578F5,31561,4,5,1,109.56792,18.28479,1765
294154,F6A1EBB84FE583E84185C423218578F5,39183,6,9,3,109.55542,18.28208,1715
294155,F6A1EBB84FE583E84185C423218578F5,31561,12,13,1,109.56792,18.28479,1765
294160,453A1B8CFD05945A8AE39F2B7AC01B79,30741,0,6,6,109.49833,18.28681,1516
294161,453A1B8CFD05945A8AE39F2B7AC01B79,39183,7,10,3,109.55542,18.28208,1715
294162,453A1B8CFD05945A8AE39F2B7AC01B79,30241,11,23,12,109.26174,18.3275,622
294163,866460FA5062A635337B6369BB2AADDA,60214,10,11,1,109.63104,18.24493,2009
294164,866460FA5062A635337B6369BB2AADDA,39183,14,16,2,109.55542,18.28208,1715
294165,866460FA5062A635337B6369BB2AADDA,30854,16,18,2,109.56889,18.27076,1763
294178,B7993F7A715835C0A2F82CB1FFA89538,38111,0,15,15,109.52007,18.22403,1555
294179,B7993F7A715835C0A2F82CB1FFA89538,38111,18,22,4,109.52007,18.22403,1555
294180,860D8FD1FD466E2189F245D42B766A0C,30271,0,10,10,109.49132,18.23153,1456
294181,860D8FD1FD466E2189F245D42B766A0C,31521,12,13,1,109.51458,18.22542,1555
294182,860D8FD1FD466E2189F245D42B766A0C,31851,17,18,1,109.71736,18.29007,2316
294183,860D8FD1FD466E2189F245D42B766A0C,38261,19,22,3,109.50361,18.28153,1515
294197,283001ED673D8EDBEF7EEB00BDB31533,31231,0,5,5,109.42597,18.29292,1217
294198,283001ED673D8EDBEF7EEB00BDB31533,30351,5,10,5,109.41701,18.29292,1217
294199,283001ED673D8EDBEF7EEB00BDB31533,31231,13,14,1,109.42597,18.29292,1217
294200,283001ED673D8EDBEF7EEB00BDB31533,30351,14,16,2,109.41701,18.29292,1217
294229,6A8C883D29A8AF90E102449F92489A64,31041,16,19,3,109.50278,18.23701,1507
294230,6A8C883D29A8AF90E102449F92489A64,30854,20,21,1,109.56889,18.27076,1763
294243,C3EC43179E51E2CA8AF203A259981D18,38754,14,16,2,109.74667,18.37382,2430
294244,C3EC43179E51E2CA8AF203A259981D18,30854,18,23,5,109.56889,18.27076,1763
294266,40C57F24FE0409ABB752B2031C349577,38951,0,4,4,109.48097,18.28868,1416
294267,40C57F24FE0409ABB752B2031C349577,38951,4,8,4,109.48097,18.28868,1416
294268,40C57F24FE0409ABB752B2031C349577,38951,8,10,2,109.48097,18.28868,1416
294326,B0C6DED232762D9BAF78468BD2731104,60491,0,9,9,109.43354,18.30847,1269
294327,B0C6DED232762D9BAF78468BD2731104,30771,13,14,1,109.49938,18.26042,1511
294328,B0C6DED232762D9BAF78468BD2731104,60041,15,17,2,109.39889,18.31944,1121
294329,B0C6DED232762D9BAF78468BD2731104,30771,18,22,4,109.49938,18.26042,1511
294345,CD576F1C1CDFB89E6A99A20E65927346,31561,4,6,2,109.56792,18.28479,1765
294346,CD576F1C1CDFB89E6A99A20E65927346,30854,7,19,12,109.56889,18.27076,1763
294363,0D61EA75C03A93303AE1706E6D1B22F4,30201,0,7,7,109.4909,18.26465,1462
294364,0D61EA75C03A93303AE1706E6D1B22F4,38153,9,11,2,109.51819,18.25736,1561
294365,0D61EA75C03A93303AE1706E6D1B22F4,30201,12,18,6,109.4909,18.26465,1462
294375,B712327B6033C61F37801CFD6DAC08AD,38484,0,5,5,109.53028,18.31528,1620
294376,B712327B6033C61F37801CFD6DAC08AD,30561,7,8,1,109.52778,18.31938,1621
294377,B712327B6033C61F37801CFD6DAC08AD,60361,8,13,5,109.51938,18.29681,1567
294378,B712327B6033C61F37801CFD6DAC08AD,38484,14,17,3,109.53028,18.31528,1620
294379,B712327B6033C61F37801CFD6DAC08AD,30561,20,22,2,109.52778,18.31938,1621
294384,30AB292EA71BCCA29EAC6C791311F4E2,30741,20,23,3,109.49833,18.28681,1516
294394,A7B3BDD8DC79485BA41EC7F220A41345,31071,2,3,1,109.58257,18.28458,1815
294395,A7B3BDD8DC79485BA41EC7F220A41345,30854,4,5,1,109.56889,18.27076,1763
294396,63FBAC0202144B00077561285E6A7F87,30821,0,8,8,109.43681,18.33639,1274
294397,63FBAC0202144B00077561285E6A7F87,30651,8,11,3,109.42611,18.385,1232
294398,63FBAC0202144B00077561285E6A7F87,30821,12,16,4,109.43681,18.33639,1274
294413,DF296B63A64E364FCDA4C38B0935EEEE,30511,0,7,7,109.51069,18.24208,1558
294414,DF296B63A64E364FCDA4C38B0935EEEE,60201,7,8,1,109.5041,18.2509,1510
294415,DF296B63A64E364FCDA4C38B0935EEEE,30511,8,22,14,109.51069,18.24208,1558
294416,DF296B63A64E364FCDA4C38B0935EEEE,38891,22,23,1,109.51486,18.24118,1558
294461,E755AD63601CF016CD8E32C53EBB1378,48574,0,12,12,109.48931,18.28458,1465
294462,E755AD63601CF016CD8E32C53EBB1378,30711,14,16,2,109.50271,18.25347,1510
294463,708F1BFEBD1E1B2DD48C4FB4053D14BA,30201,0,7,7,109.4909,18.26465,1462
294464,708F1BFEBD1E1B2DD48C4FB4053D14BA,30201,10,15,5,109.4909,18.26465,1462
294488,E75FA91D1B3B8DD834D1B7D77ECFF056,60381,0,4,4,109.5241,18.22458,1605
294489,E75FA91D1B3B8DD834D1B7D77ECFF056,31521,8,9,1,109.51458,18.22542,1555
294490,E75FA91D1B3B8DD834D1B7D77ECFF056,31781,11,13,2,109.19847,18.2975,367
294491,E75FA91D1B3B8DD834D1B7D77ECFF056,31781,13,16,3,109.19847,18.2975,367
294492,E75FA91D1B3B8DD834D1B7D77ECFF056,30731,17,19,2,109.50944,18.22306,1555
294493,E75FA91D1B3B8DD834D1B7D77ECFF056,31521,19,21,2,109.51458,18.22542,1555
294494,E75FA91D1B3B8DD834D1B7D77ECFF056,30731,21,23,2,109.50944,18.22306,1555
294629,18073AD9E71B8DFC1E520C5E3653B1BD,30721,0,7,7,109.51597,18.28257,1565
294630,18073AD9E71B8DFC1E520C5E3653B1BD,31951,11,12,1,109.52174,18.30299,1568
294631,18073AD9E71B8DFC1E520C5E3653B1BD,38881,14,15,1,109.51618,18.26431,1562
294652,C7052F3AD02E1F932680BEEA2AF77A5C,60381,19,22,3,109.5241,18.22458,1605
294653,C7052F3AD02E1F932680BEEA2AF77A5C,30711,22,23,1,109.50271,18.25347,1510
294662,C53B1AD12AB7ABCAA2CAFBE9EF3A2B34,31851,14,15,1,109.71736,18.29007,2316
294676,557A975BF2F1D3135462224F08758153,60221,0,6,6,109.52569,18.29188,1616
294677,557A975BF2F1D3135462224F08758153,30071,9,11,2,109.52819,18.30472,1619
294678,557A975BF2F1D3135462224F08758153,60221,12,14,2,109.52569,18.29188,1616
294679,557A975BF2F1D3135462224F08758153,38154,14,15,1,109.5266,18.28278,1615
294680,557A975BF2F1D3135462224F08758153,31951,18,22,4,109.52174,18.30299,1568
294707,491A112CD81B9085F752897809919691,30151,6,7,1,109.50986,18.25083,1560
294708,491A112CD81B9085F752897809919691,30181,7,9,2,109.51597,18.23313,1557
294709,491A112CD81B9085F752897809919691,31201,11,13,2,109.51042,18.23819,1558
294710,491A112CD81B9085F752897809919691,31201,14,16,2,109.51042,18.23819,1558
294711,491A112CD81B9085F752897809919691,31521,18,19,1,109.51458,18.22542,1555
294748,807332CEC38772FA8DF98C48FBD8DD1E,31561,0,6,6,109.56792,18.28479,1765
294749,807332CEC38772FA8DF98C48FBD8DD1E,39183,6,8,2,109.55542,18.28208,1715
294750,807332CEC38772FA8DF98C48FBD8DD1E,31561,8,23,15,109.56792,18.28479,1765
294755,A549C024E6F63EDBD3DC866F10DB11CE,31945,0,2,2,109.58021,18.29403,1817
294756,A549C024E6F63EDBD3DC866F10DB11CE,30854,5,10,5,109.56889,18.27076,1763
294757,A549C024E6F63EDBD3DC866F10DB11CE,30234,12,13,1,109.60681,18.29979,1918
294760,BAA9EFC72165A51675527E0DFEFC767F,30421,0,8,8,109.50021,18.25861,1511
294764,14DC797BA214017EE45D7C82C4CE6C66,60201,0,7,7,109.5041,18.2509,1510
294765,14DC797BA214017EE45D7C82C4CE6C66,60291,7,8,1,109.50826,18.24639,1509
294766,14DC797BA214017EE45D7C82C4CE6C66,38251,12,13,1,109.49618,18.25493,1510
294767,14DC797BA214017EE45D7C82C4CE6C66,38094,13,17,4,109.45403,18.28778,1316
294768,14DC797BA214017EE45D7C82C4CE6C66,60131,17,20,3,109.49819,18.24778,1509
294783,E4B522EF4348156010E5C578EC13D60F,30234,0,7,7,109.60681,18.29979,1918
294784,E4B522EF4348156010E5C578EC13D60F,30281,12,13,1,109.50597,18.27583,1514
294785,C5B2C146A715B405C4C002F4F3423FFB,30071,19,21,2,109.52819,18.30472,1619
294786,C5B2C146A715B405C4C002F4F3423FFB,31931,21,23,2,109.54771,18.29403,1667
294803,608A55C14BAB2A5B627ACC1F39B89FB6,31945,0,7,7,109.58021,18.29403,1817
294804,608A55C14BAB2A5B627ACC1F39B89FB6,30854,7,15,8,109.56889,18.27076,1763
294805,608A55C14BAB2A5B627ACC1F39B89FB6,31945,18,22,4,109.58021,18.29403,1817
294855,10EBF762D28520B09848288F7052CFDE,30854,0,6,6,109.56889,18.27076,1763
294856,10EBF762D28520B09848288F7052CFDE,39101,7,17,10,109.50132,18.24931,1509
294881,963B5F4C98446446023B8ED177B869B3,60361,0,7,7,109.51938,18.29681,1567
294882,963B5F4C98446446023B8ED177B869B3,31561,7,8,1,109.56792,18.28479,1765
294883,963B5F4C98446446023B8ED177B869B3,39181,11,12,1,109.55153,18.28035,1715
294884,963B5F4C98446446023B8ED177B869B3,39183,15,16,1,109.55542,18.28208,1715
294885,963B5F4C98446446023B8ED177B869B3,60361,19,23,4,109.51938,18.29681,1567
294950,DF5348A8E25901EBB63BBF3F6126BB02,31071,6,9,3,109.58257,18.28458,1815
294951,DF5348A8E25901EBB63BBF3F6126BB02,30854,13,22,9,109.56889,18.27076,1763
294952,DF5348A8E25901EBB63BBF3F6126BB02,31071,22,23,1,109.58257,18.28458,1815
294973,2C5F898948A2B7909519666936FBF333,38707,0,10,10,109.73778,18.35368,2427
294974,2C5F898948A2B7909519666936FBF333,38707,13,14,1,109.73778,18.35368,2427
294975,2C5F898948A2B7909519666936FBF333,60117,19,23,4,109.73604,18.35681,2427
294976,3BD938E13C8C03EC810FA672D0264137,31851,7,8,1,109.71736,18.29007,2316
294977,3BD938E13C8C03EC810FA672D0264137,38754,9,11,2,109.74667,18.37382,2430
294978,3BD938E13C8C03EC810FA672D0264137,31851,13,14,1,109.71736,18.29007,2316
294979,3BD938E13C8C03EC810FA672D0264137,30731,17,18,1,109.50944,18.22306,1555
294980,3BD938E13C8C03EC810FA672D0264137,60041,21,22,1,109.39889,18.31944,1121
294985,998285CC628D14C76697C580F37BFCB3,30854,9,18,9,109.56889,18.27076,1763
295015,37DC2EF674B0D61C6D10D120CF46E31D,60221,0,9,9,109.52569,18.29188,1616
295016,37DC2EF674B0D61C6D10D120CF46E31D,31461,11,17,6,109.5091,18.25389,1510
295017,37DC2EF674B0D61C6D10D120CF46E31D,60221,19,23,4,109.52569,18.29188,1616
295018,7AF4921BC4D1712A961904D0ECC91550,60251,0,5,5,109.51229,18.325,1572
295019,7AF4921BC4D1712A961904D0ECC91550,30071,8,22,14,109.52819,18.30472,1619
295020,89A01963B06628A3D6B13DA41FA507D1,31561,0,11,11,109.56792,18.28479,1765
295021,89A01963B06628A3D6B13DA41FA507D1,30854,13,14,1,109.56889,18.27076,1763
295022,89A01963B06628A3D6B13DA41FA507D1,31561,17,18,1,109.56792,18.28479,1765
295024,1026894DC5FF9A7FAF3A2EE28B95E239,30854,0,10,10,109.56889,18.27076,1763
295025,1026894DC5FF9A7FAF3A2EE28B95E239,30232,12,16,4,109.6191,18.31701,1971
295026,1026894DC5FF9A7FAF3A2EE28B95E239,30854,19,23,4,109.56889,18.27076,1763
295037,FB78BA035409FF816D7E7985C2AAAB1F,60571,0,7,7,109.50722,18.25056,1510
295050,A01B4012B619D942E7CC3AC9B78722B4,31561,0,2,2,109.56792,18.28479,1765
295051,A01B4012B619D942E7CC3AC9B78722B4,30854,2,7,5,109.56889,18.27076,1763
295052,A01B4012B619D942E7CC3AC9B78722B4,31561,7,21,14,109.56792,18.28479,1765
295063,D70D11871FB47AB4743A9AB8A25E5AA8,60241,16,18,2,109.53319,18.28667,1616
295064,D70D11871FB47AB4743A9AB8A25E5AA8,38241,19,23,4,109.54111,18.30542,1669
295067,C153552CEA2677B0FF473AE565EA979E,30821,0,9,9,109.43681,18.33639,1274
295068,C153552CEA2677B0FF473AE565EA979E,30651,10,11,1,109.42611,18.385,1232
295069,C153552CEA2677B0FF473AE565EA979E,30821,12,15,3,109.43681,18.33639,1274
295073,417408FFDA93B177641D270D3A5C4B2D,31071,0,5,5,109.58257,18.28458,1815
295074,417408FFDA93B177641D270D3A5C4B2D,30854,7,16,9,109.56889,18.27076,1763
295075,417408FFDA93B177641D270D3A5C4B2D,31071,20,21,1,109.58257,18.28458,1815
295166,F866B6E34CEF853A6497211DD74A607E,31781,12,14,2,109.19847,18.2975,367
295167,F866B6E34CEF853A6497211DD74A607E,31221,19,20,1,109.61333,18.26833,1913
295168,F866B6E34CEF853A6497211DD74A607E,30581,20,21,1,109.62257,18.24951,1959
295194,D4448A1349B0563C78F16B479359A95F,31071,2,6,4,109.58257,18.28458,1815
295195,D4448A1349B0563C78F16B479359A95F,30854,10,14,4,109.56889,18.27076,1763
295220,977B047FDC414AF497F7474C1B57AB53,31301,10,13,3,109.14493,18.31222,170
295221,977B047FDC414AF497F7474C1B57AB53,31471,14,16,2,109.34583,18.29563,917
295248,BD4652414D5C17466BA36FD4BD943A94,30721,1,2,1,109.51597,18.28257,1565
295249,BD4652414D5C17466BA36FD4BD943A94,60221,2,6,4,109.52569,18.29188,1616
295250,BD4652414D5C17466BA36FD4BD943A94,31931,10,12,2,109.54771,18.29403,1667
295308,528F99F7FD8CA49B85B45B64A5D784BA,39181,0,1,1,109.55153,18.28035,1715
295309,528F99F7FD8CA49B85B45B64A5D784BA,39183,3,10,7,109.55542,18.28208,1715
295310,528F99F7FD8CA49B85B45B64A5D784BA,30851,12,21,9,109.5616,18.27396,1713
295322,AF8B86B0B083254392EBA97EA612D81F,60371,1,5,4,109.53063,18.30056,1618
295323,AF8B86B0B083254392EBA97EA612D81F,31931,6,7,1,109.54771,18.29403,1667
295324,AF8B86B0B083254392EBA97EA612D81F,31951,8,12,4,109.52174,18.30299,1568
295325,AF8B86B0B083254392EBA97EA612D81F,31931,12,13,1,109.54771,18.29403,1667
295328,BC2EDF4DF9C7FAD55BDEABA03DFA7284,39181,11,12,1,109.55153,18.28035,1715
295329,BC2EDF4DF9C7FAD55BDEABA03DFA7284,39183,16,17,1,109.55542,18.28208,1715
295330,BC2EDF4DF9C7FAD55BDEABA03DFA7284,31561,19,20,1,109.56792,18.28479,1765
295389,B3F4E43DA3C4E855A3ED684A6CB97F36,31931,7,9,2,109.54771,18.29403,1667
295390,B3F4E43DA3C4E855A3ED684A6CB97F36,31781,11,15,4,109.19847,18.2975,367
295406,F09FA024A3E2DFBDA7DF33869DEBF9A1,30271,0,8,8,109.49132,18.23153,1456
295407,F09FA024A3E2DFBDA7DF33869DEBF9A1,30171,9,11,2,109.48458,18.27139,1463
295408,F09FA024A3E2DFBDA7DF33869DEBF9A1,60084,12,14,2,109.4984,18.2334,1507
295409,238275AB416C5FADC48DECC442F08D48,30861,19,21,2,109.52722,18.22743,1606
295410,238275AB416C5FADC48DECC442F08D48,31521,21,22,1,109.51458,18.22542,1555
295446,75817DB682187A07461734D66E1E6492,60631,0,4,4,109.57778,18.27583,1814
295447,75817DB682187A07461734D66E1E6492,30854,5,20,15,109.56889,18.27076,1763
295448,75817DB682187A07461734D66E1E6492,60631,21,22,1,109.57778,18.27583,1814
295455,4ADA61D538F345B0D3199AFC58D5D8E2,31351,0,10,10,109.4959,18.28417,1465
295456,4ADA61D538F345B0D3199AFC58D5D8E2,31471,14,16,2,109.34583,18.29563,917
295457,4ADA61D538F345B0D3199AFC58D5D8E2,31351,18,23,5,109.4959,18.28417,1465
295465,799220958664C2795E31D21DB72AB004,30071,0,20,20,109.52819,18.30472,1619
295466,799220958664C2795E31D21DB72AB004,60371,20,23,3,109.53063,18.30056,1618
295467,005F3AEFE6DBF371ED1FD57736434098,31071,0,5,5,109.58257,18.28458,1815
295468,005F3AEFE6DBF371ED1FD57736434098,30854,8,10,2,109.56889,18.27076,1763
295469,005F3AEFE6DBF371ED1FD57736434098,31071,13,14,1,109.58257,18.28458,1815
295470,005F3AEFE6DBF371ED1FD57736434098,30854,19,20,1,109.56889,18.27076,1763
295471,005F3AEFE6DBF371ED1FD57736434098,31071,21,23,2,109.58257,18.28458,1815
295496,C13109DDB34AB39863FA7554436B5462,38291,0,5,5,109.51618,18.24313,1558
295497,C13109DDB34AB39863FA7554436B5462,31261,8,10,2,109.51174,18.2466,1559
295498,C13109DDB34AB39863FA7554436B5462,30051,14,17,3,109.48917,18.21215,1453
295505,8C2C88A2570BC7163EE5C8FCDA6504D2,31201,15,16,1,109.51042,18.23819,1558
295506,8C2C88A2570BC7163EE5C8FCDA6504D2,30181,16,18,2,109.51597,18.23313,1557
295507,8C2C88A2570BC7163EE5C8FCDA6504D2,30181,21,23,2,109.51597,18.23313,1557
295536,F5679723FB4AA5B56D261497814C1AB4,60401,0,6,6,109.47444,18.27583,1414
295537,F5679723FB4AA5B56D261497814C1AB4,60621,7,8,1,109.48354,18.27451,1464
295538,F5679723FB4AA5B56D261497814C1AB4,31471,11,15,4,109.34583,18.29563,917
295539,ABCD0851CC1C78BCD7AF6DBDF2F5DE49,60401,6,7,1,109.47444,18.27583,1414
295540,ABCD0851CC1C78BCD7AF6DBDF2F5DE49,60552,9,10,1,109.41729,18.30014,1218
295541,ABCD0851CC1C78BCD7AF6DBDF2F5DE49,60524,11,12,1,109.42951,18.28993,1216
295542,ABCD0851CC1C78BCD7AF6DBDF2F5DE49,60552,12,19,7,109.41729,18.30014,1218
295548,5E97A4561E11AAC4FBC53FD068EAA52B,30531,13,21,8,109.53271,18.21472,1604
295549,5E97A4561E11AAC4FBC53FD068EAA52B,30854,21,23,2,109.56889,18.27076,1763
295562,C19430CE8DF26BDEF43903E57E682236,31561,0,7,7,109.56792,18.28479,1765
295563,C19430CE8DF26BDEF43903E57E682236,30854,11,21,10,109.56889,18.27076,1763
295564,C19430CE8DF26BDEF43903E57E682236,31561,21,23,2,109.56792,18.28479,1765
295572,E6541B4F346982101D887BAAF0315541,30854,0,7,7,109.56889,18.27076,1763
295573,E6541B4F346982101D887BAAF0315541,31561,10,17,7,109.56792,18.28479,1765
295574,E6541B4F346982101D887BAAF0315541,30854,20,23,3,109.56889,18.27076,1763
295590,AB6EA8E0EB921375D4ACF50883707DA2,30081,0,6,6,109.50243,18.26632,1512
295591,AB6EA8E0EB921375D4ACF50883707DA2,30084,6,8,2,109.50118,18.26972,1513
295592,AB6EA8E0EB921375D4ACF50883707DA2,30511,10,11,1,109.51069,18.24208,1558
295593,AB6EA8E0EB921375D4ACF50883707DA2,30281,13,14,1,109.50597,18.27583,1514
295607,7252A0F90E29EC78621699C082578EF7,30711,0,1,1,109.50271,18.25347,1510
295608,7252A0F90E29EC78621699C082578EF7,30911,1,7,6,109.50493,18.26181,1511
295609,7252A0F90E29EC78621699C082578EF7,60504,9,16,7,109.47917,18.28903,1416
295610,7252A0F90E29EC78621699C082578EF7,31431,20,23,3,109.44639,18.29042,1316
295614,CE70D3AAC3EF6B01DB8A5F34BD94E77D,30821,1,2,1,109.43681,18.33639,1274
295615,CE70D3AAC3EF6B01DB8A5F34BD94E77D,30651,3,5,2,109.42611,18.385,1232
295616,CE70D3AAC3EF6B01DB8A5F34BD94E77D,30821,5,22,17,109.43681,18.33639,1274
295654,614FF11A716656363443555E30C1ED90,38754,14,15,1,109.74667,18.37382,2430
295655,614FF11A716656363443555E30C1ED90,30361,19,23,4,109.50347,18.24,1508
295700,B3B9E7CAA281FDC11E6B1AB8159D5D86,31201,5,8,3,109.51042,18.23819,1558
295701,B3B9E7CAA281FDC11E6B1AB8159D5D86,30511,8,10,2,109.51069,18.24208,1558
295702,B3B9E7CAA281FDC11E6B1AB8159D5D86,31201,12,23,11,109.51042,18.23819,1558
295703,C6FC3BC8F39125E5FB7F384B2CB5A668,33051,11,13,2,109.6475,18.46618,2096
295704,C6FC3BC8F39125E5FB7F384B2CB5A668,30854,17,18,1,109.56889,18.27076,1763
295705,C6FC3BC8F39125E5FB7F384B2CB5A668,60221,19,20,1,109.52569,18.29188,1616
295708,4E94ADAE7ABEB20EEFAF67519DFCC1BE,31081,0,8,8,109.44639,18.30181,1318
295709,4E94ADAE7ABEB20EEFAF67519DFCC1BE,31031,9,21,12,109.49979,18.25382,1510
295725,89FBAD5ECA927DDE2F269DE418286B71,30791,12,18,6,109.72333,18.40889,2386
295726,89FBAD5ECA927DDE2F269DE418286B71,31091,19,20,1,109.41201,18.31222,1170
295767,6FBDDF7419820F8908B8A8CE3C81E7C3,30171,0,5,5,109.48458,18.27139,1463
295768,6FBDDF7419820F8908B8A8CE3C81E7C3,60621,7,11,4,109.48354,18.27451,1464
295769,6FBDDF7419820F8908B8A8CE3C81E7C3,60401,13,15,2,109.47444,18.27583,1414
295770,6FBDDF7419820F8908B8A8CE3C81E7C3,30171,16,17,1,109.48458,18.27139,1463
295771,6FBDDF7419820F8908B8A8CE3C81E7C3,60401,22,23,1,109.47444,18.27583,1414
295802,7A6FA68DEF3DC3D7B02A26590A74E0F0,31071,6,7,1,109.58257,18.28458,1815
295803,7A6FA68DEF3DC3D7B02A26590A74E0F0,31031,10,11,1,109.49979,18.25382,1510
295804,7A6FA68DEF3DC3D7B02A26590A74E0F0,30854,16,17,1,109.56889,18.27076,1763
295821,4EFA26B7BBE10FFA0F7013E0F210FD9B,38903,1,8,7,109.39229,18.29243,1117
295822,4EFA26B7BBE10FFA0F7013E0F210FD9B,38325,12,14,2,109.39792,18.2909,1116
295823,4EFA26B7BBE10FFA0F7013E0F210FD9B,31671,14,15,1,109.38965,18.29813,1068
295824,E987CA4A1E047E111B5BA701616DDAD3,31931,0,1,1,109.54771,18.29403,1667
295825,E987CA4A1E047E111B5BA701616DDAD3,31071,1,8,7,109.58257,18.28458,1815
295826,E987CA4A1E047E111B5BA701616DDAD3,31071,10,11,1,109.58257,18.28458,1815
295827,E987CA4A1E047E111B5BA701616DDAD3,30851,12,13,1,109.5616,18.27396,1713
295831,5793648B72B1A755037A2568E7D7481F,38105,0,7,7,109.40299,18.29229,1117
295832,5793648B72B1A755037A2568E7D7481F,31681,8,10,2,109.40396,18.29979,1168
295833,5793648B72B1A755037A2568E7D7481F,31145,12,14,2,109.20431,18.30479,369
295834,5793648B72B1A755037A2568E7D7481F,38105,16,18,2,109.40299,18.29229,1117
295841,874B1DEE34891BC74B0E782C57027407,60281,0,6,6,109.51743,18.25924,1561
295842,874B1DEE34891BC74B0E782C57027407,30421,7,10,3,109.50021,18.25861,1511
295843,874B1DEE34891BC74B0E782C57027407,30361,14,20,6,109.50347,18.24,1508
295844,874B1DEE34891BC74B0E782C57027407,30171,22,23,1,109.48458,18.27139,1463
295845,CE2F4784729107FCC048F6386F4B6BD2,31861,1,2,1,109.49042,18.27549,1464
295846,CE2F4784729107FCC048F6386F4B6BD2,31021,3,4,1,109.49021,18.27,1463
295847,CE2F4784729107FCC048F6386F4B6BD2,31861,4,6,2,109.49042,18.27549,1464
295848,CE2F4784729107FCC048F6386F4B6BD2,31864,7,8,1,109.49014,18.28333,1465
295865,662D882A6A10D0E6C3566690F0A40636,31071,1,6,5,109.58257,18.28458,1815
295866,662D882A6A10D0E6C3566690F0A40636,30854,9,18,9,109.56889,18.27076,1763
295867,662D882A6A10D0E6C3566690F0A40636,60381,18,21,3,109.5241,18.22458,1605
295872,35C6EDC8AAC6B5ABA770190223528BA2,60381,0,6,6,109.5241,18.22458,1605
295873,35C6EDC8AAC6B5ABA770190223528BA2,31521,11,12,1,109.51458,18.22542,1555
295874,35C6EDC8AAC6B5ABA770190223528BA2,60041,14,15,1,109.39889,18.31944,1121
295879,0526FBDD03CECB7E3925506B4441EC17,31443,0,9,9,109.5116,18.24438,1559
295880,0526FBDD03CECB7E3925506B4441EC17,30511,10,20,10,109.51069,18.24208,1558
295940,6ECDAC78F6AC4B567D95A309E3788C97,60371,16,17,1,109.53063,18.30056,1618
295941,6ECDAC78F6AC4B567D95A309E3788C97,60361,18,22,4,109.51938,18.29681,1567
295975,770A00BDAFE9BCA8C9E9FA68066EED7D,31071,0,6,6,109.58257,18.28458,1815
295976,770A00BDAFE9BCA8C9E9FA68066EED7D,31561,8,21,13,109.56792,18.28479,1765
296027,DC0EB400EA24BEE9EB39D315B0E6AEF0,60041,0,7,7,109.39889,18.31944,1121
296028,DC0EB400EA24BEE9EB39D315B0E6AEF0,31701,10,14,4,109.44132,18.28833,1266
296033,FFFC0994E5C15BDB165344716912442C,30854,1,4,3,109.56889,18.27076,1763
296034,FFFC0994E5C15BDB165344716912442C,39371,5,6,1,109.56627,18.2646,1762
296035,FFFC0994E5C15BDB165344716912442C,31554,7,17,10,109.55521,18.2459,1709
296036,FFFC0994E5C15BDB165344716912442C,31551,19,20,1,109.55868,18.24222,1708
296037,FFFC0994E5C15BDB165344716912442C,30854,21,23,2,109.56889,18.27076,1763
296043,79B3727B5613EF3F60EFCD1531AA56DA,38961,9,12,3,109.50847,18.23514,1507
296044,79B3727B5613EF3F60EFCD1531AA56DA,31206,12,14,2,109.50819,18.23549,1507
296045,79B3727B5613EF3F60EFCD1531AA56DA,30181,14,16,2,109.51597,18.23313,1557
296046,79B3727B5613EF3F60EFCD1531AA56DA,30181,17,18,1,109.51597,18.23313,1557
296047,79B3727B5613EF3F60EFCD1531AA56DA,38961,19,21,2,109.50847,18.23514,1507
296048,79B3727B5613EF3F60EFCD1531AA56DA,30181,22,23,1,109.51597,18.23313,1557
296094,46D3900FF4CD0CE137E6DB2E5BBC5B87,39183,0,5,5,109.55542,18.28208,1715
296095,46D3900FF4CD0CE137E6DB2E5BBC5B87,31931,6,7,1,109.54771,18.29403,1667
296096,46D3900FF4CD0CE137E6DB2E5BBC5B87,39183,12,23,11,109.55542,18.28208,1715
296115,0125189CAB0CF2CF2538FA07CD6C9B13,30861,12,13,1,109.52722,18.22743,1606
296116,0125189CAB0CF2CF2538FA07CD6C9B13,60381,14,17,3,109.5241,18.22458,1605
296117,0125189CAB0CF2CF2538FA07CD6C9B13,31421,19,22,3,109.55382,18.22347,1705
296128,8AD9F37216B2D3FCE05CA77434307672,30741,0,8,8,109.49833,18.28681,1516
296129,8AD9F37216B2D3FCE05CA77434307672,30324,13,14,1,109.50326,18.29257,1517
296130,8AD9F37216B2D3FCE05CA77434307672,31041,15,17,2,109.50278,18.23701,1507
296131,8AD9F37216B2D3FCE05CA77434307672,31461,18,19,1,109.5091,18.25389,1510
296132,8AD9F37216B2D3FCE05CA77434307672,30361,21,22,1,109.50347,18.24,1508
296144,E191BF114A3C2277CB7C3323BAA13F43,31561,1,6,5,109.56792,18.28479,1765
296145,E191BF114A3C2277CB7C3323BAA13F43,30854,8,11,3,109.56889,18.27076,1763
296146,E191BF114A3C2277CB7C3323BAA13F43,31561,12,13,1,109.56792,18.28479,1765
296147,E191BF114A3C2277CB7C3323BAA13F43,30854,13,18,5,109.56889,18.27076,1763
296148,E191BF114A3C2277CB7C3323BAA13F43,31561,18,20,2,109.56792,18.28479,1765
296156,B81DEDE33B0853E35D97557F334A4861,60361,0,6,6,109.51938,18.29681,1567
296157,B81DEDE33B0853E35D97557F334A4861,31931,6,10,4,109.54771,18.29403,1667
296158,B81DEDE33B0853E35D97557F334A4861,60371,10,11,1,109.53063,18.30056,1618
296159,B81DEDE33B0853E35D97557F334A4861,31931,13,15,2,109.54771,18.29403,1667
296160,B81DEDE33B0853E35D97557F334A4861,60371,15,16,1,109.53063,18.30056,1618
296161,B81DEDE33B0853E35D97557F334A4861,60361,18,23,5,109.51938,18.29681,1567
296173,279E4B9468E6485253E3AD5AB807E2AE,31071,1,8,7,109.58257,18.28458,1815
296174,279E4B9468E6485253E3AD5AB807E2AE,30854,12,14,2,109.56889,18.27076,1763
296175,279E4B9468E6485253E3AD5AB807E2AE,31071,18,23,5,109.58257,18.28458,1815
296176,A68637AA89BD62624E677D9E66C32FAD,30361,14,18,4,109.50347,18.24,1508
296177,A68637AA89BD62624E677D9E66C32FAD,30151,18,20,2,109.50986,18.25083,1560
296178,A68637AA89BD62624E677D9E66C32FAD,30361,21,23,2,109.50347,18.24,1508
296200,E8D51F8B53F290BFD73338AD2AD8C728,31561,3,6,3,109.56792,18.28479,1765
296201,E8D51F8B53F290BFD73338AD2AD8C728,30851,6,7,1,109.5616,18.27396,1713
296202,E8D51F8B53F290BFD73338AD2AD8C728,39183,8,15,7,109.55542,18.28208,1715
296203,E8D51F8B53F290BFD73338AD2AD8C728,30851,15,16,1,109.5616,18.27396,1713
296204,E8D51F8B53F290BFD73338AD2AD8C728,31561,21,22,1,109.56792,18.28479,1765
296205,5181D36DA7C2B30D8787EFAFB9BDA0A6,30201,13,18,5,109.4909,18.26465,1462
296206,5181D36DA7C2B30D8787EFAFB9BDA0A6,31271,20,23,3,109.48958,18.26257,1462
296214,D77A5C2E97A74D805A87772560CE2BFF,31421,0,2,2,109.55382,18.22347,1705
296215,D77A5C2E97A74D805A87772560CE2BFF,60661,3,4,1,109.548,18.2377,1657
296216,D77A5C2E97A74D805A87772560CE2BFF,31421,9,13,4,109.55382,18.22347,1705
296217,D77A5C2E97A74D805A87772560CE2BFF,60661,15,17,2,109.548,18.2377,1657
296218,D77A5C2E97A74D805A87772560CE2BFF,31421,21,23,2,109.55382,18.22347,1705
296228,5F8201E6B61274044E839FD7CFD93F63,39151,4,6,2,109.49875,18.25097,1510
296229,5F8201E6B61274044E839FD7CFD93F63,60201,7,9,2,109.5041,18.2509,1510
296230,5F8201E6B61274044E839FD7CFD93F63,30581,14,15,1,109.62257,18.24951,1959
296231,5F8201E6B61274044E839FD7CFD93F63,60381,17,20,3,109.5241,18.22458,1605
296251,3389A095460231D31BA622B7185D6321,31231,0,6,6,109.42597,18.29292,1217
296252,3389A095460231D31BA622B7185D6321,60541,6,8,2,109.4084,18.29208,1167
296253,3389A095460231D31BA622B7185D6321,31681,8,15,7,109.40396,18.29979,1168
296254,3389A095460231D31BA622B7185D6321,60541,15,17,2,109.4084,18.29208,1167
296255,3389A095460231D31BA622B7185D6321,31231,20,22,2,109.42597,18.29292,1217
296278,C73F853CCBF7708CEEEDE5C7FB7E0D81,60201,0,3,3,109.5041,18.2509,1510
296279,C73F853CCBF7708CEEEDE5C7FB7E0D81,30711,4,6,2,109.50271,18.25347,1510
296280,C73F853CCBF7708CEEEDE5C7FB7E0D81,30711,6,8,2,109.50271,18.25347,1510
296289,4FE38A259CD9CA4D16D21E385E254E6B,31521,0,9,9,109.51458,18.22542,1555
296290,4FE38A259CD9CA4D16D21E385E254E6B,60054,12,13,1,109.3016,18.31229,770
296291,4FE38A259CD9CA4D16D21E385E254E6B,31521,18,22,4,109.51458,18.22542,1555
296299,EE1DC3D3663945EFC02BAB5EE6A065E9,31071,0,6,6,109.58257,18.28458,1815
296300,EE1DC3D3663945EFC02BAB5EE6A065E9,30854,7,10,3,109.56889,18.27076,1763
296301,EE1DC3D3663945EFC02BAB5EE6A065E9,31071,13,14,1,109.58257,18.28458,1815
296302,EE1DC3D3663945EFC02BAB5EE6A065E9,31945,14,15,1,109.58021,18.29403,1817
296303,EE1DC3D3663945EFC02BAB5EE6A065E9,30854,16,18,2,109.56889,18.27076,1763
296304,EE1DC3D3663945EFC02BAB5EE6A065E9,31071,20,21,1,109.58257,18.28458,1815
296346,72177A73AAAB20F72EF042BBE6E3BE32,60221,10,18,8,109.52569,18.29188,1616
296347,72177A73AAAB20F72EF042BBE6E3BE32,31411,19,20,1,109.5016,18.23576,1507
296387,85D2E0E28FB58C7F8A0D7BC94160D3DD,31561,0,7,7,109.56792,18.28479,1765
296388,85D2E0E28FB58C7F8A0D7BC94160D3DD,30854,7,17,10,109.56889,18.27076,1763
296389,85D2E0E28FB58C7F8A0D7BC94160D3DD,31561,19,22,3,109.56792,18.28479,1765
296390,A989E432A34968A6D5E2DE0CFBC28422,30051,2,7,5,109.48917,18.21215,1453
296391,A989E432A34968A6D5E2DE0CFBC28422,39321,9,13,4,109.529,18.2167,1604
296392,A989E432A34968A6D5E2DE0CFBC28422,30051,14,15,1,109.48917,18.21215,1453
296393,A989E432A34968A6D5E2DE0CFBC28422,39321,16,22,6,109.529,18.2167,1604
296402,77A180FA90A8F66A03EF34FAA544F484,31471,13,15,2,109.34583,18.29563,917
296403,77A180FA90A8F66A03EF34FAA544F484,30661,18,20,2,109.37028,18.24361,1008
296404,77A180FA90A8F66A03EF34FAA544F484,60411,21,23,2,109.32514,18.30854,869
296429,A9FCE0049DB44FE004EAFBF5B783F4A5,31945,1,19,18,109.58021,18.29403,1817
296430,A9FCE0049DB44FE004EAFBF5B783F4A5,31071,20,22,2,109.58257,18.28458,1815
296455,0270DAEF3EF6B3B2DABFFC55A64C6B34,31471,13,14,1,109.34583,18.29563,917
296456,0270DAEF3EF6B3B2DABFFC55A64C6B34,30171,17,21,4,109.48458,18.27139,1463
296474,201045A9C980BD8E53B16B9129DFE596,31071,0,5,5,109.58257,18.28458,1815
296475,201045A9C980BD8E53B16B9129DFE596,30854,6,7,1,109.56889,18.27076,1763
296476,201045A9C980BD8E53B16B9129DFE596,31561,8,16,8,109.56792,18.28479,1765
296477,201045A9C980BD8E53B16B9129DFE596,31071,20,22,2,109.58257,18.28458,1815
296497,01ECC36953381CE72C016208317495FE,30771,0,7,7,109.49938,18.26042,1511
296498,01ECC36953381CE72C016208317495FE,31145,8,10,2,109.20431,18.30479,369
296499,01ECC36953381CE72C016208317495FE,60321,13,15,2,109.63611,18.24306,2008
296501,EC721F8259E3B17F432086B3F60AECE1,31554,0,3,3,109.55521,18.2459,1709
296502,EC721F8259E3B17F432086B3F60AECE1,31551,3,5,2,109.55868,18.24222,1708
296503,EC721F8259E3B17F432086B3F60AECE1,30051,6,10,4,109.48917,18.21215,1453
296504,EC721F8259E3B17F432086B3F60AECE1,30051,11,15,4,109.48917,18.21215,1453
296505,A94F66C88B84FF0658441320CD9F667C,60631,3,4,1,109.57778,18.27583,1814
296506,A94F66C88B84FF0658441320CD9F667C,30854,8,13,5,109.56889,18.27076,1763
296515,7024F3A14F6F554DC6E80063E30315F0,31561,1,4,3,109.56792,18.28479,1765
296516,7024F3A14F6F554DC6E80063E30315F0,39183,8,16,8,109.55542,18.28208,1715
296517,7024F3A14F6F554DC6E80063E30315F0,31561,20,23,3,109.56792,18.28479,1765
296533,C14D1B427B7E4D81EF61B9A5CEA7D7AC,38023,0,7,7,109.37132,18.28993,1016
296538,215105BD5DABC32D5AB3BF02FEF380FF,31521,0,13,13,109.51458,18.22542,1555
296539,215105BD5DABC32D5AB3BF02FEF380FF,31781,15,16,1,109.19847,18.2975,367
296578,8B167331F8E78254A4CBA6A89A1236BC,60161,14,16,2,109.49174,18.26181,1461
296579,8B167331F8E78254A4CBA6A89A1236BC,60084,16,18,2,109.4984,18.2334,1507
296580,8B167331F8E78254A4CBA6A89A1236BC,60524,21,22,1,109.42951,18.28993,1216
296606,F00821368F615DCDAF214035D8EC4A44,30854,14,18,4,109.56889,18.27076,1763
296607,F00821368F615DCDAF214035D8EC4A44,31071,19,20,1,109.58257,18.28458,1815
296608,F00821368F615DCDAF214035D8EC4A44,30854,21,22,1,109.56889,18.27076,1763
296609,8C0E6B51FAFE21C31FB9AE08C36DF0A2,30071,0,18,18,109.52819,18.30472,1619
296610,8C0E6B51FAFE21C31FB9AE08C36DF0A2,31931,18,20,2,109.54771,18.29403,1667
296631,770049901BD1590EBE86EED8F56910D2,31391,20,21,1,109.50382,18.24285,1508
296714,409F5E8F01172D32BBE91132149C037E,38371,0,7,7,109.50972,18.23924,1558
296715,409F5E8F01172D32BBE91132149C037E,30511,11,12,1,109.51069,18.24208,1558
296718,53490AD77ACCA93C3ED0F3DE79CA488B,31071,11,12,1,109.58257,18.28458,1815
296719,53490AD77ACCA93C3ED0F3DE79CA488B,30854,14,20,6,109.56889,18.27076,1763
296739,3963776B8D4E0FE3D76B833D367A499E,31231,0,17,17,109.42597,18.29292,1217
296740,3963776B8D4E0FE3D76B833D367A499E,60551,18,22,4,109.42722,18.30111,1218
296770,46CE0B466E804E1721D4C7FB123D7148,30741,0,6,6,109.49833,18.28681,1516
296773,46CE0B466E804E1721D4C7FB123D7148,30741,19,23,4,109.49833,18.28681,1516
296777,CA270603E07BFD84E81CD1B62EEBFEDA,31781,15,16,1,109.19847,18.2975,367
296778,CA270603E07BFD84E81CD1B62EEBFEDA,38754,19,21,2,109.74667,18.37382,2430
296781,98BC08E1CDA3F375385918E822A1184B,31931,0,14,14,109.54771,18.29403,1667
296782,98BC08E1CDA3F375385918E822A1184B,30071,14,16,2,109.52819,18.30472,1619
296783,98BC08E1CDA3F375385918E822A1184B,31931,20,23,3,109.54771,18.29403,1667
296786,83865250E5CCE3477CF5EC458983B28B,39091,0,19,19,109.50097,18.25222,1510
296787,83865250E5CCE3477CF5EC458983B28B,60081,21,23,2,109.51097,18.22639,1556
296806,3156215AB6E0ED7C8AC4A32B10F06A65,60524,2,9,7,109.42951,18.28993,1216
296807,3156215AB6E0ED7C8AC4A32B10F06A65,31031,13,14,1,109.49979,18.25382,1510
296819,3BD201CEDCBB0C6283517FCB62C04811,30181,0,12,12,109.51597,18.23313,1557
296820,3BD201CEDCBB0C6283517FCB62C04811,38961,15,16,1,109.50847,18.23514,1507
296821,3BD201CEDCBB0C6283517FCB62C04811,60081,16,17,1,109.51097,18.22639,1556
296822,3BD201CEDCBB0C6283517FCB62C04811,38961,20,23,3,109.50847,18.23514,1507
296843,B80D4B4CDBD08237A9C4254F8883AEF4,39151,0,7,7,109.49875,18.25097,1510
296844,B80D4B4CDBD08237A9C4254F8883AEF4,31181,7,9,2,109.50382,18.24813,1509
296845,B80D4B4CDBD08237A9C4254F8883AEF4,30711,10,11,1,109.50271,18.25347,1510
296846,B80D4B4CDBD08237A9C4254F8883AEF4,39091,13,15,2,109.50097,18.25222,1510
296847,38AA3DA5E97F70E8689E8DE10EE9EB59,30854,0,8,8,109.56889,18.27076,1763
296849,38AA3DA5E97F70E8689E8DE10EE9EB59,30854,13,14,1,109.56889,18.27076,1763
296850,3A484AED43EBFC77572B117C1C49420B,31081,0,6,6,109.44639,18.30181,1318
296851,3A484AED43EBFC77572B117C1C49420B,31471,7,9,2,109.34583,18.29563,917
296852,3A484AED43EBFC77572B117C1C49420B,31471,10,12,2,109.34583,18.29563,917
296853,3A484AED43EBFC77572B117C1C49420B,60054,12,14,2,109.3016,18.31229,770
296854,3A484AED43EBFC77572B117C1C49420B,31471,14,17,3,109.34583,18.29563,917
296855,3A484AED43EBFC77572B117C1C49420B,30761,20,22,2,109.45201,18.3,1318
296867,CCCD2290FB632A48009771412BE68ADD,31561,0,11,11,109.56792,18.28479,1765
296868,CCCD2290FB632A48009771412BE68ADD,39183,14,16,2,109.55542,18.28208,1715
296869,CCCD2290FB632A48009771412BE68ADD,31561,19,21,2,109.56792,18.28479,1765
296872,8799356B7181F28146A203E5F86C52F0,60381,18,21,3,109.5241,18.22458,1605
296873,8799356B7181F28146A203E5F86C52F0,30741,21,23,2,109.49833,18.28681,1516
296900,3DF04EEBD52CECF1C5996BD8607451EE,30351,0,10,10,109.41701,18.29292,1217
296905,99CBAA6A65A50998F0A10B72B36210E4,60231,0,1,1,109.49903,18.21972,1504
296906,99CBAA6A65A50998F0A10B72B36210E4,39151,3,5,2,109.49875,18.25097,1510
296907,99CBAA6A65A50998F0A10B72B36210E4,60231,7,22,15,109.49903,18.21972,1504
296923,FEA371B99B04FC8CCEB8F07D4D5C7BA2,60281,18,19,1,109.51743,18.25924,1561
296924,FEA371B99B04FC8CCEB8F07D4D5C7BA2,38127,19,23,4,109.50833,18.27222,1513
296933,7EBC20D0E5F0FBA046CA1D08E7FF47C1,31071,5,6,1,109.58257,18.28458,1815
296934,7EBC20D0E5F0FBA046CA1D08E7FF47C1,30854,10,18,8,109.56889,18.27076,1763
296948,D1300109B338AA3BEF146D962603C6CB,60671,0,6,6,109.52979,18.31757,1621
296949,D1300109B338AA3BEF146D962603C6CB,30071,9,11,2,109.52819,18.30472,1619
296950,D1300109B338AA3BEF146D962603C6CB,60291,13,14,1,109.50826,18.24639,1509
296960,37D38EF0062E64D55C94EB554B76F9EE,31071,1,2,1,109.58257,18.28458,1815
296961,37D38EF0062E64D55C94EB554B76F9EE,31945,4,6,2,109.58021,18.29403,1817
296962,37D38EF0062E64D55C94EB554B76F9EE,30854,8,9,1,109.56889,18.27076,1763
296963,37D38EF0062E64D55C94EB554B76F9EE,30281,12,13,1,109.50597,18.27583,1514
297003,F5E480BCE870DAE347CB60AA32F4CA1B,31071,0,6,6,109.58257,18.28458,1815
297004,F5E480BCE870DAE347CB60AA32F4CA1B,30854,10,11,1,109.56889,18.27076,1763
297005,F5E480BCE870DAE347CB60AA32F4CA1B,31071,13,23,10,109.58257,18.28458,1815
297016,020753EF78F0A0C39658113A3377EA1E,31561,0,7,7,109.56792,18.28479,1765
297017,020753EF78F0A0C39658113A3377EA1E,39183,7,10,3,109.55542,18.28208,1715
297018,020753EF78F0A0C39658113A3377EA1E,31931,11,12,1,109.54771,18.29403,1667
297019,020753EF78F0A0C39658113A3377EA1E,39183,15,16,1,109.55542,18.28208,1715
297037,1122041491C04B199A15F6E1E401D68F,60281,0,4,4,109.51743,18.25924,1561
297038,1122041491C04B199A15F6E1E401D68F,30461,4,7,3,109.5116,18.26313,1562
297039,1122041491C04B199A15F6E1E401D68F,60281,7,14,7,109.51743,18.25924,1561
297040,1122041491C04B199A15F6E1E401D68F,30461,18,23,5,109.5116,18.26313,1562
297050,744908594665C830F5D7DD2D0AC61E3F,60524,0,2,2,109.42951,18.28993,1216
297051,744908594665C830F5D7DD2D0AC61E3F,39151,3,6,3,109.49875,18.25097,1510
297053,744908594665C830F5D7DD2D0AC61E3F,60381,15,17,2,109.5241,18.22458,1605
297054,744908594665C830F5D7DD2D0AC61E3F,30191,19,23,4,109.50361,18.22701,1506
297080,E2EFA8BC0580FFAF96EC3E9753740AD9,38094,8,9,1,109.45403,18.28778,1316
297081,E2EFA8BC0580FFAF96EC3E9753740AD9,30421,9,12,3,109.50021,18.25861,1511
297082,E2EFA8BC0580FFAF96EC3E9753740AD9,38251,13,14,1,109.49618,18.25493,1510
297084,C36A64D4A6D72B66303543285987394A,31461,11,13,2,109.5091,18.25389,1510
297085,C36A64D4A6D72B66303543285987394A,31864,14,20,6,109.49014,18.28333,1465
297086,C36A64D4A6D72B66303543285987394A,60501,21,23,2,109.48701,18.29021,1466
297095,8C1099DEED57B63CAF4C9A1B76A91E98,30511,13,15,2,109.51069,18.24208,1558
297125,012ABD06F231728C214A4BA917E75B1C,30851,4,5,1,109.5616,18.27396,1713
297126,012ABD06F231728C214A4BA917E75B1C,31561,6,23,17,109.56792,18.28479,1765
297172,1980C8D409DE9551539224B3D393CDAA,30071,1,12,11,109.52819,18.30472,1619
297173,1980C8D409DE9551539224B3D393CDAA,31951,12,16,4,109.52174,18.30299,1568
297174,1980C8D409DE9551539224B3D393CDAA,30071,19,23,4,109.52819,18.30472,1619
297197,BEE3A0C9BB09D7F210E3490BED90A1BE,60371,0,7,7,109.53063,18.30056,1618
297198,BEE3A0C9BB09D7F210E3490BED90A1BE,30071,7,11,4,109.52819,18.30472,1619
297199,BEE3A0C9BB09D7F210E3490BED90A1BE,60371,12,17,5,109.53063,18.30056,1618
297200,BEE3A0C9BB09D7F210E3490BED90A1BE,30071,18,19,1,109.52819,18.30472,1619
297201,BEE3A0C9BB09D7F210E3490BED90A1BE,60371,19,23,4,109.53063,18.30056,1618
297253,D61883A9E0C7F2103C981F95E51C66DA,31931,0,6,6,109.54771,18.29403,1667
297254,D61883A9E0C7F2103C981F95E51C66DA,39321,10,14,4,109.529,18.2167,1604
297255,D61883A9E0C7F2103C981F95E51C66DA,30861,14,17,3,109.52722,18.22743,1606
297256,D61883A9E0C7F2103C981F95E51C66DA,39321,19,21,2,109.529,18.2167,1604
297262,99002E6383DE5A5B6F8A2B2BF47C2DE1,31061,0,7,7,109.53333,18.23257,1607
297263,99002E6383DE5A5B6F8A2B2BF47C2DE1,60301,10,11,1,109.60715,18.30993,1919
297264,99002E6383DE5A5B6F8A2B2BF47C2DE1,60381,14,18,4,109.5241,18.22458,1605
297265,99002E6383DE5A5B6F8A2B2BF47C2DE1,31061,19,20,1,109.53333,18.23257,1607
297266,99002E6383DE5A5B6F8A2B2BF47C2DE1,38071,21,22,1,109.40722,18.30938,1169
297273,F3EA4B3DF8A619A30272A53ECD9E968F,30461,0,2,2,109.5116,18.26313,1562
297274,F3EA4B3DF8A619A30272A53ECD9E968F,38185,3,6,3,109.51333,18.27347,1563
297275,F3EA4B3DF8A619A30272A53ECD9E968F,30251,9,10,1,109.50611,18.26653,1512
297276,F3EA4B3DF8A619A30272A53ECD9E968F,30711,13,15,2,109.50271,18.25347,1510
297295,6ADBEFDC21CA46F051933BF984A8E255,30854,2,8,6,109.56889,18.27076,1763
297296,6ADBEFDC21CA46F051933BF984A8E255,31071,9,22,13,109.58257,18.28458,1815
297326,E60ED1E1BF063E0844329EA0E7251BDC,30661,0,6,6,109.37028,18.24361,1008
297327,E60ED1E1BF063E0844329EA0E7251BDC,60411,7,9,2,109.32514,18.30854,869
297328,E60ED1E1BF063E0844329EA0E7251BDC,31471,9,15,6,109.34583,18.29563,917
297344,08077B5D5F0A9938A81D328635D03C8B,30854,0,15,15,109.56889,18.27076,1763
297345,08077B5D5F0A9938A81D328635D03C8B,31071,15,16,1,109.58257,18.28458,1815
297346,08077B5D5F0A9938A81D328635D03C8B,30854,18,20,2,109.56889,18.27076,1763
297347,189633BA4D39EBA8A203BC9E364D4B1F,30381,1,7,6,109.52521,18.24507,1609
297348,189633BA4D39EBA8A203BC9E364D4B1F,30051,8,15,7,109.48917,18.21215,1453
297349,189633BA4D39EBA8A203BC9E364D4B1F,38013,17,21,4,109.49514,18.21951,1454
297413,377B71D252968E1BF1EC3B7B3FD9F9AC,31521,15,17,2,109.51458,18.22542,1555
297414,377B71D252968E1BF1EC3B7B3FD9F9AC,31521,19,23,4,109.51458,18.22542,1555
297438,7198AE5D28E6EEC6FA2A3E21485072AD,30051,0,13,13,109.48917,18.21215,1453
297439,7198AE5D28E6EEC6FA2A3E21485072AD,60401,14,16,2,109.47444,18.27583,1414
297440,7198AE5D28E6EEC6FA2A3E21485072AD,30051,20,23,3,109.48917,18.21215,1453
297441,6422CB87ACC55DDEF6EBE8946593C808,31351,0,7,7,109.4959,18.28417,1465
297442,6422CB87ACC55DDEF6EBE8946593C808,60231,8,9,1,109.49903,18.21972,1504
297443,6422CB87ACC55DDEF6EBE8946593C808,60211,11,13,2,109.63549,18.26049,2011
297444,6422CB87ACC55DDEF6EBE8946593C808,30051,14,15,1,109.48917,18.21215,1453
297445,6422CB87ACC55DDEF6EBE8946593C808,31201,15,17,2,109.51042,18.23819,1558
297446,6422CB87ACC55DDEF6EBE8946593C808,30391,21,23,2,109.4975,18.27118,1513
297458,1412BA3B65BC1A2354CCBE297098A0E1,30281,12,13,1,109.50597,18.27583,1514
297459,1412BA3B65BC1A2354CCBE297098A0E1,30854,14,16,2,109.56889,18.27076,1763
297479,53453D8B736810206EC5A6632D159BE6,31931,0,7,7,109.54771,18.29403,1667
297480,53453D8B736810206EC5A6632D159BE6,39101,9,12,3,109.50132,18.24931,1509
297481,53453D8B736810206EC5A6632D159BE6,31931,14,23,9,109.54771,18.29403,1667
297490,FA724E83D7D22E41E07D0D2550D22166,31071,12,17,5,109.58257,18.28458,1815
297491,FA724E83D7D22E41E07D0D2550D22166,30854,18,20,2,109.56889,18.27076,1763
297492,FA724E83D7D22E41E07D0D2550D22166,31071,21,23,2,109.58257,18.28458,1815
297493,9EBFE19AEC38C3A6F47AE2D903294BAE,60211,15,18,3,109.63549,18.26049,2011
297494,9EBFE19AEC38C3A6F47AE2D903294BAE,31071,19,20,1,109.58257,18.28458,1815
297513,D96E01B8E0F0DE9C160C9FEAFDCFDB6D,31071,1,7,6,109.58257,18.28458,1815
297514,D96E01B8E0F0DE9C160C9FEAFDCFDB6D,30854,8,18,10,109.56889,18.27076,1763
297539,27EF636E06F07DE3B49333ADB4121040,31351,2,9,7,109.4959,18.28417,1465
297540,27EF636E06F07DE3B49333ADB4121040,60121,12,13,1,109.74507,18.37472,2430
297541,27EF636E06F07DE3B49333ADB4121040,60381,15,16,1,109.5241,18.22458,1605
297542,27EF636E06F07DE3B49333ADB4121040,60261,21,22,1,109.44326,18.3075,1319
297548,E450E9940D87A0177BBD06EB4A11C623,31321,0,8,8,109.63799,18.23201,2007
297549,E450E9940D87A0177BBD06EB4A11C623,38754,10,13,3,109.74667,18.37382,2430
297550,E450E9940D87A0177BBD06EB4A11C623,31031,15,17,2,109.49979,18.25382,1510
297559,5B5FB16F9BE2A1826D497C2695908410,31561,2,9,7,109.56792,18.28479,1765
297560,5B5FB16F9BE2A1826D497C2695908410,30854,10,11,1,109.56889,18.27076,1763
297591,40285EE8CCE25C38988EC087545664EC,31071,4,7,3,109.58257,18.28458,1815
297592,40285EE8CCE25C38988EC087545664EC,30854,9,10,1,109.56889,18.27076,1763
297593,40285EE8CCE25C38988EC087545664EC,31071,15,16,1,109.58257,18.28458,1815
297594,40285EE8CCE25C38988EC087545664EC,30854,17,19,2,109.56889,18.27076,1763
297595,34EC12898EF350285E14A0DA28399618,30854,0,19,19,109.56889,18.27076,1763
297596,34EC12898EF350285E14A0DA28399618,31561,20,21,1,109.56792,18.28479,1765
297601,468231DFF07583BA8A222D360B2FDB3A,60501,0,8,8,109.48701,18.29021,1466
297602,468231DFF07583BA8A222D360B2FDB3A,30084,9,17,8,109.50118,18.26972,1513
297627,C8922FAF66F21ECAECB6B717FCD5A53B,60504,1,5,4,109.47917,18.28903,1416
297628,C8922FAF66F21ECAECB6B717FCD5A53B,60614,6,22,16,109.48799,18.29521,1467
297642,9E8746086915F9D4A063A74CF0B5B7AB,39183,16,18,2,109.55542,18.28208,1715
297643,9E8746086915F9D4A063A74CF0B5B7AB,31561,20,21,1,109.56792,18.28479,1765
297644,601485EE1975CD21F8AEB362220395E5,31231,0,4,4,109.42597,18.29292,1217
297645,601485EE1975CD21F8AEB362220395E5,38102,4,6,2,109.40875,18.29111,1166
297646,601485EE1975CD21F8AEB362220395E5,31231,7,11,4,109.42597,18.29292,1217
297647,601485EE1975CD21F8AEB362220395E5,30711,13,16,3,109.50271,18.25347,1510
297648,601485EE1975CD21F8AEB362220395E5,31041,19,20,1,109.50278,18.23701,1507
297649,601485EE1975CD21F8AEB362220395E5,31231,21,23,2,109.42597,18.29292,1217
297653,2B60907F04C29DE058B3E64B1D3B4100,30854,0,6,6,109.56889,18.27076,1763
297654,2B60907F04C29DE058B3E64B1D3B4100,31561,7,8,1,109.56792,18.28479,1765
297669,51DF765CB634D9549D20AD1F2C37BA18,31561,3,9,6,109.56792,18.28479,1765
297670,51DF765CB634D9549D20AD1F2C37BA18,31931,14,15,1,109.54771,18.29403,1667
297680,033CEEC20746801745CF4A53CD517C31,31171,1,7,6,109.50938,18.24917,1559
297681,033CEEC20746801745CF4A53CD517C31,60291,11,14,3,109.50826,18.24639,1509
297682,033CEEC20746801745CF4A53CD517C31,30421,15,16,1,109.50021,18.25861,1511
297683,033CEEC20746801745CF4A53CD517C31,60201,19,23,4,109.5041,18.2509,1510
297719,E9E473F09C342630187345312F4A31D8,39181,0,16,16,109.55153,18.28035,1715
297720,E9E473F09C342630187345312F4A31D8,39181,20,23,3,109.55153,18.28035,1715
297748,08A066736557478B1013C0CF834491DF,31931,1,17,16,109.54771,18.29403,1667
297749,08A066736557478B1013C0CF834491DF,30921,18,19,1,109.53903,18.29451,1667
297785,00FC332040A284DA251A8D0705989FE9,31071,0,9,9,109.58257,18.28458,1815
297786,00FC332040A284DA251A8D0705989FE9,30854,14,23,9,109.56889,18.27076,1763
297823,5169AE4C4AE9067320D7FAAA8A39A4BE,31511,0,5,5,109.26326,18.40521,635
297825,5169AE4C4AE9067320D7FAAA8A39A4BE,31511,17,22,5,109.26326,18.40521,635
297829,D46DE9169E4BACF1D272EA5E0FDEF68F,39181,5,10,5,109.55153,18.28035,1715
297830,D46DE9169E4BACF1D272EA5E0FDEF68F,31561,10,11,1,109.56792,18.28479,1765
297831,D46DE9169E4BACF1D272EA5E0FDEF68F,39183,14,20,6,109.55542,18.28208,1715
297845,39F25FE146A03325C93C111F2A943B6C,31945,0,13,13,109.58021,18.29403,1817
297846,39F25FE146A03325C93C111F2A943B6C,31071,15,17,2,109.58257,18.28458,1815
297847,39F25FE146A03325C93C111F2A943B6C,31945,20,23,3,109.58021,18.29403,1817
297913,996108A86471458B319C4287B4728CCB,38891,0,6,6,109.51486,18.24118,1558
297914,996108A86471458B319C4287B4728CCB,31521,6,10,4,109.51458,18.22542,1555
297915,996108A86471458B319C4287B4728CCB,31521,11,13,2,109.51458,18.22542,1555
297916,996108A86471458B319C4287B4728CCB,31521,14,15,1,109.51458,18.22542,1555
297917,996108A86471458B319C4287B4728CCB,38891,19,20,1,109.51486,18.24118,1558
297918,996108A86471458B319C4287B4728CCB,31521,21,23,2,109.51458,18.22542,1555
297931,B34415F599F0ED7D1A073EE314A60B9B,31671,1,17,16,109.38965,18.29813,1068
297932,B34415F599F0ED7D1A073EE314A60B9B,60041,19,23,4,109.39889,18.31944,1121
297945,443D183C692C6C6B0CFC9BE76827D81A,31521,0,7,7,109.51458,18.22542,1555
297947,443D183C692C6C6B0CFC9BE76827D81A,30181,17,18,1,109.51597,18.23313,1557
297948,443D183C692C6C6B0CFC9BE76827D81A,31521,19,23,4,109.51458,18.22542,1555
297958,248CE0B148D688C343222BB27AEE2380,31071,0,5,5,109.58257,18.28458,1815
297959,248CE0B148D688C343222BB27AEE2380,30854,7,8,1,109.56889,18.27076,1763
297960,248CE0B148D688C343222BB27AEE2380,60631,12,13,1,109.57778,18.27583,1814
297961,248CE0B148D688C343222BB27AEE2380,30854,14,15,1,109.56889,18.27076,1763
297962,248CE0B148D688C343222BB27AEE2380,30181,19,21,2,109.51597,18.23313,1557
298037,1D60D001EBDC67D77E1C6037DB507422,31561,0,8,8,109.56792,18.28479,1765
298038,1D60D001EBDC67D77E1C6037DB507422,30854,8,10,2,109.56889,18.27076,1763
298039,1D60D001EBDC67D77E1C6037DB507422,31561,10,11,1,109.56792,18.28479,1765
298040,1D60D001EBDC67D77E1C6037DB507422,30854,13,21,8,109.56889,18.27076,1763
298081,8624CC6420981EE53672D566FC963FD7,60411,0,1,1,109.32514,18.30854,869
298082,8624CC6420981EE53672D566FC963FD7,30661,5,14,9,109.37028,18.24361,1008
298083,8624CC6420981EE53672D566FC963FD7,60411,14,16,2,109.32514,18.30854,869
298084,8624CC6420981EE53672D566FC963FD7,30661,16,23,7,109.37028,18.24361,1008
298085,C6579823835B85A254880E72927E82BB,30891,0,1,1,109.59431,18.28389,1865
298086,C6579823835B85A254880E72927E82BB,30854,4,6,2,109.56889,18.27076,1763
298087,C6579823835B85A254880E72927E82BB,39371,10,21,11,109.56627,18.2646,1762
298180,14F1CC63CDA098F9694EAC8584B9C7A5,31071,0,5,5,109.58257,18.28458,1815
298181,14F1CC63CDA098F9694EAC8584B9C7A5,31561,9,10,1,109.56792,18.28479,1765
298182,14F1CC63CDA098F9694EAC8584B9C7A5,30854,10,18,8,109.56889,18.27076,1763
298183,14F1CC63CDA098F9694EAC8584B9C7A5,31561,19,20,1,109.56792,18.28479,1765
298254,1D8B814EC83D52D7C5F3FED99C129EE0,30854,3,5,2,109.56889,18.27076,1763
298255,1D8B814EC83D52D7C5F3FED99C129EE0,60631,5,8,3,109.57778,18.27583,1814
298256,1D8B814EC83D52D7C5F3FED99C129EE0,38271,9,10,1,109.62632,18.23049,1956
298269,13A6EDC75AEBF90A555AE4ABEB3F9FCC,30851,1,4,3,109.5616,18.27396,1713
298270,13A6EDC75AEBF90A555AE4ABEB3F9FCC,39181,6,11,5,109.55153,18.28035,1715
298271,13A6EDC75AEBF90A555AE4ABEB3F9FCC,39181,12,17,5,109.55153,18.28035,1715
298272,13A6EDC75AEBF90A555AE4ABEB3F9FCC,30851,22,23,1,109.5616,18.27396,1713
298284,7C5883A3068E88CA8565279A1905B1B6,30201,19,21,2,109.4909,18.26465,1462
298285,7C5883A3068E88CA8565279A1905B1B6,39321,21,23,2,109.529,18.2167,1604
298291,A3F1517845C5D84C612625B9AE2F7500,30854,20,21,1,109.56889,18.27076,1763
298292,A3F1517845C5D84C612625B9AE2F7500,31071,22,23,1,109.58257,18.28458,1815
298300,79CCA269D4D1544F735C077DABC1670F,30731,0,5,5,109.50944,18.22306,1555
298301,79CCA269D4D1544F735C077DABC1670F,31521,6,7,1,109.51458,18.22542,1555
298302,79CCA269D4D1544F735C077DABC1670F,33051,10,13,3,109.6475,18.46618,2096
298303,4F1F2C63B1D8098AD9ABA50013979078,31461,0,9,9,109.5091,18.25389,1510
298410,23019CE071DC0B0CEC6E78ADA422CE57,60201,0,5,5,109.5041,18.2509,1510
298411,23019CE071DC0B0CEC6E78ADA422CE57,31461,6,9,3,109.5091,18.25389,1510
298412,23019CE071DC0B0CEC6E78ADA422CE57,38973,11,13,2,109.51097,18.25389,1560
298413,23019CE071DC0B0CEC6E78ADA422CE57,38127,18,21,3,109.50833,18.27222,1513
298416,036DFEF8CA623F9034F928149FE2468D,30651,1,2,1,109.42611,18.385,1232
298417,036DFEF8CA623F9034F928149FE2468D,30821,3,11,8,109.43681,18.33639,1274
298418,036DFEF8CA623F9034F928149FE2468D,30711,13,18,5,109.50271,18.25347,1510
298419,036DFEF8CA623F9034F928149FE2468D,30821,20,23,3,109.43681,18.33639,1274
298473,7BF65E5054DA81A230AB5423620158E1,60631,2,7,5,109.57778,18.27583,1814
298474,7BF65E5054DA81A230AB5423620158E1,30854,9,10,1,109.56889,18.27076,1763
298475,7BF65E5054DA81A230AB5423620158E1,60631,12,13,1,109.57778,18.27583,1814
298517,746CE65E441D0A7A7BB255CDAAD7360A,30854,5,6,1,109.56889,18.27076,1763
298518,746CE65E441D0A7A7BB255CDAAD7360A,31071,10,13,3,109.58257,18.28458,1815
298519,746CE65E441D0A7A7BB255CDAAD7360A,30854,14,20,6,109.56889,18.27076,1763
298530,DAF24E4EE5B080B65CEC42C4A439EACF,31071,2,7,5,109.58257,18.28458,1815
298531,DAF24E4EE5B080B65CEC42C4A439EACF,30854,12,14,2,109.56889,18.27076,1763
298532,DAF24E4EE5B080B65CEC42C4A439EACF,39154,18,21,3,109.50201,18.25681,1511
298533,DAF24E4EE5B080B65CEC42C4A439EACF,30081,21,23,2,109.50243,18.26632,1512
298594,3871846CD20CC7E3D76BFB165D15B326,30854,0,7,7,109.56889,18.27076,1763
298595,3871846CD20CC7E3D76BFB165D15B326,38271,8,10,2,109.62632,18.23049,1956
298596,3871846CD20CC7E3D76BFB165D15B326,30854,12,23,11,109.56889,18.27076,1763
298618,6C0260646767B781577B5B8CE2471E51,38484,2,17,15,109.53028,18.31528,1620
298619,6C0260646767B781577B5B8CE2471E51,30071,20,21,1,109.52819,18.30472,1619
298631,8F6EA1C108FADA76A214A7ED71ECE3D1,30891,0,7,7,109.59431,18.28389,1865
298632,8F6EA1C108FADA76A214A7ED71ECE3D1,30854,10,12,2,109.56889,18.27076,1763
298633,8F6EA1C108FADA76A214A7ED71ECE3D1,30891,16,18,2,109.59431,18.28389,1865
298664,63B5E489F3503F8EC6E40A38F9D2117C,31951,10,12,2,109.52174,18.30299,1568
298665,63B5E489F3503F8EC6E40A38F9D2117C,60361,13,17,4,109.51938,18.29681,1567
298666,63B5E489F3503F8EC6E40A38F9D2117C,31951,17,19,2,109.52174,18.30299,1568
298700,EF7DCA5602FCDF14AF156D676A8ED902,31561,0,1,1,109.56792,18.28479,1765
298701,EF7DCA5602FCDF14AF156D676A8ED902,30854,1,5,4,109.56889,18.27076,1763
298702,EF7DCA5602FCDF14AF156D676A8ED902,31561,7,9,2,109.56792,18.28479,1765
298703,EF7DCA5602FCDF14AF156D676A8ED902,39183,9,11,2,109.55542,18.28208,1715
298741,8AABF5FDF2B06EB445749240A3894969,30854,0,1,1,109.56889,18.27076,1763
298742,8AABF5FDF2B06EB445749240A3894969,31071,2,11,9,109.58257,18.28458,1815
298743,8AABF5FDF2B06EB445749240A3894969,30854,13,23,10,109.56889,18.27076,1763
298765,162C9DF38B34BB5029840E39407B0BD5,31201,0,2,2,109.51042,18.23819,1558
298766,162C9DF38B34BB5029840E39407B0BD5,39191,3,8,5,109.51493,18.23472,1557
298767,162C9DF38B34BB5029840E39407B0BD5,31041,12,13,1,109.50278,18.23701,1507
298773,A4D782DD7C0CB1B25E56BFC209FED42C,60241,0,2,2,109.53319,18.28667,1616
298774,A4D782DD7C0CB1B25E56BFC209FED42C,30921,3,5,2,109.53903,18.29451,1667
298775,A4D782DD7C0CB1B25E56BFC209FED42C,31931,7,8,1,109.54771,18.29403,1667
298776,A4D782DD7C0CB1B25E56BFC209FED42C,60241,8,9,1,109.53319,18.28667,1616
298777,A4D782DD7C0CB1B25E56BFC209FED42C,30921,12,13,1,109.53903,18.29451,1667
298778,A4D782DD7C0CB1B25E56BFC209FED42C,31931,13,15,2,109.54771,18.29403,1667
298779,A4D782DD7C0CB1B25E56BFC209FED42C,30921,19,21,2,109.53903,18.29451,1667
298780,A4D782DD7C0CB1B25E56BFC209FED42C,60241,22,23,1,109.53319,18.28667,1616
298802,FD9120CA3F85D3F015CEFB66B9BF2F3D,30721,0,7,7,109.51597,18.28257,1565
298803,FD9120CA3F85D3F015CEFB66B9BF2F3D,60301,8,10,2,109.60715,18.30993,1919
298804,FD9120CA3F85D3F015CEFB66B9BF2F3D,30181,10,12,2,109.51597,18.23313,1557
298812,FC8552628F8A5A5219C1C30314657039,30271,12,15,3,109.49132,18.23153,1456
298813,FC8552628F8A5A5219C1C30314657039,60661,19,23,4,109.548,18.2377,1657
298820,5A6C2C4A9B4DF43C379FCADC2CCFC5BC,30201,0,7,7,109.4909,18.26465,1462
298821,5A6C2C4A9B4DF43C379FCADC2CCFC5BC,31151,9,11,2,109.75549,18.4191,2488
298822,5A6C2C4A9B4DF43C379FCADC2CCFC5BC,60161,12,13,1,109.49174,18.26181,1461
298827,E8BAAF476E8FE57075BAB1A8D4FF1780,30232,2,5,3,109.6191,18.31701,1971
298828,E8BAAF476E8FE57075BAB1A8D4FF1780,39371,7,8,1,109.56627,18.2646,1762
298829,E8BAAF476E8FE57075BAB1A8D4FF1780,30232,9,11,2,109.6191,18.31701,1971
298830,E8BAAF476E8FE57075BAB1A8D4FF1780,39371,15,16,1,109.56627,18.2646,1762
298831,E8BAAF476E8FE57075BAB1A8D4FF1780,30232,21,22,1,109.6191,18.31701,1971
298855,11C531682FCE295EEF5C9BA53600ACF3,38017,3,10,7,109.49729,18.21424,1504
298856,11C531682FCE295EEF5C9BA53600ACF3,31471,13,16,3,109.34583,18.29563,917
298857,11C531682FCE295EEF5C9BA53600ACF3,38017,18,23,5,109.49729,18.21424,1504
298858,9A1D1AA5EE2CD156CC396C667ED8C5B9,30854,2,7,5,109.56889,18.27076,1763
298859,9A1D1AA5EE2CD156CC396C667ED8C5B9,31071,7,14,7,109.58257,18.28458,1815
298860,9A1D1AA5EE2CD156CC396C667ED8C5B9,30854,16,17,1,109.56889,18.27076,1763
298878,324F7B0754DBA5A78AE17544C944B985,31031,16,18,2,109.49979,18.25382,1510
298879,324F7B0754DBA5A78AE17544C944B985,30271,19,20,1,109.49132,18.23153,1456
298886,AE15DCAE42DF0D3349548C07BEAC73FD,38951,0,1,1,109.48097,18.28868,1416
298887,AE15DCAE42DF0D3349548C07BEAC73FD,60401,1,2,1,109.47444,18.27583,1414
298888,AE15DCAE42DF0D3349548C07BEAC73FD,38951,3,22,19,109.48097,18.28868,1416
298892,408C4FED868686E7B96333835F4C4205,30854,0,4,4,109.56889,18.27076,1763
298893,408C4FED868686E7B96333835F4C4205,31071,7,15,8,109.58257,18.28458,1815
298906,798BF3B08F72A16A6DEAAA235F1899BB,61011,0,5,5,109.60653,18.19076,1900
298908,798BF3B08F72A16A6DEAAA235F1899BB,61011,9,22,13,109.60653,18.19076,1900
298930,306C6C6EB560D035853CD87DDFB51F50,31071,3,5,2,109.58257,18.28458,1815
298931,306C6C6EB560D035853CD87DDFB51F50,60631,10,11,1,109.57778,18.27583,1814
298932,306C6C6EB560D035853CD87DDFB51F50,30854,12,23,11,109.56889,18.27076,1763
298937,3CFD22273F071C6F856BEA34279CB804,31471,15,16,1,109.34583,18.29563,917
298938,3CFD22273F071C6F856BEA34279CB804,38951,21,23,2,109.48097,18.28868,1416
298987,89C2F48F3C187B81197D45E0E1289EA8,31041,0,1,1,109.50278,18.23701,1507
298988,89C2F48F3C187B81197D45E0E1289EA8,30851,2,6,4,109.5616,18.27396,1713
298989,89C2F48F3C187B81197D45E0E1289EA8,30581,7,12,5,109.62257,18.24951,1959
299066,7F632B4875B2736225CD6D350CD25670,30854,7,14,7,109.56889,18.27076,1763
299067,7F632B4875B2736225CD6D350CD25670,31071,15,16,1,109.58257,18.28458,1815
299068,7F632B4875B2736225CD6D350CD25670,30854,17,21,4,109.56889,18.27076,1763
